date,buy?,todays_price,Minimum,Maximum,25th Percentile,75th Percentile,Skewness,Standard Deviation,Kurtosis,Shannon Entropy,Median,Mean Absolute Deviation (MAD),Coefficient of Variation (CV),10th Percentile,90th Percentile,Autocorrelation,Cumulative Return,curr_to_avg_one_month,curr_to_avg_one_two_week,curr_to_avg_one_one_week,momentum,rsi,upper_band_current,middle_band_current,lower_band_current,rolling_mean_7,rolling_std_7,rolling_mean_14,rolling_std_14,ema_7,ema_14,roc_7,roc_14,Volume,Volatility,Relative Volume (RVOL),On-Balance Volume (OBV),Williams %R,Stochastic Oscillator %K,Stochastic Oscillator %D,Commodity Channel Index (CCI),ADX1,ADX2,Chaikin Money Flow (CMF),Average True Range (ATR),Fib_23.6,Fib_38.2,Fib_50,Fib_61.8,Fib_76.4,Parabolic SAR 2,Parabolic SAR 3,VWAP,Adj Close Momentum,Adj Close Return,Adj Close 7d MA,Adj Close 14d MA,Adj Close Volatility
2021-12-30,1,356.69749450683594,302.1433410644531,376.6083297729492,319.8114547729492,354.87749671936035,-0.01864138800635705,21.317271644878282,-1.1203039099630654,2.9937455271164803,339.94083404541016,18.611208343505858,0.06298405719769806,309.45316619873046,363.27792434692384,0.7462346296240351,-0.03680438999346208,1.0538991936002242,1.072949485755823,1.0097469789469176,0.08439565660529968,58.31500104861153,381.08958403072336,338.4550407409668,295.82049745121026,347.1029728480748,22.048609805234445,332.8987481253488,22.295946540329428,347.7695368645293,343.8986028293034,17.108502172254283,2.9789070799034314,47040900,11.600353261965768,0.6620892739367294,-61999200.0,-20.894879880298987,85.04343053981948,79.70440250180728,78.21545465501805,30.021849528478633,20.51421788493745,0.13904742681175433,17.81821691972365,354.6801038818359,343.3466088256836,334.18666076660156,325.02671270751955,313.6932176513672,0.08,0.0,337.3334465012441,0.06092952426101572,0.14044306791854652,350.15904453822543,334.0645206996373,20.579463251116593
2021-12-31,1,355.56749725341797,302.1433410644531,366.2816619873047,319.8114547729492,353.36499786376953,-0.18518205793779205,19.93215115714157,-1.228913825902088,2.993979727011293,339.94083404541016,17.615666580200195,0.059065313667347734,309.45316619873046,362.792667388916,0.7845916345441533,-0.016755081424816624,1.0536597675591153,1.0577733039670925,0.9909728503683471,0.029551147403628075,56.71962001337574,377.3238012919443,337.45949897766116,297.59519666337803,354.07666451590404,13.037381547836041,334.312557220459,23.10517785459077,349.96034136667976,345.1112651566487,18.055719265626752,3.6587393198009757,40733700,11.26295136416612,0.5866862547057203,-102732900.0,-26.717606168407787,85.04343053981948,79.70440250180728,69.98703886764213,28.564035163073545,19.518079339264467,0.11806371012345164,17.032348750281663,354.6801038818359,343.3466088256836,334.18666076660156,325.02671270751955,313.6932176513672,0.08,0.0,337.79891622883423,-0.00957820101016904,0.0474887769928194,355.78999982561385,335.01094927106584,20.11414139646089
2022-01-03,0,390.3866653442383,302.1433410644531,366.2816619873047,319.8114547729492,353.08249855041504,-0.2104575578287995,19.53227817788451,-1.2011181747298165,2.994045074598419,339.94083404541016,17.255249786376954,0.05794224668708095,309.45316619873046,362.7671585083008,0.8219376344891879,0.01819807624231951,1.1580769155916595,1.1491475070632062,1.081860032422758,0.07561077284011364,58.1248292060794,376.16363853960684,337.0990821838379,298.0345258280689,362.85523550851,13.945091730797927,338.8406524658203,27.377311857427127,351.35559568863374,345.56636798219364,15.91379892725447,5.894833225601691,103931400,10.827254315533006,1.4845095945835056,1198500.0,-0.40958183119414765,85.04343053981948,79.70440250180728,183.411478938856,40.2112259912995,15.304919163393652,0.23276188482608065,19.791653933769716,375.58059130859374,360.25302404785157,347.864990234375,335.47695642089843,320.14938916015626,0.1,0.0,341.30901859013966,0.09675118937206961,0.12444239277840248,364.8809509277344,340.56737845284596,24.519000776027077
2022-01-04,0,389.1824951171875,302.1433410644531,390.3866653442383,319.8114547729492,355.84999656677246,0.23640962279797664,22.625498689508117,-0.6023244336270075,2.9935149598371993,339.94083404541016,19.313957977294923,0.06671083292678562,309.45316619873046,363.27792434692384,0.7158221686260534,0.17625906904598734,1.1474968470786306,1.119042054599124,1.0623643955881137,0.06252246701522446,73.26361569550309,384.40878775377206,339.15779037475585,293.90679299573964,369.1153542654855,14.603478126496775,344.0208309718541,29.626344526159315,361.1488031541118,350.446450103942,18.68140674248714,19.38673582881063,100248300,12.484989916232289,1.4131448807482845,-99049800.0,-18.14651509135363,85.04343053981948,79.70440250180728,139.74650898558698,35.37036928790166,15.303280720915282,0.16608430257964876,20.5359434481621,377.34542944335936,361.6806025390625,349.0199890136719,336.3593754882812,320.6945485839844,0.12000000000000001,0.0,343.9348796852019,0.05615218107165498,0.05087112936240501,368.81380789620533,345.11690194266185,26.290593449596777
2022-01-05,0,373.8433380126953,302.1433410644531,390.3866653442383,319.8114547729492,358.20999336242676,0.23048467452793503,25.023747627877153,-0.783750626655022,2.993065667837904,344.73458099365234,21.16524971008301,0.0731640396485043,309.45316619873046,368.571745300293,0.794953323514978,0.11715538387266071,1.0930372704933802,1.048690842214778,1.007891293421639,0.030588352480845016,71.3365543605117,392.0699935772875,342.0224983215332,291.9750030657789,370.67237745012557,14.415671898089144,347.8894032069615,29.739781266188473,368.21614699704025,354.56289640836405,12.688388981666302,22.902324257270628,80119800,12.104576916795194,1.110590607099661,-179169600.0,-37.243684772802,85.04343053981948,79.70440250180728,82.86285836134982,31.126825305560615,19.11345361795566,0.09266988887276005,21.3301113004057,377.34542944335936,361.6806025390625,349.0199890136719,336.3593754882812,320.6945485839844,0.12000000000000001,0.0,345.13227600249996,0.0017768744356394528,-0.0003215578776843627,368.5366646902902,347.7866646902902,26.619874041777603
2022-01-06,0,354.1833267211914,302.1433410644531,390.3866653442383,319.8114547729492,362.7966613769531,0.15089072515206275,25.945710465065957,-1.013516175486893,2.9928817814551016,344.73458099365234,22.311587219238284,0.07557820319984399,309.45316619873046,375.3772537231446,0.8475469335556566,0.06128862187755695,1.0317134877833798,0.9751880108587382,0.9492083400671175,-0.007048459337009261,61.03242447898732,395.187627595171,343.29620666503905,291.4047857349071,368.9440438406808,15.698036129015724,350.3414862496512,28.64554006385932,369.6151408992017,355.6242027549874,3.002985864383281,16.94176917107066,90336600,12.705635114483428,1.2115452510875853,-269506200.0,-44.51969231364348,85.04343053981948,79.70440250180728,28.102674972414192,28.353746781263556,25.382865603957953,0.08519650610212941,21.432604891143068,377.34542944335936,361.6806025390625,349.0199890136719,336.3593754882812,320.6945485839844,0.02,1.0,345.48538350850555,-0.005269367367130573,-0.01978474372794342,367.4047589983259,351.067140851702,26.58517822138394
2022-01-07,0,349.85499572753906,302.1433410644531,390.3866653442383,319.8114547729492,362.7966613769531,0.14074456903543003,25.982394136770722,-1.026048853522651,2.9928746181029124,344.73458099365234,22.39839946746826,0.07566380067570867,309.45316619873046,375.3772537231446,0.869317955080747,0.029281049107797115,1.0188190712058636,0.9566209031601732,0.9388736658569721,-0.01606587095278711,51.95081288082539,395.3574529921694,343.39266471862794,291.4278764450865,367.10225895472934,17.22797776086138,353.2058906555176,26.173006866177708,365.7377148725841,353.97007520355606,-3.3030141887181372,10.73275462638577,84164700,13.390031365660937,1.110360445934693,-353670900.0,-56.24454603064804,85.04343053981948,79.70440250180728,9.048304527664403,25.76116593359161,24.41550417049063,0.09216842330397991,21.617427000866027,377.34542944335936,361.6806025390625,349.0199890136719,336.3593754882812,320.6945485839844,0.04,0.0,345.52544962714245,-0.028217799823544554,-0.0405291538330405,364.5842851911272,353.3145228794643,26.509299335957888
2022-01-10,1,341.43499755859375,302.1433410644531,390.3866653442383,319.8114547729492,362.7966613769531,0.10775864301633843,26.02046804956407,-1.0428789823835496,2.992868673987789,347.6083297729492,22.657036857604982,0.07571131590914976,309.45316619873046,375.3772537231446,0.8721750006496436,0.04193540500432259,0.9934676391430841,0.9324521674954955,0.9190956597950626,-0.12539277626831735,50.893778752750094,395.72097569568575,343.6800395965576,291.63910349742946,364.92190224783764,19.57077243897472,356.0124375479562,22.059775134058093,361.7585213356605,352.4070246993519,-3.5541236147978594,12.946321241614129,91815000,13.279909606630808,1.1861334201472153,-445485900.0,-46.56392820044894,85.04343053981948,79.70440250180728,1.0026653683523212,23.212172377851225,25.75239553036808,0.11747040229947393,22.009698105341663,377.34542944335936,361.6806025390625,349.0199890136719,336.3593754882812,320.6945485839844,0.06,0.0,345.4641199720438,-0.11807164964096739,0.001267970422571329,364.00238037109375,357.0807124546596,26.56105911167845
2022-01-11,0,352.72833251953125,302.1433410644531,390.3866653442383,319.8114547729492,362.7966613769531,0.07714121968164779,25.963657620152652,-1.030197279238405,2.9928836216686703,347.6083297729492,22.345691337585446,0.07548385002919424,309.45316619873046,375.3772537231446,0.8646605205832406,0.04416501573623875,1.0254831173049304,0.9689859737330251,0.975196288888642,-0.09366855666691654,48.012160110457195,395.89039621869887,343.9630809783936,292.0357657380883,364.51630728585377,19.824721528754342,359.2964859008789,17.00544913114074,356.65007349515486,350.2624005547756,-4.278834918463295,13.004309926446117,66063300,13.266530006971406,0.8604191970173625,-379422600.0,-57.22256090108765,85.04343053981948,79.70440250180728,25.081288135176493,24.258507965308276,24.52879154967378,0.15738890531147479,21.220106756099998,382.9252579345703,370.7123588256836,360.84165954589844,350.97096026611325,338.75806115722656,0.06,0.0,345.7030935754762,-0.07410468512624613,-0.11283738313535112,364.365234375,360.0776171003069,26.127514096840642
2022-01-12,0,364.375,302.1433410644531,390.3866653442383,319.8114547729492,362.7966613769531,-0.054557511688069535,25.72739112173717,-0.969727024651498,2.992946809142637,351.29166412353516,21.678116455078122,0.0745181859946316,309.45316619873046,375.3772537231446,0.8395124128971541,0.11390240933082721,1.0553951581531555,1.0047215688417495,1.0281200588734922,-0.02532702083987326,54.359001522929255,396.70461325238546,345.24983100891114,293.79504876543683,360.80035509381975,16.290098930442237,361.8277953011649,14.607101293493953,355.59077755472117,349.34177654044765,-0.7984882633586742,14.988240847207171,83739000,13.193467950809357,1.0815219497074664,-295683600.0,-44.640350341796875,85.04343053981948,79.70440250180728,60.087940993586884,27.71457144498666,22.930542190965788,0.16220229278663098,20.863798381415197,384.73065649414065,373.63465649414064,364.6666564941406,355.6986564941406,344.6026564941406,0.06,0.0,346.46360504005537,0.016634172395654012,-0.037726490667687754,359.90999494280135,362.39547293526783,25.824446379753738
2022-01-13,0,356.89749908447266,302.1433410644531,390.3866653442383,326.66604232788086,363.30188179016113,-0.24824748398435303,25.17193916190058,-0.8109127228124611,2.993089924148096,353.4558296203613,20.71654983520508,0.07240898378262373,309.45316619873046,375.3772537231446,0.8199335522951124,0.1397998254622331,1.0266426061596812,0.9836617972214619,1.0124311432720365,0.007663185018920382,58.70439490215779,397.9794595310766,347.6355812072754,297.29170288347416,356.1882128034319,10.432220570247148,362.65178353445873,13.915805205796916,357.70288306430507,350.69698860934045,-6.6630517006264816,10.77360325220442,97209900,13.371483689994246,1.237884815469845,-392893500.0,-77.38595259817022,85.04343053981948,79.70440250180728,11.915789011966783,24.65935498253349,26.102788558903,0.062380156418243786,21.570511150132955,384.73065649414065,373.63465649414064,364.6666564941406,355.6986564941406,344.6026564941406,0.06,0.0,346.72125586080506,-0.0311261244489488,-0.05197955906738245,354.2895202636719,361.55166407993863,25.280303957112107
2022-01-14,0,344.57249450683594,302.1433410644531,390.3866653442383,338.31041526794434,363.30188179016113,-0.42385692431915867,24.40055356347825,-0.5113943300456363,2.993265980044826,354.8754119873047,19.223820419311515,0.06981634504808457,309.45316619873046,375.3772537231446,0.8114010029120133,0.11581320212742485,0.985911737944163,0.949639930711396,0.9759652337406798,-0.015099116163020398,54.83237499590099,398.29739695239596,349.4962898254395,300.695182698483,352.00666373116627,7.6790988299677565,361.3395205906459,14.728601090071908,357.38692381424556,351.4780588766905,-8.295593054100094,3.340218812525896,72924300,13.545091802870319,0.9344875342266953,-465817800.0,-69.46929128546464,85.04343053981948,79.70440250180728,-18.387680380117796,23.452019956443376,26.493140152670502,0.14939526933221414,20.879854992846607,384.73065649414065,373.63465649414064,364.6666564941406,355.6986564941406,344.6026564941406,0.06,0.0,346.70268820936184,0.02205535064100994,-0.014173003284874674,352.4557102748326,360.49618748256137,23.43173298268515
2022-01-18,0,345.3308334350586,302.1433410644531,390.3866653442383,343.7881202697754,363.30188179016113,-0.5338064741713384,23.47634834833617,-0.12697221404249293,2.9934604199075068,354.8754119873047,17.704850006103516,0.06693525123629503,309.45316619873046,375.3772537231446,0.7584442450388484,0.11240931617001176,0.9845997236300595,0.9546226222106511,0.9810488643459363,0.011410183210045055,50.15576724582422,397.6849030412768,350.7322063446045,303.7795096479322,350.7420218331473,7.983785312548407,359.84303283691406,15.24318918634208,354.09633381325665,351.24078495396714,-7.829708471323721,-5.0618476455567105,66743400,13.65787232174867,0.8741541476723983,-399074400.0,-77.84648694490132,85.04343053981948,79.70440250180728,-27.662209078807948,24.208478501170145,24.651174345966016,0.13787388499704092,20.6721418870993,384.73065649414065,373.63465649414064,364.6666564941406,355.6986564941406,344.6026564941406,0.06,0.0,346.69377931415204,-0.02609346387607281,0.0034567628723965516,350.8276149204799,359.1161869594029,21.52073022851078
2022-01-19,0,340.58583068847656,302.1433410644531,390.3866653442383,345.14124870300293,363.30188179016113,-0.5938421678555218,21.574750944914527,0.5323462202229536,2.993832341907777,354.8754119873047,15.570200042724604,0.06120304321920436,326.7181671142578,375.3772537231446,0.6702713863327598,0.1429370980623158,0.9661705652453376,0.9533801222255462,0.9654317918728571,-0.03442451516247946,51.391063800588554,395.66058320391596,352.51108131408694,309.3615794242579,349.4178553989955,8.874424427710792,358.26005717686246,16.04784963269931,351.90064566772514,351.6940776404767,-2.499409943456029,-5.719868267107581,75442500,13.48003982639581,0.9759689832225314,-474516900.0,-93.13595420435855,85.04343053981948,79.70440250180728,-81.31606488522141,22.381422719842767,25.454421150873983,0.10806940857488459,20.610973767399173,384.73065649414065,373.63465649414064,364.6666564941406,355.6986564941406,344.6026564941406,0.06,0.0,346.44679780361867,-0.06459035310765804,-0.059038673788396306,349.336661202567,356.9604731968471,18.330290954183543
2022-01-20,0,336.8050003051758,306.7516555786133,390.3866653442383,345.14124870300293,363.30188179016113,-0.25908285607826004,18.494335160943457,0.8425531927747576,2.9943623082795865,354.8754119873047,13.459125900268555,0.05218002957551706,339.4209144592285,375.3772537231446,0.5601950657356025,0.11029826406655652,0.9502636739394731,0.955798753805123,0.9613322646430528,-0.07566380705269082,48.469324320217154,391.421876117175,354.4332057952881,317.4445354734012,348.7564272199358,9.702475089757172,356.8391647338867,17.046425252199978,349.15382032257793,352.06731991408014,-2.6494305218614524,-6.1093901008241716,70488600,13.556339950990765,0.9124899100158858,-545005500.0,-92.86402652138158,85.04343053981948,79.70440250180728,-106.45421476518848,21.01703477440892,24.030600772133038,0.022254570405775113,20.24398514596693,384.73065649414065,373.63465649414064,364.6666564941406,355.6986564941406,344.6026564941406,0.06,0.0,346.1887917194467,-0.09939251197894006,-0.06400786988845601,346.3914228166853,355.1969015938895,16.43003308691839
2022-01-21,0,323.774169921875,328.9366683959961,390.3866653442383,345.14124870300293,363.30188179016113,0.6428464889065466,15.54488964608603,0.05069387962892247,2.9947866244753505,354.8754119873047,11.993296241760254,0.0436732873078664,340.2077476501465,375.3772537231446,0.5686798546512384,0.02392050709198301,0.9096418609458776,0.9285795357911042,0.9389158346053073,-0.09280908173233748,43.50616272220575,387.0256523237883,355.9358730316162,324.84609373944414,344.6201182774135,13.250169329268827,354.56821278163363,19.209419975607,346.1820176670893,351.6095217336805,-1.3560406187193548,-5.57685279768034,103416000,12.713076997223144,1.330319352669505,-648421500.0,-98.72897409930067,85.04343053981948,79.70440250180728,-186.22824765747293,19.313102324992737,28.85432740371678,-0.08360997947682437,20.32936790001025,381.6233255615234,368.6049937133789,358.0833282470703,347.5616627807617,334.5433309326172,0.08,0.0,345.2297633008195,-0.08497809518552035,-0.1467339056475977,340.653329031808,352.50928170340404,18.365882717815527
2022-01-24,0,301.64500427246094,323.774169921875,390.3866653442383,345.14124870300293,363.30188179016113,0.4699175440576069,16.026474048614272,0.13710156599955114,2.9947232271906956,354.8754119873047,12.225608673095701,0.045058972999772684,340.2077476501465,375.3772537231446,0.601090266172373,-0.06250692001483457,0.8480851160273989,0.8727247107564103,0.8918770434198504,-0.1245818831123311,35.20336770405777,387.73069620513866,355.67774810791013,323.6248000106816,335.6586903163365,18.017846049958614,348.2295227050781,21.035541670638803,340.57295399051463,348.68385295690456,-8.208629681329327,-8.94157300010001,151565700,12.459571180832828,1.878594973869102,-799987200.0,-77.97380142764038,85.04343053981948,79.70440250180728,-237.97710147085607,17.152005691952866,36.40377122278635,-0.043013810247151466,21.13381166377984,374.61963232421874,357.26850720214844,343.2449951171875,329.22148303222656,311.87035791015626,0.1,0.0,342.9277614402415,-0.11395660009036557,-0.09845282659172234,332.26190185546875,346.085948399135,20.87626043917254
2022-01-25,0,307.2558364868164,301.64500427246094,390.3866653442383,343.7881202697754,363.30188179016113,-0.4256252562349843,19.81731049340916,0.8404874036008261,2.994145018788906,354.8754119873047,14.469557723999026,0.05606156646068317,335.5019172668457,375.3772537231446,0.6223760035030084,-0.1688942144507865,0.8692018779928401,0.9015328316209662,0.9321285817525032,-0.11025658082570955,25.28272444031896,393.12653611743355,353.4919151306152,313.8572941437969,328.56702423095703,18.0344562360778,342.3776185171945,20.143126772197384,330.83332394074625,343.03973733267065,-17.2157792734241,-22.731734700396597,86595900,12.475011159032448,1.0631414370399563,-713391300.0,-79.01025894718528,85.04343053981948,79.70440250180728,-172.63201827967038,18.31858590102464,34.25769412917606,-0.06230493781929406,20.74312448616176,365.0289002685547,349.5105590209961,336.9683380126953,324.42611700439454,308.9077757568359,0.1,0.0,341.9070310742082,-0.10879078088440064,-0.1250083300333027,326.87333025251115,340.58142525809154,23.027258944029864
2022-01-26,0,315.2941665649414,301.64500427246094,390.3866653442383,341.22270584106445,363.1543674468994,-0.3906960584065138,22.077008499360645,0.16089979149760847,2.9937303969469866,353.4558296203613,16.510832061767577,0.0629499187061166,322.12233657836913,375.3772537231446,0.7278587359831481,-0.1611487323177378,0.8990231694819814,0.9344901301756325,0.9791343881843044,-0.07425929632013573,28.733964353707233,394.86151516766665,350.70749816894534,306.553481170224,324.38440595354353,17.073289434447133,338.1955348423549,19.161773970959928,324.94786169860464,338.73396201320816,-13.909221197962713,-21.050961864485195,104867400,12.548079426781767,1.2531952071713175,-608523900.0,-67.4629913858005,85.04343053981948,79.70440250180728,-127.59987178250343,20.878460279266214,30.920330400549425,-0.05692982940159711,21.23596441449509,351.0884416503906,338.2341147460937,327.8450012207031,317.4558876953125,304.60156079101563,0.1,0.0,340.9700170563929,-0.058494441411536924,-0.09034359439572982,321.5304739815848,336.99309212820873,24.18955284491483
2022-01-27,1,293.90416717529297,301.64500427246094,390.3866653442383,339.64062309265137,358.3599967956543,-0.206662670065272,23.05368661168818,-0.23861019891491875,2.993525478502015,351.29166412353516,17.672477684020997,0.06621613876676835,314.4903335571289,375.3772537231446,0.7873823886119405,-0.1308164072300534,0.844168633226058,0.8808662088050133,0.9272745964015582,-0.1273758794881631,34.50572901140084,394.2654966212035,348.1581233978271,302.05075017445074,317.0377393450056,17.613729647712233,333.8898805890764,21.873466721225185,322.59131112021157,335.8790118651943,-8.497000894920149,-15.661418967365854,147109500,12.791054124914314,1.6673827108565957,-755633400.0,-99.9651166802324,85.04343053981948,79.70440250180728,-186.89103609775722,18.326830684277915,35.821863573652934,-0.140592890621217,22.362918268703204,349.32080395507813,335.3729384765625,324.1000061035156,312.8270737304687,298.8792082519531,0.12000000000000001,0.0,338.54776538043666,-0.16779586332381446,-0.1672776465765585,311.9395228794643,331.3835688999721,28.53278286280827
2022-01-28,1,277.2850036621094,293.90416717529297,390.3866653442383,333.5472927093506,356.7474956512451,-0.22939388698494823,25.615543448674504,-0.4193882678321903,2.992948962219247,347.5929145812988,19.717194786071776,0.07430913164644808,306.6947532653809,375.3772537231446,0.7571670756895992,-0.17604084216616095,0.8043869099244011,0.848988012960051,0.8991821690975698,-0.14358516082670592,28.586755037616303,395.9470441574809,344.71595726013186,293.48487036278283,307.99476405552457,19.6417939029967,328.70630972726,26.00722768989012,315.48914525315126,330.69961462847374,-14.891999578553909,-17.01919740376413,134789100,13.45661682058154,1.455366859037887,-890422500.0,-83.20713793823452,85.04343053981948,79.70440250180728,-178.7702028548742,16.977024206978488,37.343518084535596,-0.08113908718677512,22.322783100721278,346.410919921875,330.6628719482422,317.93499755859375,305.2071231689453,289.4590751953125,0.14,0.0,336.07805218408885,-0.10334780000397681,-0.15048127973681127,304.8299996512277,327.0833304268973,31.309449185754275
2022-01-31,0,300.7891616821289,277.2850036621094,390.3866653442383,321.6541690826416,355.89999771118164,-0.35485957526040524,29.335286266418926,-0.407611064030152,2.9919762385162922,344.95166397094727,22.941348266601562,0.08609152774722151,300.8709205627441,375.3772537231446,0.7626575852988876,-0.22016211885507508,0.8827389043980054,0.94396248184951,1.0057253716964887,-0.002837251001044261,24.822808879386372,399.4159052507334,340.7453327178955,282.07476018505764,302.84964425223217,15.007695773824038,325.803035736084,26.735496802214275,306.03875652185377,324.1877780415334,-18.58586627001125,-20.742877178162672,104436000,13.765789331064068,1.0901424963924964,-785986500.0,-55.27983576585543,85.04343053981948,79.70440250180728,-89.76081763838376,24.05557108179475,33.61287146277825,-0.007895021590318926,22.939762588091853,346.410919921875,330.6628719482422,317.93499755859375,305.2071231689453,289.4590751953125,0.14,0.0,335.10848867344,0.007225774949596753,-0.007606762622933965,301.9942844935826,324.19285365513394,31.67552280970847
2022-02-01,0,309.59666442871094,277.2850036621094,390.3866653442383,313.28458404541016,354.8618698120117,-0.16844864169729623,30.362761852784605,-0.7036649192720859,2.9916645285410675,343.00374603271484,24.729881744384762,0.08982895122983237,300.1006622314453,375.3772537231446,0.7995475805479636,-0.22950964163466847,0.9159490761982476,0.985139215323484,1.0357671281968917,0.007618497889770648,33.47329667531345,398.73193964490025,338.0064159393311,277.2808922337619,300.8242863246373,12.45229281602459,322.7222023010254,25.865066490579707,304.78914344916575,321.97382478508445,-10.693380024172226,-11.904414066249785,73138200,12.227096945736225,0.7759143634258449,-712848300.0,-56.97024670770634,85.04343053981948,79.70440250180728,-67.0432713249569,23.651357721605834,32.152076138623045,-0.04713255107925736,22.189249578003327,346.410919921875,330.6628719482422,317.93499755859375,305.2071231689453,289.4590751953125,0.14,0.0,334.5634785573739,0.01399169824840607,0.0013440532069052419,301.3919023786272,321.0226157052176,28.43286085361053
2022-02-02,0,304.5625,277.2850036621094,389.1824951171875,309.0114574432373,353.0920810699463,-0.13828861763204522,28.43854636523867,-0.7418853088402044,2.9920823924960356,341.01041412353516,24.219115295410155,0.08515378323972332,300.1006622314453,365.3218338012695,0.784178337717867,-0.20449488784050351,0.911954105349385,0.980266724252161,1.0173317328723153,-0.03403699688408601,38.07572380412648,390.844008624032,333.9669158935547,277.08982316307737,301.24107142857144,12.532905176832603,318.44988087245395,23.264867281889586,305.90358210537187,320.62768009309633,-4.378825369727616,-12.228013492063903,66792900,12.57777064639139,0.7213999584610903,-779641200.0,-64.87840030148826,85.04343053981948,79.70440250180728,-74.12322350295096,22.50576732497137,32.38881092585789,-0.03589238712497303,21.581332705767117,346.410919921875,330.6628719482422,317.93499755859375,305.2071231689453,289.4590751953125,0.02,1.0,333.9747039571764,-0.03386995060170328,-0.01387197390747053,300.2328534807478,316.24737766810824,26.512653179671535
2022-02-03,0,299.22166442871094,277.2850036621094,373.8433380126953,306.5825023651123,350.5733299255371,-0.232680510782058,26.108284790191412,-1.050089628175254,2.992571733969332,338.6954154968262,23.351657104492187,0.07917937813995604,300.1006622314453,357.6452491760254,0.7906385058519965,-0.18532050987181858,0.9074585138725323,0.9743740496133847,1.0067092211964153,0.018092622859091634,37.67395752728681,381.95248571807815,329.7359161376953,277.5193465573125,300.0933325631278,12.25507886164832,314.3301783970424,20.921465473010286,305.4819199921069,318.32092387201624,0.9671951088915876,-16.41509433962264,78855600,12.304469807682429,0.8522655793027331,-858496800.0,-64.44149317853636,85.04343053981948,79.70440250180728,-71.96043256367712,21.033502543896017,31.299701440571404,-0.026100603173791547,21.376723849233084,334.99929943847656,321.4320061645508,310.46665954589844,299.5013129272461,285.9340196533203,0.04,0.0,333.2644046028152,0.07482809983190108,-0.0493594258120677,298.9347577776228,312.904044015067,26.07415281840162
2022-02-04,0,303.18416595458984,277.2850036621094,364.375,303.83312606811523,346.4618740081787,-0.18881298234074553,24.839571129742858,-1.2526927262990992,2.9928105314852207,330.2895851135254,22.671998596191408,0.07619387400616279,298.68991470336914,354.45474395751955,0.8264762259971217,-0.15517857037845711,0.9299989931688771,0.9995098852114956,1.0164040052609065,0.09340267937475755,37.49725243475175,375.68397471798176,326.0048324584961,276.3256901990104,298.3633324759347,10.47743083984639,311.3738692147391,19.170248467436267,303.8865033575265,315.532411437557,-2.614815116278579,-16.160335895800337,73625400,11.725460980857013,0.8029894931917767,-784871400.0,-52.898321555089446,85.04343053981948,79.70440250180728,-55.732508757556644,19.67559564821962,29.279016567471245,-0.020569799071674826,21.159456661465907,334.99929943847656,321.4320061645508,310.46665954589844,299.5013129272461,285.9340196533203,0.04,0.0,332.69900841627475,0.09094349995061868,0.11364133523660545,298.26380702427457,309.8971405029297,25.339311820707902
2022-02-07,0,306.8008270263672,277.2850036621094,364.375,302.7993755340576,344.7620792388916,-0.0016731873975303808,24.4303043769577,-1.2492431313990757,2.9928750050946866,319.5341682434082,22.181040954589843,0.07552925093725092,298.68991470336914,353.1452491760254,0.8376421069927401,-0.13340049547068822,0.9485119912826996,1.0183454151899407,1.0109730339264797,0.019986309714813855,40.154403833792536,372.3154831740814,323.454874420166,274.5942656662506,300.2057124546596,10.694281596805753,308.6217258998326,16.50006232663695,303.72052444105395,314.56392443611117,-3.8408578066277848,-12.011500979346161,60994500,11.817822295682868,0.6737444937132313,-723876900.0,-56.09153599158995,85.04343053981948,79.70440250180728,-45.61461236163752,19.96151053965715,27.710057227856534,-0.02334288998137412,20.705924705685923,330.89408178710937,318.11129345703125,307.7799987792969,297.4487041015625,284.6659157714844,0.06,0.0,332.27722391353007,-0.031364768342409866,0.072062337421827,301.98951939174106,306.9645211356027,25.26984108159233
2022-02-08,0,304.0516662597656,277.2850036621094,364.375,302.7993755340576,342.2193717956543,0.1848506800751172,23.900317211743662,-1.1335005557868665,2.9929735857427806,312.4454154968262,21.478466415405272,0.07438579549710056,298.68991470336914,353.1452491760254,0.8544356188193464,-0.10143708401269845,0.9463106646901926,1.007496122795574,0.9979601153609967,-0.017910393767249788,43.08775533371904,369.1028004085948,321.3021659851074,273.50153156162,304.0295213971819,3.494944409343007,306.01214272635326,13.70883838315724,304.5194623444127,314.53048874436126,4.388049334251963,-11.157418532665485,50729100,11.803765723154932,0.573363617144317,-774606000.0,-47.93108810038271,85.04343053981948,79.70440250180728,-46.179616231020205,19.187683968392193,27.6096118418891,-0.053628902587105134,19.953586030442256,327.58086596679686,315.4312314453125,305.6116638183594,295.79209619140624,283.6424616699219,0.06,0.0,331.9150414443187,-0.009932820690436883,-0.01571434435682814,305.59190150669644,305.21095057896207,24.246886158560415
2022-02-09,0,311.10582733154297,277.2850036621094,364.375,302.7993755340576,341.5824966430664,0.37635795156098445,23.713789677208023,-1.00470839836479,2.9929974100651644,308.4262504577637,20.960516510009768,0.0742371317936883,298.68991470336914,353.1452491760254,0.8250374283803742,-0.13800044332154776,0.9739313968696456,1.0319662341874407,1.0248437183099905,0.021484349949658865,40.17617000006725,366.8605787745821,319.432999420166,272.00542006574995,305.50333077566967,4.0343771628197915,304.1764875139509,10.6471013453856,304.46171133149335,313.4803712000289,9.65312304818087,-10.72685976244491,52259400,11.3918115172566,0.5953036767088009,-722346600.0,-34.134767805698374,85.04343053981948,79.70440250180728,-21.67968899144414,21.10161839570412,26.680399021836227,-0.07098047478180732,19.130328744050864,318.1301896972656,307.7865744628906,299.4266662597656,291.06675805664065,280.72314282226563,0.06,0.0,331.6338813880533,0.029083758937072046,0.0008053691539091717,305.3671395438058,303.6807120186942,22.707752747338535
2022-02-10,0,304.45249938964844,277.2850036621094,364.375,302.7993755340576,337.750207901001,0.5545487148563368,22.49557440807726,-0.6213285773612256,2.9932479922170683,308.4262504577637,19.087770881652837,0.07088527353924268,298.68991470336914,346.4875,0.7651074073720809,-0.14619326975905875,0.9593530846312774,1.011301553669782,0.9986212913421282,0.01748147137315237,42.90688521865953,362.34302297692113,317.3518741607666,272.3607253446121,304.76845005580356,3.6107643016173068,302.79636819022045,9.042765011498028,306.1728504684973,312.77391960488507,3.4298661533278967,-7.63028249294014,66126900,11.133564548380019,0.7609056801515991,-788473500.0,-42.48774649706084,85.04343053981948,79.70440250180728,-37.88917698210908,19.813785866140076,28.070557784524997,-0.12558501312861642,18.87888500643304,313.83651342773436,304.31341748046873,296.6166687011719,288.919919921875,279.3968239746094,0.06,0.0,331.19021541742796,0.015048144961409493,-0.0012256093726970543,304.095711844308,302.7438071114676,19.207169429506113
2022-02-11,0,294.69083404541016,277.2850036621094,356.89749908447266,302.7993755340576,327.0318775177002,0.5841035601074009,19.87045741900562,-0.43646613914201504,2.993755784122048,307.0283317565918,16.276975059509276,0.06321009707626682,298.68991470336914,344.6483283996582,0.721355485341057,-0.14694695207828065,0.9374437555564127,0.9754583207175348,0.9632969405299416,-0.028013771373706198,40.61638823634325,354.0966639682603,314.355749130249,274.61483429223773,303.35821206229076,5.257062609639672,302.2996417454311,9.298264984308691,305.7851064711404,310.880018739888,-1.6615699166381095,-5.967638041320214,79645800,11.116863206322286,0.9258199518269257,-868119300.0,-65.25451166585881,85.04343053981948,79.70440250180728,-92.52130514278224,18.160354011773727,31.61016628135077,-0.10983449719410555,19.089378368791095,313.83651342773436,304.31341748046873,296.6166687011719,288.919919921875,279.3968239746094,0.06,0.0,330.4162703780315,-0.06857867885915458,-0.03494402136922267,301.92142595563615,301.077139718192,18.57345465535295
2022-02-14,1,290.7800064086914,277.2850036621094,345.3308334350586,301.43104362487793,317.4141674041748,0.5953825676827648,17.720223613392186,-0.2997345842514365,2.9941275737526176,305.6816635131836,13.889000015258784,0.05693328386343592,294.61216735839844,340.9844970703125,0.6957861417134437,-0.14476390674426332,0.9342467119978181,0.9569992935205975,0.955820426708347,-0.05221896164021389,37.59383910385263,346.6858631050803,311.2454158782959,275.8049686515115,302.15226091657365,7.032546334346721,301.12279673985074,9.658392707406076,303.01175330551314,308.06212676154945,-3.241261138383696,-2.305415348688959,67756500,11.0150562765637,0.7899889610362355,-935875800.0,-57.200512036411475,85.04343053981948,79.70440250180728,-90.89386788437983,17.084483424898217,29.737490884918472,-0.14785624265830793,18.808242408473067,313.83651342773436,304.31341748046873,296.6166687011719,288.919919921875,279.3968239746094,0.06,0.0,329.78350307464643,-0.034804953740308786,-0.05150976433887678,301.18904767717635,300.06190272739957,16.394499817910116
2022-02-15,0,303.2341613769531,277.2850036621094,345.3308334350586,300.3972873687744,312.1529121398926,0.7235729485287546,16.497853988062623,0.19141051831047395,2.99431918963133,304.5074996948242,12.260195236206062,0.053467977085387086,293.5917510986328,337.18308334350587,0.6216319409227598,-0.1579668588632581,0.982753102539336,1.0012861241882243,1.0073683573688175,-0.002688703840596829,35.78973914085085,341.551499449514,308.5557914733887,275.5600834972634,302.1594031197684,7.033794272292655,300.26136779785156,8.796592200208071,299.93328071056584,305.13485364899867,-2.8212054886255546,-5.362251297326272,57286200,10.988878349954163,0.6716160160270005,-878589600.0,-16.26865101406853,85.04343053981948,79.70440250180728,-12.679041188149178,19.18513528380209,27.898780733555537,-0.09792257068948697,18.584819514825654,303.6702166748047,296.08989471435547,289.9633331298828,283.83677154541016,276.25644958496093,0.06,0.0,329.4338699990835,0.0004663032824236968,0.01663102795681218,301.1466631208147,299.70523507254467,13.966962199050498
2022-02-16,0,305.42332458496094,277.2850036621094,340.58583068847656,300.3972873687744,309.97395515441895,0.711862009105806,14.196642683942915,0.8598090758642432,2.9946695806350423,304.25208282470703,9.96106597900391,0.04632598567351484,293.5917510986328,325.0772529602051,0.5337134766972401,-0.10966888797463764,0.9966466631637784,1.0106380537432404,1.0151923495964987,-0.018265497613216497,44.84250675559614,334.84424323836924,306.4509578704834,278.0576725025976,301.96261705671037,6.9003002997155,301.084164755685,8.694358545901354,300.7649959488881,303.9735782126152,0.01649011656194784,-3.8250010519951285,51294300,11.494017426155175,0.6100026579092422,-827295300.0,-15.65230424700893,85.04343053981948,79.70440250180728,10.066954635712033,18.993417459462194,26.9410476154945,-0.032299870339121066,17.84320816626971,303.6702166748047,296.08989471435547,289.9633331298828,283.83677154541016,276.25644958496093,0.06,0.0,329.1453388561101,-0.009238182010181784,0.00150754183001597,301.91094970703125,301.95023454938615,12.502569543850793
2022-02-17,0,298.5175018310547,277.2850036621094,336.8050003051758,300.3972873687744,307.84104347229004,0.47759767428592426,11.842591916480856,1.6708008679820932,2.994980741385883,304.25208282470703,7.851315612792973,0.03886731373617896,293.5917510986328,316.1421669006348,0.357243253448685,-0.09317461347598821,0.9797326025615344,0.9875055752632346,0.9960006717374296,-0.019494001758868618,46.69538007689963,328.3780163982694,304.69283256530764,281.0076487323459,301.1720221383231,6.9379905283389425,302.6007717677525,5.482003080184031,301.95084581570995,303.3192696698587,-0.44898915519802823,3.919358313418404,55178400,11.521674699544981,0.6622218029709394,-882473700.0,-73.5758014756716,85.04343053981948,79.70440250180728,-57.42791511628862,17.713556675372317,28.83184821919405,-0.024082703435275424,17.74038436320784,308.28716833496094,303.5630961303711,299.74501037597656,295.92692462158203,291.2028524169922,0.06,0.0,328.7251008360717,-0.03117570291306826,-0.059710263091329256,299.7371390206473,302.6645202636719,10.853648689488343
2022-02-18,0,288.9550018310547,277.2850036621094,323.774169921875,299.0456237792969,306.9145793914795,-0.45400276153332525,9.323589522709701,1.503722218117785,2.995255601385303,303.6429138183594,6.539431762695313,0.030793437536253063,293.5917510986328,311.5246612548828,0.1628468032203251,-0.07800705070733287,0.954344652132056,0.9560952273311263,0.9679288829366741,-0.01946389758926681,44.653131619001506,321.425636687021,302.77845764160156,284.13127859618214,298.00761849539623,6.699443037692455,301.75547463553295,6.584377639554965,301.0130721994733,301.61337489252764,-1.820139483788535,7.6572832603737035,68501700,11.281976901699032,0.8397139282099184,-950975400.0,-82.41649012957504,85.04343053981948,79.70440250180728,-129.19685687260184,16.51577261935812,31.89126695198184,0.023091249010081975,17.64444121641182,307.25741955566406,301.8962993774414,297.56333923339844,293.2303790893555,287.8692589111328,0.02,1.0,328.0650905179309,-0.003511579771230955,-0.05258966054790145,296.16476004464283,300.76594979422435,11.004362708767086
2022-02-22,1,276.12416076660156,277.2850036621094,315.2941665649414,297.56083488464355,305.7677001953125,-0.968659539211609,8.450549404692335,1.0717211709698509,2.995334481679178,303.2091636657715,6.415665283203123,0.02807141776725201,290.5975059509277,309.74758071899413,0.22980221951775487,-0.04206932739368029,0.9172417438571655,0.917962404695998,0.9285167276544636,-0.050401834098218745,42.42335872775797,317.93859804644524,301.03749923706056,284.1364004276759,293.9607129778181,9.933129287399298,299.3645815168108,9.11065813001637,297.91036495943473,299.3251676454218,-7.120029120149629,-3.934370435720834,83288100,10.37511330645626,1.0655619573037534,-1034263500.0,-86.07078028598751,85.04343053981948,79.70440250180728,-181.47244347499313,15.255547972833458,34.44327980743405,-0.07870373468352249,17.715724710514195,304.3852963867188,297.24735424804686,291.47833251953125,285.70931079101564,278.5713686523437,0.04,0.0,327.07689296749265,-0.06192343738810857,-0.04473256114631692,292.21142578125,298.15356881277904,12.2602648274237
2022-02-23,1,265.8608283996582,276.12416076660156,315.2941665649414,294.49416732788086,305.7677001953125,-0.9582680106956232,10.039859071560732,0.3550721121062317,2.9951650231227234,303.2091636657715,7.86133163452148,0.03349282849760088,287.78800201416016,309.74758071899413,0.3051183381832186,-0.10132167406867347,0.8869079801172571,0.892948995809817,0.9029039868188479,-0.1232490851544783,35.38904485502417,319.8411752048891,299.7614570617676,279.6817389186461,289.8421407427107,14.504794152182512,296.6001764025007,12.611195294350859,292.451513152669,296.47917653283656,-9.304682562908221,-10.811648673242376,95256900,10.602461579828075,1.2119723507106128,-1129520400.0,-98.1411435900007,85.04343053981948,79.70440250180728,-217.8097223998028,13.74487440254996,36.40377558341379,-0.11296711859875067,18.237475525235322,301.1961526489258,292.08526565551756,284.72167205810547,277.3580784606934,268.2471914672852,0.06,0.0,325.7119614724097,-0.17170949625300047,-0.1275692622601636,287.6419023786272,294.7816641671317,15.569120918135326
2022-02-24,1,250.30333709716797,265.8608283996582,315.2941665649414,293.1231269836426,304.77770614624023,-1.0713877926843884,12.295090421645643,0.4823931080999113,2.9948659008405722,301.9866638183594,9.624194431304932,0.04130142072044725,277.1689193725586,309.74758071899413,0.41280818351946813,-0.15678481687069645,0.8408139410656229,0.851619807217511,0.8722095036032037,-0.1804707861218373,29.976828096131694,322.2818875007009,297.69170665740967,273.1015258141184,284.059759412493,20.779477797256877,293.10601016453336,17.61368692062616,285.7885687254801,292.5489024385009,-9.783136193950781,-12.707300340764801,135322200,10.510518545831639,1.6890080278374753,-1264842600.0,-59.32920828161007,85.04343053981948,79.70440250180728,-205.73779602626132,11.991454425214448,39.29840265480512,-0.014070637829472007,19.390471758677453,296.4320971069336,284.37395541381835,274.62833404541016,264.88271267700196,252.8245709838867,0.08,0.0,323.68613695225287,-0.1327932582190886,-0.13189070999201521,284.0709490094866,292.62999834333147,16.362879078654313
2022-02-25,1,268.41666412353516,250.30333709716797,311.10582733154297,290.3237552642822,304.4799995422363,-1.4315345376309165,15.407799240263301,1.3243243579001511,2.9943259985023376,300.0054130554199,11.788265094757076,0.05232877984929131,275.09782752990725,307.0804107666016,0.5829205097946815,-0.148350499746811,0.9116108216218951,0.9325392751380925,0.9726927243543401,-0.10083441514445957,26.699409137550916,325.25776366454767,294.442165184021,263.62656670349435,279.08583123343334,19.5558567270429,290.62261717660084,18.511532338476975,276.85780331335013,286.4318346004085,-13.920031783283429,-16.34852457122057,76067700,10.031559527871185,0.9934757349568997,-1188774900.0,-55.65645762245597,85.04343053981948,79.70440250180728,-123.54042915387622,13.596856838209181,37.43648877028682,0.1050479453978834,18.88235849640164,296.4320971069336,284.37395541381835,274.62833404541016,264.88271267700196,252.8245709838867,0.08,0.0,322.791751544691,-0.07586011356571543,-0.122938293640387,278.71095057896207,289.9288068498884,16.78068154703004
2022-02-28,0,281.4175109863281,250.30333709716797,311.10582733154297,286.03750228881836,304.4799995422363,-1.1484822642425077,16.420356530182975,0.2751764421782448,2.994127175316698,300.0054130554199,13.444952793121331,0.0560100975909475,268.16108055114745,307.0804107666016,0.7284367853254985,-0.031982759332274936,0.9599196110737638,0.9901028557872764,1.0425496517972999,-0.0260853447663576,40.81631490364461,326.00850309179907,293.1677900314331,260.3270769710672,275.6564292907715,15.93756978865635,288.80952317374096,18.042206823246556,274.7411754770512,284.08682189646476,-11.482049745093207,-11.467453031917925,99006900,10.412094590454878,1.3240086824845256,-1089768000.0,-30.795462550914515,85.04343053981948,79.70440250180728,-45.157350198242,19.673053272299356,34.27838725718223,0.10062639788562301,19.131540175863986,296.0500971069336,284.0649554138184,274.37833404541016,264.69171267700193,252.7065709838867,0.08,0.0,322.0114309454718,0.01569466269295039,-0.006755272287242928,276.18904767717635,289.04999869210377,16.588378675663844
2022-03-01,0,289.80916595458984,250.30333709716797,311.10582733154297,287.07062911987305,304.4799995422363,-1.1965908336167501,16.244251976486137,0.44743205329094815,2.9941625608241877,300.0054130554199,13.176339817047118,0.05537037697874382,268.16108055114745,307.0804107666016,0.8220294306531724,-0.06440275503102255,0.9878474425309999,1.0244108762282562,1.0796673390769111,0.04956105669998134,45.03512895819277,325.8629193506164,293.37441539764404,260.8859114446717,274.41238130841936,14.08826056400795,287.79220172337125,17.510355420663696,276.4782602579852,284.5185976176814,-7.85984948309179,-8.273548766495848,74766900,9.349325628803152,1.020086314586543,-1015001100.0,-33.25619984642697,85.04343053981948,79.70440250180728,-16.00949025433291,20.43816164557646,32.67854883677847,0.012722119685750351,18.618948650235524,296.0500971069336,284.0649554138184,274.37833404541016,264.69171267700193,252.7065709838867,0.02,1.0,321.5208511100824,0.052146602063143366,0.00862325085596325,275.61856951032365,287.6778542654855,16.054964387125604
2022-03-02,0,290.2308349609375,250.30333709716797,311.10582733154297,287.07062911987305,304.4799995422363,-1.116667221706175,16.16975412820268,0.35074099573279316,2.99417352527887,298.8695831298828,13.093664932250977,0.055219776925608206,268.16108055114745,307.0804107666016,0.8122321130772432,-0.06391379736159092,0.9911394963961259,1.0262535622145856,1.0703246351580065,0.0916645250373056,48.43969524670634,325.1649238676724,292.8254156112671,260.48590735486175,274.59464318411693,14.314198329330509,286.3011308397566,16.21314473886364,279.80397194356465,285.63680077819214,-2.917194410059517,-4.684236886571687,74643300,9.326754406696606,1.0173554058620877,-940357800.0,-26.217140423847717,85.04343053981948,79.70440250180728,-10.180024961164055,19.303703120316815,32.1152386320478,0.02992032106288172,18.290707289173078,295.4236115112305,283.5581908874512,273.9683303833008,264.3784698791504,252.5130492553711,0.02,0.0,321.05009754063116,0.1516281993549944,0.07103820691121591,276.7095206124442,286.43714032854353,15.508860657549453
2022-03-03,0,286.4250030517578,250.30333709716797,311.10582733154297,287.07062911987305,304.1518745422363,-1.0935784283967946,15.709748988504337,0.40344214391194555,2.9942526223507935,296.6041679382324,12.48166067123413,0.05382684775953173,268.16108055114745,305.5610748291016,0.8164181081265981,-0.04705656487276832,0.9813877385992662,1.017474486922026,1.0376382759770537,0.14431156361518016,49.317780503931864,323.2766221148872,291.85712413787843,260.4376261608697,276.06619208199635,15.010204530692073,285.0134525299072,15.353747621394389,282.39947016229326,286.6843697968787,0.44153349891785665,-6.709932934929939,61623600,9.283292544322114,0.8428718503403091,-1001981400.0,-38.484291426620246,85.04343053981948,79.70440250180728,-36.923642403600994,17.93613117192896,31.37562716214088,0.008763577569056996,18.26590156041533,290.99750360107424,279.9779098815918,271.07166290283203,262.16541592407225,251.14582220458985,0.02,0.0,320.60099763183035,0.04810368529558651,0.09848965064873222,277.55523681640625,284.8833312988281,15.545274950419257
2022-03-04,0,280.68333435058594,250.30333709716797,311.10582733154297,285.1731300354004,303.43853759765625,-0.9986134206316192,15.47184085614149,0.340919996124037,2.9942909665662576,292.7354202270508,12.117997932434083,0.05317692936807001,268.16108055114745,305.5610748291016,0.820046511928415,-0.04276649353376586,0.964712472441876,1.0038530412324793,0.9909041059159457,0.045700106836158216,47.92610821028886,321.8939310027493,290.95024929046633,260.00656757818336,278.1836929321289,14.362099000533037,284.01291683741977,15.12936921081306,283.4322041343771,287.3713376803562,3.7305110340790515,-5.92128373852449,66999600,9.249644115967852,0.9238944950314174,-1068981000.0,-38.92594248104545,85.04343053981948,79.70440250180728,-54.69181356231453,17.193275192711322,31.0867715981649,0.036349229335075624,17.682059289827592,290.99750360107424,279.9779098815918,271.07166290283203,262.16541592407225,251.14582220458985,0.02,0.0,320.06790435156887,0.0350920309203997,0.04685484918386051,281.0909511021205,284.36642674037387,15.668771067305332
2022-03-07,1,277.6324920654297,250.30333709716797,311.10582733154297,281.2339668273926,303.43853759765625,-0.8349874687289793,15.503817174239158,0.0978650557042049,2.9942799331512826,290.50542068481445,12.221498851776124,0.05345713748365566,268.16108055114745,305.5610748291016,0.8011500333789544,-0.0742150617699937,0.9572764004810286,0.9993157788544367,0.971717517259194,-0.013449834403099103,44.18374539898067,321.0309671350384,290.02333278656005,259.0156984380817,282.0878579275949,7.680184209328582,283.07380867004395,15.084992405156662,282.7910425268141,287.6147298251009,5.575287657136778,-4.753286521516222,72494100,9.247473919542434,1.0004415411338106,-1141475100.0,-53.813541418381995,85.04343053981948,79.70440250180728,-72.27286029076785,15.772658465023476,31.28134929573599,-0.04022794348106572,17.886661568764303,290.99750360107424,279.9779098815918,271.07166290283203,262.16541592407225,251.14582220458985,0.02,0.0,319.43858096654924,-0.07565230388022315,-0.006531923119532802,281.27237810407365,282.6716635567801,15.788477339118842
2022-03-08,1,271.0074920654297,250.30333709716797,311.10582733154297,279.9206237792969,303.43853759765625,-0.6567053690037841,15.419221675586405,-0.09816340193280926,2.9942877084684003,290.0200004577637,12.310266189575191,0.053400688058850315,268.16108055114745,305.5610748291016,0.7794802325371135,-0.09507254345970424,0.9385679024455028,0.9794613673524268,0.9510497554649232,-0.06487604982137174,41.96387474543246,319.5841924432749,288.7457490921021,257.90730574092925,282.4579762050084,6.938124527705183,280.77190371922086,14.205130145144283,281.49514884195537,286.6263773101555,10.918414147092461,-4.521464355696754,80399100,9.184928438113367,1.09487325985208,-1221874200.0,-45.06029489093063,85.04343053981948,79.70440250180728,-75.18069576448937,14.364704215103401,31.43732318383833,0.006731510969453503,18.2263563500718,290.99750360107424,279.9779098815918,271.07166290283203,262.16541592407225,251.14582220458985,0.02,0.0,318.72912951475234,-0.0462417747696936,-0.05288197625075244,281.9642813546317,280.3376159667969,15.65735639145503
2022-03-09,1,282.58499908447266,250.30333709716797,311.10582733154297,277.25540924072266,299.6966667175293,-0.4802361089517643,15.296486072572488,-0.3176035553593084,2.9942974942337743,289.38208389282227,12.473391819000245,0.053306017937031484,268.16108055114745,304.54958190917966,0.7616677310266771,-0.10867947083080527,0.9847674138011765,1.0231963346938724,1.004940214722345,-0.026343981946280515,38.95415207758782,317.5490544892001,286.9560823440552,256.36311019891025,282.62476021902904,6.922960353790847,279.14059475490023,12.346138576372677,278.8491740883731,284.2956475656868,0.9652261905401438,-10.62765130590355,59184000,9.252417073871882,0.8013531364396329,-1162690200.0,-27.24483863567561,85.04343053981948,79.70440250180728,-12.919137194884128,15.089543953307132,29.904553691961,0.017311570888244924,17.78232927470371,288.97799102783205,278.3443251037598,269.74999237060547,261.15565963745115,250.5219937133789,0.02,0.0,318.33780668486736,-0.02377568024123,-0.00624728252954463,281.41856602260043,278.8038068498884,14.872226935082805
2022-03-10,1,279.54666900634766,250.30333709716797,311.10582733154297,277.25540924072266,295.6475009918213,-0.39011974463244087,14.80448616607555,-0.17608054744493762,2.994380632084188,287.69000244140625,11.891392192840579,0.051785167935534594,268.16108055114745,304.54958190917966,0.7244910464947761,-0.09167564777459439,0.9778367879788757,1.006102497826297,0.9995709352147366,-0.024014433000345337,45.87352521336134,315.49172131744166,285.8827489852905,256.27377665313935,281.158689226423,6.196473338572845,277.78553526742115,11.026354974006031,279.7848095931877,283.57998812210354,0.414859791081462,-7.4775970471552,58648500,9.52965323448925,0.7906824087269303,-1221338700.0,-27.164558860152365,85.04343053981948,79.70440250180728,-37.67037040839021,14.094670528179291,30.86936896033721,0.03085268754254316,17.668808841798352,281.6894478149414,272.4486186828613,264.9800033569336,257.5113880310059,248.27055889892577,0.02,0.0,317.89991355341255,-0.0011796295195360962,-0.04726730341924586,280.17713710239957,277.8978533063616,13.678547445508572
2022-03-11,1,272.76000213623047,250.30333709716797,305.42332458496094,277.25540924072266,291.7577133178711,-0.4667083348455045,13.670404926992985,0.011410105511776347,2.9945662093640837,284.50500106811523,10.947042274475098,0.04808362488577878,268.16108055114745,303.35599517822266,0.7108011929725382,-0.08180530766944197,0.9593929145921527,0.9714525775554962,0.9801251379613515,-0.028228723421316104,45.085436676209966,311.64560092301673,284.3047910690308,256.96398121504484,278.66285596575057,5.400733313927783,276.62874957493375,10.605917826187698,279.7226576179114,282.272583127596,-3.5411222810841725,-6.35501526990653,67037100,9.460725799362418,0.9032209560099297,-1288375800.0,-49.78407629906801,85.04343053981948,79.70440250180728,-77.6541384897477,13.134816609889011,31.02536868306726,0.01822694551590978,17.5975126469482,281.6894478149414,272.4486186828613,264.9800033569336,257.5113880310059,248.27055889892577,0.02,0.0,317.3150492813302,-0.0512232915212395,-0.05235377759063889,276.1514238630022,276.4304722377232,13.633163082489238
2022-03-14,1,258.6433334350586,250.30333709716797,305.42332458496094,275.2831211090088,290.368127822876,-0.3866229088243564,13.066619109741831,0.0796325028774385,2.9946566700353165,282.0012550354004,10.358433818817138,0.04621749939197614,268.16108055114745,298.98916778564455,0.7179105217068605,-0.07441979653089675,0.9148386438280197,0.9197523666879801,0.934721416096163,-0.06839674452043576,42.62651540698277,308.8534044258435,282.72016620635986,256.5869279868762,274.6940460205078,8.218654698011655,275.3801190512521,11.647729714212764,278.0158231153767,280.4515829070854,-6.019633588229332,-5.604678788115619,71152200,9.34345729091341,0.964182506584255,-1359528000.0,-65.04634892103242,85.04343053981948,79.70440250180728,-135.75131011655813,12.327754707601953,34.31003034229105,0.03100814779190577,17.402792517199646,281.6894478149414,272.4486186828613,264.9800033569336,257.5113880310059,248.27055889892577,0.02,0.0,316.5526613486347,-0.047490606394353985,-0.08579368094009389,272.67904227120533,275.1171395438058,14.815813756335462
2022-03-15,1,261.60833740234375,250.30333709716797,305.42332458496094,272.3218746185303,289.91458320617676,-0.2367659825472258,13.7589181477925,-0.282080606448758,2.9945268600261192,281.05042266845703,10.819959831237792,0.048978450564492786,265.13907890319825,298.98916778564455,0.6749450374472575,-0.11051885365345479,0.9312629730830695,0.9378917637601549,0.9585935880394143,-0.03468226871313462,36.255715902103745,308.43562747142727,280.9177911758423,253.3999548802573,271.9690464564732,9.024619541765212,275.07636969430104,11.966164739057524,273.24174878153036,277.3644898121564,-9.699456863295902,-6.330785137747842,66841200,9.770113171756234,0.9063262716001171,-1292686800.0,-46.33980819157602,85.04343053981948,79.70440250180728,-97.31135363373589,12.166058556535255,31.987677927620794,0.07004916798963631,17.326005031799163,281.6894478149414,272.4486186828613,264.9800033569336,257.5113880310059,248.27055889892577,0.02,0.0,315.9084969247945,-0.02730468249390372,-0.003343362358373352,270.9457092285156,276.0183301653181,14.841922311555374
2022-03-16,1,274.4574966430664,250.30333709716797,305.42332458496094,270.35978507995605,289.1685428619385,-0.049910825875112516,14.176034308039249,-0.5118908096752088,2.9944432052820074,280.1150016784668,11.277622203826905,0.05072666749260399,261.31183700561525,298.98916778564455,0.6758569941074658,-0.1372728711883617,0.9821021782636306,0.9940069550907065,1.0126511651065726,-0.028761266407410058,36.19209395995702,307.81127634160345,279.4592077255249,251.10713910944634,271.51547568184986,8.768696503985687,276.8016668047224,9.633535334106242,270.4308558261099,275.2262161589053,-6.795913620014457,-1.5995176961240223,84028800,9.263662055381406,1.1190898844576131,-1208658000.0,-37.09656677314985,85.04343053981948,79.70440250180728,-11.518806453014571,16.595268768386795,30.186484331847826,0.08309339544479102,17.042065390343673,286.0979296875,279.5843817138672,274.32000732421875,269.0556329345703,262.54208496093753,0.02,0.0,315.3183968443878,-0.021816851258275927,0.01920186534817693,272.64332798549106,276.9578530447824,13.28641149986786
2022-03-17,1,283.6091613769531,250.30333709716797,305.42332458496094,270.35978507995605,287.05750274658203,-0.03350114210366991,13.11023044232751,-0.22550778014852613,2.994618712262579,278.5895805358887,10.338960075378418,0.047155646295463184,261.31183700561525,291.0595016479492,0.615190640801177,-0.10138658527135713,1.02010207668556,1.0330531561799248,1.0527313534296132,0.014532429898183485,45.104309019803786,304.2408353734856,278.02037448883056,251.79991360417554,273.31571415492465,9.871283323289182,277.88684517996654,9.470651761899541,271.41225839160217,274.8300329625846,-1.1435964856789995,9.649955060935433,66582900,9.818161041964558,0.8778099108833668,-1142075100.0,-13.658141173412508,85.04343053981948,79.70440250180728,65.67113479686317,20.087764902351527,28.09340841439841,0.09442916912299447,16.997910843032678,286.0979296875,279.5843817138672,274.32000732421875,269.0556329345703,262.54208496093753,0.02,0.0,314.9762451126946,0.03972327330037961,0.014703626840617963,274.8909476143973,278.4276144845145,11.710718192218552
2022-03-18,1,296.26000213623047,250.30333709716797,298.5175018310547,270.35978507995605,284.3131217956543,-0.4180422486653443,11.606211320032859,-0.24419776992517894,2.994848180107881,278.5895805358887,9.318534488677978,0.041910321396438056,261.31183700561525,289.8513328552246,0.5492510860776637,-0.049941260939999774,1.0698023294653998,1.0802421259157946,1.0963835158186042,0.08615632723254962,51.581502686151566,300.1420889684959,276.9296663284302,253.71724368836445,275.2692860194615,12.899993626267516,278.9470231192453,10.653218351420135,274.36616234769025,275.20687115056614,4.649933924513423,5.660042495135781,100414200,10.016727315965335,1.2855000355254795,-1041660900.0,-1.6204611107425666,85.04343053981948,79.70440250180728,151.91890780079993,23.617467994048493,26.470569153385945,0.1798938544116338,16.746061622953388,290.6742822265625,283.28619567871095,277.31500244140625,271.3438092041016,263.95572265625003,0.04,0.0,314.6818413038927,0.13835415500458548,0.08003105126418246,277.10142299107144,279.25999450683594,12.53673309526405
2022-03-21,1,307.17333984375,250.30333709716797,296.26000213623047,270.35978507995605,284.3131217956543,-0.5065178514914124,11.404944650491563,-0.2943230777208443,2.9948769655528182,278.5895805358887,9.216947002410887,0.04120033541004188,261.31183700561525,289.8513328552246,0.5171862971754955,0.025280753954371227,1.1096629592182905,1.1137095383257392,1.1173366148646515,0.18763292973440016,59.44355200201436,299.6266806446721,276.816791343689,254.00690204270583,279.2159532819475,17.743535823822253,280.1873212541853,12.808007869257715,279.72600954308234,277.41680171257696,4.839253002127677,5.274188908103669,81981600,10.218284188395904,1.04054802480284,-959679300.0,-11.610698160172477,85.04343053981948,79.70440250180728,194.80567174676835,27.419617605873235,25.02898223161862,0.176552672537331,16.440641189647,299.58760778808596,290.49618939208983,283.14833068847656,275.8004719848633,266.7090535888672,0.06,0.0,314.5879897374871,0.2019782090226936,0.1581819665690649,281.0471409388951,280.6121390206473,14.083105771271297
2022-03-22,1,320.2991638183594,250.30333709716797,307.17333984375,270.35978507995605,284.3131217956543,0.04509595726367862,12.959636840242176,0.047269884634546955,2.994643114624007,278.5895805358887,10.046293830871582,0.04666310366425979,261.31183700561525,290.8337516784668,0.5816147178808658,0.11244644072777558,1.153284869713412,1.1489931235711397,1.1253505984056498,0.22434616189525847,66.11066876962727,303.6469819248081,277.7277082443237,251.80843456383934,286.00726209368025,23.13833808615975,282.3350590297154,16.58566274529299,286.4982213668056,281.1780934621348,9.882668584677369,5.9915889243754785,105868500,9.974685821672734,1.3247478147826908,-853810800.0,-1.6045013873750205,85.04343053981948,79.70440250180728,232.3579496886052,32.16920995035035,22.34560478878353,0.24737776740923473,17.09484146375105,313.59682360839844,301.8282514038086,292.31666564941406,282.80507989501956,271.0365076904297,0.08,0.0,314.7485355366724,0.23954657139918045,0.29699751660652907,290.5057111467634,283.3285675048828,18.294696255996048
2022-03-23,1,333.0125045776367,250.30333709716797,320.2991638183594,270.35978507995605,287.2710437774658,0.560999068832383,15.923614007295713,0.46420480971486544,2.994128742482578,280.1150016784668,11.912793159484863,0.05688295872029003,261.31183700561525,297.35133590698246,0.6218515813553299,0.20476252837392858,1.1896003346069004,1.1738429806189983,1.1236762467847423,0.21334818196174643,72.32780907738822,311.783686411503,279.93645839691163,248.08923038232024,296.63142939976285,25.439122918071554,285.66273771013533,21.434232725075706,294.91315270967533,286.8813081982147,17.428934341474815,10.360142767555628,120676200,9.873164633010196,1.486399350240242,-733134600.0,-14.610391072304992,85.04343053981948,79.70440250180728,237.9335651413412,35.20995342598115,20.37360552697442,0.2748852583369931,17.405766519501388,324.50674267578125,310.6532906494141,299.4566650390625,288.26003942871097,274.4065874023438,0.1,0.0,315.14850914664123,0.1890911650514211,0.24594403990420124,301.5885707310268,287.13380650111606,20.50817420478499
2022-03-24,1,336.4116668701172,250.30333709716797,333.0125045776367,272.3218746185303,289.91458320617676,0.8436298880056289,19.319298122279395,0.6645251432386141,2.99344535884258,281.05042266845703,14.046683807373052,0.06819521502059722,261.31183700561525,308.485922241211,0.6324041749341024,0.3304357362537319,1.187499970880846,1.1651145009513748,1.0919945329432883,0.18618053534237822,78.58995267851772,321.9326384503693,283.29404220581057,244.65544596125181,307.31761932373047,23.942227630781122,289.6433328901018,25.269881348718624,304.4608740364498,293.6815305143068,28.753561963061806,16.265165760497666,68920800,9.083341204693724,0.8851108160775971,-664213800.0,-9.407714925097599,85.04343053981948,79.70440250180728,195.63678921186207,33.44564392413474,19.352719603518814,0.2206541902271282,17.011040763943896,324.50674267578125,310.6532906494141,299.4566650390625,288.26003942871097,274.4065874023438,0.1,0.0,315.383522966272,0.1632859239452633,0.20671721609422644,311.6852373395647,291.3154732840402,23.125189794260248
2022-03-25,1,336.4800033569336,258.6433334350586,336.4116668701172,274.0331230163574,291.73812675476074,1.0344465693548575,21.00841355546458,0.25823543498790036,2.9931243125391425,282.0012550354004,16.000046730041504,0.07304747251900655,267.735831451416,321.57049789428714,0.7529332690593064,0.2533188577117859,1.1699604890925948,1.1428435651884428,1.0560166748275122,0.13575913363495018,78.34972741402493,329.6162858053872,287.599458694458,245.58263158352884,316.1779774257115,21.057448973340936,293.8467265537807,27.878064013644412,312.5445982795633,300.14494803053475,28.59363360148906,19.854521341093978,62031600,8.484680121385756,0.8038820162831478,-602182200.0,-10.55995569343822,85.04343053981948,79.70440250180728,159.4665721752038,32.25189160567253,18.661976320248414,0.2025062662753052,16.377006124784792,324.50674267578125,310.6532906494141,299.4566650390625,288.26003942871097,274.4065874023438,0.1,0.0,315.5934335954057,0.11624828235604379,0.15952276612792426,319.8000008719308,296.22166442871094,24.997311386057486
2022-03-28,0,359.03499603271484,258.6433334350586,336.4800033569336,276.83874320983887,298.98833656311035,0.8442024190848513,23.0399283136022,-0.3889085139628641,2.992659775734987,283.0970802307129,18.362092666625973,0.07917429700729928,270.0675765991211,333.35242080688477,0.830353811605291,0.195661215883899,1.2337861049301302,1.193618238648844,1.0990575559390579,0.1688351476574932,77.53080157492012,337.08248228333235,291.0026256561279,244.92276902892348,326.95309666224887,20.911603026075777,300.13440540858676,31.95888592123289,318.6030523408413,305.06484346056686,22.598219204239054,21.19619027791434,102506100,8.215995028852394,1.3253953984880917,-499676100.0,-1.766911171555872,85.04343053981948,79.70440250180728,187.6886647554145,38.87288552163046,16.41360892268784,0.19947570921686605,17.2867837955515,339.0685808105469,322.43236914062504,308.9866638183594,295.54095849609377,278.9047468261719,0.12000000000000001,0.0,316.3123691137823,0.1852880339002323,0.2059333380724751,330.2876194545201,302.58928353445873,29.67215447935906
2022-03-29,0,366.2866668701172,258.6433334350586,359.03499603271484,276.83874320983887,310.45479583740234,0.8602664736238365,27.250753412058312,-0.33637558364078846,2.9915605204372375,285.01708221435547,22.448717727661137,0.09241193020470415,270.0675765991211,336.41850051879885,0.7972810495632322,0.23886694490874724,1.242140258725356,1.1783970885962685,1.0867503407016237,0.14357671903832125,82.28501646164781,349.38500673256385,294.8834999084473,240.3819930843307,336.956905909947,20.527628309934496,306.11309596470426,35.997359651750756,328.7142461666439,311.67202697542,26.59499230897942,32.48157580308981,73614900,9.257166191962007,0.9525439907642638,-426061200.0,-4.237156635755208,85.04343053981948,79.70440250180728,162.19754077389825,38.97029903381541,15.455985916457793,0.23248955544840572,17.043315804892913,343.3699045410156,325.91171215820316,311.8016662597656,297.69162036132815,280.23342797851564,0.14,0.0,316.87048827542645,0.10622956140751616,0.1936797049830622,339.53428867885043,308.31785583496094,33.50851786355007
2022-03-30,0,365.25917053222656,258.6433334350586,366.2866668701172,276.83874320983887,323.4774990081787,0.7901499990054985,31.33073108807291,-0.6021259475822398,2.990361311782212,285.01708221435547,26.77467166900634,0.10488770520940198,270.0675765991211,338.73550262451175,0.8326316184911663,0.2620528997872198,1.222799305133333,1.136807744598201,1.0549148544822462,0.09683319848751215,83.58887210550773,361.36883713036946,298.7073749542236,236.04591277807776,345.2548817225865,18.07513808709301,312.235417502267,38.34384147316564,338.09080326327444,317.884761388746,23.636894696870375,29.61999683522611,59865000,9.257689177127624,0.7821042936369516,-485926200.0,-5.7926574054791296,85.04343053981948,79.70440250180728,135.94369305581728,37.286075002028404,14.78800687701363,0.18818233613243002,16.537871442741604,343.3699045410156,325.91171215820316,311.8016662597656,297.69162036132815,280.23342797851564,0.14,0.0,317.31964820274965,0.0949644578100175,0.1006157183552745,347.76428658621654,314.4057137625558,36.43869253721926
2022-03-31,0,362.6624984741211,258.6433334350586,366.2866668701172,276.83874320983887,333.86229515075684,0.6291100632592583,34.42972655840544,-1.0034393521185405,2.9893820276272147,285.01708221435547,30.428717803955077,0.11383278482717381,270.0675765991211,359.657413482666,0.8709223006406275,0.2752349363376744,1.1990476335517497,1.0977043716391752,1.0282624132811802,0.07803187044086357,83.49951288859585,371.318244849599,302.4587917327881,233.59933861597716,351.3067866734096,15.188384220192889,318.6570243835449,38.75020189907074,344.8734833674453,322.8451251573585,18.90978908456805,30.661249454534776,48992700,9.154560202046524,0.6453884635167149,-534918900.0,-10.361540550362813,85.04343053981948,79.70440250180728,110.60990633298996,35.811322849316866,15.301621994786075,0.190318473887871,15.986370352324945,343.3699045410156,325.91171215820316,311.8016662597656,297.69162036132815,280.23342797851564,0.14,0.0,317.65249089138206,0.0628057980750738,0.07855990490560477,351.7461940220424,321.1259525844029,38.012694063480986
2022-04-01,0,360.5941619873047,258.6433334350586,366.2866668701172,276.83874320983887,336.4287509918213,0.43708813139782643,36.595708463046684,-1.3187355961479772,2.9886907576499615,289.9345817565918,33.01840118408203,0.11948812754674935,270.0675765991211,362.92216567993165,0.8930753511901859,0.2920699382213393,1.1773708729716224,1.0659383739700508,1.007401967896027,0.0716659486144593,82.32877628191717,379.46208342999955,306.2706665039062,233.0792495778129,355.2470234462193,13.083185222274366,325.93922642299106,36.09300996823617,349.3453513489769,326.70092690305404,13.226177099789693,32.96029316387403,54263100,9.00137595847578,0.7208635840283504,-589182000.0,-8.425459022481538,85.04343053981948,79.70440250180728,95.29300835183767,34.26321603081708,16.178015807597053,0.20809135517941282,15.512834906547964,343.4115977783203,325.9791986694336,311.88999938964844,297.8008001098633,280.3684010009766,0.14,0.0,318.00500851197785,0.07317143653289593,0.06969979349346393,355.81666782924106,328.70261928013394,39.24038324513648
2022-04-04,0,371.4391784667969,258.6433334350586,366.2866668701172,276.83874320983887,342.1187515258789,0.237887365028584,37.92226333855703,-1.5087302929819246,2.9883081656618256,301.71667098999023,34.76449615478515,0.12222492290401855,270.0675765991211,362.92216567993165,0.9046306639039313,0.29881830222639577,1.1971628524998188,1.0775053706980788,1.0239042354033367,0.03454867233318892,80.9729175051556,386.1107345628562,310.2662078857422,234.42168120862817,360.2509536743164,11.24839556062603,333.78428649902344,32.822743754930194,352.17053563309327,330.0394798817468,8.282468985556587,39.41753580045178,82035900,8.96164858913889,1.0829504402643249,-507146100.0,-1.2828970324694222,85.04343053981948,79.70440250180728,107.39836233898576,38.46872025366098,14.340250254887662,0.30252043121798877,16.24850837111111,355.9548785400391,339.03591217041014,325.36167907714844,311.68744598388673,294.7684796142578,0.16,0.0,318.6928968600956,0.04910067279321373,0.13339074855755345,362.0800040108817,336.8826206752232,40.824799226317424
2022-04-05,0,372.31082916259766,258.6433334350586,371.4391784667969,278.27437591552734,359.4247875213623,0.06955495374234856,39.36949919364404,-1.5668707012029912,2.9879132717169474,313.7362518310547,36.191458892822254,0.12499978224906269,270.0675765991211,365.36192016601564,0.885743850706895,0.3705863835569529,1.1821022245008919,1.0602675453021317,1.0193361426037406,0.01644657815135986,85.00289224291902,393.69554059309866,314.95654220581054,236.21754381852242,365.36964307512557,5.101210079604082,340.77381025041853,29.46445172644539,356.96214104885587,334.69435020307293,10.412097749928279,41.98292843226072,80075100,8.678497313070828,1.057292157681378,-427071000.0,-18.832350922145626,85.04343053981948,79.70440250180728,90.79317230131102,35.27948357368376,12.993315940514066,0.2430828277338245,16.649777517155457,358.55420422363284,342.63290155029296,329.76499938964844,316.8970972290039,300.97579455566404,0.18,0.0,319.30047106575546,-0.007557552777684551,-0.0005312010829626245,365.91904994419644,342.85952540806363,40.8034240107428
2022-04-06,0,352.1608352661133,258.6433334350586,372.31082916259766,281.8254165649414,361.1112461090088,-0.10076901863353806,39.90239733017017,-1.5478440446602737,2.987896231742118,326.65583419799805,36.355204048156736,0.12468653282082674,271.6448356628418,366.80191802978516,0.9063519786247317,0.31751802243155663,1.100427956277652,0.9882465493191324,0.9609982019060159,-0.03586038715202533,84.61513161046271,399.8265037210093,320.02170906066897,240.21691440032862,364.3876201084682,6.876631109437876,345.67035838535855,24.514048702063565,360.77025359698916,338.69114073884714,10.648723682891548,35.65336480744415,89348400,8.59889350665902,1.1566998393666634,-516419400.0,-37.519269912831206,85.04343053981948,79.70440250180728,49.69466485264439,32.12918380337236,20.206278381967923,0.1871801947171059,16.97435385542528,361.83224768066407,347.9388871459961,336.7100067138672,325.4811262817383,311.5877657470703,0.02,1.0,319.70315683840363,-0.04408630874073838,-0.04893733570786322,363.72476632254467,347.0061928885324,40.335864138466064
2022-04-07,0,350.6483383178711,258.6433334350586,372.31082916259766,282.59353828430176,361.1112461090088,-0.299107721758684,39.517972230546164,-1.450138630533492,2.9881497237882635,334.71208572387695,35.71470020294189,0.12215737572059292,271.6448356628418,366.80191802978516,0.9202977379451358,0.259756864633278,1.083918996648016,0.9787428757309896,0.9637604499608066,-0.03312766058470007,66.33152385691547,402.53644533084326,323.50050086975097,244.46455640865867,362.153573172433,8.504440585398001,349.55523954119,19.969797091119947,358.52803716001466,339.28295946246584,-1.914621371888549,24.171177530491036,79447200,10.125202741113945,1.0148564508727338,-595866600.0,-38.90063708455684,85.04343053981948,79.70440250180728,45.64639678303118,29.65891812830585,19.513049283647888,0.18978470131858216,17.072759530103735,364.9553153076172,352.9940220336914,343.32667541503906,333.6593287963867,321.69803552246094,0.04,0.0,320.056245255254,-0.018875274356586313,-0.03357430166550509,361.7100045340402,350.6221466064453,39.30383221422577
2022-04-08,0,344.9649963378906,258.6433334350586,372.31082916259766,293.09729194641113,361.1112461090088,-0.5070428608312552,38.59125286769873,-1.2318650571277656,2.988600887266487,336.4458351135254,34.16338378906251,0.11799600653854443,271.6448356628418,366.80191802978516,0.9045473258918796,0.28555629700698987,1.0547595358720465,0.9590681782421722,0.9544430682537337,-0.043342813880509534,66.4491706172692,404.2380900707246,327.0555843353271,249.87307859992967,359.254405430385,10.495390110928772,352.25464357648576,15.949768039903146,356.46238620813756,340.05091894640606,-4.269423368825855,18.35831222219158,55013700,9.900361524633881,0.7081819247337303,-650880300.0,-55.1142487839911,85.04343053981948,79.70440250180728,28.01427875562442,28.182916813026594,18.541965770649284,0.20457428477109224,16.681791752855048,366.1085665283203,354.8607252807617,345.77000427246094,336.6792832641602,325.4314420166016,0.04,0.0,320.24456290056594,-0.054490670963815435,-0.048357530747393476,358.4480983189174,353.106192452567,36.436535965578656
2022-04-11,1,328.2866668701172,258.6433334350586,372.31082916259766,304.4450054168701,361.1112461090088,-0.7190541917787943,36.67271103322531,-0.8442973859284062,2.9893886407439028,340.7224998474121,31.26100036621093,0.11090565536985314,273.17258071899414,366.80191802978516,0.8623240650680462,0.3337478749457352,0.9928049198606764,0.9105512755348392,0.916221703797582,-0.1161765212135184,64.58593435371026,404.01125611186075,330.6658340454102,257.3204119789596,354.3435723440988,15.489195393436336,352.82517950875416,14.821736559142751,353.5053754871886,340.5781542669884,-5.556102579098804,12.303039226439418,59357100,9.240813114894012,0.769939002441848,-710237400.0,-99.27622849810479,85.04343053981948,79.70440250180728,-15.191763867708096,26.137241334667785,24.01928063150639,0.19537720715593,16.700972512623522,370.2692476806641,361.5953871459961,354.5850067138672,347.5746262817383,338.9007657470703,0.06,0.0,320.3162813785588,-0.1479942762458688,-0.10018532720106123,353.6066676548549,352.67643083844865,31.728191870422453
2022-04-12,0,331.86499786376953,261.60833740234375,372.31082916259766,317.01770782470703,361.1112461090088,-0.7971085188675752,32.76710609606185,-0.5138311251954959,2.9907777340494692,340.7224998474121,26.847733306884766,0.0980616553914303,282.69399490356443,366.80191802978516,0.8234960384391972,0.25487845735292713,0.993167689621085,0.9283941117156379,0.9490687944847677,-0.1086345819964436,52.305318953595545,399.6822129092868,334.1480007171631,268.61378852503935,350.2394060407366,17.2617023884122,352.74321474347795,14.942411096036315,347.1739204916023,339.65567881872664,-9.478738978702784,2.4937633169368807,65976000,10.387279310519927,0.8562752571415,-644261400.0,-93.093195982837,85.04343053981948,79.70440250180728,-19.611485695510737,26.265193206945327,22.456823990546702,0.1356886250265935,16.58552917726891,370.2692476806641,361.5953871459961,354.5850067138672,347.5746262817383,338.9007657470703,0.06,0.0,320.42101182277645,-0.09558672454284667,-0.13837358645564685,348.9571446010045,352.3869062151228,27.427548082355617
2022-04-13,0,333.56583404541016,274.4574966430664,372.31082916259766,326.28979110717773,361.1112461090088,-0.7719053972346301,28.257808008984995,-0.3854247845937784,2.9921434673704077,340.7224998474121,22.875333404541017,0.08368695799265838,294.9949180603027,366.80191802978516,0.8071401288638029,0.2091671822517638,0.9878724468886003,0.9422253505739493,0.9765231817359373,-0.05280258154388928,52.552921395588086,394.17644975820434,337.66083374023435,281.14521772226436,344.8289282662528,15.33766051264022,352.5399409702846,15.198829491978175,343.36429706894387,339.3705232172483,-7.967173945690949,-0.3445836712115608,55121100,10.152172830379671,0.7290706697032542,-589140300.0,-72.59274952535385,85.04343053981948,79.70440250180728,-18.75926151864212,24.991282766429073,20.750114198588943,0.11880571965197058,16.666173736025204,370.14810034179686,361.3992927246094,354.3283386230469,347.25738452148437,338.5085769042969,0.08,0.0,320.5385408086315,-0.022366493184322045,-0.06312881890963432,343.09619140625,352.58809770856584,23.68303063284868
2022-04-14,0,331.5991744995117,283.6091613769531,372.31082916259766,330.97041511535645,361.1112461090088,-0.7005213898011501,24.30791197759695,-0.25856619476415643,2.993137014878947,340.7224998474121,19.919916534423827,0.0713645104543295,306.08200607299807,366.80191802978516,0.7736247247332965,0.17614618803536525,0.9735271699612624,0.9451313430084467,0.9814512584999209,-0.0543255499505344,52.22279719332798,389.23207456554553,340.6162506103516,292.00042665515764,339.01297760009766,9.953705447387149,352.1913103376116,15.644979363821287,340.95197456556554,339.38163083896023,-10.196378469745145,-0.8459376130393714,58422300,10.051206437904858,0.7769276725701936,-647562600.0,-93.38041768861582,85.04343053981948,79.70440250180728,-48.49426493328507,23.53483094314921,19.54083086806711,0.049593763159825915,16.43216225602073,370.14810034179686,361.3992927246094,354.3283386230469,347.25738452148437,338.5085769042969,0.08,0.0,320.62369900568655,-0.06834648715775649,-0.058101264803254775,338.03619384765625,351.97762189592635,20.686998132099117
2022-04-18,0,331.8041687011719,296.26000213623047,372.31082916259766,331.7985420227051,361.1112461090088,-0.44479928971916166,20.6565232613827,-0.5160260856288765,2.993899979196409,340.7224998474121,17.5204158782959,0.06022033444561913,318.98658142089846,366.80191802978516,0.7532692190772151,0.11928431819503968,0.9673146713411489,0.9541635357042876,0.9932581274669536,-0.03815119729953065,48.676402988073924,384.32879778924485,343.01575126647947,301.7027047437141,336.1048823765346,8.310226155469865,350.2462512425014,16.40305757770934,338.6152205250622,339.77552474123456,-10.934856435590305,-1.450555399645653,51715200,9.811255433644165,0.7107482824909421,-595847400.0,-82.65005337222851,85.04343053981948,79.70440250180728,-55.03438363483296,22.10177834735136,19.638906986684738,0.007978450207057453,16.24659490481579,370.14810034179686,361.3992927246094,354.3283386230469,347.25738452148437,338.5085769042969,0.08,0.0,320.7079590542787,-0.02067299730338623,-0.050101233112047276,336.0614318847656,349.8930991036551,18.34600156824913
2022-04-19,0,338.6233367919922,307.17333984375,372.31082916259766,331.8497905731201,361.1112461090088,-0.10364839878917706,17.90288968715526,-0.9340806015351202,2.9943805461021493,340.7224998474121,15.743207550048828,0.05192359411340218,327.48791656494143,366.80191802978516,0.7379541546850147,0.08018543819574593,0.9821062970369633,0.9819025584663361,1.0217219173569572,0.03148671866702579,46.6730350465725,380.5987389690371,344.79295959472654,308.987180220416,334.38702501569475,5.605539181175173,348.2702990940639,15.982970896901993,336.9165062035232,340.0776487448817,-5.780502692628702,-7.584449324561589,49847700,9.579841575382225,0.7005515991653706,-545999700.0,-69.37753110663853,85.04343053981948,79.70440250180728,-33.251392455744316,23.776623258561532,18.48240497296457,0.04345262653249686,16.029028889802643,370.14810034179686,361.3992927246094,354.3283386230469,347.25738452148437,338.5085769042969,0.08,0.0,320.83765658465046,0.05350796894263454,0.0025939451401359778,334.6752406529018,348.19262259347096,16.00248718060306
2022-04-20,0,334.7041702270508,320.2991638183594,372.31082916259766,332.7256278991699,361.1112461090088,0.22273944393550768,15.785503670974096,-1.3420757611327985,2.994696669913758,341.7941665649414,14.310754013061523,0.04557470510020965,331.26792373657224,366.80191802978516,0.760292762517072,0.05720955607622002,0.9663324130706632,0.9798621441517447,1.0036362781001134,0.008555202813062879,49.76471196765057,377.93646678408686,346.3654594421387,314.7944521001905,332.92119271414623,3.206734333352019,346.0877990722656,15.565374476820965,337.37225495960166,341.2869708884165,-3.4293621876450917,-7.552371565829949,70711200,9.268411968280233,1.0189364636674476,-616710900.0,-97.71930485728022,85.04343053981948,79.70440250180728,-75.64820790438417,21.73241922491144,19.831902879624774,-0.0715118308444316,16.283112981337652,370.14810034179686,361.3992927246094,354.3283386230469,347.25738452148437,338.5085769042969,0.08,0.0,320.9424199202228,-0.009878919782570272,0.001301342863505907,332.37571934291293,345.4119088309152,16.34016232181733
2022-04-21,0,347.6791763305664,328.2866668701172,372.31082916259766,333.4275016784668,361.1112461090088,0.36508135677898707,14.882542140132983,-1.4379970505434527,2.994817352698774,341.7941665649414,13.662528724670409,0.04287857932933484,331.78366928100587,366.80191802978516,0.7906309444552844,0.005079886269014493,1.0017098559557498,1.0291778424401277,1.0407707193753164,0.042310515180745245,43.770664143334265,376.8507940428392,347.08570976257323,317.32062548230726,335.6915512084961,5.835150923801078,345.01756177629744,14.836098349292758,336.74562114342,342.005229885793,-2.974454283700553,-8.365293131628555,105416400,8.89535167987251,1.5359192937327413,-511294500.0,-80.15240623192066,85.04343053981948,79.70440250180728,-17.49868192089693,26.164896299168742,16.78863586075566,-0.10347338775524895,17.859795425311784,370.14810034179686,361.3992927246094,354.3283386230469,347.25738452148437,338.5085769042969,0.02,1.0,321.26771234278823,-0.013292639648206594,0.022118665403354283,333.9400068010603,343.7733372279576,16.21120606862998
2022-04-22,0,337.40084075927734,328.2866668701172,372.31082916259766,334.4195861816406,361.1112461090088,0.28634814182094614,14.528149824446457,-1.3970528146114323,2.994863014771801,346.3220863342285,13.002528495788573,0.04176927658851052,331.78366928100587,366.80191802978516,0.7879213613104681,0.0334932184881668,0.9700470609929995,1.00007930295139,1.0015401103087747,0.017496021419601382,54.029420358007826,376.87534299911266,347.8190433502197,318.76274370132677,336.48238590785434,5.600522913645727,343.3608959742955,14.246154589904066,339.51745852867015,343.91128131115687,5.907187655635628,-4.13147822192701,69696600,9.329307273980072,1.014907416488303,-580991100.0,-82.22730254312557,85.04343053981948,79.70440250180728,-53.76891166143647,24.714360230406193,16.18632747501802,-0.1471643398258165,17.55650224688592,370.14810034179686,361.3992927246094,354.3283386230469,347.25738452148437,338.5085769042969,0.02,0.0,321.4130375155912,0.0203552859433469,-0.016941065766323957,334.8019104003906,341.8795275006975,16.311988816503412
2022-04-25,0,330.0758361816406,328.2866668701172,372.31082916259766,334.4195861816406,361.1112461090088,0.28413568583885146,14.49086700347713,-1.3902843308829642,2.9948676807675256,346.3220863342285,12.958015670776366,0.041656162941754435,331.78366928100587,366.80191802978516,0.7612600150543959,0.002736677939719757,0.9488523227643303,0.9822243360816477,0.9764334183278357,-0.005208893324929353,46.312996428268185,376.85023605163195,347.8685020446777,318.88676803772347,335.98381478445873,6.041422761653654,340.4063715253557,12.103025138963996,339.0110134524175,344.04061386026933,1.6681008636470527,-6.43197357944023,68341200,9.640813268292547,0.9906195024681342,-649332300.0,-86.13783683580095,85.04343053981948,79.70440250180728,-80.41738463574366,23.566719645906492,18.040812085461326,-0.13244153516343468,17.095498946518703,370.14810034179686,361.3992927246094,354.3283386230469,347.25738452148437,338.5085769042969,0.02,1.0,321.50146951654034,-0.006243205608264746,0.013218262548510168,333.6423863002232,338.3692888532366,16.47501440170461
2022-04-26,0,312.2375030517578,328.2866668701172,372.31082916259766,333.140625,361.1112461090088,0.2672351693540543,14.80630763989072,-1.4160615677942452,2.99482781700492,346.3220863342285,13.259291458129884,0.042602158919737065,331.4468406677246,366.80191802978516,0.8006442998530532,-0.08065832069594546,0.8984003337790333,0.9332768736955094,0.9246093577079519,-0.07792089579591654,37.06694015510065,377.16090896569455,347.5482936859131,317.9356784061317,333.2178617204939,10.878890184848846,336.11541966029574,10.459080746956962,336.82719777874473,343.2140713688951,-1.0462695838610434,-11.135966447021888,136133700,8.165377418082922,1.9263369144283495,-785466000.0,-99.34625068805735,85.04343053981948,79.70440250180728,-182.9509954514705,19.843887179668023,27.86641187978246,-0.27615815830597074,18.851645729969544,346.98535791015627,336.41398303222655,327.8699951171875,319.32600720214845,308.75463232421873,0.04,0.0,321.2258301522798,-0.1475757203383039,-0.12732374464710186,328.47191074916293,333.2540522984096,19.979904561299346
2022-04-27,0,297.9541702270508,312.2375030517578,372.31082916259766,331.8497905731201,361.1112461090088,0.11185426178769815,16.416367222198883,-0.9521198339479136,2.994602663990911,341.7941665649414,14.216508407592773,0.04755494454046255,329.8969192504883,366.80191802978516,0.7116920702312334,-0.14755973587628524,0.8631138575888322,0.8948768432600065,0.8963197570164818,-0.10979845269053612,27.392112829704658,378.041153481263,345.2084190368652,312.37568459246745,328.3821476527623,17.26239654037,332.24351501464844,13.61854891479572,330.73489520172797,339.41151911976135,-5.838878060229434,-16.13526156248447,76956300,8.653563564603731,1.0863887898937268,-862422300.0,-97.00302028726026,85.04343053981948,79.70440250180728,-193.88152468044595,18.78108249072897,26.373934476459755,-0.33277676537453327,18.49489824765476,346.98535791015627,336.41398303222655,327.8699951171875,319.32600720214845,308.75463232421873,0.04,0.0,320.9932757030295,-0.09792263737828644,-0.1426251142016039,322.625244140625,329.3433380126953,22.01240603701456
2022-04-28,1,291.5991668701172,297.9541702270508,372.31082916259766,331.75292015075684,354.26916694641113,-0.25498160733796765,18.63484270052721,-0.17082615439474536,2.994236955007295,338.01208877563477,15.159303703308103,0.054521035953736516,326.68175048828124,365.8771713256836,0.6938894830651693,-0.18426642158526588,0.8531485302291006,0.8848017207475435,0.8970363633216943,-0.16129815438566697,23.034648697894415,379.06147960576624,341.7917942047119,304.52210880365755,321.6644090924944,21.292219418620498,328.02571705409457,16.35004448228993,322.5682410514,333.7032563597291,-10.201800238563893,-15.392587593705807,124948500,9.006112231500264,1.6864200860104814,-987370800.0,-79.36936510085285,85.04343053981948,79.70440250180728,-203.30914448463497,16.941034460492922,30.754491538070635,-0.2688299133074797,19.038403615360963,342.79242553710935,329.6271179199219,318.9866638183594,308.34620971679686,295.1809020996094,0.06,0.0,320.4904426132113,-0.1301275265533598,-0.10201599643232902,315.45190865652904,325.0635746547154,23.535068485578666
2022-04-29,0,298.1175003051758,291.5991668701172,372.31082916259766,331.21833992004395,351.02646255493164,-0.42239192317256286,20.787543781727862,-0.04335417417095533,2.9938222334715268,336.05250549316406,15.81042049407959,0.061481819311684206,310.8091697692871,363.5401664733887,0.735075763730304,-0.195948938484123,0.8817206342350413,0.9162478343556106,0.9498619485160348,-0.11642929035298022,21.531087468283022,379.68388158506224,338.10879402160646,296.5337064581507,316.437741960798,22.03537627118879,324.6794673374721,17.378169850460925,314.859184602087,327.93102861934295,-13.88686626484954,-16.839997511759037,88133100,9.024423709984816,1.1589142592723358,-899237700.0,-81.86455936103967,85.04343053981948,79.70440250180728,-148.9793629350813,19.85358056587576,28.298739660472442,-0.2886121168340915,19.21193557250329,342.79242553710935,329.6271179199219,318.9866638183594,308.34620971679686,295.1809020996094,0.06,0.0,320.2370732085575,-0.13361525314757217,-0.13681877717685276,310.38333565848217,321.3795275006975,24.950996177047628
2022-05-02,1,293.1750030517578,291.5991668701172,372.31082916259766,329.62854385375977,348.4214668273926,-0.30603137818862464,21.714690719517495,-0.33836832835646025,2.9936120408007385,334.13500213623047,16.188779640197755,0.06484290072486026,298.1011672973633,361.67866363525394,0.7951288391353871,-0.17326032495314914,0.8754588247857924,0.9104259956156443,0.9580981539835779,-0.11179501522061219,27.50927598388357,378.3109255521942,334.8815441131592,291.45216267412417,308.65143149239674,18.502649493043435,322.17149135044644,19.25031549653481,310.7410227549343,323.4124620774873,-10.931046929309536,-13.580362219367926,75781500,9.307398376430383,0.9825941138098419,-975019200.0,-69.9689319074049,85.04343053981948,79.70440250180728,-138.01601087384756,18.41897681329472,28.9755395532843,-0.25096627751828676,19.22847109808422,342.79242553710935,329.6271179199219,318.9866638183594,308.34620971679686,295.1809020996094,0.06,0.0,320.00519631404563,-0.09526861657236374,-0.10159689177073858,305.3433358328683,319.6416713169643,24.91184979293224
2022-05-03,0,302.09166717529297,291.5991668701172,372.31082916259766,324.27437591552734,345.64354133605957,-0.20364206818495478,22.67331643217605,-0.5252341394785969,2.9933779825612907,332.71541595458984,16.912825660705572,0.06839394389896358,297.4762535095215,354.08866958618165,0.7654988375764193,-0.2107052243064207,0.911257980231365,0.9495059990878826,1.011636987611025,-0.032493969421677815,23.57449535193245,376.857219030734,331.5105861663818,286.16395330202965,303.60726383754184,13.493731958233393,320.0448248726981,19.735535566751768,306.38552142386686,319.1091316961989,-15.676571100417908,-10.69542791765311,63709500,8.692994446949578,0.835999406358343,-911309700.0,-67.63638824962771,85.04343053981948,79.70440250180728,-93.69216560288505,19.84346418419945,27.665653589928908,-0.29473667409326043,18.699789397398437,342.79242553710935,329.6271179199219,318.9866638183594,308.34620971679686,295.1809020996094,0.06,0.0,319.869138261362,0.03745919185562818,-0.08894610055554332,300.78143310546875,317.7916717529297,22.280541313179544
2022-05-04,0,308.1116638183594,291.5991668701172,372.31082916259766,309.7010440826416,340.2087516784668,-0.1935386543070926,21.57812782201796,-0.6766973885699543,2.993556064732175,331.8345832824707,17.308425292968742,0.06577830945634307,297.4762535095215,350.7995880126953,0.7599935496284282,-0.18860359808830107,0.939241093431313,0.9796764120903455,1.038855859512593,0.03409079182737473,31.293412262723535,371.1994662458426,328.04321060180666,284.88695495777074,300.4695249285017,7.563853426959592,318.2266698564802,19.56584691163319,305.28254932577545,316.3387592815487,-10.465052044483826,-8.971518804371923,81643800,9.111626744681177,1.0702327195577435,-829665900.0,-51.60430485988899,85.04343053981948,79.70440250180728,-53.71442217071365,22.031368933163478,25.23489138798828,-0.19916728553816043,19.03612604833691,342.79242553710935,329.6271179199219,318.9866638183594,308.34620971679686,295.1809020996094,0.06,0.0,319.7758729191389,0.08066841565196436,0.08694459034326685,298.6195286342076,316.1309574672154,20.423329182294566
2022-05-05,0,301.2999954223633,291.5991668701172,352.1608352661133,306.6066646575928,337.70646476745605,-0.4112111546424873,19.421482781522027,-1.1903528011745714,2.9939282762123542,331.7016716003418,17.054609184265143,0.0597890845285658,297.4762535095215,347.97609252929686,0.8347301587678804,-0.12508253910309983,0.927552808269792,0.9661874244568068,1.0089779792177682,0.033267682676771715,38.29462077815379,363.6762178976387,324.8332523345947,285.9902867715507,298.90702383858815,5.603358762490102,316.062442779541,19.648458293417082,305.93023256171216,315.0150619485987,-6.654280609379225,-7.630928479199571,92519100,8.476036621623738,1.2102770949299728,-922185000.0,-80.9330242317585,85.04343053981948,79.70440250180728,-90.54974553706752,19.533022892543958,25.66820538522561,-0.2205235571265341,19.936727974688136,342.79242553710935,329.6271179199219,318.9866638183594,308.34620971679686,295.1809020996094,0.06,0.0,319.52943140299936,-0.004820470520406905,-0.00933629954592852,298.4700012207031,313.470955984933,20.704434950639364
2022-05-06,0,290.3133316040039,291.5991668701172,350.6483383178711,301.89374923706055,335.3783378601074,-0.2788574987328668,19.00204727022409,-1.3785243373018539,2.993982977867688,330.8375053405762,17.373501281738278,0.05895943053943821,297.4762535095215,345.2364143371582,0.8091805238773441,-0.14073456937580683,0.9007823455002543,0.945010889506798,0.9659107573111447,-0.02617816362066272,35.27737256568044,360.29430488285544,322.29021034240725,284.28611580195906,297.8154754638672,6.493446026113471,313.0988115583147,20.212441188018534,304.746400284926,313.7017807913265,-3.502944880897758,-9.137290261014522,72903000,8.531930739616028,0.9577711257683038,-995088000.0,-83.75351969676458,85.04343053981948,79.70440250180728,-108.88978745360218,18.46649668895081,26.041314658748593,-0.23680670202003273,19.58136562070275,342.79242553710935,329.6271179199219,318.9866638183594,308.34620971679686,295.1809020996094,0.06,0.0,319.2627322807194,-0.005868455132209238,-0.013515533896610124,297.71476091657365,310.17000252859935,20.415240672454605
2022-05-09,0,270.8616714477539,290.3133316040039,347.6791763305664,300.5043716430664,333.8504180908203,-0.19914148661042375,19.04977389500497,-1.5205290786862204,2.9939436223755567,329.1812515258789,17.856113853454588,0.059666011370329314,293.0174194335938,339.257502746582,0.7865488280153156,-0.15842669637227721,0.8483688918022126,0.8954176363042512,0.9058969307346167,-0.07610925683205216,31.318526083277106,357.37300779672387,319.2734600067139,281.1739122167039,294.8529761178153,12.106604874634275,308.25869260515486,21.689338429660634,301.08236362721226,311.0924380230697,-2.5644341937635264,-12.504615978630238,90810300,8.713150060089527,1.1656217052138198,-1085898300.0,-98.08403532492729,85.04343053981948,79.70440250180728,-158.11786772793482,16.62620264921436,30.753462584014216,-0.25184974842294755,20.1947910674652,339.6024931640625,324.4637528076172,312.22833251953125,299.9929122314453,284.854171875,0.08,0.0,318.7214400989631,-0.1282809969426656,-0.09606550127478428,293.40999930245533,304.4309539794922,22.93017429138511
2022-05-10,0,268.24666595458984,270.8616714477539,347.6791763305664,298.07666778564453,332.2902069091797,-0.33587821442081317,20.81701083663175,-1.0461815013643858,2.99353717520024,320.2620849609375,18.99212646484375,0.0659667376226275,291.47058334350584,337.5230903625488,0.7772978665361764,-0.17492332530544963,0.8500431483675104,0.9044781595199161,0.9107442561863945,-0.11203553390654797,26.23902268336253,357.2023154354705,315.568293762207,273.93427208894354,290.5857140677316,15.54129570985221,303.5117280142648,22.70493641711429,293.49048279172405,306.0001785247819,-7.111644263236213,-20.010926000018294,84401700,8.962794031453038,1.0662244703440817,-1170300000.0,-91.88918769507181,85.04343053981948,79.70440250180728,-142.7852877550488,15.612723092899724,29.701761539636774,-0.2127426399337279,19.96914464781269,339.05969604492185,323.5851574707031,311.0783386230469,298.57151977539064,283.09698120117184,0.1,0.0,318.21309925099223,-0.12011003445121471,-0.11396111721221559,290.0423801967076,300.2128579275949,24.95192961525245
2022-05-11,0,255.49750137329102,268.24666595458984,347.6791763305664,296.75937843322754,332.2902069091797,-0.300423565614438,22.98292644747692,-1.0506356482960422,2.9930040934586453,310.1745834350586,20.422089195251466,0.07352976603525813,288.36816558837893,337.5230903625488,0.8092365216754205,-0.19169943295826272,0.8174185973011084,0.8744611255476769,0.8878634389313301,-0.1707632933886135,24.755075380594803,358.53214661138446,312.56629371643066,266.60044082147687,285.2032138279506,20.293144675297164,296.9273226601737,22.273345134396884,287.15769239232804,301.683628960439,-10.019819138429604,-19.855594935485463,97224600,8.828422293092288,1.2044398393297278,-1267524600.0,-97.78968556633386,85.04343053981948,79.70440250180728,-164.27232498789854,14.115707751258377,32.31750748485031,-0.23703283402266284,20.50887489139786,320.7482078857422,305.77590521240234,293.6750030517578,281.5741008911133,266.6017982177735,0.12000000000000001,0.0,317.48075625434745,-0.229493401873745,-0.19274128059036785,281.99761744907926,293.6704766409738,28.486603769873703
2022-05-12,1,239.05500411987305,255.49750137329102,347.6791763305664,292.78104400634766,332.24458503723145,-0.33830307525592296,25.648689550861462,-0.8687127371701919,2.99224043215494,305.1016654968262,21.895877056121826,0.08307323865668263,270.6001708984375,337.5230903625488,0.798394891379616,-0.2340417533933984,0.7742724387514549,0.8302498103812788,0.8622554427804601,-0.2065880924267357,21.128933501134252,360.0452979936297,308.74791889190675,257.4505397901838,276.1979762486049,24.99215743870935,289.9026200430734,23.970453086243364,279.2512806955308,295.75881529175666,-12.851539621819368,-26.513429975924385,140313000,8.9817700594698,1.6511017965276769,-1407837600.0,-85.3934626796937,85.04343053981948,79.70440250180728,-174.4172074141042,12.836886796834898,34.75763456075546,-0.23592560626530604,20.940728959888304,310.35522662353515,294.36238760375977,281.4366683959961,268.5109491882324,252.51811016845704,0.14,0.0,316.27086220133083,-0.16636125673661373,-0.23579182080106287,273.36666434151783,287.0740487234933,30.55404060955323
2022-05-13,0,256.8325004577637,239.05500411987305,347.6791763305664,291.27770805358887,331.65042304992676,-0.4569806153966766,29.113282296680467,-0.5560067764423273,2.9910618365561383,301.6958312988281,23.603447380065916,0.09576032707222344,266.97174949645995,337.5230903625488,0.7905435496502274,-0.27908444138715716,0.8447815672579353,0.9085723283803766,0.9699301746382304,-0.11532653688776884,17.910853402814613,362.24894198899085,304.02237739562986,245.79581280226887,268.8723814828055,21.32500655820237,284.6709532056536,22.474147299609985,269.2284173891287,288.1020869159005,-20.866733480219434,-29.148071006014565,92150700,9.373176538426314,1.063262728724508,-1315686900.0,-72.00313224777545,85.04343053981948,79.70440250180728,-117.55777192291232,15.128565736593277,32.4023220244584,-0.2034503873112146,20.858039272166895,308.160008972168,292.58667489624025,280.00000762939453,267.4133403625488,251.84000628662108,0.14,0.0,315.6574498112762,-0.11096860290510857,-0.11873623086789119,264.6509486607143,281.63523864746094,31.391817266597513
2022-05-16,0,248.3650016784668,239.05500411987305,347.6791763305664,285.4504165649414,330.50791931152344,-0.2693239302899027,30.115250365274413,-0.825514540704833,2.9906387025674146,299.70874786376953,24.118792152404787,0.10028921282280585,256.6990005493164,337.5230903625488,0.8534177487683178,-0.22595155611480242,0.8271002302471253,0.8916400601112975,0.9622870313809788,-0.08305593644550202,30.560613923826768,360.51454442409124,300.28404369354246,240.05354296299365,261.31023951939176,16.818818682985782,280.10863167899,22.92619498920369,266.2047635284075,283.97207486068083,-16.643045162622027,-22.189850844934668,86098500,10.613298042435028,0.9741079629112962,-1401785400.0,-83.89474326102882,85.04343053981948,79.70440250180728,-129.8955670799683,14.241282791867565,34.26143447983099,-0.25231963325543016,20.574547110257768,296.8273345336914,283.4196686096191,272.58333587646484,261.74700314331056,248.33933721923827,0.14,0.0,314.995033422155,-0.07970930543633259,-0.16320680903197668,257.55999755859375,278.01499938964844,32.47752188269496
2022-05-17,0,250.1916618347168,239.05500411987305,347.6791763305664,270.2079200744629,316.6970863342285,-0.11990597092975315,31.21900863645231,-0.9581538514797332,2.9901295263212018,298.0358352661133,25.106292152404784,0.10542970105510019,254.78425140380858,337.5230903625488,0.8320326609169634,-0.26654493446495336,0.844922156910311,0.9128833647044138,0.9865627688420967,-0.06730746887616301,27.26367895376369,358.5501026153119,296.1120853424072,233.67406806950254,255.57857240949357,11.178217922950076,276.6970239366804,23.609890873967124,261.83938193736464,279.4234524595185,-17.568866428189633,-20.45638360190936,80236200,10.34270556165882,0.8924410257796312,-1321549200.0,-70.37750467774681,85.04343053981948,79.70440250180728,-104.03796113053141,13.563155213458156,32.63000675409915,-0.22883966952335877,20.059833847287177,296.8273345336914,283.4196686096191,272.58333587646484,261.74700314331056,248.33933721923827,0.14,0.0,314.4296173322762,-0.048035090409529246,-0.03239699721076519,252.605712890625,275.16023690359935,31.352702501947565
2022-05-18,0,242.97000122070312,239.05500411987305,347.6791763305664,265.3931245803833,309.143123626709,0.020649046207942025,31.14723161324777,-0.9861438077086349,2.9900134511336836,295.5645866394043,25.425200901031495,0.10678178220744103,250.0089958190918,334.9738372802734,0.8448298645492399,-0.25249911984963874,0.8329719339248045,0.9036457175759639,0.9719253592244504,-0.049031791251393786,28.758427617000642,353.984964821039,291.69050159454343,229.3960383680479,251.59404809134347,9.695215731773809,273.22351210457936,24.79620710303416,258.9863225695782,275.8612805857529,-13.820126532809134,-16.030152676143917,87811800,10.446075107033947,0.9675008036173939,-1409361000.0,-89.17967914669524,85.04343053981948,79.70440250180728,-112.37155644586917,12.584909266394076,33.60286186545059,-0.22410248953965287,20.074610059313052,296.8273345336914,283.4196686096191,272.58333587646484,261.74700314331056,248.33933721923827,0.14,0.0,313.73350481685014,-0.032956426699346286,-0.11278183959160366,248.92476109095983,271.1673801967076,32.0918865686794
2022-05-19,1,237.0441665649414,239.05500411987305,347.6791763305664,256.4987506866455,303.59666633605957,0.14377363633137352,31.22959679748683,-0.9364960076850832,2.9898236500944773,292.3870849609375,26.481033706665038,0.10877458794770677,247.82550163269042,330.80833663940433,0.7962095384467204,-0.3011660813712579,0.8256392713204688,0.9034957872826556,0.957820640993746,-0.008411610383706192,24.539549635542443,349.5629867391997,287.1037931442261,224.64459954925246,247.13654817853654,7.738297411124875,268.86113112313404,25.443578262831092,254.9979234535946,271.72493156484313,-10.297385406347816,-16.67671625107017,90296700,9.613454075412118,1.0032354693030392,-1499657700.0,-89.32124527012128,85.04343053981948,79.70440250180728,-108.18088983826195,11.974674969115949,32.78791781771523,-0.19419173855318247,19.59038888923461,296.8273345336914,283.4196686096191,272.58333587646484,261.74700314331056,248.33933721923827,0.14,0.0,312.9952217803035,-0.025522021921974836,-0.033487781795163235,244.6095232282366,267.3259517124721,31.27590377515904
2022-05-20,1,227.70583724975586,237.0441665649414,337.40084075927734,254.17104148864746,301.4979133605957,0.07100427527120932,29.774433847233315,-1.1151567462107492,2.990136089850911,290.95624923706055,26.50842092514038,0.10574357299959265,242.57850151062013,314.0213363647461,0.7923879847811888,-0.29744049827645985,0.808694766362126,0.8896922657683564,0.9215850054653248,-0.11340723294791,23.69297756070532,341.1209103504115,281.5720426559448,222.0231749614781,243.16631044660295,9.631501754439485,264.1847621372768,26.620292493588607,250.4626675554182,267.02349109405685,-11.632017597911377,-20.48632961087996,144973200,9.548764315133987,1.5460621875043992,-1644630900.0,-90.41860181231831,85.04343053981948,79.70440250180728,-127.2975242189676,10.730394474344424,36.549491522594664,-0.19270957348931816,20.300236499628756,293.13,277.435,264.75,252.065,236.37,0.16,0.0,311.63681235019214,-0.13733284955046854,-0.08804945708789497,241.27142769949776,261.6345225742885,30.88074420282288
2022-05-23,1,220.66166305541992,227.70583724975586,330.0758361816406,249.7349967956543,298.91312408447266,-0.02282316252914073,29.080407421421075,-1.2511846676298184,2.9901625886618017,280.5875015258789,26.410291290283205,0.10533048138562302,238.8539203643799,308.52424774169924,0.7767583112389798,-0.3101408455587479,0.7992459959779937,0.8837885027597561,0.914639521797783,-0.11154284394268887,21.89371585467864,334.2481073233109,276.08729248046876,217.92647763762665,240.5386902945382,12.895868570457946,258.36833327157154,26.596724088916513,244.6925848694693,262.0742074337588,-10.877470023838134,-22.33108727569242,88903500,9.581962162782022,0.9378260076340673,-1733534400.0,-87.00775856195494,85.04343053981948,79.70440250180728,-123.87159417164357,10.190966891840352,34.712112300337246,-0.16816543029356568,19.847772307851365,293.13,277.435,264.75,252.065,236.37,0.16,0.0,310.7977470431603,-0.06829385095042351,-0.1230395641195697,238.74285452706474,256.05475943429127,29.3273773770035
2022-05-24,1,213.0150032043457,220.66166305541992,312.2375030517578,247.01625156402588,297.99500274658203,-0.13801019030370917,28.698489854051207,-1.4114161629192008,2.990064348634649,269.5541687011719,25.959583473205566,0.106048526104738,236.11033363342284,302.69366683959964,0.810126007022521,-0.29328904792438687,0.7871468931954274,0.8706679265207328,0.903698555684287,-0.1485927163109495,21.275664264619046,328.01356353226015,270.6165838241577,213.2196041160553,234.27904782976424,14.233784879733397,251.57571465628487,25.011666180415126,238.5835572693784,256.2040754988501,-7.694187842740103,-26.955395652347516,89092500,9.136576332013382,0.9637312845558796,-1822626900.0,-97.66483216623763,85.04343053981948,79.70440250180728,-134.03494727789538,9.522502442490342,34.54681578315116,-0.12674104591157087,19.723627616476705,289.63098443603513,273.8128570861816,261.0283432006836,248.24382931518554,232.425701965332,0.18,0.0,309.87977808761974,-0.17522087288425314,-0.13281883132213995,232.00809369768416,248.32952117919922,31.482675205694754
2022-05-25,1,214.58166885375977,213.0150032043457,308.1116638183594,241.9912519454956,294.36979484558105,-0.12406539898438915,29.635664617832862,-1.335960938909623,2.9894587475590857,262.53958320617676,26.521624755859374,0.11155676886202497,227.00141983032228,301.37916259765626,0.8378601063863823,-0.2850746037821141,0.8077442481226511,0.8973287685657548,0.9399960340267577,-0.11683883699352937,20.31871853463189,324.9267880674528,265.6554588317871,206.38412959612143,229.45285742623466,14.388257006055886,245.3815484728132,22.34604144565797,232.1493655755031,250.56353581452726,-17.060729142659184,-30.864349448995824,92139300,8.891680811770632,0.9885711021004613,-1730487600.0,-85.70467077147129,85.04343053981948,79.70440250180728,-108.88719269358714,10.870284845319933,32.58481763419227,-0.06588489650256257,19.41737772881079,274.96217510986327,261.9472495422363,251.42833709716797,240.9094246520996,227.8944990844726,0.18,0.0,308.9990485573227,-0.07186427272579543,-0.1349903087123499,228.8857138497489,243.2228557041713,32.117438645132296
2022-05-26,1,228.45666885375977,213.0150032043457,308.1116638183594,238.55229473114014,291.99312591552734,0.00841467242003609,30.645741068276152,-1.327482661604482,2.9888400619681494,256.16500091552734,27.043516178131103,0.11719802724766526,220.0536636352539,301.37916259765626,0.8682118947680331,-0.2641211181877698,0.8736832580286457,0.9719812844408692,1.0263025929965328,-0.03622741633183779,22.14300486459738,322.77831589967485,261.48683376312255,200.19535162657024,226.34785842895508,11.147039143503608,240.96321541922433,18.575781306564064,227.7825498459673,246.0105951729523,-13.602292028424728,-28.781389938968136,106003200,8.97883688102493,1.148995753830105,-1624484400.0,-61.27255690061511,85.04343053981948,79.70440250180728,-67.45891377497925,16.0130329418868,30.008362222220484,-0.05726374431622034,19.578298246940125,264.1719574584961,253.21903683471677,244.3666763305664,235.514315826416,224.5613952026367,0.02,1.0,308.1604457667283,-0.0023821882164859476,-0.0029303427387890667,226.32000078473772,239.46285683768136,31.59449779177593
2022-05-27,0,246.93416595458984,213.0150032043457,308.1116638183594,234.897292137146,291.0287494659424,0.20853419793411854,30.633412598405002,-1.2817657922514856,2.9887313694154543,252.8445816040039,26.55798278808594,0.11858261573287829,220.0536636352539,301.37916259765626,0.8809294917833527,-0.23366904452139134,0.9558876020961687,1.0553535124853697,1.1179351056182318,0.08444372325749239,32.54701405802861,319.59653405911473,258.3297088623047,197.06288366549467,226.9141676766532,12.184651365572964,239.25410788399833,16.61004182463399,228.04078587837338,244.1037506525763,-8.687337068537376,-21.306862626143012,89295000,9.565812195625066,0.9672822034860831,-1535189400.0,-32.09628261139256,85.04343053981948,79.70440250180728,-17.87729973028551,20.033959699609454,28.092395141429325,0.03732591642985361,19.419592271410995,259.00985137939455,249.0434065246582,240.98833465576172,232.9332627868652,222.9668179321289,0.04,0.0,307.62761554681714,0.14419341718059653,0.07077618116348453,228.6923828125,238.8085719517299,30.625708759697176
2022-05-31,0,253.7608299255371,213.0150032043457,308.1116638183594,234.897292137146,275.7245864868164,0.3726277133880071,29.312047619520147,-1.0346110346103927,2.9892315742192945,249.2783317565918,24.476816177368164,0.11460290686223149,220.0536636352539,301.37916259765626,0.8897761275427074,-0.1577243510389066,0.9921425188280646,1.0891369404792948,1.1291817620582614,0.14999962572476488,45.077887158275395,314.3946373838156,255.7705421447754,197.14644690573516,229.30226244245256,15.647149865919172,238.21940531049455,15.04225686704576,232.82077571004294,244.6767147242793,1.6315449289913977,-8.833846946772386,101914500,10.75674608047054,1.0885742085955112,-1433274900.0,-27.225180292838136,85.04343053981948,79.70440250180728,-2.671732658337348,21.289915265609075,26.530909343900195,0.005340664073198642,19.093636265877432,255.03960675048828,245.83187356567382,238.39000701904297,230.9481404724121,221.74040728759763,0.06,0.0,307.06642157258335,0.1235145995686886,0.14212979182337135,231.0180969238281,237.81381007603235,28.68044948352562
2022-06-01,0,249.8691635131836,213.0150032043457,308.1116638183594,234.897292137146,268.90041732788086,0.5186552193221448,28.027838043881772,-0.6912953758712299,2.989723851295565,249.2783317565918,22.28563293457031,0.11043284646266598,220.0536636352539,301.37916259765626,0.8532835600156229,-0.15998732338986102,0.9845127164929389,1.0699560881666188,1.0800498067113942,0.17301204025278727,47.63131626549553,309.8555095762278,253.79983348846434,197.74415740070086,232.46845190865653,17.412999692113402,237.81738117762976,14.614073634376263,238.13631576786867,246.23159508443595,7.052130243422781,-5.400192385431165,77247900,10.650272285862675,0.8191811306438541,-1510522800.0,-28.168876848737344,85.04343053981948,79.70440250180728,-4.707456013295065,20.177232271515443,25.56562879560526,-0.02235248473305894,18.70738710483585,249.32998443603515,241.21335708618165,234.6533432006836,228.09332931518554,219.976701965332,0.06,0.0,306.62480933868716,0.17863276483317558,0.09700696887390066,234.65952410016737,237.9654758998326,26.15068621560736
2022-06-02,0,252.19166564941406,213.0150032043457,308.1116638183594,234.897292137146,259.6860418319702,0.6442502214090762,25.74702272056192,-0.17720920795592887,2.9905704409602696,249.1170825958252,19.541449356079102,0.1025007170675141,220.0536636352539,291.41199798583983,0.7926206500858448,-0.1890304949296285,1.0039928440685952,1.0800503446117051,1.056430705624228,0.1752712475234126,44.87419605554921,302.6827537464827,251.1887083053589,199.69466286423503,236.97273799351282,17.92047290561048,238.75571414402552,15.11287456093616,241.12967669797843,246.71094753745245,9.73331493435463,-2.20289350379369,93473100,10.459059698799262,0.9850639248084027,-1417049700.0,-10.246395901569338,85.04343053981948,79.70440250180728,29.505594322450495,21.087625278179463,23.431918755596207,-0.03859395515226203,18.95283290928185,250.67460858154297,242.3010242614746,235.53333282470703,228.76564138793944,220.39205706787106,0.08,0.0,306.1508276821016,0.17638131295900594,0.2337621102484885,239.4261932373047,239.0845238821847,20.951244063924143
2022-06-03,0,239.73916625976562,213.0150032043457,301.2999954223633,234.897292137146,255.83125114440918,0.5417134927419514,22.206546702268742,0.11982600757176032,2.991784845666992,249.1170825958252,16.513790321350093,0.08940096046130494,220.0536636352539,272.80683746337894,0.7450173432992507,-0.1629881530668761,0.965161851195252,1.022681664213725,0.9735897233346381,0.04938572142635955,47.15138238369298,292.8058018014491,248.39270839691162,203.97961499237414,240.79047557285853,14.48283076908262,237.5347617013114,14.203232389191495,243.83615552719652,247.12579889107315,14.28884481219344,5.49524640904555,112393800,10.485705353071818,1.1721836122507245,-1529443500.0,-51.77264415662085,85.04343053981948,79.70440250180728,-29.807888868243488,19.15077058663979,24.468309534846792,-0.056693939664504416,19.378856230127752,250.67460858154297,242.3010242614746,235.53333282470703,228.76564138793944,220.39205706787106,0.08,0.0,305.4148055234733,-0.005906239849195916,0.06792648487955508,243.01619175502233,237.51214272635323,18.36739900709626
2022-06-06,0,240.4625015258789,213.0150032043457,290.3133316040039,234.897292137146,254.1949977874756,0.2674987664489643,18.639783147299976,0.0540490134779219,2.9928569081005305,247.64958381652832,14.460282306671143,0.07598315820207983,220.0536636352539,268.50816650390624,0.6901419444964576,-0.17420545265631465,0.9802206469207417,1.0245893704152587,0.9676598425310569,-0.026208055915199036,42.17169978740638,282.59423323338166,245.31466693878173,208.03510064418177,244.48773738316126,8.907226706390894,236.97029740469796,13.89335872678682,242.75405221625448,245.60629670157937,12.545671738334496,-6.655440478729077,84204600,10.552420148128823,0.8730460764295569,-1445238900.0,-45.21097281591779,85.04343053981948,79.70440250180728,-17.698966379620565,18.383293737109316,23.487729613522824,-0.06754891251891199,18.7457943366989,250.67460858154297,242.3010242614746,235.53333282470703,228.76564138793944,220.39205706787106,0.08,0.0,304.87857064409303,-0.05896294592907436,0.010046183207143856,245.68476213727678,237.28523799351282,15.156854735029377
2022-06-07,0,235.74417114257812,213.0150032043457,270.8616714477539,234.897292137146,252.58395671844482,-0.26978402869097845,15.529389460204987,-0.5138816106350008,2.9936719296431904,244.95208358764648,12.467744922637939,0.06395376629041963,220.0536636352539,257.9739170074463,0.7238083878950178,-0.11223134583564973,0.9708512793897125,0.999054620769237,0.9536396523309788,-0.07099858078272259,45.13534476393593,273.88090435528545,242.8221254348755,211.7633465144655,245.52880913870675,6.927001578388634,235.93833378383093,13.362174053468934,242.11103256125716,244.00443840419885,12.061064120885959,-3.1818090709972346,72808500,9.797569131982128,0.7620007783431589,-1518047400.0,-44.15318884925053,85.04343053981948,79.70440250180728,-26.965901764710765,17.665351424562523,24.249066543808794,0.00010951444177556521,18.114145609295186,250.67460858154297,242.3010242614746,235.53333282470703,228.76564138793944,220.39205706787106,0.08,0.0,304.4021199463751,-0.054862397417311026,-0.05656701299494871,246.11000061035156,236.21500069754464,14.370139600416612
2022-06-08,0,242.77333450317383,213.0150032043457,268.24666595458984,233.92229557037354,250.6916627883911,-0.37286661991032016,14.18706822269111,-0.46738307824413017,2.993985269777425,241.71625137329102,11.419665336608887,0.05885132488681477,220.0536636352539,255.6310012817383,0.6702218676180922,-0.1211664446838415,1.0070813897863582,1.0223089708369897,0.9966010074629227,-0.02839817811146339,42.83583455773337,269.4403868649989,241.0662504196167,212.69211397423447,244.93440464564733,6.964726615590947,235.92428616115026,13.354314099393518,240.49954209903038,241.84146945026194,3.1898838083309586,-5.774569218730824,76210500,9.820268911026071,0.8010390630900049,-1441836900.0,-38.95733293390518,85.04343053981948,79.70440250180728,26.716639868053388,20.914236071373093,23.159611024556067,-0.020373327820841485,17.61143516836057,250.67460858154297,242.3010242614746,235.53333282470703,228.76564138793944,220.39205706787106,0.08,0.0,303.96348567258593,-0.01994944981117097,-0.043072262862823764,244.4895237513951,236.59095328194755,13.010834138265599
2022-06-09,0,245.97999572753906,213.0150032043457,256.8325004577637,233.92229557037354,249.9497880935669,-0.6948534320328295,12.761568696204002,-0.49782674200584687,2.9942969224957845,241.61791801452637,10.212990531921387,0.05321919673856176,220.0536636352539,253.9344970703125,0.688329959113402,-0.049801531528587135,1.025803182822534,1.0229928527581158,1.0156816992168467,-0.02463075021087413,49.678211438427525,265.3157212394539,239.7925838470459,214.2694464546379,243.82285690307617,5.853534683996195,236.56255967276437,13.622802788408618,241.04850854199077,240.70762486200792,-1.6849962561200118,-0.08094279809903511,96491400,9.641640074829228,1.0146000287372956,-1345345500.0,-42.723468469343295,85.04343053981948,79.70440250180728,38.40795325984704,21.807977084055345,21.627311231942905,-0.02603788562919815,17.51204098742698,250.67460858154297,242.3010242614746,235.53333282470703,228.76564138793944,220.39205706787106,0.08,0.0,303.4279235708728,-0.07210326864512706,-0.028701845454721386,242.62571498325892,236.82190595354353,12.95236921435393
2022-06-10,0,233.6999969482422,213.0150032043457,256.8325004577637,233.92229557037354,248.741042137146,-0.7500556124448013,12.337469751422978,-0.388401204879973,2.9943846833798426,241.61791801452637,9.826948547363282,0.05155289751983406,220.0536636352539,252.34858207702638,0.7439151490935226,0.028968193463097345,0.9765302153359833,0.9593943840110642,0.9699516814284871,-0.025190582772694703,54.705459787576466,263.9916480676043,239.3167085647583,214.64176906191236,241.5129759652274,6.246983674715604,236.99071393694197,13.415651404216385,242.30246348476425,240.58203314518417,-3.066207735954061,3.7696895443953338,97536600,8.92125644575882,1.049185935534775,-1442882100.0,-55.75962691425538,85.04343053981948,79.70440250180728,-38.09778252979915,20.73383306636343,25.32882133660173,-0.05548812752739361,17.10353892783163,250.67460858154297,242.3010242614746,235.53333282470703,228.76564138793944,220.39205706787106,0.02,1.0,302.7906346408245,-0.009750551814905695,-0.1010452132274914,240.54571533203125,237.60261971609933,13.013551839332022
2022-06-13,1,220.05500030517578,213.0150032043457,256.8325004577637,232.38916492462158,248.741042137146,-0.6789376480829098,12.398202193103971,-0.4985395585693415,2.9943699354059734,241.61791801452637,10.148248977661131,0.05186469870498526,220.0536636352539,252.34858207702638,0.7244361901452655,-0.09006844331730378,0.9205436491188599,0.9014380533106553,0.9179208463333577,-0.08486770740221561,43.066750947386055,263.84536259238473,239.04895820617676,214.25255381996882,236.92202377319336,8.495304997883766,236.9473808833531,13.473307910798123,240.22308399736835,239.24989712210916,-6.471053225456646,2.6324137188945755,102767400,8.339211926904179,1.099176415058317,-1545649500.0,-84.51704269579938,85.04343053981948,79.70440250180728,-116.99761001181493,19.21720237570592,28.99133130969649,-0.10080129884550897,17.135192190375474,250.67460858154297,242.3010242614746,235.53333282470703,228.76564138793944,220.39205706787106,0.04,0.0,301.99708620446756,-0.09460859105433328,-0.08007959251712714,234.4604753766741,236.94333430698939,13.25553254953711
2022-06-14,1,219.31083297729492,213.0150032043457,253.7608299255371,228.2689609527588,247.29187488555908,-0.5677903543563481,12.351508386183252,-0.8673600903506675,2.9943619184380137,240.10083389282227,10.392657260894776,0.052069912963374786,219.50766716003417,250.39166221618652,0.6914836908195099,-0.1139854696997169,0.924542624917548,0.9083917863106258,0.9306614381590903,-0.06970835412657694,36.90446374380941,261.91309997091383,237.21008319854735,212.50706642618084,234.0036904471261,10.611489886659559,237.39708300999231,12.695693429128626,235.19582297086396,236.11763014674784,-12.742952968522474,-0.27492893049200634,97988700,8.650451697028295,1.0414422790575177,-1643638200.0,-76.61831837545424,85.04343053981948,79.70440250180728,-98.42318695814133,18.035588989326243,28.450277556091176,-0.05069621824805938,16.95362234086092,250.86655303955078,242.61171401977538,235.93999481201172,229.26827560424806,221.01343658447266,0.06,0.0,301.25999326150276,-0.07533561148457524,-0.07298136427202039,232.51380920410156,237.76500047956193,13.650308642524596
2022-06-15,1,226.93249893188477,213.0150032043457,253.7608299255371,225.94479370117188,246.21853828430176,-0.35720299039083364,12.658868244283635,-1.140505533911718,2.9942801874897524,238.39166641235352,10.858553028106689,0.05369447406251016,218.8379165649414,250.39166221618652,0.6973401964527897,-0.12342868915360802,0.9625679754855724,0.9535676779755681,0.9766257376998186,-0.06524948715519652,36.16636754208569,261.07511125205605,235.75737476348877,210.4396382749215,232.07083293369837,10.470245519341773,238.27928515842981,11.345675826162928,231.2269073510528,233.4721121580952,-8.521066290993897,2.9555804418666307,119131800,8.617559056926877,1.240514316774649,-1524506400.0,-59.4778201816166,85.04343053981948,79.70440250180728,-35.8536369994218,20.631092435636212,26.35586854642315,-0.04155379015616669,16.99360370778027,251.8262861328125,244.16518029785155,237.97332763671875,231.78147497558592,224.12036914062497,0.06,0.0,300.48140400039074,-0.036659324531098214,-0.024642115444768055,231.75952366420202,238.72214290073939,12.957495297962167
2022-06-16,1,217.42416763305664,213.0150032043457,253.7608299255371,225.36478996276855,243.7224998474121,-0.19999394620236954,12.343863377735993,-1.1524332742547199,2.994341898230651,236.39416885375977,10.693057918548584,0.05261789072251349,218.8379165649414,250.10141372680664,0.7381443688341737,-0.06600610037553815,0.9268087909644322,0.922504846459283,0.9486399651315429,-0.11609004224112773,43.42056781404669,259.28214337381917,234.59441661834717,209.9066898628752,229.4536895751953,11.6249843206439,237.49124935695104,12.413314221083185,230.08545564403863,232.2321428637651,-5.626658006191466,5.755771284704777,107390700,8.746654904604766,1.106970606921361,-1631897100.0,-92.06242407251663,85.04343053981948,79.70440250180728,-105.34379584589801,18.58604554184779,27.59985809135294,-0.03526129009929367,17.51598758903798,251.10805908203125,243.00262634277342,236.45166015625,229.90069396972655,221.79526123046875,0.08,0.0,299.6660975075847,-0.11099674233593415,-0.1189360350979064,228.07571411132812,237.09285736083984,13.79738069934195
2022-06-17,1,216.0900001525879,213.0150032043457,253.7608299255371,220.5099973678589,243.57499980926514,-0.017413522290631825,12.7268550983059,-1.276246695927903,2.9942428155192786,234.72208404541016,11.171078338623047,0.054547453821211,217.13991775512696,250.10141372680664,0.7238916475687739,-0.08276938098162229,0.9261643362402845,0.9305713964981093,0.9669126976244544,-0.07535300396069067,38.963815383228315,258.77083513557665,233.31712493896484,207.86341474235306,225.64178466796875,10.880429553067854,235.28809465680803,13.312992884761186,226.81131901384572,229.86561337381116,-7.771137424408064,-4.829143870501445,92641800,8.891583858419544,0.9537878975068568,-1724538900.0,-85.4698296475866,85.04343053981948,79.70440250180728,-86.73436694660153,17.96511266906178,26.67778679143262,-0.0283841340601914,16.826961277387703,251.10805908203125,243.00262634277342,236.45166015625,229.90069396972655,221.79526123046875,0.08,0.0,298.9861248312913,-0.06661500023818245,-0.09572812891325826,224.48904636928015,234.4892850603376,14.258707529843457
2022-06-21,1,232.3874969482422,213.0150032043457,253.7608299255371,219.86895847320557,243.57499980926514,0.11105769484195006,13.229485909299932,-1.3826965154799638,2.9941122069776442,231.07833290100098,11.846082496643067,0.056957502635992426,215.93916702270508,250.10141372680664,0.7543727115114321,-0.05101246958560533,1.0005083765724052,1.0110518919137368,1.0564868873023456,0.05604279214725194,39.47833223448904,258.72838843694706,232.26941661834718,205.8104447997473,223.6999991280692,7.254545368703959,233.76142801557268,12.211617099606011,224.0282730856199,227.7311838020417,-10.991048257088178,-12.49084576156791,122793000,8.675068293867012,1.2788088154108164,-1601745900.0,-48.94625021300923,85.04343053981948,79.70440250180728,12.345096511900222,25.20941686849453,23.764391872961788,0.01458975614560567,17.540537409542843,251.10805908203125,243.00262634277342,236.45166015625,229.90069396972655,221.79526123046875,0.08,0.0,298.2960426807974,0.09873149364028122,0.02069789101756485,224.1076180594308,233.36666652134485,14.048848773200872
2022-06-22,0,237.81249618530273,213.0150032043457,253.7608299255371,219.86895847320557,243.57499980926514,0.06092578448402629,13.188020582941103,-1.3691930800260237,2.994124043692653,233.0437469482422,11.61199951171875,0.05672181539393715,215.93916702270508,250.10141372680664,0.7422419315535684,0.053139424993263476,1.0228340502017828,1.0383022889103006,1.0691613813986642,0.08436274194409399,52.43297163598266,258.87954076915366,232.50349960327148,206.12745843738927,224.28749901907784,8.291733785050795,232.90023749215263,11.385468542921373,226.0711457256626,228.69519296888592,-5.525855360349169,-8.422628891766571,101107500,9.306851657820133,1.0463193247673974,-1500638400.0,-50.657442679903475,85.04343053981948,79.70440250180728,31.185493004840737,25.20019083315994,22.481972870937096,-0.05452836664214605,17.216678719667904,251.10805908203125,243.00262634277342,236.45166015625,229.90069396972655,221.79526123046875,0.02,1.0,297.77351500623365,0.06879745834676632,0.09432799109496498,224.65857151576452,232.60214342389787,13.927541052236606
2022-06-23,1,235.23250198364258,213.0150032043457,253.7608299255371,219.86895847320557,243.57499980926514,-0.09288393652365835,12.945513771092857,-1.27884742316464,2.9941895715922566,234.72208404541016,11.199603347778321,0.05547418584185426,215.93916702270508,250.10141372680664,0.6930380865564852,0.11641195506388227,1.0080195936467122,1.0261112724096213,1.0402564759472548,0.0365747660243636,56.9334634557239,259.25206880195134,233.3610412597656,207.4700137175799,226.45571354457311,8.95812536103468,231.68886865888322,9.991966297029043,228.99635045527248,230.84934499163302,1.759734399128532,-4.825192175922391,104202600,9.152405735266427,1.0699836564587946,-1604841000.0,-43.70373023988953,85.04343053981948,79.70440250180728,-3.647715370471805,24.052429045484136,23.671329559976996,-0.018230476000569578,16.749758006094098,244.48927490234374,237.64868835449218,232.1199951171875,226.59130187988282,219.75071533203123,0.02,0.0,297.20341510046336,0.00888415160608913,0.06419488421273829,227.42047773088728,230.94047655378068,12.697085141490467
2022-06-24,0,241.33250045776367,214.58166885375977,253.7608299255371,225.21312427520752,243.57499980926514,-0.15185688651202273,12.075981893906416,-1.1248027163516796,2.9944014319265366,235.48833656311035,10.130891418457031,0.05150289249852516,217.29075088500977,250.10141372680664,0.6529624211516871,0.09623763875168959,1.029259727008067,1.056194412276392,1.0594547941458463,0.10996170795997595,54.77434014951914,258.6238799865433,234.47191619873047,210.31995241091764,229.60166604178292,9.852904907022502,231.8026782444545,10.099212011749271,230.62965664531208,232.62079994182656,6.897140104709457,-6.7247121835292445,95770800,9.192917452483323,0.9815732857688846,-1509070200.0,-21.0017000045594,85.04343053981948,79.70440250180728,46.925863613136194,25.847084743686153,22.533315844610694,0.0015760707584448095,16.338810409143807,244.48927490234374,237.64868835449218,232.1199951171875,226.59130187988282,219.75071533203123,0.02,0.0,296.75623503511,0.15301106523529562,0.05453504308610515,230.96571568080358,231.73976244245256,12.369564182524384
2022-06-27,0,247.2308349609375,216.0900001525879,253.7608299255371,228.07562637329102,243.57499980926514,-0.2584944013361338,11.252226671630382,-0.9557241761334572,2.9945882179564336,236.77833366394043,9.276124191284179,0.047717452801147815,219.1221664428711,250.10141372680664,0.6924887818469153,0.05636006017511362,1.0484347714022322,1.084213810694458,1.0630338084683455,0.14411048538275772,56.45127885518059,258.3139111221914,235.80945777893066,213.3050044356699,232.5014283316476,11.742240026193423,232.28613063267298,10.69034933514555,233.39515236490251,234.74744850088916,10.04130401654561,0.6646115538216291,89178300,8.778258782125873,0.9219546576371696,-1419891900.0,-22.68069876049476,85.04343053981948,79.70440250180728,68.40263446706481,27.445542314483028,21.568285937754272,-0.05803025701961338,15.850549507501084,244.48927490234374,237.64868835449218,232.1199951171875,226.59130187988282,219.75071533203123,0.04,0.0,296.3758933080853,0.129913288317699,0.14931952676703733,232.66857256208147,232.21404811314173,12.518043051751224
2022-06-28,0,239.8650016784668,216.0900001525879,253.7608299255371,231.02374744415283,246.21853828430176,-0.4337307917850101,11.382031864960576,-0.9031814315086941,2.99456760662965,238.77583122253418,9.385682773590087,0.0480765365713888,219.1221664428711,250.10141372680664,0.7337262011183517,0.001201409311671405,1.0131651942472388,1.0457063848156336,1.0044633136231753,0.03217688054831114,57.31944605691146,259.5122298142107,236.74816608428955,213.98410235436842,235.70726176670618,9.850871798676467,232.58047567095076,10.848447928463575,236.93073683337875,237.25628953606522,8.944658047918209,2.8147147235471044,90391200,7.8344454339537775,0.9339647921955925,-1510283100.0,-48.840349380247375,85.04343053981948,79.70440250180728,14.39767107893273,25.2827334514397,24.43917665909005,-0.1487327077072241,15.977417940980727,244.48927490234374,237.64868835449218,232.1199951171875,226.59130187988282,219.75071533203123,0.04,0.0,295.93381519959604,-0.018450043403574035,0.07336840733674936,235.4633331298828,231.76952362060547,11.924633590240802
2022-06-29,1,228.10916900634766,216.0900001525879,253.7608299255371,231.02374744415283,243.57499980926514,-0.4010216949813708,11.167977444651271,-0.8288197674695912,2.9946083576950757,238.77583122253418,9.067570381164552,0.04724292495909009,219.1221664428711,250.10141372680664,0.7018461899201943,-0.054759547606885846,0.9649504046060319,0.9859412240138751,0.9492893529585654,-0.040802427688216514,50.25955618890033,258.7306627597859,236.3947078704834,214.05875298118087,237.42428588867188,6.25159857788549,231.5330352783203,10.490629755919983,237.6665472547785,237.8797034049862,10.32122339007097,1.7480095121403416,82897200,7.826023110356858,0.8650319827421856,-1593180300.0,-57.7475590930703,85.04343053981948,79.70440250180728,-60.585524169792514,24.078248667269634,27.892216256415512,-0.1372010578502752,15.57830735827648,244.48927490234374,237.64868835449218,232.1199951171875,226.59130187988282,219.75071533203123,0.04,0.0,295.4578818316035,-0.032177439036370714,-0.036056283991017256,237.13904898507255,230.81404767717635,11.319015778811702
2022-06-30,1,224.3258285522461,216.0900001525879,252.19166564941406,227.81500148773193,241.6927089691162,-0.35537153889705014,10.556140340406662,-0.8887358919613613,2.9947182547500533,236.77833366394043,8.688783569335936,0.044898323930700056,219.1221664428711,247.49466781616212,0.6491775951158939,-0.0870855538990422,0.9541227561941852,0.965915512272806,0.9411456364483389,-0.046365503658822194,43.08749853781074,256.22440550533724,235.11212482452393,213.9998441437106,236.27261897495814,7.867770688880624,229.98630905151367,9.768194696079572,235.24458526363497,236.09392109846934,5.562112474095357,-6.040270249134163,94600500,8.182081133152732,0.9782986380417584,-1687780800.0,-63.621007100910596,85.04343053981948,79.70440250180728,-74.5530365613818,22.8813407177973,28.10585902375176,-0.11151950671465671,15.222230449847542,241.8331112060547,235.50011614990234,230.3816680908203,225.26322003173829,218.93022497558593,0.04,0.0,294.89882607437505,-0.045078824849333454,-0.04919101230492724,235.3442862374442,229.7259521484375,11.142679976807866
2022-07-01,1,226.6533317565918,216.0900001525879,252.19166564941406,226.2808313369751,240.6800012588501,-0.22214919045496062,10.233750231698156,-0.9689262537445482,2.99477086239602,235.48833656311035,8.617963123321534,0.04376484301526528,219.1221664428711,246.1050796508789,0.5862643711625588,-0.11049467882061514,0.9692876275687724,0.9770340329385833,0.9596933239639641,-0.06082549459077491,40.430327768581265,254.30245853987336,233.83495807647705,213.36745761308075,234.67845262799943,8.600201490381082,229.48297582353865,9.74363539083337,232.52014249863822,233.93102336190347,-3.4690628806900077,-8.803222843892685,74460300,8.159445500152815,0.7776665835320835,-1613320500.0,-57.18895964237238,85.04343053981948,79.70440250180728,-48.65897343276651,22.355916518125216,26.99933300136322,-0.1250940127303848,14.714203872063326,241.8331112060547,235.50011614990234,230.3816680908203,225.26322003173829,218.93022497558593,0.04,0.0,294.47889387694283,-0.07506238731655779,-0.033209983831798656,234.08380998883928,229.37119075230189,9.531058408477898
2022-07-05,1,226.34500122070312,216.0900001525879,247.2308349609375,226.07145595550537,240.01437664031982,-0.2669937875944261,9.424939243503703,-1.1345548071434417,2.9949076570654234,234.46624946594238,8.173404617309568,0.040527255851922746,219.1221664428711,243.09400062561036,0.6502822519490427,-0.05458363231727801,0.9732839160313891,0.9718385373014825,0.9704513567778831,-0.08447908103183954,44.30618078073355,251.40791986884335,232.55804138183595,213.70816289482855,233.40880966186523,9.14363424182843,229.93226160321916,9.414938017897915,231.0718170480684,232.3155697635248,-4.692421385634736,-3.0152611397812827,84581100,7.770264142499721,0.8963876566545028,-1697901600.0,-43.81004343002188,85.04343053981948,79.70440250180728,-36.568810435016246,20.533185932573065,27.65660390430229,-0.032094919226490604,14.87604915319566,241.8331112060547,235.50011614990234,230.3816680908203,225.26322003173829,218.93022497558593,0.02,1.0,294.0144894614289,-0.04839675244221919,-0.051443453467731125,233.79761832101005,230.60904802594865,9.515080988794994
2022-07-06,1,231.06583404541016,216.0900001525879,247.2308349609375,225.84020805358887,240.01437664031982,-0.09427652405596272,9.366570144806127,-1.1528769620427313,2.99491504526558,233.0437469482422,8.174916763305664,0.040392589046555544,219.1221664428711,243.09400062561036,0.6409567539513514,-0.05870977892848892,0.9964530380922098,0.9877587766634376,1.0087582752288666,-0.03668383287050647,43.9320522523434,250.6214734194951,231.88833312988282,213.15519284027056,231.942143031529,8.458557449594409,230.77190453665597,8.905201545241706,229.92537990325962,231.0228523158789,-3.778177202552335,2.858376727092895,71853600,7.7638089327316875,0.7665187311630259,-1626048000.0,-46.88388009571068,85.04343053981948,79.70440250180728,-3.19821055236263,20.48437416236897,26.640404857559414,-0.012041327823815486,14.340370580598005,241.8331112060547,235.50011614990234,230.3816680908203,225.26322003173829,218.93022497558593,0.02,0.0,293.6466537972226,-0.003997160512870579,-0.05384068620442105,231.80142865862166,231.3835721697126,9.390834756810042
2022-07-07,0,239.0091667175293,216.0900001525879,247.2308349609375,225.84020805358887,238.32562255859375,0.012109783431961653,9.15805109896643,-1.0305432775325272,2.9949489631495454,231.72666549682617,7.787333297729492,0.03957354796020172,219.1221664428711,243.09400062561036,0.6498723152863923,-0.019844974637097217,1.0328006056978067,1.022292463804122,1.051514924806757,0.04778412791849829,49.02469888953485,249.73460195379224,231.4184997558594,213.10239755792654,230.76761899675643,6.269308051622842,231.63452366420202,9.087725777567563,230.20657207347892,230.3617509348086,-4.254158222733998,5.3599728333220185,81930600,7.7954751055812785,0.8697859405912844,-1544117400.0,-17.351887302857037,85.04343053981948,79.70440250180728,74.03180367079172,24.48732641587368,24.825330867361455,-0.0038998576528501425,14.289628271145494,241.8331112060547,235.50011614990234,230.3816680908203,225.26322003173829,218.93022497558593,0.02,0.0,293.2957182748039,0.07025834426816391,0.05106092515233649,231.74761962890625,232.20809609549386,9.706960151265378
2022-07-08,1,247.30916595458984,216.0900001525879,247.2308349609375,225.84020805358887,239.22312545776367,-0.018747795809254533,9.262212966665937,-1.0980197125922775,2.9949318497453237,231.72666549682617,7.95058307647705,0.039995435673491266,219.1221664428711,243.09400062561036,0.6066269824547257,-0.015504865035312688,1.0679130218663135,1.0572521606654575,1.0776945551383839,0.10245515440943032,54.00283146931617,250.1061754679388,231.58174953460693,213.05732360127504,231.83107103620256,8.354332539628398,233.76916640145438,9.002539279760919,232.43203574238333,231.2112602113743,-3.3255027612988597,5.321700436247089,101854200,7.842907660509883,1.0667766810034074,-1442263200.0,-10.091728042677257,85.04343053981948,79.70440250180728,135.7258177123247,27.610111216325944,23.106310325343372,0.03694680906081545,14.256082329067397,245.1191309814453,239.01876550292968,234.0883331298828,229.15790075683591,223.0575352783203,0.02,1.0,292.9334081310091,0.11711862973523912,0.09748054686419504,234.33333478655135,234.89833395821708,10.377260248547383
2022-07-11,1,243.2841682434082,216.0900001525879,247.30916595458984,225.84020805358887,239.22312545776367,0.05342910469478664,9.583431393787418,-1.079224414198318,2.9948778547698445,231.72666549682617,8.177374649047852,0.04134201159290535,219.1221664428711,246.1050796508789,0.5456429261806925,0.005403570412786912,1.0495047640670179,1.0347032398277627,1.0393361499631284,0.07337565416720482,59.18608597488615,250.9754038947526,231.80854110717775,212.6416783196029,233.99892807006836,9.157809828947906,235.71160697937012,7.739775193029967,236.1401290386093,233.16642234983982,3.1034808012974597,13.745021377738304,99241200,8.039287978435675,1.0379146451029015,-1541504400.0,-53.169003840907,85.04343053981948,79.70440250180728,70.37854466117524,24.98928220173161,24.59204842998746,0.03691850399937936,14.626129845352343,245.82005126953123,240.15330596923826,235.57333374023438,230.99336151123046,225.3266162109375,0.02,0.0,292.51791322495353,0.03115329533575073,0.04396963541231904,235.16952514648438,236.15428706577845,10.240428339972443
2022-07-12,1,234.51499938964844,216.0900001525879,247.30916595458984,225.84020805358887,239.22312545776367,0.019286092047789125,9.400371437901335,-1.0725163065480827,2.9949088509400035,231.72666549682617,8.04258327484131,0.04057590231407861,219.1221664428711,243.67883491516113,0.6513472722570429,0.04101057518322789,1.0122640120425903,0.9965801815476854,0.9878364136330234,0.03609533289837907,58.226095824911354,250.47449260877386,231.6737497329712,212.87300685716855,235.454523903983,8.114380710424719,235.86357143947058,7.690215651508639,237.83994241116312,234.26723544913338,6.652516118998386,12.584649021989755,87930900,7.569445328521195,0.9242684683883553,-1629435300.0,-56.449657384802244,85.04343053981948,79.70440250180728,15.724137700761887,23.575366316143395,25.808853748497224,0.04205240500259974,14.395927302878706,245.82005126953123,240.15330596923826,235.57333374023438,230.99336151123046,225.3266162109375,0.02,0.0,292.1092913827983,1.4337849624901366e-05,0.02555040879069514,236.39762224469865,235.87095424107142,10.243601795812554
2022-07-13,1,232.40833282470703,216.0900001525879,247.30916595458984,225.84020805358887,239.22312545776367,0.007108318587859374,9.410827471044787,-1.0809959202129102,2.9949071734830546,231.72666549682617,8.083333396911621,0.040613891132976636,219.1221664428711,243.67883491516113,0.6815942805252322,0.06571084076444207,1.0029943442041804,0.9929936053111929,0.9722706389266559,0.005810027193518641,53.27599294679514,250.53615479713108,231.7144998550415,212.89284491295194,236.27666691371374,7.327413241375268,235.47755977085657,7.7204359884408325,236.93884546617002,234.27529623921808,4.542130036100261,0.9154978083352271,97954500,7.156798985157406,1.0322406258916101,-1727389800.0,-46.221247252984824,85.04343053981948,79.70440250180728,18.585825281032786,21.609322833953595,25.290793520629613,0.10793954091884107,14.583838811581382,245.82005126953123,240.15330596923826,235.57333374023438,230.99336151123046,225.3266162109375,0.02,0.0,291.6682069701342,0.02289983799169759,0.017048030552320684,237.7942875453404,235.93904876708984,9.55494881684381
2022-07-14,1,235.29916763305664,216.0900001525879,247.30916595458984,226.57624912261963,239.22312545776367,-0.08970849861748889,9.022695570102636,-0.8718702397956641,2.994976900497106,232.3979148864746,7.473283405303954,0.03883532662206637,219.1221664428711,243.67883491516113,0.6445033208637131,0.05972117140591994,1.0127705138594356,1.0085582789035579,0.9832598725326264,-0.01552241336775706,51.60187170423082,250.37755762122333,232.33216648101808,214.28677534081282,237.55583354404993,5.958321343411056,235.4823216029576,7.720293772091269,235.79272231945737,234.39405060956886,2.53912043715098,-2.2724471788836516,78557400,7.1783156036804305,0.8363980628481957,-1648832400.0,-42.94055439581388,85.04343053981948,79.70440250180728,19.731400512095874,20.596797462050663,24.10576933861499,0.13455142257964933,14.207846691605315,245.82005126953123,240.15330596923826,235.57333374023438,230.99336151123046,225.3266162109375,0.02,0.0,291.32375894457874,-0.02547603977239543,0.028394713962239502,238.54381234305245,236.17071533203125,9.17952478620035
2022-07-15,1,240.14500045776367,216.0900001525879,247.30916595458984,226.86270713806152,239.22312545776367,-0.20818988210010342,8.528327310741476,-0.5795629930108923,2.9950611019139486,233.46166610717773,6.957417106628418,0.036581604230431976,223.63566246032715,243.67883491516113,0.6626471172274526,0.03686853465480581,1.030083513984999,1.0261664028029776,1.0066306700646188,-0.02896845925290792,52.45986039826975,250.1882378352891,233.13158321380615,216.0749285923232,238.8528573172433,5.257016842995106,235.39750017438615,7.657341490257735,235.6557149333124,234.8064866428716,3.9559815167389276,0.02834032238397832,69683100,7.013699393241179,0.7619717766968713,-1579149300.0,-38.42322313822143,85.04343053981948,79.70440250180728,60.628898006542364,22.468545640909298,23.257890332351685,0.09071524250708855,13.673947690279673,245.82005126953123,240.15330596923826,235.57333374023438,230.99336151123046,225.3266162109375,0.02,0.0,291.04745663694473,-0.04265643732095836,-0.018306241354885,239.73428780691967,235.76785823277064,9.279644012820624
2022-07-18,1,243.90082931518555,216.0900001525879,247.30916595458984,227.7452096939087,239.93500137329102,-0.39353155070444656,8.534278528550866,-0.49155958625126583,2.995062444390284,234.8737506866455,6.932071247100831,0.03650369099538656,223.63566246032715,243.67883491516113,0.595079980568085,0.10450003360736156,1.0432376301118735,1.0352177086507663,1.028551790483949,0.0025347357217275768,58.72079892796207,250.86076534720183,233.7922082901001,216.72365123299835,239.55166625976562,5.595483411072868,235.15964262826103,7.305109647016702,236.7422215276273,235.41841737193857,3.9292552487743535,-0.49205970921758546,82537500,6.66584095940683,0.9149650367790171,-1496611800.0,-37.18654542452436,85.04343053981948,79.70440250180728,88.12898835953595,24.82249314225328,21.912593076337803,0.08180352612228127,13.476758838355575,245.82005126953123,240.15330596923826,235.57333374023438,230.99336151123046,225.3266162109375,0.02,0.0,290.7454074974907,0.02647108903058193,-0.04074229893514844,239.16333443777904,235.45547703334265,7.921086591143164
2022-07-19,1,243.6616668701172,216.0900001525879,247.30916595458984,230.32666778564453,240.44187545776367,-0.4529994344362491,7.924326417571284,-0.2686642147189362,2.995161105018668,235.2658348083496,6.414437847137452,0.0337038951968363,226.14308395385743,244.23382987976075,0.47332762603344153,0.12870021353583952,1.0363464162035187,1.026686677696879,1.0270090703175716,0.03900248386787197,61.8486976810012,250.96469420934912,235.11604137420653,219.26738853906394,239.0305949619838,4.876291351048118,235.43083299909318,7.559276236166246,238.56430071680228,236.56834332574337,2.0466422542853406,-1.346921651693687,80890200,6.661058747896465,0.9025830336121247,-1577502000.0,-24.347301340189514,85.04343053981948,79.70440250180728,77.00376035370788,23.46146682754177,22.128181697989554,0.11747078433020769,13.240083260606756,245.82005126953123,240.15330596923826,235.57333374023438,230.99336151123046,225.3266162109375,0.02,0.0,290.45098534401905,0.05346029546283626,0.047736201342303726,238.41571480887276,236.37452479771204,6.861512358946291
2022-07-20,1,247.10750198364258,224.3258285522461,247.30916595458984,232.05708122253418,241.8204174041748,-0.14077559076903948,6.815154487298373,-1.0542411225348038,2.9953163790232953,236.5558319091797,5.8604583740234375,0.02881737585221237,226.62249870300292,244.23382987976075,0.6305329005956246,0.04851452883623083,1.044875765301515,1.033663826886447,1.0335636686127325,0.06324716923993567,58.36947579420794,250.12493368467977,236.494624710083,222.86431573548623,239.57678549630302,5.593516733973539,236.78785678318567,7.843719628979256,239.92456152445732,237.7996332616657,-1.4748742006361377,1.58283416300129,88864200,5.673070337585752,1.0106893602676255,-1488637800.0,-19.271721567656122,85.04343053981948,79.70440250180728,109.45860202798286,24.487012665475945,21.242065803538658,0.10337816373990884,12.80721608966108,245.82005126953123,240.15330596923826,235.57333374023438,230.99336151123046,225.3266162109375,0.02,0.0,290.15875230111124,0.044127602978965896,0.06191269671051236,240.2952379499163,237.73238154820032,7.249467927643929
2022-07-21,1,263.73666763305664,224.3258285522461,247.30916595458984,232.0727081298828,243.37854290008545,-0.25949065305350344,7.1198923863858585,-1.0822118833461676,2.9952805971975507,238.41083145141602,6.112145824432372,0.03001253479617459,226.62249870300292,247.11983528137208,0.6555160907389382,0.03908543893798249,1.1117311168213033,1.0958708726687136,1.0897181232421105,0.12085678111852727,60.25987205439199,251.47040973462475,237.23062496185304,222.99084018908133,243.7513095310756,10.196537374467571,239.6029167175293,9.844184435307566,241.77073206161634,239.17268655912162,1.5715505730767865,8.328614347267317,142032300,5.60111171612574,1.578652622965606,-1346605500.0,-2.7320451991592964,85.04343053981948,79.70440250180728,254.10747121878623,32.96195419078637,18.395193364691504,0.20323798560691156,13.732897904986688,259.79106475830076,251.4544660949707,244.71666717529297,237.97886825561523,229.64226959228515,0.04,0.0,289.90710649811194,0.14012361168318588,0.14624819749755594,245.81476048060827,241.10619136265345,10.510549351047413
2022-07-22,1,274.99083709716797,224.3258285522461,263.73666763305664,232.0727081298828,243.72145748138428,0.6585752977307685,9.171929847580245,0.6913056846943602,2.994998575149269,239.43708419799805,7.278733539581299,0.03845240265709395,226.62249870300292,247.23866806030273,0.5492131875899935,0.12117443554375902,1.1528717042969205,1.1310130494984907,1.1101306654715413,0.14510331913211294,72.04031909736052,256.87069322940124,238.52683353424072,220.18297383908023,249.83452442714147,14.212803407860026,243.0555956704276,12.94224699419176,247.2814749102111,242.47953278037107,12.460468762962227,17.568569493383887,103472700,6.600375174515055,1.1505392449070202,-1243132800.0,-13.220881444045093,85.04343053981948,79.70440250180728,257.07917096493964,35.18870343097153,17.41268115284418,0.15140742960264725,13.47150079200312,265.5363596801758,256.1018381652832,248.47667694091797,240.85151571655274,231.41699420166015,0.06,0.0,289.788698213633,0.13403227570771725,0.1423756137349075,250.84381103515625,244.31904929024833,12.761431701185943
2022-07-25,1,270.5491638183594,224.3258285522461,274.99083709716797,232.0727081298828,244.7024974822998,1.1634863664469555,12.087639590715389,1.4355623944458777,2.994491778748328,240.00500106811523,8.792141990661623,0.0502573733051504,226.62249870300292,248.95191612243656,0.632263866859702,0.13946872706975058,1.1248755574959075,1.1002186005864811,1.0623122913402712,0.10925889255069743,76.24916890931024,264.69002947134777,240.514750289917,216.33947110848624,254.870238167899,14.447222813212912,246.21303585597448,13.90794783194726,254.2281472151114,246.82647041742013,18.32227947892841,21.32662465888078,64073400,6.883685859686538,0.7252288135650773,-1307206200.0,-22.15717061259477,85.04343053981948,79.70440250180728,178.6196517474912,33.88337410811071,18.588515043113325,0.0786797956397048,12.991152830449034,267.62889349365236,259.4889056091309,252.9100112915039,246.33111697387696,238.19112908935546,0.06,0.0,289.69444495096366,0.11593034613414743,0.11816156718654378,255.14666530064173,246.8452388218471,14.123114824934598
2022-07-26,1,262.2366638183594,224.3258285522461,274.99083709716797,232.0727081298828,247.1383352279663,0.9917664410317646,13.74943131053927,0.2986593320379467,2.9941455497476985,240.00500106811523,10.399058475494385,0.0568215648622614,226.62249870300292,264.4179172515869,0.7634252950665742,0.09431804435359438,1.0837319206792357,1.0547205469708631,1.0085669915390885,0.0762327418458626,70.34969762959258,269.4744460790253,241.97558345794678,214.47672083686825,258.0261900765555,13.038691499937192,248.4395236968994,13.791080240380863,258.287473052137,249.69010980505604,14.980926851502616,19.529551065523165,66820800,6.944376465285483,0.7660182242976994,-1374027000.0,-39.3280404701779,85.04343053981948,79.70440250180728,106.61077249292559,31.60581930969658,23.490061296918885,0.08519340083390196,12.932497477725123,267.62889349365236,259.4889056091309,252.9100112915039,246.33111697387696,238.19112908935546,0.06,0.0,289.5517321730931,0.054290663619673385,0.07613210621913866,257.83142525809154,248.78285653250558,14.593523957860802
2022-07-27,1,269.086669921875,224.3258285522461,274.99083709716797,232.0727081298828,247.1579179763794,0.8418813833801736,14.40932370253936,-0.2623998584202445,2.9939968614919983,240.00500106811523,11.224379062652588,0.059364596825234504,226.62249870300292,264.4179172515869,0.8376212828083293,0.09326772135720428,1.1086031517316752,1.0703374492738416,1.0203337567254458,0.08894577364829392,63.32603168083374,271.5445223058966,242.72587490081787,213.90722749573916,261.6241673060826,11.918019780593397,250.5879167829241,14.53186244377973,259.2048939792204,250.7817496298927,9.199301804528364,13.490021102307743,88110000,7.008947535414762,1.0113951553931002,-1285917000.0,-10.701914226934814,85.04343053981948,79.70440250180728,137.45344960900528,33.345998084295545,21.32524975854132,0.17795261997082454,13.227797969750913,267.62889349365236,259.4889056091309,252.9100112915039,246.33111697387696,238.19112908935546,0.06,0.0,289.4306462760051,0.11038386797664135,0.11929299348569708,262.7276175362723,250.94547598702567,15.994266373317172
2022-07-28,1,279.26666259765625,224.3258285522461,274.99083709716797,232.0727081298828,251.04104042053223,0.641191233540156,15.486419558911425,-0.8239362358108178,2.9937456514156273,241.71458435058594,12.57079620361328,0.06342033852218104,226.62249870300292,269.23291931152346,0.817897778137734,0.17963986758632683,1.143659204926515,1.0948567504784965,1.041573407880284,0.05888447406261643,70.04133202848693,275.1597974308111,244.18695831298828,213.21411919516544,266.7105952671596,10.486015650397059,252.8705951145717,16.370815750773467,261.60235720116964,252.85695582202462,10.326262800091822,12.58424671213239,84723000,6.407518541847656,0.9714985022975091,-1201194000.0,-4.118984026189957,85.04343053981948,79.70440250180728,150.0827098947447,35.46809788200902,20.0980512811489,0.18526677856744098,13.032954231032651,269.5490590209961,261.0421285095215,254.16666412353516,247.29119973754882,238.78426922607423,0.08,0.0,289.3661251923596,0.033835492611490325,0.13494947028882576,267.7804739815848,253.0980943952288,17.357986358959234
2022-07-29,1,288.8175048828125,224.3258285522461,279.26666259765625,233.9883327484131,262.6116647720337,0.542552779098134,16.789609437501028,-0.9844893267735064,2.9934422748475757,243.4729175567627,14.032466888427734,0.0680444215746058,226.62249870300292,270.9933311462402,0.7766826474395297,0.24491532874295965,1.1705108527704347,1.1131134464169887,1.0648592150743554,0.05028046727520197,75.38734159914273,280.32405186755574,246.7448329925537,213.16561411755168,272.6691671098982,9.270394480630683,256.1229763031006,18.679968462104743,266.0019123386542,256.2935565342018,14.612473182545433,12.922083384865058,95313000,6.484380455839759,1.0924852311099191,-1105881000.0,-1.5964887989897802,85.04343053981948,79.70440250180728,170.5127280822337,39.816446042801736,18.050398688701947,0.22995769242550232,13.474888321010916,281.0243539428711,270.32450057983397,261.67667388916016,253.02884719848635,242.3289938354492,0.1,0.0,289.3810332691442,0.09148670477206822,0.09364263793000425,274.87333025251115,257.5842841012137,19.67844203650954
2022-08-01,0,301.35750579833984,226.34500122070312,288.8175048828125,235.1031255722046,265.07416820526123,0.5845286002812959,18.299397319817643,-0.8865898980789089,2.9930860799723353,243.78124809265137,15.889825210571285,0.0732065448382195,230.62458381652831,275.4184196472168,0.7688357502796883,0.2742698403965234,1.2055775048213448,1.1400572403560782,1.0998797023617788,0.11387335870926774,78.40669582563476,286.56821144871736,249.96941680908202,213.37062216944668,278.04357256208147,13.270787938217202,260.89744104657854,21.11571905338139,271.7373263385758,260.30035465234613,16.879294462671126,18.716111684607338,117042900,6.6498019057464015,1.3095953792926815,-988838100.0,-16.811889590634234,85.04343053981948,79.70440250180728,173.14067067182773,43.37645646142336,16.464187937348594,0.16548568609260095,13.717874435309666,291.3816506958008,278.70252334594727,268.4550094604492,258.20749557495117,245.52836822509767,0.12000000000000001,0.0,289.48204152547584,0.10745071948993301,0.09195201813276059,278.5261884416853,262.17047446114674,21.31878905049085
2022-08-02,0,298.77249908447266,226.34500122070312,301.35750579833984,238.08166694641113,269.4522933959961,0.7031710730557992,20.63421797912501,-0.5576485665655548,2.9924795939747724,245.50416564941406,18.04046714782715,0.08133165856771729,232.27408294677736,280.2217468261719,0.7522101568754698,0.3314078251036522,1.1776391482122153,1.1062325956725072,1.0664618889941007,0.13932390205902,81.84607299922186,294.97306146941946,253.70462551116944,212.4361895529194,281.44095284598217,15.254817416173092,265.6377386365618,21.670010332522565,279.1799953634895,265.2382931590545,14.264545959011663,28.50244401537493,95577600,6.899928646160894,1.062880856437922,-1084415700.0,-13.677671811076722,85.04343053981948,79.70440250180728,145.30531588628673,39.97654376193827,16.37957303655893,0.12024673223377873,13.821361484470254,292.3964478149414,280.3451186828613,270.6050033569336,260.8648880310059,248.81355889892578,0.12000000000000001,0.0,289.55629641429414,0.16119403125841458,0.11978151944350304,282.57523454938615,266.70952279227123,22.962881437277805
2022-08-03,0,305.77416229248047,231.06583404541016,301.35750579833984,239.86104202270508,271.6595821380615,0.6292733865593461,21.835402557503226,-0.8514333421340186,2.992187445593762,247.2083339691162,19.288017101287842,0.08485501862692238,234.3043327331543,289.8130043029785,0.8116274259403845,0.2930189368704179,1.1882754242167208,1.1095168809940583,1.0637096747481616,0.1363408019477781,78.79170780405948,300.99680551936433,257.3260004043579,213.65519528935144,286.4730954851423,16.795205284860245,270.67166682652066,22.25792697618023,284.1143164702173,269.494097881211,8.648165240102689,28.554985724122254,80091000,7.048125392596908,0.8865996328666539,-1004324700.0,-5.974409110342068,85.04343053981948,79.70440250180728,143.4183441082637,38.987051692708455,15.601291028557199,0.1320453956280643,13.474357009951136,294.17982220458987,283.23176705932616,274.38333892822266,265.53491079711915,254.58685565185547,0.12000000000000001,0.0,289.64998561534276,0.11853816784822979,0.18750167996412304,288.1414271763393,271.6440462384905,24.53930339200743
2022-08-04,0,309.55999755859375,232.40833282470703,305.77416229248047,242.49937629699707,276.05979347229004,0.5471469178155429,23.36049810537961,-1.0187716266275386,2.9917840241154643,254.7729148864746,20.397416877746583,0.0894827676576228,235.22075080871582,299.0309997558594,0.8324862334204699,0.27934073195551007,1.185774601751789,1.099841115289497,1.0500761447033062,0.1084745836798342,80.20793372621732,307.7824130274706,261.0614168167114,214.34042060595218,293.2335717337472,14.82197511027912,275.62988090515137,22.662489448841146,289.54471378151163,274.36957929556576,13.019814209357662,29.951229903765693,72256200,7.020409109442827,0.8041752982886559,-932068500.0,-6.490053908554382,85.04343053981948,79.70440250180728,133.56584151962952,39.368603959641625,14.870632700404173,0.08658827053941504,13.126663025656166,295.52198138427735,284.33400289916995,275.29166412353516,266.24932534790037,255.06134686279296,0.14,0.0,289.74915600193856,0.09873028837645292,0.12303807245997969,295.2519051688058,276.54166521344865,26.256769627755137
2022-08-05,0,295.2475051879883,232.40833282470703,309.55999755859375,243.56729221343994,281.6543731689453,0.4170273941482833,25.03117760668749,-1.177198563538305,2.991304522058236,262.986665725708,21.6874377822876,0.09460401432453924,235.22075080871582,301.7991714477539,0.8628433683272247,0.2517125936829782,1.1158723592223856,1.0321853620148678,0.9813571193193469,0.02226319456566439,80.68984695279377,314.65131357213966,264.58895835876467,214.52660314538969,296.9708339146205,10.338913850144035,279.29750061035156,21.243004190920544,294.5351550134501,278.8054511922994,18.04604018796293,28.905451693148482,113172900,6.930223116215451,1.2516739064364273,-1045241400.0,-33.19411320895981,85.04343053981948,79.70440250180728,76.20031974357528,34.67654391463061,23.1411848484488,0.01875520606154934,13.838332094524924,295.52198138427735,284.33400289916995,275.29166412353516,266.24932534790037,255.06134686279296,0.14,0.0,289.7731402354865,-0.030220362285715785,0.025881166568943056,297.1590488978795,279.9433332170759,26.501011294937626
2022-08-08,0,294.92750549316406,232.40833282470703,309.55999755859375,243.56729221343994,290.42500495910645,0.21165272233451024,25.551563648117668,-1.360334263815701,2.9911723704774578,266.4116687774658,22.35637550354004,0.09570380312235942,235.22075080871582,301.7991714477539,0.8979285773342582,0.21359111577120896,1.1046558367149355,1.0238162509505397,0.9761210936710907,-0.021336784986130564,67.29320374044572,318.0890026166699,266.98587532043456,215.88274802419923,299.2080971854074,7.036321458712415,282.95934622628346,18.919068060450194,294.6764527362874,280.3446565797959,9.722085183078248,21.05227604882352,98994000,7.823781615410288,1.0950072606699992,-1144235400.0,-33.06078289634306,85.04343053981948,79.70440250180728,75.15433833829788,31.97907600759165,21.13997154564286,0.023930412035413757,14.066309001300867,297.0575550537109,286.81955010986326,278.5449981689453,270.27044622802737,260.0324412841797,0.14,0.0,289.80848430981536,-0.023053717821344133,-0.022637234362783403,298.51952689034596,283.1500004359654,25.80718922178622
2022-08-09,1,286.3441696166992,232.40833282470703,309.55999755859375,243.84103870391846,295.0075054168701,0.010648619869913188,25.63519081409966,-1.4128610058205266,2.9912012024320322,269.8179168701172,22.358292198181154,0.09509729197314955,235.22075080871582,301.7991714477539,0.8820628587369554,0.25760614997226594,1.0622333689777403,0.9856783779746591,0.951763806606982,-0.04159797004696719,68.98218964179476,320.83842381112163,269.56804218292234,218.29766055472302,298.85476357596264,7.677903681336739,285.7619653429304,15.858124902714188,294.70422061509385,281.63622828025393,5.607845472794806,21.03976357117097,86244600,7.385087856885001,0.9548722375684873,-1230480000.0,-51.53782850302786,85.04343053981948,79.70440250180728,40.00822259874328,29.849909974097447,24.70087504051159,0.013897356729643305,13.993239214188867,299.74402124023436,291.16798266601563,284.2366638183594,277.3053449707031,268.7293063964844,0.02,1.0,289.77996111315537,-0.05739884080854252,-0.04690354189777359,296.5457196916853,285.7095249720982,24.439554425100308
2022-08-10,1,293.0758361816406,232.40833282470703,309.55999755859375,246.30583381652832,295.0075054168701,-0.1442924047477415,24.557758101862625,-1.3181461331570292,2.9916341218068756,272.7700004577637,21.3463342666626,0.09023296280018203,239.66041717529296,301.7991714477539,0.8723669794801369,0.23207359278581915,1.076853225531383,1.000547659591272,0.9822541810724639,-0.04152844705921743,61.61952547277099,321.2750168980002,272.1595006942749,223.0439844905496,297.67166791643416,7.86379367162483,287.8576202392578,14.61331275506327,292.569889960497,281.73137881749625,-0.856366121962322,15.878379781304226,94918800,7.7611220676920345,1.0526792089235322,-1135561200.0,-33.569732403915644,85.04343053981948,79.70440250180728,55.18982551906524,30.29951375509247,22.915066515798824,0.02079067584526948,14.006341181447011,300.073634765625,291.7015096435547,284.93499755859375,278.1684854736328,269.7963603515625,0.02,0.0,289.7927837701933,-0.04242078696494134,-0.020726171882297233,296.12857491629467,287.32738167899,23.407959603088372
2022-08-11,1,291.80333709716797,235.29916763305664,309.55999755859375,258.4543733596802,295.0075054168701,-0.27753461167481003,23.167844207909457,-1.2346726555525165,2.992153249990855,277.1287498474121,20.121459007263184,0.08418765978344991,243.31000022888185,301.7991714477539,0.8488194162374293,0.24554557132426963,1.060359343180703,0.9881109808849283,0.9863852480902129,-0.05736096589180517,64.65332596727879,321.5285642779405,275.1928758621216,228.85718744630267,296.6760733468192,8.137593040674675,289.05851309640065,14.158336461771162,292.6553556321005,283.11273259659913,-2.7481212371863353,11.124417704937523,70155000,7.809714370424015,0.7816829800021526,-1205716200.0,-47.04410689367789,85.04343053981948,79.70440250180728,44.35209541351458,28.74078810131018,21.453655480347543,-0.053747513102825835,13.891839403281805,300.073634765625,291.7015096435547,284.93499755859375,278.1684854736328,269.7963603515625,0.02,0.0,289.794897748551,-0.07129277425551728,-0.06755656386214959,294.134765625,288.3550000871931,21.828467609396977
2022-08-12,1,293.65999603271484,240.14500045776367,309.55999755859375,263.3616666793823,295.0075054168701,-0.40093539598786193,21.51713678986245,-1.0935911246003736,2.992700379189813,282.80541610717773,18.674775810241698,0.07739473797650477,243.8769130706787,301.7991714477539,0.8414063131423046,0.21511310475310055,1.0562622094702352,0.9901944705299331,1.0047226182854407,-0.005376875764835476,62.900961579646555,321.052357915052,278.01808433532716,234.98381075560226,294.9454781668527,7.10257353753855,290.7092868259975,13.145304126655388,292.4389549899619,284.1368981146335,-2.3325982172590387,6.113840074627398,79657200,7.854660949296516,0.8826540254111575,-1126059000.0,-23.676096019959278,85.04343053981948,79.70440250180728,56.22524338400111,27.50218956178093,19.795560646571676,-0.007897571399269165,13.980042399199471,300.073634765625,291.7015096435547,284.93499755859375,278.1684854736328,269.7963603515625,0.02,0.0,289.8235068919588,0.04115620917835949,-0.02787557806321717,293.08238438197543,290.6119057791574,20.458379985050758
2022-08-15,0,306.3675079345703,243.6616668701172,309.55999755859375,267.7491693496704,295.0075054168701,-0.5433507043602468,19.90835213453842,-0.8509761883452445,2.993179981067534,287.58083724975586,17.170784397125242,0.07092550571113583,246.78683471679688,301.7991714477539,0.8218802142146931,0.2040139299945842,1.091465043760319,1.0313589829912586,1.049339745301052,0.03878920150996712,63.42235655298826,320.51053838315147,280.6938341140747,240.87712984499797,294.48940822056363,6.02912229002634,293.86148997715543,10.890247962963862,292.7754405036105,285.3104964025888,-3.961801798079371,8.542193177825366,89359200,7.85291271980117,0.9864303893045968,-1036699800.0,-8.272730056869314,85.04343053981948,79.70440250180728,100.51003533302254,32.31098544916149,18.46429803377333,0.04753328912818203,13.917420129348432,301.3779294433594,293.81269848632815,287.6983337402344,281.5839689941406,274.01873803710936,0.02,1.0,289.9326940092215,0.06506593957164508,0.0733941524480938,293.18048095703125,294.21619306291853,19.0830103269069
2022-08-16,0,308.9449920654297,243.6616668701172,309.55999755859375,270.1835403442383,296.1287536621094,-0.648201002420616,18.757875309691734,-0.5732759238133043,2.9935129535213423,290.31042098999023,15.990151062011716,0.0660914046845634,260.7237476348877,305.83349685668946,0.7453221252803124,0.25734799351051885,1.088535250328471,1.0382847115747829,1.049939895444089,0.07892887247882152,69.70131292517901,321.33291866442744,283.81716804504396,246.3014174256605,296.4461920601981,8.161781523735042,296.70851298740934,8.952912182917942,296.1932437713604,288.56385894177333,-1.0312991501491275,16.82863237871977,88136400,8.132087481065637,0.9690562233894472,-948563400.0,-19.355092657048285,85.04343053981948,79.70440250180728,97.23578573676605,31.130978998330974,17.335288064744468,-0.0012249997880710366,13.764984470440487,304.78612268066405,298.67358905029295,293.7333221435547,288.79305523681643,282.6805216064453,0.04,0.0,290.03995122238763,0.08198816341667037,0.05557399119348607,295.808096749442,296.4835728236607,17.38394983609355
2022-08-17,0,304.27083587646484,247.10750198364258,309.55999755859375,273.8804187774658,299.41875076293945,-0.6294309703120381,17.09240381081745,-0.5089232099771608,2.993934954471239,292.4395866394043,14.333233795166018,0.05953854106261585,263.5866672515869,306.62525634765626,0.6975759160045236,0.2502452964211523,1.0598767649359058,1.0190920901842544,1.0184104691488385,0.03819830334932783,70.44129134108623,321.26614192644456,287.08133430480956,252.89652668317459,297.7809535435268,8.622988560508823,298.49452536446705,7.597181130683,299.39723610221307,291.9499595472002,4.639323495289155,14.812447660497977,68766000,8.13358113149589,0.7645266568718846,-1017329400.0,-29.999965678434386,85.04343053981948,79.70440250180728,78.6094793656381,29.542243350724974,17.96199652941392,-0.013849191992270088,13.469153031027512,306.2729270019531,301.0801960449219,296.8833312988281,292.6864665527344,287.49373559570313,0.04,0.0,290.1067666075463,0.032749436290307576,0.07292939765734871,297.7471444266183,298.13333565848217,15.019975792664816
2022-08-18,0,304.3058319091797,262.2366638183594,309.55999755859375,278.1977062225342,302.0858383178711,-0.49273597814963144,14.79390874210563,-0.9798745453214983,2.9944184557477125,293.36791610717773,12.448766860961916,0.051024122932920614,268.5516696929932,306.62525634765626,0.7606345337836479,0.15369181921948144,1.0495494089636177,1.019722740718824,1.0109514813586695,0.0428456197121847,63.687658307959914,319.52731848366193,289.9395009994507,260.3516835152394,300.34690529959545,7.209031863853196,299.60083443777904,7.196766241518787,300.62589548812394,294.58911692152964,3.1680091579377443,8.953511688873688,47500500,7.667594830752577,0.5573916037290162,-969828900.0,-33.405695214177626,85.04343053981948,79.70440250180728,69.87496982610106,28.778535155983942,17.497653866584738,-0.09949452594283666,12.838974399242376,306.3327120361328,301.17696673583987,297.00999450683594,292.843022277832,287.68727697753906,0.04,0.0,290.14996050854296,0.05665837476092106,0.028921839962535816,300.538094656808,298.54190717424666,14.629170906866454
2022-08-19,0,297.1316604614258,262.2366638183594,309.55999755859375,284.5747928619385,304.27958488464355,-0.6516758429793582,13.810693049721756,-0.6765880265357902,2.9946010259578673,294.29375076293945,11.2648664855957,0.047302084403152825,270.4029144287109,306.62525634765626,0.8011230744357342,0.10660353312664476,1.017685849029747,0.9974383862971058,0.9789852860970985,0.011822054333625376,62.017204702987975,319.58934531270035,291.96795921325685,264.34657311381335,300.92630876813615,6.670085420243912,299.29898834228516,7.2060345827284324,301.5031716535403,296.35948209377415,6.272752931035397,5.362669078057289,61395300,7.368631322986138,0.7386754727373595,-1031224200.0,-50.97226195116092,85.04343053981948,79.70440250180728,22.461238517718506,27.095100053720948,21.750237864074393,-0.05645147489534134,12.662618452350412,306.3327120361328,301.17696673583987,297.00999450683594,292.843022277832,287.68727697753906,0.04,0.0,290.1758923794959,-0.011210019994135068,0.035016053589475286,300.8680943080357,298.4983346121652,13.931075699368277
2022-08-22,0,290.1308288574219,262.2366638183594,309.55999755859375,288.1991710662842,304.27958488464355,-0.87578366889796,13.28276172816866,-0.16664893072836273,2.994690596006609,295.0875053405762,10.342083091735834,0.04532205650730928,270.4029144287109,306.62525634765626,0.7686814078283793,0.09825384883064468,0.9899542044861701,0.9733217461343436,0.9537371989566663,-0.05299739253229174,55.82307778051974,319.64052383780705,293.07500038146975,266.50947692513245,300.687379019601,7.0693516852714975,298.6817261832101,7.613216891474127,300.3678906708352,296.7483864305659,1.3838821830645445,-1.4022698142922254,55843200,7.509352186055586,0.6752186233584204,-1087067400.0,-70.09627990220775,85.04343053981948,79.70440250180728,-31.29843726750115,25.489373675561104,24.00635568478065,-0.023610899146050617,12.49885939791496,306.3327120361328,301.17696673583987,297.00999450683594,292.843022277832,287.68727697753906,0.04,0.0,290.1735300782292,-0.06273980598271589,-0.033718857255383095,301.33714076450894,297.7359531947545,12.72803729699233
2022-08-23,0,293.66416931152344,262.2366638183594,309.55999755859375,289.80249786376953,304.27958488464355,-1.0423988263072543,12.26930710218795,0.6185718310098212,2.994848215932344,295.0875053405762,9.2065083694458,0.04172466149962827,278.2486633300781,306.62525634765626,0.6485452630207739,0.10637019489533946,0.9986740047372187,0.9867631587094927,0.9757684165982086,-0.04946130588409092,51.318932702016305,318.59269783779877,294.05408363342286,269.51546942904696,300.68797520228793,7.068660410237183,297.8167266845703,7.431181797594109,297.78365253843015,296.30557988548077,-0.5731628213659404,-2.8923914528718058,63984900,7.425313091579148,0.7749913292524044,-1023082500.0,-51.57633386250839,85.04343053981948,79.70440250180728,-10.68253712947577,27.59302153549572,22.496743665754853,0.019671411895076495,12.384892162199467,306.3327120361328,301.17696673583987,297.00999450683594,292.843022277832,287.68727697753906,0.04,0.0,290.191355589092,-0.032978456850239035,-0.04159662613639301,300.82618931361606,296.95428684779574,9.696711590945496
2022-08-24,0,298.70166778564453,269.086669921875,309.55999755859375,291.38521003723145,304.27958488464355,-0.8087255983139483,9.872024513164156,0.6006959420878859,2.995169296346097,295.0875053405762,7.585586280822753,0.033393688586995714,285.63641891479494,306.62525634765626,0.5479441434689426,0.09133674067460912,1.0104057644051556,1.0012273705724428,1.0026888241477403,-0.01830332530811929,52.851070110600865,315.36950793440934,295.62545890808104,275.88140988175275,299.59285518101285,6.621795703595006,297.04113170078824,6.635273234436353,296.77727174384984,296.4044513598608,0.0014211260862813711,-3.960436974191929,57259800,7.335177145551325,0.7067403155348568,-965822700.0,-49.7545255702171,85.04343053981948,79.70440250180728,20.328270179255053,29.278637534249814,21.534617345516352,-0.05525282924868561,12.014065733917946,306.3327120361328,301.17696673583987,297.00999450683594,292.843022277832,287.68727697753906,0.04,0.0,290.22477329207624,-0.022697596704386758,-0.03087989836609886,299.0799996512277,296.1302403041295,8.348787938821257
2022-08-25,0,298.24749755859375,279.26666259765625,309.55999755859375,292.75771141052246,304.27958488464355,-0.2424283677843122,7.779590911644244,-0.46761028134589466,2.9953886322319287,296.18958282470703,6.412457275390625,0.026184545058928442,288.5701713562012,306.62525634765626,0.46440045224005816,0.06959300120970253,1.0038413494013771,0.9978233879300545,1.0049215994030463,-0.01990870274347567,54.945019762981744,312.66539062455803,297.10620880126953,281.54702697798103,298.0646416800363,5.181514214594454,297.2554168701172,6.6213200536396375,297.33519649143744,297.0649573389678,-2.502171395591645,-3.5076656734027614,53230000,7.093169842116435,0.6700239190860838,-1019052700.0,-52.66184849461651,85.04343053981948,79.70440250180728,-12.060056556037825,27.293442026466966,22.999118884396754,-0.09243084001688508,11.967345650692675,306.3327120361328,301.17696673583987,297.00999450683594,292.843022277832,287.68727697753906,0.04,0.0,290.2479378252143,-0.022451837100395777,-0.026074845380095073,297.5809544154576,296.6945255824498,7.461758981696513
2022-08-26,0,293.74749755859375,286.3441696166992,309.55999755859375,293.5139560699463,304.27958488464355,0.1530175783702432,6.61619309549222,-1.0135935812580026,2.995486139584499,297.68957901000977,5.574999237060547,0.022197874666856444,289.99949645996094,306.62525634765626,0.44591057463015926,0.03265035019123049,0.9855471326783091,0.9806538262706659,0.9938165737382022,-0.011389438936182827,52.410488756272976,311.2876367403008,298.0552505493164,284.82286435833197,296.56130763462613,4.571457308364079,297.1711305890764,6.66062654896614,297.6285589856245,297.55218303114987,-3.462588739606556,1.0160940627407946,57163900,6.806094448560803,0.7372422649333283,-1076216600.0,-75.25958240396423,85.04343053981948,79.70440250180728,-62.56239596405669,24.96209982119878,23.46249842732703,-0.18240048241299578,12.15039250615686,306.3327120361328,301.17696673583987,297.00999450683594,292.843022277832,287.68727697753906,0.02,1.0,290.25640312767945,-0.02891009140563594,-0.04879981185847792,295.3085719517299,296.5278581891741,7.762464466191836
2022-08-29,1,284.02249908447266,286.3441696166992,309.55999755859375,293.6631259918213,304.27958488464355,0.1943683605646423,6.354076529983269,-0.9169783115220849,2.995505688181887,297.68957901000977,5.333924865722656,0.021300835566948464,291.63608627319337,306.62525634765626,0.518324021189259,-0.025252426414885787,0.9521315208849166,0.9481599562586261,0.9631200588751467,-0.02105370807026863,44.6402459666267,311.009903243072,298.30175018310547,285.5935971231389,293.66368865966797,5.225897452163562,297.0052969796317,6.972526933309726,296.7263023199106,297.18535220604844,-3.4585432046282643,-0.400101012144377,41864700,6.260847962626249,0.5674372066898568,-1118081300.0,-87.87046762004961,85.04343053981948,79.70440250180728,-137.52108931238394,23.84643487426293,26.50832189260136,-0.12893766620559907,11.81036298560718,306.65052844238284,301.69139837646486,297.68333435058594,293.675270324707,288.71614025878904,0.04,0.0,290.24052094561864,-0.01756843244335715,-0.039932526661134414,292.7300022670201,296.63404846191406,8.240489166966212
2022-08-30,1,281.6750030517578,284.02249908447266,309.55999755859375,293.5139560699463,304.27958488464355,0.09183407273012445,7.025026753141098,-0.80038643468338,2.9954534967009705,296.18958282470703,5.802999343872068,0.023618695704086694,289.7521629333496,306.62525634765626,0.48461452796252047,-0.04936866694624962,0.947013643976871,0.9473902997464136,0.9591330718886873,-0.04082611197638941,37.22286662289777,311.4850533536943,297.4349998474121,283.3849463411299,291.45559474400113,6.600909382904248,296.1909517560686,8.04938005072243,293.55656727107106,295.4419062459552,-6.665443346074487,-0.8107972078964816,50541800,6.586496619244709,0.7066137615329198,-1168623100.0,-87.98091519332482,85.04343053981948,79.70440250180728,-164.38559394805628,21.61757759348422,28.783736552722726,-0.14875168297907462,12.097481411031762,304.75072412109375,298.61629138183594,293.6583251953125,288.70035900878906,282.56592626953125,0.06,0.0,290.20571144911884,-0.06325894828211498,-0.04212747950500428,290.0204816545759,295.4442879813058,9.188111006180728
2022-08-31,1,277.32249450683594,281.6750030517578,309.55999755859375,292.75771141052246,304.27958488464355,-0.014848169570478562,7.807023741181476,-0.8061963231916804,2.995385677191735,295.0875053405762,6.4083028030395495,0.026323489276216614,286.11200256347655,306.62525634765626,0.5492638377098401,-0.07881358928447074,0.9350676970145317,0.9413854192525111,0.9520859845637933,-0.07157366558177636,33.434588497471296,312.1941725281393,296.58012504577636,280.9660775634134,289.6258326939174,8.524331270231896,295.1566058567592,9.462850709004782,290.59737748435214,293.86275700620985,-5.201955720795557,-3.8900624761220093,52107300,6.331326085006564,0.7430357112682549,-1220730400.0,-91.13326169759607,85.04343053981948,79.70440250180728,-176.05491654863,20.393454728230335,27.657696340990107,-0.1867880459877174,11.907661315733026,304.55248498535155,298.2954127807617,293.2383270263672,288.1812412719727,281.9241690673828,0.08,0.0,290.1586669509698,-0.07232222978236647,-0.07030905223836116,287.9771466936384,294.65714372907365,9.741141028869828
2022-09-01,1,273.36749267578125,277.32249450683594,309.55999755859375,291.38521003723145,300.0939598083496,-0.13968392971120996,8.558164338801689,-0.5249021040325923,2.9953111968957047,294.3375015258789,6.635962142944334,0.028995241967293944,283.78774948120116,306.62525634765626,0.5486458738268096,-0.10413975741699595,0.9261748527297593,0.9365270808769612,0.9524900236075458,-0.08342066601220877,29.388312810557643,312.2738703340975,295.1575416564941,278.0412129788907,286.72630746024,10.207514169073704,293.7071413312639,11.118952684944817,287.2554559696367,291.57433655397085,-4.414675407307473,-4.962534950554742,54287000,6.249669424750494,0.7841641794548176,-1275017400.0,-77.3067454022345,85.04343053981948,79.70440250180728,-176.20541048363523,18.99119396570161,29.16087821720017,-0.14476027588880622,11.873542098975118,303.21672412109376,296.13329138183593,290.4083251953125,284.68335900878907,277.59992626953124,0.1,0.0,290.1009314164054,-0.06387004152501508,-0.06710501122517068,285.220955984933,293.02357264927457,9.767265715815915
2022-09-02,1,275.67749786376953,273.36749267578125,308.9449920654297,289.1841640472412,298.36104011535645,-0.3889329925145237,9.128866756295826,-0.3206040287032552,2.995245892511182,293.7058334350586,6.904167022705076,0.031119589557484888,281.2397521972656,304.5119995117187,0.6968823338005329,-0.07410735781924971,0.9397629314545906,0.9545583999473891,0.9774861996517834,-0.061515416624850716,29.110399019763022,311.6056499249451,293.3479164123535,275.09018289976194,283.43714032854353,9.381690223561549,291.51499775477816,11.451270225566892,283.7047911278447,288.7680973402116,-6.911526415812466,-6.91020351123104,50890100,5.536504368574072,0.7697211154173293,-1224127300.0,-91.6317459997962,85.04343053981948,79.70440250180728,-145.13590256417396,20.33339935012211,26.85237259367537,-0.1215081507419416,11.97329056352205,303.21672412109376,296.13329138183593,290.4083251953125,284.68335900878907,277.59992626953124,0.1,0.0,290.0479895986753,-0.062063956090449124,-0.08734426057828268,281.38000052315846,290.2300000871931,10.92093273248718
2022-09-06,1,272.2074966430664,273.36749267578125,308.9449920654297,285.7637519836426,298.36104011535645,-0.29363415852634295,9.889919514121907,-0.7204943366072136,2.9951580014712293,293.66208267211914,7.861200561523435,0.03382679230908698,277.1579948425293,304.5119995117187,0.7704748178856476,-0.06527030294175365,0.931039574262808,0.9495974789433472,0.9777111670410724,-0.041598825725043254,32.658116871539605,312.1492550743864,292.3694160461426,272.58957701789876,279.7171401977539,7.505398922495703,288.8908909388951,11.358773134249535,281.658599361646,287.0453278947309,-7.7080821451581905,-10.01738411416498,55860000,5.588200573097459,0.8733817675067429,-1279987300.0,-80.23525046175912,85.04343053981948,79.70440250180728,-135.286716132765,19.07713651523949,27.206573155888687,-0.030763891618743395,11.850198292722082,299.29233911132815,292.8805028076172,287.6983337402344,282.5161646728516,276.1043283691406,0.12000000000000001,0.0,289.98374132005233,-0.036514267358492725,-0.04745039079428224,278.28714425223217,287.9340493338449,11.561120320184692
2022-09-07,1,278.22750091552734,272.2074966430664,308.9449920654297,283.43562507629395,298.36104011535645,-0.23543509690861225,10.794348966486902,-0.9509737687263131,2.9950430705120357,293.36791610717773,8.911984252929688,0.037064252891837714,275.4464973449707,304.5119995117187,0.7989381793117216,-0.049369515686511746,0.9553419560006428,0.9767052128081504,1.0078880782153872,-0.012239290312875184,31.65978239853804,312.8221135366115,291.2334156036377,269.6447176706639,277.499997820173,4.261144861337853,287.03065272739957,10.763188068448203,279.2810609307141,285.2294325896458,-8.731003991210864,-11.891273969763153,50028900,5.334515715632583,0.805002614747174,-1229958400.0,-55.93714997634065,85.04343053981948,79.70440250180728,-74.14427362565476,22.48414996461052,25.305984181148343,0.03465776550483698,11.830184638875336,296.8806376953125,290.9296762695312,286.1199951171875,281.3103139648438,275.3593525390625,0.12000000000000001,0.0,289.9517220913819,0.02160604874416383,-0.00393229087980669,277.6600036621094,286.48428780691967,11.549332789685836
2022-09-08,1,284.9550018310547,272.2074966430664,308.9449920654297,280.8131275177002,298.36104011535645,-0.1816820199770799,11.118260806482546,-1.1222886466017337,2.994999488744183,293.36791610717773,9.398984374999998,0.038229732969542796,275.4464973449707,304.5119995117187,0.8572301166286225,-0.05066379903429049,0.9798073473852271,1.0057720563378834,1.0348434340846964,0.02752213569184736,38.15715181552609,313.0641037815442,290.8275821685791,268.59106055561404,277.6332124982561,4.506550273067504,285.64845057896207,9.547978352796335,279.0398776057393,284.9684717991633,-5.283448121960813,-8.559260990596941,53713100,5.284154851118706,0.8939189476496789,-1176245300.0,-37.95283248237296,85.04343053981948,79.70440250180728,-27.948492853872946,24.606085440878026,23.798758662573377,0.034583663050508445,11.680884946844236,294.70069165039064,289.16631677246096,284.6933288574219,280.2203409423828,274.6859660644531,0.12000000000000001,0.0,289.9388380263686,0.04952659605801579,0.041627645122231854,278.2942897251674,285.51214599609375,11.51789040756603
2022-09-09,0,295.6125030517578,272.2074966430664,308.9449920654297,280.8131275177002,298.36104011535645,-0.07746416848478548,11.176872602399266,-1.1768152373122258,2.994990655714303,292.7316665649414,9.620804862976076,0.038484998685154745,275.4464973449707,304.5119995117187,0.8764113917062606,-0.023469009416547025,1.0178738897694917,1.048475784183349,1.0676286904120922,0.08137401473100359,46.867279865306685,312.7752856558483,290.4215404510498,268.0677952462513,279.62428392682756,8.175392264546506,285.5399393354143,9.415143141798927,280.551520058369,285.4877620393588,0.32832002731751564,-6.359007304171637,54338100,5.540753379298555,0.9163815592758883,-1121907200.0,-10.464316824541148,85.04343053981948,79.70440250180728,42.68443368620034,29.37347983977164,22.247252977145777,0.13060945719633107,11.602964287473862,294.70069165039064,289.16631677246096,284.6933288574219,280.2203409423828,274.6859660644531,0.02,1.0,289.96286050936027,0.08125266530565645,0.08733358224853696,281.43428693498885,285.7273842947824,11.6660044062391
2022-09-12,0,302.7574996948242,272.2074966430664,308.9449920654297,280.8131275177002,298.36104011535645,-0.12238258100307929,11.231119416363875,-1.2029388595013897,2.9949839867412775,293.66208267211914,9.792217330932619,0.03864644083767739,275.4464973449707,304.5119995117187,0.8552780195264805,0.006648869595521795,1.0417928406202668,1.0748220989751363,1.0761420494680443,0.09823072989597681,56.57875687175662,313.074237581507,290.6119987487793,268.14975991605155,283.2578560965402,11.821236133348835,286.44184439522877,10.437963346719945,284.3752072562086,287.4654953845946,4.948078405608105,-0.5112741628774322,48674600,6.051106556482389,0.8428905000481408,-1073232600.0,-2.69176555129717,85.04343053981948,79.70440250180728,80.448007259358,31.884443553819697,21.422115621849315,0.09075412612881925,11.189180730537378,296.108990234375,290.305490234375,285.614990234375,280.924490234375,275.120990234375,0.04,0.0,290.00422508280775,0.1266053182875868,0.0983547748789113,285.5500052315848,286.7635759626116,11.884470635285656
2022-09-13,1,293.2074966430664,272.2074966430664,308.9449920654297,280.8131275177002,299.71562576293945,-0.1741128522097934,11.525722415614363,-1.3002010786836058,2.9949461119682437,293.7058334350586,10.201604995727541,0.039598193569466804,275.4464973449707,304.5119995117187,0.8200398176773879,-0.011783260777500821,1.0073544016956137,1.0375996310859392,1.0225124714254894,0.07714703033155756,59.71569598166128,314.11831876311345,291.06687393188474,268.01542910065604,286.0921423775809,11.42653016501845,286.4092249189104,10.414343664374051,289.0125075913543,290.12130764042035,9.171634357760803,4.352061064013101,68229600,5.5478150382361004,1.2035400477961489,-1141462200.0,-33.61002604166667,85.04343053981948,79.70440250180728,21.137536282856363,29.081443140408112,25.809277816186192,0.03369703217005385,11.391383601463323,296.108990234375,290.305490234375,285.614990234375,280.924490234375,275.120990234375,0.04,0.0,290.01839008854154,0.06453607823228924,0.08112214248516615,287.6885768345424,286.4547664097377,11.100882145678755
2022-09-14,0,298.12249755859375,272.2074966430664,308.9449920654297,280.8131275177002,298.36104011535645,-0.15504143700066975,10.996952109297766,-1.1948359870445462,2.9950135992894085,293.4358329772949,9.609404487609861,0.037867135331601263,275.4464973449707,304.27433547973635,0.7888392369943862,-0.050939474102335756,1.0265612551773786,1.051574770242535,1.024644948722876,0.07150621911062172,49.91847409076454,312.40277758590514,290.4088733673096,268.414969148714,289.29857090541293,11.163108048209793,286.36785561697826,10.362780462596314,290.04703510623494,290.622554111466,7.2576310274081335,-0.1555084740258475,72628700,5.880371547682407,1.2989039240101672,-1068833500.0,-8.420302598465783,85.04343053981948,79.70440250180728,73.27328374146268,31.80472558760542,23.527802630088324,0.09803114207695907,11.603426680450298,296.4986376953125,290.62067626953126,285.8699951171875,281.11931396484374,275.2413525390625,0.06,0.0,290.06408987496854,0.06665481963649555,0.1027256415146691,292.317147391183,286.84857395717074,10.828687139403158
2022-09-15,0,303.85499572753906,272.2074966430664,304.3058319091797,280.8131275177002,298.15374755859375,-0.299375511028152,10.31677056129924,-1.254335539725175,2.995096417089792,293.4358329772949,9.148700256347661,0.035591301928667045,275.4464973449707,302.9088333129883,0.7773466443724687,-0.02020679471353391,1.048253892166692,1.0656129285155207,1.0302579111014674,0.06632624019595168,54.952957066155335,310.5012897645662,289.86774864196775,269.2342075193693,293.81964220319475,9.348742983059209,286.76839120047435,10.949049905890757,292.0375850517646,291.60145498233675,8.14175979858747,-0.1938958799073086,64795500,5.939837561340964,1.1629426286661935,-1004038000.0,-12.378963837588534,85.04343053981948,79.70440250180728,105.12610245621583,32.08630528944067,22.2867334978934,0.09306221008314966,11.374609955990937,298.8823139648438,292.5488332519531,287.42999267578125,282.3111520996094,275.9776713867187,0.08,0.0,290.1224517800511,0.0500933061784643,0.0706732003181487,296.5071454729353,287.39714486258373,10.81220651588433
2022-09-16,0,300.56749725341797,272.2074966430664,304.3058319091797,280.8131275177002,298.15374755859375,-0.30736544601904503,10.288101402315759,-1.2585439808794108,2.9950998036574523,293.4358329772949,9.13206665039063,0.035494943682601435,275.4464973449707,302.8672492980957,0.7377094946570835,-0.0014815233044077098,1.0369869007540224,1.0443660300073827,1.006215033016413,0.016761788322575022,59.13525834255783,310.423159439153,289.84695663452146,269.27075382988994,297.01107025146484,6.525797002576526,287.2555340358189,11.424828254073457,294.98186350005835,293.0494647907034,11.626240818036917,1.880149276975463,87087800,6.092233754030678,1.509419638705936,-1091125800.0,-13.301033573553124,85.04343053981948,79.70440250180728,81.18797731966633,30.41021616056903,24.4041739854701,0.18179184781986524,11.14428014675666,298.8823139648438,292.5488332519531,287.42999267578125,282.3111520996094,275.9776713867187,0.08,0.0,290.18050549746386,0.012246441262112828,0.048710488357195124,299.3142874581473,288.48714556012834,10.842461627256254
2022-09-19,0,304.1999969482422,272.2074966430664,303.85499572753906,280.8131275177002,298.15374755859375,-0.3615343088636661,10.05503050452855,-1.2695076070245628,2.9951270368060188,293.4358329772949,8.982533264160157,0.034713212453950155,275.4464973449707,300.78649749755857,0.7924559663439272,0.011563348000871266,1.0501966272304646,1.0470915784865689,1.0150082402257683,0.004764530209398599,57.59345683970679,309.7701009107905,289.6600399017334,269.5499788926763,299.7603552682059,4.2610261613077345,288.69678388323103,12.22993993611426,296.3839043856859,293.5834321621012,8.029399058101475,2.3217218024006603,60231200,5.911270339523428,1.0449909703683384,-1030894600.0,-1.746006592072766,85.04343053981948,79.70440250180728,107.13622949126469,31.98342644833767,22.531661146292713,0.2243347192120964,11.208260770019999,299.43239489746094,292.9937940063477,287.7899932861328,282.58619256591794,276.1475916748047,0.1,0.0,290.23769537691226,0.015274928360083706,0.03133347196319642,302.144287109375,290.21928841727123,11.56512844703723
2022-09-20,0,308.6374969482422,272.2074966430664,304.1999969482422,280.8131275177002,298.36104011535645,-0.3086310118959051,10.428710219945115,-1.2938186096569724,2.9950831013180026,293.4358329772949,9.265266723632816,0.03595940111770511,275.4464973449707,302.8672492980957,0.8092104322068168,0.04849249611365596,1.0642178484833513,1.0520373021998426,1.0288242468129942,0.05262484923419053,62.065383393413875,310.87087716596443,290.0134567260742,269.15603628618396,301.6210686819894,4.937969373882186,290.62267630440846,13.129029402807173,298.35667384849796,294.39001953563917,6.753696195372473,7.104189959883577,61642800,5.7045963722891715,1.0641280665874995,-969251800.0,-9.665845639654002,85.04343053981948,79.70440250180728,116.7884281295104,32.64242047635914,21.393752867667935,0.2043332030910371,10.961242059719643,302.0987474365234,295.1506079711914,289.5349884033203,283.91936883544923,276.97122937011716,0.12000000000000001,0.0,290.30959115896246,0.056824036648254195,0.014158062441636714,303.43714686802457,292.4357169015067,12.237137361461839
2022-09-21,0,305.87999725341797,272.2074966430664,308.6374969482422,280.8131275177002,299.1681251525879,-0.2679219381684736,11.191238083474673,-1.282391196687578,2.9949896001408693,293.7058334350586,10.005533447265623,0.03846595388140039,275.4464973449707,303.8894958496094,0.8090518852312861,0.050987928393929516,1.051355156581544,1.029849573332837,1.0092501411195018,0.026021181757004186,64.48416806553058,313.32126629756465,290.93879013061525,268.55631396366584,302.0671397617885,5.192228014002499,292.6624979291643,13.122110421311412,300.967350431752,295.6990694259484,4.406103856237729,9.572199735284999,62555700,5.7314039424515535,1.0812210825640598,-1031807500.0,-27.049522805636162,85.04343053981948,79.70440250180728,83.16974520721358,29.880739086190474,22.763626172800883,0.12069645834666462,11.119009313062836,302.4578283691406,295.4410687255859,289.7699890136719,284.0989093017578,277.0821496582031,0.14,0.0,290.36615245340926,-0.0059812882793373046,0.029678508764049077,302.9200003487723,294.23500279017856,12.363636183110634
2022-09-22,0,293.88999938964844,272.2074966430664,308.6374969482422,280.8131275177002,301.11499786376953,-0.2902206208629127,11.64737492487415,-1.3564416329036153,2.9949308385271616,294.6800003051758,10.494166564941406,0.039949894161542945,275.4464973449707,304.3679969787598,0.8388134361444968,0.024031768958601124,1.0080275123348652,0.9803538969978198,0.9647504577767001,-0.032795236142261874,60.34725725448087,314.8443313774583,291.54958152770996,268.25483167796165,302.1646401541574,5.001019807421487,294.12839126586914,11.889209364543145,302.22319076974156,296.6604420168293,1.0313526706163145,10.297578924265048,70545400,5.691388935239311,1.2054754539453572,-1102352900.0,-52.4552491380022,85.04343053981948,79.70440250180728,3.744179940083155,26.99195321645718,29.81816344052114,0.12139078277990424,11.429794540307824,302.4578283691406,295.4410687255859,289.7699890136719,284.0989093017578,277.0821496582031,0.02,1.0,290.3727493295425,-0.0499094770769033,-0.046330226008186426,302.4142848423549,295.05143083844865,12.322932463644861
2022-09-23,0,278.93499755859375,272.2074966430664,308.6374969482422,280.8131275177002,301.11499786376953,-0.2468491974203385,11.546416030746585,-1.3286547378102518,2.994943844822476,293.8187484741211,10.301699829101562,0.03963631781284498,275.4464973449707,304.3679969787598,0.8468875468842694,-0.014610342767718405,0.9575227657583969,0.9277021859977852,0.9216878411578575,-0.07197218559059693,48.71273307403104,314.4018301694033,291.30899810791016,268.216166046417,299.42356872558594,10.171399977423523,294.36106981549943,11.526687047507966,300.12737368443817,295.6117150653397,0.2327712471188518,7.507295952780768,63748400,6.327520071344599,1.0796262553404736,-1166101300.0,-80.04578271940463,85.04343053981948,79.70440250180728,-77.80558691801768,24.402090328557005,34.866725437366725,0.09913103261281461,11.739808515538778,302.4578283691406,295.4410687255859,289.7699890136719,284.0989093017578,277.0821496582031,0.04,0.0,290.3231069958544,-0.09236861370521421,-0.09356383021476337,298.5171421595982,295.4171447753906,12.78294143181095
2022-09-26,0,275.55999755859375,272.2074966430664,308.6374969482422,278.75812339782715,301.11499786376953,-0.056858841865488334,11.731834778193223,-1.4354882374867766,2.9949149465947524,293.4774971008301,10.670037384033202,0.04040675925409506,275.4464973449707,304.3679969787598,0.7989527354726695,-0.05042596149111144,0.9490831308079418,0.921589168968828,0.9237416961214373,-0.09414858539436921,39.21651850330903,313.8070426642966,290.34337310791017,266.87970355152373,295.3814261300223,13.267782603188213,294.60053416660855,11.056273523807322,294.80759903018884,292.56985090159804,-6.436112724511454,1.18163423567997,58076900,7.0843275096000236,0.9828153816109624,-1224178200.0,-86.89350773289921,85.04343053981948,79.70440250180728,-73.74403543626813,22.381261652518546,33.487723339735155,0.13480774295091813,11.885536428307507,303.5363500976562,297.1868115234375,292.05499267578125,286.923173828125,280.5736352539062,0.06,0.0,290.27559038822795,-0.10696604903468798,-0.09012690221789903,294.55428641183033,295.5307159423828,13.180597993138077
2022-09-27,0,283.24000549316406,272.2074966430664,308.6374969482422,278.0012493133545,301.11499786376953,0.08228340977823899,12.130828118476424,-1.5304911476612912,2.9948545888026996,289.08124923706055,11.238999938964843,0.04191224319802841,275.3407470703125,304.3679969787598,0.8124959323604114,-0.02979518014649265,0.9785996370321473,0.9559698604543246,0.9680754789856797,-0.08228906631956401,38.63338754665084,313.69565434486304,289.43399810791016,265.17234187095727,292.90607016427174,13.746704953774477,294.9585702078683,10.555079461259485,289.9518728638901,289.72864398088905,-9.312006900263997,1.231597570556012,61925200,6.798451864487599,1.0304481682085345,-1162253000.0,-70.95882336430236,85.04343053981948,79.70440250180728,-37.0716766159737,23.42602344898685,30.95168347195711,0.12523530478290038,11.940855529402938,303.5363500976562,297.1868115234375,292.05499267578125,286.923173828125,280.5736352539062,0.06,0.0,290.2485763800939,-0.08353580030178531,-0.08454396823889081,291.6385716029576,295.4764295305525,13.225118508585858
2022-09-28,0,284.36499786376953,272.2074966430664,308.6374969482422,278.0012493133545,301.11499786376953,0.08935906891432344,12.149465882951827,-1.536988952922569,2.994851741234186,289.08124923706055,11.278124618530274,0.04198231205349973,275.3407470703125,304.3679969787598,0.8250655284395686,0.005556057244876219,0.9826193342508515,0.963006547411939,0.9890922063126532,-0.07033803969804375,45.7534339220986,313.6938051942484,289.39487342834474,265.0959416624411,290.07249886649,13.05772205925299,294.9164270673479,10.599178711853437,288.23279321285133,288.51685737743736,-5.764925322462445,1.801584876096977,54664800,7.016041915013952,0.9065238864901577,-1107588200.0,-59.76085553091757,85.04343053981948,79.70440250180728,-29.136776013703745,22.017412501590403,28.828947202230328,0.17586458226689342,11.904365317630505,303.5363500976562,297.1868115234375,292.05499267578125,286.923173828125,280.5736352539062,0.06,0.0,290.2306562603028,-0.043184809712544237,-0.06776151550961725,288.60142735072543,295.3728572300502,12.929254962516334
2022-09-29,0,275.0999984741211,272.2074966430664,308.6374969482422,278.0012493133545,301.11499786376953,0.06699179858554312,12.077938298359497,-1.5125925436385346,2.9948626075122577,289.08124923706055,11.143624877929687,0.04171576156907512,275.3407470703125,304.3679969787598,0.8126154348118796,0.025394634392919748,0.9501626569460211,0.9359912632629659,0.9714051613681951,-0.06393548931420079,47.457001948762326,313.6852497656643,289.5293731689453,265.3734965722263,285.2814276559012,11.119507655990102,293.4512481689453,11.840625936252597,287.20636209705407,287.6527206974957,-6.520381092524292,-0.20705162692141837,77620600,6.940013128990416,1.260540829871826,-1185208800.0,-94.93962259114761,85.04343053981948,79.70440250180728,-98.44082154488731,19.27374721735061,31.905531238557437,0.13458237824042438,12.627624996784034,302.4672703857422,295.4563519897461,289.7899932861328,284.1236345825195,277.1127161865234,0.08,0.0,290.14855392108734,-0.07061923539078918,-0.10834440711587164,282.81285313197543,293.125,13.465883222722812
2022-09-30,0,267.36000061035156,272.2074966430664,308.6374969482422,277.5900001525879,301.11499786376953,0.059694544608054394,12.199352162637535,-1.5215125764854636,2.99484426530934,289.08124923706055,11.25474967956543,0.042151288771380316,274.92674789428713,304.3679969787598,0.7563300353761295,0.006337643811931313,0.9237841847174639,0.9186445114876669,0.9567706884995636,-0.04149711240810039,41.67592047844609,313.8169526925846,289.41824836730956,265.0195440420345,279.77857099260603,8.433733463079236,290.92285537719727,13.37981715834362,284.1286994460386,285.98136019623615,-10.866307174511999,-6.938984097721081,67726600,7.2102354863260265,1.0879914922601415,-1252935400.0,-94.58406486161259,85.04343053981948,79.70440250180728,-121.3224391091383,17.84935654178354,31.414933581568825,0.06141847163878324,12.661366510740082,301.68611096191404,294.19193292236326,288.13499450683594,282.0780560913086,274.58387805175784,0.1,0.0,290.058238273934,-0.036610565735163525,-0.08087597156542943,277.7342834472656,290.32714189801897,14.297050119058097
2022-10-03,0,248.26749801635742,267.36000061035156,308.6374969482422,277.5900001525879,301.11499786376953,-0.03804872385332856,12.65626110182898,-1.398707997988363,2.994773104430919,289.08124923706055,11.555124282836914,0.04377543642340949,274.8107482910156,304.3679969787598,0.7352149801663623,-0.030171114138333458,0.8587068477785622,0.8628885841486633,0.8958682833246998,-0.09904376463943387,36.62752753576916,314.4303959676961,289.1178737640381,263.80535156038013,273.2610707964216,12.404554323690743,287.7128554752895,17.535143017036425,279.94476556526115,284.050334339445,-12.593172809254684,-11.691700162721945,98363500,7.394346160201829,1.5221159320222082,-1351298900.0,-98.09039769493522,85.04343053981948,79.70440250180728,-210.5319255350126,15.558138153137312,38.746638114558564,0.030677726178178256,13.488412296469027,296.6215493774414,285.994210357666,277.40499114990234,268.81577194213867,258.1884329223633,0.12000000000000001,0.0,289.8026804505185,-0.12177100351425907,-0.11960191145811906,271.1357116699219,286.7749982561384,17.291571528127996
2022-10-04,0,249.86750030517578,248.26749801635742,308.6374969482422,277.56062507629395,301.11499786376953,-0.677438494218945,15.254774648217204,0.007800594499021152,2.994308074508563,289.08124923706055,12.92562427520752,0.05301447046506194,271.7227470397949,304.3679969787598,0.6567456958585578,-0.08794760953296023,0.8683571878694191,0.8856670970857958,0.9197582337938959,-0.11782412279607768,28.6380454248665,318.2569230681019,287.74737377166747,257.237824475233,269.10857118879045,14.818910960341334,284.2660699571882,19.912967870023138,272.0301725660594,280.2363200528437,-15.523665816475535,-15.327029199876257,109578500,8.475382899447544,1.6279967573331242,-1241720400.0,-88.41872686890831,85.04343053981948,79.70440250180728,-172.7550031780122,15.521478982876884,35.60165944494634,-0.002640814293392034,13.631383262225645,296.6215493774414,285.994210357666,277.40499114990234,268.81577194213867,258.1884329223633,0.12000000000000001,0.0,289.54377838208103,-0.11839965968381394,-0.09626465122326823,267.4371425083705,282.9771423339844,19.12339561141464
2022-10-05,0,241.43999862670898,248.26749801635742,308.6374969482422,277.56062507629395,301.11499786376953,-0.7967718932860754,17.062541211971272,-0.1324365040774973,2.993929266438565,289.08124923706055,14.04262409210205,0.05952802899619965,265.61075057983396,304.3679969787598,0.7609823525150824,-0.10193097561179598,0.8423391955829688,0.8740020209493456,0.9111218432581784,-0.15095036154071462,28.754909414365702,320.7554563787155,286.63037395477295,252.5052915308304,264.2342856270926,17.678702439010795,279.80785587855746,22.060979677105948,266.5104575783898,277.35088532009166,-10.42088569302315,-16.186298467439148,86982700,8.3318131898316,1.2577663540881234,-1328703100.0,-90.63703609946394,85.04343053981948,79.70440250180728,-180.5025306141188,14.223594274389054,37.14433922031346,-0.029981325744125393,13.812712925666734,294.79491168212894,283.03753408813475,273.53499603271484,264.03245797729494,252.2750803833008,0.14,0.0,289.29276122088544,-0.16330217990579532,-0.14890084300305736,262.4085693359375,278.48142787388394,21.7050387435833
2022-10-06,0,239.37500381469727,241.43999862670898,308.6374969482422,275.4449977874756,301.11499786376953,-0.8434491803048201,19.655154518534676,-0.3443762125463654,2.99329905733435,289.08124923706055,15.898399505615236,0.06901606651393619,249.70750007629394,304.3679969787598,0.7886240252925203,-0.15270833263051498,0.8405286852092639,0.8872230774593091,0.9335743741608006,-0.12986184971856518,24.204213569346365,324.1013078774015,284.790998840332,245.48068980326255,257.96785681588307,17.593127037953206,275.4369634900774,23.637186687147253,260.278584795711,273.35635994155746,-12.382058075983853,-20.54104687381754,69298400,8.231508280780343,0.9908866352330532,-1398001500.0,-93.96498000137565,85.04343053981948,79.70440250180728,-151.63894347783094,13.528218074108148,35.32839249329843,-0.08585623163884835,13.485375937270543,294.79491168212894,283.03753408813475,273.53499603271484,264.03245797729494,252.2750803833008,0.14,0.0,289.0909771870851,-0.11215088002157314,-0.17261385322678777,256.00714111328125,273.8228563581194,24.007550310317
2022-10-07,0,228.40000534057617,239.37500381469727,308.6374969482422,273.1649990081787,301.11499786376953,-0.7287127683982517,22.00592065692599,-0.769147261699481,2.9926338181454524,288.78624725341797,18.419099655151363,0.0778937558034038,247.5847480773926,304.3679969787598,0.8291124928543395,-0.1902405975947983,0.8084612554437967,0.8640028049282816,0.9163049525756253,-0.14572110704979913,20.804745435757606,326.52384025336613,282.51199893951417,238.5001576256622,249.97285788399833,16.264057733538966,270.02267837524414,25.17336244808766,255.07530773307573,269.40619494798295,-15.486866554069978,-20.35898558490088,83916800,7.647785831755941,1.175063644123054,-1481918300.0,-98.85595637362131,85.04343053981948,79.70440250180728,-163.40739399628438,12.389675826533852,39.31888619217953,-0.169540051906636,13.67284915249431,292.1399116821289,278.7400340881348,267.90999603271484,257.07995797729495,243.6800803833008,0.16,0.0,288.78647482801233,-0.15901976503593307,-0.1683009043994536,246.7585710797991,267.6799992152623,26.96338390879442
2022-10-10,0,223.06000137329102,228.40000534057617,308.6374969482422,262.9868755340576,301.11499786376953,-0.6362573332592927,24.71418573411458,-0.9098919711504405,2.991728082108966,283.8025016784668,20.805736618041994,0.08853327631959913,241.2334991455078,304.3679969787598,0.816627540715586,-0.24560083376695696,0.7990646728114525,0.8602474024941917,0.9237586459835837,-0.101533615332143,16.032782556121234,328.5797455221842,279.15137405395507,229.7230025857259,242.53857258387976,14.680860043066176,263.91000011989047,25.463937428437468,248.39796344512945,264.4374649287391,-19.680689586840238,-24.917814716665802,67925000,7.455613212511941,0.9384860882649447,-1549843300.0,-95.18021089555066,85.04343053981948,79.70440250180728,-148.45881807430698,11.81598405702352,39.462027155942216,-0.1836747052588888,13.312645947039,291.2761508178711,277.341912689209,266.07999420166016,254.81807571411133,240.8838375854492,0.18,0.0,288.5273112650515,-0.08019796894433484,-0.15943447044724907,240.2942875453404,261.55357033865795,28.87019099421358
2022-10-11,0,219.54999923706055,223.06000137329102,308.6374969482422,249.4674997329712,298.7337474822998,-0.531573857260123,26.913962816258923,-1.0470497487635897,2.9908499820138164,281.0875015258789,22.846198654174806,0.09780973665247335,238.27750396728516,304.3679969787598,0.850730002935211,-0.23924182046125797,0.7978805556814895,0.8642084585753459,0.9286105417918988,-0.12133431130934169,15.385195224203208,328.9944247703962,275.1664991378784,221.33857350536059,235.7085723876953,12.103682677283443,257.74357169015065,24.966652661409245,242.0487752329571,259.32322147098546,-18.916756593775673,-27.727510889353255,77013200,7.346569338012977,1.057635585727031,-1626856500.0,-98.26167591672088,85.04343053981948,79.70440250180728,-134.7066860882214,11.124950901520927,38.98210424362442,-0.19699818306249497,13.129599787515929,280.9255665283203,268.3272252807617,258.14500427246094,247.96278326416015,235.36444201660157,0.19999999999999998,0.0,288.21958611006073,-0.13205581349825357,-0.10684816232934748,233.3300018310547,255.53214263916016,31.236231695267417
2022-10-12,0,215.84500122070312,219.54999923706055,308.6374969482422,246.5606231689453,298.7337474822998,-0.39708589513722903,29.140756693614744,-1.219750409948127,2.9898686178653717,277.24749755859375,25.45489868164062,0.10733891140665339,227.86600494384766,304.3679969787598,0.8622398756268456,-0.2635577622117914,0.7950571670870402,0.8714724972153836,0.9369695902069792,-0.10600976454435107,13.202964466547273,329.7651376548077,271.48362426757814,213.20211088034858,231.07678713117326,12.686315527872305,252.16892896379744,24.987984307968162,236.47496419722972,255.06992229059526,-17.882256606877014,-28.223485939433314,66860700,7.062453803222074,0.9218607134887313,-1693717200.0,-92.60548382999706,85.04343053981948,79.70440250180728,-123.11519594521586,10.639372718854634,39.23608759328376,-0.20249554735904735,12.748200373480605,270.7123587036133,259.3988179016113,250.25499725341797,241.11117660522459,229.79763580322265,0.2,0.0,287.942878349693,-0.09787796314268316,-0.12908914621986495,229.7357177734375,250.4357147216797,32.39827684182611
2022-10-13,0,214.80750274658203,215.84500122070312,308.6374969482422,240.92374992370605,295.5593738555908,-0.2578899439445842,30.847383598682185,-1.3254426005483895,2.988984792476407,275.3299980163574,27.316273651123048,0.11537349929099587,222.70900115966796,304.3679969787598,0.8623458441294524,-0.2896447178566477,0.8034098965492853,0.8919595730557549,0.9536573375382628,-0.10263185661245233,10.714554715676883,329.0645166480479,267.36974945068357,205.67498225331923,226.06821605137415,10.813986568372938,247.58839362008231,25.574788008071273,231.39032128352414,250.51762446301348,-13.059501164956396,-26.555853663285372,91483000,6.67205109918313,1.2385604792481584,-1785200200.0,-81.27567017568437,85.04343053981948,79.70440250180728,-106.14217408390961,9.66169788088315,38.52927972036802,-0.1340702253603564,13.03547210822208,269.46392028808594,257.3780404663086,247.61000061035156,237.84196075439453,225.75608093261718,0.2,0.0,287.57269547685644,-0.06891195282251383,-0.07927410211964168,225.77571759905135,246.60643005371094,32.56227034556373
2022-10-14,1,214.8549995422363,214.80750274658203,308.6374969482422,236.631254196167,286.74624824523926,-0.11861149234355411,31.675199510086195,-1.3882684145004547,2.9884114284670935,271.2299995422363,28.56438625335694,0.12047587016257219,219.17949943542482,304.3679969787598,0.8760153923728329,-0.28532690756821577,0.8171958954950724,0.915066077260228,0.9751398346040979,-0.059303876889767904,10.675437075930205,326.26777382180813,262.91737480163573,199.56697578146333,222.27035903930664,9.03818135056663,243.25232233319963,25.61362381420793,227.29031969060418,246.2867831944721,-14.031435667212905,-22.990121488265718,94124500,6.714696502971505,1.2682816272547321,-1691075700.0,-99.02168568260056,85.04343053981948,79.70440250180728,-105.51239287773069,10.254070025275595,34.08424011654233,-0.2455499715764432,13.682937790170453,268.9777608642578,256.5911213989258,246.5800018310547,236.56888226318358,224.18224279785153,0.2,0.0,287.1682164360596,-0.08105079677868332,-0.13916767610178785,220.65857587541853,241.53357260567802,33.392544590220986
2022-10-17,1,215.17499923706055,214.80750274658203,308.6374969482422,227.06500434875488,283.52125358581543,0.040156813643754556,32.086986351028635,-1.3984093713285837,2.988017486019243,258.6137504577637,29.084998893737797,0.12406437477780873,215.74600105285646,304.3679969787598,0.873165453911177,-0.293704793893234,0.8319744165473985,0.9373907418803775,0.9887489100320349,-0.035349242749420196,9.391170960923555,322.8057226181339,258.63174991607667,194.45777721401942,218.8132155282157,5.232027997368448,238.3905361720494,23.83784028987665,224.1947937022012,242.52817203465906,-11.01101691338883,-22.029684480400473,79428800,6.530992757004436,1.0565983020077068,-1611646900.0,-82.09570592046079,85.04343053981948,79.70440250180728,-86.05193587959974,9.365814639707205,31.131704218903852,-0.24589212172436836,13.910584761007629,268.9777608642578,256.5911213989258,246.5800018310547,236.56888226318358,224.18224279785153,0.2,0.0,286.8530303675797,-0.016191247316315494,-0.016676384536520667,217.97571890694755,236.99143001011439,32.02789181947417
2022-10-18,0,224.19000244140625,214.80750274658203,308.6374969482422,222.1825008392334,280.0112495422363,0.18770493956456252,31.628504069068672,-1.3543077208783068,2.988018774541862,249.0674991607666,28.534299087524413,0.12443324356223735,215.14299926757812,295.0889991760254,0.857602557705365,-0.30282288651030337,0.8820110213587958,0.9909497820094114,1.0376932837593933,0.02113415267806773,8.096054972738374,317.4375081686549,254.18050003051758,190.92349189238024,218.21178654262,4.056188330234073,234.09232221330916,20.03173100361189,221.92325531189078,239.24436952893956,-10.10966232563288,-24.030858966265008,75891900,6.287908796320218,1.000070763546574,-1535755000.0,-79.83394043447144,85.04343053981948,79.70440250180728,-67.85808698378094,12.872772655404036,29.108382685588108,-0.2625977370233222,13.814829222423452,264.89035620117187,253.2848176269531,243.90499877929688,234.5251799316406,222.91964135742185,0.02,1.0,286.5781177280824,0.017043891184324478,-0.012423771927921523,217.56428963797433,232.16143035888672,29.896809924162355
2022-10-19,0,220.6374969482422,214.80750274658203,305.87999725341797,222.1825008392334,276.40374755859375,0.2964266178797379,29.651763740849542,-1.3393386704343304,2.988752344710435,244.8537483215332,26.466499176025387,0.1186269248284987,215.14299926757812,285.31749801635743,0.8556719312265292,-0.26706550132577817,0.8826978386034229,0.9864431627818272,1.0168821492531503,0.022203413099378233,22.45739661485966,309.26165278687483,249.95812530517577,190.65459782347668,217.86571448189872,3.65733294107164,230.20214353288924,16.417737029710594,222.46504576179834,237.30026483796604,-1.8432586693210546,-21.161182239169694,66571500,7.009054500175333,0.8749355345936748,-1602326500.0,-74.96150580158744,85.04343053981948,79.70440250180728,-66.31115419302785,12.513923947997645,28.29694090990905,-0.19323154264010778,13.19591236910445,258.71724645996096,248.29138592529296,239.86500549316406,231.43862506103514,221.01276452636716,0.02,0.0,286.3332862687781,0.022095321633196052,0.025588883538719687,217.43285914829798,228.8635733468192,27.69400116727471
2022-10-20,1,208.2775001525879,214.80750274658203,293.88999938964844,220.36562252044678,275.21499824523926,0.36005608346969564,27.343802909433723,-1.434076122559867,2.9896029669796698,240.40750122070312,24.53209926605225,0.11129120082202605,215.14299926757812,283.3525047302246,0.8627733497879133,-0.24925142942440112,0.8477040729471546,0.9399249469577882,0.955695098849623,-0.030399322698229425,22.202315068423307,300.38360610878436,245.69600028991698,191.00839447104957,216.25535746983118,5.019973379664146,225.98196492876326,13.458460592480861,221.98386675828124,234.9718777557639,-1.0860326415020352,-19.797347083955817,117798100,6.770978861497685,1.501570013647554,-1720124600.0,-90.48648868595157,85.04343053981948,79.70440250180728,-94.60139992927647,11.2049668737754,33.57355261550939,-0.17511861938986278,13.684775324258267,244.402,236.299,229.75,223.201,215.098,0.02,1.0,285.82165112945574,-0.06512719809627132,-0.04584793989144245,216.11571611676897,224.72285897391183,26.779756407932613
2022-10-21,1,209.8300018310547,208.2775001525879,284.36499786376953,218.6237497329712,269.29500007629395,0.4477958258445131,26.138743995284774,-1.3608688634554227,2.9899476190560987,233.88750457763672,23.139661655426032,0.10827290498695179,214.85024986267086,279.3654983520508,0.8686960523826661,-0.2533116963609537,0.8691658579985334,0.9604093790829665,0.9686234964072583,-0.023387855632346133,18.946986529845045,293.6928633186335,241.41537532806396,189.13788733749442,215.39607184273856,5.584935044478836,223.23642948695593,12.444960421459783,218.58959135400667,231.41764181779197,-5.134365348961401,-22.09848156900256,75713800,6.568863939148994,0.9578178384144616,-1644410800.0,-77.5855811866554,85.04343053981948,79.70440250180728,-80.31532251828567,10.560314331130312,31.64197385199947,-0.10485046997658942,13.483005689377256,244.402,236.299,229.75,223.201,215.098,0.02,0.0,285.5076130801522,0.04609979362412031,-0.032834199617608084,215.71571568080358,222.72571672712053,26.011987557190558
2022-10-24,1,207.29000091552734,208.2775001525879,284.36499786376953,215.67750072479248,254.24062538146973,0.6365425199010013,25.510603185655437,-1.075362705897881,2.99009673810626,226.2950038909912,22.293387088775642,0.10720536950291013,214.30975265502929,276.32799835205077,0.8740499559259136,-0.23853242963381344,0.8711123363364224,0.9569170387823259,0.9613583066578273,-0.036644583940935505,21.480787649442757,288.98133191299786,237.960125541687,186.93891917037615,214.32214300973075,6.382759421986726,220.19517953055245,10.484374276799606,216.4399837513767,228.7092096633398,-2.786721654720211,-15.48229087271433,100446800,6.673751267706108,1.2375367638362127,-1744857600.0,-73.66887857742903,85.04343053981948,79.70440250180728,-83.8900300244034,9.684565564774681,31.743869355297175,-0.05273307083358834,13.652077157224296,235.3231177368164,228.30343746948245,222.62999725341797,216.95655703735355,209.93687677001955,0.04,0.0,285.0773961493671,-0.036927311958646736,0.030538047412485506,214.22000122070312,219.99785940987724,24.912992385252416
2022-10-25,1,216.71750259399414,207.29000091552734,284.36499786376953,215.0949993133545,248.667498588562,0.8389404512969232,24.808954073815418,-0.6474582581840558,2.9902812073852214,223.62500190734863,21.26419975280762,0.10577408222678601,209.674751663208,275.9139991760254,0.8320399923732329,-0.2681471653179648,0.9239847383793983,1.0077739372362702,1.0124857022145575,-0.03333110203861611,17.63243010953941,284.1645338571646,234.54662570953369,184.92871756190277,214.58821487426758,6.44716938958179,218.4292869567871,8.53085791513003,214.20102074926575,225.865341800089,-3.499645838685355,-17.040030951462832,96507900,6.145174632365336,1.1642065818610592,-1648349700.0,-48.184390117986055,85.04343053981948,79.70440250180728,-43.842892656717176,14.616233372022887,29.36920509301477,-0.008076678213435974,13.701929227470801,233.72636053466798,227.01181973266603,221.58499908447266,216.15817843627931,209.44363763427737,0.04,0.0,284.72745741032054,0.010127597542183953,0.01399586040577052,216.71000017438615,218.68428802490234,22.152864631504375
2022-10-26,0,223.20999908447266,207.29000091552734,284.36499786376953,215.0949993133545,243.1468734741211,1.0496633507473079,22.40006057073435,-0.06598313618725982,2.9911792433396465,221.8487491607666,18.723149375915533,0.09687748498095855,209.674751663208,268.13400039672854,0.7935584374115666,-0.23788966918559792,0.965355574179006,1.0393341402317613,1.050150428118042,0.01165940591156156,30.649937401335375,276.02062170604387,231.2205005645752,186.4203794231065,215.73607199532645,7.236064470347139,217.27464376177107,6.2729536597920985,214.82891513705863,224.17181366760062,0.866865121000691,-10.239602457477794,85012500,6.758467721641737,1.0070991233128832,-1563337200.0,-27.598679551108468,85.04343053981948,79.70440250180728,-15.7809878569284,16.94536806251389,27.457759036954403,-0.03161940932468377,13.608934932001937,226.07872473144533,220.82564312744142,216.5800018310547,212.33436053466798,207.0812789306641,0.02,1.0,284.44802602720165,0.011709629715963343,0.02020980470912323,217.46571350097656,217.72071620396204,17.63573490207663
2022-10-27,0,227.88000106811523,207.29000091552734,275.0999984741211,215.0949993133545,239.8912525177002,1.131124669719188,18.8256316208052,0.2832302159710194,2.992422698551377,221.8487491607666,15.267075080871582,0.08250966281387431,209.674751663208,251.61675033569338,0.7677328619784218,-0.18862231798423573,0.9987607549579419,1.0574527050577456,1.069532772106769,0.09411722774263276,39.61057509165543,265.81401386722075,228.16275062561036,190.51148738399993,216.26321465628487,8.04388682744928,217.23750059945243,6.203162579037746,216.90985963694968,223.02452703062366,3.7341698040671845,-6.753004479422635,61638800,6.971032474659722,0.7371814459633925,-1501698400.0,-24.758662460174154,85.04343053981948,79.70440250180728,8.743470969503118,17.665406586969752,25.855976024448207,-0.01992172944515304,13.419724674963897,225.49807727050782,220.35595709228517,216.1999969482422,212.04403680419924,206.90191662597658,0.04,0.0,284.2563221603684,0.08592241250231347,0.013736277895790787,218.16571262904577,217.86500113351005,14.823432396355994
2022-10-28,0,224.78250122070312,207.29000091552734,267.36000061035156,215.0949993133545,231.14375495910645,1.1064889501612687,15.449233674221176,0.5145697498926429,2.9934448165298395,221.8487491607666,12.1977752494812,0.06841945920500293,209.674751663208,248.42749824523926,0.711083131168422,-0.1476660661733547,0.9954860866614297,1.0367897642489514,1.0359332770281555,0.07126006414319863,45.914472231571665,256.70021810375243,225.80175075531005,194.9032834068677,216.8553581237793,8.555837700571672,217.360536302839,6.343036932784439,219.63562067548185,222.78365215494551,1.6459247007115732,-0.2276726183458441,69152400,7.0520283327011954,0.8263372935602656,-1570850800.0,-15.019855487748277,85.04343053981948,79.70440250180728,7.57156016549656,16.483407410817765,27.6025030435485,0.042456836987948,13.354743945898967,225.49807727050782,220.35595709228517,216.1999969482422,212.04403680419924,206.90191662597658,0.04,0.0,284.0327595079617,0.06565939969573509,0.10247011587345466,219.09142848423548,218.26214381626673,11.547728233450364
2022-10-31,0,226.38000106811523,207.29000091552734,249.86750030517578,215.0949993133545,228.01000213623047,0.8039111183553416,12.159122065962976,-0.28518005113651945,2.994274340095391,221.8487491607666,9.481950454711917,0.05436118270149858,209.674751663208,242.12274856567385,0.7838732623798266,-0.09459553499067751,1.0121030557360908,1.0393987139387988,1.0291122670796942,0.09209320308878399,47.330084983828975,247.9911199177536,223.67287578582764,199.3546316539017,219.44142968314034,8.26174886271397,217.84839357648576,6.7725035624155145,220.89661509548273,222.5006034269428,1.8786490645483007,0.7722136809859985,61554300,5.81725388586328,0.7520840007536198,-1509296500.0,-17.802396522278627,85.04343053981948,79.70440250180728,33.02765452679134,16.31051750687723,26.3996940175227,0.1073375697654637,12.965833910233552,225.49807727050782,220.35595709228517,216.1999969482422,212.04403680419924,206.90191662597658,0.04,0.0,283.84136867393113,0.07711239425388317,0.06108930561267837,221.9857134137835,219.05071476527624,10.724803112972305
2022-11-01,0,231.63750076293945,207.29000091552734,249.86750030517578,215.0949993133545,226.75500106811523,0.861446289848543,10.805935745686996,0.2978604903374773,2.9945687506531438,221.8487491607666,8.280000495910645,0.04854887466726561,209.674751663208,239.58150329589844,0.6935960713793767,-0.09399981673636659,1.0407002463684956,1.0580944136450519,1.0350478552622653,0.06884537700167637,48.63778754365449,244.19037242978953,222.57850093841552,200.9666294470415,222.5567866734096,8.14417405074784,218.9764292580741,7.66901784716261,222.27539906956565,222.76702007222968,8.691529763063759,3.110909521652946,62688800,5.817189701720138,0.7885334550432673,-1446607700.0,-24.684326655270155,85.04343053981948,79.70440250180728,89.39384027081508,19.612231141855826,24.904445468057155,0.07808685928250723,12.762559703258548,228.24083447265627,222.57457482910158,217.99499511718753,213.41541540527348,207.74915576171878,0.06,0.0,283.66256179763155,0.024278433592880955,0.07843790449334319,223.8971426827567,219.80642918178015,8.828925735073566
2022-11-02,0,220.92749786376953,207.29000091552734,241.43999862670898,215.0949993133545,226.75500106811523,0.4448928602417434,9.099792014146546,-0.3190168164517013,2.994894165726048,221.8487491607666,7.36850051879883,0.041051631387096235,209.674751663208,232.41125106811523,0.6621660811438154,-0.04060014048842503,0.9966639008317559,1.005750809683176,0.974201629961609,-0.010225801846087235,56.3039033496611,239.8665849895968,221.6670009613037,203.4674169330106,224.5050005231585,4.847275867792586,219.41357176644462,7.587090564547758,224.59356296854048,223.5619918331636,10.392936539858178,7.316592672020409,63070300,5.728737822936836,0.8054453825512141,-1509678000.0,-57.76861525202771,85.04343053981948,79.70440250180728,-15.079784032906698,18.182108668183727,30.05073329993413,0.03303100154055177,12.783090281795728,228.24083447265627,222.57457482910158,217.99499511718753,213.41541540527348,207.74915576171878,0.06,0.0,283.44461203468967,-0.04300215317109968,-0.033450240547862144,224.42999921526228,219.3250002179827,7.721541103573696
2022-11-03,0,214.50249862670898,207.29000091552734,239.37500381469727,215.0949993133545,225.18187618255615,0.28769791781212406,7.888794546038595,-0.178951398135347,2.995094916555126,220.78249740600586,6.342875480651857,0.035753922005934385,209.674751663208,228.7237548828125,0.5620985387871621,-0.0770652977835904,0.9721771255696585,0.9763727287300978,0.9477778215975879,-0.05870415296956055,45.86824747181912,236.41896501523394,220.64137592315674,204.86378683107955,224.1885713849749,5.472362811227024,219.38839312962122,7.603948595800142,223.65341883688404,222.6589141203453,6.578945867147541,2.8490602231931956,56538800,6.160726625811067,0.7279652418189243,-1566216800.0,-56.91831416515829,85.04343053981948,79.70440250180728,-49.40938375515858,17.047523418524353,30.816021213680493,0.04867150974059016,12.660012226237683,228.24083447265627,222.57457482910158,217.99499511718753,213.41541540527348,207.74915576171878,0.06,0.0,283.23937851438586,-0.04344928223560762,-0.04153312792202857,223.4142848423549,220.06214250837053,6.582637310685322
2022-11-04,0,214.2375030517578,207.29000091552734,231.63750076293945,214.84312534332273,224.33812713623047,-0.09649415915216258,6.709942296912758,-0.8918894062906602,2.9952639850695677,220.09374809265137,5.7279749107360844,0.030583459842285356,209.674751663208,227.93200149536133,0.5752858817788022,-0.060847225870875404,0.9764799429511565,0.9724111987550134,0.9579312982993616,-0.04691200654712746,42.74135128191036,232.81763525758285,219.39775066375734,205.97786606993182,222.9067862374442,6.661404675444994,219.32142911638533,7.647908951078498,221.32569809723026,220.81199678499027,-1.0220697178459182,-0.16406456274154352,98622200,5.84768195342893,1.257901487796925,-1664839000.0,-77.11928512902944,85.04343053981948,79.70440250180728,-92.11205666612321,15.141293463426264,31.18025058366933,0.056533312157130276,13.235725742785364,228.24083447265627,222.57457482910158,217.99499511718753,213.41541540527348,207.74915576171878,0.02,1.0,282.86283313666246,-0.09211448738929762,-0.07827977877229836,220.96142796107702,219.21357073102678,7.029880233454989
2022-11-07,0,202.8224983215332,207.29000091552734,231.63750076293945,214.73125171661377,223.45499992370605,0.061635118980461125,6.4653896060283085,-0.7671327420803142,2.9952953754546923,218.13375091552734,5.535874557495118,0.029564226422667254,209.674751663208,226.53000106811524,0.5990828293212926,-0.039552130669849445,0.9274445361185868,0.9187611587733394,0.915524260372204,-0.10406176621358809,43.63313727166541,231.62040476137304,218.68962554931642,205.7588463372598,219.3271429879325,9.619378949816502,217.79517882210868,8.66591998273493,219.50742659209686,219.32045148464206,-4.019755418447562,-0.43569010741340125,93916500,5.746099471468624,1.1783494312671217,-1758755500.0,-98.96907641231843,85.04343053981948,79.70440250180728,-188.91190294759676,14.135732748700557,32.59288005012337,-0.0020771205539821553,13.164601775955276,227.78535620117188,221.83731762695314,217.02999877929688,212.2226799316406,206.27464135742187,0.04,0.0,282.45537459139354,-0.13386653930667258,-0.1375809638263477,216.96000017438615,217.56285640171595,8.425931387577489
2022-11-08,0,191.81750106811523,202.8224983215332,231.63750076293945,214.4362497329712,223.45499992370605,-0.07147851251290413,7.239519909103641,-0.5900435708618179,2.9951785418655295,216.28125190734863,6.009524612426761,0.033257969158121375,208.17875022888182,226.53000106811524,0.5355914037603522,-0.07618993839059737,0.8811993909277283,0.8706718642695825,0.8846630184692077,-0.17190653311173687,35.537749295131704,232.15679021493582,217.67775039672853,203.19871057852123,214.6178572518485,13.705063348881788,215.7366076878139,11.037381087307919,215.31356573850567,216.74656578654688,-10.995920058422387,-9.530979922022885,128803400,6.218341264996797,1.5652137985508787,-1887558900.0,-91.01677472842968,85.04343053981948,79.70440250180728,-233.84490671163732,13.33106922402783,36.19852563208566,0.037742918425471235,12.962130346181704,225.44659533691407,218.05169622802737,212.0749969482422,206.09829766845704,198.7033985595703,0.06,0.0,281.8367758350531,-0.16030200640143089,-0.15926866178994306,211.64285714285714,215.3671428135463,10.23978399854747
2022-11-09,1,185.34499740600586,191.81750106811523,231.63750076293945,213.13562774658203,223.45499992370605,-0.7059862405072145,9.151517844515057,0.5656221658935201,2.9948272467179895,215.51000022888184,6.974237365722656,0.04231111111866164,206.84325065612794,226.53000106811524,0.5653881122974704,-0.11131830719591042,0.8569237271644229,0.8509099713145014,0.887406236168831,-0.16105962726154122,29.835033350980474,234.59416117731135,216.29112548828124,197.98808979925113,208.75571387154716,16.35528349750488,214.09857177734375,13.627338426705133,209.45823932902982,213.11981826486186,-14.66528754398953,-13.062147766699708,127062700,6.595102046790107,1.4895743150606644,-2014621600.0,-99.22030320135882,85.04343053981948,79.70440250180728,-228.64328886685988,11.994955881946526,37.71260881359865,-0.052801296722870907,13.376978493548132,223.17391418457032,214.373034362793,207.25999450683594,200.1469546508789,191.34607482910155,0.08,0.0,281.18460050803856,-0.17392315625978372,-0.22048112269105502,204.50714329310827,213.24642835344588,13.357535938573085
2022-11-10,0,187.9124984741211,185.34499740600586,231.63750076293945,209.441876411438,223.45499992370605,-0.9711414809407098,11.370920987231411,0.6096775945209125,2.9943041085132314,215.01499938964844,8.400650100708008,0.05294559824775737,201.7219985961914,226.53000106811524,0.6590780875217521,-0.1371577108055411,0.8749633966426451,0.877959375162183,0.9314357171596456,-0.12396126069776703,26.965443986592234,237.50796727200918,214.76612529754638,192.02428332308358,202.50928497314453,14.391607094549785,212.53303582327706,15.3104632143013,203.44767679034416,209.11542740643392,-18.126602822023308,-11.010552138268062,132703000,6.6961417731489465,1.5189953109091043,-1881918600.0,-77.43860919223089,85.04343053981948,79.70440250180728,-164.89413472942488,11.136209504161055,35.0126767309587,-0.02391105977518531,13.379337434211264,223.17391418457032,214.373034362793,207.25999450683594,200.1469546508789,191.34607482910155,0.08,0.0,280.53822466956774,-0.1142074061433157,-0.1128476834541503,199.20714242117745,211.55214255196708,14.193259145427916
2022-11-11,0,190.27000045776367,185.34499740600586,231.63750076293945,208.03062534332275,223.45499992370605,-0.8289871504439834,12.788481889370034,-0.18687306476079257,2.993904060158596,215.01499938964844,10.065462741851801,0.05992127960163896,191.42700080871583,226.53000106811524,0.7619982936494205,-0.12539852982484978,0.8915226995559564,0.9058901698099268,0.96865502595333,-0.11187351538635049,29.947672729527806,238.99833886266345,213.42137508392335,187.84441130518326,198.12964248657227,12.376124661191602,211.31732150486536,16.39604914948557,199.58651311725774,206.36337446906862,-18.87647818026108,-10.445362038637613,114403600,6.751213855025126,1.2945053541217864,-1767515000.0,-68.72925267876808,85.04343053981948,79.70440250180728,-117.56030659219292,13.248793355784624,32.4164707587572,0.08522957570961157,13.418671042178909,223.17391418457032,214.373034362793,207.25999450683594,200.1469546508789,191.34607482910155,0.08,0.0,280.01428388899694,-0.05542970035348138,-0.08982395874407784,196.4914289202009,210.46071406773157,14.582459471237835
2022-11-14,0,191.4474983215332,185.34499740600586,231.63750076293945,206.1731252670288,223.45499992370605,-0.6389158303470274,13.737931321143385,-0.7611009610524451,2.993604109277897,214.83874893188477,11.397200241088864,0.0647428895523161,190.0342502593994,226.53000106811524,0.8146650041204608,-0.11574299462113058,0.9022365849086689,0.9267239485404026,0.9990293929568473,-0.056083521769696776,32.591060292232925,239.6679877719865,212.19212512969972,184.71626248741293,194.8360710144043,10.162497322155838,209.51232119968958,17.130339958857608,197.24947929440242,204.48439920244147,-13.876723224788517,-8.210719466733702,92226600,6.794015423839555,1.0360654036043666,-1675288400.0,-77.05706351838118,85.04343053981948,79.70440250180728,-105.75688582273457,12.555665436991012,30.72056077599328,0.057111447609564055,13.14805202569014,223.17391418457032,214.373034362793,207.25999450683594,200.1469546508789,191.34607482910155,0.08,0.0,279.59313693085414,-0.03110414464105493,-0.0796259901444124,193.0114288330078,208.21285683768136,15.203715567423897
2022-11-15,0,195.79500198364258,185.34499740600586,231.63750076293945,200.0712490081787,223.45499992370605,-0.45236220783189074,14.435905631746778,-1.1398500874711384,2.9933643130396974,214.3700008392334,12.403925380706786,0.0684147499582603,190.0342502593994,226.53000106811524,0.8337144671266252,-0.1460480117904925,0.9279131109259772,0.9640704829729032,1.0339910955525096,0.020735860353612523,31.33279639262361,239.87756134741687,211.00575008392335,182.13393882042982,192.20142800467355,5.709242330344943,207.55410712105888,17.01059657555039,195.77504649491797,203.00879676302043,-10.748126689795615,-11.660343059509417,91293800,6.379865009721914,1.016789979851044,-1583994600.0,-71.30059156918982,85.04343053981948,79.70440250180728,-71.37945747065386,14.685576583182785,29.043452534923208,0.055667989686774284,12.91390618946591,223.17391418457032,214.373034362793,207.25999450683594,200.1469546508789,191.34607482910155,0.08,0.0,279.20234699760204,0.016309435794119365,-0.01349707548911859,191.1471426827567,206.05428532191686,15.44101204606413
2022-11-16,0,189.16500091552734,185.34499740600586,231.63750076293945,194.80062675476074,221.4981231689453,-0.25017347607998797,14.46571113559328,-1.2846129290446195,2.993333337985048,212.03375244140625,12.529650344848633,0.06902040752426503,190.0342502593994,226.53000106811524,0.8628021401587785,-0.11259416603346999,0.9025650609317376,0.9481586621827582,0.9947989607550836,0.020610232609373336,37.29852401404101,238.51742233222168,209.58600006103515,180.65457778984862,190.25035694667272,3.299967040190674,204.7887499673026,16.59388581976314,195.720432202171,202.33240035886777,-8.608437274243107,-12.282154568915622,66567600,6.503337727357853,0.7414021068629836,-1650562200.0,-83.74252944556527,85.04343053981948,79.70440250180728,-97.49849476014641,13.957287362518915,31.226294585227723,0.007858053455709894,12.617198207308661,223.17391418457032,214.373034362793,207.25999450683594,200.1469546508789,191.34607482910155,0.08,0.0,278.8946758294652,0.052536753327608654,-0.022896000067639588,189.69571358816964,203.3278568812779,15.91072704968093
2022-11-17,1,183.54750061035156,185.34499740600586,231.63750076293945,191.72500038146973,221.4981231689453,-0.06092772783318878,14.88370198488093,-1.4003181078183935,2.9931651959869106,209.0537509918213,13.02463794708252,0.07155200245331741,189.0397506713867,226.53000106811524,0.877831010128031,-0.09176458918058063,0.8823874078715787,0.9348856436116393,0.9613944236845773,-0.023228885248261832,34.82174042320009,237.77977922916128,208.01237525939942,178.24497128963756,189.06892830984933,4.042289404918923,201.84339278084892,16.430811547613818,194.04504335416482,201.17217027973535,-6.733719148037865,-16.989204831983326,64336000,6.104432878952072,0.7385350910352176,-1714898200.0,-89.96349838375299,85.04343053981948,79.70440250180728,-105.7535983844169,13.463161501403281,32.92008715667864,0.017964196621650688,12.145970061987331,223.17391418457032,214.373034362793,207.25999450683594,200.1469546508789,191.34607482910155,0.08,0.0,278.5830630616385,-0.03958684460693174,0.03142069906031153,188.53428431919642,200.08857073102678,16.822341412432735
2022-11-18,1,181.74500274658203,183.54750061035156,231.63750076293945,191.15312385559082,221.4981231689453,-0.0010302856738630137,15.808815344629174,-1.4934482986281383,2.992805306538842,208.56000137329102,14.286037998199465,0.0764538673723286,187.65574836730957,226.53000106811524,0.8694300380322864,-0.1252561644729173,0.8789468428000425,0.9405338688918028,0.9563261454329799,-0.04480473900600024,30.86331698845266,238.39350597154595,206.7758752822876,175.15824459302922,188.55464335850306,4.760277005247563,198.6551786150251,15.613664102707162,191.42552578874026,199.8452292970418,-4.311389947065861,-18.344399758175527,76048900,6.1560125445745655,0.8728236264205754,-1790947100.0,-94.0180773421367,85.04343053981948,79.70440250180728,-103.83627932101236,12.764690395181622,33.82420457202649,-0.03059721902921727,11.895543581879187,223.03939605712893,214.15529739379883,206.9749984741211,199.79469955444335,190.9106008911133,0.1,0.0,278.2066998152297,-0.08052252222790623,-0.055211822105178436,188.9057137625558,196.70642852783203,17.68009796611849
2022-11-21,1,172.00749969482422,181.74500274658203,231.63750076293945,189.9937505722046,221.4981231689453,0.0832738137413813,16.69753182996782,-1.5515063027763678,2.9924293207229065,205.05624961853027,15.384875297546387,0.08130398638709174,185.16524772644044,226.53000106811524,0.8820795571823048,-0.12323314224575234,0.8375426713405839,0.9053657671768933,0.9132818246718155,-0.10154219196983083,30.17385968386379,238.76668898799957,205.37162532806397,171.97656166812837,186.28250067574638,7.88689429558512,194.39589282444544,13.971147710637426,189.0069710665726,198.2479883905534,-1.9423209203418053,-19.716846943605688,92882700,6.15091968330099,1.0706749413324537,-1883829800.0,-99.45300543504241,85.04343053981948,79.70440250180728,-126.92337441397686,11.799471619802137,36.6523390377829,-0.12085689441239468,11.949433980680658,213.63211468505858,204.82393441772462,197.70499420166016,190.5860539855957,181.77787371826173,0.12000000000000001,0.0,277.70460648629376,-0.12086934904382651,-0.14338932453171316,185.64142717633928,192.42428479875838,19.406682511841367
2022-11-22,1,168.91250228881836,172.00749969482422,231.63750076293945,188.85187530517578,221.4981231689453,0.047869969381793186,18.198067691395636,-1.446340384798323,2.9917354021401548,199.3087501525879,16.78075029373169,0.08937817942624456,183.36725082397462,226.53000106811524,0.8543374752768921,-0.2063054546310971,0.8295986251355753,0.9037333201562274,0.915753156370775,-0.13729921306709392,22.127591090950187,240.00363564982007,203.6075002670288,167.21136488423753,183.2314295087542,9.94880271160262,190.6805359976632,13.271517932156105,184.81306431553068,195.49196399116943,-8.46404518509836,-25.74280972282691,78452300,5.866580175092257,0.9138431352997993,-1962282100.0,-93.54278565996978,85.04343053981948,79.70440250180728,-120.75391563955891,11.450808338343192,36.412658329885794,-0.13703757184293153,11.43375981350544,210.20404290771484,201.79298281860352,194.99500274658203,188.19702267456054,179.78596258544923,0.14,0.0,277.2773992815668,-0.12606724996230823,-0.1101858791431968,181.91857038225447,189.20499965122767,20.108974365471777
2022-11-23,1,178.2224998474121,168.91250228881836,231.63750076293945,187.27062320709229,221.4981231689453,0.10995432503446753,19.41777301211245,-1.3392239745426833,2.9910803955223235,193.8062515258789,17.542474880218503,0.09650153248698237,180.77125244140626,226.53000106811524,0.8505613986827438,-0.24325745718544486,0.8857217739752129,0.9653751911346923,0.9952366381897658,-0.05784633000372874,18.568922682036384,240.05279627599495,201.21725025177003,162.3817042275451,181.34214401245117,9.367246519802611,188.08910751342773,11.712686041154978,180.88981433787254,192.3058142411915,-11.22483739820365,-23.543921004810894,109536700,5.483877425287876,1.2579585155182942,-1852745400.0,-70.4738859110869,85.04343053981948,79.70440250180728,-73.65466985330019,18.306471881435844,33.33769240577566,-0.07885073612373951,11.596347789729364,210.20404290771484,201.79298281860352,194.99500274658203,188.19702267456054,179.78596258544923,0.14,0.0,276.7452698086257,-0.019901568891204757,-0.05771011895058897,180.8114275251116,186.9114281790597,19.54989190582925
2022-11-25,1,183.4375,168.91250228881836,231.63750076293945,184.89562320709229,216.10874843597412,0.3041544296686411,19.34538958713238,-1.2377751923892681,2.991039294420631,191.63249969482422,17.142699966430666,0.09722870869955326,177.60099983215332,226.53000106811524,0.8625426919092107,-0.21791074683144346,0.9219453126928776,0.9974714833528242,1.0370321104658788,-0.0005993032320559255,29.975435555325177,237.65865446418178,198.967875289917,160.27709611565223,179.5767865862165,7.072974968841212,185.88910729544503,9.002435720339443,180.25163654650663,190.37327394940226,-6.907898295912912,-16.913555325261576,50672700,5.9011120150881915,0.5856310306192894,-1802072700.0,-60.96932450459839,85.04343053981948,79.70440250180728,-57.058420058777415,18.785087318933407,32.35681083126005,-0.0589961159546178,11.094465232760072,198.82043591308596,192.58477716064453,187.5449981689453,182.5052191772461,176.2695604248047,0.14,0.0,276.5089273777975,-0.0016924035687756467,-0.02172050930004917,179.15999930245536,185.15357099260603,18.709894181452647
2022-11-28,1,182.59500122070312,168.91250228881836,231.63750076293945,183.52000045776367,214.3037519454956,0.49238166632720526,18.427434316977553,-0.9872424299859617,2.991401102564886,190.85874938964844,15.806974925994876,0.0936611555513938,177.60099983215332,224.94225120544434,0.8695268476402995,-0.18393336223315915,0.9280759609862105,0.9953122048310292,1.032397592941028,0.004676873978792573,36.59461402679534,233.60061887046632,196.74575023651124,159.89088160255616,178.63821520124162,5.93255427424678,184.44428607395716,7.587724508427881,181.08234681276912,189.3156676249927,-6.311449147550237,-14.376569280830731,92905200,6.151827513591452,1.0591795716787586,-1894977900.0,-51.68930589483555,85.04343053981948,79.70440250180728,-50.45574706163506,19.77086694128974,30.357242698757826,-0.10472766995628985,10.980574857888683,192.647326171875,187.59134545898436,183.5050048828125,179.41866430664064,174.36268359375,0.02,1.0,276.08133654175344,0.015150650372108165,-0.0013648523366223686,178.58857073102678,184.14214215959822,17.217483117495966
2022-11-29,1,182.7375030517578,168.91250228881836,231.63750076293945,183.22687530517578,205.67624950408936,0.7071599273936603,17.487998376424827,-0.5738278089785958,2.9917688886803258,189.7175006866455,14.384787502288821,0.08984958929272284,177.60099983215332,221.4727481842041,0.8397938999267212,-0.19341372754140806,0.9388661437498793,1.0002737039403875,1.0322111583683797,0.06238102045533345,35.58110001673045,229.6123719893609,194.63637523651124,159.6603784836616,178.52250126429968,5.827814784121841,183.7957147870745,7.291280908580506,181.51201912671684,188.37161393742176,-3.473158175680758,-9.973004606601165,83357100,6.096936131406892,0.9386590952738908,-1811620800.0,-57.72452403864795,85.04343053981948,79.70440250180728,-54.26808007076169,18.76771264812759,28.98319443954369,-0.13920124566349273,10.741248428945639,192.647326171875,187.59134545898436,183.5050048828125,179.41866430664064,174.36268359375,0.02,0.0,275.6949165009533,0.07720263948789663,0.003551802991159573,178.25428553989954,183.39428492954798,15.418128001590231
2022-11-30,0,188.12999725341797,168.91250228881836,231.63750076293945,182.70187759399414,197.55187606811523,0.9173509096068512,16.055051760977882,0.05388523575836457,2.992329940223505,188.53874969482422,12.519699859619141,0.08342269257744861,177.60099983215332,215.14499855041504,0.7663273161726953,-0.21110570417190985,0.9775310076304747,1.034724549062037,1.049943888624713,0.113771891980738,34.10194147799764,224.56435385764914,192.45425033569336,160.34414681373758,179.4346433367048,6.829787602895885,183.99464334760393,7.374320394219416,181.85298238495986,187.40495102383508,-0.44130132848459414,-4.733665054437902,109186400,5.86563233364244,1.1981477971004395,-1702434400.0,-17.672565732192645,85.04343053981948,79.70440250180728,0.9667865672085674,22.492922158212103,26.319851072089225,-0.045526531365147935,10.98330137347214,192.647326171875,187.59134545898436,183.5050048828125,179.41866430664064,174.36268359375,0.04,0.0,275.23657026405243,0.1459007283375222,0.1598260714329864,180.32714189801897,184.6164278302874,12.824086674109697
2022-12-01,0,195.625,168.91250228881836,220.92749786376953,182.70187759399414,192.81187629699707,0.82715088272302,13.311687812872036,0.08877312053139352,2.993326514980292,188.02124786376953,9.959787311553958,0.06995883174978526,177.60099983215332,214.26400260925294,0.7689219250065019,-0.14845368244099463,1.028096260477056,1.0805026190314384,1.0688459725688784,0.0976447988749305,43.173797544535134,216.90225078596137,190.2788751602173,163.65549953447322,182.8085719517299,8.237692014116062,184.54553631373815,7.954750205542171,183.39763248436049,187.20234339687187,3.513160972980874,1.5026031920955776,80046200,5.791648523484948,0.870274365251214,-1622388200.0,-17.672565732192645,85.04343053981948,79.70440250180728,50.96827701318952,24.199699346425334,25.06972718261368,-0.0197287684240704,10.707350924455271,192.647326171875,187.59134545898436,183.5050048828125,179.41866430664064,174.36268359375,0.06,0.0,274.9236190962175,0.06277292680986779,0.14590072833752216,184.15999930245536,184.90071323939733,11.421601649210126
2022-12-02,0,193.5,168.91250228881836,214.50249862670898,182.70187759399414,192.76937580108643,0.6842521689496218,11.404500878639665,0.3574576292503422,2.993933496233645,188.02124786376953,8.455875034332275,0.06033688481672883,177.60099983215332,203.9639987945557,0.7304732257591926,-0.088005961457637,1.0237350442845203,1.0649656529862859,1.037505695200549,0.05485519591141408,52.77244303140121,211.82275202430813,189.0137502670288,166.20474850974946,186.32107162475586,6.350849316959728,184.776250566755,8.177278012715696,186.42311901881817,188.19079250462443,13.730506139021822,4.104304710173952,73645900,6.0265808252637765,0.7933118953050071,-1696034100.0,-17.21052807828291,85.04343053981948,79.70440250180728,58.69851769887118,23.33791282903984,24.65501206916231,0.0006476302039489334,10.309682954820524,192.647326171875,187.59134545898436,183.5050048828125,179.41866430664064,174.36268359375,0.06,0.0,274.634022350496,0.06562397440635626,0.06364630925951144,187.72428458077567,184.82142748151506,9.666664894505093
2022-12-05,0,185.9275016784668,168.91250228881836,214.2375030517578,182.70187759399414,192.23812580108643,0.5192426728819433,9.873316823927754,0.9109498732478309,2.9943628382707277,188.02124786376953,7.317374801635742,0.052527805878900866,177.60099983215332,196.49775161743165,0.6321788969996684,-0.0967967921412332,0.9891674591102925,1.0177143188702429,0.9862612297398584,0.018250775954899545,50.59049115692101,207.71025898354887,187.96362533569337,168.21699168783786,187.4217861720494,5.2928685849897805,184.38196509225028,7.961086909196208,188.15378038287088,188.50444547403438,14.556351589144198,1.6975873939482786,93122700,6.0290574692375785,1.0060956044015406,-1789156800.0,-53.04651396423549,85.04343053981948,79.70440250180728,-16.18969839165273,21.086498762201188,29.395514616588656,-0.0011230385327000792,10.595419714142999,192.647326171875,187.59134545898436,183.5050048828125,179.41866430664064,174.36268359375,0.06,0.0,274.22878746024685,-0.0025694359578389836,-0.002242172485731497,187.6171417236328,184.2142846243722,8.475710117355462
2022-12-06,0,180.00500106811523,168.91250228881836,202.8224983215332,182.70187759399414,191.5399990081787,-0.3029417693483633,7.821138160568828,0.14796439053971078,2.994848850402241,186.92000007629395,6.100374412536621,0.04192557898597743,177.60099983215332,195.64200019836426,0.6299032044380816,-0.08329942083783465,0.9649252749683354,0.9830456670632184,0.9514811014178554,-0.014953153775274175,45.85319329180142,202.19040158816645,186.5481252670288,170.90584894589117,186.93142918178015,5.852887638873178,183.25410788399833,7.31183076473956,187.52892340314153,187.49141430963604,4.323248656960508,-2.8832952592546572,92150800,5.736734050746194,0.9965457525972011,-1881307600.0,-58.356227735941324,85.04343053981948,79.70440250180728,-65.03828231204983,19.88535563633839,31.29493145794022,0.0501256505542258,10.432889166797453,191.1957191772461,186.4171398010254,182.55500030517578,178.69286080932616,173.91428143310546,0.06,0.0,273.80845784388714,-0.005585325978039624,-0.016947249484790636,187.182856968471,183.17142813546317,8.175544113668373
2022-12-07,0,175.16749954223633,168.91250228881836,195.79500198364258,182.38250160217285,190.56437492370605,-0.6050882118686874,6.9832993257265645,-0.0395895825420185,2.9950170585036817,185.63624954223633,5.551749610900879,0.037664650710781615,177.60099983215332,193.7125,0.6798224749345315,-0.06158197210485674,0.9447715726338127,0.9524670397591725,0.9285931988190913,-0.06890181204712764,42.92765628396568,199.37384905581104,185.4072504043579,171.44065175290478,185.87035751342773,7.27142906386034,182.25428635733468,7.397904451567858,185.61962500914916,186.06709708331826,-1.8712089577566013,-8.064557703493625,84213300,5.365275943375252,0.9332074182483715,-1965520900.0,-76.01591240624094,85.04343053981948,79.70440250180728,-105.19238359702771,18.830189860056432,31.805715755898905,0.022934957070662586,10.230540375396707,191.1957191772461,186.4171398010254,182.55500030517578,178.69286080932616,173.91428143310546,0.02,1.0,273.4098513349478,-0.10611198760111695,-0.03754912611937937,185.9142848423549,182.25142778669084,8.412776345094947
2022-12-08,0,172.4749984741211,168.91250228881836,195.79500198364258,181.31000232696533,189.44125080108643,-0.3932082400587898,7.159711747198319,-0.4078764069460372,2.9949756035634474,184.4462490081787,5.7369993209838865,0.03879030980387413,174.85149955749512,193.7125,0.6952490702047377,-0.05491110095340368,0.9344452487003952,0.9346478001126771,0.9270606468851429,-0.11833866594698483,40.148760169169925,198.8941738224606,184.57475032806397,170.25532683366734,184.4042854309082,8.867707135447983,181.46339334760393,7.828359575816695,183.0183365122917,184.43541739908918,-4.067746449142468,-7.399625356458871,97624500,5.2832304214498125,1.099761402654987,-2063145400.0,-77.84906524170475,85.04343053981948,79.70440250180728,-119.09698793615588,17.999229477717662,32.67330144835549,0.11476456873666842,9.93835887485086,191.1957191772461,186.4171398010254,182.55500030517578,178.69286080932616,173.91428143310546,0.04,0.0,272.9394343587379,-0.10919360472556949,-0.10919360472556947,184.8585706438337,181.55642809186662,8.637869276290836
2022-12-09,0,177.1875,168.91250228881836,195.79500198364258,179.55937576293945,189.44125080108643,-0.2716227486156478,7.624822348094321,-0.8022113420190946,2.9948692506407855,183.49250030517578,6.239124565124513,0.04145474100937493,172.4282485961914,193.7125,0.7060682600578134,-0.08215259828566443,0.9633354834076138,0.963184930308461,0.9766970749440116,-0.08430232558139539,37.1598488573788,199.1808950776584,183.93125038146974,168.68160568528108,182.84107153756278,9.063783046438171,181.1378574371338,7.91008172032116,180.41378310769318,182.68010284070573,-5.615981616389937,-6.032499543393952,104872300,5.251085789918813,1.2002241086397016,-1958273100.0,-60.708822825995234,85.04343053981948,79.70440250180728,-53.726893682431026,22.08693238082095,30.51458495863968,0.05923926841596512,9.881333197052985,191.1957191772461,186.4171398010254,182.55500030517578,178.69286080932616,173.91428143310546,0.04,0.0,272.4675622064646,-0.08113516118789277,-0.0803800418170765,182.62285723005022,181.4749995640346,8.567919055499909
2022-12-12,0,172.2025032043457,168.91250228881836,195.79500198364258,177.96374988555908,189.44125080108643,-0.09473150120879076,7.702710140005302,-0.9194417136605328,2.994848532055546,183.0875015258789,6.289499664306641,0.04200065498393592,172.4282485961914,193.7125,0.7307951820975062,-0.06875755729378756,0.9389705432237471,0.9392778410525109,0.9666016646235893,-0.07381908727981712,42.42110643775106,198.8004207377743,183.39500045776367,167.98958017775306,179.495000566755,7.7919825390531505,181.15178625924247,7.892920456292673,179.65151115235963,181.52407876016454,-5.816455330447927,-2.5076357961472158,109794500,5.351285978421549,1.2598797362749135,-2068067600.0,-95.01984388760243,85.04343053981948,79.70440250180728,-117.5472565857045,20.267751288286544,32.17306724384718,-0.06021600872014675,9.999095024899583,191.1957191772461,186.4171398010254,182.55500030517578,178.69286080932616,173.91428143310546,0.06,0.0,271.9401297336868,-0.08018629689631462,-0.138766258859882,178.7828587123326,181.47142900739397,8.741629535034534
2022-12-13,0,166.94499969482422,168.91250228881836,195.79500198364258,176.68249988555908,188.3887481689453,0.08161606548057401,7.900378209100073,-0.9885306381139598,2.994795703113347,182.66625213623047,6.449962348937987,0.04329173014562984,172.18300285339356,193.7125,0.6945355982111592,-0.10052361762839972,0.9148090995980113,0.91579205386607,0.9517551943853328,-0.07255354737810316,37.91111633207901,198.29238201329295,182.49162559509278,166.69086917689262,175.70142909458704,6.122556281116272,181.01125035967146,8.141218586319406,177.8199399715219,179.8730373089144,-11.973161301292931,0.11336919021987976,175862700,5.414733816569453,1.9256034923993974,-2243930300.0,-90.38325680933994,85.04343053981948,79.70440250180728,-160.76133749658996,17.785732933045303,35.395819771248654,-0.10993939393234836,10.580588196302095,189.00563946533202,182.872180267334,177.91500091552734,172.9578215637207,166.82436236572266,0.08,0.0,271.05219205395025,-0.10493832503272893,-0.11784050621880343,173.9385724748884,180.83142852783203,9.685218852199474
2022-12-14,0,158.24499893188477,166.94499969482422,195.79500198364258,174.49437427520752,186.4781255722046,0.1253891974320659,8.305994267935578,-0.8645120784273974,2.9946836763320217,182.17000198364258,6.827350215911866,0.0458220037211558,171.69799995422363,193.7125,0.6370884856391579,-0.14734800171880072,0.8729963802049857,0.8756532959177291,0.9157935175638137,-0.09660753652689558,32.723317945355134,197.87848919962846,181.2665006637573,164.65451212788616,171.74678584507532,7.252518452358481,179.58428600856237,10.166500850023603,175.08607026410942,177.91717328035782,-13.723514369599886,-1.1648057824813747,140682300,5.338513265547309,1.4998426406351348,-2384612600.0,-96.58333989380779,85.04343053981948,79.70440250180728,-190.60650746590707,17.005601070473357,34.95547524426386,-0.12417701058182097,10.275546006680527,188.62803802490234,182.260977935791,177.11499786376953,171.96901779174806,165.60195770263672,0.1,0.0,270.3104455824238,-0.09905763559776382,-0.1280169243401011,170.2742876325335,178.94571467808314,10.500439951676531
2022-12-15,0,156.32999801635742,158.24499893188477,195.625,172.40687465667725,184.14250087738037,-0.3081876935927254,9.022756980294123,-0.20164777774058118,2.9944592982767038,180.87500190734863,7.313600292205811,0.05029715843548798,168.71575202941895,189.5985008239746,0.6438793608067013,-0.16345519432238986,0.8714581026199749,0.8796025262659178,0.9227854033093191,-0.0936077727241501,28.479090279577395,197.43451447175767,179.38900051116943,161.3434865505812,168.36464255196708,8.21584971169197,177.6480358668736,11.82265869272238,170.82141738723996,175.06358416334282,-14.888869315554345,-11.209303501315144,122334500,5.461424863425606,1.2665812060364408,-2506947100.0,-90.38124573103275,85.04343053981948,79.70440250180728,-163.34464207640397,16.08447370446259,34.499422418907,-0.08934464728747399,10.088006569544987,188.14895831298827,181.48551840209961,176.0999984741211,170.71447854614257,164.05103863525392,0.12000000000000001,0.0,269.66980302630236,-0.09092483885191693,-0.09405881262172992,167.11000061035156,177.14642878941126,11.318714187977228
2022-12-16,0,155.2249984741211,156.32999801635742,195.625,172.15375232696533,183.4650001525879,-0.38360550279471783,10.026074535652628,-0.22366231673020875,2.99412754321894,179.11375045776367,8.025275344848632,0.056406355175655336,166.07499961853028,188.66699752807617,0.7310327610274046,-0.14828587969592408,0.8732905749839309,0.8931319799630528,0.9340662556872978,-0.1239506258956129,28.178345609751222,197.7993994375162,177.74725036621095,157.6951012949057,165.5157138279506,8.893422082747477,175.69303567068917,13.132139494987443,167.15833852584302,172.59899189432954,-13.152414050317978,-14.77751385820379,139032200,5.381039568508524,1.3858706527568776,-2645979300.0,-99.6112880064931,85.04343053981948,79.70440250180728,-159.66141986766223,14.844976871243034,34.12102142693426,-0.14851814933452256,10.149578401005263,187.38431701660156,180.24783630371093,174.47999572753906,168.7121551513672,161.57567443847657,0.14,0.0,268.927819439539,-0.16096066368615347,-0.13382153129125038,163.7085723876953,174.8114286150251,12.736904712775294
2022-12-19,0,151.23500061035156,155.2249984741211,195.625,171.23375034332275,182.91250228881836,-0.329888343943055,11.054284537957429,-0.5312227021569194,2.9937504133927697,177.70499992370605,8.947012901306152,0.06269048939428902,158.05349884033203,188.66699752807617,0.7827495533637433,-0.1459187535925781,0.8576761498451897,0.8897694353260991,0.9347640046118297,-0.12176073055751613,27.790295170539967,198.43969433531427,176.3311252593994,154.22255618348456,162.4814284188407,9.709245161706614,173.44285692487443,14.4636808731432,164.14790750042437,170.4998497165671,-11.384818028590232,-14.98945894663339,139390600,5.380769377443585,1.3469216031032694,-2785369900.0,-92.37290302966039,85.04343053981948,79.70440250180728,-154.7481080823037,13.854784072372093,34.83004325149787,-0.14768798442051695,10.098179420468362,186.38840032958984,178.63580166625977,172.37000274658203,166.1042038269043,158.35160516357422,0.16,0.0,268.17146253062987,-0.10695990599233407,-0.16297127862173383,160.34142848423548,172.5999995640346,13.925270275226415
2022-12-20,0,142.49500274658203,151.23500061035156,195.625,168.42062664031982,182.91250228881836,-0.30203794387898253,12.243174678895949,-0.7224279868967556,2.9932575668759345,176.17749977111816,9.967312698364259,0.0700387911899796,156.2194980621338,188.66699752807617,0.8212715760996095,-0.12076507780955617,0.8151625705534253,0.8558168482694356,0.9041790624076498,-0.1464554014372208,26.826905624221002,199.29197451037976,174.80562515258788,150.319275794796,157.5253573826381,9.80532881185956,170.18321446010046,15.963609237257298,160.88428882325078,168.03484598088286,-12.314827106350997,-17.239210296358056,159563300,5.055002812327482,1.4937263573498831,-2944933200.0,-99.77146685895832,85.04343053981948,79.70440250180728,-175.5899926991353,12.675809024397084,37.553130903278074,-0.1754637316848782,10.24902313767246,184.46263946533202,175.518680267334,168.29000091552734,161.0613215637207,152.11736236572267,0.18,0.0,267.25215738482154,-0.14383345346647558,-0.17888215327308377,154.44857134137834,168.53571428571428,16.098382377123528
2022-12-21,0,138.51499938964844,142.49500274658203,195.625,164.76999950408936,182.91250228881836,-0.4801702456428882,14.125338871579826,-0.6120297068378528,2.9923590360590486,176.17749977111816,11.590500030517578,0.08149390669076247,154.82599868774415,188.66699752807617,0.8063730421841779,-0.15639753827733752,0.7991403631556577,0.8510867041511117,0.9070697916984337,-0.1246800826276282,22.63228650667786,201.58067804833544,173.3300003051758,145.07932256201613,152.71285683768136,9.667133405993187,166.10392870221818,16.25636453020488,156.27096297251973,165.14028675189886,-19.579539896108905,-24.257160034592427,145417400,5.322722744286244,1.3199296926542947,-3090350600.0,-97.21668668392591,85.04343053981948,79.70440250180728,-160.29683017768758,12.1847163130387,37.37522033768781,-0.21523298748397557,9.900521135251878,182.00503985595702,173.1924797668457,166.06999969482422,158.94751962280273,150.13495953369141,0.19999999999999998,0.0,266.4057385959214,-0.12264027648769538,-0.1452624421704208,150.12714276994978,164.4550007411412,17.91468113003744
2022-12-22,0,130.06000137329102,138.51499938964844,195.625,157.76624870300293,182.91250228881836,-0.5549440575852378,16.026343244230226,-0.7102526821974036,2.991291157108944,176.17749977111816,13.368087825775143,0.0932793875173844,150.36100082397462,188.66699752807617,0.8390192764139657,-0.2227973487733583,0.7569984670694277,0.8175478054927406,0.8742941752265241,-0.16804194317406485,17.210384399417112,203.86281164867773,171.8101251602173,139.75743867175686,147.44357136317663,10.621999138872832,161.57250022888184,16.86290466634274,151.8519196891791,162.33338466417948,-19.562725969622914,-29.19361053564297,210090300,4.708379106856557,1.8237283041942176,-3300440900.0,-95.52239350494331,85.04343053981948,79.70440250180728,-169.62376648405487,10.889394542239618,42.86614236987103,-0.30176137294992267,10.286912854290115,174.98364376831057,164.90818345642091,156.76500320434573,148.62182295227052,138.5463626403809,0.2,0.0,265.10691503169863,-0.20498509589752734,-0.2005740048822285,145.04142870221818,159.4900005885533,20.358202934575566
2022-12-23,0,124.78999900817871,130.06000137329102,195.625,156.05374813079834,182.91250228881836,-0.5669043833746265,18.33418464204078,-0.7210801495811916,2.9897271934221634,173.8212490081787,15.616600265502928,0.10822885571860685,142.09700241088868,188.66699752807617,0.8294420244772023,-0.2909846603159604,0.7366500916987561,0.8059078738047574,0.8695803559226892,-0.19607021913430045,12.4525791692165,206.0703695205928,169.40200023651124,132.73363095242968,142.66428565979004,12.339527910447128,157.2055357524327,17.951749855401793,146.43242761259654,158.7118884243101,-22.094101883230437,-32.785529006051156,166989700,4.579855255490202,1.3799194217830575,-3467430600.0,-96.59906598080482,85.04343053981948,79.70440250180728,-155.53940045716075,10.303818508714722,41.43840402918007,-0.31707680617166784,10.094990398109156,168.86931454467776,159.72533494567872,152.3349952697754,144.94465559387208,135.80067599487305,0.2,0.0,264.0635442180042,-0.18025690588964083,-0.2189382700827954,140.23428562709265,155.25428662981307,22.37171911016727
2022-12-27,1,113.75749969482422,124.78999900817871,195.625,154.2274990081787,182.6306266784668,-0.5135150432383244,20.425603370678484,-0.8129275911788505,2.988001198925231,172.3387508392334,17.48620029449463,0.12269868060160301,137.66949958801268,188.66699752807617,0.8458334339778426,-0.3165749435969243,0.6833528913583592,0.7603894915057514,0.827814924988063,-0.24780970518911827,11.286465877290906,207.32083192827713,166.46962518692015,125.61841844556317,136.58250018528528,14.739501761269931,152.47357136862618,20.0842161504034,141.05422155148102,154.68235434533534,-21.14126838100361,-32.882441875659715,208643400,4.586485067793574,1.6454396398514348,-3676074000.0,-99.53892548448573,85.04343053981948,79.70440250180728,-167.50038484598846,9.285641203424028,45.76253371664286,-0.373348948711611,10.401776755322445,165.0973605041504,154.33132081604003,145.63000106811523,136.92868132019044,126.1626416320801,0.2,0.0,262.67365110331946,-0.27203575079312714,-0.2737801931913276,133.29571424211775,150.20285742623466,25.204711749182227
2022-12-28,1,111.89249801635742,113.75749969482422,195.625,149.05000114440918,180.68812656402588,-0.5211714848845249,23.04963752640456,-0.7412943978805835,2.9854070665323897,169.57375144958496,19.659725275039676,0.1413847489814691,129.53300113677977,188.66699752807617,0.8346806503606242,-0.3774813719403618,0.6863401963189102,0.7783298049467143,0.8612183141253438,-0.21476195052712932,9.201706419789888,209.12702516343535,163.02775011062622,116.92847505781708,130.39214297703333,14.704462367566187,147.95392840249198,21.643462899709508,134.2747026231338,149.66418021384985,-27.232456253903795,-36.80314490163663,221070500,4.849347134548032,1.6536464834659101,-3897144500.0,-93.98060720156877,85.04343053981948,79.70440250180728,-145.02719708311523,8.765138055821708,43.560328872336626,-0.3305707426923396,10.232364042403187,164.9746394958496,154.13267918395997,145.36999893188477,136.60731867980957,125.7653583679199,0.2,0.0,261.2275279903927,-0.18207549645598575,-0.24794820339894194,127.93571472167969,145.8221435546875,26.99554866221328
2022-12-29,0,120.81999969482422,111.89249801635742,195.625,141.50000190734863,177.8918752670288,-0.42432283427963174,25.100901090193382,-0.9111872291400873,2.982951980356439,162.5949993133545,21.231000232696534,0.1573867286518683,123.68674907684326,188.66699752807617,0.8509161976755771,-0.4052384008402756,0.757561030951085,0.8738956057236593,0.9759052703588087,-0.1277478956993492,6.815461740498562,209.68730203924295,159.4854998588562,109.28369767846945,126.04714284624372,11.707371686616062,144.2642856325422,21.544394306893217,128.72388088023416,145.0563244676426,-27.91592906022029,-36.1225693643141,221923300,4.387405356915943,1.5928631432797564,-3675221200.0,-81.71289867977367,85.04343053981948,79.70440250180728,-105.65741676546877,13.177201351505948,40.27243070390959,-0.3223275952938006,10.277195225913093,164.9746394958496,154.13267918395997,145.36999893188477,136.60731867980957,125.7653583679199,0.2,0.0,259.88542723870125,-0.11448721953089402,-0.11596518870127666,123.92857251848493,142.13500050136022,26.71301703465011
2022-12-30,0,121.84000015258789,111.89249801635742,195.625,136.40124988555908,175.67249965667725,-0.2490410600776913,25.543185582630677,-1.1044115066462636,2.9820443994037906,157.2874984741211,21.629000082015995,0.16361251335992402,120.11374969482422,186.68475151062012,0.8658181783966239,-0.38238977791783146,0.7804253149338543,0.905792794859219,1.0131045084222343,-0.06320160798023167,17.763777695611967,207.2063711461879,156.1199999809265,105.03362881566511,123.09642818995884,9.206847508923392,140.31089278629847,20.065646424650787,126.75363566791171,142.19209717335377,-20.11108592110227,-29.949267567059824,157777300,4.592042376785147,1.10171927498816,-3517443900.0,-78.3885389339176,85.04343053981948,79.70440250180728,-90.56315706872702,13.384469663787101,38.895405790149155,-0.283592654701325,9.880967234573932,161.05531576538087,150.96233616638182,142.80499649047852,134.64765681457519,124.55467721557616,0.2,0.0,258.9569504714634,-0.017311513325573125,-0.10460133933938996,121.84000069754464,138.1442860194615,25.814669295656742
2023-01-03,1,112.50250053405762,111.89249801635742,193.5,128.74250078201294,173.1481237411499,-0.15172403053679417,24.89111151171639,-1.2574552335268658,2.9821814911614997,155.77749824523926,21.64717492103577,0.16329455515757252,120.11374969482422,180.5972511291504,0.8662709155019799,-0.3703359165240936,0.7380564652637608,0.8583849034898954,0.9484277624792723,-0.09846541046382873,19.409869547555036,202.21297301198868,152.4307499885559,102.64852696512312,119.38035692487445,6.9093042597608765,136.0466068812779,19.08653602853176,125.5089191167707,139.53914144664517,-14.495246988224352,-31.236684217234348,231402800,4.709558041302688,1.5314757476476182,-3748846700.0,-95.08592685056963,85.04343053981948,79.70440250180728,-113.30280102718766,11.69630221545548,44.269005126576005,-0.3191297307851571,10.49946964136772,158.4332421875,148.15338165283202,139.84500122070312,131.53662078857423,121.25676025390625,0.2,0.0,257.50035607569885,-0.12220871185775162,-0.13761468057425877,117.62999943324498,133.87857110159737,25.320849733423344
2023-01-04,1,111.21499824523926,111.89249801635742,185.9275016784668,124.052499294281,172.27062702178955,-0.11251916943951648,24.46518006043015,-1.4148878543432393,2.981953784313256,153.22999954223633,21.87553745269775,0.1648809528715494,113.63199977874756,177.46925010681153,0.8572144515644596,-0.39491199785702763,0.7495238064460964,0.877153878639923,0.9574087903623091,-0.02235018751647755,16.988927917913742,197.31123513611908,148.3808750152588,99.4505148943985,116.68821362086705,5.602317079581537,132.06589249202185,17.922695192879623,122.24172801309209,136.05054583281944,-18.779553817429246,-34.66848713543062,180389000,4.80014981865532,1.1603471437751025,-3929235700.0,-84.20498302064597,85.04343053981948,79.70440250180728,-98.21252438460303,11.120298699763723,42.088905628515015,-0.24841326797447535,10.254507501956938,148.17271612548828,139.8536367492676,133.12999725341797,126.40635775756836,118.08727838134766,0.2,0.0,256.3952043816691,0.04161320787373102,-0.07722291529352539,115.95714242117745,130.49928556169783,24.856144347060514
2023-01-05,1,109.94000053405762,111.21499824523926,180.00500106811523,121.58500003814697,168.2593755722046,-0.0194199888114684,24.148867490650915,-1.4980307118609264,2.9816814694862113,146.8650016784668,21.85649995803833,0.16695237152110212,112.44150028228759,175.3694995880127,0.8689908938711153,-0.38215606463536717,0.760066442921105,0.8953589041058184,0.9505940233132777,-0.01744976219955663,17.038232793160027,192.94298482489924,144.6452498435974,96.34751486229558,114.56678526742118,4.773398257571785,128.6155354636056,17.127214127310314,119.49477332240002,132.96685110331205,-14.489468652213738,-33.38225256908533,157986300,4.807132526491398,0.9951704222804972,-4087222000.0,-89.88465602333525,85.04343053981948,79.70440250180728,-95.64306593533853,10.604809656695918,40.39537237671208,-0.2263769463405866,9.984899517689806,147.69140405273438,139.4643031616211,132.81500244140625,126.1657017211914,117.93860083007812,0.2,0.0,255.4266843881991,-0.021027440030460753,0.011365700101853468,114.12714168003627,127.18071365356445,24.30397408192699
2023-01-06,1,108.06499862670898,109.94000053405762,177.1875,119.05437469482422,160.41999912261963,0.10655959907033476,23.845380191565386,-1.5048530162643956,2.981445921706932,140.50500106811523,21.608750152587895,0.168946027564441,111.8247480392456,172.74424858093263,0.8769947703243326,-0.37237215338825497,0.765647353494376,0.9040580669411672,0.9375474350863301,-0.10557027893008386,17.00802073409046,188.8327602000253,141.14199981689453,93.45123943376375,113.753570829119,5.380536650388255,125.16803550720215,15.93563634731617,117.11729482884246,130.3462514393369,-11.899990858360235,-30.525450234683014,220911100,4.825450325693139,1.3341017067068306,-4308133100.0,-80.99020194042885,85.04343053981948,79.70440250180728,-87.22013390846598,9.667844756711785,40.58378406117615,-0.15193113797813537,10.17026396888713,147.0235236206055,138.3832424621582,131.4000015258789,124.41676058959962,115.77647943115235,0.2,0.0,254.09369518884185,-0.07190939220304926,0.0031053010111267497,114.69285583496094,123.99428503853935,23.574241393611686
2023-01-09,1,119.83999824523926,108.06499862670898,177.1875,113.44374990463257,156.80874824523926,0.25153268933130213,23.540666116665395,-1.4281519247407364,2.981239731215867,134.28750038146973,21.298625183105468,0.17084839289496542,111.08749847412109,172.22975273132323,0.8759722196622871,-0.37344542929261987,0.8697490123374161,1.0287732768676736,1.063236097600813,-0.016414986087031402,16.58763046685026,184.86820700444895,137.78687477111816,90.70554253778738,114.88892800467355,5.74831574088939,122.64053549085345,13.407259643520064,114.86457852480919,127.75305214517616,-5.0040666183648845,-30.873792619506258,190284000,4.835495590218749,1.1178652442011006,-4117849100.0,-66.39221881742108,85.04343053981948,79.70440250180728,-48.84970328224496,15.358281127052562,37.60841336590295,-0.1695367898162929,10.190959334311255,142.63815942382814,134.8359190673828,128.52999877929688,122.22407849121095,114.42183813476564,0.02,1.0,253.04608933064247,-0.027683095093855914,-0.01682813213670457,115.70142691476005,121.81857081821987,22.170765012297228
2023-01-10,1,119.39999961853027,108.06499862670898,177.1875,113.44374990463257,155.50124835968018,0.433796144836479,22.431631140949104,-1.2381133822300345,2.9821868228562862,127.42500019073486,20.19838782310486,0.16596951969698437,111.08749847412109,167.47075004577638,0.8618617850276769,-0.32365433089106593,0.883429317466439,1.0340683997966096,1.0631051791173303,0.06130974024336999,32.32005907593699,180.01838704157228,135.15512475967407,90.29186247777585,114.68607085091728,5.524836372834459,120.3666068485805,10.587645418568856,116.12116480391552,126.66755894056529,7.102799892554013,-22.79594174696106,167642500,5.647355285175757,0.9670229275444188,-4285491600.0,-63.480498117995644,85.04343053981948,79.70440250180728,-47.979197708653885,14.50019346264873,37.06787368564823,-0.17375702986702285,10.023033950762677,137.45824035644532,130.64587982177736,125.13999938964844,119.63411895751955,112.82175842285157,0.02,0.0,252.12779273901302,0.0994449597755871,-0.035151825136606606,115.27714102608817,119.60285677228656,19.662910477460677
2023-01-11,1,122.9424991607666,108.06499862670898,172.2025032043457,113.44374990463257,152.23250007629395,0.5415375526465485,20.467162911264197,-1.1438846870371557,2.9840129084636198,123.3149995803833,18.30665031433106,0.1547427278143009,111.08749847412109,159.11499900817873,0.8499141903899003,-0.30663029051997487,0.9295112257094619,1.0697419443240455,1.0813645655260358,0.10544891516940136,32.8090540079403,173.20007556312896,132.2657497406006,91.33142391807222,114.84357070922852,5.7729132192849635,118.96999944959369,8.534721872040295,116.94183651733817,125.29027026430474,-1.1753021684163905,-21.05002206059586,183810800,5.655236271753527,1.038126015897418,-4101680800.0,-45.72875711448349,85.04343053981948,79.70440250180728,-26.147249694645623,16.072602565874796,35.15242303165236,-0.1411998470178686,9.814245702212268,131.9497952270508,126.19009567260743,121.53499603271484,116.87989639282227,111.12019683837892,0.04,0.0,251.16790820680725,0.08430131892386594,0.13987051766889458,115.28285544259208,118.56142807006836,17.683514615611344
2023-01-12,1,121.81249809265137,108.06499862670898,166.94499969482422,113.44374990463257,144.6800022125244,0.6333634785143835,18.369467162871544,-1.0216906461748103,2.985957351452054,122.39124965667725,16.062800292968745,0.1415183208999296,111.08749847412109,156.52149810791016,0.8395322498984602,-0.26357483371466217,0.9384431264038429,1.051505979690689,1.0497683843030148,0.10799069948081219,38.40304259233686,166.54168386416472,129.80274953842164,93.06381521267855,116.1735703604562,6.200298487826354,117.77696364266532,6.522654605866133,118.44057885564101,124.74141558056802,0.9048744310554679,-13.721536340883665,169400900,5.791991866310579,0.9584908342113323,-4271081700.0,-37.53591204769223,85.04343053981948,79.70440250180728,-27.91264774894422,15.221936719744408,35.8974283501045,-0.07360435490383724,9.622513669968901,128.41248315429686,123.32876208496094,119.22000122070312,115.11124035644532,110.02751928710939,0.04,0.0,250.28450906245178,0.11981150679233266,0.08729319097346763,117.49142674037388,117.56071308680943,15.984890525952254
2023-01-13,1,119.29500007629395,108.06499862670898,158.24499893188477,113.44374990463257,139.51000022888184,0.7248383515737957,16.32666027299928,-0.8803729727875504,2.9877494495898635,121.82624912261963,13.92821283340454,0.12800592995152482,111.08749847412109,155.33549842834472,0.8461710487382168,-0.23022845009411932,0.9353087017182099,1.0210313088085834,1.0074570257815512,0.10391895241101112,39.24522808696062,160.19944500431154,127.54612445831299,94.89280391231443,117.32785633632115,5.866450677076159,117.0080349785941,5.520863930807437,119.29291732569689,124.06704955276798,8.27536944903314,-12.058261827668382,180714100,5.596192839173772,1.0110518874759635,-4451795800.0,-23.200276604705707,85.04343053981948,79.70440250180728,-29.500564115679342,14.311270317658504,34.80204757416704,-0.004766845135416367,9.503762628040406,122.29283569335938,118.37857604980469,115.21499633789062,112.05141662597657,108.13715698242189,0.04,0.0,249.3455239759148,0.08261103988123342,0.109298582456513,118.74285561697823,117.34999901907784,14.353226533013009
2023-01-17,1,128.4774990081787,108.06499862670898,156.32999801635742,113.44374990463257,132.17375087738037,0.9151885291200592,14.800340794183699,-0.40436208832492015,2.989001205094003,121.3162488937378,12.02682535171509,0.11783839871871576,111.08749847412109,151.6340003967285,0.8114914016321935,-0.23690269564379038,1.0229212262773564,1.1010603289397416,1.0648071411077737,0.07207527444437845,37.43057493986157,155.19930610390082,125.59862451553344,95.99794292716605,119.97607040405273,6.152700157854007,117.27142783573696,5.988820230934453,119.31444198592052,123.21879900383524,7.265208792466591,-8.276950010249468,186477000,5.597795606937486,1.0249039789728618,-4265318800.0,-0.7025475388629474,85.04343053981948,79.70440250180728,37.07648119722484,20.13672439249506,32.36575446188522,0.038374627289517446,9.48920782762268,124.64595709228516,120.2820171813965,116.75499725341797,113.22797732543947,108.8640374145508,0.06,0.0,248.45867713101853,0.09785429722458083,0.16301086443079815,121.76428549630302,117.94571358816964,12.265587062581421
2023-01-18,1,132.2574977874756,108.06499862670898,155.2249984741211,113.44374990463257,128.8731245994568,1.0039667928266665,13.050065648353636,0.11677696682532845,2.990378177378749,121.3162488937378,10.135550365447997,0.10506791696089639,111.08749847412109,143.369002532959,0.7458839640661141,-0.17231438060153495,1.0648237464417285,1.1270441049615931,1.0806631395175488,0.107684239614938,49.10946047953893,150.30613086183178,124.20599956512451,98.10586826841725,123.43214171273368,5.041215806548489,118.59285627092633,7.093039702890563,121.63240619478685,123.62018426312383,16.861468422840765,2.954964363577182,195680300,6.125886059987849,1.059000835758628,-4069638500.0,-22.655563529432364,85.04343053981948,79.70440250180728,64.17938310494804,22.416498429227648,30.01307263358464,0.04053609400488942,9.502120878484751,128.450673828125,123.35965454101563,119.2449951171875,115.13033569335938,110.03931640625001,0.08,0.0,247.5529868988392,0.08355069779271385,0.07522753935680324,124.00999995640346,119.35142789568219,10.662289477030345
2023-01-19,1,127.1825008392334,108.06499862670898,151.23500061035156,113.44374990463257,128.8731245994568,0.863640654020607,11.14081975091023,0.16905775857677208,2.9917246985382455,121.3162488937378,8.642662820816042,0.09053335616861762,111.08749847412109,138.9129997253418,0.6721608597461326,-0.12548353718575,1.0335198759456714,1.0658540531873717,1.0178101429698678,0.034487680886674754,53.98470354658059,145.3392640326127,123.05762453079224,100.77598502897177,124.48107065473285,4.931921131065021,119.68499932970319,7.158825008696235,124.28825486742991,124.00182698976504,22.38698881988165,16.26266236712399,170291900,6.198771268209652,0.9139592556046199,-4239930400.0,-27.272715338432697,85.04343053981948,79.70440250180728,52.27714151124985,21.431061741427303,30.783352269153706,0.04579744080776495,9.229112810864718,128.450673828125,123.35965454101563,119.2449951171875,115.13033569335938,110.03931640625001,0.08,0.0,246.75167464125803,0.032056459252644,0.07000420531461651,125.06714303152901,120.38428497314453,8.631237224363367
2023-01-20,1,130.7399959564209,108.06499862670898,142.49500274658203,113.44374990463257,127.50625038146973,0.49944790020032875,9.155548151297292,-0.3770653425236721,2.99293832836606,121.3162488937378,7.188000297546386,0.07513477646129632,111.08749847412109,132.8832479476929,0.6561889335104026,-0.10745992218815496,1.072914500410834,1.0811995147466236,1.0392273504914367,0.0732888496956956,50.72936158413642,140.16609584483092,121.85499954223633,103.54390323964174,126.10107013157436,4.846461788093004,120.39357049124581,7.74661108476118,124.96544302890865,123.6454247321874,6.126921479895655,13.664904344740565,138858100,6.008997350171778,0.7494175217520117,-4101072300.0,-9.348996166704596,85.04343053981948,79.70440250180728,105.34756736331505,23.14202341426517,29.238318104390903,0.12437220776912097,9.022747348370748,128.450673828125,123.35965454101563,119.2449951171875,115.13033569335938,110.03931640625001,0.08,0.0,246.12917553815774,0.07979929431186505,0.08277874409344194,127.14857155936105,121.21285629272461,8.244194699466103
2023-01-23,1,139.81750106811523,108.06499862670898,138.51499938964844,113.44374990463257,127.50625038146973,0.17766098076551456,8.131745380873962,-0.7690876328967442,2.9934892384706546,121.3162488937378,6.59449987411499,0.06705640174355514,111.08749847412109,130.89174613952636,0.5907666790341042,-0.05613112996778155,1.1529700062246455,1.1367161106010746,1.0958300379413946,0.17203152670854882,55.42849708346032,137.5307399644762,121.26724920272827,105.00375844098033,128.511784689767,6.81190435282669,121.67767769949776,9.332497664937872,126.36396790358911,123.85401242523992,9.497484400436058,8.210558091916333,203119200,6.035104905823062,1.07942725615042,-3897953100.0,-3.7411168437110836,85.04343053981948,79.70440250180728,199.23551542178234,30.184050389571002,26.532902243672744,0.17506245781292462,9.232551588894268,135.09748315429687,128.73626208496094,123.59500122070312,118.45374035644532,112.09251928710938,0.1,0.0,245.306646106143,0.1744280899343542,0.16340241858480026,130.08142852783203,122.68214198521206,8.968740126954511
2023-01-24,1,143.62250137329102,108.06499862670898,139.81750106811523,113.44374990463257,127.50625038146973,0.2556336040183246,8.273595926243521,-0.6073926203370599,2.9934166928514756,121.3162488937378,6.65962495803833,0.06818951639977708,111.08749847412109,130.89174613952636,0.5894977335427739,0.07502306313851853,1.1837112907226084,1.138266654474494,1.0905691373107904,0.11788058206323115,65.52942971993275,137.87956613913863,121.33237428665161,104.7851824341646,131.62749944414412,8.102590267287754,123.90053490230015,10.599193571279411,129.70198819264348,125.31632311218257,13.725930432959494,14.755007298927273,158699100,6.074589290948764,0.8550433823833071,-3739254000.0,-5.8402337609481565,85.04343053981948,79.70440250180728,193.79934135849217,29.777473371931066,25.39054938749141,0.21116760153816413,8.958797467849227,135.95315942382814,129.42841906738283,124.15499877929688,118.88157849121095,112.35683813476564,0.12000000000000001,0.0,244.6893140249904,0.09430369897679425,0.1755718757832362,132.98571450369698,125.23857062203544,10.240087066469737
2023-01-25,1,142.7050018310547,108.06499862670898,143.62250137329102,113.44374990463257,127.50625038146973,0.576018563728863,9.435382906055434,-0.2613568128503614,2.99277879135525,121.3162488937378,7.374599990844726,0.0773325489299731,111.08749847412109,133.01349811553956,0.6721108156225822,0.15091355489054878,1.1696124732330075,1.1100717990600801,1.059239648922245,0.07899366174587086,69.82080239782228,140.88126509876247,122.01049928665161,103.13973347454075,134.97178540910994,6.907032556302992,126.14982087271554,11.03251442719664,133.16665517404618,127.34554160094909,17.90456941786944,27.661608134489878,192734300,5.956693168504698,1.0312669492363173,-3931988300.0,-4.631924840310244,85.04343053981948,79.70440250180728,155.19570140124864,27.78760689448897,26.121635918202745,0.2564267979211413,8.914597387114116,135.95315942382814,129.42841906738283,124.15499877929688,118.88157849121095,112.35683813476564,0.12000000000000001,0.0,243.94330537266262,0.1215250352914301,0.09841042392602163,136.13285609654017,127.43785585675921,11.349030298294556
2023-01-26,1,159.10499954223633,108.06499862670898,143.62250137329102,113.44374990463257,129.04312324523926,0.5531112873788034,10.45231663849889,-0.647115529912631,2.992163075006026,121.3162488937378,8.449500160217287,0.08504300381112341,111.08749847412109,140.10625114440919,0.7602665243505402,0.25446675791826967,1.2945232669857594,1.2156068015801627,1.162933477279705,0.2509975703603671,72.59204223231528,143.8108827047932,122.90624942779542,102.00161615079764,139.34714262826103,10.74300241533008,129.66160651615687,13.105904299717624,135.54092227479845,128.85705411913332,19.62362357164098,28.314529589234976,234815100,5.2708277383640345,1.247693270827991,-3697173200.0,-1.9291962501417477,85.04343053981948,79.70440250180728,217.28025778406567,35.530605287502844,22.78172395979538,0.3474609257664459,9.491412252120147,147.35203802490236,138.648977935791,131.61499786376953,124.58101779174805,115.87795770263673,0.14,0.0,243.1894124859865,0.26028156467803254,0.24452559241852165,140.2442844935826,131.0042849949428,13.469752733058952
2023-01-27,1,170.54499435424805,108.06499862670898,159.10499954223633,117.59687519073486,131.11937141418457,0.8949900374307713,12.862442542688887,0.33128158997868384,2.990586808216097,121.82624912261963,10.251850204467775,0.10275681160684431,111.08749847412109,142.79675178527833,0.6728224168162988,0.4219451917051398,1.3624674938051287,1.2679783862286642,1.190973298570975,0.30445922922542556,80.96821839159354,150.89850950554379,125.17362442016602,99.44873933478824,144.8167849949428,15.30847575902045,134.12446335383825,15.588802959698285,141.45123800699702,132.60335397532864,23.83880505963765,44.71984606999178,306590600,6.156377771181742,1.5928821236024544,-3390582600.0,-4.227492414111876,85.04343053981948,79.70440250180728,240.32804341179505,43.88132856550848,19.548204732868843,0.39018066725744344,10.271310548996254,165.16063397216797,155.55967477416993,147.79999542236328,140.04031607055666,130.43935687255862,0.16,0.0,242.38993549131078,0.3333832734071509,0.3989148105525979,147.2614266531808,135.63571330479212,17.360952810777384
2023-01-30,1,172.74500274658203,108.06499862670898,170.54499435424805,119.37374973297119,134.1474986076355,1.1215416299955163,15.841426211183649,0.7503667184011991,2.988376421849058,122.39124965667725,12.241999702453615,0.12365849679877128,111.08749847412109,145.17075119018557,0.7267646187096339,0.4115626120263431,1.3484510222988224,1.2394282591242916,1.1428032943132007,0.23550343431202814,83.77523450909851,159.78910165942784,128.10624923706055,96.42339681469326,151.32571383884974,16.220105150812273,137.9033922467913,18.074027220907997,148.71550085822133,137.6397199145399,28.949206817973067,57.817051331638766,230878800,6.318199609081175,1.1967396760451157,-3159703800.0,-21.31993641242543,85.04343053981948,79.70440250180728,182.90406196140546,39.914590460976456,17.781106718201755,0.3065291425240898,10.48550295790743,165.16063397216797,155.55967477416993,147.79999542236328,140.04031607055666,130.43935687255862,0.16,0.0,241.78044685894244,0.15937393851902182,0.2491381048519679,152.9028560093471,138.98499952043807,19.128798729801947
2023-01-31,1,168.71750259399414,108.06499862670898,172.74500274658203,119.37374973297119,140.5393762588501,0.9917929839984203,18.471240176939055,0.05660978768525915,2.986123732373429,125.0625,14.591749954223634,0.14132277701800375,111.08749847412109,160.2489990234375,0.7993382861610373,0.417802056223265,1.290851386789597,1.1658222408095607,1.0695618714226776,0.17472889680063708,84.30070095381647,167.64497974352656,130.70249938964844,93.76001903577031,156.75107192993164,14.440751533269559,141.426071030753,18.97390944690579,154.69126431951807,141.9960718851997,35.8245054207123,44.14636621829596,196813500,6.30798667192793,1.0099475576570967,-3356517300.0,-11.462802888338034,85.04343053981948,79.70440250180728,146.03051157086728,36.804183545442996,18.911864699159928,0.3262585897985689,10.559395908976523,165.32111404418944,155.81943489074706,148.13999557495117,140.46055625915528,130.95887710571287,0.16,0.0,241.262708900303,0.20383627740264432,0.20500870414402175,158.58857073102678,142.86857114519393,21.124977070253674
2023-02-01,1,177.2599983215332,108.06499862670898,172.74500274658203,119.37374973297119,142.93437671661377,0.7607772749377135,20.10031820348333,-0.6190316305799639,2.9846644094341586,127.82999992370605,16.59328819274902,0.15107753426015297,111.08749847412109,168.90025177001954,0.8443206365745429,0.4996778008762453,1.332317389121491,1.191713927804258,1.089064797014588,0.24214285446972217,81.7521470899982,173.24701091868542,133.04637451171874,92.84573810475207,162.10000010899134,14.052312028183264,145.3058923993792,20.403253583239376,158.15252811705298,145.00561403606758,29.048116729506518,41.304441484947915,213806300,5.871957712730946,1.1021219113498948,-3142711000.0,-3.5185367668927867,85.04343053981948,79.70440250180728,149.46771244853988,39.71619768864789,17.175225349264093,0.3942821801049243,10.796582264338623,167.7124377746582,157.7537779083252,149.70499801635742,141.65621812438965,131.69755825805663,0.18,0.0,240.77316823583115,0.2560410777652078,0.2607547740052331,163.96857125418526,147.02499989100866,22.66282789593617
2023-02-02,1,188.7400016784668,108.06499862670898,177.2599983215332,119.72999858856201,147.49312591552734,0.6211024951578235,21.68360317616365,-0.9231595331573632,2.9833903470295517,129.6087474822998,18.42435066223144,0.15910571670206392,111.08749847412109,170.76499519348144,0.8298393465985892,0.5938497605391196,1.3848995941049205,1.231630614233546,1.1123651592997996,0.18626065944812442,84.69231718337869,179.65145575341984,136.28424940109252,92.91704304876521,168.54535729544503,14.504471490380585,150.08642836979456,22.233790591176614,162.9196021590885,149.0082498555076,26.779549746906874,44.181222548386586,217448300,5.907982912682076,1.1102905205467646,-2925262700.0,-10.449778888586644,85.04343053981948,79.70440250180728,159.2306470694153,44.11422864004812,15.483026263579662,0.3458034023180673,11.121111841132844,177.59859963989257,165.75069941711425,156.17499923706055,146.59929905700685,134.75139883422852,0.19999999999999998,0.0,240.36809790710268,0.17470518034303972,0.30353814179782224,170.3085719517299,151.64714322771346,24.531747438272077
2023-02-03,1,189.15499877929688,108.06499862670898,188.7400016784668,121.31937313079834,161.50812530517578,0.5828680546788813,23.691987273792165,-0.9467108623948888,2.981787731459887,131.49874687194824,20.2156005859375,0.16903469483921346,118.35950012207032,173.19650230407714,0.8086544724033994,0.7167546003421951,1.349559964154602,1.1866706117335313,1.0771832748868484,0.10912078947560899,87.64203613845137,187.54447412033826,140.1604995727539,92.77652502516955,175.18107114519393,10.886403008555927,155.07642827715193,22.62755046927096,169.3835855581458,154.1964985967697,31.41394967624908,54.943051520797106,232662000,6.052877059528352,1.1657470232958755,-2692600700.0,-12.076588536112439,85.04343053981948,79.70440250180728,140.6464842969256,41.29726470945812,14.000423720587044,0.3136780281726007,11.42031796390445,181.37315942382813,170.46841906738283,161.65499877929688,152.84157849121095,141.93683813476565,0.2,0.0,239.95567942955896,0.06790332909220731,0.18537462196962792,176.81571524483817,156.47428567068917,25.63072859050426
2023-02-06,1,193.96499633789062,108.06499862670898,189.15499877929688,122.6599988937378,169.17437553405762,0.49120610457970626,24.899434544415893,-1.1408955719074036,2.9811023884986994,136.0374994277954,21.741875162124636,0.17276726807038026,119.38949966430664,178.40799865722659,0.8246855858794997,0.750381725656599,1.3458459250872437,1.1738291502226137,1.0816485036631547,0.1228399852610409,88.35480615230061,193.92011857384762,144.12124948501588,94.32238039618413,180.16107068743025,10.262192928129021,159.75410665784563,23.459567115499546,174.32313193305143,158.4837810741485,32.54966283748997,58.5607097181983,186188100,5.953746009014207,0.941077100242919,-2506412600.0,-5.676804598433832,85.04343053981948,79.70440250180728,128.79995935336592,39.12322701240808,13.263390671125563,0.2805623729689538,11.193866680701072,181.37315942382813,170.46841906738283,161.65499877929688,152.84157849121095,141.93683813476565,0.2,0.0,239.65304549099034,0.16860668563104775,0.0947723506958744,181.74285670689173,160.99357060023718,26.66551548117569
2023-02-07,1,195.0724983215332,119.29500007629395,193.96499633789062,126.1225004196167,171.09499645233154,0.4430555637297497,25.705098917014777,-1.3143425870066396,2.9810005889136386,141.26125144958496,23.290249938964838,0.1731959878115009,119.79599838256836,188.7815013885498,0.8564002216344581,0.6185330371998403,1.3143607869679015,1.143074363635642,1.0626744865403024,0.15620783453012788,88.72330075868298,199.82644720460445,148.41624937057495,97.00605153654544,183.66499982561385,10.613000960837736,164.24089241027832,23.80054071963393,179.24276155459015,162.79583120156954,21.910057443795342,50.97195838591399,186010300,5.688764398518018,0.9411949660394169,-2320402300.0,-2.9321225998409775,85.04343053981948,79.70440250180728,113.29156754024827,37.096583363365916,12.817412395166404,0.3279428323540671,10.962161699747165,181.37315942382813,170.46841906738283,161.65499877929688,152.84157849121095,141.93683813476565,0.2,0.0,239.35689314908265,0.13618517591299484,0.18090719569172228,184.4442858014788,165.8528562273298,27.666145534505038
2023-02-08,1,198.67499923706055,119.29500007629395,195.0724983215332,128.15374946594238,173.87375164031982,0.29589179789838577,26.732236336565027,-1.4459485820180082,2.980453104515589,143.16375160217285,24.57041233062744,0.17566440881410977,121.57124824523926,189.63599853515626,0.8663809127194151,0.633773022988008,1.3055445809965656,1.130113024714593,1.0520894871420348,0.12081124403872856,89.10575567478789,205.6423470475197,152.17787437438966,98.71340170125961,187.36928503853935,10.691245483440513,169.34749943869454,22.889960569644302,183.20284086015448,166.51864365150482,14.381837508720881,47.49447221131838,180673600,5.636866955402268,0.9111877448875441,-2139728700.0,-2.2604186112041464,85.04343053981948,79.70440250180728,112.64032671729231,38.60209562331874,12.08074082526973,0.3543865585017516,10.799864609824054,185.14659963989257,174.10169941711425,165.17499923706055,156.24829905700685,145.20339883422852,0.2,0.0,239.10412847917044,0.10958596120780384,0.16204821537707495,189.39142717633928,171.14714159284318,28.36265270603426
2023-02-09,0,208.46750259399414,119.29500007629395,198.67499923706055,130.17437171936035,180.1299991607666,0.16541421893524075,27.44596187040769,-1.5123805267427055,2.980317361450856,151.36375045776367,25.256374835968025,0.1757760749814643,122.82949905395508,194.07574653625488,0.8733276079459236,0.6159993541148193,1.335118059996642,1.1492271332836763,1.079462948521372,0.10452209780698563,89.63569950008946,211.03354809613154,156.14162435531617,101.2497006145008,193.04785646711076,9.63793685820128,174.8994641985212,22.22204168674073,187.07219347444607,170.55789400144744,15.01056243491916,56.21252760880848,215431400,5.63663622269405,1.077886486626987,-1924297300.0,-8.37826794649376,85.04343053981948,79.70440250180728,122.03577614089943,42.5820713526997,11.077879774987977,0.32763703316972226,10.936303331573908,195.18372100830078,183.54314163208008,174.13500213623047,164.72686264038086,153.08628326416016,0.2,0.0,238.87572840435863,0.10118448302677563,0.14282566087352525,194.26285661969865,176.42571367536272,29.213458405519493
2023-02-10,1,199.55249786376953,119.29500007629395,208.46750259399414,131.8781223297119,188.84375095367432,0.07952214152890433,28.57945570597029,-1.4463314153460554,2.9798073611047506,163.91125106811523,25.916374969482423,0.1781563045280473,126.6455005645752,195.43274841308593,0.8531044941851855,0.7113802430636668,1.243954256669887,1.0709383723230157,1.0126124557726377,0.05496814332992761,91.68080567854801,217.5767859389181,160.41787452697753,103.25896311503695,196.2324992588588,6.823967665430622,179.1662496839251,20.646847947125718,192.39682651877803,175.2319633977047,23.560092692727533,59.45197264919748,204754100,5.642537799885164,1.0154826132647743,-2129051400.0,-22.533915791893648,85.04343053981948,79.70440250180728,88.148544299129,38.658367830887926,17.643229614361942,0.26921756673843394,11.185853660414542,196.08052172851563,184.99474279785156,176.03500366210938,167.0752645263672,155.98948559570312,0.2,0.0,238.59066185788444,0.03637226980476105,0.04578528135959868,196.47428458077567,180.22142791748047,28.754425769174095
2023-02-13,1,193.24250030517578,119.29500007629395,208.46750259399414,137.92750024795532,190.3574981689453,-0.07465826416605516,28.35019756972272,-1.4580374056135668,2.980664331596273,169.6312484741211,25.55413731575012,0.17254629634887966,128.34799919128417,198.76274909973145,0.8649563615958441,0.6727649753648325,1.1761215294127294,1.0211773744867234,0.9703534905250698,-0.0037248784386655354,80.08763409467164,221.00526965497886,164.30487451553344,107.60447937608801,196.87571334838867,6.182040000263011,182.71053532191686,18.188575514028177,194.17001789161247,178.04642346088147,12.576159174840903,42.72354772422449,172475500,6.216561886952436,0.8571472943532682,-2301526900.0,-25.497171707915438,85.04343053981948,79.70440250180728,67.70240749164205,36.339307332366474,19.997980233682807,0.2542861450571894,11.049721168878188,196.08052172851563,184.99474279785156,176.03500366210938,167.0752645263672,155.98948559570312,0.02,1.0,238.3191666984093,-0.0006161178916199717,0.024528917606633574,197.38428388323103,183.84642791748047,27.56745532336099
2023-02-14,1,200.1125030517578,127.1825008392334,208.46750259399414,141.98312664031982,193.4231243133545,-0.20685153359950706,27.030316123425642,-1.4522464643319917,2.9825542301812495,171.64499855041504,24.011049880981442,0.1608925844715261,130.51374626159668,198.76274909973145,0.8895466982124692,0.5040960619327919,1.1911299022196964,1.0461498026726923,1.0055803629577815,0.025836572420973924,71.62579055387737,222.06288177382888,168.00224952697755,113.94161728012622,198.44107110159737,5.212495743353053,186.81107112339564,14.591092875546062,193.95179679240823,179.97970466369588,2.385556101869353,34.548903171458356,216455700,6.52128309314202,1.0677606390826804,-2085071200.0,-8.018230181541968,85.04343053981948,79.70440250180728,88.94271569246094,40.066788035121576,17.513264453893324,0.2597053572455133,11.716170005714837,200.01935870361328,191.37031790161132,184.37999725341797,177.38967660522462,168.74063580322266,0.02,0.0,238.05680988477678,0.0632081835055287,0.07439929093166772,200.13714163643974,188.47642844063895,27.46460469921513
2023-02-15,0,211.69250106811523,127.1825008392334,208.46750259399414,143.39312648773193,194.24187183380127,-0.3750449368867901,26.29167509144547,-1.3223037297071367,2.983683827689054,175.00250053405762,22.956350221633908,0.15322917715490136,132.10574760437012,199.60849838256837,0.8762341414849929,0.5130522382429944,1.2337543209289303,1.0888173746342755,1.058409581631485,0.0655215899385615,74.16985035095497,224.1673499120474,171.5839997291565,119.00064954626558,200.97357177734375,6.75389892834105,190.567321232387,13.64840715482951,195.45258508893306,182.44903849017294,5.792870578718348,40.22809325819329,181006400,6.566886022609494,0.896135103482493,-1904064800.0,-0.7851899903037606,85.04343053981948,79.70440250180728,105.53387769993189,40.945989119664105,16.582403667101232,0.33175996406733843,11.490015223249298,202.03636236572262,194.22682156372068,187.91500091552734,181.60318026733398,173.79363946533203,0.02,1.0,237.8946613923016,0.06433510178830848,0.08856261445448738,202.92000034877233,192.33142852783203,26.863205796121807
2023-02-16,0,208.07749557495117,127.1825008392334,211.69250106811523,155.234375,195.97312355041504,-0.4920051760700232,26.04963120627732,-1.0777518749632948,2.9843691801622643,183.0,22.48217487335205,0.14838381096675227,138.9097505569458,200.94800300598146,0.8225765212551426,0.6644782078605903,1.1852502450164666,1.0516001650356017,1.0269675740858983,-0.0018708288543300977,79.60975592493519,227.65501230574307,175.55574989318848,123.45648748063388,202.83142852783203,6.647963947198037,193.24821417672294,13.08763140825391,199.4572139214556,186.25395254959656,9.139538094462656,33.05207358485232,229586500,6.465034265094465,1.1202054819668636,-2133651300.0,-28.44906506190284,85.04343053981948,79.70440250180728,86.18799650601157,37.02689950777889,17.580299724313946,0.2720751272915772,11.798585390110338,204.70067504882815,196.68965576171877,190.21499633789062,183.7403369140625,175.72931762695313,0.04,0.0,237.6570870540925,-0.025467942560067347,0.003725967633839991,203.6671425955636,194.0557141985212,24.637368421738618
2023-02-17,0,203.56000137329102,130.7399959564209,211.69250106811523,166.3143768310547,198.8943738937378,-0.5907655165533103,24.456245040019773,-0.9086683820585404,2.9861454153845566,188.94750022888184,21.11469988822937,0.1361702505861969,142.41625175476074,208.11649627685546,0.8173937874364235,0.5915366529788552,1.1334044270070502,1.0188124552416664,1.0050583813835021,0.02008245224901839,75.21482070515879,228.51298971001393,179.60049962997437,130.6880095499348,203.52928597586495,6.390336802248104,195.44928550720215,11.912645229174656,201.60104416517905,189.3821574112423,6.6667507543693585,22.007389523695064,213738500,6.710740105573138,1.0241699626149465,-2347389800.0,-17.02204696381499,85.04343053981948,79.70440250180728,73.59508225512042,34.56176808117909,19.05101990667957,0.2848892698685913,11.737258036622114,204.70067504882815,196.68965576171877,190.21499633789062,183.7403369140625,175.72931762695313,0.04,0.0,237.42184408790894,0.058001920891598724,0.004775179429869483,204.67000034877233,197.0307137625558,22.631204889448274
2023-02-21,0,202.32250213623047,139.81750106811523,211.69250106811523,170.08812141418457,199.6924991607666,-0.6888469152544917,22.230305524507358,-0.7464006052277528,2.988122915971057,191.19874954223633,19.14144973754883,0.1213169807960524,143.53075141906737,208.11649627685546,0.8276494442794645,0.4558978655620672,1.1041303539085876,1.0053704192384088,0.9950107548697118,0.046987602710145016,69.30885327176354,227.7021109498326,183.24149990081787,138.78088885180316,202.651428767613,6.0096358403051084,197.8496426173619,9.185412356862564,202.11637980246883,191.4149024285794,2.45879056498782,17.83843129280838,180018600,6.861792480310501,0.8673950892248932,-2527408400.0,-42.49790079740924,85.04343053981948,79.70440250180728,57.96881592045417,32.71607716927106,17.609564411333714,0.20957061989069323,11.791025712097017,206.38807360839846,199.4209534301758,193.7899932861328,188.15903314208987,181.1919129638672,0.04,0.0,237.20645748491606,0.014025872051478538,0.002437887800431871,203.24857003348214,198.7557133265904,20.60147791749503
2023-02-22,0,198.13999938964844,142.7050018310547,211.69250106811523,172.19500064849854,200.66500282287598,-0.8465306167003536,20.207457643179477,-0.3461125612406102,2.9896395395041284,193.6037483215332,16.9867248916626,0.10842844900253365,157.5567497253418,208.11649627685546,0.8054839619942467,0.4087103357876462,1.0631724781288328,0.9805148977003066,0.9658157510281932,-0.009856973612484388,67.47602717856667,226.78166524058258,186.36674995422362,145.95183466786466,202.44964327130998,6.153033644450199,199.3410712650844,7.02656073668299,202.17317729011972,193.28440572639215,-2.9477018630244323,19.91790953846929,191828500,6.936359936681042,0.9169806249221871,-2719236900.0,-47.91665668719611,85.04343053981948,79.70440250180728,40.89284548978013,30.672988651965447,19.837217667164754,0.24234711039834042,11.678095783637168,209.38055548095704,204.26471646118165,200.12999725341797,195.99527804565432,190.87943902587892,0.04,0.0,236.9593335594638,-0.04009557653356477,0.03195643875980162,203.81571306501115,200.14499882289343,18.04141043745051
2023-02-23,0,201.8625030517578,142.7050018310547,211.69250106811523,176.1312494277954,200.66500282287598,-0.9958740514145834,17.79010627292576,0.23008144933696384,2.991144407690359,194.5187473297119,14.383087291717533,0.09408143911780624,167.75625228881836,208.11649627685546,0.7357071879716994,0.38845868643218284,1.067532396921909,0.997421996983595,0.9858565243543768,-0.046435267979542005,63.1603466320204,224.672837400893,189.0926248550415,153.51241230918998,203.68107223510742,4.692498786482518,200.27839279174805,6.3459142765883945,201.1597834796893,194.63840572792378,-0.707833021005519,11.779307946421644,146360000,7.072606292897994,0.7074732151346483,-2572876900.0,-45.8774749483511,85.04343053981948,79.70440250180728,51.032361340250034,30.951714671301307,18.749182958228943,0.2313202340935212,11.473231624680459,209.63543591308596,204.67727716064454,200.6699981689453,196.66271917724612,191.7045604248047,0.04,0.0,236.7871719269625,-0.056805441826473735,-0.034312987697879334,204.87714276994978,201.1307133265904,14.605650448688396
2023-02-24,1,195.92000198364258,159.10499954223633,211.69250106811523,185.8700008392334,201.97750282287598,-0.7937875342553036,14.43266320858599,-0.45150518532759554,2.99284503932501,196.60624885559082,11.80860013961792,0.07515035480195499,170.36224517822265,208.11649627685546,0.7553152256519723,0.2687376489270596,1.0201483571730188,0.966537255808837,0.9661106879633565,-0.05842771971911476,62.97397076480776,220.91582633324862,192.05049991607666,163.1851734989047,203.08214351109095,5.433013057280734,200.76160730634416,5.65355499062194,201.37070260507085,196.35601452122162,4.460717871570178,6.95268690081195,142228100,6.328000298908253,0.7032370299910397,-2715105000.0,-69.1411240203566,85.04343053981948,79.70440250180728,11.064666272613024,29.140586801455452,19.88030650426826,0.22236552348383268,11.315858242361204,210.56055548095705,206.17471646118165,202.62999725341797,199.08527804565432,194.69943902587892,0.02,1.0,236.5963335706066,-0.02553944058002733,-0.0810306206368423,203.11000061035156,201.62357112339564,12.390424007460224
2023-02-27,0,205.08499908447266,168.71750259399414,211.69250106811523,189.05124950408936,201.97750282287598,-0.7718737511137626,12.304135843243072,-0.41785470224941523,2.9936821927947133,197.0300006866455,9.683375148773191,0.06345895361870278,172.52500190734864,208.11649627685546,0.7835660320684471,0.1487877596494375,1.057732100051567,1.0180530160682504,1.0235774300394949,0.0074916373594686725,54.47683397670528,218.49952172463315,193.89125003814698,169.2829783516608,202.13821465628487,4.097599839966753,201.55589321681433,5.400713818351328,200.0147749461239,196.48379092730502,-2.0950720240758125,3.5764337437568883,161028300,6.188275304480583,0.8259148059601592,-2554076700.0,-33.355496847921614,85.04343053981948,79.70440250180728,79.61792339390054,34.21165951461043,18.318734806900572,0.19762618806677523,11.403296459782675,210.56055548095705,206.17471646118165,202.62999725341797,199.08527804565432,194.69943902587892,0.02,0.0,236.43649716824822,-0.003264330487018463,0.02766784687407413,202.16571480887276,202.54285757882255,12.007316337183065
2023-02-28,0,207.81999969482422,168.71750259399414,211.69250106811523,192.22062492370605,202.6318769454956,-0.9710802532432912,11.288128595775996,0.23177857654107115,2.994033062946284,198.4074993133545,8.604850311279296,0.0577048847943731,176.8084987640381,208.11649627685546,0.7148347738795855,0.18721234087062766,1.0623753121349062,1.0288042364670664,1.0356512738850536,0.027171953196249543,60.931254214795516,218.1945074662102,195.6182502746582,173.0419930831062,202.10142953055245,4.03608923889581,202.46642902919226,5.29715301474776,201.2770110695501,197.7773231785515,-3.121273521879037,5.732994590019109,153144900,6.430193323878022,0.8014577754276638,-2400931800.0,-39.746970210306245,85.04343053981948,79.70440250180728,81.8703100472287,33.730655530342986,17.438812185633935,0.2415303106229607,11.123060693166423,210.56055548095705,206.17471646118165,202.62999725341797,199.08527804565432,194.69943902587892,0.02,0.0,236.2899679569854,0.04225572175612524,-0.01248135411261398,202.69000244140625,203.17857251848494,9.8885405138545
2023-03-01,0,203.6750030517578,168.71750259399414,211.69250106811523,193.7843723297119,203.94125080108643,-1.1686367264136006,10.277697723180601,1.197528908188925,2.994346215409541,199.11374855041504,7.6903502655029286,0.05207272417984348,187.59200134277344,208.11649627685546,0.5829478022967153,0.23176313363840662,1.031934635742604,1.0010604207486713,1.0094639688391895,0.027934812148780797,63.796247287629356,217.9273955684315,197.37200012207032,176.81660467570913,202.117858341762,4.0432435521358325,202.82357215881348,5.189321766046428,202.91161277793813,199.4664370097789,-0.12374999007723113,6.534750660895122,156852800,6.288803408857537,0.8295363836439711,-2557784600.0,-49.53393125720966,85.04343053981948,79.70440250180728,38.70257102995539,31.82054162127131,19.863338151501967,0.20093696290664417,10.94855583476591,210.56055548095705,206.17471646118165,202.62999725341797,199.08527804565432,194.69943902587892,0.02,0.0,236.12083407603578,0.009509129026712637,0.027359828184964165,201.89857482910156,203.28428758893693,7.935525103923455
2023-03-02,0,189.3499984741211,177.2599983215332,211.69250106811523,194.79562282562256,204.02750205993652,-0.8262508336585295,7.969214783194869,0.7081628579776189,2.994921723536755,199.83250045776367,6.190888195037843,0.04002219656572862,189.11349906921387,208.11649627685546,0.49820954201257056,0.14901841916025657,0.950934698689797,0.9290264865956548,0.9333448209706443,-0.061985283985250605,57.73877051760653,215.05830471134823,199.11987514495848,183.18144557856874,200.26464353288924,6.285200091665827,201.4580361502511,6.0361435848528435,203.1120586858732,200.6563978586579,0.05649522386075508,2.5166748880825325,181500700,6.238204994512409,0.9681606269901392,-2739285300.0,-84.54488152977547,85.04343053981948,79.70440250180728,-117.96876702435723,28.468297946168448,25.634185500044325,0.17812282729587245,11.363659687005159,210.18295404052736,205.5635141296387,201.82999420166016,198.09647427368162,193.47703436279295,0.04,0.0,235.8539154283184,-0.05527793845136153,-0.04958681013443081,200.9742889404297,202.11142948695593,6.9985759844352975
2023-03-03,0,196.48749923706055,188.7400016784668,211.69250106811523,194.79562282562256,204.02750205993652,-0.07726015612721984,6.6349662977945885,-0.960579009462474,2.9951797892308085,199.83250045776367,5.543125915527344,0.033220613621775134,189.33049850463868,208.11649627685546,0.3879236331322791,0.0032319423027953216,0.9837932855563853,0.9747310271428031,0.9806233407604272,0.0028965763968569203,42.879615039605326,212.99430774817705,199.7243751525879,186.45444255699874,200.02857208251953,6.408133365003201,201.23910767691476,6.164785400685105,199.70856891179113,199.76446970986845,-6.411794795506511,-9.170496063890495,154193300,6.686625846675973,0.8366118104173711,-2585092000.0,-62.76865042181098,85.04343053981948,79.70440250180728,-42.48956236108622,31.012823976183377,24.073068435367176,0.20516308900797606,11.23625555442728,210.18295404052736,205.5635141296387,201.82999420166016,198.09647427368162,193.47703436279295,0.04,0.0,235.66315826792155,0.004622045818527765,-0.02118084764167257,200.5357164655413,202.17571476527624,6.430906436491295
2023-03-06,0,195.8125,189.15499877929688,211.69250106811523,195.70812606811523,204.02750205993652,-0.011099311175624417,6.193848862419577,-0.8260851838501657,2.9952530405058164,199.83250045776367,5.155751037597656,0.030951949905365365,192.8532501220703,208.11649627685546,0.32652253786770363,0.03876450797009663,0.9785157541730461,0.9769998055082015,0.9767013249939256,-0.045212956217501765,48.95611911612774,212.49944775535675,200.11175003051758,187.7240523056784,199.16428593226843,6.5264598175486634,201.4226790836879,5.942610734455898,198.93634104869267,199.58227108510263,-0.8340063377804893,-1.5359359865299191,128100100,6.872790941307937,0.7153282323750604,-2713192100.0,-75.3476510675606,85.04343053981948,79.70440250180728,-76.35265077880364,29.730555902608845,23.458384397211326,0.20411490828167717,10.883666089925239,210.18295404052736,205.5635141296387,201.82999420166016,198.09647427368162,193.47703436279295,0.04,0.0,235.49737088819157,-0.06656074266346446,-0.01559329158918951,199.35571507045202,202.1164289202009,6.139820253258275
2023-03-07,0,189.84750366210938,189.3499984741211,211.69250106811523,195.89312648773193,204.02750205993652,0.13602641297386406,5.759740928759389,-0.7835527972950245,2.9953198407881674,199.83250045776367,4.856088180541991,0.028734823526091746,193.89274673461915,208.11649627685546,0.2908272479989741,0.009524933348752212,0.9471319252157391,0.9509135004531378,0.9557894545841958,-0.08648107044127984,47.42765552612088,211.9641069490715,200.44462509155272,188.92514323403395,198.2967861720494,7.377637711273674,200.68946484157019,6.701502538147538,198.17334508705673,199.53064912958166,-2.997091069561633,1.329935025041375,148125800,6.7956623908803495,0.8360392402669543,-2861317900.0,-94.62701567691097,85.04343053981948,79.70440250180728,-141.92213372834058,28.120682155583673,26.332866321118697,0.1720155519484492,10.684832143826188,210.18295404052736,205.5635141296387,201.82999420166016,198.09647427368162,193.47703436279295,0.04,0.0,235.28128072449326,-0.08750182009880125,-0.09593988200399199,198.04571533203125,200.5778579711914,6.697981999642845
2023-03-08,1,183.3849983215332,189.3499984741211,211.69250106811523,195.89312648773193,204.02750205993652,0.012328394812582674,6.053750977025933,-0.7851714957600553,2.9952751689352226,199.83250045776367,5.041375350952149,0.030232664572599047,192.90300064086915,208.11649627685546,0.28601507087462263,-0.026784886154539313,0.9158317154012333,0.9243195444371641,0.9402695291827111,-0.09961951356921561,42.654715009452566,212.34625241181556,200.23875045776367,188.1312485037118,195.19678606305803,8.520453888702578,198.66750035967146,7.364012084298177,196.07334558791666,198.33187069174184,-3.0994784912467477,-5.129614208560202,151897800,6.922643675376036,0.8656623584095814,-3013215700.0,-94.68791414548741,85.04343053981948,79.70440250180728,-196.3259065259326,26.641884861774546,29.108708307672416,0.1132374394594711,10.472344613101502,208.76459533691408,203.26769622802738,198.8249969482422,194.38229766845706,188.88539855957032,0.06,0.0,235.03070900867976,-0.10243134504525842,-0.11525937455656533,194.38428606305803,198.2750004359654,7.868715125131708
2023-03-09,1,177.71499633789062,183.3849983215332,211.69250106811523,195.89312648773193,204.02750205993652,-0.41564164974253665,7.012442281255283,-0.2965155987152408,2.9951121115498127,199.83250045776367,5.613125610351562,0.035122908101449274,189.79775314331056,208.11649627685546,0.38666619989479956,-0.07695986397001667,0.8901132065371927,0.9024524411425007,0.9305595002248311,-0.06144706749401241,37.50903006597352,213.67926002027423,199.65437545776368,185.62949089525313,190.89607129778182,8.683156338307715,196.49875041416712,8.724781275527699,192.9032039163439,196.37087211953167,-10.580979037867815,-13.371991262682313,170023800,6.990426989338728,0.971911460513278,-3183239500.0,-98.94110627793536,85.04343053981948,79.70440250180728,-210.42529734337714,24.373545718885648,31.663590686478063,0.036815297165876476,10.62931986709949,202.0920754394531,196.43895526123046,191.8699951171875,187.3010349731445,181.64791479492186,0.08,0.0,234.7213411060874,-0.09418541803248437,-0.14721115290507347,189.6999991280692,196.19500078473772,9.911081659210833
2023-03-10,1,173.82500076293945,177.71499633789062,211.69250106811523,195.17000007629395,204.02750205993652,-0.7244537227957724,8.490871649206335,0.03716362688734387,2.994808077556171,199.83250045776367,6.755738010406494,0.04275226127979632,188.7534984588623,208.11649627685546,0.5108159284797891,-0.14751702722700283,0.8752236703840195,0.8936570057623106,0.9214177679392231,-0.11533811851704101,31.67732913791033,215.58811861121785,198.60637531280517,181.6246320143925,186.63178525652205,8.691131766672466,194.374821799142,10.3428390219815,189.11840398100898,193.966477528928,-14.486095371543474,-14.591918820035842,191488900,6.598408853680254,1.102155189395628,-3374728400.0,-88.31502504203388,85.04343053981948,79.70440250180728,-200.14708891704424,22.751730285920146,32.30611172845129,0.0656494460481117,10.573653508355555,201.1315573120117,194.8842182922363,189.83499908447266,184.78577987670897,178.5384408569336,0.1,0.0,234.35610988169057,-0.12311032747496309,-0.09146145632956824,185.50999886648995,193.70428684779577,11.151917936665924
2023-03-13,1,170.8000030517578,173.82500076293945,211.69250106811523,192.39375114440918,203.58875179290771,-0.8149004299988208,9.74363272587568,0.021033575524705306,2.994489508308447,198.84624862670898,7.62832529067993,0.049491656297994936,182.81799812316893,207.84574928283692,0.6442136377124404,-0.12892595871385043,0.8675588750677566,0.8881943896262888,0.9276710093126623,-0.12773697771205716,30.76595918725304,216.36151567300382,196.87425022125245,177.38698476950108,183.98178591047014,10.386800897117924,192.1232147216797,11.80709148593367,185.28136516159773,191.4635595206677,-14.655702389376122,-14.607486937388611,167790300,6.398327275758932,0.9761366460873957,-3542518700.0,-77.66273491590088,85.04343053981948,79.70440250180728,-172.19179373555664,20.72529966542921,32.430737104424395,0.1180783779082944,10.77839271786946,200.06247760009762,193.1537587585449,187.56999969482422,181.9862406311035,175.07752178955076,0.12000000000000001,0.0,234.03197140087278,-0.09973686638745627,-0.11785225921350001,183.1642848423549,192.0692868913923,12.223275322004683
2023-03-14,1,180.37749862670898,170.8000030517578,211.69250106811523,189.7231273651123,203.58875179290771,-0.7678465460180941,11.247501124829066,-0.345508173487028,2.9940492817405646,197.3137493133545,8.989137744903564,0.05755063104045748,177.3259967803955,207.84574928283692,0.7245626502225953,-0.11613644626816533,0.9229462399030538,0.9550263518973892,1.007051345348647,-0.049882167806931554,29.96135330973666,217.93162773030997,195.43662548065186,172.94162323099374,181.6803572518485,8.820769063033106,190.854464667184,12.062402798893173,181.68302556753486,188.89648428657915,-9.796670489489628,-15.580322876418121,143717900,6.305787344723399,0.843146004873035,-3398800800.0,-59.108211983697764,85.04343053981948,79.70440250180728,-91.50620717165971,23.74887055082116,30.408142738169033,0.12313140052984871,10.674222332603836,200.06247760009762,193.1537587585449,187.56999969482422,181.9862406311035,175.07752178955076,0.12000000000000001,0.0,233.79899315994976,-0.023706845921190434,-0.05443477212040263,181.08857073102678,190.81214359828405,12.538044863340755
2023-03-15,1,179.90499877929688,170.8000030517578,211.69250106811523,187.85874843597412,203.58875179290771,-0.6209304373858866,11.712841956520972,-0.7608176316080519,2.9938994360455946,197.3137493133545,9.825362854003904,0.060129570282694965,177.3259967803955,207.84574928283692,0.8063558224770164,-0.09861954712517136,0.9235683626965803,0.9665686082487016,1.0151477925404457,-0.018976467944966546,39.10376760267106,218.21905930977044,194.79337539672852,171.3676914836866,179.40785707746232,6.246604957014821,189.28607150486536,11.947951840143185,181.38938642664368,188.14501377031522,-8.198995189467489,-8.964621387733501,145995600,6.5132976873626545,0.874584724474146,-3544796400.0,-65.0465002968241,85.04343053981948,79.70440250180728,-90.32776073165789,22.57277296776276,29.66256401282441,0.08205621515465987,10.428206146517127,200.06247760009762,193.1537587585449,187.56999969482422,181.9862406311035,175.07752178955076,0.12000000000000001,0.0,233.55639700112104,-0.008516500284383555,-0.038676732757735616,179.17999921526228,189.26785714285714,12.489836076219644
2023-03-16,1,182.2874984741211,170.8000030517578,211.69250106811523,182.63312339782715,203.58875179290771,-0.412911652600237,12.07635460686434,-1.0851023818328975,2.9937712989571135,196.20375061035156,10.505900344848635,0.06231895777985375,177.3259967803955,207.84574928283692,0.7932621194325121,-0.15015884893622308,0.9406784821262842,0.9920381100818365,1.0326470205458351,0.02572941074447499,35.55506524825116,217.9357093968341,193.78300018310546,169.6302909693768,178.32785633632116,4.5691309073129664,188.31232125418526,11.921191629991,181.0501560557392,187.38964523257496,-8.123843585421321,-10.877455664379136,121136800,5.801460346927009,0.7389190026025715,-3423659600.0,-57.26964367883917,85.04343053981948,79.70440250180728,-61.07380531160707,23.90343301569289,28.212073474145765,0.05290809962716304,10.18119150894905,200.06247760009762,193.1537587585449,187.56999969482422,181.9862406311035,175.07752178955076,0.12000000000000001,0.0,233.36903655200106,0.06482770548560168,0.011703323531936814,178.66857038225447,188.35714285714286,11.67591653396273
2023-03-17,1,182.0500030517578,170.8000030517578,208.07749557495117,181.80999851226807,202.6318769454956,-0.31829514008714704,11.586480139645793,-1.2355433963163405,2.9939037596286555,195.8662509918213,10.332225399017336,0.060248112184076184,177.3259967803955,205.3584991455078,0.8073871621199531,-0.12394419218459074,0.9466351191026183,0.9945682714694625,1.0259864128764198,0.04731771754763581,39.14901898798345,215.4857103326974,192.31275005340575,169.1397897741141,178.13714272635323,4.345243238961211,186.66696439470564,10.980702119088173,181.32517090115508,186.830254700177,-3.9821462184952297,-6.958198944209722,133197100,5.850167559569709,0.8370943170050928,-3556856700.0,-65.72273047240662,85.04343053981948,79.70440250180728,-64.96612991186223,22.398949535027445,27.505460710875077,0.10933916641349563,10.088963500424134,200.06247760009762,193.1537587585449,187.56999969482422,181.9862406311035,175.07752178955076,0.12000000000000001,0.0,233.15772747867396,0.03857243050758341,0.04169562103986901,178.40142822265625,186.39285714285714,11.734411098246015
2023-03-20,1,181.03000259399414,170.8000030517578,207.81999969482422,181.6318769454956,201.97750282287598,-0.1803826765823147,11.197891982057676,-1.3037881104903355,2.994006114378714,192.8300018310547,10.057125473022461,0.05862421521760528,177.3259967803955,203.8160026550293,0.8200267000863669,-0.10566908123609159,0.9477446156757625,0.9968585025234962,1.0108664213048324,0.05989460983285988,39.87280672914286,213.40715939136143,191.0113754272461,168.61559146313076,178.61071504865373,4.470409531273373,184.75339317321777,9.200942743606635,181.4717591080482,186.45769823828275,-0.7279740883901049,-11.231926340564254,129684400,5.806386422850297,0.8371289195151543,-3686541100.0,-55.3245568553002,85.04343053981948,79.70440250180728,-53.81160957418238,20.798872479399662,26.23441755346493,0.06034976593778671,10.089037274528886,196.98355853271485,190.66321951293946,185.55500030517578,180.4467810974121,174.1264420776367,0.02,1.0,232.95672187088263,0.05026366624948708,0.056561331990916515,179.87714276994978,184.78857094900948,11.125654868087851
2023-03-21,0,192.9749984741211,170.8000030517578,207.81999969482422,180.86687660217285,199.07062530517578,0.006989080003264892,11.010530062375526,-1.295996867660145,2.9940497396070103,189.59875106811523,9.816112823486327,0.057985292583531974,177.3259967803955,203.8160026550293,0.8149139797602424,-0.10524039252885169,1.0162736657034623,1.071355693601312,1.0653950099320286,0.06983964154798827,39.22708279712876,211.90593561303228,189.88487548828124,167.8638153635302,181.34642900739397,6.467199668559976,183.989107131958,7.854127405935827,181.3523643327413,186.11506008950528,1.8653497591169368,-12.890961957545073,153391400,5.806381753690867,0.9987438496734612,-3533149700.0,-7.929982296128984,85.04343053981948,79.70440250180728,36.364707818048736,26.61911116916903,23.5823420957251,0.16379673509562787,10.421963183501827,191.84947760009763,186.5102587585449,182.19499969482422,177.87974063110352,172.54052178955078,0.04,0.0,232.77896370256175,0.07814038935641587,0.1323934357471424,183.32571411132812,184.41785648890905,11.133194473691756
2023-03-22,0,195.51499938964844,170.8000030517578,207.81999969482422,180.86687660217285,196.90062427520752,0.06116077146939949,10.665648028337722,-1.1575893227252392,2.9941472759012817,189.59875106811523,9.345000457763671,0.056307616831359306,177.3259967803955,203.8160026550293,0.8069649225553958,-0.026067431772674076,1.0321907905797976,1.0835758004543963,1.0646094821779788,0.08676802043450471,53.945042580147806,210.74879636185122,189.4175003051758,168.08620424850037,184.87714276994978,6.496251968707273,184.42946434020996,8.335869475087824,184.28982790904496,187.4075797791134,11.016825903713464,-5.2534697028665995,150376400,6.44088279295717,0.9925067182921559,-3382773300.0,-25.877577593537282,85.04343053981948,79.70440250180728,36.47513831028446,26.670962752615868,22.005263909623288,0.06916416351772395,10.371109149954973,191.98700366210934,186.62150366210935,182.28500366210938,177.94850366210937,172.58300366210938,0.06,0.0,232.60499460176737,0.05929618802549075,0.04305358303038792,185.70714242117745,184.4357136317662,10.837351864453213
2023-03-23,0,193.8599967956543,170.8000030517578,207.81999969482422,180.86687660217285,196.06187629699707,0.08153827960854639,10.573253829460931,-1.1068443529479577,2.994173020424175,189.59875106811523,9.220125274658205,0.05585854129612826,177.3259967803955,203.8160026550293,0.7810313625462212,-0.0314446891629094,1.0241631205811543,1.0672289089035287,1.037952773222193,0.06348487097800692,55.4470470061534,210.43275796409762,189.28625030517577,168.13974264625392,186.80321393694197,6.9244055809226595,184.24178559439522,8.068804931199816,187.11294602098985,188.61457001065875,14.470138112586097,3.2558758728323562,144193900,6.40761273980222,0.952382084644524,-3526967200.0,-22.965993037840075,85.04343053981948,79.70440250180728,34.35439505290774,24.71671531141784,21.973811135474172,0.03884102025400399,10.391744472252286,191.98700366210934,186.62150366210935,182.28500366210938,177.94850366210937,172.58300366210938,0.06,0.0,232.43593946325194,0.04393632826458349,0.06522584910786607,186.98714338030135,184.03785705566406,10.448235852561245
2023-03-24,1,190.39249801635742,170.8000030517578,207.81999969482422,180.86687660217285,195.83937549591064,0.11892640825749494,10.235792468926157,-0.9470895829091495,2.994265667917529,189.59875106811523,8.860012493133544,0.05419028247490172,177.3259967803955,203.8160026550293,0.8034164725191407,-0.010514522086214922,1.0079750327031574,1.038905930107673,1.0069095435669513,0.04582529428592097,55.207438392357794,209.35770993022294,188.8861249923706,168.41454005451828,188.3014281136649,6.288473896753735,183.8546425955636,7.586549255353698,188.8042162247932,189.26799816735252,7.474600918403534,-1.3372364407957527,116312400,6.280359754008847,0.7748600121126421,-3643279600.0,-27.891156462585055,85.04343053981948,79.70440250180728,10.886995991579655,23.798883604523148,22.226951668693864,0.01691267122975129,10.021620346643807,191.98700366210934,186.62150366210935,182.28500366210938,177.94850366210937,172.58300366210938,0.06,0.0,232.2887789950959,0.05706988564167714,0.034106330379416884,188.41000148228235,183.79500034877233,10.287420723986322
2023-03-27,0,193.38999938964844,170.8000030517578,207.81999969482422,180.86687660217285,195.58937454223633,0.18853786837003184,10.116064003583954,-0.8436994620442024,2.9942972990013206,189.59875106811523,8.611274814605713,0.0536348943500132,177.3259967803955,203.8160026550293,0.767362210691219,-0.07164103241926303,1.025344657955715,1.0458078305903151,1.013816189650908,0.06827595767854433,48.64766246675104,208.84187780117426,188.60974979400635,168.37762178683843,189.88749967302596,5.907428525204478,184.10767800467355,7.856093927757318,189.23601256589285,189.40072407521112,5.829465166738562,-2.76795505069522,120851600,5.921875686724141,0.8160201438505965,-3522428000.0,-24.08164926126695,85.04343053981948,79.70440250180728,43.05949400853599,26.163624457258763,21.024675868626044,-0.033690201571898545,9.837932961039295,191.98700366210934,186.62150366210935,182.28500366210938,177.94850366210937,172.58300366210938,0.06,0.0,232.14797913152879,0.04671212855985685,0.06484201609487505,189.50714329310827,184.08785683768136,9.307686504607256
2023-03-28,1,189.74250030517578,170.8000030517578,207.81999969482422,180.86687660217285,194.27374744415283,0.15851650951453986,9.463808204450968,-0.6246358575552837,2.9944676958122156,189.59875106811523,8.084999828338624,0.05033271221407351,177.3259967803955,197.20624961853028,0.6930130101546866,-0.06943508962739721,1.0091344262606192,1.0136995134574904,0.9819693564986001,-0.016750865109496638,51.38750922690524,206.95261621816707,188.02499980926513,169.09738340036319,190.98642785208565,4.822299593409095,184.56178528921944,7.993645177428866,190.28942757102294,189.58922620753182,6.090654053878269,1.8659690852948991,98654600,5.9303446202909385,0.6786248571618033,-3621082600.0,-31.210887675382597,85.04343053981948,79.70440250180728,18.31223676565822,24.820634968353396,23.290849128079152,-0.0063108837046778835,9.629510137227166,191.98700366210934,186.62150366210935,182.28500366210938,177.94850366210937,172.58300366210938,0.06,0.0,232.02193991022673,-0.042463808644067624,0.032414747292803546,190.80142865862166,184.60142844063895,8.314266779306356
2023-03-29,0,192.93500137329102,170.8000030517578,203.6750030517578,180.86687660217285,193.5074987411499,-0.11188969703425414,8.32478619211239,-0.7504683124504217,2.9947402677131456,189.54624938964844,7.271512355804444,0.04448875667693991,177.3259967803955,195.87999992370607,0.6550623317230606,-0.06840556051466713,1.0310701239022921,1.0256239973656196,1.001843403241481,-0.013195908367192088,48.25179780261525,203.7706972240075,187.1211248397827,170.4715524555579,192.68714196341378,1.9977894300051375,185.64892850603377,8.02575002632922,190.15435241191835,189.11727206121316,4.225485923903528,3.466751392878834,123660000,5.916420759651973,0.8604551352597063,-3497422600.0,-18.448976270195516,85.04343053981948,79.70440250180728,63.32753248583638,25.906780135148463,22.208658039766167,0.01703156692125326,9.377401616329063,191.98700366210934,186.62150366210935,182.28500366210938,177.94850366210937,172.58300366210938,0.06,0.0,231.87914165242236,0.014282035435515095,-0.018726576141070973,192.32000078473772,186.09857177734375,7.634995715917016
2023-03-30,0,195.6525001525879,170.8000030517578,196.48749923706055,180.86687660217285,193.07874870300293,-0.44044977269931446,7.549980786647748,-0.9685770934869296,2.994908266199606,189.54624938964844,6.788212280273439,0.0404642184672823,177.3259967803955,195.54474945068358,0.768314589732903,0.01893320796440298,1.0486020737755384,1.0329153438536907,1.0186838813726546,0.009246380824111222,56.65866246919381,201.68408632915487,186.58412475585936,171.48416318256386,193.06964220319475,2.296131472178012,187.20803560529436,7.664099096350822,190.84959736537257,188.8379105560641,6.5762573102298765,8.564277269242096,110252200,5.024168378692257,0.7866604177465194,-3387170400.0,-14.639469068877483,85.04343053981948,79.70440250180728,85.51806504864562,26.82115473861284,21.597441430731138,-0.01568633046491384,8.95401556860046,191.98700366210934,186.62150366210935,182.28500366210938,177.94850366210937,172.58300366210938,0.06,0.0,231.76179898541045,0.015919246379986873,0.021606094766861667,191.9914289202009,187.65857151576452,7.827468046474542
2023-03-31,0,202.49499893188477,170.8000030517578,196.48749923706055,180.86687660217285,193.5074987411499,-0.446233196920154,7.786666475826704,-1.050944997756246,2.9948585140418498,189.79500198364258,7.071824855804442,0.04166237415346362,177.3259967803955,195.6685001373291,0.7504318763111683,-0.004249629557681106,1.083444685334325,1.0615490820282045,1.052345744871104,0.06356605980603058,57.76981745171444,202.47258279143614,186.89924983978273,171.3259168881293,194.0667849949428,4.233415482580838,189.4719638824463,7.105317145069615,192.08139628549333,189.281907909566,1.3874863063288807,12.557169160848462,170222100,4.794095658876557,1.207645874808993,-3216948300.0,-1.039000722102139,85.04343053981948,79.70440250180728,156.5859731404175,32.33239932341867,19.501566252393538,0.025045062545681295,9.208014064193227,200.29463458251954,195.6576753845215,191.90999603271484,188.1623166809082,183.52535748291015,0.08,0.0,231.62430833969148,0.08954363071182847,0.07928418164801589,194.32143075125558,190.0142865862165,8.785663271959415
2023-04-03,0,197.3925018310547,170.8000030517578,202.49499893188477,180.86687660217285,193.5074987411499,-0.22503821512394465,8.25267186045073,-0.8838650611807579,2.9947566463180304,189.79500198364258,7.342162342071532,0.0440848739317003,177.3259967803955,195.6685001373291,0.7095675223894902,0.03412702933614946,1.0544492384324236,1.0238266705553087,1.0130849032304872,0.020696532675104296,64.89973884464968,203.7049685454254,187.19962482452394,170.69428110362247,194.57142857142858,4.411458848433702,190.68732125418526,6.8817385216752704,194.6515282999789,190.431295410835,3.5700583402942154,18.556788825420785,169545900,5.030089814248689,1.1854205892504328,-3386494200.0,-40.994934715336484,85.04343053981948,79.70440250180728,84.91647144440338,28.676668718701652,21.001267059305796,0.01776868827305938,9.640299471445497,200.29463458251954,195.6576753845215,191.90999603271484,188.1623166809082,183.52535748291015,0.08,0.0,231.4512275027242,0.015431973054287784,0.022897959805140415,194.6857169015067,190.836430140904,8.82604625718778
2023-04-04,0,194.74000549316406,170.8000030517578,202.49499893188477,180.86687660217285,193.5074987411499,-0.21012859387302082,8.341822820337685,-0.9108295679337206,2.994736474708468,189.79500198364258,7.413262424468994,0.04454231135067242,177.3259967803955,195.82650032043458,0.7907522903200008,0.03974241442949864,1.0398410687841764,1.0015686786229816,0.9953819318135337,0.02633835424298958,59.33859498885507,203.96227055675203,187.27862491607667,170.5949792754013,195.19250106811523,4.0131171446477145,191.74696459089006,6.202382802807296,195.29332771111365,190.84788581417365,1.8221938996130107,9.432996539972113,126463800,4.976485283104604,0.8909487477160262,-3512958000.0,-48.3778551394816,85.04343053981948,79.70440250180728,56.856122952820826,26.87129655729853,21.08477242249855,0.02870619609811087,9.553135092694149,200.37015631103515,195.77991818237305,192.06999969482422,188.36008120727539,183.7698430786133,0.08,0.0,231.31343053213956,0.01791849117766331,0.004014411564891023,194.99571663992745,191.7028590611049,8.905471350771183
2023-04-05,0,187.61999893188477,170.8000030517578,202.49499893188477,180.86687660217285,194.07999897003174,-0.2536356894957789,8.484092151533087,-0.9937226088158386,2.994704186764031,190.0674991607666,7.633425006866455,0.04524288135571408,177.3259967803955,195.82650032043458,0.8235556443755376,0.06191895343435814,1.0005159302873186,0.9640745730343173,0.9541148042234091,-0.027548150431879193,57.77053798841066,204.49143431069558,187.5232500076294,170.55506570456322,194.3682152884347,4.932347349829987,192.12785748073034,5.721910765107897,195.11223619364483,190.93530837031585,2.2834447376351603,8.24602251995589,133882500,4.768451772558295,0.9492379862804066,-3646840500.0,-70.83332726670027,85.04343053981948,79.70440250180728,-9.251544518806684,25.089448034957574,24.618572410390176,0.026281160365314887,9.50076882351659,200.37015631103515,195.77991818237305,192.06999969482422,188.36008120727539,183.7698430786133,0.02,1.0,231.1406962186477,-0.04311945739533374,-0.01939847836347438,194.0971461704799,191.80214473179407,8.825067633147736
2023-04-06,0,183.56750106811523,170.8000030517578,202.49499893188477,180.86687660217285,194.07999897003174,-0.32792264402222776,8.430847716992904,-0.9163015659528781,2.9947182278714126,190.0674991607666,7.400499973297118,0.04490823615883981,177.3259967803955,195.82650032043458,0.8038209657390636,0.055735322275007666,0.9778011613754232,0.9470932141475337,0.9385801210021655,-0.06176767010412676,50.13737970931535,204.5966954721328,187.73500003814698,170.87330460416115,193.4860725402832,6.268695505474046,192.23625019618444,5.527382763178656,193.21253903906282,190.36732678773654,-2.983608498874902,2.925324283014786,123857900,4.878484257305859,0.8927738834487937,-3770698400.0,-72.29645354342325,85.04343053981948,79.70440250180728,-41.21241707318181,23.80760498862171,26.449285117575563,0.11081273705925522,9.297142043011597,200.37015631103515,195.77991818237305,192.06999969482422,188.36008120727539,183.7698430786133,0.04,0.0,230.97165837156226,-0.052335115140253796,-0.045492093573805376,193.50714547293526,192.15428706577845,8.146733192200616
2023-04-10,0,181.41500091552734,170.8000030517578,202.49499893188477,181.7950029373169,194.07999897003174,-0.3815929790898519,8.17569216480687,-0.7062372380681672,2.9947810320798607,190.0674991607666,7.078612213134766,0.04348133500523854,179.29699897766113,195.82650032043458,0.745573624849001,0.05604775068266786,0.9648316339183055,0.9409845567254427,0.9391808976895408,-0.10410132658855598,46.55434026094037,204.3790096042719,188.0276252746582,171.6762409450445,191.8403581891741,7.769896188741077,192.26375007629395,5.467979137345125,190.79534872010777,189.4482735064397,-3.2544101754371715,0.8335611045971743,142154600,4.8863465951466285,1.0432058163428626,-3912853000.0,-73.48486162086148,85.04343053981948,79.70440250180728,-67.43638692022334,22.159350859069008,27.413617188888693,0.15706238439660639,9.275203718022215,200.31351501464843,195.68823608398438,191.9499969482422,188.2117578125,183.58647888183594,0.06,0.0,230.77169842390512,-0.11062378995622213,-0.05515159944584543,192.16857256208147,192.2442866734096,7.42817530949575
2023-04-11,0,187.07999801635742,170.8000030517578,202.49499893188477,181.8912525177002,194.07999897003174,-0.32546760227304883,7.668020279876583,-0.54682954656321,2.9948998293602993,190.0674991607666,6.66116220474243,0.04069920534262014,180.33024864196778,195.82650032043458,0.6543153348676264,0.06214869832615196,0.9929560664760329,0.9749081382953279,0.9901189031034722,-0.05224364511841273,44.97754524050766,203.74316584204075,188.4071252822876,173.07108472253447,190.61571502685547,7.744439588112069,191.8426786150251,5.633468262790606,188.42994082931608,188.472640955735,-5.97092304442715,0.2126710026053857,115770900,4.856894657328472,0.8661201306838457,-3797082100.0,-66.28789411322717,85.04343053981948,79.70440250180728,-23.54894005316508,24.59667648882538,26.389360869694837,0.10874567067901102,8.946975447771909,200.31351501464843,195.68823608398438,191.9499969482422,188.2117578125,183.58647888183594,0.06,0.0,230.62759457731224,-0.04097145767458643,-0.09963372582091377,190.9557146344866,191.47357177734375,6.642764367006765
2023-04-12,0,185.79249954223633,179.90499877929688,202.49499893188477,182.22812461853027,194.07999897003174,0.07588041515231796,6.536318925774509,-1.117122940703155,2.995135954497007,190.0674991607666,5.765762481689452,0.03454328328679122,180.96475219726562,195.82650032043458,0.720711182100196,0.03715817904493316,0.9818803239451817,0.9713929378263104,0.9941568116264208,-0.04594590581564828,49.32483083419799,202.29376288206663,189.22112503051758,176.14848717896854,188.22964368547713,5.804462846167935,191.14821434020996,5.744123008763364,188.09218360827322,188.38258203713636,-4.381493785944386,-3.0548001059081344,150256300,4.542946499633687,1.1213740835156936,-3947338400.0,-86.01643402787812,85.04343053981948,79.70440250180728,-62.99566772364838,22.423897365424853,28.243806343703454,0.009767952525497139,9.112906078108598,200.31351501464843,195.68823608398438,191.9499969482422,188.2117578125,183.58647888183594,0.06,0.0,230.42887102035715,-0.06251951620337115,-0.07306058774030726,187.10999843052454,190.71571459089006,6.802550387791255
2023-04-13,0,184.07500076293945,179.90499877929688,202.49499893188477,183.2475004196167,194.07999897003174,0.08836756233335008,6.271159920667603,-0.9976241247674911,2.9951849825685612,190.0674991607666,5.467937431335448,0.03309461114437062,181.37650108337402,195.82650032043458,0.6811887728315409,0.03272560964335459,0.9714136856201695,0.9644049068188012,0.9944893220585834,-0.018894564487404786,47.88748455004866,202.03419491762915,189.49187507629395,176.94955523495875,186.32714353288924,4.2840260308675715,190.4492860521589,5.97927133787904,187.5096687643147,188.10473543933966,-8.248351553248394,-4.972764175517711,112933000,4.554369418022806,0.8533557040133553,-4060271400.0,-69.09723627045815,85.04343053981948,79.70440250180728,-65.11879845003457,21.34980785987721,26.890947137468103,0.021232601998337847,8.887698980660568,200.31351501464843,195.68823608398438,191.9499969482422,188.2117578125,183.58647888183594,0.06,0.0,230.28159631878674,0.00204824070327958,-0.034686924244763884,185.84285409109933,190.26428549630302,6.531641828333132
2023-04-14,0,184.30999755859375,181.03000259399414,202.49499893188477,183.9481258392334,194.07999897003174,0.16226983237990764,6.012960250065397,-0.9507801512044574,2.995230610181294,190.0674991607666,5.238587322235108,0.03169714474472339,181.98650283813475,195.82650032043458,0.6682425721947287,0.00980595105962314,0.9715847814644746,0.9701394177946294,0.9995878076295583,0.004044814502339289,44.960685335570695,201.72629567560685,189.70037517547607,177.6744546753453,184.8371423993792,2.15519458026643,190.0148217337472,6.200601232798424,186.6652773413453,187.78748613008452,-6.746710713213152,-5.047454964640849,96438700,4.548180762009446,0.7355837766199356,-3963832700.0,-71.93812675201572,85.04343053981948,79.70440250180728,-67.24591403331932,20.588905585270425,25.932559924921637,0.012233720581841,8.557863644357585,200.31351501464843,195.68823608398438,191.9499969482422,188.2117578125,183.58647888183594,0.06,0.0,230.15653093765013,-0.000324205983925574,-0.0028029552635050075,184.75999668666296,189.8778566632952,6.496039048614084
2023-04-17,0,186.43500137329102,181.03000259399414,202.49499893188477,184.25124835968018,194.07999897003174,0.18100548699302654,5.9034512114232385,-0.8981584883451177,2.995249312160072,190.0674991607666,5.1332498550415036,0.031103290581945615,181.98650283813475,195.82650032043458,0.6532050950181106,0.01241414154875575,0.9822630550648535,0.9872186131600861,1.0102988981505379,0.027671363627207235,45.3936432086212,201.60840255254618,189.80150012969972,177.99459770685326,184.6678570338658,1.93552069428452,189.51803616115026,6.187985072570606,186.0839154836251,187.71840049684164,-5.355863017543376,-3.1947164521372575,116662200,4.5475915132478315,0.8954849251878134,-3847170500.0,-65.49875251664113,85.04343053981948,79.70440250180728,-46.68609866584109,22.253804686821,24.3974690137135,0.042103461110326396,8.446587669759671,200.31351501464843,195.68823608398438,191.9499969482422,188.2117578125,183.58647888183594,0.06,0.0,230.01286783821266,0.013711987722178298,0.010699209735546202,184.97713797433036,189.53714207240515,6.136798603969738
2023-04-18,0,185.68249893188477,181.03000259399414,202.49499893188477,185.42187404632568,194.07999897003174,0.20269519938712344,5.689028566137883,-0.7692699435364001,2.9952848612350205,190.0674991607666,4.913999938964844,0.029938985951625727,183.35225105285645,195.82650032043458,0.6212222471695426,0.029856922619721553,0.9771695927268653,0.9916672254981604,1.000776116448217,-0.0074700614672363885,49.01017351739541,201.39880717805212,190.02075004577637,178.6426929135006,184.96999958583288,1.8998739530957227,189.22803606305803,6.27123243468053,186.19865567999452,188.07687563749556,-0.6315944810467471,-3.5963586733067134,92067000,4.560341996130428,0.7170473974661631,-3939237500.0,-74.1161652650541,85.04343053981948,79.70440250180728,-68.26192308281495,21.450902200458952,23.517224542814,0.0010348730655004772,8.136831451228081,200.31351501464843,195.68823608398438,191.9499969482422,188.2117578125,183.58647888183594,0.06,0.0,229.89684425826843,-0.013276919624597316,-0.0010839355817917461,184.8699951171875,189.1885702950614,6.079774296338737
2023-04-19,0,180.20999908447266,181.41500091552734,202.49499893188477,185.76499938964844,194.07999897003174,0.3115130674191771,5.404653168351351,-0.6882940279398637,2.9953298427838106,190.0674991607666,4.681375122070312,0.028407659902235895,184.02425079345704,195.82650032043458,0.7579116341260225,-0.03778986708070522,0.9472105249883331,0.9684973610085627,0.9727462603204323,-0.03004696352930325,42.92250266572635,201.06268119937363,190.2533748626709,179.4440685259682,184.79785646711076,2.2901703968526634,188.31910732814245,6.605859346362101,186.09844761322867,188.38068315490992,1.1521635646087116,-2.1397427391127652,125732700,3.6401243467418865,0.989908745411496,-4064970200.0,-85.8585960754847,85.04343053981948,79.70440250180728,-118.73257348363032,20.180317035074047,27.398233084891203,-0.053990944122735515,8.031343752004545,200.31351501464843,195.68823608398438,191.9499969482422,188.2117578125,183.58647888183594,0.06,0.0,229.7231098496341,0.0002769638507662542,-0.03319233990626436,184.30999537876673,188.2392839704241,6.158721483212392
2023-04-20,0,164.85499954223633,180.20999908447266,202.49499893188477,185.339373588562,194.07999897003174,0.319462469934111,5.785846605606718,-0.720587019062124,2.9952680832143237,188.68124961853027,4.996375274658203,0.030513634441693013,183.35225105285645,195.82650032043458,0.700292832453663,-0.07828044064626433,0.8694190383551962,0.8929483049953977,0.8952577484939805,-0.10441396789918012,34.77986949111937,201.1868181044019,189.61512489318847,178.04343168197502,181.62285668509347,7.674788701155184,186.11928585597448,8.754438921924582,184.61781044087104,187.40571232249445,-0.6642239202786627,-6.595486665583297,210970800,3.7397343376142764,1.6223012868206188,-4275941000.0,-94.8549477992999,85.04343053981948,79.70440250180728,-271.81866126647043,16.932004983070712,36.72189645850332,-0.035281090931151234,8.888390539674104,196.6437142944336,189.74813491821288,184.17499542236328,178.60185592651368,171.70627655029296,0.08,0.0,229.33934862338705,-0.12323824182628762,-0.097208310876329,180.90999712262834,185.9328558785575,8.473510879599287
2023-04-21,0,164.3000030517578,164.85499954223633,202.49499893188477,184.25124835968018,193.5074987411499,-0.9192640792410585,7.748464130590445,1.9413319676879768,2.99487169735718,187.3499984741211,5.7860878181457505,0.04119723835891622,181.29450073242188,195.82650032043458,0.5486347035859593,-0.149618269539083,0.8735545875951732,0.9010528461751803,0.9112666144830921,-0.10856705969232394,23.42228540214076,203.57905316199873,188.08212490081786,172.585196639637,178.55250004359655,9.74782024136885,183.39107186453683,9.198811010430413,179.64481692871266,184.44650681151325,-11.879943719145134,-15.740918509261485,123539000,4.956727430211359,0.9575819689126721,-4399480000.0,-89.27129421172953,85.04343053981948,79.70440250180728,-229.22559982651987,16.272915966488622,35.29247338379578,0.011944571119931706,8.587790692251291,192.7473212890625,186.59634057617188,181.625,176.65365942382812,170.50267871093752,0.08,0.0,229.11574306984545,-0.10767566577808274,-0.11199565760622356,178.70142691476005,182.9057126726423,9.79697361630018
2023-04-24,0,162.86499786376953,164.3000030517578,202.49499893188477,183.9481258392334,193.04875087738037,-0.943096206117473,9.190456414575866,0.9682666104420696,2.994498603459537,186.75749969482422,6.539875030517578,0.04925108919245327,178.67449913024902,195.82650032043458,0.700701939532898,-0.13704581449610423,0.8727834804151455,0.9027217615668558,0.9238129940030947,-0.1264247771926058,23.584962952521792,204.98503804277473,186.60412521362304,168.22321238447134,175.5224996294294,10.96550188565798,180.9248215811593,9.767142005437892,175.80084992692434,181.86377269384286,-11.568010841897637,-18.862192193188424,140006600,4.939337986067052,1.0753515542552265,-4539486600.0,-90.18190390728377,85.04343053981948,79.70440250180728,-201.62026817426542,15.307631242584828,35.4824098015627,0.007019991847167114,8.477233734670753,189.26932434082033,183.4103436279297,178.6750030517578,173.93966247558595,168.08068176269532,0.1,0.0,228.8569643302033,-0.1309345119410389,-0.12135133485536317,175.36571393694197,180.60428401402064,11.096572321238195
2023-04-25,1,160.6775016784668,162.86499786376953,202.49499893188477,183.02937602996826,193.04875087738037,-0.8203236918348752,10.48950908711152,0.11506951976507285,2.99410113556993,186.11375045776367,7.6224501800537094,0.056630332525477584,164.79949989318848,195.82650032043458,0.7593456732307748,-0.15784167548589803,0.8674591226194548,0.899849082316211,0.9364445789299434,-0.13466534216878856,21.33267340693361,206.2067683802167,185.22775020599366,164.24873203177063,172.14642878941126,11.436944913433623,178.49178559439522,10.289580904772212,172.5806406628045,179.49336932895133,-11.522478778356858,-17.491801181402895,121999300,4.830876976986771,0.9366296899265781,-4661485900.0,-93.75190329898987,85.04343053981948,79.70440250180728,-173.51949166630567,14.67893738275198,34.02512533861737,0.021387666183784744,8.208859983671607,183.79908154296874,178.9854613647461,175.09500122070312,171.20454107666015,166.3909208984375,0.1,0.0,228.62870416355764,-0.12826216538868473,-0.1409858643271379,171.88999938964844,178.32499803815568,12.22439158752787
2023-04-26,1,156.96249771118164,160.6775016784668,202.49499893188477,181.11375045776367,190.5406255722046,-0.6764380355814665,11.582709168139294,-0.41000903794297017,2.993710252613395,185.73749923706055,8.725487403869627,0.06308935717108391,164.156502532959,195.82650032043458,0.8049259278484194,-0.15318127767875814,0.854952234128917,0.8922366684087787,0.9422564779470624,-0.12900228339934594,20.61215866077786,206.75754365671315,183.59212532043458,160.426706984156,167.93607112339564,10.70140900762366,176.30196407863073,11.399840349006919,169.6302486249578,176.976333885404,-12.822145403487392,-17.49127187730975,153364100,4.809365835836912,1.1532090854445234,-4814850000.0,-98.41310985533525,85.04343053981948,79.70440250180728,-168.7003146012485,13.711435892006712,36.69299204944467,-0.030586670904150088,8.160369897644594,182.50816125488282,176.8959208984375,172.36000061035156,167.82408032226562,162.2118399658203,0.12000000000000001,0.0,228.32242300910454,-0.14862393755007342,-0.16580759569962264,167.13428606305803,176.0557120186942,13.81863375307272
2023-04-27,1,156.4199981689453,156.96249771118164,202.49499893188477,176.37124919891357,188.94874954223633,-0.5617738008013077,12.846724405710203,-0.7526451406340131,2.9932019564290733,184.99624824523926,10.238687648773197,0.07060458231889916,162.64624824523926,195.82650032043458,0.8132745791216947,-0.18644882165527707,0.8596719512510483,0.9039672000661155,0.9659610095498363,-0.05116618480915369,17.016986525447567,207.64657400215526,181.95312519073485,156.25967637931444,163.75571387154716,7.984124430700306,174.36285672869002,12.33910387614241,166.50650245317325,174.4016433227118,-15.808460559987774,-16.340209676599187,127015200,4.6984578330928946,0.9538773628732575,-4941865200.0,-80.05609287117747,85.04343053981948,79.70440250180728,-129.73187165322176,12.737663492412805,34.76138270517727,-0.010315673421112217,8.156772091409362,182.32644024658202,176.60177926635743,171.9749984741211,167.34821768188476,161.62355670166016,0.14,0.0,228.07705252529854,-0.017178986179463895,-0.11296303400059464,163.6885724748884,174.27928379603796,14.302418627047324
2023-04-28,1,161.88249969482422,156.4199981689453,202.49499893188477,164.7162504196167,187.21499824523926,-0.40734442937628357,13.72122125977965,-1.0174182875414586,2.9927951950376834,184.1924991607666,11.468425216674802,0.07617510252095203,160.30600128173828,195.82650032043458,0.8295656933115332,-0.20052134244666156,0.8987112573388566,0.9507302307843489,1.010218727592864,-0.01471395807687248,15.211615579015506,207.56981755007686,180.12737503051758,152.6849325109583,161.13749967302596,3.348073274478167,172.96767807006836,12.582254118917549,164.0174726206712,172.1284519890268,-15.759428557493738,-14.78883938671501,122515800,4.585104781295033,0.9158695766581905,-4819349400.0,-69.54858353241879,85.04343053981948,79.70440250180728,-88.9797568617799,15.852167545486862,32.41375880687379,0.04414860283554184,8.122716418864348,182.32644024658202,176.60177926635743,171.9749984741211,167.34821768188476,161.62355670166016,0.14,0.0,227.8571102442055,-0.004664430966320077,0.008098607405010788,161.36285836356026,172.8364268711635,14.240715122314635
2023-05-01,1,161.7775001525879,156.4199981689453,202.49499893188477,163.94125175476074,186.59625053405762,-0.2198116109686135,13.784526790227087,-1.1785441530669392,2.9927260759281844,183.82125091552734,12.110962734222408,0.0772506932115421,160.30600128173828,195.00525512695313,0.8268172380188016,-0.20056050495707192,0.9066269900304564,0.9627951153177043,1.0126188170583867,-0.006677295462167332,23.914996604638016,206.00792858808356,178.4388750076294,150.86982142717525,160.69785690307617,2.9578810796392525,171.16035679408483,12.210976487453863,163.48290850163602,171.15587533860804,-10.17007906484562,-10.766750887264326,109015000,4.452441126190291,0.8340246561144933,-4928364400.0,-75.87348866604117,85.04343053981948,79.70440250180728,-82.18335885603497,15.070087251776075,30.814598191443142,-0.001349199724643945,7.933950655197493,182.32644024658202,176.60177926635743,171.9749984741211,167.34821768188476,161.62355670166016,0.14,0.0,227.6599798293711,-0.004429413763061385,-0.01968742406076599,161.1971435546875,171.05357033865792,12.950276815731447
2023-05-02,1,161.6525001525879,156.4199981689453,197.3925018310547,162.6193733215332,185.953125,-0.20217945874783516,13.06956800179092,-1.4600500742985407,2.992970042178456,182.4912509918213,12.14840026855469,0.07408926150180901,160.30600128173828,188.3319995880127,0.8401898979566937,-0.18042732802965913,0.9163818080739271,0.9763791213016396,1.013215794252639,0.006068046017246198,24.74020025530237,202.54213607224636,176.40300006866454,150.2638640650827,160.31964220319475,2.5634912791822178,169.43607112339564,11.678641878291318,163.02851648847195,169.98213461646387,-1.86679166430738,-13.524961584379104,128259700,4.416987451779093,0.9970029598060185,-5056624100.0,-78.72454211375891,85.04343053981948,79.70440250180728,-71.73828140355583,16.183479950245847,28.971921508013807,0.003360432487755594,7.835812238210361,180.88248071289064,175.43375964355468,171.02999877929688,166.62623791503907,161.1775168457031,0.14,0.0,227.43045433937996,-0.0022406212389012303,-0.0137804088041193,160.51571437290735,169.6085706438337,12.638052920762567
2023-05-03,1,161.38249969482422,156.4199981689453,194.74000549316406,161.85624980926514,185.70999908447266,-0.11732331084447742,12.508842537602549,-1.654413160601533,2.9931562283479396,180.8125,12.015150184631347,0.07163629071044825,160.30600128173828,187.13399810791014,0.8396744321809061,-0.16990605118236807,0.9242137015446843,0.9891042700754771,1.0102886616748346,0.028159605307604085,25.16878380509557,199.63368505994632,174.61599998474122,149.59831490953613,160.10785675048828,2.372262783838336,167.81517818995886,11.048349778336977,162.66398994328438,168.98616706333473,-1.6113833536180187,-12.99298919446459,119728000,4.429594855919172,0.9331262750279181,-5176352100.0,-77.9206755733493,85.04343053981948,79.70440250180728,-63.14375205962005,15.413310945497685,27.59315278694341,-0.007628080436890301,7.639682531043983,180.88248071289064,175.43375964355468,171.02999877929688,166.62623791503907,161.1775168457031,0.14,0.0,227.2184818814929,0.04461789014862805,-0.0003734210448590549,160.2385711669922,167.80214255196708,12.243353029938907
2023-05-04,1,161.62749862670898,156.4199981689453,187.61999893188477,161.7462501525879,184.6531229019165,-0.021736293237966546,11.924631242048086,-1.8303393663575567,2.9933518741568346,172.5324993133545,11.670624923706054,0.0689491792009292,160.30600128173828,186.49950103759767,0.8718622911066175,-0.1398438300097531,0.9345432274094265,1.002170165435895,1.0062537684928496,0.03329178186116066,26.560874026307875,196.79738717892042,172.94812469482423,149.09886221072804,160.24357060023718,2.436584790179428,166.19499969482422,10.062562153105517,162.3201994982219,168.08532006358396,-0.9102619890035345,-12.32785602285001,95108500,4.252377368327742,0.7526206921410354,-5081243600.0,-76.33976393856581,85.04343053981948,79.70440250180728,-60.38787809387202,14.917637418526594,26.959171824089548,0.01600106604398373,7.329705425379682,180.88248071289064,175.43375964355468,171.02999877929688,166.62623791503907,161.1775168457031,0.14,0.0,227.04960286494307,0.006304978409656714,0.04845526470401423,160.3142852783203,166.10214233398438,12.128808969890407
2023-05-05,0,167.0824966430664,156.4199981689453,187.07999801635742,161.64624977111816,184.13374996185303,0.16725929478846258,11.668437732869013,-1.804937198322577,2.9934283726929145,164.57750129699707,11.373100013732909,0.06797867592581194,160.30600128173828,185.85674972534179,0.8887416538376717,-0.11952008015441204,0.9733991089638252,1.0380712403684906,1.033513832597819,0.03212204505147298,28.410658510222433,194.9853751453034,171.64849967956542,148.31162421382743,161.68928473336356,3.0821128378473657,164.8126779283796,8.230784785797258,162.13351233384407,167.51274699533695,0.5912445353695099,-12.306711102133134,107440900,4.218417138719283,0.8557692434060462,-4973802700.0,-49.91506576139268,85.04343053981948,79.70440250180728,-16.555655051718926,21.029031119490714,24.49399439829581,0.02071710529266518,7.491154776273806,179.35448071289062,174.1977596435547,170.02999877929688,165.86223791503906,160.70551684570313,0.02,1.0,226.87963050325845,0.03499482737165471,0.06161430155916074,162.64428492954798,164.88928549630302,11.713346311817741
2023-05-08,0,172.125,156.4199981689453,187.07999801635742,161.64624977111816,184.13374996185303,0.33750090130386146,11.375954473364418,-1.6698785791361528,2.9935293383377615,164.57750129699707,10.84060005187988,0.0665944941039565,160.30600128173828,185.85674972534179,0.9005641138594253,-0.07900396439175729,1.0076145544078885,1.0675544152018757,1.0578994496207565,0.06396130387509014,43.330033163690494,193.57615840504184,170.82424945831298,148.07234051158412,163.93285642351424,4.14125568714302,163.84428514753068,6.111069890844475,163.3719102126641,167.7570165943189,6.447399270178561,-10.38029586058033,112249400,4.458893441349117,0.9048455686372159,-4861553300.0,-37.61646282404703,85.04343053981948,79.70440250180728,8.564926929901684,23.029689042476665,23.386907628706147,-0.023018165257632745,7.285358050135929,176.15331884765624,171.60833813476563,167.93499755859375,164.26165698242187,159.71667626953126,0.04,0.0,226.71353039562885,0.06154601336207133,0.04552367986538165,164.30142647879464,163.9949994768415,11.27318636688187
2023-05-09,1,168.61999893188477,156.4199981689453,187.07999801635742,161.64624977111816,184.13374996185303,0.443538013841462,11.12083525031705,-1.5210432813428145,2.9936200162821667,164.57750129699707,10.283199996948241,0.0652785372640298,160.30600128173828,185.85674972534179,0.8656574000117835,-0.07993905374667486,0.9897877844581766,1.0398436084913925,1.0233410606724438,0.043101707506658204,50.502138545634445,192.60141991317073,170.35974941253662,148.1180789119025,164.89535631452287,4.36234821885552,163.0164279937744,4.2141087449562775,165.58436415713692,168.45334834479257,10.040277467649698,-7.301441444332435,88965000,4.413662938974806,0.7249821861287149,-4950518300.0,-21.69858811751613,85.04343053981948,79.70440250180728,-6.131416331308506,21.824509968486588,24.794627795518636,0.014869204901455808,7.138546455664343,168.74252117919923,165.61374002075195,163.08499908447266,160.55625814819336,157.42747698974608,0.04,0.0,226.57526802474283,0.05514313812312044,0.04523260200584762,164.99285452706474,163.1778564453125,10.581984739297074
2023-05-10,1,170.54999542236328,156.4199981689453,186.43500137329102,161.64624977111816,181.17624950408936,0.5963834807800337,10.440021487873732,-1.260827056012419,2.9938552402263694,164.57750129699707,9.257275104522705,0.06161603973901967,160.30600128173828,185.69349899291993,0.8484540723089482,-0.09242838463695746,1.006570274557375,1.0466191775393419,1.0263739700919927,0.05680600898408983,45.135512653511604,190.31679243406043,169.436749458313,148.55670648256555,166.1485699244908,4.572391748732244,163.4232134137835,4.656847020639866,166.38629047205487,168.34196020845212,4.161968866160251,-6.431385723028126,119840700,4.454481768813631,0.9888451916775763,-4830677600.0,-26.699909526299624,85.04343053981948,79.70440250180728,10.11051343884693,24.727099512633497,22.88357602266427,0.048806355472065584,7.182221708831281,169.22383325195312,166.00307360839844,163.39999389648438,160.7969141845703,157.57615454101563,0.06,0.0,226.39443669981137,0.04937421484120308,0.05133800669250822,165.95142473493303,163.57428414481026,10.251761692211343
2023-05-11,1,170.2849998474121,156.4199981689453,186.43500137329102,161.64624977111816,174.14624977111816,0.7308618138080987,9.751905025485543,-0.9193410447433816,2.9940826727264875,164.57750129699707,8.26651233673096,0.057814891058525365,160.30600128173828,184.44724769592284,0.8333352925737934,-0.07347551424429609,1.009547230961569,1.0363515820154137,1.0135951687836384,0.05356453137159711,49.38427612126811,188.17843430329043,168.67462425231935,149.17081420134826,167.38178416660853,4.314515912744062,163.85071318490165,5.005210227572348,167.45715933809868,168.44289148204996,5.4225681948980595,3.454548479536939,103889900,4.493702838491053,0.8604400721630722,-4934567500.0,-10.652724863113567,85.04343053981948,79.70440250180728,25.744312318059446,23.053091230067558,21.334373061067602,0.03642854247410537,7.153492589492264,169.22383325195312,166.00307360839844,163.39999389648438,160.7969141845703,157.57615454101563,0.06,0.0,226.2411694936396,0.06749382809421411,0.07141523676679362,167.63285391671317,164.07428414481026,9.474322753136148
2023-05-12,1,172.16500091552734,156.4199981689453,186.43500137329102,161.64624977111816,170.94374656677246,0.8839942258632925,9.1046870872856,-0.437496759185688,2.9942851868067075,164.57750129699707,7.433649749755858,0.054199365153851965,160.30600128173828,184.44724769592284,0.7994134433186373,-0.07609461177884815,1.024882421754471,1.039025712611646,1.0143313907049245,0.030419130516816217,48.80246457523151,186.19449838111416,167.98512420654296,149.77575003197177,168.92214148385185,3.696149550730156,164.51499911717005,5.460737954247781,168.18530797838034,168.45667781550878,5.340158479872432,3.6427247014529285,157577100,4.489543107428277,1.2728633235228106,-4776990400.0,-37.58498794428012,85.04343053981948,79.70440250180728,35.92978537847167,24.47836710807071,19.234967222506747,-0.03430714696686136,7.367529487048506,171.477642578125,167.82618115234374,164.875,161.92381884765626,158.272357421875,0.08,0.0,226.01051327010296,-0.012230988244828267,0.04205954657352621,168.68571036202567,164.46214076450892,8.600790869416947
2023-05-15,1,167.0800018310547,156.4199981689453,186.43500137329102,161.64624977111816,170.94374656677246,0.9907643101541688,8.371085268101472,0.12171351464490598,2.9945007291994274,164.57750129699707,6.704949951171875,0.05001309342342996,160.30600128173828,180.75724906921388,0.7222885190273195,-0.07654142383484873,0.9982203589067652,1.0021187529559303,0.9785123355722911,-0.029310083770197948,51.39218312751535,184.12004491059258,167.37787437438965,150.6357038381867,169.70107051304407,2.1565280764726213,164.97232055664062,5.382167270138091,169.18819414029423,168.61417194366817,6.681332388017866,5.710252769927223,105592500,4.481645909553529,0.8567769623573945,-4882582900.0,-44.10233695493015,85.04343053981948,79.70440250180728,7.034350514454965,23.21552160570799,20.896406806861386,-0.05919349090520429,7.213419627621753,171.477642578125,167.82618115234374,164.875,161.92381884765626,158.272357421875,0.08,0.0,225.84595437095862,-0.03166649627581253,-0.021815779773840444,169.42142595563615,164.86785561697823,7.230501360545791
2023-05-16,1,166.51000213623047,156.4199981689453,185.68249893188477,161.64624977111816,170.3512487411499,1.0549788859111453,7.140326356520159,0.8215717022308531,2.994824589818324,164.57750129699707,5.610887203216552,0.042908004440125054,160.30600128173828,172.9695007324219,0.6128709737077541,-0.10018443960975647,1.000600190278773,0.9955338367072457,0.980970912778176,-0.012513324688767424,42.96011893230835,180.69077711031812,166.41012439727783,152.12947168423753,169.6192855834961,2.2797239203373683,165.65428515842981,4.869659294510416,168.65130164916673,167.7737093320027,3.3734997142650056,3.9846898823458132,98288800,4.584946869791215,0.7955067765395073,-4980871700.0,-43.42261643287355,85.04343053981948,79.70440250180728,20.715266755011168,22.00247529380482,20.006668300619985,-0.04140750159727108,7.067460952001746,171.477642578125,167.82618115234374,164.875,161.92381884765626,158.272357421875,0.08,0.0,225.69336629937735,-0.015548269103887291,-0.03067692659428771,168.91571262904577,165.77999877929688,5.850028667450151
2023-05-17,1,170.9900016784668,156.4199981689453,180.20999908447266,161.64624977111816,169.0362491607666,0.6653718767131973,5.61200291003102,0.33944022614430036,2.9951609842860374,164.57750129699707,4.556399879455566,0.03391932333669073,160.30600128173828,172.12900009155274,0.5182212510762049,-0.07602240174153918,1.0334750796202183,1.0193585253912893,1.0098749196638743,0.0025799253468981043,44.184624084839825,176.67550537755716,165.4514995574951,154.22749373743306,169.4571429661342,2.105511544935187,166.69499969482422,4.263540976071216,168.08506051641822,166.7817070003886,-0.34264181966285867,6.082665964335432,125473600,4.461086468087083,1.0156352097114831,-4855398100.0,-17.547381360238298,85.04343053981948,79.70440250180728,112.76897419413187,25.23129202499051,18.407850525384013,0.00021695787302719607,7.1326420073973775,172.64584545898438,169.7170858154297,167.35000610351562,164.98292639160155,162.05416674804687,0.08,0.0,225.51633249927323,0.0315652517867786,0.027845148588947603,169.21142796107702,166.75642721993583,5.067071170292319
2023-05-18,1,175.15499877929688,156.4199981689453,172.16500091552734,161.64624977111816,169.0362491607666,-0.041025999000789765,4.682428926806079,-1.020507272367594,2.995329297644734,164.57750129699707,4.049300022125243,0.028379991185453025,160.30600128173828,171.1035015106201,0.7624761610865336,0.03721453491411198,1.061606571962464,1.038241644015666,1.0339362091901187,0.028599107004425806,60.33075221875107,174.35535754080695,164.9904996871948,155.62564183358268,170.39071437290735,2.9513537833744286,167.64303534371513,4.575350238696448,168.76021981189996,166.7221765893503,-0.6594035273976488,9.314667996469856,109520300,2.9939974867021606,0.9244601161801433,-4745877800.0,-2.6415386121331617,85.04343053981948,79.70440250180728,145.03386203434488,26.666381373723745,17.536008210427244,0.08473501294643979,6.952453336179541,173.00220416259765,170.29390371704102,168.1050033569336,165.91610299682617,163.20780255126954,0.08,0.0,225.37310616840333,0.027952100810157532,0.04954317334841528,170.317143031529,167.65499877929688,5.692796563815246
2023-05-19,1,178.89249801635742,156.4199981689453,175.15499877929688,161.64624977111816,170.3512487411499,0.048336865841146145,5.179271161957509,-1.0145242869613773,2.995242715461699,165.40500259399414,4.550749969482422,0.03129364989646919,160.30600128173828,172.12900009155274,0.7354108258318113,0.06606814075420023,1.0808855197905598,1.0519607389769479,1.0499618317577015,0.039075869456945744,66.5341496431484,175.86404197296287,165.50549964904786,155.14695732513286,171.58250045776367,4.369885793525733,168.86553519112724,5.139310134455404,170.3446686792987,167.59327998228625,3.8755781572813133,8.198847379731319,136024200,3.1046222787446123,1.1421608845402693,-4609853600.0,-7.86271599766412,85.04343053981948,79.70440250180728,171.35367047270748,30.19267683157078,16.506002731874116,0.07327006437096717,6.858706625712899,176.5172759399414,173.15635531616212,170.43999481201172,167.72363430786132,164.36271368408202,0.1,0.0,225.21052283854988,0.07238959382897425,0.04683866499784747,171.97428676060267,168.96285574776786,6.541211182777016
2023-05-22,1,184.75,156.4199981689453,178.89249801635742,161.64624977111816,170.65999698638916,0.23657239168951755,5.931308680035848,-0.7556830018165352,2.9950972257219712,166.79500198364258,5.086862583160399,0.03568023726358143,160.30600128173828,172.4640007019043,0.7350706510402896,0.09840972807425628,1.1113776385697784,1.0789124461144193,1.0758448772877942,0.10575770873412238,71.59252258457428,178.09774175734952,166.23512439727784,154.37250703720616,173.64892905099052,6.536870524638644,170.51535660879952,6.236025672281937,172.46697073915237,168.89330312676876,4.8915290635652715,10.579343757708417,132001400,3.1432982927774153,1.1121201528609788,-4477852200.0,-1.516723974956466,85.04343053981948,79.70440250180728,213.82109500329702,34.85783273413802,14.960659009885218,0.11665192096704528,7.026656632009858,182.31788415527345,177.98606219482423,174.48500061035156,170.9839390258789,166.65211706542968,0.12000000000000001,0.0,225.07656495054286,0.1353771457012043,0.1243600423917839,174.37285723005022,171.0028555733817,8.16394389971993
2023-05-23,1,187.54750061035156,156.4199981689453,184.75,161.64624977111816,171.2737512588501,0.560158751044336,7.1102167792714,-0.10429997677212022,2.994835877027709,167.08124923706055,5.756812305450438,0.04249234063262236,160.30600128173828,175.52874870300295,0.7139279479217004,0.14981872427730983,1.1208283134158736,1.087233464835685,1.0701131777719468,0.1263437523525417,77.87752219058147,181.54980806263214,167.32937450408934,153.10894094554655,175.84642900739397,8.302100776370208,172.38428524562292,7.143197650667785,175.5263839649386,170.81926204881472,8.494582708723373,14.288365367445474,156952100,3.246635255946049,1.3031439182186215,-4320900100.0,-21.585108600300877,85.04343053981948,79.70440250180728,197.46929078265404,35.822976930713494,13.797597208788128,0.06787611834434801,7.074753458797161,185.09884368896485,180.23558181762695,176.30500030517578,172.3744187927246,167.5111569213867,0.14,0.0,224.92616880494654,0.11560172655594614,0.1167417941473398,176.91428702218192,172.7999986921038,8.912416808227494
2023-05-24,1,181.89249801635742,156.4199981689453,187.54750061035156,161.7462501525879,172.13500022888184,0.6511733945780694,8.183914167423623,-0.09953628391276537,2.9945663124787067,167.8512477874756,6.440412521362305,0.048519444481373485,160.94049949645995,179.47824821472167,0.731927950637278,0.19485548041830833,1.078374330245608,1.0430064257117277,1.0135150094554295,0.06376101661424571,82.00599719358912,185.04070278553084,168.6728744506836,152.30504611583635,177.96249989100866,7.54883740428234,173.83178520202637,6.842697459505746,178.52586168273467,173.09856148415534,8.934742609139027,16.213034848887332,137605100,3.0397570325021452,1.1500331458024176,-4458505200.0,-34.15962189306303,85.04343053981948,79.70440250180728,119.74380876828481,33.10534531089051,19.824693177085692,0.15422754245958947,7.108699858294392,186.00980383300782,181.71010205078124,178.23500061035156,174.75989916992188,170.4601973876953,0.14,0.0,224.77328333308205,0.05199581993786451,0.09836649774055037,179.27857099260603,174.3499984741211,8.66563257483657
2023-05-25,1,184.59249877929688,156.4199981689453,187.54750061035156,161.85624980926514,172.91250038146973,0.5417199835654564,8.203899377952503,-0.46644779873759923,2.99457578741522,169.45249938964844,6.515874862670898,0.04828112982252558,161.6029987335205,182.1782482147217,0.7837906946934019,0.16284682358773525,1.0863534506260526,1.0516488147062155,1.0162127180922798,0.05388084876693511,69.19881987269119,186.3271732218474,169.91937446594238,153.51157571003736,180.545713697161,5.887782581968352,175.08249964032854,7.109217521281751,179.3612484355958,174.4731911713656,8.865511146139799,12.538088853587963,96870700,3.420764649330505,0.8199241048792749,-4361634500.0,-29.674957399659196,85.04343053981948,79.70440250180728,124.88413719494513,33.61994954176696,18.5782761868706,0.11673317045020193,7.043792507576309,186.2080465698242,182.0309864807129,178.6550064086914,175.27902633666992,171.1019662475586,0.14,0.0,224.67168683882474,0.04285150012555361,0.06102611626080857,181.84285627092635,175.37928444998605,8.848841128791985
2023-05-26,1,190.22999954223633,161.38249969482422,187.54750061035156,165.3531265258789,176.089373588562,0.5368779564526426,8.18371012208584,-0.8431006844991624,2.9946003050720615,170.4174976348877,6.649599914550782,0.04776633210063796,161.65,184.60824890136718,0.8136952384602545,0.14028693112155316,1.1103263920744426,1.0750038820633205,1.0364780586327422,0.06337605909467614,70.42712520794346,187.69541974063162,171.32799949645997,154.9605792522883,183.29428482055664,5.124892844368126,176.37571389334542,8.106592590841634,180.66038113580572,175.9619679023056,10.859705970258878,10.479854256449489,162061500,3.2990233787964924,1.349127171249655,-4199573000.0,-15.854037765168727,85.04343053981948,79.70440250180728,167.25857902225826,40.30826849184607,16.094710877974006,0.0883689471479797,7.549950534379392,190.5170061035156,185.5165061035156,181.47500610351562,177.4335061035156,172.43300610351562,0.16,0.0,224.536658974666,0.07233262364519377,0.09203459118927204,184.60142735072546,176.90642765590124,9.876898604060589
2023-05-30,1,200.81750106811523,161.38249969482422,190.22999954223633,166.93750190734863,179.64249801635742,0.4871857688701651,8.852545761232987,-0.9167312206082454,2.9944289493360885,170.76999855041504,7.384237232208255,0.051246210136905154,161.65,185.02975006103517,0.7793383232679676,0.17587426782347454,1.1625058075352388,1.1233665678586298,1.0808116237821896,0.08696888264203095,74.93713266412,190.45046601129656,172.74537448883058,155.0402829663646,186.96035657610213,7.121817600129965,178.67553547450476,10.067160244697845,183.04781368092603,177.78811177876034,11.252118647234608,10.518518252570125,128818700,3.4266351991770523,1.0636204968393053,-4070754300.0,-8.273094751667237,85.04343053981948,79.70440250180728,196.52465604873058,41.5152237563399,14.43170873842521,0.07434261389107212,7.81852532182352,195.00931817626952,189.1503396911621,184.41500091552734,179.67966213989257,173.82068365478514,0.18,0.0,224.45954174059727,0.06507125992827123,0.11668704531853574,188.06857081821985,179.19285692487443,11.319733160287925
2023-05-31,1,200.69499588012695,161.38249969482422,200.81750106811523,167.08187294006348,182.56749820709229,0.7761840803579352,10.389646935165874,-0.09559567911289157,2.9939881536895703,171.5575008392334,8.629849853515623,0.0594722557384955,161.65,187.81575050354004,0.7150830558951607,0.24227896802436402,1.14881518062179,1.1018857761855956,1.0617884004601128,0.07010221531605798,80.85127931740678,195.47666840493866,174.69737453460692,153.91808066427518,190.0749991280692,7.745586948526154,180.82874979291643,11.338986146860849,187.4864237657734,180.74113591566228,14.651310249588857,19.094711386658755,150711700,3.954015219667687,1.2329566889886494,-4221466000.0,-1.370553685437612,85.04343053981948,79.70440250180728,163.32236058114935,38.196886251153074,15.459748000756067,0.1654190443425858,7.890773643911522,195.00931817626952,189.1503396911621,184.41500091552734,179.67966213989257,173.82068365478514,0.18,0.0,224.36974190324796,0.09775522412480431,0.07973737463830359,191.4671412876674,181.72071402413505,12.466091240328035
2023-06-01,1,204.81999969482422,161.38249969482422,200.81750106811523,168.23562335968018,184.63187408447266,0.7435124118230001,11.376262596078446,-0.39014458142086017,2.9936881346611455,172.14500045776367,9.622149734497071,0.06440019722562032,166.02175178527833,191.2764991760254,0.770321978306009,0.24359826040396587,1.1594711588887816,1.1038162311265138,1.0687441193761682,0.12604973777645823,80.74280015851022,199.4020245131408,176.6494993209839,153.896974128827,192.94214194161552,9.050603788973097,183.29553549630302,12.559589820456601,190.79329702625984,183.20328884068826,12.187485839554867,17.675169315079867,148029900,3.9495728243385515,1.1971579710977096,-4073436100.0,-5.016499301184282,85.04343053981948,79.70440250180728,164.35855495881367,39.84812663555582,14.032925585613775,0.23231154303761675,8.072147521815864,199.07380377197265,192.4381042175293,187.07500457763672,181.71190493774415,175.0762053833008,0.19999999999999998,0.0,224.29929944842905,0.13460913722015055,0.11708025784453446,194.13142830984933,184.25214276994978,13.533501188112181
2023-06-02,1,212.77999877929688,161.62749862670898,204.81999969482422,169.86874961853027,185.4493751525879,0.73380605081296,12.358280637923604,-0.5945622251060807,2.993380242611507,173.6599998474121,10.484512271881105,0.06910963907334994,167.02300186157225,200.70724639892578,0.7763596724920377,0.2672348544344648,1.189902491171762,1.1261820921904786,1.084334278841306,0.15270122126523478,82.5574704714935,203.53793559683106,178.8213743209839,154.10481304513672,196.54678453717912,11.291330337895971,186.19660677228654,14.353452078242231,194.30815833307892,185.91515821105477,10.863328657550321,20.280705804009756,164129000,3.9502871732997065,1.2913159398397156,-3909307100.0,-6.200376479655619,85.04343053981948,79.70440250180728,180.4796522507407,42.96388571732683,12.842180050859424,0.23636367334958822,8.190565250796178,204.7656014404297,197.04220233154297,190.8000030517578,184.55780377197266,176.83440466308593,0.2,0.0,224.25528313438826,0.15991760071983574,0.16987429393684594,198.15999930245536,187.53714316231864,14.835259947535727
2023-06-05,1,217.80500030517578,166.51000213623047,212.77999877929688,170.4837465286255,188.21812534332275,0.8192740950134451,13.750039830180636,-0.5107543203462774,2.99291191824597,177.02374839782715,11.571399841308594,0.07580833437761453,167.08224716186524,201.21775093078614,0.7859586609607558,0.27350262926614477,1.2008281064036952,1.1302699710392279,1.0789449636360293,0.14495611012613718,85.03306305242783,208.87907898897456,181.37899932861328,153.878919668252,201.67714200701033,11.675362197262015,189.81982094900948,15.512126891257827,198.95556471675366,189.573301537986,13.453923985565831,23.590740073644383,151143100,4.0934847989735745,1.1690489010767382,-3758164000.0,-6.462932041025625,85.04343053981948,79.70440250180728,169.9151652739592,43.750406964714955,12.016109285004463,0.19405657336697105,8.128381451841387,207.85215631103515,199.53891818237304,192.81999969482422,186.1010812072754,177.78784307861326,0.2,0.0,224.23081599019793,0.1265206951031348,0.1796498030593016,203.11857169015067,191.19857134137834,16.495177375566104
2023-06-06,1,217.9724998474121,166.51000213623047,217.80500030517578,170.88000011444092,192.84624862670898,0.7751517308643134,15.451693832473719,-0.6027719661461388,2.99227033907104,180.39249801635742,12.880137405395507,0.08401535150247616,168.46599922180175,205.6159996032715,0.8203556051629525,0.2653885275536719,1.1851798509019484,1.1087500605793945,1.0510599963137601,0.08542581541973315,86.2368735293077,214.81851217666613,183.91512451171874,153.01173684677136,206.44571358816964,10.26615168956971,193.49571364266532,15.660322488364377,203.68493339117714,193.25953745489755,19.743806193474114,30.359706678368603,146911600,4.092893139106685,1.1212884533314273,-3611252400.0,-1.0965023576947337,85.04343053981948,79.70440250180728,146.75856771405316,40.18341237776687,12.766132429351558,0.23489939712623847,8.217783125482235,208.9960833740234,201.00696319580078,194.5500030517578,188.09304290771485,180.10392272949218,0.2,0.0,224.21006491265769,0.10016898752065329,0.14567479244389372,208.38142830984933,195.11214229038782,18.10397602200956
2023-06-07,1,226.6500015258789,166.51000213623047,217.9724998474121,170.88000011444092,200.72562217712402,0.6141631980657026,16.86845423044398,-0.9383342411615434,2.9916942516794935,183.24249839782715,14.300749969482421,0.09058955345712877,168.46599922180175,213.28249893188476,0.8476349935069992,0.29268474219041857,1.217190511281751,1.1337304301375069,1.0751158136989458,0.12932562434817552,88.00658915391736,219.9444079649773,186.20749950408936,152.4705910432014,211.6485710144043,9.900665081581085,197.47142791748047,16.547380884581457,207.24483182422614,196.24676288357108,18.083075579373975,30.906550387932555,185710800,3.8910014211423216,1.3669515150915148,-3425541600.0,-10.722839985028719,85.04343053981948,79.70440250180728,152.5699681506356,44.561997432985315,11.721590980367969,0.16344907719005408,8.310798921695055,217.05232067871094,208.5288399658203,201.63999938964844,194.75115881347656,186.22767810058593,0.2,0.0,224.21926503565555,0.10121127538729469,0.11637504094219168,212.86714390345983,198.73428562709265,19.40496671965511
2023-06-08,1,229.32999801635742,166.51000213623047,226.6500015258789,171.8712511062622,201.81812572479248,0.555804269162507,18.505129958803145,-0.9733639883409229,2.9910167716425238,184.67124938964844,15.889799957275391,0.0978543062183104,169.96450004577636,217.8217502593994,0.8363808431266725,0.3289358405702985,1.2126868549908074,1.1251290871583095,1.061685919960174,0.1196660402209373,90.04784812676428,226.11925955139532,189.10899963378907,152.09873971618282,215.7217848641532,10.546107508849863,201.34107072012765,17.246879689240316,212.0844619858072,199.8941137900845,19.145246318289733,32.551610796563615,164489700,4.11532792028574,1.1911767597217424,-3261051900.0,-0.6279618613133009,85.04343053981948,79.70440250180728,146.72727495892588,43.69264821657693,10.530526662179136,0.23932281750732567,8.59002765733864,221.32487615966795,212.72255642700193,205.7699966430664,198.81743685913085,190.21511712646483,0.2,0.0,224.24705495605846,0.13174631734295295,0.1516697349356771,217.68142918178015,202.875,21.153975625048123
2023-06-09,1,246.97750091552734,166.51000213623047,229.32999801635742,174.4074993133545,206.80999946594238,0.4499142419801103,19.936567325102917,-1.101099027927747,2.9904104064783836,186.14875030517578,17.448599700927737,0.10381033569553043,169.96450004577636,218.8402500152588,0.8516785909335313,0.34674221582555115,1.286019647274043,1.1841510754460782,1.1180132012571682,0.1607176535972319,90.73394667009136,231.92113441369457,192.04799976348878,152.17486511328298,222.33357129778182,13.616336152673226,206.2042852129255,19.83498567779504,216.37366479045528,203.48722123281834,14.198213201831967,30.92974771751931,199882300,4.046098087213952,1.3988572514723856,-3061169600.0,-10.808631539506964,85.04343053981948,79.70440250180728,170.97664886768794,51.057461480720264,9.099624305932833,0.17297845441714157,9.2307397931429,234.90879888916015,224.0755993347168,215.31999969482422,206.56440005493164,195.73120050048828,0.2,0.0,224.35570807480784,0.14221616349103883,0.1777177566727605,223.46285792759485,207.46499960763114,23.414688577500968
2023-06-12,1,248.33250045776367,166.51000213623047,246.97750091552734,177.95812320709229,214.0362491607666,0.559649228758284,22.58192781808911,-0.6930526204240102,2.9891987402114526,188.88875007629395,19.490387268066407,0.11528295497978981,170.5990016937256,226.91800117492676,0.8050936200517324,0.43453953824625896,1.2677617562552972,1.1560686286660034,1.0903875806252539,0.14015977645056132,93.33687589789452,241.04648045307272,195.88262481689452,150.71876918071632,228.5496428353446,14.207802850245791,210.74589238848006,21.73313663562817,223.9955105706164,208.97571797839538,23.061115615979013,38.059171655674696,150337900,5.1700713417877715,1.0547974361062122,-2910831700.0,-3.490561245841106,85.04343053981948,79.70440250180728,154.53904405573374,48.40715816464687,8.627278760862158,0.25442024333029967,9.040687473933941,234.90879888916015,224.0755993347168,215.31999969482422,206.56440005493164,195.73120050048828,0.2,0.0,224.44479426674462,0.1480630537674399,0.16759358978253747,229.50714329310827,211.8192858014788,25.195317239595056
2023-06-13,0,255.80999374389648,166.51000213623047,248.33250045776367,181.14249801635742,217.84687519073486,0.4947786781713364,24.593961303049415,-0.8201746719948511,2.988263092064045,195.46249771118164,20.926999855041505,0.1231600889795715,170.5990016937256,231.09474830627443,0.8260808899395287,0.486308940245695,1.2810291600912427,1.1595155161901158,1.093894628353263,0.17358838350237704,95.53497428152303,248.87892240010518,199.69099979400636,150.50307718790754,234.69678497314453,15.497868314467441,215.62178475516183,23.696879452101545,230.04941662054478,213.7867428902999,21.244263659687434,34.41542649946613,162384300,4.7624856107956886,1.1170618213507182,-2748447400.0,-1.1907700987644239,85.04343053981948,79.70440250180728,155.50515834440108,51.501775829735266,7.960146307011402,0.30353460388229797,9.098494857562011,240.45543469238282,228.5622759399414,218.9499969482422,209.33771795654297,197.44455920410155,0.2,0.0,224.57253736721387,0.16899369350262816,0.188869954181561,235.89857046944755,217.02928488595145,26.932788897481135
2023-06-14,0,257.25750732421875,166.51000213623047,255.80999374389648,183.917498588562,220.1418752670288,0.4787535020759482,26.257829662867568,-0.8937524566112365,2.9875836613894826,200.7562484741211,22.332999877929687,0.12863445513896857,174.73849906921387,247.11300086975098,0.8215972178469507,0.5363040685964622,1.2602785420554885,1.137717306206369,1.0656014765239163,0.13504304254260102,96.31087836444708,256.6431587153836,204.12749938964845,151.6118400639133,240.3328574044364,15.504838762642757,221.00499970572335,24.00354110103865,236.50392344161634,219.13930413375132,20.222763047024866,36.39744220071852,170575500,4.669578070676414,1.1449428644476867,-2577871900.0,-5.901961297805233,85.04343053981948,79.70440250180728,134.9268131641985,48.55533382760851,7.2789048856555825,0.30927537720512494,9.239317176608978,242.45636602783202,230.63182522583008,221.07500457763672,211.51818392944335,199.69364312744142,0.2,0.0,224.70442895402888,0.14347419588487664,0.16031815723523507,241.49571446010046,222.30714307512557,27.607937570579764
2023-06-15,1,252.6349983215332,170.9900016784668,257.25750732421875,184.71062469482422,227.32000064849854,0.4313957536814133,27.189555467778206,-1.07799534991636,2.9873583575751352,202.81875038146973,23.493112907409664,0.1303025030614671,178.51874809265138,249.08024978637695,0.8445541861105348,0.5045178361245425,1.2107212521821817,1.0900081254112501,1.0205763406463024,0.1016221188102635,96.33393911640358,263.04398558460423,208.66487464904785,154.28576371349143,245.28464290073939,12.39701559643589,225.8651782444545,22.928144785197194,241.71431184616767,224.18876418077875,18.11368286483983,41.43381949764845,160171200,4.725855502363289,1.0627313324250058,-2738043100.0,-7.3598296973554636,85.04343053981948,79.70440250180728,114.87117559032862,44.25882321370553,9.070864025754087,0.2967161462746852,9.41222444405829,243.3885653076172,232.1407240600586,223.0500030517578,213.95928204345702,202.71144079589843,0.2,0.0,224.81856756236678,0.08958525603105816,0.13951100124886032,246.43714250837053,227.40928540910994,28.041284503534428
2023-06-16,0,260.0675048828125,175.15499877929688,257.25750732421875,186.84812545776367,233.7418737411499,0.3108553237591846,27.355181391547816,-1.2899244805235772,2.9875383747643642,208.79999923706055,23.807875442504884,0.12858073385600557,181.5924980163574,252.95249786376954,0.8722360874988497,0.4423510609586689,1.2224254758648578,1.0993955104169844,1.0311852766148872,0.053000795290103264,88.29177245127119,267.45748726429684,212.74712448120118,158.03676169810555,250.0585719517299,10.278345629799936,230.8535714830671,22.163125907128347,244.45226396094802,227.79308582177202,15.902234684827663,36.860923381068446,167563700,5.150851522532984,1.0907765668142528,-2570479400.0,-4.468453661908248,85.04343053981948,79.70440250180728,118.77118182389812,45.21382038808959,8.533832360665764,0.2603974181027908,9.289923569984886,247.4387235107422,237.44064190673828,229.36000061035156,221.27935931396485,211.28127770996093,0.2,0.0,224.9629799385483,0.06603934145462209,0.1093417690021008,251.57571411132812,232.22142900739397,28.428805057914253
2023-06-20,0,267.9550018310547,178.89249801635742,260.0675048828125,189.55937480926514,247.31625080108643,0.2059188033146667,27.777385389211968,-1.404767577425117,2.987575905567429,215.29249954223633,24.29100074768066,0.12801066126199145,184.32249870300294,255.95474510192872,0.8649404649030882,0.4537641755051834,1.2348569345973477,1.110538945279004,1.0515441294411034,0.07901704906574802,89.59934078916498,272.54752056480095,216.99274978637695,161.43797900795295,255.57642963954382,7.20355796469559,235.6491072518485,22.42602243829395,248.33909410731007,231.93609257263122,14.744100212643493,36.712140834059305,165611200,5.203809966588544,1.067783757721808,-2404868200.0,-0.3767270809668128,85.04343053981948,79.70440250180728,127.45540419048808,48.714449343383755,7.635428261936577,0.2932472241509729,9.641356990348804,255.95731884765624,244.33133813476562,234.93499755859375,225.53865698242188,213.91267626953123,0.2,0.0,225.14309155690663,0.09854705277801523,0.1229542514770869,257.23143005371094,237.45642961774553,29.561444020097923
2023-06-21,0,267.3399963378906,181.89249801635742,267.9550018310547,198.0787467956543,249.40812492370605,0.1260299147834335,28.44343355719854,-1.4213153521001594,2.9874923114437366,217.88875007629395,25.200213222503663,0.12844417878697623,184.7342498779297,257.53850708007815,0.8640681741396264,0.450365368503679,1.2072475785133605,1.0854297701169215,1.0332180141708562,0.04507252599965805,90.70620069116485,278.3327420915089,221.44587497711183,164.55900786271474,258.48535755702426,7.263543430108471,240.40946442740304,21.489376291858804,253.23549206064058,236.22093924724248,16.842543125100562,33.4320965084448,211797100,5.255837562532683,1.3313216147140836,-2616665300.0,-22.584385315704797,85.04343053981948,79.70440250180728,101.45463305496996,42.24043008382519,8.931354864831725,0.1935369683597894,10.32483088068682,258.67167138671874,247.33915209960938,238.17999267578125,229.02083325195312,217.68831396484376,0.2,0.0,225.3441222826014,0.002898998974804723,0.03854616960910737,259.3828582763672,241.42285810198103,29.481371188281575
2023-06-22,1,257.15749740600586,181.89249801635742,267.9550018310547,200.78687477111816,253.42874717712402,-0.006200490328764341,28.809031579387387,-1.4296854469994065,2.9875393498589116,222.3112506866455,25.660125541687012,0.1277135485453391,187.2520004272461,260.7947540283203,0.8773381083368207,0.4254521946059726,1.1400069606039227,1.0235714979069428,0.9850852733467718,-0.00038875412909467055,89.60139970418784,283.19343795278115,225.57537479400634,167.95731163523152,259.7460714067732,5.832542161477082,244.14785712105888,19.25844730546032,256.7421583808993,239.9144057496943,8.244676274916142,33.207106218816755,166875900,5.364013737210077,1.0456928823930989,-2783541200.0,-18.411669662146217,85.04343053981948,79.70440250180728,78.69061213953842,37.5539753243326,14.252841094361266,0.2854461332042325,10.783771532066462,261.1213525390625,251.30431396484374,243.3699951171875,235.43567626953126,225.6186376953125,0.02,1.0,225.4793447921936,0.030452807922519476,0.022805435009682795,261.4942844935826,245.50071389334542,29.006458501458905
2023-06-23,1,257.78500747680664,181.89249801635742,267.9550018310547,203.81937503814697,256.1468696594238,-0.18593204265481858,28.20304919853502,-1.3767856550494166,2.9880616421889576,227.98999977111816,25.230375289916992,0.1231273777353478,189.66624946594237,260.7947540283203,0.8752983737658447,0.4137883651632511,1.1254241258337043,1.0137591299338848,0.9875647249480379,0.020385176992456566,76.68308982660514,285.4619730308591,229.05587463378907,172.64977623671905,260.02821622576033,5.655485727290158,247.36250059945243,17.27358049204132,256.81380628239816,241.73351915318676,3.5537019648957067,25.552923439685078,176584100,5.8729217746966995,1.093176660285411,-2606957100.0,-31.631999431878704,85.04343053981948,79.70440250180728,66.47604510620882,34.63611567906349,13.145427311918807,0.24653840739058167,10.85707230119064,261.7774322509766,252.36627349853515,244.75999450683594,237.15371551513672,227.7425567626953,0.02,0.0,225.61285588270434,0.002735491300223991,-0.000739913684659626,261.19285801478793,248.54571424211775,27.269420017760343
2023-06-26,1,247.54750061035156,184.59249877929688,267.9550018310547,210.7899990081787,257.1824998855591,-0.31059713134225597,26.665741141250486,-1.3358820911717093,2.989071868941933,238.15374946594238,24.281250762939454,0.1145187196463764,199.64849624633788,260.7947540283203,0.8629813257200867,0.3965085752754257,1.063117753652229,0.9627263057674496,0.9446178527568933,-0.04814136344370479,76.66951982877947,286.18198238931257,232.85050010681152,179.5190178243105,258.6410724094936,7.377097120549014,249.48696490696497,15.043774843995251,257.0522305767798,243.80243613899094,0.7720627736254261,21.15095824593485,179990600,5.914434946606331,1.0863159948044827,-2786947700.0,-55.7554947981394,85.04343053981948,79.70440250180728,31.312905253592298,30.78237453081791,19.301897320492262,0.18074079163733253,11.343709863173233,261.7774322509766,252.36627349853515,244.75999450683594,237.15371551513672,227.7425567626953,0.04,0.0,225.70272998240222,-0.07480619042738545,-0.05803044626383871,258.94428580147877,250.22000013078963,24.648455853661325
2023-06-27,1,246.17250442504883,190.22999954223633,267.9550018310547,216.54874992370605,257.1824998855591,-0.39677094497067816,24.403109977153342,-1.2809037247834345,2.990295545366841,247.26250076293945,22.28842571258545,0.10340377505613592,200.8052505493164,260.7947540283203,0.8636581005141094,0.30130631974999905,1.0431115663702286,0.9571666864190699,0.9484333064814107,-0.08129162455321393,63.373225948482045,284.80447015267094,235.99825019836425,187.19203024405755,257.7178589957101,8.563054090461344,251.50125094822474,12.099327269763352,254.69255301959458,244.5741855890632,-3.774430847465911,13.65556358371126,164968200,6.675564261751616,0.994777166910409,-2951915900.0,-49.61094042259327,85.04343053981948,79.70440250180728,27.055613595945353,28.912003390148165,18.12909267956776,0.21729669556425044,11.214872964813177,264.2507112426758,256.36963186645505,249.99999237060547,243.63035287475583,235.74927349853513,0.04,0.0,225.78615751541477,-0.08832211482970753,-0.03964842823467401,258.13143048967635,252.28428649902344,22.51505748470998
2023-06-28,1,253.67749786376953,200.69499588012695,267.9550018310547,217.93062496185303,257.1824998855591,-0.46712301087838365,22.09359637933546,-1.219737783319981,2.991379025827043,247.26250076293945,19.94930084228515,0.09252103956533685,204.41974983215331,260.7947540283203,0.8767663582810332,0.22585184615732093,1.0623216525600088,0.9871766428294704,0.9940321301095254,-0.05110532902399345,60.1143752277286,282.9825682011758,238.79537544250488,194.60818268383395,256.80500085013256,8.611289919451576,253.43178640093123,9.758989062785897,252.56614687777324,244.96869613669622,-2.5580358776179697,12.937413938628794,159770800,6.493472709660879,0.9545283651586525,-2792145100.0,-38.44016606584118,85.04343053981948,79.70440250180728,49.17726607793517,32.93830756716271,16.858301980134453,0.22968246903912262,11.198811002552523,264.2507112426758,256.36963186645505,249.99999237060547,243.63035287475583,235.74927349853513,0.04,0.0,225.89581533871487,-0.01241039592518689,-0.06635096069487338,257.5171421595982,254.54642813546317,20.83646888283899
2023-06-29,1,257.46999740600586,200.69499588012695,267.9550018310547,224.4806261062622,257.1824998855591,-0.6368386317858158,20.496328551916875,-0.9435303725369142,2.9920544264668063,247.94000053405762,18.00161329269409,0.08489258813124777,211.9839988708496,260.7947540283203,0.8348287218450207,0.2639951322717009,1.0664004721907783,1.0027671644223348,1.0198123953086071,0.0012152085906584897,65.18982580749444,282.43103238612133,241.4383752822876,200.44571817845386,255.30714307512557,7.133729010912516,255.44178635733468,6.888908728466226,252.83573745872744,246.06574674712041,-2.457057071363965,11.924772184395783,131283400,6.561334757328754,0.7889128881068603,-2660861700.0,-53.70623819272665,85.04343053981948,79.70440250180728,54.47402962862678,31.96360494102388,16.071215668795343,0.18954138471982895,10.908180904086104,268.4255518188477,263.12721279907225,258.8449935913086,254.56277438354493,249.26443536376954,0.04,0.0,225.99231670251748,-0.026869678943204356,-0.007554118244151219,255.09571184430803,256.1635709490095,18.958630331082695
2023-06-30,1,261.67750549316406,204.81999969482422,267.9550018310547,228.6599988937378,257.3106298446655,-0.7640779603685172,18.490280669933817,-0.7183184325501695,2.9928055747097186,250.48374938964844,15.630525398254395,0.07569386876806984,217.3025001525879,260.7947540283203,0.8030071132924609,0.2570549643083126,1.0712321307573929,1.0190697894001943,1.0362213826860232,0.015099784329806853,66.86388481108592,281.25768669844916,244.27712535858154,207.29656401871392,254.49821581159318,5.723518062592426,256.49178668430875,6.614360138751163,253.96574282690528,247.81298110800014,-3.9129720861339288,12.27052702788638,112267600,6.558189540612276,0.6819703758419268,-2548594100.0,-41.9399394778037,85.04343053981948,79.70440250180728,73.57579696609726,32.96426634993469,15.320356061135794,0.16031386105203865,10.625454568582134,268.4255518188477,263.12721279907225,258.8449935913086,254.56277438354493,249.26443536376954,0.04,0.0,226.08683547241188,0.020148023332745346,-0.01073276329355972,255.42571149553572,257.4042848859514,17.052917267031145
2023-07-03,0,278.91749572753906,212.77999877929688,267.9550018310547,241.96187782287598,257.54874992370605,-0.8581194629144675,16.465234966377775,-0.5449125833956847,2.9934659982675007,253.15624809265137,13.215250072479245,0.0666285000128249,217.95574989318848,262.2437545776367,0.7871129167003784,0.229803115867979,1.1286722847021557,1.0823970904053122,1.101095872829759,0.12672313410493685,68.20125048300258,280.0504705812541,247.12000064849855,214.189530715743,257.60678700038363,10.940284146533946,258.6764292035784,8.495555733319552,255.88694449008287,250.2994685835148,-2.118085928889499,5.951961017965154,119685900,6.454636333871587,0.7369810310323116,-2428908200.0,-10.172198313089307,85.04343053981948,79.70440250180728,156.02835786741676,40.67832282056059,13.17603255088809,0.15730304696709216,11.472208598421274,273.9721992797852,267.6138988342285,262.4749984741211,257.3360981140137,250.97779766845701,0.02,1.0,226.23637098010204,0.16083801610297566,0.09049103923768376,257.59857177734375,259.54642813546315,16.4802855287998
2023-07-05,0,280.68750762939453,217.80500030517578,278.91749572753906,246.77625179290771,258.3556318283081,-0.6839124468600828,15.866971654598245,-0.13606439137201765,2.9936920266669027,254.743745803833,12.262749786376952,0.06335969980529245,225.78225135803223,267.40149688720703,0.6956144948610983,0.2805835280950207,1.1208362004819168,1.0813557311491666,1.0813015776510877,0.14020657296783656,75.6866793682092,282.16081880510717,250.42687549591065,218.69293218671416,260.8785727364676,13.999373391558988,260.453394481114,10.2669474030096,261.6287137397313,254.70691559560512,8.461739805772819,12.316146784410638,131530900,7.228693231249983,0.8148382939906907,-2297377300.0,-4.06426840330711,85.04343053981948,79.70440250180728,161.4350768842327,39.04217103889607,12.646069965446667,0.1852194016804383,11.09919369853398,273.9721992797852,267.6138988342285,262.4749984741211,257.3360981140137,250.97779766845701,0.02,0.0,226.4045829916296,0.1289716774172185,0.17187308612344027,261.29571533203125,261.2442866734096,15.870654054948947
2023-07-06,1,276.87000274658203,217.9724998474121,280.68750762939453,247.4050006866455,260.4700050354004,-0.5162430174488679,15.31180005673013,0.20428289194724503,2.9938864753699534,256.4837455749512,11.295050277709958,0.06038466545729285,229.06199836730957,269.05125122070314,0.6593050030166457,0.28771981706813926,1.0918835426970972,1.0614420792764705,1.0389664068300026,0.09142515626382997,76.3345645141736,284.19460097558186,253.5710008621216,222.94740074866132,265.067501613072,13.729974544414738,261.8542870112828,11.101451916744267,266.39331461358904,259.06078961878796,8.884341404008326,9.724996870295891,120332100,7.201926072694667,0.7516497214765684,-2417709400.0,-17.70376788703101,85.04343053981948,79.70440250180728,130.32863569313875,36.60662461522461,14.924313238174905,0.14796240307205993,10.992108870318368,273.9721992797852,267.6138988342285,262.4749984741211,257.3360981140137,250.97779766845701,0.02,0.0,226.5440704493625,0.07922267828678531,0.10523160994582005,266.36571611676897,262.65500095912387,14.529947688009303
2023-07-07,1,276.8524932861328,226.6500015258789,280.68750762939453,248.13625049591064,263.0931282043457,-0.2549809221345803,13.768022446007906,0.018684288816841477,2.994283152898236,257.2075023651123,10.151038818359376,0.05367317867541226,244.48825378417968,277.0747520446777,0.6784591439817962,0.22157511971147728,1.0792801505918934,1.0575112955633827,1.021126793954645,0.07528059997438308,70.81941597221724,284.0519208990959,256.51587600708007,228.97983111506423,269.45035716465543,11.390583511816832,263.5841080801828,11.436137140557985,269.05706121979506,262.4761789225588,11.8452022597413,7.623682444238983,113602000,7.251246787218922,0.725959934107515,-2531311400.0,-22.548809726943027,85.04343053981948,79.70440250180728,117.38722774592436,35.435148018341565,14.22641864430005,0.15993764612582892,10.707673219983091,273.9721992797852,267.6138988342285,262.4749984741211,257.3360981140137,250.97779766845701,0.02,0.0,226.6746863687512,0.06574754437196595,0.0709881483556427,269.8257141113281,263.9785723005022,12.788782241800497
2023-07-10,1,272.1749954223633,229.32999801635742,280.68750762939453,251.55937385559082,267.49374771118164,-0.0639577067006993,12.622919385697662,-0.1456283839183108,2.9945422502638404,257.3637523651123,9.815950317382818,0.04873224833297604,246.8970012664795,277.0747520446777,0.6353312795667393,0.2072231966198585,1.0507632237576987,1.0318814861880534,0.9897236535715734,0.0401161342065508,70.46131088600596,284.2718393664881,259.0260005950928,233.78016182369748,272.09285681588307,9.020654897702721,264.4489288330078,11.606278351572954,271.0315346404847,265.0881318438894,12.46280080415114,9.585962010606922,119425400,7.2755026512928795,0.7743230725684983,-2650736800.0,-33.61656400124313,85.04343053981948,79.70440250180728,69.12176532613647,32.5324656368263,18.779298357671312,0.10157924540640574,10.829981054995473,273.9721992797852,267.6138988342285,262.4749984741211,257.3360981140137,250.97779766845701,0.02,0.0,226.7959031574507,0.029949943335487283,0.04702906932645631,271.73571341378346,264.62642778669084,11.518177821458817
2023-07-11,1,268.92749786376953,246.17250442504883,280.68750762939453,253.41687297821045,269.01000022888184,0.39741451546685297,10.922501274963839,-1.0793256462159158,2.99486210989639,257.62750244140625,9.312899475097652,0.04182170403753254,247.49050064086913,277.0747520446777,0.7574290146614908,0.10202344105609089,1.0297097651975298,1.0140372591436526,0.9705052819131093,-0.03581703556354987,61.86612111078647,283.0132530153207,261.16825046539304,239.3232479154654,273.72964259556363,6.654212886778633,264.51839283534457,11.631758721751202,271.34219648545184,266.65662963714334,7.291737625277004,4.655518398965864,91972400,6.495409133207492,0.6179424658640544,-2742709200.0,-33.20319274809896,85.04343053981948,79.70440250180728,49.30007157076346,31.51834314423396,18.193898250829776,0.15743243492000836,10.37998232101695,273.9721992797852,267.6138988342285,262.4749984741211,257.3360981140137,250.97779766845701,0.02,0.0,226.8851587198332,-0.03584446614525105,0.03063765850878775,273.4914289202009,264.2935703822545,10.912076236703097
2023-07-12,1,274.07498931884766,246.17250442504883,280.68750762939453,255.27686977386475,269.73937225341797,0.27108522314852407,10.537454889897605,-1.110725064954695,2.994927640443504,258.92625617980957,9.15989883422851,0.04017853981059117,248.25400047302247,277.0747520446777,0.756331627418232,0.08293315360672515,1.0450277590267032,1.0251820538909329,0.9962649918736456,-0.023558292160539285,57.78280748947978,283.34066009260033,262.26575031280515,241.19084053300998,275.5007117135184,4.0533884947382095,264.9994637625558,11.893756032209197,270.7377624586147,267.0520321821828,4.450033236181797,0.3629325916923922,95672100,6.575149766662034,0.6548254035742676,-2647037100.0,-28.151570393816876,85.04343053981948,79.70440250180728,72.5231401958364,33.98804240159313,17.32960238439625,0.10143223689436491,10.119267902997855,273.9721992797852,267.6138988342285,262.4749984741211,257.3360981140137,250.97779766845701,0.02,0.0,226.98704691064955,-0.037135444434901355,-0.027982334661192945,274.95142909458707,265.18857029506137,10.645842475241745
2023-07-13,1,275.63500213623047,246.17250442504883,280.68750762939453,256.8206214904785,272.6499938964844,0.10971905701708477,10.327022801546457,-1.180296427008046,2.994965328513323,260.8725051879883,9.182410736083984,0.03918387462520693,252.12624855041503,277.0747520446777,0.7691003134501724,0.07140063336711201,1.045843276767758,1.0203677591985896,1.0067755366996844,-0.0044605793263994276,60.4830558890768,284.20692035895223,263.55287475585936,242.8988291527665,275.0317840576172,3.772358206514406,266.3192855290004,11.981491657572906,271.6099068664994,267.64711393519786,4.73769566181051,2.519261267754595,112681500,6.4757382147957205,0.7845913272200826,-2534355600.0,-14.580954439816782,85.04343053981948,79.70440250180728,82.82847252923519,33.932543568013905,16.237248019124202,0.08529248000723362,10.028606345891973,273.9721992797852,267.6138988342285,262.4749984741211,257.3360981140137,250.97779766845701,0.02,0.0,227.11333386371842,0.004917861103419963,-0.01621359711029401,274.67714146205356,266.13785661969865,11.009698637030402
2023-07-14,1,280.0,246.17250442504883,280.68750762939453,257.2325048446655,274.46499252319336,-0.08303335968103054,10.486472349306748,-1.237521290049582,2.9949453893826226,264.50875091552734,9.399373054504395,0.03963978539440599,252.12624855041503,277.0747520446777,0.7747561243037511,0.07143618471297232,1.0584245626859858,1.028169083629739,1.0236425019958433,0.011368894231391868,61.44808885775836,285.51706987408954,264.5441251754761,243.57118047686262,274.9335686819894,3.605841449168755,267.9060707092285,12.232703569582265,272.63453105127326,268.2215255828078,-1.176869017393983,7.1852871942722025,119771100,6.476231469511636,0.8489716246050231,-2414584500.0,-8.789201154331051,85.04343053981948,79.70440250180728,105.93943996157024,35.94130190201134,15.189811598641707,0.0840120697038378,9.95441948078361,274.7743899536133,268.2627912902832,262.99999237060547,257.73719345092775,251.22559478759766,0.04,0.0,227.26055187260445,0.025325264703272232,0.017501975078967294,274.5199977329799,267.9078565325056,11.42349361005557
2023-07-17,0,288.20250701904297,246.17250442504883,280.68750762939453,257.39187240600586,275.93937492370605,-0.2307863621667821,10.861054886338602,-1.242690836883601,2.9948936419354597,267.64749908447266,9.69412343978882,0.04088002030303549,252.12624855041503,279.02574615478517,0.7483136462096884,0.10831833221950847,1.0847679586946615,1.0496054749017776,1.051210542021914,0.05888678925780111,66.29166008198936,287.40335958194225,265.6812498092651,243.959140036588,276.55249786376953,6.217997817839448,270.80999973842074,11.847499486882167,274.5170704605833,269.4580764911555,-0.24493702452275903,8.617643338002145,131569600,6.378162178117796,0.9421531799503007,-2283014900.0,-3.6006343474180613,85.04343053981948,79.70440250180728,142.38940439145742,38.10189268789343,14.014761449323727,0.08450713096019785,10.018389953835904,280.10432983398437,272.60284912109375,266.5400085449219,260.47716796875,252.97568725585936,0.06,0.0,227.44447839166563,0.07703727851239117,0.058120513911447756,276.4971400669643,271.4314280918666,12.364064974589724
2023-07-18,0,291.19000244140625,246.17250442504883,288.20250701904297,257.70625495910645,276.8568706512451,-0.21284020173105583,11.473883888120977,-0.9432773691361382,2.994808701533934,268.4412498474121,9.824161529541016,0.042899498859491285,253.06449813842772,280.06875076293943,0.7513671952122011,0.10818345855591692,1.0887250820590368,1.0503392108693883,1.0498327247927906,0.08278255200557516,70.43294006083741,290.4073930203826,267.4596252441406,244.5118574678987,278.60071345738004,8.334478731525087,274.02553531101773,10.699766862262685,277.99055134076536,271.84294616808813,4.09307767545823,16.423113264505872,112434700,6.418426837231594,0.821342739529231,-2170580200.0,-4.140636183098846,85.04343053981948,79.70440250180728,143.01814655004603,37.74743746322206,13.085394410286195,0.10764114556248106,9.963504957133335,284.31668731689456,277.54666580200194,272.0750045776367,266.6033433532715,259.8333218383789,0.08,0.0,227.60795264020152,0.08729006652241345,0.08801606867559068,279.19856916155135,274.5121416364397,13.470951064748053
2023-07-19,0,294.02750396728516,246.17250442504883,291.19000244140625,257.70625495910645,277.3818759918213,-0.18660383062193409,12.435950095058182,-0.8537007341540672,2.9946598806869638,270.5512466430664,10.444749450683593,0.04622759109611674,253.06449813842772,281.4390075683594,0.7956835242459072,0.08671232278396207,1.0929750538169805,1.0559000227781927,1.0433148183906014,0.07279947250212437,71.06733908046763,293.8876503121867,269.0157501220703,244.14384993195392,281.7225003923689,9.532910991718344,276.907678604126,10.220818740694062,281.292724085485,274.3036355504584,5.178753850143341,18.28697243077515,142355400,6.252108850487402,1.0488243666365231,-2028224800.0,-17.578803381117254,85.04343053981948,79.70440250180728,133.78926506414672,37.99300645890366,12.16760107244073,0.01647870296162867,9.949684569570238,288.5095266723633,281.840245513916,276.4500045776367,271.05976364135745,264.39048248291016,0.1,0.0,227.81959609188863,0.07084826730073757,0.07958041640051404,282.2914297921317,277.0135716029576,14.296644808545288
2023-07-20,0,271.14749908447266,246.17250442504883,294.02750396728516,257.70625495910645,279.1881217956543,-0.11961702278649697,13.571166070810003,-0.9192760482914011,2.9944684105113715,273.12499237060547,11.511937217712404,0.050204192945175224,253.06449813842772,288.5012565612793,0.816788882999432,0.09982609409354606,1.0030635016631333,0.9690917103612636,0.9486951031674121,-0.016280599404932983,72.98139643882034,297.46170737050187,270.3193752288818,243.1770430872618,282.03964342389787,9.06157507366643,277.8846430097307,8.770758014487273,284.43688442862543,276.70987942695666,8.028845012382927,15.906024950303033,175158300,6.246220566539971,1.3081609241758192,-2203383100.0,-92.36045757784889,85.04343053981948,79.70440250180728,-12.941637158318946,30.828467987259867,27.639046414924117,0.027823879752584598,11.38613549735773,289.99160998535154,284.2392108764648,279.5900115966797,274.94081231689455,269.18841320800783,0.1,0.0,227.979466136632,-0.05397625163528208,-0.033420334072065426,281.30714198521207,277.39928545270647,14.179350798073667
2023-07-21,0,262.9549980163574,246.17250442504883,294.02750396728516,257.70625495910645,279.1881217956543,-0.16164778442697403,13.554732028181053,-0.9013851178267522,2.9944723595303318,273.12499237060547,11.366299438476563,0.05010810889378633,253.06449813842772,288.5012565612793,0.8125958468851243,0.054402464713595645,0.9720721625019947,0.9417374767584124,0.9229292248587067,-0.06087500708443783,50.22991316882163,297.61921442257307,270.50975036621094,243.4002863098488,280.45107323782787,11.370986072457457,277.9758924756731,8.594036271068672,281.0574845985521,275.63213261445327,0.8255017572906248,5.312270096037119,161050100,7.908309616831644,1.20541691045064,-2364433200.0,-90.29665341712276,85.04343053981948,79.70440250180728,-55.90862656395899,28.481022084913754,28.904836824425658,-0.050233657734970245,11.444268458135193,289.02636724853517,282.6768264465332,277.54500579833984,272.4131851501465,266.0636443481445,0.02,1.0,228.09979771512096,-0.0759116337283331,-0.06433970951965068,279.5971418108259,277.27428545270647,14.316017788160615
2023-07-24,0,262.2200012207031,246.17250442504883,294.02750396728516,260.7043809890747,279.1881217956543,-0.19419231346942797,13.326151508226046,-0.7848205717908754,2.9945164899860175,273.12499237060547,11.018449401855468,0.04921037644975648,253.06449813842772,288.5012565612793,0.7893659921458467,0.020055435303063286,0.9683174444445556,0.9438026791842703,0.9314948757808218,-0.09015364254490355,44.13506710255042,297.4519284131806,270.7996253967285,244.14732238027642,278.53464453560963,13.28698924263432,276.78321429661344,9.557895358051569,276.4606802794309,273.90021428374064,-4.057280574972016,0.48819348105056437,136508500,8.156055048355578,1.0372865725801212,-2500941700.0,-66.92495461550362,85.04343053981948,79.70440250180728,-41.012652779239055,26.88225378573942,26.140957208227704,0.009908623444875614,11.750392924434706,288.6298853759766,282.03506341552736,276.7050018310547,271.374940246582,264.7801182861328,0.04,0.0,228.2104897159333,-0.0734210584947913,-0.04378423168110227,278.3342851911272,276.5057133265904,13.956866815520865
2023-07-25,0,268.88999938964844,246.17250442504883,294.02750396728516,262.08437728881836,279.1881217956543,-0.21838886268944033,13.143387107836345,-0.6849750171250637,2.9945511204030137,273.12499237060547,10.752349777221685,0.048495758328162934,253.06449813842772,288.5012565612793,0.741020968223064,0.05927145527292797,0.9921357653298937,0.9712900659804776,0.9731531423954496,-0.07658231005456673,45.3927369834969,297.308149299596,271.0213750839233,244.73460086825062,276.9475015912737,13.73865139595521,275.9405351366316,9.706110480543943,272.84115549886405,272.24229173499225,-4.866943897385385,-5.986535359957092,112757300,7.778896050708455,0.8792687047822454,-2388184400.0,-75.29333552232876,85.04343053981948,79.70440250180728,-29.47578766994675,27.458825194690384,24.855511555193644,0.03671850060841572,11.47536442243824,288.6298853759766,282.03506341552736,276.7050018310547,271.374940246582,264.7801182861328,0.04,0.0,228.3099274743562,-0.0956569097596639,-0.08643847951461098,276.03428431919644,275.27714102608815,12.167894743627738
2023-07-26,0,264.3475036621094,246.17250442504883,294.02750396728516,262.77124881744385,279.1881217956543,-0.18044206344837288,12.01190526138693,-0.39400535819439586,2.994754367757786,273.12499237060547,9.56589994430542,0.044147052375886835,257.09074745178225,288.5012565612793,0.6733028295127367,0.09228282832665545,0.9715497113618267,0.9548945024483433,0.9724092262428933,-0.10094293868670912,51.32349641315002,296.112310545662,272.0885000228882,248.06468950011435,273.53964396885465,13.436849821111181,275.0460709163121,10.179334608517488,271.8579058046404,271.8791112464376,-3.9678573608398438,-4.203075633605654,95856200,7.868925602035312,0.768175378522284,-2484040600.0,-77.35220733840451,85.04343053981948,79.70440250180728,-61.66715727355129,26.347893650057596,25.940343969403102,-0.03252760075371808,11.104981859758482,288.6298853759766,282.03506341552736,276.7050018310547,271.374940246582,264.7801182861328,0.04,0.0,228.38763552159114,-0.09239168701451217,-0.09882726732219016,272.31571306501115,274.4064265659877,11.201810562629936
2023-07-27,0,262.1125030517578,253.67749786376953,294.02750396728516,263.9993772506714,279.1881217956543,0.188383226375874,10.62422944767691,-0.6063819790113123,2.9949764047484564,273.12499237060547,8.648500442504883,0.038916983406502216,261.25675468444825,288.5012565612793,0.6420746065612803,0.04206130180324419,0.9601287304777182,0.9501597774334145,0.9857114488290264,-0.033321332718249,46.132275097729774,294.245708880095,272.9972499847412,251.74879108938737,269.38571548461914,11.413092927680307,273.9932144709996,10.725741904211468,270.01443513584275,271.0860113326073,-8.277167191802873,-4.522880398832678,103697300,7.820214849983067,0.8501131204562955,-2587737900.0,-96.47993995126107,85.04343053981948,79.70440250180728,-101.55481771636227,24.04445829236368,27.749788728244724,-0.09536867132149585,11.299626143422506,288.6298853759766,282.03506341552736,276.7050018310547,271.374940246582,264.7801182861328,0.04,0.0,228.4605757481884,-0.027348753706887496,-0.12205590146194345,266.94000026157926,273.0692847115653,11.243600892262746
2023-07-28,0,262.9449996948242,257.46999740600586,294.02750396728516,263.9993772506714,279.1881217956543,0.39569215416447284,9.997880913701005,-0.6521837935616777,2.995066613061037,273.12499237060547,8.22675018310547,0.03656615269887506,262.0690032958984,288.5012565612793,0.6146438855266629,0.018031249048529565,0.9616924919630164,0.9578729969381882,0.995607802318776,-3.802293779786581e-05,43.53743949149228,293.41476207154267,273.41900024414065,253.42323841673866,264.9453577314104,3.60092077299464,273.33392906188965,11.122437267029962,268.0855481890928,269.98074115131516,-9.985747843626418,-5.324131294400486,111446000,7.804955623956337,0.9211271926837477,-2476291900.0,-72.7252520216116,85.04343053981948,79.70440250180728,-76.56251455657791,22.29312396553357,25.72856799741658,-0.0633120256126122,11.31679522504467,288.6298853759766,282.03506341552736,276.7050018310547,271.374940246582,264.7801182861328,0.04,0.0,228.54829135785386,0.024690461114498463,0.01346522870714001,263.394284929548,272.84285736083984,10.772172021753091
2023-07-31,0,266.94249725341797,261.67750549316406,294.02750396728516,263.9993772506714,279.1881217956543,0.5211160844561489,9.625454973049475,-0.6381084619200643,2.9951173342698456,273.12499237060547,7.953000068664551,0.03516883425095689,262.2092514038086,288.5012565612793,0.6218447974541816,0.0048437262472041855,0.9753363832387973,0.9785147584531322,1.0107514713370025,0.01800967130932185,43.3339245331284,292.94366030468046,273.6927503585815,254.4418404124826,264.34464318411693,2.6075462800621967,273.1921433040074,11.195343330392959,266.85809668451884,269.78208594976866,-10.571291410860434,-3.3911990016628395,84582200,7.750955954855302,0.7071827176998849,-2391709700.0,-70.53355412460114,85.04343053981948,79.70440250180728,-57.51130444960253,22.718567376202174,24.833917727024023,-0.04246733757860988,10.88702326561066,288.6298853759766,282.03506341552736,276.7050018310547,271.374940246582,264.7801182861328,0.04,0.0,228.6197949435352,-0.0060581465011628755,0.02849782314897243,264.0414276123047,272.6742847987584,10.527021531384099
2023-08-01,0,263.5125045776367,262.1125030517578,294.02750396728516,266.2937488555908,279.1881217956543,0.5690097162836533,9.361627715467302,-0.5512963264676243,2.995151923236705,273.12499237060547,7.689750480651855,0.034172011992043554,262.8724998474121,288.5012565612793,0.7335345728205044,-0.04293383763139365,0.9618789317591386,0.9735284995535782,0.9942086002351275,-0.019998865053434733,43.08718287433498,292.6792553775289,273.95599994659426,255.23274451565968,264.42428697858537,2.5662139637389663,272.4376801082066,11.483470537132776,266.9192214600524,270.2856718127319,-1.5508171180825352,-0.7381173833540455,83166000,6.6994458723867405,0.706122354890799,-2474875700.0,-84.61365919638195,85.04343053981948,79.70440250180728,-83.47030271454243,21.621682655884257,26.00862695396942,-0.07067945954014597,10.62223536633712,288.6298853759766,282.03506341552736,276.7050018310547,271.374940246582,264.7801182861328,0.04,0.0,228.68218933664687,-0.015869991987525145,-0.02969594256624864,264.1914302280971,271.8942860194615,10.767240313998437
2023-08-02,0,254.92250061035156,262.1125030517578,294.02750396728516,264.1387538909912,277.6525020599365,0.7054893063186856,9.553496577643143,-0.485925315540495,2.9951255232091514,271.66124725341797,7.886825504302976,0.034970698742654314,262.8724998474121,288.5012565612793,0.7209367461891059,-0.06118905396543266,0.9331471361418553,0.951522898236762,0.9657179512179224,-0.03565383792617505,39.62869261888077,292.29274354438536,273.1857503890991,254.07875723381284,263.3817868913923,4.422106362898122,270.958215713501,12.342006066406958,266.055604208065,269.76739584934785,0.21201595918881014,-3.853866698111214,101752900,6.702014349155539,0.8749960389821768,-2576628600.0,-92.58197768277172,85.04343053981948,79.70440250180728,-133.14281239929622,20.082980254470534,30.722641573930794,-0.11201717899044836,10.619218685245517,287.773207824707,280.6484073791504,274.89000701904297,269.13160665893554,262.0068062133789,0.06,0.0,228.74052987509322,-0.03873654343383759,-0.042106446849912486,262.0557163783482,270.1950007847377,11.25059699603948
2023-08-03,0,255.96249771118164,254.92250061035156,294.02750396728516,263.3731279373169,276.8568706512451,0.656968318143816,10.172177959106932,-0.3029123226649211,2.9950377565433053,270.0374984741211,8.194999599456787,0.037411811280647245,262.2092514038086,288.5012565612793,0.7001543896891801,-0.07927006146750729,0.9413933474021289,0.9695567494447088,0.9766317928696608,-0.0234632276941088,34.005121559202884,292.2418559563608,271.897500038147,251.55314411993317,261.5350009373256,4.4377409155520695,269.24125126429965,12.655411238815422,263.2404871755667,267.8769584152747,-2.7829687195407584,-7.51446709066431,97569100,6.893211005355817,0.8473114157834201,-2479059500.0,-81.90573508430016,85.04343053981948,79.70440250180728,-102.90278115576967,19.58138159292586,28.94268235503963,-0.08413041135414538,10.467130938754762,287.773207824707,280.6484073791504,274.89000701904297,269.13160665893554,262.0068062133789,0.06,0.0,228.80172475562733,0.014117557059044161,-0.01902779899058221,261.2042890276228,268.6192866734096,11.473070525212705
2023-08-04,0,258.17749786376953,254.92250061035156,294.02750396728516,262.9524984359741,275.93937492370605,0.6925471680778855,10.669597968690171,-0.31164681425166707,2.994962913021159,268.908748626709,8.563586959838869,0.03939270543698101,261.4975025177002,288.5012565612793,0.7393388932706094,-0.07545532758977513,0.9532046243587566,0.9836045174830812,0.9897280804961094,-0.018131175099689645,35.35021298932852,292.1913207237573,270.852124786377,249.51292884899664,260.65357153756275,4.398588739699184,267.09660775320873,11.703244505959857,261.3806427196404,266.56434252966505,-4.807728702373032,-8.584822246006556,99242600,6.906428540222641,0.867251778293643,-2379816900.0,-93.09427273270204,85.04343053981948,79.70440250180728,-94.68090306375436,20.93302011527704,26.658344750181424,-0.08215249825668075,10.55233504336659,287.773207824707,280.6484073791504,274.89000701904297,269.13160665893554,262.0068062133789,0.06,0.0,228.86364971629487,-0.0472151393025948,-0.007234781803379848,259.70571681431363,266.01071493966236,11.992504188665986
2023-08-07,0,249.82749557495117,254.92250061035156,294.02750396728516,262.76375007629395,274.46499252319336,0.8170348563972235,10.91789904025199,-0.22617102766070563,2.994922631455248,267.9162483215332,8.710549926757812,0.04044889140887422,257.9559978485107,288.5012565612793,0.7786896986323689,-0.05142830088734758,0.9255668331614257,0.9535282294964339,0.9612317493081056,-0.06411493806555246,39.13265821941167,291.7541730957628,269.9183750152588,248.08257693475477,258.8985704694475,5.910453109358903,264.14214297703336,10.288468577805503,260.54157973909184,265.7306971063888,-2.3340510929228913,-10.418024973422433,111097900,6.88996020686337,0.9743971647751661,-2490914800.0,-84.62763084482596,85.04343053981948,79.70440250180728,-138.15473741749855,19.36601118414177,31.642772981974918,-0.039080427376218876,10.591454404805809,285.9489252319336,277.69554318237306,271.0250015258789,264.35445986938475,256.1010778198242,0.08,0.0,228.91330107399398,-0.059753939966308955,-0.05626034137445471,259.0971439906529,263.01857212611606,12.634887857089115
2023-08-08,0,248.2699966430664,249.82749557495117,294.02750396728516,262.1931266784668,274.46499252319336,0.692297542531819,11.74221221196078,-0.28927698616848474,2.9947869632080226,265.6450004577637,9.288600101470944,0.043683662675960806,255.85849800109864,288.5012565612793,0.7585831660976687,-0.07102286839590438,0.9236200632509791,0.9520869318662745,0.9679878094125747,-0.05784358491450459,33.515821550449566,292.2854244468097,268.80100002288816,245.31657559896658,256.80214146205356,6.7753059681604,260.873749596732,6.710040166600206,257.8455992307056,263.9551244399734,-4.686921582821554,-14.204645255558907,96642200,7.079426643073875,0.8458795165537496,-2587557000.0,-81.81817454984166,85.04343053981948,79.70440250180728,-127.0229396178339,18.50069443705464,30.228903025729075,-0.034693310366891945,10.294922121705834,271.92187310791013,266.3490533752441,261.8449935913086,257.340933807373,251.768114074707,0.08,0.0,228.95472733593522,-0.043551576423929594,-0.06629770860830117,256.7057146344866,260.0499997820173,13.295856834287807
2023-08-09,0,246.51499938964844,248.2699966430664,294.02750396728516,261.12875175476074,274.46499252319336,0.5940069791175663,12.565350040605226,-0.4216787017687973,2.9946404560881934,263.93000411987305,10.102250366210933,0.046926235310477384,254.41300010681152,288.5012565612793,0.7834967865858022,-0.09415303723960297,0.9206286200972116,0.9528917430461608,0.9727066891540216,-0.03298061646411499,30.75208429010041,292.8988250430635,267.768124961853,242.63742488064253,253.88392748151506,6.038974697221182,259.114285332816,7.030724240594434,255.52204130904306,262.1648102236507,-5.581016208252571,-15.562322132051271,101596300,6.929455706125932,0.8869417170769387,-2689153300.0,-99.06448856476824,85.04343053981948,79.70440250180728,-134.4476856929303,17.310721319402205,30.45887481035202,-0.043142021821748706,10.216714270657643,265.5839938964844,261.0579938964844,257.3999938964844,253.7419938964844,249.2159938964844,0.1,0.0,228.99038570255058,-0.04690881169695982,-0.07231778585490947,253.1000017438616,258.57071467808316,14.37424847521423
2023-08-10,0,246.3849983215332,246.51499938964844,294.02750396728516,257.62374782562256,272.2693748474121,0.6045199726040602,13.288531877495432,-0.42803254598887497,2.9944993011396592,263.23375129699707,10.491400756835935,0.04988372543569283,249.6717456817627,288.5012565612793,0.7977587097408672,-0.10564696980026396,0.9249028952972255,0.9589996800669157,0.9786872352999298,-0.03741758841740683,29.042961902892024,292.9671892203839,266.39012546539306,239.8130617104022,251.43714087350028,4.837912447127342,257.9307139260428,7.697531969922584,253.34589048778224,260.3053660779922,-7.652396330276698,-9.084538776125783,109498600,6.895433848531563,0.95725922775818,-2798651900.0,-88.90321793094758,85.04343053981948,79.70440250180728,-114.0939128270779,16.634191208917223,28.403722223556258,-0.09761181154666594,10.17337758063578,265.5839938964844,261.0579938964844,257.3999938964844,253.7419938964844,249.2159938964844,0.1,0.0,229.03256848106048,-0.053910267590149274,-0.0345126293786001,250.85285731724335,257.52214377267023,14.776759883349849
2023-08-11,0,241.55749893188477,246.3849983215332,294.02750396728516,255.70249843597412,269.4543743133545,0.6925092623278113,13.790686749414004,-0.34520681408563236,2.994392151659143,262.9499988555908,10.590663223266608,0.05205454408583021,248.0944969177246,288.5012565612793,0.802822510975433,-0.1200535774230957,0.9117867518778195,0.94600072098684,0.9668681381407837,-0.06437431251523906,27.181978450762475,292.50899877348627,264.9276252746582,237.3462517758302,249.5278549194336,5.778903637295949,256.45482090541293,8.7242567256504,251.6684184413803,258.81200402682424,-6.499693926690817,-6.301458355925018,98866600,6.764905831895015,0.8722826472955088,-2897518500.0,-86.72594323011336,85.04343053981948,79.70440250180728,-134.20060979590437,15.761806421154331,30.482080356225268,-0.07889079346402911,9.969564329549627,264.66831634521486,259.5758378601074,255.45999908447266,251.3441603088379,246.25168182373048,0.12000000000000001,0.0,229.05927517603683,-0.04415822377261136,-0.06428356068528261,249.21571350097656,255.6357149396624,14.947688861411187
2023-08-14,0,237.46749877929688,241.55749893188477,294.02750396728516,253.64874935150146,267.4293727874756,0.7573232542060615,14.228063556589014,-0.05652081181452928,2.994286948990295,262.5825004577637,10.421601562499996,0.05409796960375242,246.50199928283692,288.5012565612793,0.7554907362093376,-0.1618480302951568,0.9028993636236816,0.9378384703043886,0.9633140140819341,-0.04947412520471006,20.658014367736236,291.46162733443043,263.0055002212524,234.5493731080744,246.88571221487862,6.526299351672301,254.21035657610213,9.301871508234564,249.1602649853167,256.6310985142923,-5.242770507298283,-7.879834563583621,98595300,6.368083242177023,0.8827294831153152,-2996113800.0,-83.01301956644006,85.04343053981948,79.70440250180728,-142.87067994504986,14.748986238832956,31.606305843764023,-0.08114951852012843,9.89316644147354,260.78032373046875,255.61484301757812,251.44000244140625,247.26516186523438,242.09968115234375,0.14,0.0,229.07847527219567,-0.046490366209121614,-0.055542448867939936,246.42142595563615,253.81285749162947,14.208914672963889
2023-08-15,0,236.20000076293945,237.46749877929688,294.02750396728516,249.43812084197998,264.9962520599365,0.7469321231823909,14.030955356699337,0.48410312239385256,2.9942985144412195,262.16625213623047,10.513376445770263,0.05386809499018159,245.90224838256836,273.151749420166,0.6995867656426912,-0.18449295378167907,0.9068266382662139,0.9438193790949465,0.9678780944803036,-0.04861640972863823,17.331677982846454,288.53066052266377,260.46874980926515,232.4068390958665,243.7460697719029,5.3732985333545775,252.19982065473283,9.960854829017704,246.23094742989755,253.79225940168985,-7.225667469753253,-11.686005683244925,88197600,6.244632630064542,0.7982996659540909,-3084311400.0,-99.04160442889224,85.04343053981948,79.70440250180728,-147.01388472629068,13.896469749193088,30.614564881646665,-0.14817330080224841,9.750083080628887,260.5112838745117,255.17936325073242,250.87000274658203,246.56064224243164,241.22872161865234,0.16,0.0,229.0904369981349,-0.06704041024816221,-0.0735334677223358,243.43571254185267,251.57071467808314,13.067737808526825
2023-08-16,1,228.24250411987305,236.20000076293945,294.02750396728516,247.8312473297119,263.7212543487549,0.5939510921042874,13.09835097863392,0.8960331362354048,2.9944516644056196,260.1450004577637,10.236576080322266,0.050824107988026425,241.14849891662598,269.11574935913086,0.6112685772701185,-0.19667378875814234,0.8856245870772832,0.9220857620069373,0.9446146087555377,-0.07412325949746112,15.364982486415183,283.9159516826097,257.7192497253418,231.5225477680739,240.6624995640346,7.188555653631678,249.78053501674108,11.380120038891192,243.69239418838066,251.17037349391694,-8.512553294798282,-10.64791704450829,112484500,6.114554523810518,1.0320789094056217,-3196795900.0,-99.49656450140758,85.04343053981948,79.70440250180728,-171.990456067721,13.014471264751684,34.013537202675245,-0.15711914082142006,9.667219741861867,258.7667908935547,252.38659356689453,247.22999572753906,242.0733978881836,235.69320056152344,0.18,0.0,229.08856135244227,-0.06849992225382762,-0.09651578349727427,239.74285670689173,249.42000034877233,12.155678687787743
2023-08-17,1,222.7125015258789,228.24250411987305,271.14749908447266,246.48249912261963,263.09437465667725,-0.577485672571498,11.759128076382462,-0.6943252745207849,2.9946538298723064,257.0699977874756,10.097500534057616,0.046217537588821585,237.34074897766112,267.137247467041,0.7484298317506605,-0.1582348910075438,0.8753389999592015,0.9095485086749818,0.9358828146955763,-0.09607929442506724,14.454230394416307,277.9482558857361,254.4299997329712,230.91174358020626,237.0114288330078,8.954218649085309,246.90678514753068,12.792274975833603,239.76268436614697,247.62511561513267,-8.639958306191472,-12.921931818413354,120718400,4.163182679474576,1.135999114676829,-3317514300.0,-99.22388157597072,85.04343053981948,79.70440250180728,-180.52984587215505,12.243835387569002,36.90275675701605,-0.14412998567127092,9.541704307593832,257.2209901733398,249.88449240112305,243.95499420166016,238.02549600219726,230.68899822998048,0.19999999999999998,0.0,229.06912185842486,-0.106464479934263,-0.09484289602854407,235.3885716029576,246.0471431187221,14.13341857769939
2023-08-18,1,214.88750076293945,222.7125015258789,268.88999938964844,245.1781234741211,262.9474992752075,-0.6970509626342074,12.989937106968085,-0.5411643761592977,2.9943863630925307,255.4424991607666,11.089675464630128,0.05154568199430007,235.4042510986328,264.60700302124025,0.7973591907274301,-0.15303948125745526,0.8527002623388147,0.8896725387466096,0.9213307551312245,-0.11040848777982182,13.19602855821041,277.98812406897764,252.0082498550415,226.02837564110533,232.49321474347795,11.085416243173622,243.1885711124965,14.026357282773635,235.47400567925416,244.3691305722989,-10.294234286364889,-15.300727610579942,135813700,4.002796048783402,1.293408870442265,-3453328000.0,-94.21547801236997,85.04343053981948,79.70440250180728,-183.0849217055362,11.602190357360628,39.91147103946844,-0.10934240723492454,9.350154043505096,253.70004107666017,245.79998098754882,239.41500091552734,233.03002084350587,225.12996075439452,0.2,0.0,229.02858805688905,-0.1119307194992426,-0.12166785395894493,231.57428632463728,242.33714403424943,16.05967653789946
2023-08-21,1,226.38500213623047,214.88750076293945,268.88999938964844,240.5349988937378,262.4012508392334,-0.7389963066719232,15.028911843677975,-0.40766798371359236,2.9938896975643035,252.37499809265137,12.42063756942749,0.060210810562643644,227.68950386047362,264.60700302124025,0.7991319962748042,-0.1805068272344536,0.9069734801579902,0.9543794231244144,0.9933436343426877,-0.04666953035693744,10.96689597408032,279.66269867972653,249.6048749923706,219.5470513050147,229.63607243129186,9.349728112247766,240.53660665239607,13.383226942103638,230.3342139029715,240.655914357792,-12.829847556950352,-19.500453103598886,135702700,4.182899050246459,1.2928478355995194,-3317625300.0,-63.90001458625265,85.04343053981948,79.70440250180728,-101.51114917835562,20.7339769069158,35.10564404267912,-0.1127511263793867,9.87085728251534,252.40123175048828,244.74937344360353,238.56499481201172,232.3806161804199,224.72875787353516,0.2,0.0,229.02559560525197,-0.035368685025963575,-0.046857594902879,229.56571524483817,240.20928628104073,15.801931633489401
2023-08-22,1,235.9525032043457,214.88750076293945,268.88999938964844,237.15062427520752,262.3206272125244,-0.513798673447048,15.545381230176096,-0.8249410968886299,2.99374064835914,249.0487461090088,12.996562061309813,0.06273025784160191,226.01775207519532,264.60700302124025,0.8508793693095498,-0.1580757832195313,0.9521388472383151,1.0046420958088373,1.0454925161700057,-0.0010478304733035904,27.89441478613107,278.9038874984992,247.81312503814698,216.72236257779477,228.83535875592912,8.344592918072676,239.18160683768136,12.760502885173148,229.3785781233243,239.05280500668277,-8.117375782434074,-14.089465128387351,130597900,4.828455888547549,1.233729342258649,-3187027400.0,-60.25566410975384,85.04343053981948,79.70440250180728,-60.48902036481289,25.285327337194005,32.27136148724344,-0.08415602087059047,9.970796353225742,252.40123175048828,244.74937344360353,238.56499481201172,232.3806161804199,224.72875787353516,0.02,1.0,229.0408867365632,0.000987275587700065,-0.02740236993641714,228.21428789411272,238.71500069754464,15.49140689972428
2023-08-23,1,233.61749649047852,214.88750076293945,266.94249725341797,236.13812637329102,259.1612491607666,-0.4097983246054659,14.958899252514948,-0.8938808835202745,2.993868112097397,247.39249801635742,12.592499160766602,0.06076746604624468,226.01775207519532,263.596004486084,0.8833800868265166,-0.1074154287988221,0.9490232567350899,0.9999443381624644,1.0353733183423872,0.023549480371028997,40.62132518882925,276.0840487339117,246.16625022888184,216.24845172385196,228.28535842895508,7.789211376658171,237.58553532191686,11.866217224839842,231.02225031505418,238.76112417173027,-2.320356748320026,-7.441476276353281,101077600,5.460485392099782,0.9525084842457783,-3288105000.0,-53.253185611375066,85.04343053981948,79.70440250180728,-51.23977828193586,23.526557261771188,30.21330489146649,-0.04933601078154161,9.950739645238633,252.40123175048828,244.74937344360353,238.56499481201172,232.3806161804199,224.72875787353516,0.02,0.0,229.05378796292405,0.04991132181826874,0.016741044746253538,227.8000030517578,237.11071450369698,14.946062423293503
2023-08-24,1,233.9499969482422,214.88750076293945,266.94249725341797,235.3687515258789,256.5162477493286,-0.2535151636029171,14.586071976175191,-0.9369829273680801,2.9939435036654625,246.44999885559082,12.464524211883546,0.059625094592577345,226.01775207519532,263.00175018310546,0.8782240799604547,-0.10871288561023949,0.9563431964929843,1.0069262341677665,1.0319305022604004,0.050457407399096876,39.28558398273573,273.80189382265064,244.6297498703003,215.45760591794993,227.96392931256975,7.4470825692889004,235.85499954223633,10.294711512777097,231.67006277968676,238.24092874054313,-1.6212754623724592,-8.729794958445973,99777400,5.4612448113001975,0.9419958360584312,-3188327600.0,-57.18092625188428,85.04343053981948,79.70440250180728,-59.01489140782095,21.723016662322998,28.689453519686058,-0.03416537601675897,10.007115777233306,243.90555548095705,237.87721646118166,233.00499725341797,228.1327780456543,222.10443902587892,0.02,0.0,229.06083017312204,0.04935677404059713,0.019680793716733973,227.3828582763672,235.40928540910994,15.006032426608206
2023-08-25,1,234.8125,214.88750076293945,266.94249725341797,233.86687183380127,255.18249988555908,-0.09184488544531164,14.184188450620258,-0.8880772280606255,2.9940266755287985,243.97124862670898,12.124374198913575,0.05831795785420523,226.01775207519532,263.00175018310546,0.8653263880124361,-0.11027021917219887,0.9654260817468026,1.0160765635588551,1.0255679526809163,0.09272293254060182,39.440111267813954,271.59000146636504,243.2216245651245,214.85324766388396,228.9025001525879,7.888949473241827,234.78249985831124,9.476719201082037,232.26265178432925,237.99722275059565,-0.9525841691065305,-9.384048228831809,106612200,5.451138583840686,1.0088249305672425,-3081715400.0,-33.493929756958075,85.04343053981948,79.70440250180728,-33.807859959915234,20.380802921669307,26.840815959724488,-0.031842255407528074,9.932322272707152,242.49216247558593,236.73392211914063,232.0800018310547,227.42608154296875,221.66784118652345,0.02,0.0,229.07644751610394,0.10719750455182653,0.08835870362798916,229.2385711669922,234.49071393694197,13.962338568790809
2023-08-28,1,240.2825050354004,214.88750076293945,266.94249725341797,233.86687183380127,251.10124683380127,0.04062374606560099,13.53874811890882,-0.7213855091693002,2.994164255110257,239.51249885559082,11.417999172210694,0.055988041033030775,226.01775207519532,258.71099853515625,0.8262360507135171,-0.12036299047174877,0.9936625331445849,1.0427898484074918,1.0315055165189533,0.06138879681970666,39.29113666501799,268.8924958182009,241.8149995803833,214.73750334256567,231.41250065394811,8.371587396909316,234.21196474347795,8.81993821536734,232.91343487945537,237.88418747923978,2.8785155093971406,-6.010145336643499,107673700,5.327493944277286,1.0078583479291643,-2974041700.0,-32.9107376370544,85.04343053981948,79.70440250180728,-5.5040844307050465,22.94295551132844,25.086402605018392,-0.05809964090418361,9.86787059460642,242.49216247558593,236.73392211914063,232.0800018310547,227.42608154296875,221.66784118652345,0.04,0.0,229.1001927702871,0.03260121318193643,0.10826489041875656,232.03857203892298,233.7135718209403,12.561840832566048
2023-08-29,1,247.75250244140625,214.88750076293945,263.5125045776367,233.86687183380127,248.6593713760376,-0.04903128168718331,12.250252351510854,-0.5781814796871312,2.9944323551391174,238.87500190734863,10.079198989868164,0.050940412808715134,226.01775207519532,256.18399772644045,0.8097212589154986,-0.08815520758481594,1.0302330422769541,1.0738965635075568,1.0510323646338358,0.050010061672629114,46.868218867043815,264.98250467250415,240.48199996948242,215.98149526646068,236.10750089372908,6.5843210168807795,234.30035781860352,8.957846343769443,234.74747222599615,238.437461055156,7.889096206608713,-3.217260126341202,134047600,5.540993305570249,1.2255417530945827,-2839994100.0,-0.6649340459961752,85.04343053981948,79.70440250180728,78.96415444931462,28.739166946019182,21.745329575520678,0.030656931677679546,10.570880317410763,246.83168853759764,240.24416702270508,234.92000579833984,229.5958445739746,223.00832305908204,0.06,0.0,229.16149050330236,0.10287743892623769,0.1119854463558689,237.9942844935826,234.78428540910994,12.245796043591794
2023-08-30,1,255.54999923706055,214.88750076293945,258.17749786376953,233.86687183380127,247.8818759918213,-0.2731517341491568,11.205826238692262,-0.5307906542912324,2.994633806390262,238.87500190734863,9.271249389648437,0.046750549638758056,226.01775207519532,255.02650032043456,0.8226871844667535,-0.028126187966062036,1.0661510066312636,1.1021760930269284,1.073365166939771,0.09388210676025266,56.755019210443976,262.1056523400554,239.6939998626709,217.28234738528636,240.27392905099052,8.387387298135556,234.9550007411412,10.162783029969749,237.9851393343828,239.50509713692583,15.294049938587612,0.5019990892326113,121988400,5.577483977119561,1.1050673378384812,-2718005700.0,-7.497435478151415,85.04343053981948,79.70440250180728,114.68872635843881,28.860700669253237,20.281288395525507,0.054550445751156154,10.524389825291019,249.14660760498046,242.11670626831054,236.43500518798828,230.75330410766603,223.7234027709961,0.08,0.0,229.23027519454106,0.08460691224560013,0.10167670657765761,241.65428379603796,235.60999952043807,12.430916838903743
2023-08-31,1,257.57249450683594,214.88750076293945,258.17749786376953,233.86687183380127,247.8818759918213,-0.2623961203620711,11.249214699807908,-0.5363497152362511,2.9946257361104873,238.87500190734863,9.302624320983886,0.04692542334942326,226.01775207519532,255.59124908447265,0.7693413863465612,-0.0016115582470465706,1.0744481877572012,1.0979675994735478,1.0622882206990687,0.10097242088795522,62.78805512019018,262.2238041936222,239.72537479400634,217.22694539439053,243.36249923706055,10.294661877689325,236.09892899649483,11.741792884393893,242.38967321505822,241.3292360231807,12.882919286004475,3.719788533377746,108861700,5.864587569135528,0.9811369321221297,-2609144000.0,-6.3498701502469,85.04343053981948,79.70440250180728,128.67219108489115,28.091762107911205,19.411567187347327,0.0218626914169454,10.210504096629046,249.65847454833985,242.53075570678712,236.7699966430664,231.0092375793457,223.88151873779296,0.1,0.0,229.29616079687898,0.12189181926838066,0.08958872712671385,245.20999581473214,236.71214185442244,12.332289932497654
2023-09-01,1,250.83999633789062,214.88750076293945,258.17749786376953,233.86687183380127,247.8818759918213,-0.22759620390925406,11.37022986614606,-0.5378575712946785,2.9946031104567736,238.87500190734863,9.383124160766602,0.04741430910943987,226.01775207519532,255.7522487640381,0.7474830963219818,-0.0023433620743076185,1.0460127247547706,1.0536120098393116,1.0147495331203389,0.0682565721070667,63.854040915847804,262.5463343660812,239.80587463378907,217.06541490149692,245.82285635811942,9.61296661871963,237.05410739353724,12.387832318450865,246.19423872244042,243.13303837689105,9.162857358527928,6.629889631150361,132272500,5.860879725792031,1.174647314968793,-2741416500.0,-33.121673078672224,85.04343053981948,79.70440250180728,68.72531470985832,24.890792782728976,25.904244490188326,0.02185110155432215,10.700467522971955,249.65847454833985,242.53075570678712,236.7699966430664,231.0092375793457,223.88151873779296,0.1,0.0,229.3498117307924,0.02690807773790005,0.065075646225058,246.37428065708704,237.08714185442244,11.960379764175425
2023-09-05,1,251.08749771118164,214.88750076293945,257.57249450683594,233.86687183380127,247.8818759918213,-0.34722139541053354,10.879305812928624,-0.4697912569483931,2.9946936758409164,238.87500190734863,9.016249084472657,0.04543664913833821,226.01775207519532,251.3109966278076,0.8170453897590513,0.004052799555186235,1.0486491263963431,1.0389619714846843,1.0027476021350064,0.044967870940871846,58.169937447260004,261.19761118335236,239.43899955749512,217.68038793163788,248.27107075282507,8.157309045964606,238.1175000326974,12.935741646102855,247.344554628909,243.63272269090695,7.372093317554254,5.631295915161087,129469600,5.750137821823932,1.1404528837220262,-2611946900.0,-9.606725120152825,85.04343053981948,79.70440250180728,97.85306147695938,22.742527237808282,23.6685103216854,0.03643017837774329,10.874719799163133,249.65847454833985,242.53075570678712,236.7699966430664,231.0092375793457,223.88151873779296,0.1,0.0,229.41396014561744,0.07398870433065396,0.07502407549030016,250.15285164969308,238.76785496303015,12.274050588789311
2023-09-06,1,251.87749862670898,214.88750076293945,257.57249450683594,233.86687183380127,247.8818759918213,-0.3409586084329696,10.942744580056283,-0.4967163822964129,2.994682149324945,238.87500190734863,9.07924919128418,0.04568957501563231,226.01775207519532,251.53374786376955,0.8252499198073446,0.011348536296014488,1.0516717980632655,1.0316854837857488,0.9972956997414566,0.016649665067574038,58.836388879760754,261.3874888244192,239.50199966430665,217.61651050419408,250.70892769949776,5.620221156412141,239.80571392604284,13.089207080893491,248.29911378353478,244.231119582348,7.325283601833455,6.302919940793702,116959800,5.737637594730921,1.021120850549026,-2494987100.0,-18.967628045546338,85.04343053981948,79.70440250180728,79.10389141376677,21.04131897200111,21.898035783936802,0.028092534968095037,10.914382147492999,249.65847454833985,242.53075570678712,236.7699966430664,231.0092375793457,223.88151873779296,0.1,0.0,229.46595407692334,-0.020452580514173424,0.05485298736693445,252.05713762555803,240.6478543962751,12.378198882506432
2023-09-07,1,248.16000366210938,214.88750076293945,257.57249450683594,233.86687183380127,248.52437591552734,-0.3296366492233224,11.114174910689066,-0.570313242878862,2.9946507233428044,238.87500190734863,9.25962429046631,0.04637043054023556,226.01775207519532,252.24474868774413,0.8342728830491886,0.02175323712689966,1.0353702641130207,1.0098714564253493,0.9793772979202096,-0.028918002727504777,60.10165891809424,261.9107245848669,239.68237476348878,217.45402494211066,251.8342846461705,3.615776575368329,241.6233926500593,12.274477302702545,249.21358125365174,244.69811861719933,7.267500080578753,10.355211706940803,115312900,5.7213249089502085,1.000750392043284,-2610300000.0,-19.84839974908315,85.04343053981948,79.70440250180728,64.60553548848874,19.715702713648998,21.700529438255252,0.1054221785027271,10.816211514538697,249.65847454833985,242.53075570678712,236.7699966430664,231.0092375793457,223.88151873779296,0.1,0.0,229.51314109584595,-0.021058733094015514,-0.02212453279672633,253.8671373639788,242.9528547014509,12.64148536643562
2023-09-08,1,250.72749710083008,214.88750076293945,257.57249450683594,233.86687183380127,248.8300018310547,-0.33636171618148125,11.170380050418403,-0.5996760599661197,2.9946403687692267,238.87500190734863,9.341874504089356,0.046588941348143995,226.01775207519532,252.24474868774413,0.8494186922848507,0.007204194056733049,1.0457234761998973,1.0143169996096544,0.9953157366227985,-0.02657503247430093,55.295343686106726,262.10538507794865,239.76462497711182,217.42386487627502,252.25928388323103,3.207873223304632,244.18339238848006,9.746568355896164,248.97424745082037,244.43211470367257,3.278432037966479,11.42616690211865,118367700,5.790591985756695,1.0233233558015833,-2491932300.0,-31.231516096334843,85.04343053981948,79.70440250180728,71.27236542106859,20.89075777222347,20.279892961694664,0.095024080477615,10.747195752409258,251.59839483642577,245.6707961730957,240.87999725341797,236.08919833374023,230.16159967041017,0.1,0.0,229.56470817937816,-0.03712022268562509,-0.03269752470242985,252.62713841029577,245.31071145193917,12.726681751656672
2023-09-11,0,268.3274917602539,214.88750076293945,257.57249450683594,233.86687183380127,250.75562191009521,-0.34388327729048446,11.337901407700572,-0.676390851110106,2.994609196139901,238.87500190734863,9.5589994430542,0.04724484845895789,226.01775207519532,252.24474868774413,0.8563775261785532,0.03796196851471417,1.1181162394810853,1.078199604550937,1.0710030321315243,0.0697157378315656,59.371042343253684,262.65755273147784,239.98174991607667,217.30594710067552,254.08463995797294,6.901421676520405,247.17928450448173,10.28607122510311,249.38096058397224,244.34829316680256,1.2007929809417033,16.678492797693593,174667900,5.69448265345857,1.4621460388127552,-2317264400.0,-2.7212752642905205,85.04343053981948,79.70440250180728,165.9026020780106,28.61388610077915,17.061996557143576,0.12704702557326872,11.861682206059719,263.8358829345703,257.0220609741211,251.51499938964844,246.00793780517577,239.19411584472655,0.12000000000000001,0.0,229.70919866710514,0.11660745563843755,0.06005889959103747,255.00999450683594,248.33213915143693,14.724017728759543
2023-09-12,0,270.80751037597656,214.88750076293945,268.3274917602539,233.86687183380127,250.90187168121338,-0.016171214278267447,12.91535256303355,-0.5177964057474003,2.994297985411007,238.87500190734863,11.00127353668213,0.053519555804853576,226.01775207519532,255.7522487640381,0.7515370424655778,0.12995459647990995,1.1221914069480359,1.0737052084324075,1.0660202205625915,0.078538409297775,72.81046614128392,267.15095468356225,241.32024955749512,215.48954443142802,255.97535651070731,9.382992850779711,249.66892787388392,11.505578239741508,254.06105533347238,246.7523656445352,4.999997089156842,18.527061964459968,135999900,6.74127056450764,1.1209073817863213,-2181264500.0,-21.728737079722503,85.04343053981948,79.70440250180728,146.2966148411274,28.714149397628017,15.850123491023254,0.047362909528488,11.856562658835587,266.54044946289065,259.20978625488283,253.28500366210938,247.36022106933595,240.02955786132813,0.14,0.0,229.82418066854194,0.04284775691211462,0.09171061174349478,256.35285513741627,250.78142547607422,15.765167499956142
2023-09-13,0,271.1125030517578,214.88750076293945,270.80751037597656,233.86687183380127,251.28499794006348,0.07108449789942911,14.379157972398895,-0.6142148286044784,2.9939813602710603,244.01750373840332,12.282999038696289,0.059176594509679936,226.01775207519532,258.6479942321777,0.789834954796621,0.14651782176652364,1.1157478546653503,1.0620607137998606,1.0509051195094465,0.0763665056621663,74.42693522974004,271.74556608212686,242.9872501373291,214.22893419253134,258.8714288984026,10.585319735400669,252.34714262826103,11.840858484227773,258.2061999639379,249.53160200858477,5.138365373399515,14.77204382165203,111673700,6.708522184059259,0.9115923489512464,-2069590800.0,-14.120740395871344,85.04343053981948,79.70440250180728,131.3314799880256,27.38179129839723,15.114665856021276,0.0765329095795919,11.545379611775902,266.54044946289065,259.20978625488283,253.28500366210938,247.36022106933595,240.02955786132813,0.14,0.0,229.91957484624302,0.07692914323946054,0.05774103521568501,260.1085684640067,253.24142456054688,16.726249051270848
2023-09-14,0,273.6225051879883,214.88750076293945,271.1125030517578,233.86687183380127,252.79562377929688,0.019292810724101793,15.52292278620741,-0.7911065030220379,2.9937185443135688,247.9562530517578,13.17533670425415,0.06342802441330424,226.01775207519532,268.5754936218262,0.8108921904091942,0.18782653606608446,1.118045562560804,1.0621733983486903,1.0450507546745902,0.10260517871585884,77.4766892652307,275.77872082418486,244.73287525177003,213.68702967935522,262.09071568080356,11.230553404784963,255.18089321681433,11.846587222512738,261.3914953812944,252.06677931411352,8.081847795340972,16.049742474150463,107709800,6.316894296214292,0.8809518288740329,-1961881000.0,-4.891768704241901,85.04343053981948,79.70440250180728,132.7011933133944,27.386697179492486,14.50671746729878,0.15499033637456364,11.16999378431646,267.0525726318359,260.03873138427736,254.37001037597656,248.70128936767577,241.68744812011715,0.14,0.0,230.0176302917061,0.09761820555698031,0.09574472273456013,262.90142822265625,256.52713993617465,17.381303842105478
2023-09-15,0,275.4800033569336,214.88750076293945,273.6225051879883,234.59687423706055,256.0556230545044,-0.0714544683406585,16.24643620839348,-0.7897141198846263,2.993562237267123,249.44375038146973,13.341499633789061,0.06577454599614145,226.01775207519532,270.8380096435547,0.7983267974731457,0.22859068670733645,1.1152951896279026,1.0619339530717395,1.0320714740347328,0.09872274298717731,80.86311194158854,279.49474772196277,247.0018753051758,214.50900288838884,265.4625020708357,11.196224038535131,258.08571488516674,11.44717553327426,264.43086988272194,254.87881640702668,8.974961988242034,16.95768700887097,133422800,6.044550950463194,1.0856166341098357,-1828458200.0,-10.520274637188487,85.04343053981948,79.70440250180728,126.33739582087621,27.441895381772085,13.751029644824198,0.19029620323203206,10.942137870174436,268.6833298339844,262.3133491210937,257.1650085449219,252.01666796874997,245.64668725585935,0.16,0.0,230.13958562561282,0.10418516961141844,0.09105733291614194,266.1114305768694,259.0842841012137,16.967548228784334
2023-09-18,0,267.9100036621094,214.88750076293945,275.4800033569336,235.66750240325928,260.26124382019043,-0.13103732551614702,16.371840803244112,-0.713181880863242,2.993572008730128,250.78374671936035,13.09622428894043,0.06558173522589393,232.8942470550537,271.36350326538087,0.7529938252129672,0.2819731365429153,1.0731843251893336,1.0256724495353158,0.9854342183967832,-0.0015558901378527334,85.17085100434188,282.3839320032167,249.6402503967285,216.89656879024028,268.28393064226424,8.195763081170046,260.05910764421736,10.482711860091,267.1851945507392,257.9238672787867,9.370628523353856,17.319139039418086,101543300,5.52312236441957,0.8379061921309929,-1930001500.0,-33.244382370899245,85.04343053981948,79.70440250180728,77.85695774999438,25.533786504917764,17.530685826238074,0.15651093052727622,10.91984265679144,269.2544494018555,263.23778842163085,258.37500762939453,253.5122268371582,247.4955658569336,0.16,0.0,230.2154828115965,-0.03033843190417851,0.06752514599314638,268.0814296177455,260.97428349086215,15.088786358023128
2023-09-19,0,264.9750061035156,226.38500213623047,275.4800033569336,239.20000457763672,268.0143756866455,0.025452483054773465,14.74144567591629,-1.1608200236541275,2.994024278159827,250.96374702453613,12.205150680541994,0.058430240210413015,233.91674690246583,271.36350326538087,0.8144333598963367,0.18342646877680807,1.0502737381909943,1.00784962470245,0.9749380528652231,-0.021537453907254478,70.17792299776904,281.7742668935196,252.29137554168702,222.80848418985443,270.3192890712193,3.5764281591210048,261.2892864772252,9.923015166112714,267.380888754713,259.82577385865005,7.958574995385348,11.49792350576613,103704000,5.653063378549077,0.8671844151647896,-2033705500.0,-33.757115021171174,85.04343053981948,79.70440250180728,61.1072009134305,24.391185949562093,18.468864460572036,0.13597255168210445,10.614853459626648,270.255087097168,264.8574646911621,260.49500274658203,256.1325408020019,250.73491839599606,0.02,1.0,230.28920684943182,-0.003663866255703918,-0.025879036917035084,270.6528581891741,261.63999829973494,14.447188758977601
2023-09-20,0,266.50499725341797,233.61749649047852,275.4800033569336,245.88500308990479,268.0143756866455,-0.01665195337533941,13.714006149218532,-1.2544867079424855,2.9942755550846236,251.4824981689453,11.736963558197022,0.05394523997801632,234.72624969482422,271.36350326538087,0.8585129441644455,0.12300146218001808,1.0483206639801195,1.008342773157414,0.9847941506389898,-0.01699481118161572,63.78096964245855,281.64888803848834,254.22087574005127,226.7928634416142,270.05893271309986,3.8046484238583673,262.0717863355364,9.867401365919335,266.76292588407966,260.41770520697315,5.6824676860057,6.9514953400652395,122514600,5.48051394527354,1.0279549017348175,-1911190900.0,-44.33326303094636,85.04343053981948,79.70440250180728,60.62004510398612,26.587257976469587,17.051538690535935,0.10559835091641975,10.675935442560682,270.255087097168,264.8574646911621,260.49500274658203,256.1325408020019,250.73491839599606,0.02,0.0,230.3787445942927,-0.03210465111308736,-0.018281794704604847,269.0828595842634,262.04642704554965,13.594419436775036
2023-09-21,0,257.1549987792969,233.61749649047852,275.4800033569336,248.0581283569336,268.0143756866455,-0.1952943263908587,13.289042017461195,-1.15198989058408,2.994376571573551,253.71374893188477,11.45760112762451,0.051961368275739786,234.72624969482422,271.36350326538087,0.8276616543750301,0.14077499013127143,1.0054995369840232,0.9676111369915155,0.9534906416286256,-0.06018330399167149,66.0217228911294,282.3265844774273,255.74850044250488,229.17041640758248,268.1085739135742,6.139706074634175,262.0419652121408,9.88266411073016,266.669078057096,260.9493339261187,-0.6792052856307045,4.286831559015203,119531000,5.404576298669974,0.9952164981585985,-2030721900.0,-62.969985558431354,85.04343053981948,79.70440250180728,-0.9904415142774077,25.073326739757967,21.686450456320358,0.05365848241561191,10.511939312665165,270.255087097168,264.8574646911621,260.49500274658203,256.1325408020019,250.73491839599606,0.04,0.0,230.442934867097,-0.07368501292221064,-0.057500890330415506,267.4000004359654,261.87642778669084,12.802336179597637
2023-09-22,0,251.13750076293945,233.9499969482422,275.4800033569336,250.0856237411499,268.0143756866455,-0.2431326549627042,12.2810198187772,-0.9556336704874004,2.994584520778683,256.3524990081787,10.421375846862793,0.04779994888459428,239.73550453186036,271.36350326538087,0.7965936654593218,0.09918786977453321,0.9774725451642922,0.9417812202385655,0.9426906365752196,-0.0883639549054821,52.92070782000794,281.4874151945002,256.9253755569458,232.36333591939143,265.25500215802873,8.642622821092827,262.06321552821566,9.857010645427179,264.3045983731452,260.3667535749989,-5.041408038397892,-0.16208862997519413,127524100,5.942161580376201,1.0496427526687577,-2158246000.0,-95.49145811354236,85.04343053981948,79.70440250180728,-61.29143388792658,22.847968809154448,26.249869543628233,0.030558243540100765,10.711801705859285,270.5524494018555,265.33878842163085,261.12500762939453,256.9112268371582,251.6975658569336,0.06,0.0,230.49081594786125,-0.10754768100229428,-0.11288220075909212,263.62571716308594,261.8671428135463,11.503801609033188
2023-09-25,1,243.94500350952148,234.8125,275.4800033569336,250.8118715286255,268.0143756866455,-0.12644335384690375,11.196718076813344,-0.9205262605095572,2.994786646579993,256.3524990081787,9.646201477050784,0.04343436935015863,247.00550270080566,271.36350326538087,0.7394452085275754,0.06952355927788961,0.946312777625448,0.9146682751457899,0.9327378866258849,-0.089451680881662,46.32076699437087,280.17818690130736,257.7847507476807,235.391314594054,261.0153590611049,10.850871667628068,261.55303737095426,10.623804352121379,261.0397184776954,259.13493035242726,-7.367790885322965,0.11860326478719878,104636600,6.158677215182816,0.8619580131090412,-2262882600.0,-78.65747462809756,85.04343053981948,79.70440250180728,-101.76546357013382,21.491381488201736,28.858990646952684,0.03285347710048866,10.574530765792325,269.3818878173828,263.4440658569336,258.64500427246094,253.84594268798827,247.90812072753906,0.08,0.0,230.51956052630743,-0.06894599430901449,-0.09985789457528074,259.4757167271205,261.1885724748884,10.893625685348347
2023-09-26,1,244.57749938964844,240.2825050354004,275.4800033569336,250.8118715286255,268.0143756866455,0.13087438861988515,10.409068358928725,-1.2804033221465305,2.994920976369393,256.3524990081787,9.280901336669922,0.04030751587238323,247.37175254821778,271.36350326538087,0.7038723746202895,0.015242468333603832,0.9470887401964038,0.9255009041077085,0.952614177841489,-0.07697898384385227,38.54089697434641,279.0595126410142,258.24137592315674,237.4232392052993,256.60071563720703,10.255098372163538,261.03160885402133,11.293273211707696,256.8025368319818,257.1936257834529,-10.846147928540201,-2.844623594073151,101993600,6.307007281396497,0.8421561955105716,-2160889000.0,-85.71429643386422,85.04343053981948,79.70440250180728,-99.15242015672044,22.01032259424712,27.292540848444077,0.02736858328459585,10.38277852463919,269.3818878173828,263.4440658569336,258.64500427246094,253.84594268798827,247.90812072753906,0.08,0.0,230.5494644378917,-0.0839775042507036,-0.07976479101130317,255.15142822265625,260.63142939976285,10.446089360588424
2023-09-27,1,241.16749954223633,243.94500350952148,275.4800033569336,250.8118715286255,268.0143756866455,0.2388097886432281,10.075297046617852,-1.399639164367435,2.9949745040316427,256.3524990081787,9.109101562499996,0.03898262044141958,247.43500213623048,271.36350326538087,0.7516841987693464,-0.012815220917934843,0.9331080814750905,0.9217461172185798,0.9544988585651074,-0.09507325555733714,36.983248426418406,278.60671973410484,258.4561256408691,238.3055315476334,252.7803579057966,10.320856608253264,260.53214427403043,12.036503351971733,253.78815173882464,255.79263030729388,-11.217694057904245,-2.8982339736029354,136597200,6.07221064463646,1.126690487943278,-2297486200.0,-86.66667353999365,85.04343053981948,79.70440250180728,-125.81189247813917,20.38665371075358,30.137640729308476,-0.020548194816013946,10.409008630022106,268.5016088256836,262.0192074890137,256.7800064086914,251.54080532836915,245.0584039916992,0.1,0.0,230.57570843377866,-0.08412352582337557,-0.0975609756097561,251.6114283970424,259.84642900739397,11.213276556091843
2023-09-28,1,243.1500015258789,241.16749954223633,275.4800033569336,250.8118715286255,268.0143756866455,0.13449987105601563,10.517587986736483,-1.3299521107211913,2.9949032971904868,256.3524990081787,9.3725016784668,0.040745807527907366,244.51424980163574,271.36350326538087,0.7861633383693075,-0.05628057029060022,0.9419786337968166,0.9400825442977757,0.9820413500848159,-0.05446130668234739,31.543261038953496,279.1620514693836,258.12687549591067,237.09169952243772,249.66250010899134,9.265595370501517,259.9908945901053,12.665254807748754,250.64965906974152,254.0861544867383,-9.98189830701542,-2.817740174356995,117058900,5.808494820448303,0.9675002487786702,-2180427300.0,-73.42342203018146,85.04343053981948,79.70440250180728,-88.26497532236523,20.667887429890392,28.27776947472638,0.001345231496125644,10.301222953254342,268.5016088256836,262.0192074890137,256.7800064086914,251.54080532836915,245.0584039916992,0.1,0.0,230.607578608773,-0.036448933033488506,-0.061731184284033944,248.73714338030135,259.6950007847377,11.504957906451363
2023-09-29,1,250.33500289916992,241.16749954223633,275.4800033569336,250.0856237411499,268.0143756866455,0.16121138108213148,11.005388695256961,-1.418320063324527,2.994820655673344,254.51624870300293,9.875063476562502,0.042738232403199385,243.86550331115723,271.36350326538087,0.822924615073965,-0.05599391739623138,0.9721488108067692,0.9794004565301623,1.0226291003376977,-0.0031954521380980205,33.882871213618536,279.51765300086555,257.5068756103516,235.49609821983765,247.35250091552734,5.694111306799192,258.70571681431363,12.667118780655176,248.72267598576263,252.66489765671363,-8.236627634649633,-3.0222036523995137,128346200,5.807494362287102,1.05231729629996,-2052081100.0,-64.77478341287491,85.04343053981948,79.70440250180728,-43.11572750906263,24.51777042492852,26.604974537178112,-0.002405041417203197,10.16684975437513,268.5016088256836,262.0192074890137,256.7800064086914,251.54080532836915,245.0584039916992,0.1,0.0,230.6583560067393,0.021806583761079468,-0.02143134842761966,246.97000122070312,258.02643040248324,11.612844554991923
2023-10-02,1,248.32749938964844,241.16749954223633,275.4800033569336,249.79125308990479,268.0143756866455,0.2407293003052603,11.115718588514778,-1.4465351967749098,2.9948007613393535,251.50749969482422,10.159001026153566,0.043227434109128667,243.86550331115723,271.36350326538087,0.8494269339163038,-0.0020132094007865417,0.9657100017305325,0.9811990523848948,1.015093907231709,0.01796509794042933,45.433105688228096,279.3764382069979,257.1450010299683,234.9135638529387,246.091429574149,3.8355132773490728,257.1000017438616,12.437796532906686,249.071353554526,252.61940855731748,-6.067426322543625,-6.705421327889865,123810400,5.885061020897447,1.0186618310348174,-2175891500.0,-61.66666494833498,85.04343053981948,79.70440250180728,-49.672396233376794,22.53015184572454,27.041513594442662,0.06039420533765366,10.273503604927576,268.5016088256836,262.0192074890137,256.7800064086914,251.54080532836915,245.0584039916992,0.1,0.0,230.704761629185,0.01866472532419583,0.02744201685196371,246.38428824288505,256.8921443394252,11.346121675809975
2023-10-03,1,247.4025001525879,241.16749954223633,275.4800033569336,248.28562545776367,268.0143756866455,0.2534999165191397,11.200141994066938,-1.4680423818686361,2.9947858355751555,251.50749969482422,10.27206338882446,0.04357703360898239,243.86550331115723,271.36350326538087,0.8459934097746138,-0.010992177415013892,0.9625830699116725,0.985166894309228,1.0077022852250934,0.011550534166018256,43.31519157554946,279.41966017069,257.01937618255613,234.61909219442225,245.55785805838448,3.228264608283843,255.40643010820662,11.989164754186818,248.8642884729225,252.67226516418762,-3.43275434331519,-8.301103228310737,101985300,5.9010535668440385,0.8486894408689636,-2277876800.0,-73.0855980086597,85.04343053981948,79.70440250180728,-62.40358278601193,21.385273160589335,25.667388256093187,0.00885387152051213,10.050396858523706,268.5016088256836,262.0192074890137,256.7800064086914,251.54080532836915,245.0584039916992,0.1,0.0,230.7377539439895,0.00987220920167764,-0.0018624507212294768,246.62000165666853,255.12285940987724,11.599187847587046
2023-10-04,0,254.68999862670898,241.16749954223633,275.4800033569336,247.970627784729,268.0143756866455,0.2705367948602618,11.325815148967235,-1.4966689602938277,2.9947633726784244,251.50749969482422,10.437888278961179,0.04409760966860093,243.86550331115723,271.36350326538087,0.8487981488719912,-0.017766567075343215,0.9916478415208161,1.021332730345495,1.0350033339235387,0.05607098431646018,42.105271315544016,279.48675660256094,256.83512630462644,234.18349600669197,247.09285736083984,4.597667630452491,254.05410821097237,10.783555746893093,248.4877115353877,252.7771261101257,-1.4872333279597323,-8.745447971701795,129721600,5.899173444342516,1.0738003035029489,-2148155200.0,-40.135143355262684,85.04343053981948,79.70440250180728,-1.6703734881673367,27.249994212959518,22.972040620995465,0.0413400500113382,10.427510409505272,268.5016088256836,262.0192074890137,256.7800064086914,251.54080532836915,245.0584039916992,0.02,1.0,230.80488784681933,0.08590438113143195,0.0698017732498396,248.644287109375,254.06000191824776,11.578604509966492
2023-10-05,0,259.9749984741211,241.16749954223633,275.4800033569336,247.970627784729,268.0143756866455,0.24029201866365035,11.280757440262441,-1.4872202266817494,2.9947716750996847,252.91374969482422,10.31132577896118,0.04389813973883437,243.86550331115723,271.36350326538087,0.845883147074973,0.02631364792164794,1.0116713236726342,1.0474890501467882,1.0449953892458776,0.06919595658094813,52.21175617149754,279.53726618515134,256.97575130462644,234.41423642410155,249.29250008719308,6.4882563517316925,252.94660786220007,9.074571952141316,250.03886451711463,253.7703431821102,4.404679318126764,-6.919206645035283,119159200,6.066744073925105,0.9847998803951028,-2028996000.0,-35.27320994198557,85.04343053981948,79.70440250180728,15.25370783705944,27.066060391589183,21.790545796167113,0.008484632824051425,10.207688673363155,264.6433948364258,258.89829617309573,254.25499725341797,249.61169833374024,243.86659967041015,0.04,0.0,230.87353389347936,0.05548332916325016,0.0812889305320946,250.92000034877233,253.03571428571428,11.512051793848563
2023-10-06,0,256.7024955749512,241.16749954223633,275.4800033569336,248.0962495803833,268.0143756866455,0.11773424030867292,11.111723854756992,-1.454596059340159,2.99480282425348,255.92249870300293,10.061650981903075,0.043141184158905214,243.86550331115723,271.36350326538087,0.8429869556844878,0.036882677329850795,0.9966455052704073,1.0331296345084908,1.0180708623898787,0.02543588632048377,56.95292409241248,279.78994875474103,257.566501045227,235.34305333571305,251.51178523472376,5.873679088745651,252.14607157026018,8.094412085695756,252.5753909444736,255.50831058734693,6.295550131511543,-5.6283594794076555,117947000,6.148961777344127,0.9749510559228213,-2146943000.0,-34.0533596293839,85.04343053981948,79.70440250180728,-2.818482403695493,24.99419704993773,24.019527785762293,0.07805041157385413,10.2642823395515,264.6433948364258,258.89829617309573,254.25499725341797,249.61169833374024,243.86659967041015,0.04,0.0,230.93568574350846,0.041203730750124734,0.05743158379761636,253.78142874581474,252.69642857142858,11.31930084979433
2023-10-09,0,257.0974998474121,241.16749954223633,275.4800033569336,248.0962495803833,268.0143756866455,0.05174791468040199,11.003630402395414,-1.41047296812602,2.9948220546279454,256.928747177124,9.792776050567625,0.042672017113779714,243.86550331115723,271.36350326538087,0.8896088925974551,-0.04332391030468646,0.9970226654478022,1.032407095777397,1.014513490186814,0.03531626774851371,48.21785722598459,279.87251177372394,257.8652509689331,235.85799016414222,253.5042849949428,4.838922574723067,251.58339255196708,7.375928439124944,253.6751743981318,256.4202767008642,6.441579426001453,-4.18331078868306,101377900,4.683243074386907,0.8641670173315619,-2045565100.0,-36.2388375242987,85.04343053981948,79.70440250180728,1.9922518541888963,23.364056112482963,22.452955534464426,0.04684396151553299,10.196118050998155,264.6433948364258,258.89829617309573,254.25499725341797,249.61169833374024,243.86659967041015,0.04,0.0,230.9890422742576,0.03207475011307648,0.0377668138475309,255.68000139508928,252.2085723876953,10.74312282592617
2023-10-10,0,261.98999786376953,241.16749954223633,275.4800033569336,248.0962495803833,266.8562488555908,0.166422154891708,10.738768467895442,-1.2744067586103054,2.994862919919311,256.89999771118164,9.195751647949214,0.04173576331701382,243.86550331115723,271.36350326538087,0.8698775549291528,-0.0506264043767845,1.0182128961022407,1.0465262524055292,1.026713194621479,0.05896261235106626,47.93899361245032,278.7812883090819,257.303751373291,235.8262144375001,255.1692842755999,5.523411472427251,251.2608925955636,6.745045044903767,254.54722469015258,256.511536924771,5.7361703615077895,-2.9729242663083757,122656000,4.633674689680283,1.0515264777103581,-1922909100.0,-15.483140947954475,85.04343053981948,79.70440250180728,48.59899599299599,26.799977172911298,20.690616373831325,0.09973258102232853,10.274253086278422,260.8310422973633,255.81448220825195,251.76000213623047,247.705522064209,242.68896197509764,0.06,0.0,231.0670567373615,0.0693221775139432,0.04777420000827237,257.5942862374442,252.28214372907365,10.589779293092667
2023-10-11,0,264.67250061035156,241.16749954223633,275.4800033569336,248.0962495803833,265.3575038909912,0.2073749132928473,10.349263106045457,-1.1179725885896228,2.9949224427317067,256.89999771118164,8.719375610351562,0.04029100381252313,243.86550331115723,271.36350326538087,0.8433757893037738,-0.03364841195187045,1.0304038675886444,1.0499387653951646,1.0255007054952976,0.039194715291013926,54.01030207507505,277.5614019597716,256.8628757476807,236.16434953558974,257.5042844499861,5.603331826410831,251.7978570120675,7.506598817061754,256.4382233359608,257.1479452898538,4.655759214501064,-1.694151868137449,103706300,4.797500747514797,0.8921180012024367,-1819202800.0,-17.316682483523305,85.04343053981948,79.70440250180728,59.401878088967315,25.339178604700383,19.562823518662604,0.08303442130772186,10.090378737760766,260.8310422973633,255.81448220825195,251.76000213623047,247.705522064209,242.68896197509764,0.06,0.0,231.1342694153723,0.007007147138170744,0.06676668777260548,259.221426827567,252.802857535226,10.170525465026403
2023-10-12,0,260.95750427246094,241.16749954223633,275.4800033569336,248.0962495803833,264.7481269836426,0.20586054978739085,9.995022804829796,-1.0042668783607358,2.99497495433756,256.89999771118164,8.413537483215332,0.038960741754917434,243.86550331115723,268.48125381469725,0.7996793015826603,-0.03270931450425743,1.0172160815935474,1.02563827310557,1.0033450504289672,0.003779231865012056,56.36322232688741,276.53092123527,256.54087562561034,236.5508300159507,259.44071360996793,3.4644465948397825,252.4992858341762,7.889195968920182,258.5297961633449,257.9814760786372,6.582034313910732,2.9233349018062755,111508100,4.803310509883392,0.9576672679492779,-1930710900.0,-29.30735490495009,85.04343053981948,79.70440250180728,36.80364475954785,23.749538501659263,21.38653454240649,0.02304893922746471,9.99678016929906,260.8310422973633,255.81448220825195,251.76000213623047,247.705522064209,242.68896197509764,0.06,0.0,231.19782425088587,-0.00453756097354896,-0.008768603587112457,260.9842834472656,253.80214255196708,9.151187095943952
2023-10-13,0,254.95999908447266,241.16749954223633,275.4800033569336,248.0962495803833,262.66062355041504,0.15587904234857766,9.267453925080275,-0.8597446041071168,2.9950774753328697,256.89999771118164,7.843612442016601,0.03621405928831598,243.86550331115723,266.64549789428713,0.7492277256294696,-0.05271707168398776,0.996296997820154,0.9951017673135193,0.9795454174793414,-0.006787999807231104,50.74562157351385,274.44253342999457,255.907625579834,237.37271772967344,259.47928510393416,3.403709660962516,253.286071232387,7.510635000291722,259.1625676862572,257.84570831973656,5.478927703443929,3.91020993666376,102073800,4.82226585809481,0.8886046636035744,-2032784700.0,-51.86265136110083,85.04343053981948,79.70440250180728,-11.980908429634761,22.150760336651164,24.547151910973785,-0.0038077446072452407,9.952724791692876,260.8310422973633,255.81448220825195,251.76000213623047,247.705522064209,242.68896197509764,0.06,0.0,231.24250933557965,-0.03611869537557888,-0.03433952353380076,259.5499965122768,254.0971418108259,8.12943906440222
2023-10-16,0,251.96249771118164,241.16749954223633,267.9100036621094,248.0962495803833,261.2156276702881,-0.08911071965394192,8.107035649446205,-1.1853151086663916,2.9952257956528503,255.8312473297119,6.920212249755861,0.03180706195591036,243.86550331115723,265.12800521850585,0.7712629411363293,-0.04833714456579004,0.988547123980259,0.9816306388768841,0.9693269960655048,-0.01997297577486401,45.74073978078558,271.09569666510333,254.88162536621093,238.66755406731852,258.33464213779996,4.4082563646676824,253.8135711124965,7.100066808979091,258.1046753294706,256.6571082437935,0.1060114096429059,4.515360190405065,88917200,4.717099847379278,0.7783473952946666,-2121701900.0,-43.71363214683964,85.04343053981948,79.70440250180728,-16.217252821234695,21.026203290775758,24.577483082145587,0.045293326536721856,9.736101461496627,260.8310422973633,255.81448220825195,251.76000213623047,247.705522064209,242.68896197509764,0.06,0.0,231.2794783486893,-0.022143547431167976,-0.025371360846437884,258.6742837088449,254.7971420288086,7.759232683795123
2023-10-17,0,252.3025016784668,241.16749954223633,266.50499725341797,248.0962495803833,260.22062492370605,-0.05194867507635306,7.551645709282212,-1.120437630838311,2.995290253908654,254.82499885559082,6.475324573516846,0.029721030356039114,243.86550331115723,264.70275115966797,0.7566618396590435,-0.04910843699443295,0.9929875685339952,0.981565207271677,0.9744852014039075,-0.03697658790142089,43.21680074156418,269.187541487229,254.08425006866455,238.98095865010012,257.70607158115934,4.95905660661342,254.60892840794153,6.132173867812197,256.57003242498376,255.47972164673214,-3.082027429548018,3.019492120069393,93562900,4.7186917457173525,0.8226655445490667,-2028139000.0,-46.516977098221574,85.04343053981948,79.70440250180728,-6.235555791635651,20.774759986893635,22.761183911548297,0.040569662117643575,9.762093560298766,261.7915604248047,257.3692191772461,253.7949981689453,250.22077716064456,245.79843591308597,0.06,0.0,231.31903486898918,-0.033267541067108164,-0.018562048272701987,257.86285618373324,255.82214246477398,7.2214760763054615
2023-10-18,0,248.02249908447266,241.16749954223633,266.50499725341797,248.0962495803833,257.85999870300293,0.026693557549629616,7.131211328608878,-0.9461582790044338,2.9953364344644697,253.4962501525879,6.019874191284179,0.028136491408936815,243.86550331115723,262.25824813842775,0.7043131654368382,-0.05329166702808993,0.9785831036470815,0.9630782301431066,0.9651769983245799,-0.06290793900946623,43.166039920513256,267.71304750462986,253.45062484741212,239.18820219019437,256.4096429007394,6.180474362122814,254.9569639478411,5.541622062677129,255.4862756972815,254.53789798743225,-1.7140440674834339,4.6171238485144075,125147800,4.696724578164736,1.0991080469428824,-2153286800.0,-97.76622922154614,85.04343053981948,79.70440250180728,-71.30489832175392,18.875425415835473,24.2599220978427,0.04340151391486951,9.976944325453205,262.6010422973633,258.67948220825195,255.51000213623047,252.34052206420898,248.41896197509766,0.02,1.0,231.3557740231141,-0.07722726458331597,-0.07943252723336768,255.43571036202567,255.55785587855743,7.31973579265267
2023-10-19,0,223.36249923706055,241.16749954223633,264.67250061035156,247.86749935150146,257.1118745803833,0.03665782478254079,6.5538205411841215,-0.9835586068187716,2.9953955250928233,252.13249969482422,5.546149368286132,0.025953001141536303,243.86550331115723,261.0607536315918,0.7658192450829171,-0.03551359972847419,0.8845111277075746,0.8695741028238424,0.88062457928555,-0.14406562148965119,40.87711527039384,265.63414102133305,252.52649993896483,239.41885885659661,250.89142881120955,13.397811486049855,253.0303565434047,10.092292288466355,253.56145807677387,252.9445408245843,-3.5297895811221363,2.003906036609735,170772700,4.330114368505187,1.4668026166857089,-2324059500.0,-93.61579448378433,85.04343053981948,79.70440250180728,-268.92898641257256,15.733570953349721,36.481420616808926,0.032754282091210896,11.114305009098288,256.6302415771484,249.01488104248045,242.86000061035156,236.70512017822267,229.0897596435547,0.04,0.0,231.3265549487779,-0.149727644137706,-0.16304799124030944,249.2199968610491,253.40714154924663,10.30134937040613
2023-10-20,0,214.56999969482422,223.36249923706055,264.67250061035156,246.69624996185303,256.8012466430664,-1.1088966826389857,9.030699191870626,1.953166627738801,2.9950748328512375,251.54999923706055,6.724186992645263,0.03600227914354301,242.95175132751464,261.0607536315918,0.48270952300133946,-0.11059679036981833,0.8554164922021763,0.8474228193249509,0.8718034155968833,-0.15841700476421217,24.55873146602122,268.8982733455943,250.83687496185303,232.77547657811175,243.73392868041992,17.54863590122284,250.619106565203,14.410976426572958,245.97596793800108,248.47004795416169,-14.743882950369214,-10.774563424905216,137734000,6.85158517016052,1.1778616501291501,-2461793500.0,-97.31714420780108,85.04343053981948,79.70440250180728,-262.81500063229646,14.744711643023175,38.31371011473571,0.04687878266279882,11.012569111405998,255.12928143310546,246.58536080932618,239.68000030517578,232.7746398010254,224.2307191772461,0.06,0.0,231.2799236579379,-0.15582187951924353,-0.18109472132064347,241.93428475516183,250.57785579136439,13.473315135830264
2023-10-23,1,210.39249801635742,214.56999969482422,264.67250061035156,244.4193754196167,256.8012466430664,-1.3927597702337726,11.998765180060555,1.7737390655219096,2.9945430381247062,251.14875030517578,8.655149765014647,0.04818616707651398,239.38699951171876,261.0607536315918,0.6232266015436408,-0.12041650122811685,0.8449209488580198,0.8449845750426195,0.8838386956818567,-0.1649848690675978,21.7257816264373,273.0060302685684,249.00849990844728,225.01096954832613,236.51035635811942,19.568116903291703,247.97553498404366,17.99526867099444,238.1040128153648,243.72975046797802,-18.929998696497673,-13.593943392413271,150683400,6.9308750874615335,1.2637198845418165,-2612476900.0,-85.59384889183714,85.04343053981948,79.70440250180728,-224.00521673470638,13.39121678773557,39.81466698414216,0.023587076956680435,11.259528547784365,253.26252056884766,243.5637394104004,235.7249984741211,227.88625753784177,218.18747637939452,0.08,0.0,231.21982986528567,-0.16477629426435503,-0.1554634997022616,235.25,248.1171417236328,15.852550591586123
2023-10-24,0,217.29500198364258,210.39249801635742,264.67250061035156,244.22062492370605,256.8012466430664,-1.3358654805478976,14.64355727278926,0.8780580747011433,2.9939290661149953,251.14875030517578,10.676525039672857,0.05920634572805062,222.4832492828369,261.0607536315918,0.7263496458727215,-0.1397716529877068,0.8785599545765601,0.88938960899692,0.9458712506709096,-0.13875209108880582,20.029297938196205,276.61798917936756,247.33087463378905,218.04376008821055,231.12964248657227,18.81330712323854,245.3044637952532,19.623597282703386,231.15836283067597,239.4791547630476,-19.37672051128659,-14.959429315954443,118231100,6.9345220318020475,0.984850043544411,-2494245800.0,-78.91011878333043,85.04343053981948,79.70440250180728,-148.78222451748582,15.780119397776394,37.27569777167624,0.020068441866894167,11.167419452992847,253.26252056884766,243.5637394104004,235.7249984741211,227.88625753784177,218.18747637939452,0.08,0.0,231.18886995968776,-0.1504022009537863,-0.14729046221715988,230.3071441650391,244.92857033865795,17.310270670092866
2023-10-25,0,215.1500015258789,210.39249801635742,264.67250061035156,242.65437602996826,256.8012466430664,-1.088612988510432,16.04062222829046,-0.10563055637710317,2.993550787054321,251.14875030517578,12.586299858093264,0.06521459605298051,217.02250175476075,261.0607536315918,0.8196388012522096,-0.09898720849163548,0.8747117312919656,0.8970199110180102,0.9659742776928344,-0.1325383692202774,29.146911635687545,278.04799422006965,245.96674976348876,213.88550530690785,225.87071446010046,17.08503219190053,242.1026782989502,20.674509381154866,227.6682690050265,236.81957966039366,-14.77290446975214,-14.682554024382819,107065100,7.186215846131355,0.9029448422365434,-2601310900.0,-85.08203751553037,85.04343053981948,79.70440250180728,-137.09236275586593,14.965734964996901,36.59970888303414,-0.02815473247081961,10.934033003155745,253.26252056884766,243.5637394104004,235.7249984741211,227.88625753784177,218.18747637939452,0.08,0.0,231.15552015227814,-0.1246909321744668,-0.1664901193580351,224.37857273646765,241.52642822265625,18.871227416459302
2023-10-26,1,209.19000244140625,210.39249801635742,264.67250061035156,238.20312595367432,256.8012466430664,-0.9091874988555609,17.37645661306844,-0.709779654257479,2.9931507962911335,251.14875030517578,14.407524719238278,0.07102116967812415,215.09200134277344,261.0607536315918,0.8438982585449138,-0.11515525323580929,0.8550027769864638,0.8905586574466461,0.9677822402213382,-0.0634506546267315,27.520822534801702,279.4187880888078,244.6658748626709,209.91296163653402,219.7117859976632,13.325851625351907,238.70892878941126,21.95362851261937,224.547415973627,234.35271342310776,-14.61030769249636,-17.242041431420276,115112600,7.147301125445722,0.9716117020562742,-2716423500.0,-95.10763267829041,85.04343053981948,79.70440250180728,-135.1368967272719,13.989424996955329,39.025884554489885,-0.104552582808096,10.861601943569285,253.26252056884766,243.5637394104004,235.7249984741211,227.88625753784177,218.18747637939452,0.08,0.0,231.10569404038873,-0.0651947029381853,-0.15213449515086394,217.36571393694197,237.6142850603376,20.788140372315013
2023-10-27,1,209.02000427246094,209.19000244140625,264.67250061035156,221.84562492370605,256.8012466430664,-0.7487358743738525,19.022881568919544,-1.1159502681583608,2.992601137990144,251.14875030517578,16.784724655151365,0.07829381384714978,214.15224952697753,261.0607536315918,0.8486352862021919,-0.16435975784950888,0.8602783571746749,0.9098873490131371,0.9798448034746058,-0.025865663560874608,22.62525650804006,281.01363804628636,242.96787490844727,204.92211177060818,214.14000102451868,5.179673987688087,235.27482196262903,22.606488008399374,220.72222360923547,231.5173020168884,-17.08762257617363,-18.5087772626162,94881200,6.907868412865591,0.8123204022373459,-2811304700.0,-92.78939037665059,85.04343053981948,79.70440250180728,-113.64346947180249,13.36021106880501,37.27058509611931,-0.12351162392514778,10.560773887262439,253.26252056884766,243.5637394104004,235.7249984741211,227.88625753784177,218.18747637939452,0.08,0.0,231.06481346212024,-0.02212369602281794,-0.0581981623873173,212.3114297049386,233.87357003348214,22.15595120310462
2023-10-30,1,203.04750061035156,209.02000427246094,264.67250061035156,216.75875186920166,256.8012466430664,-0.5448696792041945,20.31038817208143,-1.4446043055218596,2.992116882534616,250.14499855041504,18.73348676681519,0.08430970948891019,210.2722484588623,261.0607536315918,0.8749515072889944,-0.15828893382246992,0.8428630533235985,0.9019252492258114,0.9568256794985683,-0.03491092826624842,22.757450196082935,281.5229013212747,240.9021249771118,200.28134863294895,211.23785836356026,4.830565938177467,231.0646435873849,22.73667672718662,217.78582527229077,229.48635603926272,-15.725385783943766,-18.700102336072995,136448200,6.922251417371978,1.1619082864611332,-2947752900.0,-96.3614200558629,85.04343053981948,79.70440250180728,-118.68842700349482,11.949337998803532,40.56598544858648,-0.19014317621168736,10.964290517734208,251.15252423095703,240.35874307250975,231.63500213623047,222.91126119995118,212.1174800415039,0.1,0.0,230.98677246426283,-0.06940777580919322,-0.06901271052273403,209.0614297049386,229.14071328299386,23.993459882028436
2023-10-31,1,198.45750045776367,203.04750061035156,264.67250061035156,215.00500106811523,256.8012466430664,-0.38976439778264804,21.82379417095251,-1.6076936091937006,2.991492405620101,249.99249839782715,20.707749252319342,0.09145141484607254,209.17300262451172,261.0607536315918,0.8755938905479302,-0.17928274578825984,0.8316252921700574,0.9011159643506983,0.9417150401432304,-0.08669091030127307,20.45411356978552,282.285713380052,238.63812503814697,194.99053669624192,208.9360727582659,6.521158731877438,226.3350007193429,22.085495619603915,214.10027471755973,227.1124258494765,-9.095080282544716,-22.497995241813427,118068300,6.969947835422789,0.9985586785783879,-3065821200.0,-90.51024760134985,85.04343053981948,79.70440250180728,-107.55190860208754,11.25970631292177,38.621449084562535,-0.15042388352096595,10.80469803272027,248.5737645263672,238.15812506103515,229.74000549316406,221.32188592529297,210.90624645996093,0.12000000000000001,0.0,230.91568902789348,-0.07241828757235358,-0.052998893795361005,207.4685712541853,224.70142800467355,25.27700733507211
2023-11-01,1,203.38500213623047,198.45750045776367,264.67250061035156,213.52562427520752,256.8012466430664,-0.2575636242732201,23.391715960023934,-1.6843727510156636,2.990775392063206,249.99249839782715,22.523286724090575,0.09903733984107035,208.42275390625,261.0607536315918,0.8738718096917684,-0.22078801080588756,0.8611044016422842,0.9466338909354288,0.9826644069851124,-0.05468277623150897,16.20947357886378,282.97430697345357,236.19087505340576,189.40744313335793,207.93500191824776,6.792536074856079,222.2226791381836,20.441711800947868,210.21507564765793,224.44436661529556,-7.509204110535872,-25.017710566791752,121661700,6.601847178256354,1.0324687186335044,-2944159500.0,-82.31344948299882,85.04343053981948,79.70440250180728,-85.96565090893976,12.78961612978378,36.50586159986482,-0.1531401619442188,10.614362415358,244.13492639160157,234.56754656982423,226.8350067138672,219.10246685791014,209.5350870361328,0.12000000000000001,0.0,230.8518199433251,-0.0318237198244371,-0.05015703120292657,206.55142865862166,220.90071432931083,25.380166194370403
2023-11-02,1,215.53249740600586,198.45750045776367,264.67250061035156,210.09187412261963,256.8012466430664,-0.06624964725471909,24.026906899059938,-1.7586881365260405,2.990420075757007,235.6924991607666,23.238624191284185,0.10284362802890694,203.35125198364258,261.0607536315918,0.8874199718174756,-0.21767476361202406,0.9225550373374058,1.0244572922425406,1.0533305410838363,0.03031930250288184,21.72727060038591,281.6794390270017,233.62562522888183,185.57181143076195,207.68321555001395,6.409626091604245,219.4064290182931,18.17482465390833,208.5350860024597,222.23803899515852,-3.3306776364156008,-22.062022050962014,125987600,6.5787918948072,1.0660910787783882,-2818171900.0,-61.27397741186124,85.04343053981948,79.70440250180728,-43.49980721923411,20.364702193712333,33.24380213654021,-0.1105994634110619,10.823336048984775,242.2860361328125,233.07197827148437,225.625,218.17802172851563,208.9639638671875,0.12000000000000001,0.0,230.8174240772879,0.06196539823282521,0.02866959980409661,206.83571297781805,218.57142857142853,24.73436564677836
2023-11-03,1,221.46999740600586,198.45750045776367,264.67250061035156,210.09187412261963,255.39562320709229,0.12073907603498446,23.53737465358064,-1.7211850128864485,2.9905690584949562,220.32875061035156,22.603599414825442,0.10171572441960455,203.35125198364258,261.0607536315918,0.9088614865875378,-0.1603802022911173,0.9570728067555697,1.0566114983642467,1.0756792941594007,0.05956364404871106,37.1941237889791,278.47824948263735,231.40350017547607,184.3287508683148,208.5860721043178,7.906919451097126,217.2283932822091,15.620898762706853,210.30188984385768,221.69093957302667,-0.8111114206710542,-15.46419117510421,119281000,7.393175598688862,1.0087713233614823,-2698890900.0,-58.976381874556324,85.04343053981948,79.70440250180728,-24.30647313158924,24.095653581193698,31.461686456624033,-0.18094866223594092,10.619526418393226,242.2860361328125,233.07197827148437,225.625,218.17802172851563,208.9639638671875,0.02,1.0,230.79666741188487,0.061070928488835996,0.06901250284860168,207.91285705566403,216.14571489606584,23.817916740267897
2023-11-06,1,221.1425018310547,198.45750045776367,264.67250061035156,210.09187412261963,252.96687602996826,0.2910659636172446,22.887473620244304,-1.5884676201885028,2.9908023236571606,219.38249969482422,21.482999801635742,0.09966594112520039,203.35125198364258,261.0607536315918,0.9053416607238778,-0.1385758417042221,0.9629885732900805,1.051587307166019,1.0612539309577733,0.08911708426013809,42.92883284899569,275.41682250751745,229.6418752670288,183.8669280265402,210.29357201712472,9.23766344196048,215.00267900739397,12.05096908164424,213.11481040609826,222.08294821287035,2.937483539532657,-12.101999536505856,117335800,7.595089698913391,0.9856693962974667,-2816226700.0,-58.38837852683133,85.04343053981948,79.70440250180728,-24.49473086754909,22.269611247632128,31.353587673669036,-0.21896105866899368,10.669560768809335,240.33784545898436,231.4960858154297,224.35000610351562,217.20392639160156,208.3621667480469,0.02,0.0,230.77329753607734,0.11101542153603039,0.05774240735401501,209.84285845075334,213.60428619384766,22.75239054482578
2023-11-07,1,220.24999618530273,198.45750045776367,264.67250061035156,210.09187412261963,252.04749870300293,0.47094443599145563,22.057333143350494,-1.3689648349466945,2.991106062349651,219.21875190734863,19.995862274169923,0.09680887364507655,203.35125198364258,261.0607536315918,0.8792535255307435,-0.15591242553448498,0.9666696292094332,1.0420165451693892,1.0389273285950564,0.10980938325471357,41.52166293164857,271.9587916529119,227.84412536621093,183.72945907950998,211.89785657610213,9.928904437674305,213.01892880031042,7.696493890842987,215.1484474610065,222.17977828675205,5.7137048855842485,-12.350254016554413,116900100,7.438104618085155,0.984389192291675,-2933126800.0,-23.070633507120977,85.04343053981948,79.70440250180728,-19.038560025237242,21.141684105998863,29.765568820018427,-0.1857498988899224,10.43602027792898,221.98656219482422,216.65172317504883,212.34000396728516,208.02828475952148,202.6934457397461,0.02,0.0,230.75043081648735,0.10625371801933547,0.12575999183558917,211.96857125418526,212.14000047956193,21.044837391706732
2023-11-08,1,221.7624969482422,198.45750045776367,264.67250061035156,210.09187412261963,249.0074987411499,0.6490980025242803,20.658094914979255,-1.0514485422576423,2.9916177359372593,218.77249908447266,17.833475074768064,0.09150583791828626,203.35125198364258,255.55974960327148,0.8431580670883111,-0.1678395160910473,0.9823056378439861,1.0477075584267237,1.0249888978373056,0.09035816121634266,40.1397739952143,267.0733151122461,225.7571252822876,184.4409354523291,214.57142748151506,9.664758310843116,212.90464292253768,7.541403224174609,216.4890144023126,221.95925481767685,5.372687629554979,-11.19757401110253,106584800,7.358271714236189,0.8964399446348366,-2826542000.0,-13.18884246687944,85.04343053981948,79.70440250180728,-8.783396846001049,20.8980999608308,28.402676264760508,-0.1488574228422779,10.15558986570805,218.7471979980469,214.03139978027343,210.22000122070312,206.40860266113282,201.69280444335936,0.02,0.0,230.73158359973561,0.0799863690329834,0.1059052213717258,215.50428553989954,212.28285762241907,19.01998776613327
2023-11-09,1,214.30249786376953,198.45750045776367,260.95750427246094,210.09187412261963,229.52749919891357,0.7754435554048238,18.63414192848009,-0.7302533570884555,2.992326297099533,218.77249908447266,15.014687633514404,0.08333261707755571,203.35125198364258,252.5682514190674,0.8186208366397105,-0.15019689674567074,0.9583692161296016,1.0093099772145924,0.9739628183019686,-0.005706793903655916,42.61618185943638,260.8799089561423,223.61162509918213,186.34334124222198,216.8349985395159,6.645709401714773,212.8855356488909,7.5371969268918555,217.85306686373633,221.77113679487516,9.21705329129105,-0.7163253877815159,142110500,7.399257984966065,1.1800454362810506,-2968652500.0,-50.743051343246435,85.04343053981948,79.70440250180728,-44.788055794808855,18.711243427957566,32.86341016433624,-0.15571556128388356,10.532334013483927,218.7471979980469,214.03139978027343,210.22000122070312,206.40860266113282,201.69280444335936,0.02,0.0,230.6831981148348,-0.03903711040105318,0.02100550417439091,216.80999973842071,212.13928549630302,17.175658235950376
2023-11-10,1,211.4375,198.45750045776367,254.95999908447266,210.09187412261963,222.16249752044678,0.9400938625269584,16.624884339033763,-0.2767366840345278,2.9929695951347246,216.41374969482422,12.489036769866946,0.07513091503044139,203.35125198364258,251.99649810791016,0.7898003625135903,-0.15946619613546748,0.9555250143576165,0.9934245478233136,0.9620175210782352,-0.045299577927090384,37.85311883876429,254.52864345681508,221.27887477874756,188.02910610068005,217.98535537719727,4.1625325217932785,212.96017864772253,7.515752463547225,216.99183759168668,220.3293939960978,7.984075869875243,-0.12466879406960268,130994000,7.4472402432376255,1.0748313832318623,-3099646500.0,-36.28484721364005,85.04343053981948,79.70440250180728,-42.65126090248341,17.47455037623135,31.366602405909756,-0.07438308542399945,10.472167472621237,218.7471979980469,214.03139978027343,210.22000122070312,206.40860266113282,201.69280444335936,0.02,0.0,230.6374099352218,-0.02414081039872973,-0.017665098656303103,218.0942840576172,212.32285635811942,15.586053184352044
2023-11-13,1,219.0800018310547,198.45750045776367,252.3025016784668,210.09187412261963,221.54312229156494,1.168363436387196,14.824742345881036,0.5407909315427895,2.9934978063833997,215.34124946594238,10.745299148559571,0.0676611423533203,203.35125198364258,248.41649894714357,0.7408109166601877,-0.16083741858137332,0.9998961765952848,1.028164482719968,1.0059739610979455,-0.00932656537265586,36.29897657157309,248.75223451628602,219.10274982452393,189.45326513276183,218.4921417236328,4.027902137910206,213.08767863682337,7.609502718987579,215.58954821548178,218.32841206180439,3.959238773356475,0.49669165654439457,140447600,7.4464958624220685,1.1285416886968411,-2959198900.0,-8.235261326938812,85.04343053981948,79.70440250180728,23.04557249263846,22.55048084891743,28.481585965402715,-0.050689712475319844,10.709155030729208,218.7471979980469,214.03139978027343,210.22000122070312,206.40860266113282,201.69280444335936,0.02,0.0,230.61029603000722,0.020249018811935526,0.01704855376222165,218.83714294433594,212.83642796107702,13.25245335195737
2023-11-14,0,235.32500076293945,198.45750045776367,252.3025016784668,210.09187412261963,221.22437572479248,1.364348932228572,12.770345085326277,1.8414156801876098,2.9940495349822696,215.34124946594238,8.77234939575195,0.05872540159551786,203.35125198364258,225.8284992218018,0.6297855776959919,-0.131677251023657,1.0821598854950663,1.0961561827852,1.0826185374276514,0.06844497089095825,44.932980939089724,242.9993152011701,217.45862503051757,191.91793485986503,220.47142791748047,7.576262006067787,214.52875001089913,9.663295412431745,216.4321320151024,217.38908295621744,1.6459255415048961,0.8214638307909538,149771600,7.746619648765345,1.1768857148683192,-2809427300.0,-1.6564462422758854,85.04343053981948,79.70440250180728,161.3536570199715,28.72427453437054,25.806729277267877,-0.022104118414426763,10.974929148232926,227.73948126220702,221.3052624206543,216.1050033569336,210.9047442932129,204.47052545166017,0.04,0.0,230.62364339025984,0.0685480758321595,0.08272905110681689,221.32999965122767,214.62142835344585,11.007336892939183
