date,buy?,todays_price,Minimum,Maximum,25th Percentile,75th Percentile,Skewness,Standard Deviation,Kurtosis,Shannon Entropy,Median,Mean Absolute Deviation (MAD),Coefficient of Variation (CV),10th Percentile,90th Percentile,Autocorrelation,Cumulative Return,curr_to_avg_one_month,curr_to_avg_one_two_week,curr_to_avg_one_one_week,momentum,rsi,upper_band_current,middle_band_current,lower_band_current,rolling_mean_7,rolling_std_7,rolling_mean_14,rolling_std_14,ema_7,ema_14,roc_7,roc_14,Volume,Volatility,Relative Volume (RVOL),On-Balance Volume (OBV),Williams %R,Stochastic Oscillator %K,Stochastic Oscillator %D,Commodity Channel Index (CCI),ADX1,ADX2,Chaikin Money Flow (CMF),Average True Range (ATR),Fib_23.6,Fib_38.2,Fib_50,Fib_61.8,Fib_76.4,Parabolic SAR 2,Parabolic SAR 3,VWAP,Adj Close Momentum,Adj Close Return,Adj Close 7d MA,Adj Close 14d MA,Adj Close Volatility
2021-12-30,0,29.852500438690186,27.57824993133545,32.330750465393066,29.172187447547913,31.220187664031982,-0.07686767464580686,1.3539947313706124,-1.026309702200323,2.9947135267442024,29.884124755859375,1.151312565803528,0.045097361668626816,28.10440049171448,31.728075122833253,0.6629094552427565,-0.07063710248551609,0.9942941267087946,1.0184951579620618,0.9956209886327109,0.026785344824998836,48.01289052642571,32.731801971324295,30.02381250858307,27.315823045841846,29.75199999128069,0.7600502153687483,29.341499975749425,0.995443809752159,29.815375279823044,29.995938355399705,6.864172250598077,-5.761511581554012,308864000,1.0032197095751891,0.5992933180320127,-700969000.0,-41.67263330363308,44.757923903640624,51.57585752245338,-0.5565193476571182,26.08979229737747,23.116853992476646,0.01702893818192307,1.4931416750810804,30.34234004974365,29.731330127716063,29.237500190734863,28.743670253753663,28.132660331726075,0.04,0.0,29.884126095226595,0.006326550343021875,0.017575191600710506,29.80775260925293,29.24381651197161,1.3693801142789925
2021-12-31,0,29.611499786376953,27.57824993133545,31.884000301361084,29.172187447547913,30.861562490463257,-0.11653396114059819,1.2463212583552685,-0.9433432082681819,2.9948616027057624,29.786875009536743,1.0321400213241578,0.04168312462761255,28.10440049171448,31.629974842071533,0.6405771358540628,-0.05859999080031306,0.9903544754062368,1.0083694424572436,0.9824798267420645,-0.003692637273191357,47.75847346706257,32.39254252395846,29.899900007247926,27.40725749053739,29.911857060023717,0.535502700052691,29.268857104437693,0.9292040422989352,29.823247466083036,29.95414402017425,8.246536720122501,-4.362589667284016,266530000,0.9965396637005116,0.5277170234526489,-967499000.0,-45.85426213855511,44.757923903640624,51.57585752245338,-11.784527027524867,24.928267149696314,23.41884257482544,-0.02710174861600445,1.4212548609172548,30.34234004974365,29.731330127716063,29.237500190734863,28.743670253753663,28.132660331726075,0.04,0.0,29.87705318632697,-0.007726166953597957,0.00037398839258541373,29.85567937578474,29.18768678392683,1.266147742728271
2022-01-03,0,30.1080002784729,27.57824993133545,31.884000301361084,29.172187447547913,30.65737497806549,-0.053654771602849635,1.1757973380667772,-0.7518731297214178,2.994952603266464,29.709624767303467,0.940781319141388,0.0394629905971607,28.10440049171448,31.276300334930422,0.6202322826370389,-0.05206801287145859,1.0105072476539396,1.0255790215550018,0.9996812599383624,-0.007417645138107276,46.97400297956089,32.14653216755049,29.79493749141693,27.443342815283376,30.059607097080775,0.38811877187339267,29.333357129778182,0.9554017262248629,29.773184751108595,29.87381734001942,3.9273474395572823,-3.3204374973339092,391547000,0.9932887522443188,0.7871502640255501,-575952000.0,-28.888883824906742,44.757923903640624,51.57585752245338,36.70529253886136,27.176055139605868,21.501591342185858,-0.014418865634477342,1.4104844265614762,30.34234004974365,29.731330127716063,29.237500190734863,28.743670253753663,28.132660331726075,0.04,0.0,29.88829048883564,-0.026627847737763832,0.016228153646336663,29.958524431501115,29.327476228986466,1.2500308627121457
2022-01-04,0,29.59600067138672,27.57824993133545,31.884000301361084,29.172187447547913,30.406874775886536,-0.012968812236032143,1.1314088642513191,-0.5273487639404544,2.9950079982676647,29.709624767303467,0.8786313128471374,0.038045336605043965,28.10440049171448,31.254925060272218,0.678706778635628,0.018917746662736944,0.995210346395076,1.0013474571009422,0.984151706006443,-0.03734059615594865,53.35277397560077,32.00125521419752,29.738437485694885,27.475619757192245,30.041714395795548,0.40866064854334866,29.448000056403025,0.87483440667878,29.86233137939209,29.857082502936816,3.5573335353055815,3.091937535099493,527154000,0.9251574181309239,1.073995956883612,-1103106000.0,-48.74550223435553,44.757923903640624,51.57585752245338,-25.710214268476438,23.761327308078705,27.31503420094987,-0.07531130477465721,1.4723425550224467,30.34234004974365,29.731330127716063,29.237500190734863,28.743670253753663,28.132660331726075,0.04,0.0,29.86543493625288,-0.03403473848927119,-0.053482058292962625,29.908599581037247,29.395445006234304,1.2511271585660892
2022-01-05,0,28.375500202178955,27.57824993133545,31.884000301361084,29.172187447547913,30.406874775886536,-0.019078907721870486,1.1310617028287404,-0.5242057101840794,2.9950085007725793,29.709624767303467,0.8765162730216979,0.03803065744946728,28.10440049171448,31.254925060272218,0.691159834367226,-0.06403969367393268,0.9540937735293076,0.9535435114917379,0.9508259890696774,-0.05562950487490492,45.70452370842182,32.002910935602856,29.740787529945372,27.47866412428789,29.76207160949707,0.7241136127958948,29.382017953055247,0.9205573742437336,29.800838697481865,29.803266292534925,-0.4214119889469558,5.733989460997519,498064000,0.7957780838849801,1.0246442596024397,-1601170000.0,-89.03226541545796,44.757923903640624,51.57585752245338,-104.78989313434663,21.210795965226694,29.03462336566653,-0.18292589608996515,1.5076352774468178,30.34234004974365,29.731330127716063,29.237500190734863,28.743670253753663,28.132660331726075,0.02,1.0,29.79831847659354,-0.07989730713618115,-0.08963791704132108,29.432032448904856,29.19182355063302,1.1551507888763217
2022-01-06,0,27.830249786376953,27.57824993133545,31.884000301361084,28.92843759059906,30.164250135421753,0.0683005273730023,1.081391681667863,-0.4615560478791858,2.9950641359478194,29.654749870300293,0.8495850086212158,0.036560042695243204,28.10440049171448,30.7910249710083,0.5632238756390914,-0.11003952032431627,0.9408941622705493,0.9355885105800613,0.9431201485196476,-0.06774141604876438,37.63233978338669,31.741295912736057,29.57851254940033,27.415729186064603,29.345821584974015,0.8851503487754647,29.248607226780482,1.0028995786153965,29.44133502462217,29.523559301235924,-6.45336604702778,-3.1528092286790557,454186000,0.827818772459605,0.9364340247770927,-2055356000.0,-73.90388929237132,44.757923903640624,51.57585752245338,-116.14883022644547,19.56196118599266,29.427294833563465,-0.15091157377657005,1.4962298990345773,30.323460067749025,29.70077015686035,29.197500228881836,28.69423030090332,28.071540390014647,0.04,0.0,29.73141185469814,-0.04759022387526313,-0.06076467738348282,29.126207624162948,29.176917484828405,1.0410490532664456
2022-01-07,0,27.716750144958496,27.57824993133545,31.214250087738037,28.463250279426575,30.062250018119812,-0.1639728758115927,1.0076622359663814,-0.9264405590738289,2.995142601724065,29.603750228881836,0.8419925117492675,0.03430243185187447,27.97492470741272,30.640049982070924,0.5251642610285515,-0.10841203270458925,0.9435224414171561,0.9356844129914441,0.9523265504835435,-0.06398695287599565,35.638807988242704,31.39114949558389,29.375825023651124,27.36050055171836,29.01292875834874,1.0072608140200525,29.220017910003662,1.0425600138221955,29.03689476442504,29.21523058671651,-9.477459587686305,-6.289144624976839,409939000,0.8244389189470678,0.8521078725385358,-2465295000.0,-95.55346355795236,44.757923903640624,51.57585752245338,-126.65537181949612,18.05895625139673,27.211344099793255,-0.13566019112691935,1.4852589487812902,30.321571754455565,29.697713649749755,29.19349956512451,28.68928548049927,28.06542737579346,0.06,0.0,29.665152425698146,-0.07357789455963293,-0.07905781057000535,28.733371462140763,29.137405531747,1.0900262463509363
2022-01-10,0,26.773499488830566,27.57824993133545,30.74399995803833,28.310875296592712,29.9011253118515,-0.2161541002438469,0.9764415261605323,-1.2081512794200713,2.995171665508277,29.447625160217285,0.8432599544525147,0.03343869036021091,27.818899822235107,30.3625497341156,0.5430346394276303,-0.0950666810726388,0.9168708368913461,0.9099993170479039,0.9320529041255683,-0.11075132053942782,35.79829494030035,31.153833078833213,29.200950026512146,27.24806697419108,28.573071479797363,1.2276867103787072,29.162535735539027,1.1560509522805713,28.705637867774477,28.95083963336464,-7.755349258502109,-1.423517539643098,594681000,0.8188744764466529,1.2226650735395783,-3059976000.0,-69.11712514365493,44.757923903640624,51.57585752245338,-158.4606476943373,16.260139851171342,32.21298886614906,-0.05087733860484609,1.513320459457362,29.988103729248046,29.157947608947755,28.48699951171875,27.816051414489745,26.985895294189454,0.08,0.0,29.54448046008205,-0.0903357021161767,-0.06837564481735185,28.42155592782157,29.114654268537247,1.119942061912522
2022-01-11,0,27.511000156402588,26.773499488830566,30.74399995803833,28.085500359535217,29.754062294960022,-0.3539968665080359,1.0530984490704418,-0.8942076569492876,2.9950701686433767,29.252124786376953,0.919084987640381,0.03630347450059372,27.70290012359619,30.13050022125244,0.6149117985733282,-0.0832563068388098,0.9483870131471299,0.9465173518917754,0.9804906943661204,-0.07044872508736966,32.65448513876751,31.114396899857496,29.008200001716613,26.90200310357573,28.27300010408674,1.187620189529507,29.092428582055227,1.2273709101832153,28.217958302724824,28.614489906139912,-10.314047080187278,-2.918062039863142,404089000,0.7860286470535802,0.8477364338548281,-2655887000.0,-61.78332710521143,44.757923903640624,51.57585752245338,-92.01599042408303,18.434867631782538,30.047692428256315,0.03349400545271195,1.4898508678545208,29.988103729248046,29.157947608947755,28.48699951171875,27.816051414489745,26.985895294189454,0.08,0.0,29.488937502909067,-0.05029026431811723,-0.07649165619998864,28.194184712001256,29.024932043892996,1.1352555325680476
2022-01-12,0,28.06724977493286,26.773499488830566,30.74399995803833,27.950812220573425,29.754062294960022,-0.20464145708533654,1.1009024088361214,-1.1643632593025957,2.9950056883481735,29.18649983406067,0.9925749826431275,0.03806255841540379,27.571524953842165,30.13050022125244,0.7115278182180045,-0.017148352949311364,0.9703960365092978,0.976517096412597,1.0154062319515322,-0.010863259679997572,41.4725467752836,31.125304831023684,28.92350001335144,26.721695195679196,27.981464317866735,0.870134668015037,29.020535707473755,1.257653311259054,28.038113140475176,28.447278104221283,-7.093526653927606,-3.444766651787663,383413000,0.7646165934911305,0.8290242041345586,-2272474000.0,-58.58246380029936,44.757923903640624,51.57585752245338,-57.98692457380555,20.376731525289124,28.393030413778728,-0.011761297049810025,1.4491927734841983,29.988103729248046,29.157947608947755,28.48699951171875,27.816051414489745,26.985895294189454,0.08,0.0,29.451912833245764,0.014309531309599333,-0.04407645442269128,27.891498020717076,28.925011226109095,1.1470759803948205
2022-01-13,0,27.482999801635742,26.773499488830566,30.74399995803833,28.007999777793884,29.754062294960022,-0.20988386373305123,1.0977941338377077,-1.148167485917463,2.995009932584026,29.18649983406067,0.9883812284469606,0.03795009070359548,27.571524953842165,30.13050022125244,0.7801895598306571,-0.0420488541130618,0.950070967889834,0.9628217172294522,0.9964919889005688,-0.012477429681971186,43.60366947176151,31.122900784841548,28.927312517166136,26.731724249490725,27.67960705075945,0.5077270612010658,28.8606607232775,1.3031668719292395,28.044652341375297,28.43034846165897,-6.778100453915458,-3.461886559113711,540171000,0.7122340207687946,1.1882837990517858,-2812645000.0,-83.62642405392369,44.757923903640624,51.57585752245338,-104.63982704653186,18.208329749254315,31.331273942091194,-0.14120424205654802,1.491870676710397,29.988103729248046,29.157947608947755,28.48699951171875,27.816051414489745,26.985895294189454,0.08,0.0,29.371654615349957,-0.0568883004595917,-0.03727722106302776,27.504225049700057,28.706412315368652,1.2002135175898814
2022-01-14,0,26.66224956512451,26.773499488830566,30.74399995803833,27.80187487602234,29.754062294960022,-0.05265521746162711,1.137668735188957,-1.3202286738340396,2.9949531482584093,28.783125162124634,1.0420000076293945,0.03945238618454785,27.508200120925903,30.13050022125244,0.7590446515827001,-0.07458415233356058,0.9246007505140549,0.941886831441786,0.9691733528121588,-0.03804560687378389,38.84599570135663,31.111837495173447,28.836500024795534,26.56116255441762,27.434856959751674,0.5288590451941261,28.598464284624374,1.3524889470466515,27.898965095783346,28.336671846503442,-7.139481084664984,-7.530806444372562,395832000,0.7123821411385548,0.9016590050070148,-3208477000.0,-77.17199881117787,44.757923903640624,51.57585752245338,-115.2796701949721,17.225291225494708,31.215092329429694,-0.05930753220665981,1.4517782932194152,29.988103729248046,29.157947608947755,28.48699951171875,27.816051414489745,26.985895294189454,0.08,0.0,29.306212037562574,-0.011193824236221617,-0.04386394674036947,27.409796033586776,28.420914241245814,1.2633260796795667
2022-01-18,0,26.14275026321411,26.66224956512451,30.74399995803833,27.682125091552734,29.754062294960022,0.02786301634865877,1.2126458042696986,-1.2749967272138663,2.994838576989752,28.434000253677368,1.092458782196045,0.04227498546634992,27.412049770355225,30.13050022125244,0.7877058504260777,-0.051739196383302925,0.9113826836628326,0.9332580192421714,0.9576309550960646,-0.023558714312994167,36.24414605268487,31.110004113879977,28.684712505340578,26.259420896801178,27.19378559929984,0.681242462977465,28.269803592136928,1.3500683940661948,27.58298972687052,28.144557852722386,-6.037781272038626,-12.101507192462863,424270000,0.6473910426733407,0.999388264236872,-3632747000.0,-94.88848017442054,44.757923903640624,51.57585752245338,-138.71815951474875,16.112874305075646,31.62372413054937,-0.017853665804325004,1.4297365767677088,29.51518812561035,28.77540592956543,28.177499771118164,27.579593612670898,26.839811416625977,0.08,0.0,29.221722770252438,-0.054635173040999185,-0.04932655195075519,27.085285459245956,28.105746541704452,1.3947792903448655
2022-01-19,0,25.68524980545044,26.14275026321411,30.74399995803833,27.561437487602234,29.754062294960022,-0.1012493418447811,1.329559869405259,-1.2030785284505174,2.9946482358470137,28.434000253677368,1.1813000464439392,0.046510874900062185,26.762374496459962,30.13050022125244,0.7873086713357125,-0.052051876812178315,0.898525495517958,0.9300917071618504,0.9452402597548679,-0.06636437572507681,34.05008108426106,31.2451197283201,28.58599998950958,25.926880250699064,26.903571265084402,0.8363776626024166,27.95825001171657,1.4103320196140006,27.224160782473206,27.952085864440715,-6.06354429484453,-14.966333922405486,488315000,0.6466815627781094,1.1466747570934672,-4121062000.0,-99.73494630505577,44.757923903640624,51.57585752245338,-150.70456261609002,14.803121924816956,32.9675398161506,-0.08206616662349311,1.4345277675348285,29.375476348876955,28.54926229095459,27.881500244140625,27.21373819732666,26.3875241394043,0.1,0.0,29.113636692646512,-0.09886031954617713,-0.08514600851723637,26.77432632446289,27.75384889330183,1.5905102901551842
2022-01-20,0,24.77775001525879,25.68524980545044,30.74399995803833,27.504000067710876,29.754062294960022,-0.25819233529808894,1.4590100737040463,-1.0832582607148755,2.9944141957958865,28.434000253677368,1.2666000843048095,0.05120887829336168,26.610299634933472,30.13050022125244,0.820291993805398,-0.09852594435930893,0.8696586869297426,0.9101185541561335,0.9242635681464302,-0.11720064438276234,29.143592253109798,31.409370130623422,28.491349983215333,25.573329835807243,26.61846419743129,1.164070487989858,27.59576783861433,1.5328546084416845,26.84462505963173,27.763712022756078,-7.329504104497524,-14.516424720779604,435181000,0.6075351914956092,1.0327202950025973,-4556243000.0,-98.91451094331349,44.757923903640624,51.57585752245338,-167.69779743305176,13.604233907835198,35.55290978064711,-0.18857983864189168,1.4396914888157315,29.145612129211425,28.177193935394286,27.39449977874756,26.611805622100828,25.643387428283688,0.12000000000000001,0.0,28.99818867371997,-0.13746918798179475,-0.13182577684946564,26.31073978969029,27.36614785875593,1.8448545316809886
2022-01-21,1,23.741750240325928,24.77775001525879,30.74399995803833,27.30562472343445,29.754062294960022,-0.38863112157670066,1.6684583125799406,-0.8996200515094332,2.993979585454692,28.221374988555908,1.4406375885009766,0.05894443423274282,26.097000217437746,30.13050022125244,0.811861856361305,-0.14776215661881792,0.838764759694316,0.8837436232932308,0.9078993789749498,-0.13612959241396716,23.528932281501003,31.642529093879357,28.30561246871948,24.968695843559605,26.079999923706055,1.5044166610601635,27.176500013896398,1.7292648837661029,26.332538540241398,27.429188026165868,-7.454197290885971,-16.999414953041224,718958000,0.6044575180499818,1.6430261235847212,-5275201000.0,-98.50966619606099,44.757923903640624,51.57585752245338,-173.3850219406465,12.473544719461447,36.940117042373245,-0.28456252469562915,1.4489790401504012,28.953272453308106,27.865864459991457,26.987000465393066,26.108136470794676,25.020728477478027,0.14,0.0,28.7881437701377,-0.12045147027365233,-0.16518441500317588,25.676982062203543,26.9355833871024,2.107618702068468
2022-01-24,1,22.492499828338623,23.741750240325928,30.74399995803833,26.745687007904053,29.754062294960022,-0.49842351377116345,1.9299268752702443,-0.654619463890318,2.9933317458609707,27.948749780654907,1.606587553024292,0.06883005871415204,25.594499826431274,30.13050022125244,0.799551366971058,-0.20118600073948364,0.802185877429069,0.8501811921277477,0.885463511578037,-0.15639152002538148,18.254400500726337,31.898866230322593,28.039012479782105,24.179158729241617,25.28360707419259,1.7349793902819854,26.632535696029663,1.9231033598861005,25.68718664534506,26.964987831801366,-13.700882900105865,-19.822533773691053,913982000,0.5931887876778723,1.9607894456820592,-6189183000.0,-74.07098880896037,44.757923903640624,51.57585752245338,-190.42955773350064,10.91317250101805,44.241248003856924,-0.15742049366576388,1.5290363140026388,28.207120429992678,26.80844044113159,25.678000450134277,24.547560459136964,23.148880470275877,0.16,0.0,28.482074982167287,-0.13250693486684562,-0.12052687297728101,25.016977310180664,26.45423766544887,2.289515353226121
2022-01-25,1,22.45324993133545,22.492499828338623,30.74399995803833,26.53237473964691,29.67174994945526,-0.6183239272095196,2.2339818112386967,-0.3677263838122631,2.992410592196388,27.773499965667725,1.7828425765037537,0.08071450666721686,24.674150037765504,30.13050022125244,0.7811414659563859,-0.2584808609057366,0.811243396059065,0.8657943148548688,0.9139225782906523,-0.141129004971991,13.597240064208513,32.14553861465726,27.67757499217987,23.20961136970248,24.56507137843541,1.7136928581415047,26.122339214597428,2.0213921987267494,24.89084336452894,26.387779977555493,-19.862116848987117,-25.29394307060416,664616000,0.5857222823068475,1.3869973898948633,-6853799000.0,-83.16136330697756,44.757923903640624,51.57585752245338,-166.57507758989672,10.159631023269961,41.18644286858246,-0.20868488856981116,1.5170467911545698,27.40339239501953,26.158304412841797,25.152000427246094,24.14569644165039,22.900608459472657,0.16,0.0,28.273432727075598,-0.1381692980976058,-0.17140529145725936,24.410606111798966,25.95741558074951,2.4267116319963207
2022-01-26,1,23.092249393463135,22.45324993133545,30.74399995803833,26.028375148773193,29.599875450134277,-0.5648144796483191,2.4181735231606543,-0.5941506078797634,2.991725707390436,27.613875150680542,1.9539700889587401,0.08863106887451526,23.6168251991272,30.053099966049196,0.8080695381545032,-0.2696705060505694,0.8463787759053799,0.9055189296162891,0.9690370341799244,-0.1009528983220972,12.265688233020992,32.11993454975453,27.28358750343323,22.447240457111924,24.055071353912354,1.5039285970345349,25.744964156832015,2.0611663293277513,24.284697631352827,25.876280546894534,-18.301313199445318,-24.134175489990607,755959000,0.5604834518845174,1.5242814468151173,-6097840000.0,-75.55470146536962,44.757923903640624,51.57585752245338,-127.07240108936472,14.789019823183018,37.60540569837748,-0.21443868401726116,1.5352771867700041,26.77614759063721,25.650925762176513,24.74149990081787,23.83207403945923,22.706852210998534,0.16,0.0,28.076313207154268,-0.0915545802018558,-0.12087387361343996,23.815789358956472,25.612792696271622,2.4909030632226967
2022-01-27,1,22.7955002784729,22.45324993133545,30.1080002784729,25.458374857902527,28.680625319480896,-0.46624010487927015,2.4455741679949305,-0.9084218155436932,2.9915289428245897,27.496999979019165,2.028775124549866,0.09091015836768508,23.032274436950683,29.871950387954712,0.8582437737009835,-0.2314623940415208,0.8473848667144069,0.9096441473630084,0.9778650191583952,-0.08000120009141942,20.695540696059624,31.79214831119433,26.900999975204467,22.009851639214602,23.57689278466361,1.238166669380473,25.385339191981725,2.108035645610828,23.988170310422213,25.50455426344746,-13.389718534219659,-18.619057888220485,573353000,0.6053795056007552,1.129859345219046,-6671193000.0,-86.2981715732993,44.757923903640624,51.57585752245338,-123.78505563081018,13.161717237927267,36.431802992659534,-0.255484054747283,1.5946266537111669,26.77614759063721,25.650925762176513,24.74149990081787,23.83207403945923,22.706852210998534,0.16,0.0,27.92240784939114,-0.09134572831211585,-0.12458608410434162,23.251070295061385,25.16817787715367,2.5879185155152404
2022-01-28,1,22.25149965286255,22.45324993133545,30.1080002784729,24.518750071525574,28.144312381744385,-0.32718492403874394,2.4894302550824308,-1.1279702065851651,2.9912750277673315,27.128249645233154,2.112640018463135,0.09380474748521106,22.765200233459474,29.635599851608276,0.860616987351927,-0.23639561365087847,0.8384634604012707,0.9070166658660624,0.9710430357592672,-0.06276919655789115,19.920668706653508,31.517285502726203,26.53842499256134,21.559564482396475,23.086357048579625,0.8967962119943454,24.994964156832015,2.148730601174149,23.691769749739215,25.157353616556385,-12.803740811658905,-18.09092461099141,543774000,0.6042841563531001,1.0473290964361182,-7214967000.0,-74.6723762568098,44.757923903640624,51.57585752245338,-114.33465831180742,12.189232511488523,35.53273688580641,-0.17178479269741176,1.5921694153790333,26.77614759063721,25.650925762176513,24.74149990081787,23.83207403945923,22.706852210998534,0.16,0.0,27.77883575705905,-0.022845804650460155,-0.05424416165018191,22.933407102312362,24.853866713387625,2.5841058380481394
2022-01-31,1,23.807250022888184,22.25149965286255,30.1080002784729,23.57937502861023,27.88949978351593,-0.21068746159998042,2.534276346973682,-1.2556539824641417,2.990994166179701,26.71787452697754,2.1992875170707697,0.09688202541254887,22.488574838638307,29.59755058288574,0.8560357293927554,-0.24855208910763923,0.9101196104657919,0.9915772887428501,1.0526263525502864,0.05845282670150742,18.470856298155756,31.226927647217327,26.15837495326996,21.08982225932259,22.947714192526682,0.6258040557313043,24.783089194978988,2.1056803120981056,23.334553098124665,24.796003021497512,-13.368568258422174,-19.718222603706092,564680000,0.6046299286631335,1.0572389639402653,-6650287000.0,-53.3151664556052,44.757923903640624,51.57585752245338,-56.025752889077175,18.98553502877332,32.74840818166967,-0.09655742830057035,1.5979335182889194,26.77614759063721,25.650925762176513,24.74149990081787,23.83207403945923,22.706852210998534,0.02,1.0,27.681093311535392,0.0476640271243578,0.04757421206871303,22.981334958757675,24.646037374223983,2.476338286462896
2022-02-01,1,24.694250106811523,22.25149965286255,30.1080002784729,23.57937502861023,27.74512505531311,-0.05915745750387185,2.4532670422927865,-1.279825796682385,2.9912151817222803,26.40249991416931,2.1716463017463687,0.09483731384488688,22.488574838638307,28.49755024909973,0.857961603300555,-0.20927162871357244,0.9546194145073899,1.0408985073527999,1.0792965134294998,0.09980738567153091,33.81111441684803,30.774696549681092,25.86816246509552,20.961628380509946,23.083785602024623,0.8794004351755192,24.58189276286534,1.9540931126513,23.4519064316275,24.70425680483952,-3.916820501348775,-11.07905026453434,518925000,0.7211614493183982,0.9601239349456249,-6131362000.0,-51.3429275764245,44.757923903640624,51.57585752245338,-32.96024323267404,20.876530415476047,30.794359837349024,-0.07626515291960832,1.5722978631577265,26.77614759063721,25.650925762176513,24.74149990081787,23.83207403945923,22.706852210998534,0.04,0.0,27.60827868097106,0.10365542482246304,0.05416755685766349,23.16163444519043,24.419308253696986,2.2643714882628734
2022-02-02,0,25.351500034332275,22.25149965286255,29.59600067138672,23.57937502861023,27.562437653541565,-0.05111343772843125,2.2617116815713816,-1.3432247389423972,2.9918144876152803,25.914000034332275,2.0271275138854983,0.08835682759388587,22.488574838638307,28.098074817657473,0.8568057160628594,-0.16562205883831413,0.9903906567894661,1.0751671282229336,1.086734273952086,0.09783588434259172,41.83956510251295,30.12089831965522,25.59747495651245,21.07405159336968,23.49221420288086,1.1736895656200776,24.387910638536727,1.6997287918223023,23.756788274002442,24.73706393313718,4.011919327109052,-10.23863194205074,543419000,0.7688298037744725,1.0039325474765992,-5587943000.0,-42.65014970879768,44.757923903640624,51.57585752245338,-5.013272923905689,22.83915907537901,28.922519212946955,-0.06617705080691334,1.549327676995295,26.68828776550293,25.57985590362549,24.68400001525879,23.78814412689209,22.67971226501465,0.06,0.0,27.550982269966877,0.10846653896597713,0.1307115103688199,23.428375516619003,24.22267641339983,2.081464084717561
2022-02-03,1,24.315750122070312,22.25149965286255,28.375500202178955,23.57937502861023,27.489999890327454,-0.11973149491392371,2.0673449288648222,-1.4388599095062902,2.992399533749168,25.518374919891357,1.8394999742507943,0.0814388251051475,22.488574838638307,27.853949785232544,0.8807851527332584,-0.1065708144808128,0.957869242738852,1.0327022997051747,1.0225294408144285,0.06669078655988403,48.478998876282546,29.519939782389372,25.38524992465973,21.250560066930085,23.758285658700125,1.1081884387073313,24.161678518567765,1.448264482801365,24.151255449573398,24.838922764063874,12.710904647386313,-9.675866935228006,410178000,0.7593811855936461,0.7639802900393847,-5998121000.0,-51.497868782032896,44.757923903640624,51.57585752245338,-33.79469481417449,21.231605362745153,30.608273100272413,-0.05213609388291809,1.542841157955365,25.708076499938965,24.78696249771118,24.042500495910645,23.29803849411011,22.376924491882324,0.06,0.0,27.492977735656837,0.09132321951368993,0.051642192565202805,23.660026005336217,24.03531605856759,2.0278988444185573
2022-02-04,1,24.1395001411438,22.25149965286255,28.06724977493286,23.57937502861023,26.95087456703186,-0.014264237051460653,1.9603119097218922,-1.4055866671640542,2.992696320881306,25.064625024795532,1.7400874614715576,0.07784494804224022,22.488574838638307,27.728100109100343,0.8700435130231758,-0.12628343946905593,0.958591398100306,1.0272324440729002,1.0023023600008691,0.0848482357474889,43.00771184012618,29.10288624009808,25.182262420654297,21.261638601210514,23.90789290836879,1.073431690502286,23.981482131140574,1.257597102745264,24.192606932763855,24.780453879992038,8.295013846238728,-11.524395817144097,354829000,0.7801221030811868,0.6670618327811911,-6352950000.0,-40.33043902853261,44.757923903640624,51.57585752245338,-31.453642799522893,20.182087451128883,29.824655768159662,-0.06680939545997099,1.502856868693816,25.28100048828125,24.44150048828125,23.76300048828125,23.08450048828125,22.24500048828125,0.06,0.0,27.443329958147558,0.06475463472207732,0.10822998754836516,23.880692890712194,23.848241124834335,1.9006812233098183
2022-02-07,1,24.620999813079834,22.25149965286255,28.06724977493286,23.57937502861023,26.690062046051025,0.1303881681228747,1.8741783546837731,-1.2930152285362435,2.9929264230005277,24.736000061035156,1.641372458934784,0.07497395700219603,22.488574838638307,27.531575155258178,0.8550826968785994,-0.12906455428957916,0.9849296235460926,1.0459518216495884,1.0065142673153273,0.034180755417333675,42.16444203585666,28.746081647760185,24.99772493839264,21.249368229025094,24.168678556169784,0.9754121847416262,23.872785670416697,1.1139897177261424,24.18127726888368,24.709247105232855,4.535074647068015,-9.461877617710806,376868000,0.7799453335313631,0.7107034062442925,-5976082000.0,-32.09547335984846,44.757923903640624,51.57585752245338,-5.129401529550732,21.943908250936165,28.350067966633386,-0.03651411782712132,1.4642323985945809,25.20841955566406,24.382789733886717,23.715499877929688,23.048210021972658,22.222580200195313,0.06,0.0,27.40021570912679,0.009883151390179368,0.08266182720589219,24.277808053152903,23.764439174107142,1.8202185780375848
2022-02-08,1,24.669249534606934,22.25149965286255,28.06724977493286,23.57937502861023,26.27262508869171,0.23627795982323524,1.768057272029651,-1.0876633837747898,2.993209909714556,24.65762495994568,1.4932999515533445,0.07116941294060701,22.488574838638307,27.485799837112427,0.8772408244058884,-0.08039665030149373,0.9930085607735192,1.0386101309419078,1.001821343506448,-0.0010124045920185676,47.32410956079219,28.379051965858007,24.842937421798705,21.306822877739403,24.51407139641898,0.4913410966178835,23.800214222499303,1.0155803956749998,24.29327287715673,24.70912138877189,8.008157365736157,-5.820927158821378,410359000,0.7722065380213514,0.7875487313277941,-5565723000.0,-14.38425208428858,44.757923903640624,51.57585752245338,2.8730953944435735,20.548371044017408,27.676586284430687,-0.05821863282107542,1.4484452152809766,24.653755683898925,23.934121837615965,23.352499961853027,22.77087808609009,22.05124423980713,0.06,0.0,27.355944404882575,0.019076127816561206,0.025402193927610672,24.601319449288503,23.76736327580043,1.7169005800669428
2022-02-09,0,26.101250171661377,22.25149965286255,28.06724977493286,23.57937502861023,25.799624919891357,0.3732117999271459,1.71175691232051,-0.8352034985433305,2.993354805050454,24.645124673843384,1.377895002365112,0.06919621418595955,22.488574838638307,27.485799837112427,0.840212777973248,-0.10329506763258473,1.0551192662930036,1.0887417717767591,1.0601903477292483,0.02957419230868985,46.27417608704014,28.161238748728543,24.737724924087523,21.314211099446503,24.84178570338658,0.6728372488840639,23.89474994795663,1.164286449911373,24.393119601811456,24.681128826311657,10.86555926325331,-3.9555787019361963,524282000,0.7471702180915105,0.994713777078564,-5041441000.0,-0.3426496167493773,44.757923903640624,51.57585752245338,84.002433962896,26.400524878013368,25.42412039196194,-0.03209421156507797,1.4608383239811316,25.347468406677248,24.49526642227173,23.80650043487549,23.117734447479247,22.265532463073733,0.08,0.0,27.33287083796942,0.05795887225704921,0.08389470794319068,24.91784177507673,23.9495883669172,1.6257297478911248
2022-02-10,0,26.085999965667725,22.25149965286255,28.06724977493286,23.57937502861023,25.789249897003174,0.34850288245396377,1.6228217766157533,-0.6724968267189793,2.993581219930978,24.645124673843384,1.2962124824523926,0.06578854975388843,22.488574838638307,26.744324588775637,0.7494853367377801,-0.07004603653854743,1.05751606944797,1.0746178879340555,1.053156421604399,0.07280260056590393,55.616357509593385,27.91288097808197,24.667237424850462,21.421593871618956,25.040607111794607,0.8130039454632514,24.062196356909617,1.301122288292814,24.824445519604602,24.7902402331629,9.63572082692353,5.34148643677308,513200000,0.813369053765498,0.9618456340838959,-5554641000.0,-18.237536199190806,44.757923903640624,51.57585752245338,88.57679975469459,25.64293629847188,23.720548595649195,-0.05607300347762651,1.4508715652680744,25.500267532348634,24.618865715026857,23.9064998626709,23.19413401031494,22.312732192993163,0.1,0.0,27.308283988149675,0.07833641241736178,0.023056654588196474,25.087014607020787,24.124324526105607,1.4518755243660155
2022-02-11,1,24.947500228881836,22.25149965286255,27.482999801635742,23.57937502861023,25.78543734550476,0.09726127113364647,1.4650519785888823,-0.9035679283496356,2.993955529368764,24.645124673843384,1.2024324798583983,0.05963210464356881,22.488574838638307,26.19470019340515,0.7294030540896449,-0.05083141745992628,1.0154397017893135,1.0139724888396784,0.9929985711777235,0.033472113466047615,56.66165938513644,27.498278891564972,24.56817493438721,21.638070977209445,24.982892853873118,0.8015142362452246,24.23755352837699,1.2371575220247344,25.14222131266501,24.83732463718893,5.635926796061358,9.873954959563314,605472000,0.8055535074635207,1.1278809796755949,-6160113000.0,-52.86907062408491,44.757923903640624,51.57585752245338,12.637334820166139,22.701660803041406,29.80847753703501,-0.057379333246911156,1.518837749323852,25.59655530548096,24.77472134780884,24.110499382019043,23.446277416229247,22.624443458557128,0.1,0.0,27.245785239255174,-0.015214489783799579,4.179715981917783e-05,24.90257808140346,24.16547679901123,1.3723876802973833
2022-02-14,1,24.207749843597412,22.25149965286255,26.66224956512451,23.57937502861023,25.434937477111816,-0.12325322615972692,1.3086976688197547,-1.041669374027992,2.9942942705856823,24.645124673843384,1.0883349990844728,0.053544300702460426,22.488574838638307,26.105400180816652,0.7337084584522372,-0.0643137531232792,0.9904403956984823,0.9732414074057535,0.9573956851247788,-0.016784451184751803,49.32815921964359,27.058795293389018,24.44139995574951,21.824004618110003,24.967464242662704,0.8173790830960249,24.362874950681412,1.1264148728361552,25.09328098496578,24.760225322431257,-1.5935932978455816,10.91475122498444,440424000,0.823980182618805,0.8170340460534249,-6600537000.0,-47.21974019531609,44.757923903640624,51.57585752245338,-1.1141966642117356e-05,21.454031660020036,28.258607003284787,-0.07838746938816983,1.489683696256217,25.59655530548096,24.77472134780884,24.110499382019043,23.446277416229247,22.624443458557128,0.1,0.0,27.196696641179503,-0.018642777206174355,-0.0021381740695672704,24.948081425258092,24.304053715297155,1.2334544423054248
2022-02-15,0,25.69325017929077,22.25149965286255,26.14275026321411,23.57937502861023,25.048500180244446,-0.16401970730934642,1.205715196694144,-0.9864149989422488,2.9944988381941684,24.468374967575073,0.9889750242233276,0.04957980639149719,22.488574838638307,26.08752498626709,0.7133001610509184,-0.07401671209549325,1.0565234418130014,1.0313034738659408,1.0194783514792625,0.04150919318592705,45.21097139184711,26.730105363061448,24.318674969673157,21.907244576284867,25.189428533826554,0.7643096056177533,24.548660721097672,1.1151652537800179,24.868529549579023,24.611456291831153,-0.44415770819619255,7.814013194648525,699869000,0.8314529483792763,1.2659701502526581,-5900668000.0,-7.638984188556789,44.757923903640624,51.57585752245338,116.59079477571822,27.02565055840102,25.22238163371493,0.009883694830435413,1.5472117601013275,25.59655530548096,24.77472134780884,24.110499382019043,23.446277416229247,22.624443458557128,0.1,0.0,27.16432234816371,0.0552414958129932,0.07145756758153511,25.258470807756698,24.569581849234446,1.2812898426401833
2022-02-16,0,26.22600030899048,22.25149965286255,26.101250171661377,23.57937502861023,25.048500180244446,-0.22663319758228168,1.1753103106180174,-0.9858964668119228,2.9945570320390176,24.468374967575073,0.9684550356864928,0.04837424421465258,22.488574838638307,25.732525157928468,0.6523222964502494,0.0003114773615569175,1.0794280729601988,1.048483267600536,1.03222912560687,0.004779469814995441,55.76677402305613,26.646820586713027,24.29619996547699,21.945579344240954,25.41871431895665,0.8050239204619012,24.793696437563217,1.0765335246061594,25.07083048313672,24.673502063505374,6.436546030622784,11.263522844872435,732676000,0.8982272561730746,1.2966564740619506,-5167992000.0,-7.3547624590126714,44.757923903640624,51.57585752245338,129.17564254779543,25.860614892136653,23.96840103066895,0.10790505842783664,1.5095261401182,25.59655530548096,24.77472134780884,24.110499382019043,23.446277416229247,22.624443458557128,0.1,0.0,27.139366611143497,-0.007264508792296009,0.05587866886143301,25.512801579066686,24.895304816109793,1.3657505013689513
2022-02-17,0,25.02174997329712,22.25149965286255,26.22600030899048,23.57937502861023,25.048500180244446,-0.14688871380574842,1.2125826956839063,-0.9775743808620048,2.9944855356876574,24.468374967575073,0.9935375452041626,0.049852849405833885,22.488574838638307,26.08752498626709,0.6834647527967367,0.05844962891464394,1.0287179074295323,0.9968536742462732,0.9838648743009925,-0.04079774567857408,60.3078821475387,26.748402882021804,24.32323749065399,21.89807209928618,25.469071524483816,0.7601001432706197,24.9915714604514,0.7896980027574734,25.3558410812477,24.80474897336912,6.518827456625026,15.04902278348853,810595000,0.8789740154146378,1.3884309383237223,-5978587000.0,-62.432217208296905,44.757923903640624,51.57585752245338,32.71406249169468,23.04971583470993,27.78938316706174,0.09801997503630791,1.570386848854739,26.01097142791748,25.44551354598999,24.988499641418457,24.531485736846925,23.96602785491943,0.1,0.0,27.0737891484155,-0.05099905169238139,-0.08230673154114267,25.427073614937918,25.01419653211321,1.3653358546501313
2022-02-18,0,24.098999977111816,22.25149965286255,26.22600030899048,23.57937502861023,25.104187488555908,-0.16804265447717665,1.218308194420658,-1.004761326001185,2.9944745445528085,24.468374967575073,1.005737543106079,0.05006313097899247,22.488574838638307,26.08752498626709,0.7306746335945993,0.053913452884239405,0.9902842300839967,0.9573989435110242,0.9555795622409433,-0.034011433770334554,53.39993944022065,26.77205387739723,24.335437488555907,21.898821099714585,25.18303578240531,0.8535459809471607,25.012410742895945,0.7593055981501898,25.264742918144734,24.743732832633597,1.4289062105261245,12.449724124900458,761255000,0.8909011955829925,1.299212413647742,-6739842000.0,-85.8300659070182,44.757923903640624,51.57585752245338,-29.1754170407582,21.06722054689329,30.256082516953082,0.12266291753500176,1.593319940966688,26.022299507141113,25.463849674224853,25.012499809265137,24.56114994430542,24.00270011138916,0.02,1.0,26.991971534295455,-0.012818988134649212,-0.08449509646551992,24.99016080583845,24.95400129045759,1.3563833482664882
2022-02-22,0,23.372249603271484,22.25149965286255,26.22600030899048,23.62849986553192,25.104187488555908,-0.2093582233024913,1.2120757796283983,-0.955173520244204,2.9944883609454402,24.468374967575073,0.9878750562667846,0.049770494382814286,22.488574838638307,26.08752498626709,0.6939559423109473,0.07142381509542753,0.9597159164008615,0.9286762116131264,0.9330406953655583,-0.03451375058499728,49.44130057129367,26.777451534652,24.353299975395203,21.929148416138407,24.795357159205846,0.9817317790205193,24.91798213550023,0.8752649091307532,24.966166638579086,24.604917895074255,-7.6710892443130625,1.2254668386443026,633422000,0.8681993629988713,1.1075597419339045,-7373264000.0,-90.06370788646282,44.757923903640624,51.57585752245338,-64.24595233022018,20.021014951430928,29.220289575119963,0.03149685940395953,1.554905765968574,25.998699417114256,25.425649528503417,24.962499618530273,24.49934970855713,23.926299819946287,0.04,0.0,26.918106269025458,-0.03613976519503892,-0.02334130237856563,24.64297022138323,24.86499241420201,1.355686467833682
2022-02-23,0,23.161250114440918,22.25149965286255,26.22600030899048,23.69849991798401,25.104187488555908,-0.17689140033825634,1.1585279144947127,-0.8389384715974209,2.9946007317551397,24.468374967575073,0.9438875675201416,0.047485931220733885,22.761275243759155,26.08752498626709,0.6309367189173538,0.040929472336808215,0.9493370994001851,0.9248814065025124,0.9308267516514295,-0.09854728565600823,45.24406110928208,26.71434329313127,24.397287464141847,22.080231635152423,24.540178571428573,1.1528319662258275,24.761535712650844,0.9811557335462109,24.56392185323378,24.464850214768312,-10.403091182886829,-5.353474990420486,566511000,0.8867338465094065,0.9991331607885326,-7939775000.0,-98.14016954123385,44.757923903640624,51.57585752245338,-107.40481066282067,18.314327786175237,29.943330904723293,0.004781690362298243,1.57658701006453,25.833735557556153,25.158631755828857,24.61299991607666,24.067368076324463,23.392264274597167,0.06,0.0,26.844702846327475,-0.15504830898718036,-0.0774716254707769,24.420163290841238,24.66137068612235,1.3507321791529319
2022-02-24,1,22.3632493019104,22.25149965286255,26.22600030899048,23.69849991798401,25.104187488555908,-0.09741556260409345,1.10831362351099,-0.8094951821360339,2.99470112505538,24.468374967575073,0.9084875583648682,0.04536192036681532,23.062574481964113,26.08752498626709,0.6329733753363318,0.0029880467598498942,0.9153004280168344,0.8984255439187949,0.9174271182619845,-0.14728708005680513,42.951918771645005,26.649314720319097,24.43268747329712,22.21606022627514,24.276678494044713,1.421068577048096,24.62207136835371,1.169990602318196,24.214683808293998,24.34582608828036,-7.160036468796052,-8.639527905351601,735801000,0.8771977455474427,1.3000141697464958,-8675576000.0,-52.64291841098737,44.757923903640624,51.57585752245338,-115.00279128245168,16.00775966131868,32.27891106480233,0.09836900958518942,1.673143190875687,25.50073927307129,24.61962929534912,23.907499313354492,23.195369331359867,22.3142593536377,0.08,0.0,26.750155536125007,-0.10422096391783964,-0.1036800770578994,24.34613173348563,24.64710657937186,1.3064215417419274
2022-02-25,0,23.86899995803833,22.25149965286255,26.22600030899048,23.69849991798401,25.104187488555908,-0.19575886085720642,1.1624631134760879,-0.8066677951856045,2.9945925605123236,24.468374967575073,0.9449375629425049,0.0476492784990547,22.75227518081665,26.08752498626709,0.5954986575700864,-0.018962118456803487,0.9783885727724544,0.9735375933835761,1.011248338862841,-0.04606991982930808,39.08625376968793,26.72116369567166,24.396237468719484,22.071311241767308,24.016071319580078,1.27806684473357,24.602749926703318,1.180756902938074,23.75311528735076,24.085043059913374,-7.61946299678429,-8.02977827275711,528866000,0.8932260845084317,0.9380878114799424,-8146710000.0,-45.86577827727385,44.757923903640624,51.57585752245338,-43.175489111398136,17.27810374535879,31.068339203203173,0.17798680738007622,1.6125827938184516,25.50073927307129,24.61962929534912,23.907499313354492,23.195369331359867,22.3142593536377,0.08,0.0,26.70321832711196,-0.014281680016630549,-0.08879346527155561,24.012634004865372,24.635552406311035,1.171579797337029
2022-02-28,0,24.18725061416626,22.25149965286255,26.22600030899048,23.853562474250793,25.104187488555908,-0.22510056052785635,1.1109547597940201,-0.5542082783354667,2.9946955632406147,24.468374967575073,0.8912625789642334,0.04543798518474612,23.081450033187867,26.08752498626709,0.5480778238245406,0.07269174349638487,0.9892571460515593,0.9955198844692849,1.0348394546043482,0.0036620041137913617,50.029161263894686,26.671821972285795,24.449912452697752,22.22800293310971,23.72482136317662,0.8517100064543427,24.571767841066634,1.1859205251425604,23.784046641257504,24.06530157058026,-7.100114654715114,-1.120570772070062,477319000,0.9459800162479879,0.8516747777445702,-7669391000.0,-42.08780567356433,44.757923903640624,51.57585752245338,-27.6394666239208,18.5824290783517,29.694026531324788,0.14933893489276365,1.5652724265464244,25.50073927307129,24.61962929534912,23.907499313354492,23.195369331359867,22.3142593536377,0.08,0.0,26.667094940381798,0.031427184935118646,-0.004978185605796802,23.709376743861608,24.611089161464147,1.102366896726669
2022-03-01,0,23.819250106811523,22.3632493019104,26.22600030899048,24.041499972343445,25.104187488555908,-0.06703831597571894,0.9933032110063837,-0.40323472836943086,2.9949122021818897,24.468374967575073,0.7944750308990478,0.04046585532782455,23.35114965438843,26.08752498626709,0.6073257873080943,0.015961549146278772,0.9703646561888642,0.9834507167790228,1.0183257458099433,0.01912526655018576,49.64764372651205,26.533306422775706,24.54670000076294,22.560093578750173,23.55303566796439,0.641973559020054,24.511053596224105,1.2021925668680102,23.89008017415681,24.152526424656585,-7.773772862060554,-1.7617042451831961,412056000,0.8829886527022486,0.7453759956064971,-8081447000.0,-57.13338925273027,44.757923903640624,51.57585752245338,-76.40558598766329,17.492520297430488,30.643958413804654,0.08532607474380118,1.5427218620458587,25.50073927307129,24.61962929534912,23.907499313354492,23.195369331359867,22.3142593536377,0.08,0.0,26.629339426732738,0.003719591249221388,-0.0069790069054807375,23.562455586024694,24.494764600481307,1.1315227070416636
2022-03-02,0,23.950000286102295,22.3632493019104,26.22600030899048,24.041499972343445,25.104187488555908,-0.06795173501181534,0.9928598908769075,-0.39940619304389147,2.9949129640040706,24.468374967575073,0.7938750267028809,0.04044680639729532,23.35114965438843,26.08752498626709,0.6266470602521319,-0.03543334971563461,0.9756673964657562,0.9904378406181118,1.0200170471314742,0.03405473226894595,45.87077649275392,26.53301978671292,24.547300004959105,22.56158022320529,23.531749997820175,0.6230452934045503,24.35739289011274,1.117826313522888,23.870731496331793,24.167350905682568,-4.805818409059669,-3.4455828362472056,389642000,0.8623611848862707,0.7131700680595839,-7691805000.0,-44.82187228001335,44.757923903640624,51.57585752245338,-42.373908549459266,16.811443535434506,29.181719855860045,0.09931412662603582,1.5031272908642601,25.50073927307129,24.61962929534912,23.907499313354492,23.195369331359867,22.3142593536377,0.08,0.0,26.598640737910397,0.08206232386278112,0.03566176996028854,23.645491736275808,24.31782627105713,1.1340138730112965
2022-03-03,0,23.942749977111816,22.3632493019104,26.22600030899048,23.929750204086304,25.104187488555908,0.034437583566924515,1.0005721485773227,-0.47551545156352715,2.9948988208806653,24.261749982833862,0.8126712584495543,0.040822871318142766,23.35114965438843,26.08752498626709,0.6310034530455043,-0.0552827148820385,0.9768528963232165,0.9973278496083623,1.0129030860812454,0.07062930139881263,45.64339938705724,26.51123181107829,24.510087513923644,22.508943216768998,23.613250051225936,0.6358848719149734,24.20430360521589,1.0038273445320747,23.887882364785398,24.19102615041257,-0.6182816347194279,-8.241941943051964,365095000,0.847650145585583,0.6793274621840985,-8056900000.0,-50.386496028480245,44.757923903640624,51.57585752245338,-52.467590197518746,16.098212003155734,27.94367490609381,0.08185635364221658,1.4565381977396292,25.238688415527346,24.407656219482423,23.736000061035156,23.064343902587893,22.23331170654297,0.08,0.0,26.56858254219136,-0.001261498718070242,0.05945609202259881,23.692284447806223,24.167627334594727,1.136305835516655
2022-03-04,1,23.120500564575195,22.3632493019104,26.22600030899048,23.924312472343445,24.966062664985657,0.2095841085660454,0.9883714004654873,-0.34012398012537837,2.9949162407890246,24.197500228881836,0.7848800086975096,0.040441307466273065,23.35114965438843,26.08752498626709,0.6687247838694361,-0.015339857626680439,0.9460242087799821,0.9723249005924948,0.9652182603771714,-0.0313586406962586,47.40102950953739,26.416392811993596,24.43965001106262,22.462907210131647,23.607428686959402,0.6408793851354267,24.073803629193986,1.018428872418522,23.900781126203768,24.19088406432135,2.4409305202716873,-8.21609289034992,431415000,0.8167662729244682,0.8011453342984873,-8488315000.0,-64.05479705440035,44.757923903640624,51.57585752245338,-108.75311172612804,15.106032054285038,31.15905855957721,0.10021735868959966,1.4403588049890912,25.238688415527346,24.407656219482423,23.736000061035156,23.064343902587893,22.23331170654297,0.08,0.0,26.523694205787635,-0.050382456381184215,-0.03402772739272515,23.77115276881627,24.09565802982875,1.1821789779454557
2022-03-07,1,22.132999897003174,22.3632493019104,26.22600030899048,23.85656249523163,24.966062664985657,0.25476217624606845,1.0293428367070743,-0.5652080966738535,2.9948435216982032,24.16337537765503,0.8326899909973143,0.04222098380502576,23.157175159454347,26.08752498626709,0.6467538817813003,-0.04221295265479844,0.9078384741059183,0.9382981861782399,0.9298036506123276,-0.0849311378929497,41.90022096639223,26.438573206602015,24.379887533187866,22.321201859773716,23.5745359148298,0.7167917748565081,23.925607204437256,1.1410141508077833,23.709948263493388,24.124571931766727,-0.1759384733741791,-7.323377683313996,450821000,0.8358020994325701,0.8297867797637168,-8939136000.0,-91.88334883696005,44.757923903640624,51.57585752245338,-170.63556395928163,13.836542463164447,34.22531210559954,0.046835772307281295,1.4592719875990208,25.238688415527346,24.407656219482423,23.736000061035156,23.064343902587893,22.23331170654297,0.08,0.0,26.463224720609006,-0.12423048487071342,-0.11596471905911587,23.429901668003627,23.88801670074463,1.3667377523249062
2022-03-08,1,21.46149969100952,22.132999897003174,26.22600030899048,23.707499980926514,24.966062664985657,0.06981070419262474,1.139744473544452,-0.6470225764216235,2.9946307205381992,24.143125295639038,0.9129500007629396,0.04694254571348055,23.044775438308715,26.08752498626709,0.638284029340107,-0.10105194488303913,0.8839327179995057,0.9174776536340921,0.9174286237575208,-0.0989850816137895,35.11257269186977,26.55905146806974,24.279562520980836,22.00007357389193,23.230607305254257,1.051423438491331,23.623339312417166,1.1959230310968088,23.316673764109325,23.893390292937617,-1.0295883294900143,-8.570602224489603,557467000,0.85053874493755,1.0093054417819434,-9496603000.0,-85.43492653075792,44.757923903640624,51.57585752245338,-169.4047071002135,12.675865635932569,34.6649329262407,0.0437099424031373,1.4782522702988417,25.182048469543457,24.31597630691528,23.616000175476074,22.916024044036867,22.049951881408692,0.1,0.0,26.384349452947216,-0.08345759253126683,-0.11758593823072909,23.053422110421316,23.533028057643346,1.493120921746629
2022-03-09,1,22.716999530792236,21.46149969100952,26.22600030899048,23.319499731063843,24.966062664985657,-0.10443746973648482,1.290467472229818,-0.5727372159898865,2.9942968817503663,24.024500131607056,1.0045713186264038,0.053498447041841854,22.34022436141968,26.08752498626709,0.6713023685589148,-0.1300302969937315,0.9417704998388359,0.979148303483016,0.9910760593578511,-0.05148228561924251,31.757704324404052,26.702522459336958,24.12158751487732,21.54065257041768,23.02057143620082,0.9723484066537134,23.37269639968872,0.95115783745832,22.852170921433242,23.579485332911116,-10.086305548038002,-16.470280944417528,492742000,0.8577119960355667,0.8855154987945831,-9003861000.0,-53.9629948380871,44.757923903640624,51.57585752245338,-76.65198373801451,15.711396509328658,31.81885574966537,0.03923884100508405,1.4946342061707694,24.573139793395995,23.82342975997925,23.21749973297119,22.611569705963134,21.861859672546387,0.1,0.0,26.334951219769806,-0.04979367241029897,-0.019554489482244752,22.858419145856583,23.283897944859095,1.4931324762679539
2022-03-10,1,22.464750289916992,21.46149969100952,26.22600030899048,23.151062726974487,24.966062664985657,0.06063167255405801,1.3188725421923164,-0.7272980747307134,2.9942253112378285,23.946375131607056,1.0353976130485534,0.054898181561796065,22.34022436141968,26.08752498626709,0.7115684490121693,-0.12965856495806802,0.9350971384287409,0.9701334751352629,0.9907298740323196,-0.06173057349751909,39.83981772112374,26.661720099071218,24.023975014686584,21.38622993030195,22.82707146235875,0.9203008921146101,23.19005356516157,0.8502979926708243,22.821932119891308,23.48127692680927,-6.078620124409305,-13.379854864850776,428066000,0.8411190862008274,0.7759940119901595,-9431927000.0,-53.69001101036249,44.757923903640624,51.57585752245338,-93.98548872919518,14.840707343876808,31.842405003176438,0.021111044958712317,1.468562870351289,23.962703956604003,23.32964789199829,22.817999839782715,22.306351787567138,21.673295722961427,0.1,0.0,26.288556052148767,-0.04453062110418071,-0.06449209820136595,22.742146355765207,23.15230097089495,1.3788318948377898
2022-03-11,1,22.57824993133545,21.46149969100952,26.22600030899048,23.019625306129456,24.392687439918518,0.18895327160194259,1.2697125412082115,-0.6140717607373456,2.994317398220936,23.905874967575073,0.9966601085662841,0.053254951424732806,22.34022436141968,25.732525157928468,0.6737249631848788,-0.13881966114071637,0.946988837492763,0.9746077241753155,1.0088876547676089,-0.023453239333000142,38.491976900878065,26.381575103015788,23.842150020599366,21.302724938182944,22.631107125963485,0.7760853964283961,23.08142856189183,0.8219121897834953,22.733978523623204,23.312325610551554,-5.686576239052919,-10.21910812037097,367209000,0.8403682806132756,0.674599693590073,-9064718000.0,-63.885422303002784,44.757923903640624,51.57585752245338,-86.06246044871916,15.806991661466116,30.09847453717139,0.022180285381486694,1.4420058406162544,23.717460609436035,23.13127042007446,22.65750026702881,22.183730113983152,21.597539924621582,0.02,1.0,26.24950435805129,-0.03644923425789515,-0.06806103723677359,22.439693995884486,23.04259286608015,1.3432354813748522
2022-03-14,1,21.65499973297119,21.46149969100952,26.22600030899048,22.68231213092804,24.192375421524048,0.2796618559662212,1.1872397418069875,-0.418672466333498,2.9944785622773695,23.844125032424927,0.9629113745689392,0.050164856340605815,22.34022436141968,25.088899993896487,0.7224234711323453,-0.09496944687081292,0.914996282896469,0.9399921931128321,0.9723450718789803,-0.02159671830553367,41.1513679538657,26.041242002496727,23.666762518882752,21.292283035268778,22.304285662514822,0.5914028584908817,22.958767856870377,0.8996366217863401,22.69659102348024,23.173004321621526,-5.727558824134315,-6.3104280145263685,385354000,0.8120669156815173,0.7225429272012979,-9450072000.0,-83.06350970087178,44.757923903640624,51.57585752245338,-127.95449966411108,14.923589928688589,32.910617713548774,0.04607715774515659,1.4176550326487767,23.717460609436035,23.13127042007446,22.65750026702881,22.183730113983152,21.597539924621582,0.02,0.0,26.20046552532744,-0.0010302656409092448,-0.07002087766812302,22.09957776750837,22.895931107657297,1.433770188595257
2022-03-15,1,22.21274995803833,21.46149969100952,26.22600030899048,22.549875020980835,24.121062636375427,0.3813381456678748,1.2258800214479553,-0.32967316114434464,2.9943793378513264,23.595749855041504,0.999462628364563,0.052160362935344415,22.085199880599976,25.088899993896487,0.7165255987883327,-0.10545177173091885,0.9451374354195111,0.9749190209572653,1.001688821486589,0.035004555965094886,36.73902768376324,25.95389753698313,23.50213749408722,21.050377451191306,22.174607004438126,0.469574308019452,22.891017845698766,0.9187274397407265,22.439836333895464,22.976539255686212,-9.555085553362126,-7.347388032600526,491996000,0.8203729902076278,0.9180591065066382,-8958076000.0,-42.1419874518829,44.757923903640624,51.57585752245338,-63.319185416644224,17.51762908611514,30.092885553798627,0.09180294525371274,1.439076464730232,23.717460609436035,23.13127042007446,22.65750026702881,22.183730113983152,21.597539924621582,0.02,0.0,26.150730298277942,0.06781628807483209,0.07591791185423574,22.10485621861049,22.93800449371338,1.4260875070342365
2022-03-16,1,23.941250324249268,21.46149969100952,26.22600030899048,22.439375042915344,23.987250208854675,0.5398883330880948,1.24541693305641,-0.3066022177846288,2.9943280478424548,23.2667498588562,1.0186763882637024,0.05321751607892829,22.085199880599976,25.088899993896487,0.711522679625968,-0.1354636021898774,1.0230259764925436,1.0582446317746654,1.0723700174777178,0.05389139493521555,38.59562632118558,25.89322136592208,23.402387499809265,20.91155363369645,22.432928494044713,0.8139602476583201,23.003732204437256,0.9454086076641642,22.389734169875137,22.92155816585576,-3.9261719442515184,-4.095202770644936,671422000,0.7468178734631088,1.2562001098250377,-8286654000.0,-4.209229664178484,44.757923903640624,51.57585752245338,57.053352013290485,23.816200744056562,27.677716150853417,0.08420029449250431,1.4523492520607053,23.717460609436035,23.13127042007446,22.65750026702881,22.183730113983152,21.597539924621582,0.04,0.0,26.114124339596945,0.06439569913032872,0.1386074186232772,22.553398949759348,22.991650308881486,1.2609108171887564
2022-03-17,1,24.40850019454956,21.46149969100952,26.22600030899048,22.439375042915344,23.944562554359436,0.5362589975962295,1.1382028135528326,0.1723412299998115,2.994549587558954,23.2667498588562,0.9280626058578492,0.04881892289210477,22.085199880599976,24.270700550079347,0.5599000077920734,-0.08711774414026757,1.0469106864971989,1.0789396128292652,1.081438527602306,0.08652443848908464,51.261610248336424,25.591193134162854,23.31478750705719,21.038381879951526,22.853928565979004,0.9741414946074708,23.04226793561663,0.9931791009499337,22.773843226673513,23.068653248608804,8.169929226317542,7.056224258985768,471941000,0.8480232166514641,0.905055568633411,-7814713000.0,-1.8129369396424098,44.757923903640624,51.57585752245338,103.37668485038292,23.928134185866423,26.364382056365333,0.06364143173690057,1.4153014010285054,23.852687187194828,23.240655269622806,22.745999336242676,22.25134340286255,21.639311485290527,0.06,0.0,26.09429233435044,0.09303535473290347,0.07612755420361528,23.017349243164062,23.03538567679269,1.0767540757893945
2022-03-18,1,25.611249923706055,21.46149969100952,25.02174997329712,22.439375042915344,23.944562554359436,-0.14092841606783263,0.9608848793412652,-0.9904405454009493,2.994874178454623,23.2667498588562,0.8371876001358032,0.041374806216912155,22.085199880599976,24.20937557220459,0.5304331975900072,-0.024508668634368524,1.102796521569467,1.1297793226849921,1.1155138536146365,0.13433282037334648,56.40249560170856,25.145682260017672,23.223912501335143,21.302142742652613,23.267392907823837,1.4189850882677146,23.14398217201233,1.175621065449752,23.174571478609025,23.19229741073374,13.731568371126333,2.260254880638783,730719000,0.8171444329380367,1.412137593547818,-7083994000.0,-1.9598093747191057,44.757923903640624,51.57585752245338,197.37333128363974,30.154675441669344,23.833553945850035,0.1715719470945244,1.4532947695475413,25.17211609649658,24.30794200515747,23.60949993133545,22.911057857513427,22.046883766174318,0.08,0.0,26.09031789030341,0.19696827102607872,0.16749044354478088,23.507978984287806,23.183199065072195,1.2681767841340412
2022-03-21,1,26.589999675750736,21.46149969100952,25.611249923706055,22.439375042915344,23.944562554359436,0.16105064977803843,1.0226382525120725,-0.4497537277279222,2.994766741713317,23.2667498588562,0.86666259765625,0.043978033418245036,22.085199880599976,24.20937557220459,0.5320211817255863,0.06275156429853967,1.1434892949278619,1.160206940813838,1.1283324165630635,0.22789194198260265,64.73818251605105,25.298664003879736,23.25338749885559,21.208110993831447,23.856714248657227,1.8278172386400529,23.341892855507986,1.489393073994062,23.77909908961924,23.48872829538526,12.74046068007681,5.887396348825902,591727000,0.83291956712106,1.1625751958010886,-6492267000.0,-6.428808411811296,44.757923903640624,51.57585752245338,210.4513490968439,31.283044938280163,22.421370219917975,0.2233493695475209,1.4340567718076893,25.617528236389163,24.668236118316653,23.901000022888184,23.133763927459718,22.184471809387208,0.1,0.0,26.09819334958568,0.25335188374984763,0.2096831077965844,24.089486258370535,23.41581630706787,1.4781739246085899
2022-03-22,1,26.640250205993652,21.46149969100952,26.589999675750736,22.439375042915344,23.944562554359436,0.733879253352912,1.245460683657061,0.3704551278174488,2.9943295036339372,23.2667498588562,0.9917813706398013,0.05327504552190631,22.085199880599976,24.528775167465213,0.6124081625849493,0.13767395638410662,1.1395466441155688,1.1402252091087082,1.0850210338734987,0.19932247273837,70.44767289083835,25.86885885110166,23.377937483787537,20.887016116473415,24.437000002179825,1.9917318959534218,23.534053564071655,1.7282761244114464,24.478960848556966,23.890768131096994,18.36321050799887,11.632396303470818,547007000,0.8330840073241826,1.0839145180862793,-5945260000.0,-10.837895663301495,44.757923903640624,51.57585752245338,173.14115968548694,29.87066162904949,21.09677557559381,0.22983489614058294,1.4148410806819398,25.68323257446289,24.721384391784667,23.944000244140625,23.166616096496583,22.20476791381836,0.12000000000000001,0.0,26.10518100488512,0.15457282013798035,0.24350671997434126,24.720641817365372,23.58016790662493,1.6254558102270582
2022-03-23,1,25.98675012588501,21.46149969100952,26.640250205993652,22.439375042915344,24.009312868118286,0.7260161770041644,1.4340869366817302,-0.15260984892351326,2.9939010290732306,23.49025011062622,1.1546126127243044,0.06091781895712307,22.085199880599976,25.709124898910524,0.7150981841030559,0.15020778560582082,1.103877386342854,1.0881357911726268,1.0215620201718618,0.08543830309329858,71.13200659823822,26.409511387287104,23.541337513923644,20.673163640560183,25.0558214868818,1.6219122156010464,23.680053574698313,1.8476692663501946,25.018778347447522,24.285981683839815,17.990766720235104,11.232776149286543,502120000,0.8288379408593666,1.001357592170936,-6447380000.0,-24.34729488333855,44.757923903640624,51.57585752245338,118.57143395757221,28.271006564471904,22.533593285736416,0.238187934688076,1.3877623083143653,25.68323257446289,24.721384391784667,23.944000244140625,23.166616096496583,22.20476791381836,0.12000000000000001,0.0,26.103145853679646,0.04645659530009838,0.11583168002064452,25.334677287510463,23.717127527509415,1.654736194902241
2022-03-24,1,27.13574981689453,21.46149969100952,26.640250205993652,22.439375042915344,24.242563009262085,0.5306918670743618,1.5259179325079115,-0.6970405223530984,2.993677007409152,23.844125032424927,1.2437513732910157,0.06443199336956237,22.085199880599976,26.047075080871583,0.779577189512444,0.1620292639524914,1.1458089685116055,1.1209009000324675,1.0498464945328068,0.11173360102453023,66.7309553189465,26.734448379511676,23.68261251449585,20.630776649480026,25.759107181004115,1.1947361059849784,23.96685709272112,2.054219141696941,25.26355958728135,24.526191841647844,20.003465464460096,8.537031672331562,877379000,0.820420774824912,1.7253641782500782,-5570001000.0,-2.216428612815443,44.757923903640624,51.57585752245338,169.15911402610007,32.861148889563744,19.60499077987567,0.23922297661537045,1.480780680733784,26.509879676818848,25.39005966567993,24.484999656677246,23.57993964767456,22.460119636535644,0.14,0.0,26.131776970767852,0.13663909780756267,0.14916722543623026,26.073260716029576,24.089058467320033,1.917393137523248
2022-03-25,0,27.80174970626831,21.46149969100952,27.13574981689453,22.549875020980835,24.709187626838684,0.443184816110023,1.6675297691375957,-0.8623133762274837,2.9933235369813596,23.9051251411438,1.318137574195862,0.06970917647266978,22.085199880599976,26.595024728775027,0.794396613024125,0.13686161400138855,1.1622203767465913,1.1266727948432542,1.0533838683015975,0.08552881210747576,70.12210058868912,27.256297078520245,23.921237540245055,20.586178001969866,26.31060709272112,1.1032592656658247,24.37176779338292,2.217164567527459,25.739582800922584,24.862557403574378,22.1629463625897,17.366619036230674,579016000,0.7937586744396883,1.1330468441261217,-4990985000.0,-8.640378183574672,44.757923903640624,51.57585752245338,152.18920078074834,31.287004380309067,18.554052729579976,0.18096217883304883,1.4525726123835423,26.538911758422856,25.413543731689455,24.503999710083008,23.594455688476565,22.469087661743167,0.16,0.0,26.154343369312954,0.046837718975563325,0.11814592963906458,26.52922194344657,24.541310446602957,2.084974084050971
2022-03-28,0,27.857749938964844,21.46149969100952,27.80174970626831,22.549875020980835,25.705124974250793,0.4450285942419332,1.8694308023533686,-0.9721277073344186,2.9927568645534905,23.942000150680542,1.5418500041961674,0.07751225181362979,22.085199880599976,26.689800167083742,0.8107838547523716,0.1494381957569444,1.1550665183818924,1.105539752188968,1.0382711737734411,0.04767770886324074,72.40431137652672,27.856736632363294,24.117875027656556,20.379013422949818,26.80335705620902,0.8543134370802321,24.82864281109401,2.230311594301684,26.25950371434022,25.19140942180134,16.124886251696203,25.612207272601534,425494000,0.8008985584487525,0.8368709906332066,-4565491000.0,-1.9308230372973412,44.757923903640624,51.57585752245338,131.46887590937425,29.643410258090235,17.906430839976473,0.20174189670618817,1.423311001535298,26.65903594207764,25.607982028961185,24.75850009918213,23.909018169403076,22.85796425628662,0.16,0.0,26.171714873999864,0.05554721284838493,0.06675979954746633,27.021848678588867,25.019598960876465,2.2698670216169194
2022-03-29,0,28.569249629974365,21.46149969100952,27.857749938964844,22.549875020980835,26.13756251335144,0.38020975699149917,2.039652588203607,-1.1892773225972209,2.992240248636262,23.942000150680542,1.7620799636840823,0.08393148496448287,22.085199880599976,27.20234980583191,0.8460239050577748,0.16954773194133604,1.1756215541964574,1.106537521179542,1.0548211122408488,0.07240920821181773,73.53744668569146,28.380705170303695,24.301399993896485,20.222094817489275,27.225928442818777,0.8968834764432122,25.246660675321305,2.349345644456071,26.657125871776913,25.444874746836497,14.131346526508432,29.803370407683055,488984000,0.7908775991300456,0.9545233785845575,-4076507000.0,-3.7241435055344225,44.757923903640624,51.57585752245338,130.90378621910858,31.752825517543762,17.015710134985497,0.2372264032472964,1.390564954889468,27.1082674407959,25.97136562347412,25.052499771118164,24.133633918762207,22.99673210144043,0.18,0.0,26.198475786464304,0.08037998691785986,0.07189352908515381,27.33614240373884,25.42206069401332,2.4472001832002586
2022-03-30,0,27.998250484466553,21.46149969100952,28.569249629974365,22.549875020980835,26.602562308311466,0.3164169753782224,2.2367118817626594,-1.2874074016485746,2.991608535297912,23.946375131607056,1.9881549263000486,0.09114963932744212,22.085199880599976,27.807349729537965,0.8509742835126374,0.1928705339745874,1.1409741479297544,1.058364933154962,1.019220816842778,0.07740484473192821,76.00506334659693,29.012323733579944,24.538899970054626,20.065476206529308,27.427107129778182,0.8883660762437717,25.641910689217703,2.3104716384855863,27.133860978789997,25.750622000848605,11.549610874439804,25.761545186676493,463487000,0.7983128803623343,0.8982775360069678,-4539994000.0,-16.129431273468327,44.757923903640624,51.57585752245338,96.09463729478259,29.84457696358973,18.479345977994793,0.1841319647864981,1.3735569809344756,27.1082674407959,25.97136562347412,25.052499771118164,24.133633918762207,22.99673210144043,0.18,0.0,26.216563712166174,0.08020590325640464,0.04396010955356261,27.472531454903738,25.781008856637136,2.535768744697229
2022-03-31,0,27.646499633789062,21.46149969100952,28.569249629974365,22.549875020980835,26.764125108718872,0.17215974841263235,2.35434160117792,-1.4756081018331795,2.991219190068814,24.17562508583069,2.1519187188148505,0.09515831478559074,22.085199880599976,27.871799993515015,0.8881315930608145,0.16938323756592752,1.117422515728212,1.0292833629405498,0.9918898600159843,0.018822027043326583,70.10740680374285,29.44999568232868,24.74131247997284,20.032629277617,27.570857048034668,0.8184850529934178,26.00392852510725,2.1872918328640933,27.346780608432745,25.94537602044199,5.2961670774298595,24.631923894712507,523440000,0.8173172266140344,0.9991404689111442,-5063434000.0,-21.31758204882637,44.757923903640624,51.57585752245338,77.85660613669582,28.29146855538542,18.757488529489805,0.14794845590716713,1.345242469978197,27.1082674407959,25.97136562347412,25.052499771118164,24.133633918762207,22.99673210144043,0.18,0.0,26.233026379269365,-0.03069281074841701,0.06444553770354344,27.58124269757952,26.150942257472447,2.5783306924910003
2022-04-01,0,26.96250009536743,21.46149969100952,28.569249629974365,22.549875020980835,27.263437271118164,0.014983867347537542,2.428734338626773,-1.5916781953354222,2.9909771043407214,25.009875059127808,2.25724995136261,0.0974358350450618,22.085199880599976,27.871799993515015,0.8997014528778579,0.19575696713714405,1.0816801450503954,0.9918609529774053,0.9638173139402954,-0.030186934986745073,68.59082900639352,29.78396864006024,24.9264999628067,20.069031285553162,27.71024990081787,0.5391656457046486,26.383035693849838,1.8014686036298786,27.41974339123923,26.095482147883317,3.7771770911108757,22.4474869304179,517235000,0.7923074800053475,0.9792754874131288,-5580669000.0,-29.302198980228766,44.757923903640624,51.57585752245338,49.967124707828305,26.43009566311742,22.892797831475775,0.14312663621633165,1.3369229771245346,27.146735466003417,26.033631664276122,25.133999824523926,24.23436798477173,23.121264183044435,0.02,1.0,26.239899818597696,-0.035389299467521784,-0.051083558037800285,27.73503657749721,26.534856932503835,2.5567735724946172
2022-04-04,0,27.06475067138672,21.46149969100952,28.569249629974365,22.549875020980835,27.263437271118164,-0.1727545505082705,2.4302327506448935,-1.5686725529391756,2.99101517628477,25.799000024795532,2.2495399904251108,0.09675032671061116,22.085199880599976,27.871799993515015,0.8949722564205181,0.21820359738121972,1.0774784716003185,0.9906978504573318,0.9733123569808766,-0.02846602002371168,64.19749501786792,29.9790654406361,25.118599939346314,20.25813443805653,27.700107165745326,0.5522825883388696,26.72960717337472,1.3468095009671135,27.302895416628424,26.137370210509598,3.7547979826476725,24.50935316482694,397120000,0.7701854584504513,0.7557047267225979,-5183549000.0,-27.467942725349058,44.757923903640624,51.57585752245338,55.351173220583235,25.403535314213503,21.710021608230143,0.20759592887709197,1.3088769134693212,27.583335556030274,26.74033180999756,26.05900001525879,25.37766822052002,24.534664474487307,0.02,0.0,26.24817995344715,-0.030440372206916866,-0.01198894972372585,27.622330256870814,26.847795486450195,2.431357611798344
2022-04-05,0,26.580999851226807,21.46149969100952,28.569249629974365,22.68231213092804,27.263437271118164,-0.37311192940181753,2.364087680481535,-1.4155841631604862,2.9913281824205473,26.28837490081787,2.148250017166137,0.09320205823536201,22.156974935531615,27.871799993515015,0.864978399527007,0.2610838506651269,1.0479323235522184,0.971302341058069,0.9613989945911862,-0.06959404970375982,66.43391244511575,30.093362839028558,25.36518747806549,20.637012117102422,27.525714329310826,0.6903231477432465,26.918160711015975,1.0859261173682213,27.2390035892045,26.215930119641953,-0.2616443105014512,21.843313963891045,436615000,0.7400287806480594,0.8405273502265312,-5620164000.0,-59.821428233533695,44.757923903640624,51.57585752245338,24.76140320074165,23.29161597257583,24.186071240197343,0.17405274895731873,1.3254139919944086,27.756559379577638,27.020719524383544,26.425999641418457,25.83127975845337,25.095439903259276,0.04,0.0,26.249223724968562,-0.09509359018347463,-0.081080113420437,27.371094839913503,26.950158391680038,2.2443178079030806
2022-04-06,0,24.66099977493286,21.65499973297119,28.569249629974365,23.63518762588501,27.263437271118164,-0.5262582738348253,2.198944843709026,-1.2116467806518025,2.991985283699513,26.58549976348877,1.9380550003051753,0.08582533461953679,22.439550256729127,27.871799993515015,0.8962288001903267,0.1700928996013329,0.9625246234761874,0.9013383300536765,0.9049708865741792,-0.11919497296394288,59.44692682373645,30.019052173494405,25.621162486076354,21.223272798658304,27.069035734449113,1.2580229693725378,26.936196395329066,1.0422567047487947,27.072770919951765,26.26124885936487,-4.390910169104457,11.025946812409492,703833000,0.7229170392098536,1.3279662465599589,-6323997000.0,-91.8268375550587,44.757923903640624,51.57585752245338,-42.87715701157199,20.94406629154726,31.24704529717929,0.1187514639361879,1.3685241280919715,27.77945140838623,27.057773571014405,26.474499702453613,25.891225833892825,25.169547996520997,0.06,0.0,26.223577415155678,-0.11856267335846848,-0.14827614429398603,26.827251161847794,26.924549920218332,2.176731656524524
2022-04-07,0,24.212250232696533,21.65499973297119,28.569249629974365,24.291687726974487,27.263437271118164,-0.6086041503690116,2.1095729618462498,-0.9668016432725479,2.992304000935534,26.58549976348877,1.821414985656738,0.0820259439918485,22.439550256729127,27.871799993515015,0.8537054931835518,0.09776425095638062,0.9414382519226339,0.8892457637299841,0.9108119326653265,-0.12422004400496511,44.716444677314634,29.93750842197589,25.718362498283387,21.499216574590886,26.44660724912371,1.454555595597197,26.836267845971243,1.2293365013540747,26.463274312358763,26.01367287511357,-11.475263332594798,1.0344739675553034,557992000,0.8609752471109476,1.0400509222196646,-6881989000.0,-86.64960237979132,44.757923903640624,51.57585752245338,-66.05649034951607,19.57325937009973,31.964092989365685,0.09789746982160091,1.3596164031139502,27.655551498413086,26.857223716735838,26.211999893188477,25.566776069641115,24.768448287963867,0.08,0.0,26.19860329301913,-0.11280501291839184,-0.12574932036100084,26.192671639578684,26.764407021658762,2.085319036414053
2022-04-08,0,23.505249977111816,21.65499973297119,28.569249629974365,24.359437704086304,27.263437271118164,-0.6458262573922324,2.0066845240180977,-0.7452142508763075,2.9926509163302164,26.58549976348877,1.716564989089966,0.07776117711706787,22.541699934005738,27.871799993515015,0.8293766307163277,0.07237054715623997,0.9108536418027725,0.8726494765438685,0.9076682716659323,-0.12822438965330307,41.79129933180129,29.81910654345856,25.805737495422363,21.792368447386167,25.804750033787318,1.6357726493299223,26.61592858178275,1.519155321691134,25.894784943575402,25.78550563747815,-15.25066095087966,-5.4624420720465965,524781000,0.8701520774513923,0.9639920857205155,-7406770000.0,-99.03128454314712,44.757923903640624,51.57585752245338,-101.7586124200434,18.379806465181826,32.2284817965339,0.0850754087678963,1.3443372052757747,27.557375411987305,26.69831157684326,26.003999710083008,25.309687843322756,24.45062400817871,0.1,0.0,26.167110019746172,-0.13450870291001715,-0.1527155361160606,25.540544509887695,26.506537982395717,1.9993637001525022
2022-04-11,0,22.02775001525879,21.65499973297119,28.569249629974365,24.359437704086304,27.263437271118164,-0.6384396777409556,1.9412400156858276,-0.6513053889806812,2.992861286017444,26.58549976348877,1.6609449863433838,0.07509026169966722,23.37599997520447,27.871799993515015,0.752566235098449,0.08544217349139445,0.8520685231786028,0.8310523899880656,0.8739488601034472,-0.1861092576571609,39.051177638049886,29.734567529082838,25.85208749771118,21.969607466339525,25.00207151685442,1.9329662396523177,26.286464282444545,1.9519805417902354,25.294654904151308,25.521617595313927,-16.047433070317933,-11.601164859930844,575207000,0.8582089762198107,1.0385126989220959,-7981977000.0,-96.4726874246393,44.757923903640624,51.57585752245338,-162.2025852421116,16.96182668075748,37.15557261494877,0.09613163082510259,1.3525377832828434,27.226503311157227,26.162747413635255,25.30299949645996,24.44325157928467,23.379495681762695,0.12000000000000001,0.0,26.116490366175658,-0.19894006117125895,-0.17950726540817152,24.77456964765276,26.17790617261614,1.9318299738760865
2022-04-12,0,22.01200008392334,22.02775001525879,28.569249629974365,24.359437704086304,27.263437271118164,-0.5771428547936777,1.9022528789058404,-0.7988228207265085,2.992985073069948,26.58549976348877,1.6385799694061276,0.07352916773829557,23.37599997520447,27.871799993515015,0.6946630961024053,-0.008328547484171063,0.8508458914027963,0.8491350315581461,0.9096826364344431,-0.17188968785508618,30.956584090495298,29.675230769637245,25.870725011825563,22.06621925401388,24.294857229505265,2.000597141138043,26.00255356516157,2.263178600913453,24.48342573160757,25.162256652068553,-20.32354798241126,-17.31402728979295,662258000,0.9189304456084256,1.177580245412049,-8644235000.0,-97.10333853225234,44.757923903640624,51.57585752245338,-162.29361137618486,17.805038964533892,34.334250056070594,0.01348622166382031,1.3590070485126566,27.137295249938965,26.018351314544677,25.113999366760254,24.20964741897583,23.090703483581542,0.14,0.0,26.05793956663953,-0.17072231743531985,-0.2140351844683779,24.03156362261091,25.88330010005406,2.0731916980609277
2022-04-13,0,21.971499919891357,22.01200008392334,28.569249629974365,24.359437704086304,27.263437271118164,-0.6038325242096848,1.9219557988621592,-0.7441640985150384,2.992923153072101,26.58549976348877,1.6506249618530275,0.07431959407558296,23.357499980926512,27.871799993515015,0.7864379132319971,-0.08058268528990972,0.8496100463105083,0.8695686528868173,0.9436449999915214,-0.10905883295839847,26.81451047702723,29.704599115844125,25.86068751811981,22.016775920395496,23.567249979291642,1.7336919594511158,25.633678572518484,2.475200116829156,23.869924111983213,24.85056592176261,-18.360686115656847,-15.295294804880127,516943000,0.8227895712969835,0.9319915502134712,-9161178000.0,-87.98278209610763,44.757923903640624,51.57585752245338,-138.35819724555515,16.80958710047895,32.41467586770044,-0.018159993393013298,1.3365534152570369,27.137295249938965,26.018351314544677,25.113999366760254,24.20964741897583,23.090703483581542,0.14,0.0,26.01561672242432,-0.09030205333667207,-0.14376621244507407,23.295833042689733,25.459081649780273,2.2117341854430683
2022-04-14,0,21.92574977874756,21.971499919891357,28.569249629974365,24.359437704086304,27.263437271118164,-0.6395775009350327,2.0630781257119732,-0.8427172529127738,2.9924631083828817,26.58549976348877,1.768809986114502,0.08008159729681437,22.026175022125244,27.871799993515015,0.8294066851506379,-0.09984227851911964,0.8510821971932987,0.8889616332830068,0.9639492975444406,-0.0944356857365225,25.378205067707547,29.88835624932586,25.762199997901917,21.636043746477974,22.90221425465175,1.193737399518738,25.213964291981288,2.5754456739820037,23.396288293527043,24.554986909208683,-18.81876102734627,-19.031167120312805,569097000,0.8120573744385712,1.0171115488254543,-9730275000.0,-98.77939965195723,44.757923903640624,51.57585752245338,-131.81434747459602,15.379412505065176,31.19606289264765,-0.09819621912644591,1.356391203319715,27.109211372375487,25.97289351272583,25.054499626159668,24.136105739593507,22.99978787994385,0.16,0.0,25.966366701191703,-0.12186052441627826,-0.12902028295980955,22.629153932843888,25.000124386378697,2.422983754960337
2022-04-18,0,21.537500381469727,21.92574977874756,28.569249629974365,24.035500168800354,27.263437271118164,-0.6014616742090153,2.210242879198117,-1.0696219149810262,2.9919425581539656,26.58549976348877,1.9177750110626222,0.08620943494350614,22.00795006752014,27.871799993515015,0.8711440135953936,-0.143901611828291,0.8400595950141383,0.8939550519889784,0.966307680658213,-0.08371532306859875,21.434568862916734,30.05854823550805,25.638062477111816,21.217576718715584,22.456000055585587,0.9937656953247507,24.76251789501735,2.62973376690899,23.031171085541676,24.339595059119134,-17.5134498270741,-21.135360146760554,525701000,0.7498238350826243,0.9570871834308624,-10255976000.0,-91.05121912013684,44.757923903640624,51.57585752245338,-114.22384845116115,14.546204471867728,29.95698344999825,-0.1396879504172032,1.3315540369303942,27.08938745880127,25.94080565261841,25.012499809265137,24.084193965911865,22.935612159729004,0.18,0.0,25.9209991460119,-0.057788049901770555,-0.10017351469707275,22.254797799246653,24.541024480547225,2.5557343171678184
2022-04-19,0,21.901249408721924,21.537500381469727,28.569249629974365,23.13587498664856,27.263437271118164,-0.4766399084074203,2.3841936846811818,-1.3435015568220836,2.9912620759544284,26.58549976348877,2.1621999835968024,0.09373903171126406,21.966924905776978,27.871799993515015,0.8807642217780823,-0.19001501902569534,0.8610885625741511,0.9299942927452601,1.0002899932337381,-0.005742783827183295,16.58237249779123,30.202762369362368,25.434375,20.66598763063763,22.12585708073207,0.6305810087931094,24.286232164927892,2.4872176824377004,22.657304355496237,24.07754140248168,-12.665745192691153,-22.687580911389173,512781000,0.6976121201402723,0.9403226886010073,-9743195000.0,-84.91304423855719,44.757923903640624,51.57585752245338,-91.99329611916379,15.259746877780165,28.228401558461478,-0.12520043671902437,1.3120688254067594,26.745588333129884,25.662706359863282,24.787500381469727,23.91229440307617,22.829412429809572,0.18,0.0,25.880818918879296,0.012821089301107369,-0.03983743336642483,21.96803855895996,24.080355099269322,2.626485664987405
2022-04-20,0,21.96725034713745,21.537500381469727,28.569249629974365,22.023812532424927,27.263437271118164,-0.28449451542098114,2.4873266735662662,-1.5610338948049483,2.9908036623081284,26.283874988555908,2.304518780708313,0.09870368428033216,21.923299741744994,27.871799993515015,0.9043293321515391,-0.17788874956608047,0.8717184460785329,0.9537077109158436,1.0044651220401017,-0.00203297004430647,21.870764769007675,30.17459083378109,25.199937486648558,20.225284139516027,21.90614284787859,0.1684761983353051,23.855446440832957,2.310873982239285,22.468483009320963,23.88220350500153,-9.54475854893406,-23.339780734935687,468974000,0.7085172786645788,0.8661880450741967,-9274221000.0,-94.37857511533488,44.757923903640624,51.57585752245338,-86.5538684176807,15.652372697381075,25.98683747757305,-0.14144450876284215,1.3233587570622107,26.556115493774413,25.509441680908203,24.66349983215332,23.817557983398437,22.770884170532227,0.18,0.0,25.843144920995904,-0.0010229833758541584,-0.019847643686514736,21.734493528093612,23.637519018990652,2.724757903254532
2022-04-21,0,21.07100009918213,21.537500381469727,28.569249629974365,22.001875042915344,27.263437271118164,-0.09612894734675952,2.5594901704157245,-1.6795317759294586,2.990447718188035,25.323874950408936,2.3941375017166138,0.10251785216608587,21.923299741744994,27.871799993515015,0.922405596389711,-0.1546749693315362,0.8439781086593006,0.9334954847748325,0.9638780242492101,-0.0409849042619973,23.58286260455435,30.085267834537202,24.96628749370575,19.847307152874297,21.76946428843907,0.3469421862745766,23.385767902646744,2.1432270315098254,22.345286907125335,23.746498793984383,-6.543217500226498,-21.540632121550253,656209000,0.7051279382026304,1.1950034172404105,-9930430000.0,-97.57871724126444,44.757923903640624,51.57585752245338,-99.8111662443574,13.740356234662402,28.9405973440957,-0.14955039803138415,1.3997479808780753,25.77431243133545,24.670844348907472,23.779000282287598,22.887156215667723,21.783688133239746,0.19999999999999998,0.0,25.77981855565037,-0.09097855591794801,-0.06143033823375943,21.487110137939453,23.130839892796107,2.9101651108713393
2022-04-22,0,19.95099973678589,21.07100009918213,28.569249629974365,21.97043752670288,27.263437271118164,0.036337741234267695,2.6827550077774824,-1.7219313951217237,2.9898365562682407,24.436625003814697,2.513299989700317,0.10852349299591234,21.864874505996703,27.871799993515015,0.8995001991369262,-0.22349666984092442,0.8070629535382897,0.8981616616669906,0.9202257200106816,-0.0900653369617388,15.554692985646719,30.086010007925573,24.720499992370605,19.354989976815638,21.475035667419434,0.7487083886157133,22.88494644846235,2.0607615616356445,22.03364002213077,23.51096649033155,-4.343384664406996,-23.784202780486808,624713000,0.6425463588256453,1.1644361353528652,-10555143000.0,-99.8138571779905,44.757923903640624,51.57585752245338,-114.22107872920013,13.033589810316649,30.060352711848058,-0.2797704761219212,1.3701738178057514,25.65631243133545,24.47984434890747,23.529000282287598,22.578156215667725,21.401688133239745,0.2,0.0,25.70876442851379,-0.08199283333680762,-0.12106471692731297,21.203346797398158,22.617455210004533,2.9945312037837923
2022-04-25,0,19.536250114440918,19.95099973678589,28.569249629974365,21.956875205039978,27.210187911987305,0.1413794543573207,2.813157993453105,-1.582865635090391,2.9890802136137893,23.858750104904175,2.589138739109039,0.11547669152190516,21.490850353240965,27.871799993515015,0.8677051128387999,-0.2823833050950874,0.8019391492444753,0.8966919594123995,0.9178153361588388,-0.0929193375082017,10.257633454536421,29.987578475271388,24.361262488365174,18.73494650145896,21.12714283806937,1.002379853861513,22.347196408680507,1.8584970996523704,21.516572811063828,23.107748477912068,-9.36307622787409,-26.004637306561293,641566000,0.62184946755593,1.1889185290059792,-11196709000.0,-90.19822695199963,44.757923903640624,51.57585752245338,-108.4950387847367,12.440225915427053,30.858192202595543,-0.2126322800231094,1.3329227888001973,25.378372344970703,24.177814407348635,23.207500457763672,22.23718650817871,21.03662857055664,0.2,0.0,25.63528459654389,-0.08635173082145009,-0.06378777663815878,20.87507220676967,22.0854526247297,3.0182516539768223
2022-04-26,0,19.241000175476074,19.536250114440918,28.569249629974365,21.91962468624115,26.988062739372253,0.2450088968900253,2.8836177439062927,-1.4089716229950109,2.9885266385845384,22.766499996185303,2.6021362733840947,0.12041169400350757,20.959000062942504,27.871799993515015,0.8631740148991808,-0.2987139967425934,0.8034495662078814,0.8995272437991992,0.9212677896035826,-0.12146563803736399,9.322912062140187,29.715222996586387,23.947987508773803,18.18075202096122,20.743607180459158,1.1488150505274424,21.822910717555455,1.5878688123638034,21.023995772233956,22.66319295412273,-11.083675735973518,-27.816626313520967,653143000,0.61196108512016,1.185368997808455,-11849852000.0,-98.22021047580442,44.757923903640624,51.57585752245338,-113.81851447867827,11.613949555742696,31.1052581846826,-0.2913149993168719,1.3257096815570892,23.735319435119628,22.767339557647706,21.984999656677246,21.202659755706787,20.234679878234864,0.2,0.0,25.555390330910647,-0.1536174878658777,-0.13749257253662686,20.52268627711705,21.57592010498047,3.024375709118224
2022-04-27,1,18.61750030517578,19.241000175476074,28.569249629974365,21.810312151908875,26.676374912261963,0.35289361076864717,2.9108597916284724,-1.2115658054588965,2.9881496769019975,22.019875049591064,2.5558300209045415,0.12377604382668667,19.909524774551393,27.68167471885681,0.840229351257031,-0.32651363180050946,0.7916563141736206,0.8818674369187769,0.9147165431964098,-0.15248836285958633,5.994630974777571,29.338869603856306,23.517150020599367,17.695430437342427,20.326464312417166,1.328574608739164,21.391232184001378,1.5784196861748538,20.58441188409614,22.22332049155563,-12.24473338591955,-27.613707974991637,499460000,0.5506535641238631,0.9055935988714983,-12349312000.0,-98.0565918000605,44.757923903640624,51.57585752245338,-118.40137765739425,11.051244091127106,31.69753238215923,-0.34112415111039035,1.2936409050408204,23.204048309326172,22.2649764251709,21.506000518798828,20.747024612426756,19.807952728271484,0.2,0.0,25.491366856858562,-0.14277069984130975,-0.17042079067361543,20.042186192103795,21.148491995675222,2.936644701204487
2022-04-28,0,19.318999767303467,18.61750030517578,27.998250484466553,21.420875310897827,25.140999794006348,0.3723942722712208,2.8547599344779324,-1.0469304476388204,2.988123603193342,21.99175000190735,2.44750002861023,0.12401451711936634,19.506725120544434,27.122925567626954,0.8326028156630376,-0.3350477268033307,0.8392426972355668,0.9300500550004068,0.9814894153021283,-0.0831474692056342,5.481740043561084,28.7290824233153,23.019562554359435,17.31004268540357,19.957571506500244,1.1671279807170003,21.04171429361616,1.4415280074686585,20.094864143359843,21.702379794638407,-13.557748227859502,-24.50630357614337,570327000,0.5511797412596173,1.0241658843921762,-11778985000.0,-73.51324647497692,44.757923903640624,51.57585752245338,-92.0921897077537,14.799230323867144,28.907857939720177,-0.27758390830985497,1.3171073427354492,22.59361247253418,21.77119455718994,21.10650062561035,20.441806694030763,19.619388778686524,0.2,0.0,25.428169046618454,-0.01986824403384435,-0.07913604079480363,19.69750431605748,20.83277143750872,2.7707249418228352
2022-04-29,0,19.148500442504883,18.61750030517578,27.646499633789062,20.79100000858307,24.324437618255615,0.48041995758027534,2.7215202319199228,-0.8712964778524408,2.9885769669082176,21.969375133514404,2.253405010700226,0.12049802660502952,19.311199808120726,26.97272515296936,0.8411721409849723,-0.30121353432779147,0.8478189831936785,0.9337657323475823,0.9904593154618261,-0.04022351284990233,16.86453442150563,28.028640482341128,22.58560001850128,17.142559554661435,19.554892948695592,0.7803699056553721,20.730517898287093,1.335131362703746,19.90311892833976,21.33307247520203,-11.79042160211237,-20.20981287722344,500435000,0.6122520560824773,0.9005172573573539,-12279420000.0,-94.27234237910623,44.757923903640624,51.57585752245338,-101.9324516710761,14.011939567963283,26.420707933182875,-0.2759524979379294,1.338109848065413,21.71806854248047,21.062966613769532,20.53350067138672,20.00403472900391,19.34893280029297,0.02,1.0,25.370413771860836,-0.04960270836927938,-0.0810582984711618,19.278778893607004,20.506636210850306,2.64583956302947
2022-05-02,0,19.009750366210938,18.61750030517578,27.06475067138672,19.847312331199646,23.682000041007996,0.5733565817324701,2.5565953582991057,-0.6563001194754907,2.9891919711730175,21.946500062942505,2.0022550249099735,0.11536618209261262,19.231750202178954,26.61914987564087,0.8375813533338062,-0.2898099072869401,0.8578136212147591,0.9397264718928169,0.9915138757225503,-0.026949887780193804,16.85469607615988,27.273890775535286,22.160700058937074,17.047509342338863,19.26042870112828,0.41743229585354386,20.514946494783675,1.3530910520787798,19.717827658091743,21.000090868401422,-12.831600951822717,-18.53521889301032,572049000,0.6121428763120638,1.0243326203013214,-12851469000.0,-72.29774535809028,44.757923903640624,51.57585752245338,-94.02441986461756,13.11931159427859,25.416092306522618,-0.21415793789288126,1.3270254941486308,21.71806854248047,21.062966613769532,20.53350067138672,20.00403472900391,19.34893280029297,0.02,0.0,25.306711604629903,-0.018540773570096203,0.0009226048363207675,19.186046055385045,20.336578096662247,2.4473645856448023
2022-05-03,0,19.489999771118164,18.61750030517578,27.06475067138672,19.481937527656555,22.397125005722046,0.6845816385962874,2.391991696108382,-0.3142695988586208,2.9898136094047825,21.91349959373474,1.8436061763763427,0.10991061980096518,19.13462543487549,24.852999782562257,0.7988740253207517,-0.2976196013396737,0.8955540933730753,0.9756585793971002,1.022176862042686,0.012941094193193559,16.00092189624765,26.547045964696014,21.76306257247925,16.979079180262485,19.194571563175746,0.3138345403449997,20.33480361529759,1.3054956641057744,19.54176583769589,20.716553325843392,-9.782401040618849,-13.700898398416816,475751000,0.603811108561326,0.8459423524616071,-12375718000.0,-70.76000646126651,44.757923903640624,51.57585752245338,-72.09392933599767,14.012595061943667,24.435473180455407,-0.2181359857669367,1.2816476830611188,21.71806854248047,21.062966613769532,20.53350067138672,20.00403472900391,19.34893280029297,0.02,0.0,25.257718024697514,0.04332560549475528,-0.015073837100337136,19.198458535330637,20.200902666364396,2.0739028280768577
2022-05-04,0,19.851999759674072,18.61750030517578,26.580999851226807,19.44724977016449,22.015937566757202,0.6882859110864074,2.105024474035961,-0.16592940637485087,2.9909764002912986,21.719374895095825,1.7074924468994142,0.09843773284086768,19.13462543487549,24.257125186920167,0.7690622610459956,-0.2667695015159999,0.9283435289248716,1.0059221639829523,1.0384501515249616,0.06630855024909499,24.17431791329416,25.594373975537742,21.38432502746582,17.1742760793939,19.239678655351913,0.38561158460416295,20.183410746710642,1.2212727798771408,19.525337516759876,20.514342361777295,-2.310660978145007,-11.45738825726764,648855000,0.6362825541673137,1.1323747881231143,-11726863000.0,-54.44620145548531,44.757923903640624,51.57585752245338,-52.34097251316289,15.891644441731406,22.23402661903941,-0.1295532164347425,1.3078973215522824,21.71806854248047,21.062966613769532,20.53350067138672,20.00403472900391,19.34893280029297,0.04,0.0,25.19573970747237,0.10420858456414628,0.08228663917499744,19.26009041922433,20.067581312997,1.7582624067383628
2022-05-05,0,19.283999919891357,18.61750030517578,24.66099977493286,19.44724977016449,21.981624960899353,0.4383430561694973,1.7564336041621875,-0.8412462016999367,2.992284531639518,21.304250240325928,1.5265874767303464,0.08344945046719353,19.13462543487549,23.57595000267029,0.827652226703976,-0.19500426013332142,0.9161969984580995,0.9877276663506844,0.9958763313399528,-0.001811680099056967,32.44697779718915,24.56074223121256,21.047875022888185,17.53500781456381,19.245821475982666,0.3859784651685954,19.994714328220912,1.1321966203672518,19.60095303660922,20.37936373433485,1.616224420671993,-9.646588389254426,626331000,0.5412534511090277,1.1005086459801312,-12353194000.0,-87.35161978783137,44.757923903640624,51.57585752245338,-78.04935829085058,14.34384010904777,21.40146209339192,-0.13558105772395931,1.345489589374651,21.63632027435303,20.996840396881105,20.480000495910645,19.963160594940184,19.32368071746826,0.04,0.0,25.129189709299922,-0.0474168360107855,0.023296221560478347,19.26807975769043,19.895383017403738,1.6144406787491599
2022-05-06,0,18.728249549865723,18.61750030517578,24.212250232696533,19.31024980545044,21.968312740325928,0.44884213737510986,1.5860668121123045,-0.892227285428878,2.9928467339747242,20.51099991798401,1.4341249942779541,0.07633018439565907,19.13462543487549,22.175500011444093,0.7920312158491699,-0.20354367171333804,0.9013055002678847,0.9681233562929045,0.9675256821058491,-0.021946934899732873,29.35826553863573,23.95115865436071,20.779025030136108,17.606891405911504,19.26164279665266,0.35712212177104063,19.794053554534912,1.0857233397633965,19.519219395842505,20.231497123524417,0.22347977767854926,-12.048618111189185,633297000,0.5441692908160879,1.105435055251941,-12986491000.0,-85.36326022917527,44.757923903640624,51.57585752245338,-88.61696565573664,13.195250784613773,22.37094414328285,-0.1486657394594702,1.3581016454841306,21.56552000427246,20.8822399597168,20.329999923706055,19.77775988769531,19.09447984313965,0.02,1.0,25.059390783349265,0.006901261644296053,-0.055960024747026355,19.305172783987864,19.673679488045828,1.438649812488067
2022-05-09,0,17.516499996185303,18.61750030517578,23.505249977111816,19.273249983787537,21.93612492084503,0.3556286750243845,1.435741798761175,-1.2361093120678543,2.99329784173985,19.90149974822998,1.3375825047492982,0.07001970507144704,18.981600284576416,22.013575077056885,0.7711169896769238,-0.2032312114058641,0.8542623504276186,0.911243910784441,0.9088715760705256,-0.07855181374079623,27.042321457358568,23.376308593516917,20.504824995994568,17.63334139847222,19.004142829350062,0.7464702716746787,19.480857167925155,1.0633049127653822,19.31692847992644,20.00003683570597,0.5948663508771499,-13.043532359126532,644455000,0.5386411793688749,1.113283706261911,-13630946000.0,-97.89489834057743,44.757923903640624,51.57585752245338,-149.47013498057683,11.944581827960178,26.215479257177538,-0.15387791325531933,1.3931052183780006,21.291051979064942,20.437973918914796,19.748499870300293,19.05902582168579,18.205947761535644,0.04,0.0,24.974749528332413,-0.1322377815472333,-0.08610553952444337,18.901142120361328,19.299323218209402,1.4809018576872564
2022-05-10,0,17.626749515533447,17.516499996185303,22.02775001525879,19.217875242233276,21.907374501228333,0.05882882135877499,1.4028786507511923,-1.306906410768971,2.993321892738402,19.694124937057495,1.2770900058746335,0.06943092039007313,18.71717462539673,21.975549936294556,0.7897679555435528,-0.2047984935342243,0.8723786919798364,0.9267164639791093,0.9289875805734465,-0.09560032208650049,22.749340999849274,23.011144798450623,20.20538749694824,17.39963019544586,18.786749839782715,0.9026684917550618,19.17082139423915,0.9033220313059751,18.862543565463994,19.643995537178913,-9.330192001807534,-20.020544630620225,761474000,0.5092717410112056,1.2946033936768324,-12869472000.0,-86.19946854725853,44.757923903640624,51.57585752245338,-126.81780218202175,11.174312416541087,24.524923483158954,-0.1424460867973491,1.3827375142476166,21.078660072326656,20.266169994354247,19.60949993133545,18.95282986831665,18.140339790344235,0.04,0.0,24.88045486460409,-0.10238749228688493,-0.09921673852055433,18.765323911394393,19.022051402500697,1.5122355373755587
2022-05-11,1,17.07450008392334,17.516499996185303,22.01200008392334,19.113812923431396,21.628437638282776,0.1295326155775317,1.4443216157731698,-1.172605936310526,2.9931248284272383,19.51312494277954,1.2488887715339665,0.07226906314689213,18.518425226211548,21.967675304412843,0.8120728809523926,-0.1992209045825281,0.8543513517286192,0.9053659489632858,0.9179098629156532,-0.13991032185043373,24.443086478751507,22.873980703508316,19.985337471961977,17.096694240415637,18.51028551374163,1.098173086136234,18.885357107434952,0.8879927623558254,18.555308121052533,19.38090442281812,-7.947102341202285,-19.758962833368965,670167000,0.5129225294242996,1.1386042898714615,-13539639000.0,-98.41760135529852,44.757923903640624,51.57585752245338,-149.56933147265877,10.483042611828184,25.393496076872655,-0.1543754077573176,1.3686095871846233,19.56135223388672,18.989324340820314,18.527000427246094,18.064676513671877,17.49264862060547,0.06,0.0,24.79251050456674,-0.18215822116089497,-0.1516174571629202,18.35116277422224,18.76860441480364,1.620967723393974
2022-05-12,1,16.187249898910522,17.07450008392334,21.971499919891357,18.939375162124634,21.18762516975403,0.12423646804522483,1.4977978208051632,-0.9561421363331934,2.992856587293814,19.404499769210815,1.2269549655914305,0.07588219310053912,17.615724563598633,21.929899835586546,0.7949838050735327,-0.22287963287998555,0.820086666927788,0.8654004210413804,0.8969993387220319,-0.16058649833256589,21.92265934551358,22.7340581135723,19.738462471961974,16.742866830351648,18.038464103426254,1.298348380425863,18.616517833301,1.0878082911813474,18.188911728901473,19.054957668157055,-10.180303502182895,-18.966826427066046,708728000,0.5156513686246252,1.1848158647046232,-14248367000.0,-87.41984388785038,44.757923903640624,51.57585752245338,-176.51593386917895,9.809658654780172,29.028491663240345,-0.17079177244444899,1.3580634044190074,19.25941180038452,18.553793912887574,17.983500003814697,17.41320609474182,16.70758820724487,0.08,0.0,24.692218374741554,-0.1416365892486715,-0.20453431785779316,17.862245287214005,18.530351911272323,1.6730788629945874
2022-05-13,0,17.25374984741211,16.187249898910522,21.96725034713745,18.700562238693237,20.23099982738495,-0.036954687602930525,1.5940474164851062,-0.5931997568969698,2.992360950664081,19.301499843597412,1.2188749659061433,0.08195932587987005,17.472300004959106,21.903699445724488,0.7651209785776579,-0.26172422552223573,0.8871164632680296,0.9381244260455186,0.9900784164846523,-0.07873131434561564,18.588366162263114,22.637344803883146,19.449249970912934,16.261155137942723,17.667285544531687,1.0389659387066073,18.453482099941798,1.1101749490744726,17.691746349671003,18.635722080197652,-16.94586922008034,-18.864968610749465,670437000,0.5314384378555848,1.1113885929650364,-13577930000.0,-55.74178923379861,44.757923903640624,51.57585752245338,-100.47420627017887,14.79865121242055,26.405917510136067,-0.09065226394082139,1.3862796905188985,19.25941180038452,18.553793912887574,17.983500003814697,17.41320609474182,16.70758820724487,0.08,0.0,24.612892539375082,-0.05188752378299211,-0.060390617406425366,17.48731803894043,18.37370422908238,1.6437072786475526
2022-05-16,1,17.41675043106079,16.187249898910522,21.96725034713745,18.369812607765198,19.876749753952026,0.07194562677242074,1.5558845337335305,-0.563475146472658,2.9924518355158902,19.262500047683716,1.1778099763393404,0.08096965420429249,17.235824871063233,21.573875284194948,0.8210696851413032,-0.19889729347344498,0.9063836224282297,0.9568447105988542,1.016635811569585,-0.005694605951316434,32.605690445252385,22.327419041813222,19.21564997434616,16.1038809068791,17.400535617555892,0.7558235174905905,18.323178546769277,1.1176648403145233,17.584337863530834,18.422315529070573,-13.088101670945319,-11.683410345681523,521446000,0.6121642008478748,0.8647100251579565,-13056484000.0,-64.88723731773774,44.757923903640624,51.57585752245338,-91.74909556463693,14.25892122450812,25.442852340615715,-0.13112368690518725,1.3359631607198028,19.25941180038452,18.553793912887574,17.983500003814697,17.41320609474182,16.70758820724487,0.08,0.0,24.552186657638973,0.01852501839757914,-0.07555546146674653,17.261905397687638,18.264992577689036,1.5692099032542135
2022-05-17,0,18.064000129699707,16.187249898910522,21.96725034713745,17.59918713569641,19.615187525749207,0.2239662981363629,1.5068436364186364,-0.40079238031950615,2.9926008048393262,19.19475030899048,1.1655650186538693,0.07926745683298926,17.235824871063233,21.15402503013611,0.792134386715269,-0.20475996113149747,0.9502560955264718,1.0011652874587,1.0556458219950704,0.02480608315111854,33.44513581057904,22.023299749662986,19.009612476825716,15.995925203988445,17.30564284324646,0.5833728853347422,18.28364281994956,1.1162415013458757,17.54515845275568,18.27476535142327,-9.682895128538696,-9.481054663366253,585830000,0.6035756719008384,0.9656288830555232,-12470654000.0,-45.99627409863159,44.757923903640624,51.57585752245338,-44.83166246211156,16.560683301721483,23.917999810360044,-0.13576489395190355,1.3196054198043679,19.25941180038452,18.553793912887574,17.983500003814697,17.41320609474182,16.70758820724487,0.08,0.0,24.49149785830968,0.03307758363262692,0.07238938888712985,17.190858023507253,18.24801540374756,1.3707739201109803
2022-05-18,1,17.40625,16.187249898910522,21.96725034713745,17.59918713569641,19.501562356948853,0.23367573537762365,1.3639638806795802,-0.11440437587053776,2.993113753483593,19.07912540435791,1.0874500358104704,0.0724828356071471,17.235824871063233,20.062999773025513,0.7462599338270792,-0.1776849699328153,0.9249910317700631,0.972395834410662,1.0120354039192128,0.019429553688018242,40.27566836820228,21.545677774233766,18.817750012874605,16.089822251515443,17.289892843791417,0.5781966452870815,18.14701783657074,1.0966543845206556,17.67208863850393,18.242628102616322,-3.5467779217560573,-2.9730101592757743,545161000,0.6321618151442052,0.8929867514988328,-13015815000.0,-71.63253559210592,44.757923903640624,51.57585752245338,-81.85536441119471,15.383060123976888,26.387377511914945,-0.15062467949211403,1.3191334972994795,19.25941180038452,18.553793912887574,17.983500003814697,17.41320609474182,16.70758820724487,0.08,0.0,24.429529509643007,0.018520985596154338,-0.03734025955756094,17.18914576939174,18.045143944876536,1.2585314163455588
2022-05-19,1,17.120500087738037,16.187249898910522,21.07100009918213,17.491562604904175,19.36174976825714,-0.07854753393903932,1.1882927475682035,-0.6414935411503131,2.993682541753042,18.86899995803833,1.0171850061416627,0.06392210459849915,17.235824871063233,19.861899757385252,0.7241299385470285,-0.1739238803062023,0.9209669920367762,0.9696813595864961,0.9915960074852629,0.05765341207775676,37.403255331542766,20.966285490654133,18.58969999551773,16.213114500381327,17.2175714969635,0.5604279632246261,18.002160668373108,1.08809861679528,17.600867766784948,18.10449027093805,-0.6294065378889201,-9.900873701239489,621310000,0.6205817195871391,1.0206378925226294,-13637125000.0,-67.78397665086021,44.757923903640624,51.57585752245338,-80.19961397351396,14.57304732241313,25.716214427466195,-0.11466892425045498,1.2929766904455489,19.25941180038452,18.553793912887574,17.983500003814697,17.41320609474182,16.70758820724487,0.08,0.0,24.358979223775197,0.058670841565289455,0.02970567772311329,17.121949877057755,17.943636894226074,1.2259288540233555
2022-05-20,1,16.797750234603882,16.187249898910522,19.95099973678589,17.414125323295593,19.292749881744385,-0.27652504270061534,1.0831013047267952,-1.1932621386496414,2.99398702124813,18.672874927520752,0.9863324964046477,0.058889245291785734,17.115900087356568,19.567825078964233,0.7677427325455147,-0.14187257212123275,0.9133096134209348,0.9632041307999727,0.9624976801926005,-0.026429014958543773,37.32626741768907,20.558377604399116,18.392174994945528,16.22597238549194,17.178035804203578,0.5815662727884755,17.844160658972605,1.0911297338971746,17.47701795621478,17.97076822579506,-2.872052089633891,-10.590909511980332,739105000,0.5817286779271461,1.202840481012508,-14376230000.0,-76.68114970558035,44.757923903640624,51.57585752245338,-105.63520678034624,13.266583235069376,28.713893092740012,-0.056210628443428313,1.3188395990789101,19.25941180038452,18.553793912887574,17.983500003814697,17.41320609474182,16.70758820724487,0.08,0.0,24.270388345115077,-0.05715581664264824,0.03208644486710872,17.131080899919784,17.74112183707101,1.2438885441283214
2022-05-23,1,16.566500663757324,16.187249898910522,19.851999759674072,17.368124961853027,19.251750111579895,-0.15630053129785582,1.0741805096324362,-1.3330160922223768,2.9939900914385507,18.340750217437744,0.988112497329712,0.0589091980640496,17.046825098991395,19.49462480545044,0.7715851754932961,-0.14017530814743082,0.9085244612783285,0.9605773171292494,0.954233787427609,-0.04881793367074627,35.83361202355931,20.382873539101293,18.234512519836425,16.086151500571557,17.23221448489598,0.4832334131750313,17.635339294161117,1.0299541758742248,17.304272945268078,17.852888494484844,-1.6208372014360437,-11.636134557236462,639889000,0.5798762423538083,1.041515668170887,-15016119000.0,-72.4601584879494,44.757923903640624,51.57585752245338,-93.66264641898066,12.720431219558474,27.53181400667135,-0.05347169054623013,1.2772020445371257,19.25941180038452,18.553793912887574,17.983500003814697,17.41320609474182,16.70758820724487,0.08,0.0,24.19574677042171,-0.021200071023866562,-0.04563406625648283,17.234228951590403,17.548237119402206,1.206389821572789
2022-05-24,1,16.260249853134155,16.187249898910522,19.851999759674072,17.22043740749359,19.17162537574768,-0.0033894537166333184,1.089129182932539,-1.3633483317116049,2.9939171554784036,17.845374822616577,0.9915774631500245,0.06021937822622865,16.774625277519227,19.336099767684935,0.7809648061802568,-0.13900002532755945,0.8990504995214287,0.9480421288354421,0.9458582771250433,-0.09985331397335062,34.757936557468845,20.26428341316732,18.086025047302247,15.907766681437174,17.09028591428484,0.6061260360023971,17.378785729408264,0.8702910196923005,17.116996822179026,17.689280168123723,2.342898066164575,-14.999995596167805,588550000,0.579174088727915,0.9630160441860003,-15604669000.0,-86.53053936008389,44.757923903640624,51.57585752245338,-113.28034786331074,11.91782853806552,28.04648349647249,-0.015665330912542255,1.2658289781025123,18.89651150894165,18.260243677139282,17.745999813079834,17.231755949020386,16.595488117218018,0.08,0.0,24.124019327357605,-0.11129463749563817,-0.06429573807017534,17.012810843331472,17.25006444113595,1.2620323144349226
2022-05-25,1,16.52650022506714,16.187249898910522,19.851999759674072,17.109000086784363,19.044437885284424,0.1285858650323494,1.1242617895988083,-1.3040246402230367,2.993771086190829,17.571624755859375,1.008011223077774,0.06267840615065226,16.535875582695006,19.336099767684935,0.807560564381464,-0.12661476639730715,0.9213643147342471,0.9713043157009894,0.9819521433282176,-0.05054217737495792,33.70462250420224,20.18551111038277,17.93698753118515,15.688463951987528,16.963107313428605,0.6194603936979529,17.18182146549225,0.7016302191815577,16.902692778533527,17.50210202345795,-5.758168531850885,-18.09263525096318,781132000,0.5695087486361001,1.2493385502396732,-14823537000.0,-64.30924102246487,44.757923903640624,51.57585752245338,-72.82172896195047,14.09034980302093,26.27247253358981,0.06041685424855992,1.2547683590467933,18.580979427337645,18.00500961112976,17.539499759674072,17.073989908218383,16.498020092010496,0.08,0.0,24.03686150669256,0.002184579735638126,-0.06612749837111578,16.971580505371094,17.116742951529368,1.2722238482088761
2022-05-26,1,17.00024938583374,16.187249898910522,19.851999759674072,17.005312621593475,19.044437885284424,0.29017513009560814,1.1529755888448636,-1.3049981800980357,2.993652714284847,17.466625213623047,1.0235999488830565,0.06465608456990411,16.49987518787384,19.336099767684935,0.8128968048192957,-0.1445467972396018,0.9533329002231142,1.0023761419325832,1.0207723632066208,-0.00702378442732654,35.01046868134135,20.13838870486944,17.832437527179717,15.526486349489995,16.811142921447754,0.39373201160539384,17.058392882347107,0.5426394557477848,16.812094534683474,17.369912086160806,-5.111459853073352,-14.299417684501599,996575000,0.544024097844759,1.541376185264269,-13826962000.0,-18.544952787337753,44.757923903640624,51.57585752245338,-27.8674152299348,17.840797296066995,23.313588820592532,0.08798352554039054,1.3130060659463805,17.709256313323973,17.299872327804565,16.969000339508057,16.638128351211545,16.228744365692137,0.02,1.0,23.937827124615787,0.042455018245213916,0.05390253734414686,16.925071171351842,17.05796459742955,1.186909117226435
2022-05-27,0,18.494500637054443,16.187249898910522,19.851999759674072,16.949624598026276,18.798624753952026,0.4957307962003532,1.1135729390502456,-1.0539616103490734,2.9937749547553683,17.411500215530396,0.9560999882221217,0.06285513157456199,16.49987518787384,19.304599905014037,0.8227339193370995,-0.11218899689411513,1.0439139010861196,1.0852784005811926,1.112099971825455,0.10101057455629991,41.599932886834225,19.94364588620672,17.71650000810623,15.48935413000574,16.966607298169816,0.7349042951885563,17.128250070980616,0.6570429974382204,16.863380707328172,17.31230152915709,-5.888788398074765,-9.226704073068975,738379000,0.5613039549339989,1.121396354340648,-13088583000.0,-2.1122417647751157,44.757923903640624,51.57585752245338,65.98681453860333,21.18521454606838,21.986687372536778,0.16899858937306023,1.2927891726948064,18.0988964881897,17.615052469253538,17.224000453948975,16.832948438644408,16.34910441970825,0.04,0.0,23.8801028736373,0.12681229763651225,0.09851679354907861,17.192285537719727,17.190715653555735,1.197823386556886
2022-05-31,0,18.80050039291382,16.187249898910522,19.851999759674072,16.949624598026276,18.552937865257263,0.536223164429981,1.0801427627621607,-0.8831957458777029,2.9938848298481644,17.411500215530396,0.913590000867844,0.0610809193540337,16.49987518787384,19.304599905014037,0.7673371204302913,-0.02710449738847332,1.0631482132773464,1.0952603701019625,1.1078929511267293,0.1348504294599664,56.36762197734696,19.844085543358034,17.68380001783371,15.52351449230939,17.206607341766357,1.0146252743668327,17.21208941936493,0.7874830616266268,17.274176801264176,17.46654308246182,6.2520682918747195,5.5833108274034595,664100000,0.6660423865994773,1.0015857057838595,-12424483000.0,-14.533438579626443,44.757923903640624,51.57585752245338,80.43022157692441,21.972133104437955,20.92810251067854,0.1155408779983187,1.261158171821067,18.342612674713134,17.812194620132445,17.383500576019287,16.954806531906126,16.424388477325436,0.06,0.0,23.83062113828534,0.10498256981595988,0.11848568472636675,17.413132531302317,17.267541204180038,1.1446686872892566
2022-06-01,0,18.554749965667725,16.187249898910522,19.851999759674072,16.949624598026276,18.552937865257263,0.5452952363147555,1.0681959998690687,-0.8250969732796678,2.9939234440565805,17.411500215530396,0.8999887526035308,0.06044110223722497,16.49987518787384,19.304599905014037,0.7178816398938789,-0.03537708498211995,1.0498724389517755,1.072299554028832,1.0653608013372096,0.14111099972374075,57.794603121198705,19.809729518906995,17.673337519168854,15.536945519430713,17.457607303346908,1.1095122216250553,17.317821553775243,0.8633112006173793,17.659359255569953,17.645500749905825,9.812799255665569,6.658918459957756,544514000,0.6601668177796683,0.8169914855771702,-12968997000.0,-24.22243263314097,44.757923903640624,51.57585752245338,71.39116776167855,20.79136655089153,21.119509384685642,0.07878288447657407,1.2375731914206385,18.342612674713134,17.812194620132445,17.383500576019287,16.954806531906126,16.424388477325436,0.06,0.0,23.788856977544167,0.1340845009808429,0.08415179603288266,17.64510808672224,17.38809449332101,1.066162628022818
2022-06-02,0,18.925249576568604,16.187249898910522,19.851999759674072,16.949624598026276,18.509562969207764,0.5311316180723817,1.0063236416775028,-0.6546678700922159,2.9941170389340455,17.411500215530396,0.8392149639129641,0.05709127496565693,16.49987518787384,18.848850345611574,0.6531757758974348,-0.06534605126489512,1.0736770782493634,1.0906180376850556,1.0587374448616775,0.1451456339112307,54.538520648139766,19.639222312251338,17.626575028896333,15.613927745541329,17.79457143374852,1.1511728253103262,17.51339295932225,0.8969666452412548,17.88579498988639,17.75043360816016,10.459732443481444,8.669360007430779,648656000,0.6547954169804566,0.9732611847854269,-12320341000.0,-0.698768935584183,44.757923903640624,51.57585752245338,133.07578750022094,22.336693923137407,19.405382093066613,0.08081643613159216,1.250676226255484,18.707095630645753,18.142951723098754,17.686999797821045,17.231047872543336,16.666903964996337,0.08,0.0,23.74584881756679,0.15416759348862996,0.2128264589209405,18.029450280325754,17.63183961595808,0.9768583383978972
2022-06-03,0,18.914000034332275,16.187249898910522,19.283999919891357,16.949624598026276,18.509562969207764,0.2790152211938522,0.920457562555214,-1.1186276442607705,2.9943671314713796,17.411500215530396,0.7836099529266356,0.052357515734450195,16.49987518787384,18.812975311279295,0.6234410249808616,-0.018603523377569847,1.0758671498660652,1.080511344761751,1.0304521122514063,0.1125719161563159,59.10510289815189,19.421152644851485,17.580237519741058,15.73932239463063,18.173678602491105,0.9869241108717193,17.631982258387975,0.9670151077431239,18.141501115475158,17.876053514178462,14.238063672502271,16.914545057109184,598779000,0.6506202510590506,0.9002852506814021,-12919120000.0,-23.26605370539801,44.757923903640624,51.57585752245338,112.1866190834439,20.957357602169406,18.207060244930314,0.08232880054070438,1.2377697044769405,18.707095630645753,18.142951723098754,17.686999797821045,17.231047872543336,16.666903964996337,0.08,0.0,23.704492495388227,0.048680578878156355,0.10279797283925031,18.395531790597097,17.704171316964285,0.9689447237116003
2022-06-06,0,18.956499576568604,16.187249898910522,18.925249576568604,16.949624598026276,18.509562969207764,0.18891683156808917,0.8892163297729865,-1.247636504743347,2.9944535188837986,17.411500215530396,0.761409959793091,0.0506337330508268,16.49987518787384,18.811850357055665,0.654415232328158,0.00991819785249949,1.079420504325566,1.0719561566274207,1.0116715651701578,0.024980341377183635,60.62753102648544,19.34017018500908,17.561737525463105,15.783304865917131,18.520821366991317,0.6952422337464234,17.74196434020996,1.0263907417594653,18.329776603956606,17.979136676117207,16.32047603922034,9.622546991830806,422406000,0.6382151678240704,0.6453334339615493,-12496714000.0,-21.557979286210198,44.757923903640624,51.57585752245338,113.22174409871268,20.02630003039106,17.372432461711384,0.07475318274452493,1.204569399076497,18.707095630645753,18.142951723098754,17.686999797821045,17.231047872543336,16.666903964996337,0.08,0.0,23.675959837622987,-0.0013292442050658604,0.05237787460008018,18.653899874005997,17.812740189688547,0.9757260024666975
2022-06-07,0,18.64650011062622,16.187249898910522,18.956499576568604,16.949624598026276,18.509562969207764,0.2169788412184759,0.9054313777170647,-1.2379360180350878,2.994408853772546,17.411500215530396,0.7751049613952639,0.05152356727941908,16.49987518787384,18.91512498855591,0.7502090737365827,0.08220817975605287,1.0610789802733809,1.0417097345929134,0.9902444052920473,-0.00819128635244426,65.25908722943278,19.38401278223238,17.57315002679825,15.762287271364118,18.75600004196167,0.19002785502079336,17.783571481704712,1.0519379611396829,18.480262429021526,18.067407414159316,14.703653637541962,8.840622431850692,388914000,0.5696352397182876,0.6059949739598266,-12885628000.0,-17.934756720455653,44.757923903640624,51.57585752245338,84.79867032706012,19.038980646995963,18.798857505383953,0.14257774568865217,1.1765267703874263,18.707095630645753,18.142951723098754,17.686999797821045,17.231047872543336,16.666903964996337,0.08,0.0,23.64894950537241,0.013603336597989513,0.006113284664773993,18.807265962873185,17.866168567112513,1.0057723006794166
2022-06-08,0,18.790500164031982,16.187249898910522,18.956499576568604,16.949624598026276,18.57768750190735,0.09124705509725603,0.934910310100538,-1.407002268492154,2.9943273706815043,17.411500215530396,0.8318800163269046,0.053030565460798616,16.49987518787384,18.91512498855591,0.7885643221696611,0.05785244716810241,1.0658464648685788,1.037696264567865,0.9995265971897821,0.012705652126839384,60.2449316439599,19.49947065272137,17.629650032520296,15.75982941231922,18.798285688672745,0.15108237396336854,17.88244649342128,1.0784647664683595,18.520850134831086,18.093081331219874,9.683685735600424,3.2246455754216,363252000,0.5759912367442849,0.5841318032085665,-12522376000.0,-25.129371717578984,44.757923903640624,51.57585752245338,80.82120485109726,19.397846431892315,18.03811677508734,0.12989243701920525,1.1385581196853751,18.707095630645753,18.142951723098754,17.686999797821045,17.231047872543336,16.666903964996337,0.08,0.0,23.62440425326805,0.018119137963514387,-0.0010741145152752668,18.78457341875349,17.988429478236608,1.0274190898438362
2022-06-09,0,18.37575054168701,16.187249898910522,18.956499576568604,16.949624598026276,18.68250012397766,-0.01228906844128999,0.9685296741681063,-1.5324626226705391,2.9942316748215214,17.411500215530396,0.8955962502956389,0.054756816406296864,16.49987518787384,18.91512498855591,0.7956908007711255,0.10050075092531459,1.0388918642098532,1.0008074503226287,0.9750193349219987,-0.029035233203049904,63.773501709565444,19.624896913281432,17.68783756494522,15.750778216609007,18.737607138497488,0.2197396727562785,17.972107240131923,1.062303779114392,18.587550561907655,18.127114902961043,1.6004732043669923,7.952604173971892,395574000,0.5581481590976478,0.6504687226238633,-12917950000.0,-40.65733444529539,44.757923903640624,51.57585752245338,42.43660774088468,18.29521027361617,20.160812131023903,0.150146407931092,1.120945768999481,18.707095630645753,18.142951723098754,17.686999797821045,17.231047872543336,16.666903964996337,0.08,0.0,23.59551101761668,-0.07861280692134287,-0.014638886511359374,18.696094240461075,18.054613385881698,0.9943520069619682
2022-06-10,0,17.285000324249268,16.187249898910522,18.956499576568604,16.949624598026276,18.68250012397766,-0.18345990922397634,0.9688491460267573,-1.5075178220991696,2.994237012025173,17.74037528038025,0.8993250250816345,0.05457413387296303,16.49987518787384,18.91512498855591,0.7789942357406769,0.13519903976547526,0.9736437561598851,0.9320144554355936,0.9225235164994998,-0.08612666316623052,60.49505510023676,19.690598379886914,17.752900087833403,15.81520179577989,18.556214332580566,0.5966600796062423,18.006910817963735,1.0283072213621398,18.53615474810403,18.12920978886626,-2.259247585702033,7.331856239690125,465248000,0.52348847357755,0.7806661103120773,-13383198000.0,-68.89811731908941,44.757923903640624,51.57585752245338,-51.80564456816441,16.925717766962304,26.09275126472218,0.1243236767132057,1.1250927948972806,18.7129955406189,18.15250157737732,17.69949960708618,17.246497636795045,16.686003673553465,0.02,1.0,23.5545133862141,-0.09307755900414594,-0.13344280753061596,18.504577091762,18.074842589242117,0.9390892690469461
2022-06-13,1,15.891250133514404,16.260249853134155,18.956499576568604,17.090437412261963,18.68250012397766,-0.154977325748144,0.9077662207310536,-1.486785589392732,2.994428720534723,17.74037528038025,0.8444375038146973,0.050975800063291214,16.562500619888304,18.91512498855591,0.815196284629935,0.0018112281164111965,0.8923764412707548,0.8555492606199877,0.8631459172016026,-0.16169912755638893,43.16044218951413,19.623320050562448,17.80778760910034,15.992255167638232,18.122785840715682,1.1392135351234969,17.9586786372321,1.1133827371967915,18.228285379808675,18.008702174614513,-6.843259239644316,2.900686596956511,604153000,0.5385705616335127,1.0194117543337018,-13987351000.0,-98.97831121440802,44.757923903640624,51.57585752245338,-138.60216358197667,15.477969008928223,31.757909858087412,0.04221761651280756,1.1424442892867783,18.671931591033935,18.08603365898132,17.612499713897705,17.13896576881409,16.553067836761475,0.04,0.0,23.49114623542824,-0.1669163248819605,-0.1639791514756278,17.942231042044504,17.98584066118513,1.0615162284212445
2022-06-14,1,15.761250019073486,15.891250133514404,18.956499576568604,16.949624598026276,18.68250012397766,-0.2620471513546413,0.9938341916647124,-1.3601358984932899,2.9941539063616753,17.74037528038025,0.9125624895095825,0.05602328594194693,16.49987518787384,18.91512498855591,0.7228926135901631,-0.08758811258073898,0.888475184318236,0.8606120972201339,0.8855729243732495,-0.15473413640281453,31.687234542074478,19.727331006734882,17.739662623405458,15.751994240076035,17.672392981392996,1.3734203237579434,17.923035791942052,1.1780466549696218,17.646427538804637,17.697492962120062,-16.031489734278598,-4.075999777793577,469680000,0.6200444343551043,0.7959863766477446,-14457031000.0,-89.92154118492729,44.757923903640624,51.57585752245338,-127.52352842699726,14.825108792566898,31.669573333856253,0.07792151123052964,1.1075537335555021,18.62614753341675,18.011925565719604,17.515499591827393,17.01907361793518,16.404851650238037,0.06,0.0,23.442067543954273,-0.16309047242637986,-0.1568534585914722,17.53125967298235,17.963395731789724,1.141254558231864
2022-06-15,0,16.353999853134155,15.761250019073486,18.956499576568604,16.739937841892242,18.68250012397766,-0.2771015291564163,1.0822878101213953,-1.3960172930434687,2.99384112443608,17.735125064849854,0.9953375101089478,0.06129550317516857,16.22334988117218,18.91512498855591,0.7698316606648606,-0.12747730813177874,0.9262107921293629,0.9080472908972466,0.9496682565234934,-0.1296666022526467,28.714246503911433,19.82146322304888,17.65688760280609,15.492311982563299,17.300607306616648,1.3190500932711946,17.91071433680398,1.1945632516607052,17.175460244640945,17.41109672992781,-16.668869670804625,-3.0688325122168214,563936000,0.5958633339080684,0.9575023602819621,-13893095000.0,-73.49653474133478,44.757923903640624,51.57585752245338,-74.59716546856086,19.031370138625757,29.55135873283883,0.06772937404599973,1.1021567649705961,18.62614753341675,18.011925565719604,17.515499591827393,17.01907361793518,16.404851650238037,0.06,0.0,23.38902589099471,-0.11373864879554663,-0.1265721283098693,17.20947551727295,17.931687695639475,1.1634203444059585
2022-06-16,1,15.700999975204468,15.761250019073486,18.956499576568604,16.556500554084778,18.68250012397766,-0.10594712950239121,1.1138336704855463,-1.5453570975778406,2.9937166982750543,17.345625162124634,1.031576269865036,0.06338905592090133,16.22334988117218,18.91512498855591,0.82966017475061,-0.06045243213591927,0.8935549281863998,0.8825744769952427,0.9383002197173343,-0.14555871121642816,37.91134518072042,19.799054929948905,17.571387588977814,15.343720248006722,16.87982157298497,1.2875849894783382,17.817910807473318,1.3151213430695936,16.96626429007754,17.23667501532232,-13.728798995418424,-1.0437804107571276,545749000,0.6019939787299763,0.9265765476297296,-14438844000.0,-95.25842022404792,44.757923903640624,51.57585752245338,-112.5006312106386,17.644662799674293,30.795430029919654,0.09646833581424148,1.103859953543313,18.623551609039307,18.007723688125612,17.509999752044678,17.012275815963747,16.39644789505005,0.08,0.0,23.332687972944143,-0.1355829450876852,-0.1633955988189136,16.735580580575125,17.771423271724156,1.2393849234186185
2022-06-17,1,15.71274995803833,15.700999975204468,18.956499576568604,16.483375132083893,18.68250012397766,-0.06762520988584131,1.1861322529603555,-1.6102351926748688,2.9934256261812417,17.202750205993652,1.108312520980835,0.06783276723738631,15.878250122070312,18.91512498855591,0.8114853690529537,-0.08291230427026118,0.8985838703085071,0.8995381380732121,0.970012649247366,-0.09096038974354048,33.75272846121994,19.85838959365875,17.48612508773804,15.11386058181733,16.440142972128733,1.0251335849985588,17.61921433040074,1.4116351199788348,16.643643626180832,17.016925060637735,-15.796530812466939,-7.642531477873103,630334000,0.6148392070558735,1.0693663756449379,-13808510000.0,-87.13586293757956,44.757923903640624,51.57585752245338,-97.14237601150566,16.860929806063123,29.913701074185138,0.1409926495100287,1.0726544420792963,18.60632361984253,17.979837705612184,17.47349977493286,16.96716184425354,16.340675930023192,0.1,0.0,23.269349982805466,-0.0644513171636939,-0.12012404111215913,16.340597016470774,17.56258521761213,1.2912004378790203
2022-06-21,0,16.613999843597412,15.700999975204468,18.956499576568604,16.330562353134155,18.68250012397766,-0.031573629719539635,1.2459992800737318,-1.68019125763111,2.9931681315647185,17.142624855041504,1.1716612768173218,0.07154444503200208,15.756400012969971,18.91512498855591,0.8314570145507537,-0.06459199960780568,0.9539647555025944,0.9688904052804239,1.04595489540548,0.04548098507107001,34.45992235687986,19.907736141400516,17.41573758125305,14.923739021105586,16.188464300973074,0.5980032993742258,17.46303571973528,1.3917010355463342,16.405729882937095,16.85315717603463,-16.379288359151598,-15.040961276038828,483089000,0.612268461986992,0.8377574122886082,-13325421000.0,-71.14891434243246,44.757923903640624,51.57585752245338,-44.38210844949219,22.32012796483221,27.67493280416162,0.11576307464370375,1.0766077896724058,18.60632361984253,17.979837705612184,17.47349977493286,16.96716184425354,16.340675930023192,0.1,0.0,23.227396084287857,0.05873334483725645,-0.024036555606703466,16.12912109919957,17.412607669830322,1.2954676919064854
2022-06-22,0,16.35700035095215,15.700999975204468,18.956499576568604,16.330562353134155,18.68250012397766,-0.016283353006930214,1.2511888536096,-1.6973000948106738,2.993144950165046,17.142624855041504,1.1799300444126128,0.07188034671858505,15.756400012969971,18.91512498855591,0.8518478033326663,0.002867182442699094,0.939703749046759,0.9671144586283096,1.0204884033902317,0.037798418980583115,45.831561318425955,19.908927768921927,17.406550061702728,14.904172354483526,16.055892876216344,0.3760838885897457,17.306053604398453,1.3830089798684537,16.455753400395462,16.874839439897325,-9.587367297422288,-11.630012518924921,437135000,0.6465778827086388,0.7716311030166842,-13762556000.0,-75.94964616699993,44.757923903640624,51.57585752245338,-57.90895505002607,21.577017110331045,28.321499457564023,0.05420160842947046,1.0341344026917474,18.60632361984253,17.979837705612184,17.47349977493286,16.96716184425354,16.340675930023192,0.1,0.0,23.188406461005542,0.03308911769647871,0.04556786139058024,16.04150594983782,17.27304152079991,1.3133022602338347
2022-06-23,0,16.295499563217163,15.700999975204468,18.956499576568604,16.330562353134155,18.68250012397766,-0.005133802866356452,1.2590303418351962,-1.7158019981284995,2.9931099652597166,17.142624855041504,1.189357558488846,0.07237439126363004,15.756400012969971,18.91512498855591,0.837786625858241,0.00595012368763476,0.9367342644860331,0.9766995489506489,1.0091498547517,-0.0035771242779961687,44.21569927345486,19.914135729732866,17.39607504606247,14.878014362392074,16.11364279474531,0.3776226749108814,17.118214317730494,1.3234783252530737,16.430353692602953,16.904891320044868,-5.368816638060576,-11.844673837061249,463680000,0.6454325954292999,0.8276094717805036,-14226236000.0,-77.62533419637413,44.757923903640624,51.57585752245338,-68.3341023269544,20.462799480685756,29.16583753459807,0.05992013806036289,1.012552657541936,18.39087593460083,17.805561960220338,17.332499980926514,16.85943800163269,16.2741240272522,0.1,0.0,23.146451120301744,-0.01827302808116449,0.024564390071944345,16.12398488180978,17.03310796192714,1.3095569774792555
2022-06-24,0,16.768999576568604,15.700999975204468,18.956499576568604,16.339374780654907,18.68250012397766,-0.006032546121420368,1.2574627913119243,-1.7133078737980825,2.99311696653612,17.142624855041504,1.1877713215351104,0.07227695907783856,15.756400012969971,18.91512498855591,0.8446944377375515,-0.013977591063085297,0.9638553955997662,1.0203379740584715,1.0392258105788454,0.06802111986820947,42.89005540875404,19.91276311419047,17.39783753156662,14.88291194894277,16.257607017244613,0.41146592999064974,16.964999999318803,1.219684486904945,16.3989980691521,16.932690862243042,2.543849139031566,-13.89545750882641,472153000,0.6425958348524031,0.8666294797521289,-13754083000.0,-55.15092390325664,44.757923903640624,51.57585752245338,-32.792786211996784,23.07518636999362,27.27017458743845,0.04935204790502787,1.0055843378528728,18.39087593460083,17.805561960220338,17.332499980926514,16.85943800163269,16.2741240272522,0.1,0.0,23.10813131162501,0.09775030400056783,0.036243693213794635,16.3080632346017,16.919661453792028,1.307064825862042
2022-06-27,0,17.034249782562256,15.700999975204468,18.956499576568604,16.339374780654907,18.68250012397766,-0.02467048429950652,1.2501504230662384,-1.6911442360826408,2.993149729356634,17.142624855041504,1.1768588507175444,0.07180661205490078,15.756400012969971,18.91512498855591,0.8652015724869625,-0.01360273040805134,0.9784196711165829,1.0467107853864008,1.041872451704687,0.0841036628249705,47.1383723854398,19.910263345274167,17.40996249914169,14.909661653009215,16.354785578591482,0.5072149389673182,16.827696442604065,1.0782459563653628,16.49509618717441,16.994295218582568,6.393842850507342,-11.340808152004412,427968000,0.642585921604415,0.8287770586652458,-13326115000.0,-59.994825599172096,44.757923903640624,51.57585752245338,-26.574626228631253,23.27517676342034,25.876597946106408,-0.03478919294150262,0.9840420537044207,18.27092824935913,17.70853621482849,17.254000186920166,16.79946415901184,16.2370721244812,0.02,1.0,23.074254851722714,0.06227953010030385,0.0812769309008392,16.356865201677596,16.78317035947527,1.3098777142451563
2022-06-28,0,16.50724983215332,15.700999975204468,18.956499576568604,16.339374780654907,18.68250012397766,-0.028380172266486068,1.2496151210410351,-1.688925963586938,2.9931522138844744,17.15962505340576,1.1753288328647613,0.07176885720585252,15.756400012969971,18.91512498855591,0.8879184965085479,-0.07895594929265183,0.9480570746280534,1.0158932813137806,0.9935776866813425,-0.0064253047098246086,45.923674905029735,19.910892761060186,17.41166251897812,14.912432276896052,16.469964129584177,0.4176419936233987,16.67489285128457,0.9438766450325966,16.63472534212056,17.08514642055836,4.1595324418309465,-10.140320401675668,461149000,0.5416142566999486,0.9176666282936647,-13787264000.0,-83.02180056769862,44.757923903640624,51.57585752245338,-53.493869279359274,21.192717177653297,28.408634385968597,-0.13922858399808202,1.0035395347332214,18.27092824935913,17.70853621482849,17.254000186920166,16.79946415901184,16.2370721244812,0.02,0.0,23.03483921780521,-0.03525306938955708,0.006423027085992648,16.411232539585658,16.573406560080393,1.3030838214113383
2022-06-29,0,15.5864999294281,15.700999975204468,18.956499576568604,16.339374780654907,18.68250012397766,0.1591615866834807,1.2385217932022752,-1.6438995284913678,2.993180059249314,16.90162467956543,1.1465350532531737,0.07153999149296811,15.756400012969971,18.91512498855591,0.8576743085465718,-0.12197816615694215,0.9003136468623473,0.95560556009274,0.9393645418734349,-0.047105239652281194,39.651785443204076,19.789343565137614,17.312299978733062,14.83525639232851,16.451928411211288,0.4566924002056027,16.44603569167001,0.7624498485900487,16.603656148774668,17.042837725804944,5.135022343940569,-11.472663855314005,482352000,0.5425624295474262,0.9775370080884849,-14269616000.0,-90.11427870501025,44.757923903640624,51.57585752245338,-96.41025669946858,19.950916110346245,32.33657255284194,-0.1184156570176612,0.9898578416585094,18.04493244934082,17.495534378051758,17.05150032043457,16.607466262817383,16.05806819152832,0.02,1.0,22.98880879223298,-0.05000004085108922,-0.06181341085356204,16.363001005990164,16.35179901123047,1.313233135088813
2022-06-30,0,15.237250328063965,15.5864999294281,18.956499576568604,16.194437205791473,18.57768750190735,0.32774400286656025,1.243500704326067,-1.5136237635511736,2.9931215737100696,16.691499710083008,1.1235450649261474,0.07250056598498571,15.711574959754945,18.91512498855591,0.8209323335937116,-0.1599725160259149,0.8883865276443568,0.9351950870643895,0.9269246325421181,-0.06494119625162764,32.88493071259438,19.638601364210913,17.151599955558776,14.66459854690664,16.255249908992223,0.6363707454870021,16.22185710498265,0.5942717030552715,16.350435107362244,16.839273223631405,-0.8034877977908793,-17.051170573611714,686070000,0.5709443393261974,1.3707312994435619,-14955686000.0,-89.52381208680421,44.757923903640624,51.57585752245338,-107.16985309864626,18.914627428735283,32.926181803226655,-0.09627358204870202,0.9695104092603691,17.027940494537354,16.614030488967895,16.279500484466553,15.94497047996521,15.531060474395751,0.04,0.0,22.92158516501263,-0.06570120883770225,-0.0734107496490016,16.162227085658483,16.145674092429026,1.3495028576327146
2022-07-01,1,14.719249963760376,15.237250328063965,18.956499576568604,15.858750104904175,18.443437933921814,0.4647921303125466,1.266323307578563,-1.2918578913652852,2.9929810957365506,16.560624837875366,1.1041950321197511,0.07455220837149325,15.689549970626832,18.91512498855591,0.7901421940720561,-0.19487189500902324,0.866565894983559,0.909637272432858,0.907092261514868,-0.12223446028780105,29.32975403086287,19.518371588835716,16.98572497367859,14.453078358521461,16.021285567964828,0.8559180104305693,16.038589222090586,0.6353920789112987,16.07645700665666,16.621639971419594,-8.28668308952711,-17.079575642383052,577610000,0.5584813854096318,1.1622830780369227,-15533296000.0,-95.54119886416015,44.757923903640624,51.57585752245338,-132.22822270301808,17.82957672005827,34.552587684469266,-0.19516669050950644,0.9550451048861222,16.63663198852539,16.207684028625486,15.861000061035156,15.514316093444824,15.085368133544922,0.06,0.0,22.86201210218385,-0.15199117925407657,-0.10490002065433644,15.900093623570033,15.970799786703926,1.302944981732568
2022-07-05,1,14.541249990463257,14.719249963760376,18.956499576568604,15.749125003814697,17.557687878608704,0.4974275883632725,1.2759726884725076,-0.9479090976988576,2.9928704904879138,16.432125091552734,1.057452558279038,0.07606201863750324,15.551574969291687,18.80285015106201,0.7587451079708887,-0.22178016617096763,0.8668185751775525,0.9041224544921258,0.9193489255558158,-0.14635219184416626,26.368773261558037,19.327370369983196,16.77542499303818,14.223479616093162,15.77067848614284,1.00592067884263,15.942160640444074,0.7513340745118073,15.74268623533738,16.3454872284302,-10.012535012854226,-14.843797005253043,651397000,0.5612056552083639,1.3038567736562072,-16184693000.0,-72.24428858217293,44.757923903640624,51.57585752245338,-124.87540011560515,16.604502203010377,34.706348648385045,-0.09931319706854162,0.9522560750641464,16.55710001373291,16.07895006942749,15.692500114440918,15.306050159454344,14.827900215148924,0.08,0.0,22.79588350627462,-0.11292908917719824,-0.12624090519459794,15.720152854919434,15.922068868364606,1.2665727599476786
2022-07-06,1,15.062000036239624,14.541249990463257,18.956499576568604,15.709812462329865,17.09693741798401,0.5169570715920594,1.265387561621576,-0.6231296683332195,2.99284365537468,16.355500102043152,1.0017199993133545,0.07642711862559613,15.185450291633606,18.660900115966797,0.7383054386746352,-0.23291481469304945,0.9097175430057514,0.9433723032614725,0.9832683801474459,-0.08755242760660198,25.256210166647666,19.08756261408788,16.556787490844727,14.026012367601572,15.526821408952985,0.927413491009496,15.892214213098798,0.7866954541037567,15.445652979548786,16.0597280324138,-10.765239604643154,-8.495241920608988,529066000,0.55791154969872,1.0478101272177902,-15655627000.0,-67.17557451968294,44.757923903640624,51.57585752245338,-92.42132798988432,18.618558609926236,33.28143219717239,-0.06543618444290265,0.9220944557498753,16.55710001373291,16.07895006942749,15.692500114440918,15.306050159454344,14.827900215148924,0.08,0.0,22.74566116969971,-0.05330993397169603,-0.10308854217074086,15.435330527169365,15.871696880885533,1.182265120832854
2022-07-07,1,15.661999940872192,14.541249990463257,18.790500164031982,15.672374963760376,16.835312128067017,0.616521653416773,1.1777420924957718,-0.32171319017835565,2.9931743041238863,16.32474970817566,0.9125750064849854,0.07198005089519806,15.0277250289917,18.402825498580935,0.7472388439680807,-0.19223447044326944,0.9572142832014954,0.9905808803041112,1.0421012285505453,0.004843936213129174,33.42180584564723,18.717546698819824,16.362062513828278,14.006578328836733,15.330785717282977,0.6630105186330295,15.84278564793723,0.7771305532651513,15.348737486694612,15.864602230764937,-10.179495398844052,-4.436513487113424,492903000,0.582142138190439,0.9662398365576744,-15162724000.0,-44.94657384817967,44.757923903640624,51.57585752245338,-38.477542101022536,22.323116539915215,31.16267659337682,-0.06274810183663823,0.9144446992968976,16.55710001373291,16.07895006942749,15.692500114440918,15.306050159454344,14.827900215148924,0.08,0.0,22.703381919298085,0.020332048725215657,-0.0077586005019985175,15.291064534868513,15.823964868273054,1.0153076268119785
2022-07-08,1,15.673500299453735,14.541249990463257,18.790500164031982,15.64312493801117,16.65274977684021,0.7528567639156468,1.0622523037855278,0.2913203811321545,2.993616401573208,16.093374848365784,0.8253874778747559,0.065519209912245,15.0277250289917,17.394075345993045,0.6809103451719857,-0.16649371734916557,0.9667339411926393,0.99568497799055,1.0418197027724196,0.02863049185365707,40.64071170508305,18.337342112911628,16.212837505340577,14.088332897769524,15.211678641183036,0.46035813759931726,15.840821385383606,0.7775511358040499,15.426556955894483,15.790942997859915,-8.0558278715322,-4.231380203475695,467972000,0.6043385134019722,0.9080471568564864,-14694752000.0,-45.55724579990127,44.757923903640624,51.57585752245338,-28.397131782354506,21.903088540440148,29.551788358059017,-0.021700396255551004,0.8954127032903394,16.55710001373291,16.07895006942749,15.692500114440918,15.306050159454344,14.827900215148924,0.08,0.0,22.663846638633185,0.04479179728928062,0.01904514721289592,15.270516395568848,15.840874467577253,0.8333114339515756
2022-07-11,1,15.310750246047974,14.541249990463257,18.37575054168701,15.64312493801117,16.533937335014343,0.5874406088664734,0.8868019668958216,0.4403676156130256,2.994221128449815,15.826250076293945,0.7078862059116364,0.05522841480862544,15.0277250289917,17.05932483673096,0.5928929686896276,-0.14705523108310506,0.9535256992944157,0.9764991750126925,1.0118394749625719,0.04018549068355415,41.653167181163944,17.830591445903305,16.056987512111665,14.283383578320024,15.172285829271589,0.43398143556306057,15.812107120241437,0.7899681098825992,15.48477883830173,15.739799717383269,-5.050808227761734,-0.1751460148663194,437321000,0.6025471819684006,0.8451492492244393,-15132073000.0,-66.50380916494225,44.757923903640624,51.57585752245338,-74.10621404076929,20.494551223442205,30.47287917925708,-0.006543798101511493,0.888597429720687,16.55710001373291,16.07895006942749,15.692500114440918,15.306050159454344,14.827900215148924,0.08,0.0,22.6245780523413,0.04331071993798297,-0.00046172305774170013,15.214865003313337,15.788933004651751,0.7070036692841872
2022-07-12,1,15.164499759674072,14.541249990463257,17.285000324249268,15.517562508583069,16.39456272125244,0.02414169792950194,0.7224559259612088,-0.6901240900298751,2.994700031913823,15.736999988555908,0.598609914779663,0.04542680147245334,15.0277250289917,16.79552459716797,0.5936384549634717,-0.11421753203160792,0.9535179867135156,0.9762511572224067,0.9943999408280295,0.042860811114558084,40.765920426462884,17.34864934925213,15.903737497329711,14.458825645407293,15.161892890930176,0.43303646172216254,15.7085713999612,0.7715585280488484,15.434259902700724,15.655893643033759,-1.7691571849270509,-2.558430020613301,458483000,0.5628515009351183,0.8866256695867417,-15590556000.0,-68.6412337955426,44.757923903640624,51.57585752245338,-81.83084660461472,19.556640439018636,30.408285403267026,0.0155048979832783,0.8646972997996693,16.55710001373291,16.07895006942749,15.692500114440918,15.306050159454344,14.827900215148924,0.08,0.0,22.583251754144012,0.007885734403718425,0.03849076261404487,15.203877449035645,15.683052267347064,0.6801662559805177
2022-07-13,1,14.898499965667725,14.541249990463257,17.034249782562256,15.292375266551971,16.354749977588654,-0.002982688987389187,0.6653048400040237,-0.7958431569105295,2.9948448616351757,15.706874966621399,0.5440549182891846,0.04211399854917641,15.0277250289917,16.62949981689453,0.7338111852197541,-0.04573273768484876,0.9430795752744573,0.9708124161818819,0.9690364863334751,-0.010855136779877372,42.75641505452614,17.128322149109003,15.797712469100953,14.467102789092904,15.187500034059797,0.40701688227376687,15.604392801012311,0.7757251895501218,15.362669343745885,15.597612044156486,-0.47745207844948634,-8.724570227331126,521918000,0.4743652824077227,1.0173874862146215,-16112474000.0,-66.13742346580722,44.757923903640624,51.57585752245338,-88.16781288012223,18.092015628239047,31.52165249620072,0.0949536928496707,0.8679332345827502,16.55710001373291,16.07895006942749,15.692500114440918,15.306050159454344,14.827900215148924,0.08,0.0,22.53595624860267,0.002247287154683919,0.013365520681462444,15.295345987592425,15.59771980558123,0.6940377120624938
2022-07-14,1,15.170249700546265,14.541249990463257,17.034249782562256,15.219062685966492,16.354749977588654,0.10324112791405513,0.6929345852796762,-0.9863777653707135,2.9947650582957666,15.687250137329102,0.5707649135589599,0.04400122472165933,14.88057496547699,16.62949981689453,0.7355543517908163,-0.05473868204372776,0.9633081972492495,0.9989924404862174,0.9888148859933279,-0.031397665826995436,40.212757117934565,17.133944131267963,15.748074960708617,14.36220579014927,15.277357135500226,0.29442452885191706,15.524017810821533,0.7566705478799393,15.246575879456968,15.548135442326721,1.2177930420957064,-8.916673925482455,456235000,0.4767159814619114,0.8905169755194935,-15656239000.0,-59.78627209685485,44.757923903640624,51.57585752245338,-59.97781440506643,17.78617982597553,29.56923878002755,0.11393408966819964,0.8591521840065424,16.55710001373291,16.07895006942749,15.692500114440918,15.306050159454344,14.827900215148924,0.08,0.0,22.49612218729904,-0.03064707166867764,0.015994717521627132,15.35356616973877,15.536859512329102,0.6994095068702906
2022-07-15,1,15.661999940872192,14.541249990463257,17.034249782562256,15.168812215328217,16.354749977588654,0.1966784290022191,0.7042517720896465,-1.067622550323468,2.99473088175615,15.667750120162964,0.5901324188709257,0.044803935137910124,14.88057496547699,16.62949981689453,0.7588561633354315,-0.07238291324559547,0.9964039244071163,1.0342100820628564,1.0274543213009697,-0.0007337453894675772,42.216374653266556,17.127028488961553,15.718524944782256,14.31002140060296,15.363071407590594,0.3082903586936268,15.44494640827179,0.6693671863283132,15.227022159749414,15.526315139643785,4.325623385166553,-6.905279941284257,385935000,0.4591654255368185,0.766617215501108,-15270304000.0,-47.877863280069256,44.757923903640624,51.57585752245338,-2.406379109973078,19.82504040306945,28.522210932071054,0.13427038994167956,0.8270695449100381,16.55710001373291,16.07895006942749,15.692500114440918,15.306050159454344,14.827900215148924,0.02,1.0,22.464917324040282,-0.004798578113342944,-0.006053783432521878,15.443750381469727,15.439540454319545,0.6749958387093289
2022-07-18,1,16.325500011444092,14.541249990463257,17.034249782562256,15.168812215328217,16.31087476015091,0.32153938111393493,0.6890150467450549,-0.8776662541362192,2.9947711885985453,15.661999940872192,0.5519349288940429,0.04393128945580391,14.88057496547699,16.62949981689453,0.794848595150521,-0.0024839204123218595,1.040906537384886,1.0750079036675904,1.0711426983696573,0.06627694587716548,51.362549365361865,17.061955042659267,15.683924949169159,14.30589485567905,15.457857131958008,0.47333530861311107,15.394321424620491,0.5573488466138321,15.333462574963077,15.536468146305108,3.9835340803940418,-6.601464986875106,670517000,0.4527637374367666,1.3156050643918884,-14599787000.0,-34.98570245840135,44.757923903640624,51.57585752245338,70.33909144579195,27.31222140483011,25.79879438305772,0.09535314476332143,0.8490647353063152,16.459307815551757,15.999845909118651,15.628499984741211,15.257154060363769,14.797692153930662,0.04,0.0,22.41665155325904,0.06263191430050585,0.01660567722632757,15.478425570896693,15.384745052882604,0.6800628401275626
2022-07-19,1,16.690000534057617,14.541249990463257,17.034249782562256,15.168812215328217,16.333375096321106,0.2072844667761034,0.7030882477355745,-1.0565506055495282,2.9947339117761254,15.661999940872192,0.5896449303627012,0.04473951886737669,14.88057496547699,16.62949981689453,0.7619210367060267,0.03899699639096535,1.062032534599876,1.0875072234443401,1.0806681279609798,0.10059684121201329,58.95833969519392,17.121326446452283,15.71514995098114,14.308973455509994,15.603071451187134,0.6668761609630649,15.407375046185084,0.5867826051717507,15.583302727947185,15.650404718192783,4.236368746499625,-4.160733699253971,702366000,0.47657319425669975,1.3684250825522324,-13897421000.0,-3.862521071361676,44.757923903640624,51.57585752245338,103.03874266241003,26.792750658042856,23.637960014139498,0.10566017146708044,0.8604888394876505,16.38902053833008,15.942990493774413,15.582500457763672,15.222010421752929,14.775980377197264,0.06,0.0,22.37037437914221,0.1266410725085798,0.12143613999412244,15.643097605024066,15.456807000296456,0.7357792410232075
2022-07-20,1,17.372000217437744,14.541249990463257,17.034249782562256,15.168812215328217,16.39456272125244,0.09885894872433078,0.7344807229267333,-1.265823521121889,2.9946478417168843,15.661999940872192,0.6480399656295777,0.046592244447200885,14.88057496547699,16.697900438308714,0.7573683735942038,0.0045744968806830525,1.1020037087459769,1.116316141916597,1.1030366642078662,0.16602344245863554,60.4100859618924,17.23297392563557,15.764012479782105,14.295051033928639,15.897535732814244,0.9224094974016691,15.534910781042916,0.788183451064755,15.864795873215058,15.806798959778257,6.485470476810529,1.1070935725969904,760538000,0.43862132333404613,1.442767212557461,-13136883000.0,-3.249132274471285,44.757923903640624,51.57585752245338,164.1518931971832,31.011740996072277,21.465723108367452,0.1805352854029895,0.8798826510282555,17.017792503356933,16.451604465484618,15.994000434875488,15.536396404266355,14.970208366394042,0.08,0.0,22.327743491432027,0.17429407557395704,0.18067860939730074,16.02195589882987,15.618410451071602,0.8482678292122992
2022-07-21,0,17.905999660491943,14.541249990463257,17.372000217437744,15.168812215328217,16.39456272125244,0.28821698852934263,0.7944701525069282,-1.0283221432326082,2.9944734667242514,15.661999940872192,0.6935199880599974,0.0502768353250687,14.88057496547699,16.79552459716797,0.7295529443772985,0.0620529341999135,1.1331539560303856,1.133800606009123,1.1023180674248405,0.18033651482000113,67.40920162925522,17.390852803487977,15.80191249847412,14.212972193460264,16.289178575788224,1.1201140180860067,15.7255357333592,1.0038679616540758,16.244138773146403,16.0082089674346,13.462762688078087,11.455428069765224,557049000,0.45886250208997476,1.0448571944657077,-12579834000.0,-2.2988478939161197,44.757923903640624,51.57585752245338,172.6994286501761,31.221408802041463,20.397554807507266,0.22472779400202775,0.859819381649965,17.178995384216307,16.582001560211182,16.099499702453613,15.616997844696044,15.020004020690916,0.1,0.0,22.299541666547793,0.17421294901418727,0.19031916447560582,16.44547884804862,15.824678148542132,0.9759577865173855
2022-07-22,1,17.578999519348145,14.541249990463257,17.905999660491943,15.168812215328217,16.552937507629395,0.5386628459143674,0.9116673401751167,-0.6775052202033369,2.994099167519239,15.661999940872192,0.7864599466323853,0.057412087056061524,14.88057496547699,17.068024826049804,0.7408200624883718,0.09883097422248188,1.1070343383908203,1.0975007949221014,1.0469236347272386,0.12239813470266148,71.40873467248387,17.702697144301347,15.87936246395111,14.056027783600875,16.672107083456858,1.0190799655390657,15.929803558758326,1.0719975470204088,16.66316843141984,16.262871091888623,18.078406437831575,17.514638632094115,536671000,0.47014138135734884,0.9997901389135082,-13116505000.0,-20.176060132110393,44.757923903640624,51.57585752245338,118.57199900397237,28.863773288792846,22.23180503951906,0.1944254651882614,0.8636180317960944,17.178995384216307,16.582001560211182,16.099499702453613,15.616997844696044,15.020004020690916,0.1,0.0,22.2700269990475,0.09878199015789035,0.12665900110287973,16.752989768981934,16.02416787828718,1.0225131443971356
2022-07-25,1,16.953999996185303,14.541249990463257,17.905999660491943,15.168812215328217,16.709750294685364,0.49159362713784466,0.9812230686919047,-0.9750627483216303,2.9938552256855266,15.661999940872192,0.8634699440002442,0.06154362361837684,14.88057496547699,17.392700147628783,0.8033081285655433,0.04830341482692608,1.0633775620279595,1.046036336878268,0.9871611987238328,0.03849805422808705,65.46685357524588,17.90598359914147,15.94353746175766,13.981091324373851,16.926928554262435,0.7746498132207374,16.10214284488133,1.0244852120967831,16.894962863786983,16.428825002798575,17.991741181041004,19.428636395391297,480748000,0.46928455001109,0.89489204848576,-13597253000.0,-30.443034857467254,44.757923903640624,51.57585752245338,75.75256275723592,27.23825394991794,25.08165908864707,0.17771246789769687,0.8497880868222178,17.275755348205568,16.73862150192261,16.304499626159668,15.87037775039673,15.33324390411377,0.1,0.0,22.240939151098306,0.057325459421861735,0.08006584504922205,16.98872402736119,16.171145098549978,1.016797850350632
2022-07-26,1,16.704750537872314,14.541249990463257,17.905999660491943,15.168812215328217,16.75600039958954,0.47508995204128385,0.989795680516793,-1.032470176831382,2.993824026243252,15.661999940872192,0.8745699691772462,0.06204531224325457,14.88057496547699,17.392700147628783,0.8287448147879073,-0.004711084280277715,1.0471367813272427,1.0203134652976846,0.9655813546588615,0.0008837629324576213,56.33645209372153,17.93237884377208,15.952787482738495,13.973196121704907,17.07589292526245,0.5619133957499227,16.219482166426523,0.9896731817749116,16.908137835180657,16.457545567190845,11.758213153042611,16.592452556034903,397865000,0.4887573472912518,0.7426897009706309,-13995118000.0,-43.78903546404473,44.757923903640624,51.57585752245338,55.70789511106527,25.955423519547345,25.375399120439326,0.16270899153530483,0.8280887713811146,17.275755348205568,16.73862150192261,16.304499626159668,15.87037775039673,15.33324390411377,0.1,0.0,22.21580731541149,-0.027012767397775028,0.026830675522544003,17.098743166242325,16.271246773856028,1.0041399404724882
2022-07-27,1,17.417750358581543,14.541249990463257,17.905999660491943,15.168812215328217,16.69368803501129,0.5034925618756546,0.9742784259678431,-0.9299209826379449,2.9938803332946904,15.661999940872192,0.8548000144958496,0.06113575048897389,14.88057496547699,17.392700147628783,0.86199191469459,0.011964482741049711,1.092959888692663,1.0539476921334887,1.0066230930440647,0.002633556330368547,54.83312393060901,17.884869372439685,15.936312520503998,13.987755668568314,17.23192868913923,0.46148796450281965,16.34489291054862,1.024235525406524,16.85183087115151,16.419302147560487,6.657838085408988,10.906589414952752,569776000,0.47691296041842285,1.0529186923300382,-13425342000.0,-9.622133338172128,44.757923903640624,51.57585752245338,113.01864771255948,31.32065124782524,22.449575317761465,0.2387954711122362,0.8691540834287842,17.275755348205568,16.73862150192261,16.304499626159668,15.87037775039673,15.33324390411377,0.1,0.0,22.185975833166655,-0.000954373238430728,0.04696325219434206,17.339757646833146,16.40909160886492,1.0835535977116402
2022-07-28,1,17.88474988937378,14.541249990463257,17.905999660491943,15.168812215328217,16.76706290245056,0.44906645287267555,1.0200884059715307,-1.152081435379342,2.9937122526974647,15.661999940872192,0.9094300460815429,0.06382797991674984,14.88057496547699,17.433875274658202,0.850990550619321,0.11748952217912303,1.1190671809153985,1.0659564068419456,1.033066078706966,-0.0011867402837636432,64.36312771656168,18.02201435876847,15.981837546825409,13.941660734882348,17.40260716847011,0.4484042520138086,16.502839309828623,1.0816259809951616,16.98844559455282,16.484753734311266,6.690455706543685,11.210256827593728,474646000,0.4476615234206488,0.8777479901685479,-12950696000.0,-4.349004979638179,44.757923903640624,51.57585752245338,116.70322870809035,31.193593046154533,21.139902973802332,0.25684189847397626,0.8570715034939157,17.275755348205568,16.73862150192261,16.304499626159668,15.87037775039673,15.33324390411377,0.1,0.0,22.163046752566352,-0.0036565009156589445,0.009940172593574688,17.481312343052455,16.56220497403826,1.157246604643602
2022-07-29,1,17.977999687194824,14.541249990463257,17.905999660491943,15.168812215328217,17.058500051498413,0.31080778875594134,1.0957256277856422,-1.3544032407737405,2.993428887452229,15.667750120162964,0.9963000321388243,0.06807123330700336,14.88057496547699,17.609574556350708,0.8330873424640882,0.17375179276497482,1.1168713956005805,1.0544544140838419,1.0387074005788999,0.02269754700246307,69.05128941824947,18.288201300393975,16.09675004482269,13.905298789251407,17.48917852129255,0.49733888690890254,16.693357127053396,1.0903688570448669,17.2109973852567,16.614461460232423,7.158474038860313,14.108205236051274,435460000,0.4419645125624042,0.8243854214823338,-12515236000.0,-2.1434080121779617,44.757923903640624,51.57585752245338,113.4378714269497,30.610479404805474,20.1420103578809,0.3022818905148666,0.8352805784743002,17.352155639648437,16.8004217376709,16.35449981689453,15.908577896118164,15.356843994140625,0.12000000000000001,0.0,22.143085089574605,0.04873268040657419,0.006260504215015655,17.532113211495535,16.777034555162704,1.211287916809949
2022-08-01,0,18.364749908447266,14.541249990463257,17.977999687194824,15.168812215328217,17.383437752723694,0.14970884848343005,1.149718838000468,-1.4564422129827668,2.9932300109287775,15.999500155448914,1.0473875284194947,0.07082258758748747,14.88057496547699,17.886874866485595,0.8268208244992457,0.22139373483415759,1.131267111509901,1.0627026151095205,1.0561828983648596,0.08321044665444055,71.7249388314575,18.533225188780172,16.233787512779237,13.934349836778303,17.554714271000453,0.5840799975292832,16.92194642339434,1.0806109820074319,17.402547296888905,16.743077010176407,3.4883689970760376,17.42076252491496,476469000,0.4143276619262979,0.9107402181044572,-12038767000.0,-9.24447931260574,44.757923903640624,51.57585752245338,123.997537825901,33.51263011803344,18.67020714441343,0.3412994007635731,0.8367606081833764,17.812084548950196,17.172458473205566,16.655500411987305,16.138542350769043,15.498916275024413,0.14,0.0,22.123529143201942,0.08323562827038122,0.06478429271229236,17.587907518659318,17.01669318335397,1.2203667689584237
2022-08-02,0,18.419499397277832,14.541249990463257,18.364749908447266,15.275625109672546,17.458062648773193,0.06808927939267934,1.1836334183582875,-1.419425796127924,2.9931336171441956,16.507750272750854,1.0690375208854674,0.07210215102655017,15.045650029182434,17.91319966316223,0.7992346298719049,0.2629416260975924,1.1220412559980313,1.0534397495426133,1.0424164865731615,0.10265037215119799,74.93146295769937,18.783329346730156,16.41606251001358,14.048795673297006,17.674785682133265,0.669980123589022,17.17344638279506,0.9783486619281968,17.64527067925506,16.941137731267457,2.5619918276191833,21.103565560951782,489527000,0.4084026609592931,0.950402685443284,-11549240000.0,-9.786238774222705,44.757923903640624,51.57585752245338,118.26286500613446,31.879052420177604,17.322951559945437,0.2856310644583072,0.8374206154821402,17.94443971633911,17.329779710769653,16.83299970626831,16.336219701766968,15.72155969619751,0.16,0.0,22.10415032705127,0.12054671683354146,0.08822854112479309,17.760141917637416,17.256565843309676,1.2400795890866416
2022-08-03,0,18.545499801635742,14.898499965667725,18.419499397277832,15.574187517166138,17.655437111854553,0.018053446123929354,1.1782732670269247,-1.4681688100174364,2.9932140401430716,16.697375535964966,1.056077492237091,0.07093769066001271,15.154249787330627,18.016674709320068,0.8317956268920537,0.22291192092417766,1.1165278589263803,1.050257524957452,1.029564838516144,0.06474713552766986,74.47607479931243,18.96652151440816,16.60997498035431,14.253428446300456,17.902142797197616,0.6544733842903812,17.414535675730026,0.8548124549993692,17.841065072825494,17.15341439328615,4.781272546282284,23.633247909010567,418146000,0.4024270119466959,0.8206548324942385,-11131094000.0,-2.1288886651106873,44.757923903640624,51.57585752245338,115.07931365124311,29.874220467062354,16.09440544452221,0.3074765656750706,0.836962089847167,18.13657224273682,17.622214138031005,17.20650005340576,16.79078596878052,16.27642786407471,0.18,0.0,22.088434943434432,0.06200121246052204,0.1427449466714205,18.026842389787948,17.50778320857457,1.2735730857648062
2022-08-04,0,19.024500370025635,14.898499965667725,18.545499801635742,15.661999940872192,17.89006233215332,-0.10140909272979767,1.193939889844124,-1.4119237570250227,2.9931926718557507,16.82937526702881,1.0579748749732971,0.07113496316918322,15.169674706459045,18.37022485733032,0.8651736467695382,0.1841080239847691,1.1334801229487093,1.070271302087359,1.04309568465516,0.06372750458920518,74.33248241533295,19.17202974831236,16.784149968624114,14.396270188935866,18.233535630362375,0.5207690297288866,17.654714277812413,0.7947984986163255,18.016925576450255,17.354701086722145,9.387164125330491,22.24914004525541,409652000,0.3899105874588112,0.8106066767227708,-10721442000.0,-1.803179303631075,44.757923903640624,51.57585752245338,125.05600004514588,31.212118189928944,15.368392964844274,0.30772942943968956,0.8138932808741512,18.501808319091797,18.024096412658693,17.63800048828125,17.251904563903807,16.774192657470703,0.19999999999999998,0.0,22.075036508061118,0.06844978371107224,0.08010117862840833,18.40955434526716,17.754148755754745,1.3488657651077178
2022-08-05,0,18.923500061035156,14.898499965667725,19.024500370025635,15.67062520980835,17.923999667167664,-0.17235765544453568,1.2590567499261784,-1.2613812463310232,2.9929579597494715,17.163000106811523,1.0970723915100098,0.0742706657757033,15.169674706459045,18.432099437713624,0.8504174062526213,0.21380036408897704,1.1162808574133365,1.0579323326690708,1.0247503029685872,0.05259207866789439,77.46277060945333,19.470388489934148,16.952274990081786,14.434161490229425,18.44864273071289,0.4308615685536925,17.84028570992606,0.7632447284805327,18.26535495671297,17.562781545640604,13.886767281523182,21.469163847833535,386068000,0.39500051725444046,0.7701805116808423,-11107510000.0,-9.187618094852185,44.757923903640624,51.57585752245338,106.22622876774825,29.635208112414244,15.435479633470461,0.2979119318229623,0.7959722520923851,18.54192833709717,18.08903644180298,17.723000526428223,17.356964611053467,16.904072715759277,0.19999999999999998,0.0,22.0620092849371,0.04547698616853024,0.055883036537066735,18.580647332327707,17.96020248958043,1.382108360988294
2022-08-08,1,17.694000244140625,14.898499965667725,19.024500370025635,16.159624993801117,18.074687242507935,-0.3126450768406321,1.292803477701536,-1.1513887705823174,2.9928517028006625,17.394875288009644,1.1152724111080168,0.0755372757953993,15.169674706459045,18.583299827575683,0.851016347203771,0.2359616450486944,1.0338435805740291,0.9818163793311151,0.9484577153553843,-0.03652375706995692,77.20162271061939,19.700381933563925,17.11477497816086,14.529168022757792,18.42139278139387,0.4761236491011788,17.91199997493199,0.6905569130779006,18.426023038686697,17.724138416775446,8.64491493708742,15.913754848365317,981859000,0.3802465613767018,1.8578347931982129,-12089369000.0,-52.96856762595768,44.757923903640624,51.57585752245338,30.961527962096003,25.35456357092421,24.979752358172153,0.31443002276442394,0.863903000037791,18.61414427947998,18.20592834854126,17.87600040435791,17.54607246017456,17.13785652923584,0.02,1.0,22.016694855586547,-0.035139045545755754,-0.020371150676855132,18.55339241027832,18.01735237666539,1.2981297871999735
2022-08-09,1,17.12725067138672,14.898499965667725,19.024500370025635,16.598875403404236,18.074687242507935,-0.49210138028949046,1.2293050737336857,-0.8339058234793892,2.9931535996604515,17.498374938964844,1.0301999378204343,0.0713304823867607,15.169674706459045,18.583299827575683,0.8441855155061283,0.16680408352097983,0.9938094932272697,0.9464817966255017,0.924727649889781,-0.07015656061109299,57.044000507273466,19.692547625532864,17.233937478065492,14.775327330598122,18.299857207706996,0.6751509054291837,17.89451786449977,0.7081529629049874,18.239506778800443,17.717505340337276,-1.0665491349503755,6.015576260972826,668263000,0.4913799562157529,1.2398536212669211,-12757632000.0,-78.25465291501723,44.757923903640624,51.57585752245338,-20.149135777605423,23.15093408170815,27.020179918728036,0.31945197665675606,0.8785527096129925,18.61414427947998,18.20592834854126,17.87600040435791,17.54607246017456,17.13785652923584,0.04,0.0,21.98161174488325,-0.07772865748859048,-0.07347767061084753,18.399707794189453,17.965910502842494,1.1866497306780135
2022-08-10,1,17.807499885559082,14.898499965667725,19.024500370025635,16.70106303691864,18.074687242507935,-0.5823607309956612,1.134901082330404,-0.4144205459912551,2.993557047075666,17.498374938964844,0.9124348831176761,0.06547981593558376,15.6128249168396,18.583299827575683,0.7837912819498585,0.1495956445853578,1.0274303487181542,0.9817812843986259,0.9750615131532036,-0.03979401601306898,51.01532671535958,19.60187718831193,17.33207502365112,15.062272858990314,18.220250061580114,0.6986673095583583,17.887482166290283,0.7085193297213371,17.95881821241818,17.64123575593003,-4.73216726338063,-1.4088737220101437,597422000,0.5085271925706838,1.1007099631034383,-12160210000.0,-42.095859974937056,44.757923903640624,51.57585752245338,27.846069797698256,26.62059379681794,24.781002596462898,0.34359628734677233,0.889513230567446,18.61414427947998,18.20592834854126,17.87600040435791,17.54607246017456,17.13785652923584,0.04,0.0,21.955460606008195,-0.04213212303895841,-0.023156589964186045,18.35062026977539,17.969263894217356,1.0644472203522528
2022-08-11,0,18.164000034332275,15.170249700546265,19.024500370025635,16.891687631607056,18.074687242507935,-0.5722178150028837,0.9909751899840716,-0.1618252062752017,2.9941048805948474,17.636499881744385,0.7874223208427431,0.05669997261455278,16.259150004386903,18.583299827575683,0.7200668503590901,0.17384355808710603,1.0392775872965394,0.999288935984422,1.0026855560196757,-0.045231166073046225,57.002485424753885,19.459475399613837,17.47752501964569,15.49557463967754,18.18375015258789,0.6931755574849464,17.92926791736058,0.7061733950090013,17.922425310187087,17.685365815351716,-3.0343458291902157,-0.5500936937365897,509327000,0.5230311651815914,0.9338335271917614,-11650883000.0,-47.63951923345856,44.757923903640624,51.57585752245338,49.258057348534926,29.587869705340857,23.11955526241414,0.27216477702412856,0.8853337951560707,18.61414427947998,18.20592834854126,17.87600040435791,17.54607246017456,17.13785652923584,0.04,0.0,21.935199309856685,-0.06625033713072881,-0.050336195876547064,18.267285755702428,18.013713836669922,0.9284518934364308
2022-08-12,0,18.384999752044678,15.661999940872192,19.024500370025635,17.083938002586365,18.214187502861023,-0.41487175085505545,0.8467655530868842,-0.30575238568046226,2.9945695766544023,17.750750064849854,0.6812661039829255,0.04803740530962825,16.653550481796266,18.583299827575683,0.6653053079736886,0.1597497192507811,1.0429896226727657,1.0098957006446503,1.0246192617468908,-0.028456697083183324,59.07556034168676,19.32074364250876,17.62721253633499,15.933681430161222,18.16082157407488,0.6817761944209006,18.031482185636246,0.6559272135841941,17.987198601094658,17.773824442536796,-1.3871135009419213,3.3278373683340514,478094000,0.5190846105166178,0.8692252317016111,-11172789000.0,-20.2074617182922,44.757923903640624,51.57585752245338,71.70686081668237,27.808488858135743,21.65920990696872,0.2814037999086727,0.877524289903925,18.61414427947998,18.20592834854126,17.87600040435791,17.54607246017456,17.13785652923584,0.04,0.0,21.917803708045586,-0.014745428279695383,-0.02633366133809646,18.24102919442313,18.13393579210554,0.829219132229979
2022-08-15,0,18.87750005722046,16.325500011444092,19.024500370025635,17.310812830924988,18.36981236934662,-0.18269872582081337,0.7308105964692861,-0.7740901109248881,2.9948833060572317,17.84612488746643,0.600601065158844,0.0411414559243974,16.703275537490846,18.583299827575683,0.6483937952829029,0.12615232238871013,1.062721093973061,1.0346358451346187,1.0584198375078917,0.0668870688792802,59.596844966079836,19.22498371983219,17.763362526893616,16.301741333955043,18.139821529388428,0.6523690990236202,18.1866785798754,0.5691730240268363,18.09150746017189,17.86612723212379,-0.8654393319553895,8.440484582879284,457666000,0.504421052780139,0.8485028938749373,-10715123000.0,-9.490221656416846,44.757923903640624,51.57585752245338,113.86868119628087,30.256686286948753,20.661266270907763,0.357459743083251,0.8542009821074379,18.67220034790039,18.29990045928955,17.999000549316406,17.698100639343263,17.325800750732423,0.02,1.0,21.903585348411454,0.0696341113586445,0.0022644664300066793,18.214915684291295,18.312235014779226,0.7555061765403255
2022-08-16,0,18.8604998588562,16.690000534057617,19.024500370025635,17.406312823295593,18.393624663352966,-0.11554665795848455,0.6902862149029819,-0.9262504066555177,2.9949864593738513,17.89537477493286,0.5678623437881469,0.038582955711691715,16.929075050354005,18.882100057601928,0.6021536809194677,0.13106647412617092,1.0541914571724316,1.0308072482818322,1.0436165820666212,0.10119833128647437,63.07732131729998,19.271534958988397,17.890962529182435,16.510390099376473,18.13082150050572,0.6400743261693129,18.289732115609304,0.5495142733473252,18.289682192947737,18.00792648532079,-0.7726894790718632,13.006776212683794,451240000,0.5086336690235737,0.8565284479094833,-11166363000.0,-15.490218664496528,44.757923903640624,51.57585752245338,93.33082007568446,28.605465751841628,20.487265193660647,0.3237740966666351,0.8389723633164675,18.67220034790039,18.29990045928955,17.999000549316406,17.698100639343263,17.325800750732423,0.02,0.0,21.889251058291205,0.10493984794432931,0.0610352061881725,18.199219022478378,18.38993317740304,0.7381343920809446
2022-08-17,0,18.422749996185303,16.704750537872314,19.024500370025635,17.538687229156494,18.45099949836731,-0.17233708909296797,0.6630249136967222,-0.9218179107557516,2.995052078228753,17.941999673843384,0.5569361782073976,0.03683576623308541,17.10992560386658,18.882100057601928,0.6680205204178776,0.08568383736976495,1.0235152529132057,1.0044613301800855,1.0002090286933525,0.034550055570976346,61.354505445227794,19.32553732281581,17.999487495422365,16.67343766802892,18.234928607940674,0.6159967892198088,18.32816069466727,0.5376992116923998,18.432564151717877,18.160257237249876,-0.3329204532763842,8.283213793817126,446799000,0.49128507461695176,0.8741270814977619,-11613162000.0,-36.82358291433982,44.757923903640624,51.57585752245338,36.6183785450432,26.801747908955846,22.253688752466534,0.262756017568572,0.8314742699611681,18.67220034790039,18.29990045928955,17.999000549316406,17.698100639343263,17.325800750732423,0.02,0.0,21.873107646016486,0.013151226495713653,0.07310078211586261,18.27656010219029,18.414976256234304,0.7360352232273251
2022-08-18,0,18.530500411987305,16.704750537872314,19.024500370025635,17.665250062942505,18.453437447547913,-0.36451484750361174,0.6527728482900298,-0.7435662686775659,2.9950752767453395,18.07099986076355,0.5467249393463135,0.03616064396407559,17.10992560386658,18.882100057601928,0.7202791038246766,0.028859060956731995,1.0265053603704912,1.0110128306167465,0.9993825068141325,0.02017729448151817,53.76711536583579,19.3575706809398,18.05202498435974,16.746479287779678,18.4353928565979,0.3776733909225756,18.36762503215245,0.5302459737124328,18.428749873324797,18.232186805335274,4.11862632524832,3.0081500168541697,415447000,0.491768393950322,0.8242059805706594,-11197715000.0,-19.647043159946424,44.757923903640624,51.57585752245338,56.596132327916735,26.751381626605585,20.93293275430838,0.2586249224187133,0.8207974612080032,18.67220034790039,18.29990045928955,17.999000549316406,17.698100639343263,17.325800750732423,0.02,0.0,21.859159621124444,0.04631598709009199,0.03735436224006098,18.517289570399694,18.45849868229457,0.7489937143853355
2022-08-19,0,18.136250495910645,16.704750537872314,19.024500370025635,17.665250062942505,18.534250259399414,-0.475223572420705,0.6599379936590761,-0.7497766976329059,2.9950621610475032,18.26437497138977,0.5602249407768248,0.036494435063309336,17.10992560386658,18.882100057601928,0.7148268304672953,0.0541271357105335,1.0029309152896657,0.9921769437694026,0.9742684348071871,-0.013530011394553787,56.127545953823876,19.403126009252663,18.08325002193451,16.76337403461636,18.482357229505265,0.29878089627832244,18.35130364554269,0.533845756082141,18.450544162946034,18.273897104274294,8.193082284624325,3.073204663508865,441588000,0.4848207494497934,0.884408688830492,-11639303000.0,-55.88233974152801,44.757923903640624,51.57585752245338,-11.353965100458717,24.452843026524416,22.672302846027584,0.25635590689424304,0.8338119677431366,18.67220034790039,18.29990045928955,17.999000549316406,17.698100639343263,17.325800750732423,0.02,0.0,21.841930467572304,-0.04596703160993154,-0.005183268885252901,18.481901168823242,18.416260719299316,0.7261491165753573
2022-08-22,0,17.26200008392334,16.704750537872314,19.024500370025635,17.779124975204468,18.534250259399414,-0.6032686119876277,0.6497452253704692,-0.5309133754813149,2.9950837546557123,18.26437497138977,0.5320899295806882,0.03587550034995499,17.10992560386658,18.882100057601928,0.667314858524608,0.06973283590841993,0.9531164922352674,0.9484341770591527,0.929789121295316,-0.08557806745598218,52.64768570310309,19.410603021503572,18.111112570762636,16.8116221200217,18.35350009373256,0.5488338049693591,18.268625123160227,0.6070811656952562,18.369687082261525,18.25762768929506,1.8461356870099517,-1.244228283400243,409593000,0.47043467079283746,0.8262165242699705,-12048896000.0,-87.84315456110772,44.757923903640624,51.57585752245338,-119.83268566143173,22.610930450416628,27.82309906626743,0.19830366888911205,0.8373254986929974,18.67220034790039,18.29990045928955,17.999000549316406,17.698100639343263,17.325800750732423,0.02,0.0,21.82249736001344,-0.10498107509512622,-0.08952905070183621,18.35233279636928,18.309809276035853,0.7252993568176072
2022-08-23,0,17.151249885559082,16.704750537872314,19.024500370025635,17.779124975204468,18.534250259399414,-0.5590170593279702,0.625328572040073,-0.48688333186868915,2.9951330871131336,18.26437497138977,0.5136099243164061,0.03449800779093958,17.248525142669678,18.882100057601928,0.5045589179069634,0.03335874694971663,0.9461968933325053,0.9445912196719618,0.9401860350785735,-0.09062591055849023,42.978482441396885,19.377169719229684,18.126512575149537,16.87585543106939,18.177250112806046,0.7111347993414047,18.169035843440465,0.6693356943082664,18.09299526938063,18.14244190463014,-4.965866266813701,-6.284097566329929,369986000,0.511153277255928,0.7484271309841541,-12418882000.0,-82.0784720861314,44.757923903640624,51.57585752245338,-128.13548754417658,21.627431587279922,26.612888528464914,0.22354773472523368,0.8128737033640779,18.67220034790039,18.29990045928955,17.999000549316406,17.698100639343263,17.325800750732423,0.02,1.0,21.805154945390584,-0.08994134561301781,-0.09725740629726523,18.134292330060685,18.187660762241908,0.6582870109380753
2022-08-24,0,17.133749961853027,17.12725067138672,19.024500370025635,17.779124975204468,18.534250259399414,-0.31667892458857827,0.5805376129022058,-0.9774477646075268,2.9952187642810917,18.26437497138977,0.48807866811752304,0.03198759212768584,17.250925064086914,18.882100057601928,0.5538754504775802,-0.015300510544472177,0.9440687273605335,0.9435027192483907,0.9571633159106298,-0.06996784055579008,39.34599432180756,19.30991276833829,18.148837542533876,16.987762316729462,17.928142956324987,0.7301185028840635,18.033982242856705,0.6741820218557953,17.858765874161342,18.028247548887627,-6.710633033043065,-7.517995907307308,522661000,0.4856237524057568,1.0623284982296084,-12941543000.0,-80.11978610277149,44.757923903640624,51.57585752245338,-124.88137986087067,20.62984463267561,26.062328587735536,0.19810576511234398,0.7913112453019356,18.637820289611817,18.272090412139892,17.976500511169434,17.680910610198975,17.31518073272705,0.04,0.0,21.780713392995462,-0.06070335719431974,-0.08776938047005436,17.876011984688894,18.045463834490096,0.6899390314066841
2022-08-25,0,17.384250164031982,17.12725067138672,19.024500370025635,17.779124975204468,18.534250259399414,-0.36472171789855656,0.6013468181727528,-0.9842709683113715,2.9951800541235283,18.26437497138977,0.503859987258911,0.03316012340583607,17.149499893188477,18.882100057601928,0.6314513061538493,-0.04199107799471987,0.9586213202372379,0.9608619174595826,0.9853480890816102,-0.06185749021725384,37.26604629727142,19.337331159042957,18.13463752269745,16.93194388635194,17.71725014277867,0.6209720462970728,17.924035821642196,0.6427377135577622,17.67852433547381,17.914579274169014,-9.237187604724516,-9.938502307012543,770691000,0.47223152237017835,1.5207067748307561,-12170852000.0,-51.27049814658764,44.757923903640624,51.57585752245338,-71.59356501500085,23.359279974631814,23.515766205263755,0.23775759708163685,0.8143604925393948,18.588159881591796,18.231920082092284,17.944000244140625,17.656080406188966,17.299840606689454,0.06,0.0,21.748151940513928,-0.045810622060689754,-0.023016023943330365,17.73816708156041,17.968693052019393,0.6913258135435252
2022-08-26,0,17.069499969482422,17.12725067138672,19.024500370025635,17.616562724113464,18.534250259399414,-0.2946197446574337,0.6213079862086656,-1.183220682213264,2.995141552596455,18.26437497138977,0.5338899707794191,0.03430818770742919,17.149499893188477,18.882100057601928,0.6849764478121497,-0.03302645085625134,0.9425657194566927,0.9475488273241071,0.980245203638724,-0.05881869169532883,41.20268453160256,19.35222850884769,18.109612536430358,16.866996564013025,17.523928710392543,0.5735671573588057,17.87942865916661,0.6804925229948798,17.608790468571087,17.852637383782568,-7.827203445676578,-8.134065537762751,769127000,0.47585015498079186,1.469254151891782,-12939979000.0,-99.21418801491733,44.757923903640624,51.57585752245338,-139.64506953133144,20.148577807656125,25.139482386679326,0.12933450441372196,0.8766919748172182,18.473227546691895,18.045885540008545,17.700499534606934,17.355113529205322,16.927771522521972,0.08,0.0,21.710362036387107,-0.08902485169549779,-0.1338626855129713,17.44207191467285,17.85931600843157,0.8165229572635496
2022-08-29,0,15.981499910354614,17.069499969482422,19.024500370025635,17.353687644004822,18.534250259399414,-0.23225636903589764,0.6612002683574131,-1.3696378415430568,2.9950602458847624,18.26437497138977,0.5883999538421634,0.036602823487485,17.133100032806396,18.882100057601928,0.6940647536727775,-0.07052913573133197,0.8847062656782857,0.8936787018417491,0.9291488677891518,-0.07418029007897509,36.03995155218659,19.386588087259565,18.064187550544737,16.74178701382991,17.159785781587875,0.6339788651248359,17.797589319092886,0.8303152915595827,17.47876681003334,17.753509915556297,-7.345537593372819,-3.5294465131761634,496132000,0.46915276893219143,0.9459784114994269,-13436111000.0,-98.99913307422888,44.757923903640624,51.57585752245338,-187.83547796961543,19.187277852100546,27.867202729000955,0.0849848483580854,0.8548567501913357,18.362307708740236,17.86634580230713,17.465499877929688,17.064653953552245,16.56869204711914,0.1,0.0,21.68217498583175,-0.07238464887638563,-0.11474041536921512,17.01797785077776,17.76763371058873,0.9603124532096227
2022-08-30,0,15.66225004196167,15.981499910354614,19.024500370025635,17.234312534332275,18.534250259399414,-0.5753351791077219,0.7970875718972369,-0.3772323933933066,2.994736486842016,18.15012526512146,0.6894224679470063,0.0444183036606463,17.121475601196288,18.882100057601928,0.624946675567823,-0.132359703938725,0.872790647979786,0.8902432599053843,0.9243510295390153,-0.08681582121027298,26.94933836911823,19.53920019443458,17.945025050640105,16.350849906845628,16.80635714530945,0.6863335626232486,17.64435718740736,1.0074094609736102,17.10548310284877,17.52339842896153,-13.755702463295338,-6.689636200316896,530181000,0.5200300344568797,1.0069969996036066,-13966292000.0,-92.81767214817921,44.757923903640624,51.57585752245338,-187.0013247530765,17.813567500869578,30.759221475696314,0.06670377734021883,0.8550097965584516,18.22424769973755,17.642875787734983,17.1729998588562,16.703123929977416,16.121752017974853,0.12000000000000001,0.0,21.650240725532065,-0.09970300049190584,-0.09193378394193445,16.678217342921666,17.580059255872452,1.1010074308081528
2022-08-31,0,15.244249820709229,15.66225004196167,19.024500370025635,17.14687490463257,18.534250259399414,-0.6591268853973796,0.930397403793686,-0.3014124464860144,2.9943498861929623,17.971875190734863,0.7798712313175201,0.05224849267611439,16.960699963569642,18.882100057601928,0.69147475927044,-0.1554689703978625,0.8560740516498736,0.8825274548963401,0.9157768153173057,-0.11027942775811628,24.47168818919772,19.667957390461673,17.807162582874298,15.946367775286925,16.518107107707433,0.8638358999174034,17.435803600719996,1.1791431697115058,16.74414178633952,17.301756111935827,-13.641190357989439,-12.04688955431129,573710000,0.5180702311199997,1.0738097007291934,-14540002000.0,-96.78953076501237,44.757923903640624,51.57585752245338,-180.47122703977902,16.928685062267313,31.137888589072617,0.004924586357246835,0.8354376742512301,18.17161957550049,17.557689586639405,17.06149959564209,16.565309604644774,15.951379615783692,0.14,0.0,21.61400644705621,-0.12356305462654293,-0.12147133176210975,16.40138598850795,17.376859392438615,1.2269918862968956
2022-09-01,0,13.949000120162964,15.244249820709229,19.024500370025635,17.13212513923645,18.449687600135803,-0.6772874992989913,1.0675030207393434,-0.3559796112467857,2.9938734775967903,17.750750064849854,0.8762900245189666,0.06050884053865526,15.94957492351532,18.882100057601928,0.711664160253614,-0.1987043273563411,0.7906655133959719,0.822680482721566,0.8574317700436794,-0.19760703001021873,20.10488673353905,19.777106125306663,17.642100083827973,15.507094042349284,16.060642855507986,1.2390722950348703,17.118946484157018,1.4656625993492949,16.3674287896717,17.04835282068905,-11.688971459879134,-16.074379036029217,1178865000,0.4989585749023112,2.05830452933852,-15718867000.0,-88.68340823253735,44.757923903640624,51.57585752245338,-225.93070892011963,14.494416899376201,39.975670204880494,-0.0021902339568581003,0.9060492847815533,17.773015769958498,16.912491901397704,16.217000007629395,15.521508113861085,14.660984245300293,0.16,0.0,21.52558223925331,-0.22196164249335304,-0.1907444641014235,15.938479151044573,17.036385740552628,1.4207829029335841
2022-09-02,0,13.877249956130981,13.949000120162964,18.923500061035156,17.112812995910645,18.394437313079834,-1.024001297606856,1.289014655401128,0.5060928658171653,2.992905272927148,17.539125204086304,0.991825008392334,0.07413104195562263,15.620450019836426,18.86219987869263,0.6789830187713336,-0.26287420005958856,0.7980785900424666,0.8411779988328945,0.8906349265204444,-0.1870148521666528,15.310186268384614,19.9663543821371,17.38832507133484,14.81029576053258,15.595428568976265,1.3731033147914107,16.761785762650625,1.6066295799537684,15.75806613870347,16.636370491308973,-18.670649583925258,-24.128363838505717,743157000,0.5547603744750171,1.2583289535353097,-16462024000.0,-93.57970245749799,44.757923903640624,51.57585752245338,-191.19811601681872,13.814182918135593,38.099581674723915,-0.05770950033435213,0.882760026837149,17.756208259582518,16.898896297454833,16.206000328063965,15.513104358673095,14.655792396545408,0.16,0.0,21.47044526407118,-0.16070107425054003,-0.23815111087233076,15.428338868277413,16.652175426483154,1.5917769429604787
2022-09-06,1,13.581500053405762,13.877249956130981,18.87750005722046,16.79749995470047,18.219249963760376,-0.9670069479888488,1.4479093522440882,0.010894394786089556,2.992051211264376,17.32312512397766,1.1043350076675416,0.08449511499013189,15.114724850654602,18.563500356674194,0.8023533288860325,-0.21570872811949698,0.79257061705721,0.8450673590305219,0.9088962333688927,-0.15017363016057472,16.05333146898666,20.031831270577804,17.13601256608963,14.240193861601455,15.05217855317252,1.2976040477062454,16.384714347975596,1.693322139906686,15.283367940661698,16.258607754951992,-19.00634719762102,-26.487882854895982,535751000,0.5066187399954574,0.9427505564989398,-16997775000.0,-96.51475033502183,44.757923903640624,51.57585752245338,-165.0738443687394,13.317497763100608,38.745870462820655,-0.09109927934018688,0.8502771767889353,17.544579933166503,16.72771003341675,16.067500114440918,15.407290195465087,14.590420295715333,0.16,0.0,21.42979280114207,-0.14783879213375872,-0.17189411992392076,14.793625150408063,16.265896115984237,1.7760638113379084
2022-09-07,1,13.615249872207642,13.581500053405762,18.87750005722046,15.901687443256378,18.219249963760376,-0.8097742146782556,1.6341114697190586,-0.528361843489741,2.990933255063745,17.20662498474121,1.3286575436592103,0.09651943667920217,13.941825103759765,18.563500356674194,0.8439946620028788,-0.2070239226371919,0.8041900887813921,0.8670228441708862,0.9413946679695977,-0.13069643022361332,15.49755906889813,20.198610495991,16.930387556552887,13.662164617114772,14.558714253561837,1.0322537495117763,16.04132148197719,1.735176808476758,14.858640413298637,15.931039244641575,-21.87468584922985,-27.98971313038458,512657000,0.49988755148063263,0.914634614125448,-16485118000.0,-92.06435487120538,44.757923903640624,51.57585752245338,-132.6179722498398,13.261007383971807,37.094765510928774,-0.06976633519858426,0.8246859743631463,17.544579933166503,16.72771003341675,16.067500114440918,15.407290195465087,14.590420295715333,0.16,0.0,21.39177309185749,-0.11313205394512937,-0.13182245319491728,14.430901663643974,15.936486789158412,1.9103926931913564
2022-09-08,1,13.706500053405762,13.581500053405762,18.87750005722046,15.55774998664856,18.219249963760376,-0.6452524857955894,1.7852322147112936,-0.9823316944496061,2.98990207084159,17.20662498474121,1.5372512841224673,0.10655057325813297,13.851049947738648,18.563500356674194,0.8751757428422203,-0.23542047116626003,0.8180646898583973,0.8929403261261296,0.9753121182347824,-0.1008740859923748,12.751039803589931,20.32525194601652,16.754787516593932,13.184323087171343,14.233714273997716,0.8520428325542382,15.696750027792794,1.680981118640815,14.550799765761163,15.69482135810863,-20.236387143445533,-26.095453311656097,624873000,0.46014690837476696,1.11211656994477,-15860245000.0,-86.28572736467633,44.757923903640624,51.57585752245338,-108.09553683379283,14.011561247067954,35.00816871344703,-0.06749838440322509,0.8114226779732253,17.28100045776367,16.51450045776367,15.895000457763672,15.275500457763671,14.509000457763673,0.16,0.0,21.346853319844634,-0.07286626482559322,-0.09528348302146103,14.173071316310338,15.59552458354405,1.9735928131950957
2022-09-09,0,14.28600001335144,13.581500053405762,18.87750005722046,14.920437395572662,18.219249963760376,-0.4403843270660451,1.8852589259058248,-1.303472067263733,2.98911008034318,17.142499923706055,1.6780400371551516,0.11391473266929587,13.69737503528595,18.563500356674194,0.8908401471234724,-0.24540299342112257,0.8632161079160858,0.9519478259148794,1.0392917162102262,0.024159430087132172,12.844025610741214,20.320255376797917,16.549737524986266,12.779219673174618,14.037107127053398,0.584137640404291,15.421732136181422,1.5619079327579772,14.342617283689371,15.48542676957303,-14.23520864568445,-26.03275816265014,486612000,0.4462385224993101,0.8678009385786499,-15373633000.0,-76.1171773524272,44.757923903640624,51.57585752245338,-77.11777449485558,17.62075255985807,33.472344696297185,-0.007738585111456431,0.788035345206227,16.843228492736817,16.16038648605347,15.608500480651855,15.056614475250244,14.373772468566894,0.16,0.0,21.314711739132743,0.03259481975247236,-0.04655653936540659,14.019426345825195,15.34882184437343,1.9977498455102491
2022-09-12,0,14.404750108718872,13.581500053405762,18.87750005722046,14.201750040054321,18.198437809944153,-0.23231406772475605,1.9085432169395309,-1.4678332195292787,2.988838021978295,17.101624965667725,1.7299037873744965,0.11668880998275537,13.69737503528595,18.563500356674194,0.9072219051883087,-0.2229534834906576,0.8807100270858718,0.9800949920887347,1.0428174382268944,0.03801186504930265,24.156223021319857,20.172923957816288,16.355837523937225,12.538751090058163,13.91717859676906,0.32264237428630493,15.217642852238246,1.4878679971062683,14.332649759835704,15.372734995702524,-8.787051827949597,-21.22958371923324,484159000,0.4719430517143383,0.8629596836972452,-14889474000.0,-73.59419190528915,44.757923903640624,51.57585752245338,-66.3858679181078,17.729343508889954,32.36960257363196,-0.016576422637466302,0.7566756594470541,16.843228492736817,16.16038648605347,15.608500480651855,15.056614475250244,14.373772468566894,0.16,0.0,21.283420724776384,0.06318682664071984,0.04106397197066771,13.935993194580078,15.168689591544014,1.9554605967054501
2022-09-13,0,13.488499879837036,13.581500053405762,18.87750005722046,14.201750040054321,17.572250247001648,-0.037450101421939753,1.8940415466826954,-1.5120387115292127,2.988827325308093,16.525499939918518,1.7260000467300416,0.11722857317486252,13.69737503528595,18.563500356674194,0.8929615297508601,-0.2369355017848777,0.8348484213305916,0.9347005375279872,0.9690849685493129,-0.00684756272893472,24.121402335354734,19.944908135136327,16.156825041770936,12.368741948405546,13.85139284815107,0.3598719888287547,14.956017851829529,1.4430629174012464,14.353628173629282,15.30640694906574,-5.506992615995447,-16.552253280693222,714956000,0.4492569442876869,1.24576490098391,-15604430000.0,-99.33994256316076,44.757923903640624,51.57585752245338,-96.49553409054735,15.512146095634975,38.096686145251454,-0.09441784701248734,0.8030560021063352,16.80287237930298,16.09506430244446,15.523000240325928,14.950936178207398,14.243128101348876,0.18,0.0,21.23085765702348,-0.024515299478635844,-0.037524543827268546,13.821536472865514,14.880007811955043,1.9386431645601092
2022-09-14,0,13.146250009536743,13.488499879837036,18.8604998588562,13.931062579154968,17.2925626039505,0.09741184077263912,1.871011599319068,-1.5228844240223256,2.9888008625728513,15.821874976158142,1.7058500409126285,0.11776719536388608,13.611874890327453,18.433525037765502,0.8548782092949027,-0.2848280808685285,0.8274652031762125,0.9269983317705819,0.945759774913047,-0.034446658494917015,19.122457924548545,19.629398231539906,15.887375032901764,12.14535183426362,13.746964284351893,0.44670416166952315,14.67119642666408,1.3719333541568663,14.137625672843182,15.095828546548582,-3.3013136164525876,-21.355586503383574,588507000,0.4706148299952476,1.0133174326750263,-16192937000.0,-95.72903981637319,44.757923903640624,51.57585752245338,-98.27259531808687,14.971494646422666,38.48844453403785,-0.09314883429991645,0.7726234062750028,16.75897640991211,16.024012351989747,15.430000305175781,14.835988258361816,14.101024200439454,0.19999999999999998,0.0,21.18662229250805,-0.04272987226986813,-0.024738015001283753,13.748034068516322,14.588186468396868,1.8883549639928923
2022-09-15,0,12.991750001907349,13.146250009536743,18.530500411987305,13.834562480449677,17.178937435150146,0.194048564493346,1.8310563985268016,-1.5116684456486738,2.988874585973242,15.45324993133545,1.6717375516891475,0.11736290243306698,13.572200036048889,18.164900445938112,0.8535534800080913,-0.28641217992651125,0.8327157421996424,0.9326503920446662,0.9409947553093257,-0.052146795222228426,18.081950993732185,19.263775337489395,15.601662540435791,11.939549743382187,13.662714276994977,0.5308093510268633,14.357446415083748,1.1945500408835734,13.88800187193165,14.855787002744888,-5.267613892558604,-23.27278010472982,523625000,0.46944092149489847,0.8956766166524607,-16716562000.0,-97.29256050417308,44.757923903640624,51.57585752245338,-94.77129565096298,14.339063371412536,38.0354727422997,-0.09774584943963584,0.7490788558268422,16.712375827789305,15.962811853408814,15.35699987411499,14.751187894821168,14.001623920440673,0.2,0.0,21.147057658273887,-0.07583983521257376,-0.05724074352207664,13.672096933637347,14.232861042022705,1.8540859549969801
2022-09-16,0,12.942249774932861,12.991750001907349,18.530500411987305,13.683687508106232,17.13812494277954,0.31549347306515857,1.7949048953998537,-1.416625538589591,2.988938603968472,14.82449996471405,1.6340238058567045,0.11708360852746433,13.454274892807007,17.45945019721985,0.8341306508156678,-0.2988991277589547,0.8442371013620368,0.9443675073249387,0.9472168282830119,-0.09406063538868359,16.886001919608045,18.9199223315216,15.330112540721894,11.740302749922188,13.566571405955724,0.5975872977054535,14.062642829758781,0.9600146751985571,13.663193309087212,14.61821082377461,-4.342304231339487,-25.267124671346007,670751000,0.46169605741794945,1.1228230113842281,-17387313000.0,-84.38590776295052,44.757923903640624,51.57585752245338,-87.0799685920632,13.513385545189315,37.51954591576007,-0.06754905391876335,0.7380732380075326,15.459843410491944,14.916577451705933,14.47749948501587,14.038421518325805,13.495155559539795,0.2,0.0,21.097084010245243,-0.08264402718171193,-0.0566117700450742,13.598443848746163,14.014672756195068,1.7140592600050093
2022-09-19,0,13.216750144958496,12.942249774932861,18.136250495910645,13.606812417507172,17.085562467575073,0.395752225489038,1.7078004929320507,-1.395898624643417,2.9893697950361413,14.345375061035156,1.556870025396347,0.11346983807568202,13.130800008773804,17.274225091934206,0.8330415666550087,-0.2863877912443327,0.8781485337672033,0.9715341202460881,0.98671490883513,-0.0824727922937939,17.094669731914422,18.466300994733274,15.050700008869171,11.635099023005068,13.4966071333204,0.6070685522004063,13.865160703659058,0.8071173574183302,13.483467357906594,14.380654515159483,-4.942987485294362,-24.179092544763666,569685000,0.4640701957258042,0.9435245835865627,-16817628000.0,-77.64464176876213,44.757923903640624,51.57585752245338,-69.94938404202446,15.402176682411385,35.82802081773095,-0.007662715660414328,0.7177108613232839,15.23140757369995,14.731795583724976,14.327999591827393,13.92420359992981,13.424591609954835,0.2,0.0,21.05655168973892,-0.07742160146223609,-0.0698547836349801,13.511658668518066,13.842364992414202,1.610457694318825
2022-09-20,0,13.232749938964844,12.942249774932861,17.384250164031982,13.55825001001358,16.253499925136566,0.5136161089010963,1.5963133555678268,-1.335908658253107,2.9900087652048737,14.117500066757202,1.4450949907302857,0.10782458684667062,13.130800008773804,17.162324905395508,0.8687058152371654,-0.23434421963259727,0.8938193682572151,0.9774559625010324,1.0057497455326394,-0.01896059184865284,24.45643966330387,17.997351702457212,14.804724991321564,11.612098280185913,13.346142836979457,0.49986603723397893,13.691624982016426,0.6335193400152143,13.417285895231654,14.188635568487157,-3.573121559398919,-17.299688895939,524818000,0.4566185090239019,0.8609993155552698,-16292810000.0,-80.87581419568369,44.757923903640624,51.57585752245338,-67.71845334276586,14.934642823282935,34.26361403332953,-0.0007092978509669908,0.6968743385411638,14.850171882629395,14.423413833618165,14.078499794006348,13.73358575439453,13.3068277053833,0.02,1.0,21.01936162739324,0.0034270161568470403,-0.09162355014960531,13.33880192892892,13.679114137377058,1.555194755566355
2022-09-21,0,13.403749942779541,12.942249774932861,17.384250164031982,13.424562394618988,15.742062509059906,0.7226928697103034,1.5261960626220792,-1.0113619063578958,2.990390181963822,13.913125038146973,1.3403912365436554,0.10451062317660544,13.130800008773804,17.135499954223633,0.8585255871157791,-0.228467311288696,0.9178599615940417,0.9926442653135467,1.0227225015591317,0.019587329699039646,25.01997634654786,17.6556546093178,14.603262484073639,11.550870358829478,13.203142813273839,0.19946700081317473,13.560160705021449,0.45130374957802805,13.373581722952192,14.03216061134961,-7.372603061754501,-15.51182043759873,807679000,0.4589820413460188,1.2791270479214754,-15485131000.0,-66.63212686139408,44.757923903640624,51.57585752245338,-52.79954389526816,19.047240434910375,31.101724786830964,-0.03934887424577093,0.7128833537392211,14.091519859313966,13.8097398147583,13.581999778747559,13.354259742736817,13.072479698181152,0.04,0.0,20.964475392532158,0.010130789567893927,0.009900163903933062,13.161234719412667,13.548613956996373,1.4537076560687652
2022-09-22,0,12.802000045776367,12.942249774932861,17.384250164031982,13.360999941825867,15.348749876022339,0.9633064943981048,1.4288087901955149,-0.4901837700983491,2.9909584302288437,13.791875004768372,1.198017494678497,0.09911348097648973,13.130800008773804,17.075924968719484,0.8377304221574916,-0.21769898751750455,0.8880479996378312,0.9495676662103778,0.9729848932738706,-0.014605419293253319,28.997938309221155,17.27350506732569,14.415887486934661,11.558269906543632,13.105071408408028,0.2044844606124945,13.478232128279549,0.4785728284600597,13.385514417139136,13.935205419868995,-6.949097751674624,-12.073404067607044,759162000,0.46495283670243753,1.1801884447362936,-16244293000.0,-93.72348028652543,44.757923903640624,51.57585752245338,-92.752296406584,17.476390658225753,35.288873146673176,-0.08723353598541894,0.7214630616575687,14.046916053771973,13.737542129516601,13.487500190734863,13.237458251953123,12.928084327697754,0.02,1.0,20.90848829153257,-0.028463040827674257,-0.04319017721574942,13.079873766217913,13.450705119541713,1.3440553885844762
2022-09-23,1,12.450999975204468,12.802000045776367,17.384250164031982,13.228749990463257,14.614625036716461,1.180908390685304,1.3249442356602597,0.23017657216856513,2.991520359357699,13.660874962806702,1.0637400090694427,0.09331053196198734,12.9867999792099,16.090299916267398,0.7545481276209033,-0.2635862965051143,0.8768742109105108,0.9297706181096752,0.9490453145445353,-0.037957063746356434,22.87150601114172,16.849188462451348,14.199299991130829,11.54941151981031,13.00574997493199,0.31831428397622197,13.376357129641942,0.535516058247167,13.24155146605975,13.765670053219724,-5.0895195179329535,-8.22281213352801,663309000,0.4607742936058733,1.0398554098554944,-16907602000.0,-88.68996380618506,44.757923903640624,51.57585752245338,-112.1538871649299,16.840755911118578,35.762290964676446,-0.12060306819633605,0.6952156995148131,14.006559940338136,13.672219945907592,13.401999950408936,13.131779954910279,12.797439960479736,0.04,0.0,20.85870727494383,-0.05167452218548252,-0.03194367380855426,12.992517335074288,13.370275701795306,1.0611042406095137
2022-09-26,1,12.398000001907349,12.450999975204468,17.069499969482422,13.199125111103058,14.315687537193298,1.2057634404643296,1.1576990546496462,0.6906449220675088,2.9923915704029826,13.598374962806702,0.8932424974441531,0.08297349201317214,12.928224802017212,15.694175028800965,0.6804194388751321,-0.2705703156234866,0.8885775193527166,0.9386753093156137,0.952135931099324,-0.061947917155977916,21.12010440505393,16.268035590988745,13.952637481689454,11.637239372390162,12.92092854636056,0.3930108581095916,13.29182141167777,0.5911629904090755,13.042968817157142,13.552317615442117,-5.288580650968276,-10.277612534437308,547343000,0.46114990171628306,0.8732386231833421,-17454945000.0,-99.39991693673129,44.757923903640624,51.57585752245338,-122.5174351354934,16.556650680273865,34.08406946513518,-0.10397065254588235,0.677343191359247,13.996411888122559,13.65579386138916,13.380499839782715,13.10520581817627,12.764587791442871,0.06,0.0,20.81761263564394,-0.08623512999572114,-0.07349595151625928,12.892457553318568,13.282277243477958,0.9636377186874578
2022-09-27,1,12.478500127792358,12.398000001907349,15.981499910354614,13.107625007629395,14.033250093460083,0.9359565206293607,0.9595900778747471,0.150166989633985,2.9933335664901843,13.534999966621399,0.7371562588214873,0.06994574731634125,12.766900038719177,15.286049842834473,0.7055298362493881,-0.22422800916986965,0.9095738242297905,0.9593459176813394,0.9705230524054922,-0.05699872019432173,22.5678168179858,15.638242639060191,13.719062483310699,11.799882327561207,12.85467859676906,0.4264798017051927,13.210625001362391,0.6206537123840304,12.878537625207557,13.353443896293715,-4.570208015954973,-8.71405991123663,553854000,0.41715726324989916,0.8795763326513496,-16901091000.0,-91.47019532948974,44.757923903640624,51.57585752245338,-111.47859918282509,16.480329062740772,32.224962248066035,-0.08424723586305026,0.6652472729869139,13.996411888122559,13.65579386138916,13.380499839782715,13.10520581817627,12.764587791442871,0.06,0.0,20.776929103075013,-0.057908250266795025,-0.07241058276201795,12.780407633100237,13.1894257409232,0.8634930594838369
2022-09-28,1,12.580749988555908,12.398000001907349,15.66225004196167,12.979374945163727,13.895187497138977,0.8863762338818724,0.843299585672904,0.40097015649911016,2.993825521625237,13.446124911308289,0.6431537592411042,0.06226410470645908,12.47575011253357,14.488700079917908,0.6657100606429214,-0.20327538544203655,0.9288859473922045,0.9747758840324848,0.9900917999668752,-0.06140072425530252,25.334695151205853,15.230511665528395,13.543912494182587,11.857313322836779,12.76382143156869,0.40362235499010474,13.130214282444545,0.6243810160428769,12.77586870997165,13.200894377532604,-3.5832228183288066,-8.349092048142964,542414000,0.42010792019988286,0.8605725245672915,-16358677000.0,-77.62536340180057,44.757923903640624,51.57585752245338,-89.37989720658592,16.586799901712897,30.56727322737075,-0.04311391125716498,0.6512295977704539,13.996411888122559,13.65579386138916,13.380499839782715,13.10520581817627,12.764587791442871,0.06,0.0,20.738269509292053,-0.039589596686255946,-0.03339395082623194,12.688198634556361,13.099928651537214,0.7454851987639588
2022-09-29,1,12.278500080108643,12.398000001907349,15.244249820709229,12.907187342643738,13.749187529087067,0.6896009281569266,0.7137446931809442,0.22759889518285048,2.9943269103830965,13.318249940872192,0.5658374905586243,0.05330495561528516,12.47575011253357,14.297875022888183,0.6164347462265608,-0.17472160739159304,0.9170014264842181,0.9555438888364606,0.9789866929924945,-0.0408920452894731,29.14518538360765,14.817326877874189,13.3898374915123,11.96234810515041,12.627500023160662,0.379258974204588,12.98682143007006,0.5663504471380385,12.722107640191371,13.080403657221696,-4.812076716492888,-8.213256925279985,532763000,0.41984711707027234,0.8480151914772375,-16891440000.0,-89.46558302466934,44.757923903640624,51.57585752245338,-131.27495246032927,15.171113264749144,32.366310104494055,-0.019272769662219757,0.6611417686368348,13.933163970947266,13.55341799545288,13.246500015258789,12.939582035064696,12.559836059570312,0.08,0.0,20.69872343213265,-0.02714764612879539,-0.07850082591687584,12.55174023764474,12.94527108328683,0.6693010211333978
2022-09-30,1,12.233500003814697,12.278500080108643,14.404750108718872,12.746687531471252,13.638062417507172,0.14823303123512102,0.6142097329086124,-0.9431474745968211,2.994658168912814,13.22475004196167,0.5138549959659576,0.04638503292293592,12.445699977874757,13.982700109481812,0.7638077468705498,-0.11975769056304267,0.9238722052685413,0.9573558558121275,0.9836098501425075,-0.01746847416455788,29.316887417806097,14.469969470299493,13.241550004482269,12.013130538665045,12.460321460451398,0.19150961325645208,12.831732136862618,0.4287746912405292,12.606173028568472,12.934039873927706,-7.211274022841915,-14.052218475196867,565638000,0.32357803298163346,0.9465387932257074,-17457078000.0,-90.74341312941924,44.757923903640624,51.57585752245338,-109.74841742382758,15.699315074883422,30.393106626582227,-0.07663705672179157,0.6537745383926609,13.538940128326416,13.234530122756958,12.988500118255615,12.74247011375427,12.438060108184812,0.08,0.0,20.657433085638797,-0.030121460898403396,-0.03359615241556467,12.391587393624443,12.776411056518555,0.6893934673147989
2022-10-03,1,12.410500049591064,12.233500003814697,14.404750108718872,12.55518752336502,13.589937508106232,0.2727104202303474,0.6290311608021933,-0.8436492951923613,2.9945932289536605,13.18150007724762,0.5255249977111817,0.04781407107266824,12.386050009727478,13.918124961853028,0.7785952872644644,-0.11844925741861946,0.9433499775460261,0.9766241348795694,1.0013434089569384,0.0010082309793348898,28.971168332843902,14.413837320269245,13.155774998664857,11.897712677060468,12.404392889567784,0.11824936493181029,12.754732148987907,0.3974057406680401,12.513987941345754,12.848753454012751,-8.730765225855658,-15.073153567516355,547478000,0.3237035011428137,0.9313991436227558,-16909600000.0,-72.85371825488117,44.757923903640624,51.57585752245338,-82.50426730523469,15.203759485210073,28.473447614765327,-0.007317919009147571,0.6480049923518797,13.538940128326416,13.234530122756958,12.988500118255615,12.74247011375427,12.438060108184812,0.08,0.0,20.61855813964592,0.023225306895359177,-0.0003196038407062734,12.38459300994873,12.732233388083321,0.691987584478719
2022-10-04,0,13.036249876022339,12.233500003814697,14.404750108718872,12.471625089645386,13.511749923229218,0.468687387122814,0.6261367620677031,-0.6541981295960801,2.994594513344536,13.069000005722046,0.5257624983787537,0.047860863994798386,12.386050009727478,13.764450049400331,0.8228832372851218,-0.0862202259846144,0.996469493754223,1.0324168283308874,1.0516200190757943,0.044696857997200246,35.44419651581375,14.334711027473265,13.08243750333786,11.830163979202457,12.48800001825605,0.2683397849021806,12.74687499659402,0.39008962510609685,12.48982309759273,12.805188850250962,-3.058115878654963,-7.991991992062766,584182000,0.32483126010238894,0.9897644662422228,-16325418000.0,-41.43886353126607,44.757923903640624,51.57585752245338,2.9863698440007225,19.960156179123633,26.26592837558978,0.048024899940843635,0.6522903638134514,13.538940128326416,13.234530122756958,12.988500118255615,12.74247011375427,12.438060108184812,0.08,0.0,20.580776650254464,0.06074256781674037,0.07679077257155152,12.477515765598842,12.735016550336566,0.6865638543996553
2022-10-05,0,13.01550006866455,12.233500003814697,14.404750108718872,12.471625089645386,13.424937427043915,0.5994637049085828,0.6155952353816783,-0.41651975623607207,2.994630004023148,13.013999938964844,0.5003925013542176,0.0471533499660095,12.386050009727478,13.764450049400331,0.8165079163369627,-0.042525844301043364,0.9969609809274139,1.0323801185595483,1.040582357474996,0.034556769708015356,50.09069326958394,14.286365465232047,13.05517499446869,11.823984523705333,12.57621431350708,0.3285628828702015,12.74857142993382,0.39128626877488437,12.628913698806391,12.855452281846198,4.700424881402028,-0.836741530357375,507131000,0.3590734945117124,0.8596213608698205,-16832549000.0,-39.42448386094922,44.757923903640624,51.57585752245338,1.8854135102280396,18.438102718253997,27.073551508420124,0.05572644486851625,0.6556981818577776,13.538940128326416,13.234530122756958,12.988500118255615,12.74247011375427,12.438060108184812,0.02,1.0,20.548118219190453,0.0371387614412475,0.06412629229117346,12.617542539324079,12.755000046321324,0.6705514095157336
2022-10-06,0,13.277250051498413,12.233500003814697,14.404750108718872,12.471625089645386,13.275499939918518,0.7501548341741248,0.6020404934974574,-0.07875993872043408,2.9946753525831173,13.00362503528595,0.46948124289512627,0.04622125349820087,12.386050009727478,13.764450049400331,0.7983343673254362,-0.050414035825981175,1.019351932332938,1.0563951822641928,1.0541808782963475,0.08134136619893506,49.23808283796724,14.229268491286446,13.025187504291534,11.821106517296622,12.690321445465088,0.416029123360629,12.772500021117073,0.4136458883771041,12.727555266047979,12.888337736145592,4.980642576723697,0.18280883448123114,644157000,0.35794437665360396,1.0901080475465728,-16188392000.0,-43.213429563720275,44.757923903640624,51.57585752245338,41.68591746591856,21.005419099616347,25.4241561590344,-0.04344218504414529,0.6483626285682957,13.538940128326416,13.234530122756958,12.988500118255615,12.74247011375427,12.438060108184812,0.04,0.0,20.50838941969741,0.07446816902961806,0.030935865462454453,12.719886234828405,12.75014693396432,0.632966221746607
2022-10-07,0,12.318250179290771,12.233500003814697,14.404750108718872,12.471625089645386,13.243874967098236,0.8536731891331074,0.5847730789002799,0.30870178975232987,2.994733000701506,13.00362503528595,0.44704999923706057,0.0449696589793755,12.386050009727478,13.568249893188478,0.7140577084612116,-0.0706110850420179,0.9472862718425529,0.9764009644519293,0.9627694628782314,0.00692771287445515,51.70883366103738,14.173271161996727,13.003725004196166,11.834178846395606,12.652821472712926,0.43876128212536014,12.708321452140808,0.40909452329513796,12.86539450172792,12.941706617536932,6.401009059791275,2.588423824228733,672478000,0.335498539444713,1.1204148852945026,-16860870000.0,-93.76498263489444,44.757923903640624,51.57585752245338,-100.30358496248131,18.564955525729225,33.805448451208484,-0.10972210625414475,0.6811938594696516,13.538940128326416,13.234530122756958,12.988500118255615,12.74247011375427,12.438060108184812,0.02,1.0,20.461459503993467,-0.005189759526621818,-0.011783812636847805,12.625678607395717,12.656938620976039,0.5740369376411236
2022-10-10,0,11.809749841690063,12.233500003814697,14.404750108718872,12.440874993801117,13.220750093460083,0.9147481067486565,0.5230313395071512,0.9860332323950187,2.9949203020355997,12.966999888420105,0.4197037160396576,0.04052829606361134,12.314275169372559,13.412224936485291,0.47994639611172835,-0.14484804760099163,0.915105849053349,0.937080927234136,0.9218049182336614,-0.048406607751538266,35.86868378593069,13.951400191507439,12.905337512493134,11.859274833478828,12.585857152938843,0.5314026259765158,12.606678588049752,0.4440570106067982,12.726600932362512,12.845938140771038,-2.0865195596758532,-6.79819135425251,698699000,0.3885622165897906,1.1436618625543014,-17559569000.0,-90.01143463804554,44.757923903640624,51.57585752245338,-166.32564610236605,17.17619985316034,37.69149264184875,-0.15321706729106876,0.6836799843260253,13.411972103118895,13.029014081954955,12.719500064849854,12.40998604774475,12.027028026580808,0.04,0.0,20.410195626401663,-0.0672953328413527,-0.038635732647026466,12.54717241014753,12.549456323896136,0.496826208475383
2022-10-11,1,11.569000005722046,11.809749841690063,13.488499879837036,12.407375037670135,13.163875043392181,-0.2349503526810788,0.4520292321041972,-0.954007000194423,2.995104314612743,12.872124910354614,0.4021537244319916,0.03538226575760731,12.274000072479248,13.289900040626526,0.5157468010043584,-0.12445787545703375,0.9055552244857068,0.9222827859090144,0.91156216040724,-0.11255153009908281,32.752844851951444,13.679645963350085,12.775587499141693,11.871529034933301,12.49092858178275,0.6507809881625846,12.475625021117073,0.46113820260370897,12.493648723571184,12.684623121609734,-3.817650652443792,-10.753623425503173,667482000,0.3530687768802061,1.0968260612899927,-18227051000.0,-87.23133452907648,44.757923903640624,51.57585752245338,-168.31259244595628,16.152989494783494,36.768791439295015,-0.09545211054040065,0.6750599648641733,13.095972103118896,12.749514081954956,12.469500064849854,12.18948604774475,11.843028026580809,0.06,0.0,20.36087565335017,-0.12007272113091794,-0.07400885412510781,12.468238013131279,12.42991270337786,0.5498727708026385
2022-10-12,1,11.539750099182129,11.569000005722046,13.403749942779541,12.378062546253204,13.06374990940094,-0.47683618580213855,0.49244257847620343,-0.5659901964369372,2.994972971656355,12.691375017166138,0.42683748006820676,0.03883735234535643,12.191124987602233,13.237199950218201,0.5970246176029792,-0.11997718000726486,0.910102741249771,0.9266698454980867,0.9307788845609317,-0.11338403916076656,31.143987054770133,13.664497662388351,12.679612505435944,11.694727348483537,12.36653573172433,0.7451008943173962,12.385464310646057,0.5129076694175875,12.262539149509973,12.527044182988092,-5.431806088898879,-13.688333077609043,492590000,0.34994082759868084,0.8158679770949442,-18719641000.0,-90.85545746423915,44.757923903640624,51.57585752245338,-152.11686508414493,15.465687655637092,35.204297263924005,-0.11142983162062721,0.654698493093717,13.095972103118896,12.749514081954956,12.469500064849854,12.18948604774475,11.843028026580809,0.06,0.0,20.324645365562944,-0.12938152147986326,-0.12660428490706707,12.323786326817103,12.354189668382917,0.5957421234952077
2022-10-13,1,11.45549988746643,11.539750099182129,13.403749942779541,12.30831265449524,13.020687520503998,-0.4200566232247088,0.5386319480305953,-0.7093717574162683,2.9948123244883775,12.529625058174133,0.45246622562408445,0.042750984736762455,11.785674858093262,13.237199950218201,0.6801994654072563,-0.11176322685643184,0.9092180711368489,0.9276590982345998,0.9465164965038804,-0.13720839458215883,31.233885273845612,13.676551405979403,12.599287509918213,11.522023613857023,12.140714304787773,0.7478362245705589,12.314357161521912,0.569055718332826,12.083367018341592,12.376169625756093,-7.016235823935454,-9.859787080774769,850103000,0.34971172554075064,1.3709441499869857,-19569744000.0,-59.65528854765788,44.757923903640624,51.57585752245338,-123.5576998388172,13.464466260868784,36.09080864252091,-0.03701144043424679,0.6982914865948862,12.985052040100097,12.569973979949951,12.23449993133545,11.899025882720947,11.483947822570801,0.08,0.0,20.263448688249543,-0.08910898358451591,-0.09455681991356288,12.151500701904297,12.31450823375157,0.6052155164667707
2022-10-14,1,11.649750232696533,11.45549988746643,13.403749942779541,12.267250061035156,13.020687520503998,-0.32125883384039283,0.5847524093894043,-0.9018012697427253,2.994635702446779,12.464750051498413,0.48049747943878174,0.04669623290870688,11.566075015068055,13.237199950218201,0.7255383851614091,-0.11487569111407783,0.930307325731759,0.949718867137903,0.9924436556825155,-0.05426906718602853,30.435028053909836,13.691979822974977,12.522475004196167,11.352970185417357,11.94560718536377,0.6538198253001402,12.260910749435425,0.595136203994245,11.92799472969137,12.238955112881301,-12.12580307672218,-7.995342460208215,713432000,0.3496570152533378,1.1465915142372909,-18856312000.0,-85.43790182288295,44.757923903640624,51.57585752245338,-124.03503917215018,12.5718818535429,32.81238666291781,-0.14266992990224703,0.7131992094581457,12.985052040100097,12.569973979949951,12.23449993133545,11.899025882720947,11.483947822570801,0.08,0.0,20.212146622346012,-0.07030482403777583,-0.14493528176917192,11.868592262268066,12.243067400796074,0.6498134853125845
2022-10-17,1,11.717749834060669,11.45549988746643,13.403749942779541,12.127562463283539,13.020687520503998,-0.13375174341897816,0.6058307321786449,-1.1006004987220863,2.994546355433669,12.430750012397766,0.4922849941253663,0.04863044031365934,11.566075015068055,13.237199950218201,0.7527036310256211,-0.11856166569507952,0.940591659763551,0.9598300976028711,1.0097373765552227,-0.007790174124147953,33.654660107780806,13.66951149144164,12.457850027084351,11.246188562727063,11.72282144001552,0.28754536309827694,12.206571442740303,0.608325084894096,11.859487410086286,12.140663731183047,-10.493256722852522,-6.035245758152139,580774000,0.3458342470851538,0.9325593557730305,-18275538000.0,-62.18784194569659,44.757923903640624,51.57585752245338,-80.45164882297027,11.664777236306833,30.444859844641204,-0.13827840061116362,0.713756388665441,12.985052040100097,12.569973979949951,12.23449993133545,11.899025882720947,11.483947822570801,0.08,0.0,20.172110165942875,0.01868035403360291,-0.015568143170325855,11.691310610089984,12.205598422459193,0.6202819419315735
2022-10-18,1,12.105249881744385,11.45549988746643,13.403749942779541,11.786749839782715,12.855375051498413,0.0439996535064747,0.6000035971243409,-1.1098311275308508,2.99455833692045,12.404250025749207,0.48743499398231516,0.04845420673389962,11.566075015068055,13.237199950218201,0.7520377605754416,-0.11448868238967784,0.9775779397769234,0.9972299635786779,1.0447854474782143,0.04635231011816998,35.28110628703961,13.582907205788139,12.382900011539459,11.182892817290778,11.692392826080322,0.21653669462011968,12.172607149396624,0.599029905848395,11.82352144698514,12.082744648988147,-11.745656754138977,-6.096488247312124,659362000,0.3468070957225275,1.0474351530536463,-17616176000.0,-59.4090708737909,44.757923903640624,51.57585752245338,-42.351991615426506,16.0187306099664,27.82403488523083,-0.12895055240241438,0.7252023329036636,12.985052040100097,12.569973979949951,12.23449993133545,11.899025882720947,11.483947822570801,0.08,0.0,20.128409352324425,0.032884544378651404,0.025449937673538568,11.675752094813756,12.150715351104736,0.5948773795204284
2022-10-19,1,12.028499841690063,11.45549988746643,13.403749942779541,11.786749839782715,12.636062502861023,0.17746899004928043,0.5697090576654742,-0.907936398319158,2.9946663495167973,12.35812509059906,0.45882500410079957,0.04621813992705755,11.566075015068055,13.060349893569947,0.7122085198155964,-0.09687587925606181,0.9758224506275248,0.9985658733871609,1.0286395853314196,0.042353581170061494,43.34837886280295,13.465943124009383,12.326525008678436,11.187106893347488,11.723642826080322,0.24956233691248128,12.154749989509583,0.5993565828607047,11.893597408854147,12.093443529508793,-1.729144110942633,-3.7795847405286853,523131000,0.358226806820309,0.8502405675779299,-18139307000.0,-56.454458787388084,44.757923903640624,51.57585752245338,-28.02930938492791,15.187477166095348,26.38017360908537,-0.09457472757555054,0.7102593614604606,12.985052040100097,12.569973979949951,12.23449993133545,11.899025882720947,11.483947822570801,0.08,0.0,20.094292925868707,0.04791296742420181,0.040134471924685444,11.730135372706822,12.138653891427177,0.5518591315151279
2022-10-20,1,12.295249938964844,11.45549988746643,13.277250051498413,11.786749839782715,12.504062592983246,0.17644615694091867,0.5160042638972879,-0.8482718316354707,2.994847869248002,12.298375129699707,0.42111129045486456,0.042096121844809216,11.566075015068055,13.01757504940033,0.7634375796647309,-0.06042026256213744,1.003058260863661,1.0291431127604997,1.0427347170755057,0.07330540436888233,44.567699290540155,13.289771031418537,12.257762503623962,11.225753975829386,11.827392816543579,0.3165333120950776,12.159160699163165,0.600207296526586,11.925691402431363,12.087879282344488,1.852283096021069,-2.0360812541230775,652398000,0.33554689928520537,1.0696173155244675,-17486909000.0,-51.42454032099545,44.757923903640624,51.57585752245338,19.233119461491796,18.302158643705837,24.476820326042972,-0.09527317632608086,0.710812293677719,12.985052040100097,12.569973979949951,12.23449993133545,11.899025882720947,11.483947822570801,0.02,1.0,20.053609120459846,0.01956533067934685,0.06034789990370696,11.816920552934919,12.142579283033099,0.546632158057279
2022-10-21,1,12.237249851226807,11.45549988746643,13.277250051498413,11.786749839782715,12.45787501335144,0.28068671887697916,0.5008781802587486,-0.6045949645893809,2.9948966152557865,12.286875009536743,0.398415036201477,0.040946760787745555,11.566075015068055,13.01757504940033,0.78371951239452,-0.012509038354332366,1.0003944314348217,1.032777363067802,1.0232413190282423,0.05043023299172367,51.99348367104384,13.234181358800884,12.232424998283387,11.23066863776589,11.927035638264247,0.32065132636046667,12.146785684994288,0.5964005402531842,12.017048231842988,12.130200131475851,6.277551498691274,0.5047609852527191,609494000,0.3338302549775776,1.0037033642837658,-18096403000.0,-41.85720582522839,44.757923903640624,51.57585752245338,9.024378337973816,17.167046957494055,25.171594314045453,-0.0760693373701136,0.7036828480487274,12.985052040100097,12.569973979949951,12.23449993133545,11.899025882720947,11.483947822570801,0.02,0.0,20.01563190577793,0.11035888791386017,0.04230768831745529,11.954806191580635,12.13929625919887,0.5453194383863593
2022-10-24,1,12.470250129699707,11.45549988746643,13.277250051498413,11.786749839782715,12.427500069141388,0.3450643794753389,0.4983744993517005,-0.5311060197804576,2.994904204622305,12.257874965667725,0.3898650312423705,0.04077771263492415,11.566075015068055,13.01757504940033,0.7835397624425143,-0.01296581308725695,1.0203336585961,1.0531616546525224,1.0325790163298803,0.06421883947818219,51.006558437607175,13.218486490787905,12.221737492084504,11.224988493381103,12.071999958583287,0.3007039182890974,12.10635713168553,0.548748016035398,12.070332115006767,12.166884909894893,6.044322849713292,-1.395996919318062,517457000,0.33386743864880836,0.8542406502607467,-17578946000.0,-37.17903647711484,44.757923903640624,51.57585752245338,36.941701965807255,18.199332660917456,23.51128668803427,-0.00588690763041516,0.6995626378409477,12.985052040100097,12.569973979949951,12.23449993133545,11.899025882720947,11.483947822570801,0.02,0.0,19.984398698204636,0.05980811630595517,0.12220531932782969,12.04601628439767,12.098758493150983,0.5519734840040276
2022-10-25,1,12.979749917984009,11.45549988746643,13.277250051498413,11.786749839782715,12.47231262922287,0.3241891258379399,0.49989858405071913,-0.5684805176555541,2.994899402465233,12.257874965667725,0.392755036354065,0.04089032903868706,11.566075015068055,13.01757504940033,0.770795847691652,-0.000661136996286662,1.0617078381890128,1.0901100797584444,1.061538523934858,0.07224138657050228,55.33146699109287,13.22514716657556,12.22534999847412,11.225552830372681,12.261999913624354,0.3948738946840856,12.103803549494062,0.5442567122435085,12.169274359490675,12.222236077962554,8.858192590473717,-4.341737475926101,505482000,0.3377204679230489,0.8378169739807544,-17073464000.0,-13.893788270243688,44.757923903640624,51.57585752245338,125.2346320468152,22.920189924987326,21.828704892533295,0.04697482645000442,0.6996653218308506,12.985052040100097,12.569973979949951,12.23449993133545,11.899025882720947,11.483947822570801,0.04,0.0,19.95661860233444,0.10813046407462035,0.1154944834461635,12.336346898760114,12.102469580514091,0.5969826074283721
2022-10-26,1,12.965250015258789,11.45549988746643,13.277250051498413,11.786749839782715,12.497875094413757,0.28156213240642,0.5239486410752777,-0.8405524575601628,2.9948207207602655,12.257874965667725,0.4158125400543213,0.042769877470592375,11.566075015068055,13.01757504940033,0.7215851807438962,0.03171511474205046,1.0583521189981366,1.0761419049561218,1.0453992099994516,0.0778775562952585,63.26367380803686,13.29830977013426,12.250412487983704,11.202515205833148,12.440214225224086,0.3897825305109079,12.081517832619804,0.4968330450523102,12.37044044959589,12.330900284058359,11.416551073813233,-0.2746736621100884,532953000,0.3559868980486639,0.8840422440264659,-17606417000.0,-19.106783013707357,44.757923903640624,51.57585752245338,106.03441602530336,22.226038512962624,20.310288405609473,-0.0010458804942810223,0.6982606095950172,12.780299579620362,12.404349607467651,12.100499629974365,11.79664965248108,11.420699680328369,0.06,0.0,19.92724182186153,0.07011882853088625,0.07763010751624731,12.480227742876325,12.085769176483154,0.6044573728375318
2022-10-27,1,13.441499948501587,11.45549988746643,13.277250051498413,11.786749839782715,12.594000101089478,0.25049691524845896,0.5424445309099515,-1.019488241201541,2.994757982431876,12.257874965667725,0.4350375413894653,0.04421031439455066,11.566075015068055,13.01757504940033,0.761339519560993,0.0559310934291308,1.095509134658859,1.1026254158162847,1.0676712018985963,0.09322706046862583,64.78356012003294,13.35452655113875,12.269637489318848,11.184748427498945,12.631107091903687,0.5077522212230167,12.161749958992004,0.6147137172734878,12.52046179308428,12.406812490263489,10.646243509755928,-2.3498844642487775,583113000,0.3479427209200852,0.963223394623546,-17023304000.0,-21.884315071235623,44.757923903640624,51.57585752245338,136.5614974551657,24.62769614821006,18.400760614242333,-0.04146165785124059,0.715670594644575,13.124100162506105,12.682450078964234,12.325500011444092,11.96854994392395,11.52689986038208,0.08,0.0,19.897136102826053,0.08053133170754445,0.09335332606152216,12.652798788888115,12.164275441850934,0.6359003080806905
2022-10-28,1,13.462249994277954,11.45549988746643,13.441499948501587,11.786749839782715,12.968874990940094,0.26687406416668913,0.5996030364046931,-1.103942924359516,2.994553676604586,12.266249895095825,0.4973950195312501,0.048638333297379106,11.566075015068055,13.060349893569947,0.7358258645969441,0.09874524415009657,1.0920248270930972,1.0866248855748428,1.0501958079634945,0.10010420298220346,71.11294826830782,13.52699355554788,12.327787482738495,11.12858140992911,12.835928542273384,0.5133020795752682,12.279785684176854,0.6952968712922273,12.754137711745031,12.545345913183573,11.03859961430756,9.118582208203593,521040000,0.36077596399852846,0.863869293511961,-16502264000.0,-0.5268601983466881,44.757923903640624,51.57585752245338,137.34796199615462,22.7024203991862,17.566671852890245,0.03596091441282276,0.7209084460482079,13.133268226623537,12.68986613082886,12.331500053405762,11.973133975982666,11.529731880187988,0.1,0.0,19.87129888324657,0.10973856500899659,0.13449232091929178,12.90730231148856,12.318718842097692,0.7163110934369356
2022-10-31,1,13.602499961853027,11.45549988746643,13.462249994277954,11.786749839782715,12.988687455654144,0.19494073888684132,0.6478078326080967,-1.2661295855269399,2.994368832398951,12.306750059127808,0.5555475211143494,0.052288002965124876,11.566075015068055,13.29367504119873,0.781322339342203,0.08474678219928339,1.0979298528623447,1.0821141923280733,1.0412360844977286,0.09079608030128461,70.85678323491892,13.68484064747785,12.389224982261657,11.093609317045464,13.022678545543126,0.5215431577811113,12.425035681043353,0.7459470762516913,12.934949975179219,12.661530541929611,11.919609024049683,13.992677023135027,486341000,0.35987656110790256,0.8104468338454927,-16015923000.0,-11.623331070306904,44.757923903640624,51.57585752245338,114.16240569053544,21.463415713269853,16.607955189249132,0.006396865600668107,0.7080578684082935,13.133268226623537,12.68986613082886,12.331500053405762,11.973133975982666,11.529731880187988,0.1,0.0,19.847229052084494,0.07127569342824591,0.08270514580241829,13.09329114641462,12.45510584967477,0.7557885232940137
2022-11-01,1,13.69950008392334,11.45549988746643,13.602499961853027,11.786749839782715,13.020687520503998,0.15912769110161062,0.699772824488024,-1.3725306378951097,2.9941557506825367,12.306750059127808,0.6211075162887573,0.056211957813828,11.566075015068055,13.443574953079224,0.8048186027303541,0.04343657809691083,1.1004653136558193,1.0737316191898056,1.0307932595208318,0.055451774532426557,70.69766789750706,13.848370626850803,12.448824977874756,11.049279328898708,13.231571435928345,0.44116872735105606,12.579303537096296,0.7716630631998317,13.104531587651735,12.777337118578872,10.632154932819878,17.577145432839565,432817000,0.3348340516107408,0.7304660740695236,-15583106000.0,-12.275061451000603,44.757923903640624,51.57585752245338,117.23195535791201,21.412925235687414,15.870033978360476,-0.05969906284836447,0.6880537663677191,13.1905680809021,12.736216012954712,12.36899995803833,12.001783903121948,11.54743183517456,0.12000000000000001,0.0,19.82636096279511,0.02126547019681646,0.07492665946872396,13.247020993913923,12.600913592747279,0.7783991630058182
2022-11-02,1,13.62250018119812,11.45549988746643,13.69950008392334,11.786749839782715,13.080937564373016,0.21478484251894756,0.7413084811956099,-1.3728227592735416,2.993974506259618,12.306750059127808,0.6587600135803221,0.059390259915920375,11.566075015068055,13.476274991035462,0.8215324544446496,0.05255272649151241,1.0913726835570163,1.0545199961748788,1.0140164788691912,0.05069321186755471,72.10639323225915,13.964604450661025,12.481987488269805,10.999370525878586,13.396178586142403,0.30312968380016114,12.734089272362846,0.74580541605116,13.253319742229458,12.864884607816556,11.949173633567185,18.715743115566095,672628000,0.3349307244607614,1.119560356996058,-16255734000.0,-32.96740914315552,44.757923903640624,51.57585752245338,98.77873570757299,19.26166288259278,17.37307673144039,-0.14265762022298634,0.7102641835025313,13.500584140777587,13.061708204269408,12.707000255584717,12.352292306900024,11.913416370391843,0.14,0.0,19.79360516589482,0.025046407661059256,-0.003167130307730376,13.335519109453474,12.690767696925572,0.7788898748498139
2022-11-03,1,13.300250053405762,11.45549988746643,13.69950008392334,11.786749839782715,13.318312525749207,0.21434983138765076,0.7742246559723859,-1.4510434375269228,2.993824492444047,12.306750059127808,0.6951800203323366,0.0618769000076966,11.566075015068055,13.604499983787537,0.836885629068461,0.026003135314962574,1.0629708525600128,1.0170252990669524,0.9804358818131953,-0.010508492031171768,68.64995591192566,14.060786805841259,12.512337493896485,10.963888181951711,13.441964319774083,0.24914545453884962,12.851982116699219,0.6895427191849558,13.343895631394677,12.915470913985926,9.239991495873548,18.916680328395138,500065000,0.33143702946718356,0.8424389852321953,-16755799000.0,-29.298201192358498,44.757923903640624,51.57585752245338,82.34028290542436,17.681807768525683,18.48331184238545,-0.09006740039950702,0.7184595856024575,13.574452075958252,13.181274099349976,12.863500118255615,12.545726137161255,12.152548160552978,0.14,0.0,19.768852839452595,0.01859445941047455,0.040710256106046096,13.358357565743583,12.847352232251849,0.7940780743378356
2022-11-04,1,14.016999959945679,11.45549988746643,13.69950008392334,11.786749839782715,13.335562527179718,0.21340845792699148,0.7753761954355491,-1.4555461415750164,2.9938191393299785,12.306750059127808,0.6965600204467772,0.06196323733154594,11.566075015068055,13.604499983787537,0.9195490710600475,0.07971910456615919,1.1201513540230663,1.0636586416356342,1.0354277706995385,0.04120781933952489,65.72733547058161,14.06423988486295,12.513487493991851,10.962735103120753,13.59221431187221,0.23015385562847213,13.016214268548149,0.6722105902195428,13.32904477393909,12.908659120253589,2.469231976324028,14.16768417984522,612576000,0.25410769105541886,1.0372151493865909,-16143223000.0,-2.795861835203913,44.757923903640624,51.57585752245338,122.42281761531723,20.688622933060277,17.0116363033326,-0.00545243885243197,0.724855370003021,13.612804077148438,13.231598068237304,12.923500061035156,12.615402053833009,12.234196044921875,0.16,0.0,19.7418113647075,0.02327592654278443,0.07437762032297084,13.538208280290876,13.0092180115836,0.8680454990730808
2022-11-07,1,14.223749876022339,11.45549988746643,14.016999959945679,11.786749839782715,13.446687459945679,0.15117269109203055,0.8397115419691827,-1.4861008906486013,2.993516019913124,12.382750034332275,0.7704675269126892,0.06665210477505157,11.566075015068055,13.630200171470642,0.8522540289369469,0.18690066663933172,1.129010165571311,1.064964808135556,1.0421589295358615,0.04567174533442753,78.80087249311349,14.27784806696296,12.598424983024596,10.919001899086233,13.703964301518031,0.3179441019328352,13.167535696710859,0.6895920585300072,13.498039306461234,13.013596991913357,8.112068363117459,19.621942424488743,410061000,0.2591826005296824,0.7117076455275525,-15733162000.0,-4.305665557745943,44.757923903640624,51.57585752245338,122.62832610406365,21.581698701216773,16.223130820721387,0.02900676954686447,0.7057942165841374,13.803591686248778,13.427203676223753,13.122999668121338,12.818795660018921,12.442407649993896,0.18,0.0,19.72446442178752,0.05956871805722286,0.033757444810910565,13.698789596557617,13.175794192722865,0.9167164417996795
2022-11-08,1,14.62749981880188,11.45549988746643,14.223749876022339,11.950812339782715,13.497312486171722,0.05729031398892067,0.8896800603384487,-1.4144299257314945,2.9932860182779772,12.717750072479248,0.8123000144958497,0.06994821274307578,11.566075015068055,13.731250071525574,0.8387862742302946,0.2294709887619716,1.1500397893998286,1.0810021723230643,1.0620725052629751,0.06773967876153142,82.4492685825512,14.498485105418107,12.71912498474121,10.939764864064314,13.870428562164307,0.44852541856174394,13.353178552218846,0.7089315077578343,13.678213117575034,13.151489942482367,5.819662467118891,17.500671320075842,595292000,0.24565797802630585,1.0397106516058838,-15137870000.0,-9.62049218996534,44.757923903640624,51.57585752245338,135.70720219943027,24.96558291241023,15.111429768216603,0.032208135933752616,0.7035946432533741,14.182055862426758,13.743471904754639,13.388999938964844,13.034527973175049,12.59594401550293,0.19999999999999998,0.0,19.701052278269295,0.07819541824519582,0.08186996708557412,13.808413096836635,13.357857704162598,0.9641525577030733
2022-11-09,1,13.976999998092651,11.45549988746643,14.62749981880188,12.086062371730804,13.6075000166893,0.06584794276477693,0.9402658714389855,-1.19481729878739,2.993064368890483,12.972499966621399,0.8349200081825255,0.07304709609085534,11.638750219345093,14.037674951553345,0.8151700412686812,0.2675750941815103,1.085841029580335,1.0205020377179648,1.0013468799879424,0.026023109721357462,85.2993681191281,14.752581718273175,12.872049975395203,10.991518232517231,13.923928567341395,0.43331787577354197,13.47330355644226,0.6564186332861576,13.914604653523202,13.335107502343803,8.655684042557581,21.607016762837187,454414000,0.24898731342744418,0.7963141464161754,-15592284000.0,-37.117173060158315,44.757923903640624,51.57585752245338,77.18194271757093,22.858819712761804,18.41092180308834,0.0043486609256150836,0.7135521983975701,14.182055862426758,13.743471904754639,13.388999938964844,13.034527973175049,12.59594401550293,0.19999999999999998,0.0,19.68106261706446,0.04213638080450699,0.01720446779412796,13.848237037658691,13.470764092036656,0.925315624946026
2022-11-10,1,15.21749997138977,11.45549988746643,14.62749981880188,12.204249858856201,13.641750156879425,-0.08942190597997719,0.9173570847514356,-1.183509557501958,2.9932311336536537,13.139999985694885,0.8034625172615051,0.07059898909164966,11.710949873924255,14.037674951553345,0.8387212961921071,0.2201126214828056,1.1711253255033458,1.1029271861541492,1.0847096417526776,0.14415141897975547,68.13768088165416,14.828626639843598,12.993912470340728,11.159198300837858,14.140785694122314,0.635132010942352,13.68617856502533,0.7060988212303756,13.93013646004303,13.414056890159852,2.7531706472330475,13.678046948831662,700819000,0.3044512900256905,1.2443906943478087,-14891465000.0,-0.6201069226117261,44.757923903640624,51.57585752245338,178.0141862071988,32.66535998642713,15.149498472866247,0.0028985747156943607,0.8052270248464788,14.89767584991455,14.356161903381349,13.918499946594238,13.48083798980713,12.939324043273928,0.2,0.0,19.658142345744373,0.17353392666459722,0.19146682944337842,14.163261549813408,13.705141271863665,1.0762570528684545
2022-11-11,0,16.00125002861023,11.649750232696533,15.21749997138977,12.280749917030334,13.768875062465668,0.14203588924140859,0.9669766358857033,-0.7898920686640105,2.9930458626114134,13.370875000953674,0.8189112627506256,0.07335576701611904,11.997424840927124,14.264124870300293,0.7302828339866874,0.3062511785600249,1.2138700414310128,1.144993106619862,1.110230327876991,0.14156025357313617,77.4084211937207,15.115965746308303,13.182012474536895,11.248059202765488,14.480607100895472,0.8948662447006253,13.938392843518939,0.8535891382079234,14.252194970987865,13.661165856197396,11.080695486456738,24.35392066350748,655487000,0.392489954818847,1.169916678148914,-14235978000.0,-1.664436733124318,44.757923903640624,51.57585752245338,211.9874079448689,35.47614575522033,13.941529378524834,0.11385005583521152,0.8124964937917598,15.509899848937987,14.966049793243407,14.52649974822998,14.086949703216552,13.543099647521972,0.2,0.0,19.640422562619747,0.15336251611367246,0.2165262278660878,14.606893811907087,13.97120646068028,1.1848866379149257
2022-11-14,0,16.24375033378601,11.717749834060669,16.00125002861023,12.426500082015991,13.986999988555908,0.5200137358171102,1.0806102806241604,-0.1322789829909654,2.9925163806777935,13.45187497138977,0.8496787714958192,0.08064504101343127,12.097574877738953,14.686499834060669,0.7044723756002517,0.3655565492701047,1.2122574950179703,1.1416046835331004,1.0968540522337897,0.14201602779650147,81.19699638183218,15.560808025580897,13.39958746433258,11.238366903084263,14.901107140949794,0.938296585108442,14.171535730361938,1.0040949173230063,14.688581200626821,13.991146205693504,17.461918265894234,28.315389524552796,527852000,0.4129989229384582,0.9465835519783315,-13708126000.0,-6.393548862360333,44.757923903640624,51.57585752245338,194.45769011764335,34.86577746336452,13.17090969162402,0.08661744384869177,0.7986039571296751,15.635648742675782,15.076176635742188,14.624000549316406,14.171824462890624,13.612352355957032,0.2,0.0,19.627016971253884,0.13943073033199438,0.15110203394175406,15.017125129699707,14.187741347721644,1.2852186545314894
2022-11-15,0,16.691999912261963,12.028499841690063,16.24375033378601,12.841500043869019,14.068687438964844,0.6765548399350972,1.1745386787802214,-0.18187688412342595,2.992077213987814,13.53237497806549,0.9000150156021117,0.08619905893843074,12.224049854278565,15.295874977111817,0.7593277099990579,0.3418764992437531,1.2250211169985514,1.1517284121378597,1.0971906266315818,0.14113827510060317,81.82889151044637,15.97496484687929,13.625887489318847,11.276810131758404,15.283249991280693,1.055605844541344,14.437732151576451,1.1439557824750697,15.077430543785276,14.295263313699598,22.131164967282057,25.146866745711236,545876000,0.411270000720884,0.9889688617824904,-13162250000.0,-8.213728808640546,44.757923903640624,51.57585752245338,185.18724976898673,36.7863461837896,12.335613088187241,0.09568259686738777,0.7917750397143699,16.04408745956421,15.453955625534057,14.976999759674072,14.500043893814087,13.909912059783935,0.2,0.0,19.615015695451945,0.14135045312560046,0.16537300140396607,15.375399725777763,14.45680400303432,1.3837377670069013
2022-11-16,0,16.07675004005432,12.028499841690063,16.691999912261963,12.976124942302704,14.324687361717224,0.7083753196144429,1.2966806666147497,-0.3241383101568789,2.9914337105301763,13.612500071525574,1.0157949972152711,0.09358784627976607,12.28944993019104,16.025500059127808,0.7666441416024606,0.3877042134887416,1.160338431940119,1.0868360138277473,1.0288264009918315,0.15022895057939545,83.97515194416764,16.448586324074228,13.855224990844727,11.261863657615226,15.547964300428118,0.9748853239465859,14.625964300973076,1.1835447106283474,15.479661025815965,14.610724859958177,19.08396917999742,28.744142169392536,649547000,0.40817574753937336,1.1634672289595147,-13811797000.0,-26.917358977317313,44.757923903640624,51.57585752245338,123.18443836614512,34.15497491879678,16.04457559091781,0.05267466550551858,0.7918625526827986,16.04408745956421,15.453955625534057,14.976999759674072,14.500043893814087,13.909912059783935,0.2,0.0,19.597804152601686,0.15490707167859474,0.08957672544230752,15.605066435677665,14.65192801611764,1.3811745946668985
2022-11-17,1,15.798250198364258,12.237249851226807,16.691999912261963,13.220125019550323,14.774999856948853,0.59583378837539,1.311610599868215,-0.7318143007507389,2.9914466783622875,13.66100013256073,1.067903747558594,0.09330234897556798,12.452750110626221,16.09345006942749,0.8285148817961246,0.3075578064586988,1.1238197170404238,1.0505779782556668,0.9845446843984208,0.038163313820689826,72.85146419304023,16.68085870049937,14.05763750076294,11.434416301026511,15.715214354651314,0.8871291218856184,14.792821458407811,1.171467191520858,15.628862856306437,14.802373046029139,13.02750807756873,19.605327542678772,710894000,0.45101896047439877,1.2667156560177788,-14522691000.0,-32.68182872410279,44.757923903640624,51.57585752245338,95.07499053942466,31.890409568801005,18.046480562379504,0.056213477216384554,0.7875152917304014,16.04408745956421,15.453955625534057,14.976999759674072,14.500043893814087,13.909912059783935,0.02,1.0,19.57798837701265,-0.004634880869162972,0.13799359131270825,15.75851058959961,14.783461843218122,1.3481810772883909
2022-11-18,1,15.624250173568726,12.237249851226807,16.691999912261963,13.40618747472763,15.362687528133392,0.45257089885727997,1.2983955371522165,-1.00000357266569,2.99161733745515,13.838250041007996,1.1027487707138064,0.0912256672067522,12.91575002670288,16.09345006942749,0.8350278834594994,0.29099678362622095,1.0977645916861487,1.0220294822744296,0.9667035882276204,-0.02356065022216569,68.72336273805718,16.829578588037347,14.23278751373291,11.635996439428475,15.950535808290754,0.4692619205514625,14.937232187816075,1.1375684584980614,15.671093451053032,14.95081382787456,8.003762735019967,17.352227191436842,492072000,0.46022612622484116,0.8860745133650725,-15014763000.0,-39.31220290571103,44.757923903640624,51.57585752245338,66.55486341025443,29.360901417506007,20.34717075002228,-0.007590110020661167,0.794264265498373,16.04408745956421,15.453955625534057,14.976999759674072,14.500043893814087,13.909912059783935,0.04,0.0,19.563249873413245,-0.05622579127859928,-0.021650714985005814,15.991603170122419,14.919920103890556,1.3009364488828226
2022-11-21,1,15.255250215530396,12.470250129699707,16.691999912261963,13.457062482833862,15.667750179767609,0.37541541468013745,1.2469368193696841,-1.2142473219138876,2.992016714372076,13.996999979019165,1.1064150238037107,0.08657998278278285,12.978299927711486,16.09345006942749,0.8409253920389799,0.2529219551384387,1.0592351436661551,0.9875098834086511,0.9482967669999285,-0.06085418071217186,65.6344389101089,16.89601116858937,14.402137529850005,11.908263891110638,15.955928700310844,0.45955003985900894,15.048357197216578,1.0819881247731111,15.660325498235231,15.032263973370119,11.7854344687763,14.863078238452584,404739000,0.4670277249054706,0.7362861499492271,-15419502000.0,-41.58830467472788,44.757923903640624,51.57585752245338,46.464989564288565,28.273808199073553,19.966861917973297,-0.031419783947121555,0.7658882685078543,16.04408745956421,15.453955625534057,14.976999759674072,14.500043893814087,13.909912059783935,0.06,0.0,19.550556236651882,-0.060018347746853995,-0.061860623472970354,15.929797445024763,15.046529497419085,1.241885259181945
2022-11-22,1,15.636500120162964,12.965250015258789,16.691999912261963,13.567437469959259,15.667750179767609,0.329999875646135,1.1769628219213462,-1.3396824783232752,2.9924801258142044,14.120374917984009,1.0664012885093688,0.08093882507140189,13.268200039863586,16.09345006942749,0.8647775491181221,0.17531156701205636,1.0753100475075177,1.0054754121499991,0.9840899230252194,-0.06323387237281419,59.11957347534071,16.89531317798423,14.54138753414154,12.187461890298847,15.903821570532662,0.474006321864824,15.192214335714068,1.0092721492960126,15.560645443732511,15.038069578227834,0.24807126145292432,11.356254768980673,472866000,0.47416390864966373,0.862779857996915,-14946636000.0,-23.750602535000116,44.757923903640624,51.57585752245338,66.29621937217075,31.178153857972593,18.251101850616614,-0.03067675782614439,0.7780391654738605,16.04408745956421,15.453955625534057,14.976999759674072,14.500043893814087,13.909912059783935,0.06,0.0,19.53737107011031,-0.03768136891292506,-0.015771541381772072,15.888546398707799,15.247720105307442,1.2452206400159627
2022-11-23,0,16.2979998588562,12.965250015258789,16.691999912261963,13.617500126361847,15.676937639713287,0.18196063101195717,1.142638900390815,-1.429160658348189,2.992710216148676,14.42562484741211,1.0477475595474242,0.07786706943263848,13.427374958992004,16.09345006942749,0.8365526669871405,0.2060315151470572,1.1106548938502157,1.0412560338342545,1.0395325804880993,0.013762098574068071,62.67696042396312,16.95950284503212,14.674225044250488,12.388947243468856,15.911571502685547,0.4808839929004049,15.40633932181767,0.8876734140309587,15.581266606472045,15.086401710933337,-2.279508837091433,14.784363458806057,427241000,0.4764950169305892,0.7871245995206223,-14519395000.0,-14.510758666635473,44.757923903640624,51.57585752245338,94.89220814978943,34.16337865453117,17.409418747479673,0.02901388746502469,0.7573935334534876,16.218963275909424,15.73701732826233,15.347499370574951,14.957981412887575,14.47603546524048,0.06,0.0,19.527484848234554,0.038277754511075734,-0.008820408524184278,15.920519828796387,15.468822479248047,1.2339212538536601
2022-11-25,0,16.311750411987305,13.300250053405762,16.691999912261963,13.680250108242035,15.84900015592575,0.06951066859507032,1.1241254613377754,-1.5460493559757973,2.992864673553619,14.922499895095825,1.0434875488281254,0.07574529166201406,13.460174989700317,16.24917528629303,0.8223077056547363,0.2125134785030481,1.0991106731125841,1.0269070074906919,1.0374814545089523,0.032503613196112946,67.0345094048037,17.08911345910591,14.84086253643036,12.592611613754807,15.857250145503453,0.3911341363735816,15.570250068392072,0.8207362684090018,15.760604129918233,15.218342443702095,0.33397167498539254,22.539048464602462,167934000,0.4850813779456722,0.3216953571747725,-14351461000.0,-22.47603815522429,44.757923903640624,51.57585752245338,83.46005744339234,33.00037475242879,16.816760095611595,0.07151752891082708,0.7280795818098172,16.23359534072876,15.760701433181763,15.378499507904053,14.996297582626344,14.523403675079345,0.06,0.0,19.523548474657794,0.03782625819692331,0.022627412790511187,15.863995552062988,15.619697638920375,1.2037770083842374
2022-11-28,1,15.983749866485596,13.300250053405762,16.691999912261963,13.907625019550323,16.020125031471252,-0.10525977690292893,1.1195208720780074,-1.5399412768851672,2.992930142038886,15.236375093460083,1.032712560892105,0.07471255008132087,13.58847496509552,16.299374914169313,0.820901173563053,0.21166598591769675,1.0666944602564772,0.9993731772047824,1.0100220035134475,0.023009084527142898,67.10035076528182,17.223416803760657,14.984375059604645,12.745333315448631,15.843964406422206,0.38394918836577285,15.695964353425163,0.7281993843709749,15.897294685159956,15.351288951196462,-2.278034401350113,16.371195395583914,303741000,0.4851823039335992,0.594215427522057,-14655202000.0,-36.153126147375836,44.757923903640624,51.57585752245338,56.770783911752495,30.93479441078165,20.191202235871067,0.004018048318068718,0.7212167522914069,16.23359534072876,15.760701433181763,15.378499507904053,14.996297582626344,14.523403675079345,0.06,0.0,19.51570257510191,0.027126952908202995,0.00956814809308286,15.852148192269462,15.728607313973564,1.182211628070976
2022-11-29,1,15.72950005531311,13.300250053405762,16.691999912261963,14.006999969482422,16.020125031471252,-0.2890816636735009,1.0823707052165963,-1.435044174817021,2.9931455660467945,15.43975019454956,0.981360049247742,0.07163060672612474,13.62050015926361,16.299374914169313,0.8287604452475003,0.1750597251468897,1.0409683364769382,0.9835840016548298,0.9894603062647297,0.031087647405475538,61.75271327296439,17.27519146364822,15.110450053215027,12.945708642781835,15.8341429574149,0.38618625651202965,15.774678656033107,0.6602057642910146,15.917378046602568,15.440088669821996,-0.5784762053090386,12.373670837886243,298384000,0.4968034877744802,0.5946685227803241,-14953586000.0,-41.95737937666374,44.757923903640624,51.57585752245338,34.31475071036347,29.632652617266736,21.43573128357076,0.004166817554741376,0.6991298199615426,16.23359534072876,15.760701433181763,15.378499507904053,14.996297582626344,14.523403675079345,0.06,0.0,19.507438641017878,0.02102233841166057,0.014926293944151202,15.846724101475306,15.802617345537458,1.1224813604072497
2022-11-30,1,16.286750078201294,13.300250053405762,16.691999912261963,14.172062397003174,16.020125031471252,-0.47673085447301156,1.0323185028711213,-1.1972610818302045,2.993402970554014,15.630375146865845,0.9050100433826447,0.06784070888386232,13.691800093650818,16.299374914169313,0.821518098075896,0.14818058753633057,1.0703137332581711,1.0217149913485954,1.0184374598694834,0.04158539014749496,57.84323829097722,17.281437063630275,15.216800057888031,13.152163052145788,15.928785800933838,0.40680386317877976,15.939660804612297,0.42206748630353297,15.87104660109313,15.492895271984688,-0.43517568204019086,7.533756623908774,565298000,0.503996888622302,1.1119392166593594,-14388288000.0,-3.0599297525854463,44.757923903640624,51.57585752245338,86.93043567266191,35.41863321029988,18.693964845965212,0.09666041114019729,0.7444062748498448,16.41956336593628,16.061717473983766,15.772499561309814,15.483281648635865,15.12543575668335,0.02,1.0,19.495090746803246,0.05545119012889144,0.10513337735614968,16.06344849722726,16.02752583367484,1.1093273603193246
2022-12-01,1,17.00850009918213,13.300250053405762,16.691999912261963,14.526562333106995,16.118500113487244,-0.6844934034887097,0.9955282651871817,-0.8645391097517905,2.9935936470914455,15.683000087738037,0.8528550386428833,0.064871479202078,13.941550016403198,16.299374914169313,0.7678421114660023,0.1955771599607238,1.1083226855795776,1.0697119347065585,1.054990248824409,0.04359432117308848,63.32629349847876,17.337219087976294,15.346162557601929,13.355106027227565,16.179250070026942,0.4593369549277485,16.067589385168894,0.4563748108214704,15.972441473042256,15.627863974638236,4.240202872284444,16.525363671917,470977000,0.5116609465294786,0.9451547666171489,-13917311000.0,-5.949619795926745,44.757923903640624,51.57585752245338,122.74139057934038,36.50390483778799,17.55135676524791,0.1927813406422309,0.7362343380662575,16.749339515686035,16.43032959365845,16.172499656677246,15.914669719696047,15.595659797668459,0.04,0.0,19.486671092409118,0.03755583985792632,0.06867324424759233,16.32357338496617,16.126685414995467,1.0479996912256422
2022-12-02,1,16.72825002670288,13.300250053405762,17.00850009918213,15.069999933242798,16.25450026988983,-0.7298902397758927,0.9757211404345888,-0.42644005040102817,2.993721080672815,15.763875126838684,0.7989987981319429,0.06288701590881113,14.012999963760375,16.34977536201477,0.661220908710816,0.27881055099612995,1.078166375576607,1.045956882683953,1.0285414716230636,0.025533716749950752,69.87272821975017,17.466904834370304,15.515462553501129,13.564020272631954,16.335214342389786,0.4286591679393912,16.119517956461227,0.4884774685925287,16.22847947085927,15.839678360398143,11.492763860843539,11.769345366581863,371389000,0.5150915787647175,0.755050669080298,-14288700000.0,-17.803205219414995,44.757923903640624,51.57585752245338,99.00265816552135,34.04921242775529,18.222789998314006,0.2177665618963659,0.7329319234704375,16.749339515686035,16.43032959365845,16.172499656677246,15.914669719696047,15.595659797668459,0.04,0.0,19.479377790953826,0.037511455628308044,0.021872664612093477,16.443803923470632,16.166175161089217,0.95085051271881
2022-12-05,1,16.689000606536865,13.976999998092651,17.00850009918213,15.24581265449524,16.28956252336502,-0.6707750706007107,0.8665091667590585,-0.5118187449508484,2.99418580421705,15.891000032424927,0.6916150283813476,0.05523788863945991,14.203074884414672,16.695624923706056,0.6935907817210669,0.19342584536667926,1.0638839061053995,1.0374699207424394,1.0208994473620299,0.04412298402704762,64.42902381869433,17.4198808856841,15.686862552165985,13.953844218647868,16.391071592058456,0.448038627442174,16.151321547372,0.5111562558648681,16.35294017546999,15.98641334870889,6.98206055159445,4.543395027218346,352255000,0.5100429210513696,0.7356164231944867,-14640955000.0,-29.97706816437947,44.757923903640624,51.57585752245338,88.80647203851507,32.89434211756463,17.274583593551768,0.15990636919736081,0.717936837205387,16.749339515686035,16.43032959365845,16.172499656677246,15.914669719696047,15.595659797668459,0.04,0.0,19.472347258648714,0.04974101844588885,0.0211584912208617,16.45740004948207,16.18895993913923,0.8879625801345971
2022-12-06,1,16.227250337600708,13.976999998092651,17.00850009918213,15.532000184059143,16.301437497138977,-0.8008741897629822,0.8023597370226744,-0.06553466595784796,2.994427074139089,15.992499947547913,0.6294662833213807,0.05071657878126821,14.587124824523926,16.695624923706056,0.6663359553718078,0.17331932521327012,1.0257127597206814,1.0021321428863486,0.9841616025300491,0.03164438033867878,63.40588197422321,17.425182058540894,15.820462584495544,14.215743110450196,16.379000152860367,0.45165569230990515,16.11812514918191,0.4879039476572328,16.435397273725606,16.098393222048372,2.3990719785667283,2.7410558744230453,352694000,0.511373214017569,0.7409716053043713,-14993649000.0,-58.48966758004106,44.757923903640624,51.57585752245338,23.16287353312001,30.324312865868652,22.374827760321427,0.11813550422515429,0.7231556607381787,16.749339515686035,16.43032959365845,16.172499656677246,15.914669719696047,15.595659797668459,0.04,0.0,19.46391745439025,0.022513625183856023,0.010367765325304099,16.41758850642613,16.140792029244558,0.8050411043463264
2022-12-07,1,15.936250448226929,13.976999998092651,17.00850009918213,15.633437633514404,16.301437497138977,-0.9819209823134238,0.7173181668409484,0.8024134130453202,2.994700905279708,16.039000034332275,0.5499350309371949,0.045055869276220094,15.158499956130981,16.695624923706056,0.6548005408737839,0.10936595717762666,1.0009806667947168,0.9782887462831229,0.9607124585982193,-0.021520538369621423,55.74014003677102,17.35527394125636,15.920637607574463,14.486001273892567,16.372214521680558,0.4588825893616899,16.108089464051382,0.4902597353476756,16.38493657988689,16.145483056634266,-0.5180319233213537,-2.7842653792482306,372388000,0.5233454912197406,0.8011042859922596,-15366037000.0,-52.40269246112634,44.757923903640624,51.57585752245338,-1.8606159134206084,28.737789681818047,22.73646845686413,0.1416340756836721,0.708573185392833,16.749339515686035,16.43032959365845,16.172499656677246,15.914669719696047,15.595659797668459,0.04,0.0,19.454703881509765,-0.04745019028026787,0.031020134146266917,16.459999629429408,16.156073910849436,0.7372414641557662
2022-12-08,1,16.645000457763672,13.976999998092651,17.00850009918213,15.706250071525574,16.301437497138977,-1.2140109311101668,0.6531961443219696,2.1882295598280885,2.994882399535165,16.039000034332275,0.4716425204277039,0.040860319912205914,15.251475191116333,16.695624923706056,0.4703686481840964,0.1401767511198142,1.0412187052160504,1.0199204820673173,1.0076977422471056,-0.021371645900506886,53.954316970581594,17.292467427689655,15.986075139045715,14.679682850401775,16.503000293459213,0.366295700189604,16.168571625437057,0.5012039093796279,16.2752519236278,16.149046000418785,-0.29717318311057167,-0.8739303122667562,515456000,0.5025257494060613,1.1016478146987752,-14850581000.0,-4.393537185451076,44.757923903640624,51.57585752245338,103.8341795596884,34.896075316636,20.077345092673266,0.23979619216237757,0.7451037595390889,16.749339515686035,16.43032959365845,16.172499656677246,15.914669719696047,15.595659797668459,0.04,0.0,19.44487745167148,0.0019844001224254004,0.014536654635393326,16.67901747567313,16.26287078857422,0.5532440413547822
2022-12-09,1,17.179749965667725,15.21749997138977,17.00850009918213,15.781062662601471,16.395062923431396,-0.11414627949961395,0.4782882180314236,-0.6837744568024511,2.9952914285240633,16.152000188827515,0.3935500502586365,0.029671451038187042,15.587350177764893,16.695624923706056,0.4477425921019537,0.09380650494875814,1.0657760127411604,1.0504536775475606,1.044669679117188,0.026990267257132494,58.36887260676209,17.076051598092114,16.119475162029268,15.162898725966421,16.630571705954416,0.4286295887471819,16.279678753444127,0.542007546241705,16.373819916081533,16.256152680266357,5.8202765455429954,5.359772435349113,465338000,0.450519074718831,1.020206462577726,-14385243000.0,-23.252124335037998,44.757923903640624,51.57585752245338,153.43690867697217,36.75953717245433,18.891546721176933,0.1253970888256104,0.7353106196401785,16.992292121887207,16.626854084014894,16.33150005340576,16.036146022796633,15.670707984924318,0.06,0.0,19.437441936617034,0.007407254950543507,-0.007820209361619472,16.690154211861746,16.376801354544504,0.5675565326254213
2022-12-12,1,17.226750373840332,15.255250215530396,17.179749965667725,15.901750385761261,16.65600049495697,0.12125154208155652,0.4844220552809666,-0.5983972620848008,2.995286539680371,16.23550033569336,0.3916537809371949,0.029870167215047937,15.63527512550354,16.756275033950807,0.5090993329122171,0.07365049198970941,1.0622264379355109,1.0477666239126526,1.0418071474014015,0.03222180764334315,61.71445884367278,17.186431772305095,16.217587661743163,15.24874355118123,16.661750316619873,0.4669286775284538,16.42050019332341,0.5105728062473502,16.579560069686416,16.373119260324955,5.482983917470744,9.955676431310676,457328000,0.43299608468614065,1.0249085947543715,-13927915000.0,-1.9504399456549117,44.757923903640624,51.57585752245338,145.29453303981336,34.11500416433466,19.260606380111202,0.11560369900894464,0.7357169483678808,17.002204078674318,16.642898014068603,16.352499961853027,16.06210190963745,15.702795845031739,0.06,0.0,19.430516291501352,0.055689251110968785,0.03904977339234771,16.747264317103795,16.535418851034983,0.6328844528392814
2022-12-13,0,18.276000499725342,15.255250215530396,17.226750373840332,15.901750385761261,16.68975043296814,0.09521903811779092,0.5286685826688831,-0.7694414500003104,2.9952052727126546,16.265250205993652,0.42771250009536743,0.032475768921542816,15.63527512550354,17.02562508583069,0.599409312828513,0.06051558413882668,1.1226828839398246,1.1032434626690744,1.0981193385831243,0.12625368559067618,61.5950871272324,17.33619984434243,16.278862679004668,15.221525513666904,16.88285752705165,0.7710703590973745,16.60903593472072,0.6632950838627081,16.742016910163905,16.471614047472766,1.2831835457889547,12.923420661451217,656589000,0.4309029627904845,1.4505436094928028,-13271326000.0,-21.957196069579137,44.757923903640624,51.57585752245338,217.97882483842915,41.729688257767066,17.026447619920294,0.07788686945241817,0.7728086713659271,18.018280807495117,17.54086074066162,17.155000686645508,16.769140632629394,16.2917205657959,0.08,0.0,19.424803472813604,0.1304185009563097,0.08801923009973414,16.91802433558873,16.68091412952968,0.7409790527998226
2022-12-14,0,17.833250045776367,15.255250215530396,18.276000499725342,15.901750385761261,16.701062440872192,0.8371549473879367,0.6844937533440556,0.7873817349770955,2.9948684525817812,16.292374968528748,0.5401450443267819,0.04178717317521316,15.63527512550354,17.184450006484987,0.564128251180134,0.09489579414026778,1.0886894209028162,1.0602187076373328,1.0457697251619757,0.1190367585971579,69.424956010262,17.749462693989745,16.380475187301634,15.011487680613524,17.046321732657297,0.8412211956918939,16.718696662357875,0.7313362314289735,17.123355775322068,16.69349978705555,9.25231551747389,16.880378340922938,496888000,0.4783012532632899,1.1037028135661213,-13768214000.0,-34.1284701199588,44.757923903640624,51.57585752245338,145.56846152840313,38.53815556732253,18.399247299264907,0.06154413312614633,0.7770366757438905,18.018280807495117,17.54086074066162,17.155000686645508,16.769140632629394,16.2917205657959,0.08,0.0,19.41909346450514,0.09640197265577832,0.10552317454208514,17.069937024797714,16.763668537139893,0.7902998675345508
2022-12-15,0,17.029500007629395,15.255250215530396,18.276000499725342,15.901750385761261,16.798312544822693,0.7591269287510246,0.7522970991946264,0.02473763016206787,2.9946960316459625,16.292374968528748,0.6086200523376462,0.04576701895383424,15.63527512550354,17.287400341033937,0.7184207438235295,0.10925715715836998,1.0360128338363557,1.0032105873701647,0.976901859224354,0.023100002360551652,64.98695061280706,17.942131892366607,16.437537693977355,14.932943495588102,17.16092882837568,0.7619470799644124,16.769964490618026,0.72575058705547,17.297162027110563,16.827109417443943,6.856308931951949,9.419868696869104,478542000,0.4664443962474078,1.0835306140724574,-14246756000.0,-56.2079814654735,44.757923903640624,51.57585752245338,53.106432534918625,35.1490347138054,23.282024668581915,0.11500741585272449,0.7911054149168464,18.018280807495117,17.54086074066162,17.155000686645508,16.769140632629394,16.2917205657959,0.08,0.0,19.410991573401752,-0.012639349585037207,0.051612798584628,17.207714898245676,16.812651702335902,0.7846597710459032
2022-12-16,0,16.721499919891357,15.255250215530396,18.276000499725342,15.901750385761261,17.013750076293945,0.5822998894046013,0.7580858636611774,-0.2206460072056653,2.994683359236776,16.304875135421753,0.6249425351619721,0.04598591490933555,15.63527512550354,17.287400341033937,0.7549640936368887,0.07793583427312853,1.0143355909038096,0.9849444043513874,0.9550203894211072,-0.026673848379175524,55.38889720684974,18.001346919678465,16.48517519235611,14.969003465033754,17.273107324327743,0.5899933109970086,16.82266092300415,0.6901850071681757,17.229179567611848,16.86011816800216,4.943842322871959,4.400199718079456,478232000,0.5018326766279381,1.112122051762771,-14724988000.0,-67.85937184660486,44.757923903640624,51.57585752245338,14.952016909855374,33.117123989538435,24.592939530972494,0.14143334021717105,0.7796693508691787,18.018280807495117,17.54086074066162,17.155000686645508,16.769140632629394,16.2917205657959,0.02,1.0,19.401896464958938,-0.025292653450404434,-0.03483035173490935,17.27210671561105,16.86605317252023,0.7579528825539625
2022-12-19,0,16.394999980926514,15.255250215530396,18.276000499725342,15.971875011920929,17.013750076293945,0.4734511382970025,0.7428070900549204,-0.16175555989274448,2.9947289963146497,16.47837543487549,0.6024125218391418,0.04493327185639794,15.63527512550354,17.287400341033937,0.7377389871731429,0.07022735389752209,0.991752772815002,0.9657510178839172,0.9413000689825182,-0.04828248943438995,52.38259016453121,18.0169518585423,16.531337678432465,15.04572349832263,17.23739297049386,0.6398148569897775,16.870196631976537,0.6293389487573552,17.10270616487711,16.836929548798,4.927441835929454,4.615625617069128,354039000,0.5060629653942345,0.836742367753138,-15079027000.0,-79.42375744600525,44.757923903640624,51.57585752245338,-29.777418352625062,31.667431531748996,26.016455688111975,0.14160148125848446,0.7571214539178046,18.036452728271485,17.570274612426758,17.193500518798828,16.8167264251709,16.35054830932617,0.04,0.0,19.394372664122407,-0.07305406205203735,-0.0439388221210783,17.141466413225448,16.91024194444929,0.7110145757696125
2022-12-20,0,16.077749490737915,15.255250215530396,18.276000499725342,16.16637521982193,17.013750076293945,0.4727339768487313,0.7141892229557014,0.07168667097825843,2.9948088448169212,16.520000219345093,0.5638750314712524,0.04310166586532034,15.720200061798096,17.287400341033937,0.6736442412077629,0.07471196796469531,0.9702999767319268,0.9487062949090981,0.931986714207137,-0.12028074791420929,49.792335835802334,17.998253614711757,16.569875168800355,15.141496722888952,17.079964331218175,0.777189611810271,16.855268018586294,0.6464887507543909,16.925339897194114,16.76795560977298,-1.5019553617407762,4.2309032281582954,403260000,0.504262473326267,0.9532387981853809,-15482287000.0,-86.6154620387064,44.757923903640624,51.57585752245338,-70.26083396092535,30.25938830347554,27.704177027678295,0.13318037192435028,0.7357555806769775,18.05297265625,17.59701449584961,17.228500366210938,16.859986236572265,16.404028076171876,0.06,0.0,19.385140636218598,-0.10994920644776829,-0.08269182609252136,17.010683877127512,16.85041904449463,0.6549559732132096
2022-12-21,0,16.335999965667725,15.636500120162964,18.276000499725342,16.18987512588501,17.013750076293945,0.7910417389857566,0.6588417331227546,0.24343172030115712,2.9949532807127803,16.520000219345093,0.5227500677108765,0.03966297801848181,15.915575408935547,17.287400341033937,0.6493093855378419,0.02821919017580978,0.9834446954007332,0.964796095625556,0.9717215742612925,-0.08395834053048856,45.39780381001478,17.928683598806238,16.61100013256073,15.293316666315219,16.9527142729078,0.820846204611947,16.80723229476384,0.6590888449886233,16.71297987693611,16.682091706254788,-6.4145315102493585,-1.2832553238666808,325025000,0.504962277671903,0.7819681900561025,-15157262000.0,-73.29492986236313,44.757923903640624,51.57585752245338,-34.19849077496406,31.77316684278953,26.218476737051038,0.10142813100681429,0.7219160194651151,18.05297265625,17.59701449584961,17.228500366210938,16.859986236572265,16.404028076171876,0.06,0.0,19.378471553486634,-0.06636870622821978,-0.08693016712904544,16.863054003034318,16.805159160069056,0.6395509000005072
2022-12-22,0,15.613250017166138,15.72950005531311,18.276000499725342,16.271875143051147,17.013750076293945,0.9498538777553367,0.6238172169000619,0.5077606644278756,2.9950378439284164,16.520000219345093,0.48787254214286796,0.037475558639356615,15.978999924659728,17.287400341033937,0.6979759429069424,0.0023315810001602426,0.937959470687362,0.9199389556399394,0.9455727601695557,-0.08316450804948838,46.58811001586819,17.89360955863609,16.645975124835967,15.398340691035845,16.572321346827916,0.7156486051825294,16.727589436939784,0.7326311416324491,16.619179499285757,16.611002230355886,-5.170739627859563,-3.953906162170891,565045000,0.4858001516795775,1.3372576945951402,-15722307000.0,-88.30604738696229,44.757923903640624,51.57585752245338,-147.1798097375394,27.098396570496526,33.447929510366386,0.03270058276491258,0.7859934097525727,17.867712692260742,17.297144554138185,16.836000442504883,16.37485633087158,15.804288192749024,0.08,0.0,19.363233568397174,-0.09515086785562987,-0.132114906865497,16.472848892211914,16.69543661390032,0.7064944509411872
2022-12-23,0,15.156000137329102,15.613250017166138,18.276000499725342,16.18987512588501,17.013750076293945,0.7743939387750884,0.6597328492280804,0.2449910784324607,2.9949510759099227,16.520000219345093,0.5220125675201416,0.03971486089013112,15.915575408935547,17.287400341033937,0.6500118226411606,-0.04282191531742956,0.9123669342963706,0.8984594475528241,0.9339010675026796,-0.09362197111875037,39.57536908988048,17.931203331207623,16.611737632751463,15.292271934295304,16.18985707419259,0.6409614786065804,16.618089403424943,0.8448153777386488,16.36692289576273,16.455269089119206,-14.56965643330564,-6.665371498853119,349326000,0.5119934865962017,0.8093562308724758,-16071633000.0,-91.70930705865243,44.757923903640624,51.57585752245338,-161.27947395225996,25.940728234474175,32.019003308075256,0.05622452326482089,0.7624224071708176,17.867712692260742,17.297144554138185,16.836000442504883,16.37485633087158,15.804288192749024,0.08,0.0,19.353129102240516,-0.08237282654399636,-0.10299656374720086,16.120479447501047,16.59520823614938,0.7716286278738315
2022-12-27,1,14.587750196456911,15.156000137329102,18.276000499725342,16.054249584674835,17.013750076293945,0.41621012872285873,0.730319794168971,0.04291353967244005,2.994764111693935,16.520000219345093,0.5798000812530517,0.04411755435519398,15.717875051498414,17.287400341033937,0.6537480796248287,-0.051786954630221226,0.8812247283321997,0.8752737622211928,0.9165692949860895,-0.11023176496322695,36.50488175403903,18.014589707356496,16.553950119018555,15.093310530680615,15.841035672596522,0.761030146455296,16.5009822504861,1.0021436338873806,16.064878407984693,16.28619760940969,-15.012686423254332,-9.185693651465908,464902000,0.5166552299961303,1.0573939071037164,-16536535000.0,-98.62694300518139,44.757923903640624,51.57585752245338,-206.78839704897248,23.243817841255915,36.16656227461591,0.032300325951750516,0.7901065618769776,17.672776641845704,16.98161247253418,16.42300033569336,15.86438819885254,15.173224029541018,0.1,0.0,19.337479083430985,-0.13122901451080127,-0.1478486187324823,15.716282844543457,16.461998871394567,0.9350760649325118
2022-12-28,1,14.027250051498413,14.587750196456911,18.276000499725342,16.04237473011017,17.013750076293945,-0.102234394424627,0.8399616981939391,0.1541514956171528,2.99442998434779,16.520000219345093,0.649600064754486,0.05095571754009561,15.567525029182434,17.287400341033937,0.6622468366072739,-0.07258653198392909,0.8509537911375235,0.8551845456910405,0.9018332783369484,-0.12753647147075875,32.82364429822222,18.164073531904997,16.48415013551712,14.80422673912924,15.456142834254674,0.9085340584674857,16.36462507929121,1.1960163784622928,15.698064777478004,16.084806480228966,-14.33835291745826,-10.103376154522348,351066000,0.528026930643026,0.7937249188534934,-16887601000.0,-96.90174493591469,44.757923903640624,51.57585752245338,-206.66305699831727,22.418777829376463,36.49794507585824,0.038584373644587874,0.7606703973541749,17.632184658050537,16.91590849876404,16.337000370025635,15.758092241287232,15.041816082000732,0.12000000000000001,0.0,19.32485353640149,-0.1273856999666838,-0.1364585599661473,15.354347229003906,16.31322697230748,1.0702898633033693
2022-12-29,1,14.478749990463257,14.027250051498413,18.276000499725342,16.04237473011017,17.013750076293945,-0.5553852521053381,0.9857152635061956,0.33910592421753627,2.9939018788855964,16.520000219345093,0.7347125649452209,0.06010811642890514,15.099175143241883,17.287400341033937,0.716774588519571,-0.13873240614940532,0.882902418570801,0.9061834527382123,0.9560685496993205,-0.11369062066036517,27.403771445916497,18.370468162338778,16.399037635326387,14.427607108313996,15.182392835617065,0.8662058463332672,16.209892903055465,1.2931370073430521,15.281848046217075,15.854772013549331,-16.112489198340107,-11.978980895979277,354923000,0.5181433044072925,0.8219937278693863,-16532678000.0,-85.34448220997353,44.757923903640624,51.57585752245338,-139.30979372432137,25.037965906061977,34.256602349315976,0.0014297045676250168,0.7525510374656827,17.632184658050537,16.91590849876404,16.337000370025635,15.758092241287232,15.041816082000732,0.12000000000000001,0.0,19.31322115627876,-0.11502334576212336,-0.09213553694533588,15.118625368390765,16.130045890808105,1.135250405701506
2022-12-30,1,14.452499866485596,14.027250051498413,18.276000499725342,15.855500340461731,17.013750076293945,-0.46717825929143814,1.0710776008732419,-0.28866431565915374,2.993549222078481,16.520000219345093,0.83648503780365,0.06567547977406013,14.576850175857546,17.287400341033937,0.8062489395493062,-0.14873446182597358,0.8861868289394961,0.9239384864967827,0.9783314913830743,-0.07434391618685054,31.399115491720234,18.450792832685966,16.308637630939483,14.166482429192998,14.950214317866735,0.8016241395979279,16.015089324542455,1.3403550804270707,15.080084849847227,15.709749926182084,-11.688014594038236,-13.01442119390281,310490000,0.4981959820473629,0.7327046344175784,-16843168000.0,-85.12025410574586,44.757923903640624,51.57585752245338,-121.02345457901603,24.06391412603449,32.92391803217796,0.0026794599322696898,0.7270830996338032,17.632184658050537,16.91590849876404,16.337000370025635,15.758092241287232,15.041816082000732,0.12000000000000001,0.0,19.303065000176893,-0.047265301805921145,-0.11435676182812057,14.908602714538574,15.959643295833043,1.1759444227216178
2023-01-03,1,14.564499855041504,14.027250051498413,18.276000499725342,15.498937547206879,16.80356252193451,-0.28952115483008345,1.130772470670991,-0.6694658158685396,2.993269227720269,16.36549997329712,0.9117200756072995,0.0698834323213228,14.47612497806549,17.287400341033937,0.8384704081411546,-0.13604233297473214,0.9001079052709379,0.9466949780111326,1.0016539932749482,-0.03902746614726782,31.68809050684102,18.442382560646635,16.180837619304658,13.919292677962678,14.69714287349156,0.5221215153249033,15.824928573199681,1.3440754441070537,14.920388428988389,15.55110015082737,-10.10868856483051,-15.874795061815842,401277000,0.49747660076458555,0.943619112521565,-16441891000.0,-91.21484590271008,44.757923903640624,51.57585752245338,-106.81342010480404,25.517005704171144,30.061542293884614,-0.05501532066767404,0.7394343476947709,17.632184658050537,16.91590849876404,16.337000370025635,15.758092241287232,15.041816082000732,0.12000000000000001,0.0,19.289939958400378,-0.0585953303434924,-0.06675798916322963,14.59649590083531,15.729774951934814,1.2326009406591454
2023-01-04,1,14.602499961853027,14.027250051498413,18.276000499725342,15.013937652111053,16.798499941825867,-0.11560885968614874,1.175834263250757,-0.9239350182462012,2.993043741340021,16.281625151634216,0.9764950323104855,0.07315746035349782,14.47612497806549,17.287400341033937,0.8618500981371233,-0.1272994591817093,0.9085309430155598,0.9626620303089143,1.012505068243228,0.0010111062499342793,33.5081892153524,18.42431863722311,16.07265011072159,13.720981584220072,14.55275000844683,0.3315180101422475,15.562535677637372,1.1769478803807318,14.827081645928383,15.453265003498538,-10.8441485942046,-15.454165533399651,431324000,0.49990567818518505,1.0049332885375015,-16010567000.0,-80.19689614886398,44.757923903640624,51.57585752245338,-85.30597301624073,23.989677031179294,28.26219890571028,-0.0019591785019298685,0.7303318593969478,17.221152576446535,16.583424432754516,16.068000316619873,15.55257620048523,14.914848056793213,0.12000000000000001,0.0,19.276334288578106,0.04447271764519356,-0.030053931723215407,14.512258393423897,15.492553642817906,1.2571388714980631
2023-01-05,1,14.367000102996826,14.027250051498413,18.276000499725342,14.598812520503998,16.798499941825867,0.05652424354267304,1.2086253259840747,-1.0593988528823608,2.992866704514493,16.15249991416931,1.0296175181865692,0.07568892291730336,14.47612497806549,17.287400341033937,0.8852234039528708,-0.10012481116304202,0.899718663816039,0.9584629467238733,0.9959723092184608,0.024220716836948375,35.092576605703215,18.385575730455546,15.968325078487396,13.551074426519246,14.440035717827934,0.20045193792286178,15.314946396010262,1.016125268852617,14.769175005702586,15.38222409887915,-6.473668545638041,-20.100133713213243,389168000,0.4939131607592053,0.9028785215331729,-16399735000.0,-88.91150951162491,44.757923903640624,51.57585752245338,-90.90886074509194,22.56151027147477,27.50090157433689,0.000979872972294935,0.721093857437949,16.50910372543335,16.007447744369507,15.601999759674072,15.196551774978637,14.694895793914796,0.12000000000000001,0.0,19.263370245916306,0.01631522782016681,0.010197543448084417,14.377906799316406,15.249193123408727,1.3118400745868326
2023-01-06,1,14.594250202178955,14.027250051498413,18.276000499725342,14.58193761110306,16.798499941825867,0.16888998705174718,1.2557801641361837,-1.1856671654884328,2.992611802386974,16.006999969482422,1.1028312921524048,0.07910270483529118,14.443949890136718,17.287400341033937,0.8886562652969761,-0.09847048716561164,0.9193047469653742,0.9848635789535765,1.0069826742557684,0.007977222604974576,33.60002784264397,18.38687289502957,15.875312566757202,13.363752238484835,14.44096429007394,0.20126366651911018,15.14099998133523,0.9020806398458447,14.671453940598154,15.311951335454575,-5.2058592450720225,-19.437006344227697,405044000,0.4928522301385875,0.936164882098797,-15994691000.0,-69.11624281987883,44.757923903640624,51.57585752245338,-65.41374974582259,24.74310445547386,24.907635401274838,0.0012114522518266169,0.7393014270843139,16.2959482383728,15.8350261592865,15.462500095367432,15.089974031448364,14.62905195236206,0.12000000000000001,0.0,19.250788226818727,0.017530725474313558,0.058634938356030744,14.483274868556432,15.099778856549944,1.3288145151982824
2023-01-09,1,15.527250051498413,14.027250051498413,18.276000499725342,14.58193761110306,16.798499941825867,0.2644229593507104,1.286216069256623,-1.263353753714726,2.9924398415570073,15.845499753952026,1.1638375163078312,0.08136378890567,14.443949890136718,17.287400341033937,0.9022577071789207,-0.12320517868344018,0.9822268012915089,1.0602876538637975,1.0696534586613293,0.07436431032288704,34.5824744535629,18.380644692968048,15.808212554454803,13.235780415941559,14.655250004359655,0.39380009598974475,15.055696419307164,0.7907191733041612,14.657427967287845,15.298242906659382,0.044557972507802135,-14.300183824301488,504231000,0.4629846369316682,1.166926269813471,-15490460000.0,-36.41998508471983,44.757923903640624,51.57585752245338,-7.365420899905513,31.680839103551897,22.149062647763177,-0.05369207652157599,0.7719941501798748,15.979652576446533,15.579174432754517,15.255500316619873,14.93182620048523,14.531348056793213,0.02,1.0,19.238504950381536,0.06938570164180957,0.07019118653743174,14.710573332650322,15.032460280827113,1.2891445436972506
2023-01-10,1,15.712500095367432,14.027250051498413,18.276000499725342,14.58193761110306,16.798499941825867,0.38989851607804527,1.272856888473471,-1.1416045012657694,2.992495556234311,15.570250034332275,1.1304574942588808,0.08080438193820182,14.443949890136718,17.287400341033937,0.8924982844652208,-0.09618882215816253,0.9974718056739058,1.0735680242917276,1.0666209623409673,0.07882181000046828,47.12669186584114,18.29803881108848,15.75232503414154,13.206611257194599,14.831500019345965,0.5476690179236967,15.006946427481514,0.7196400659239094,14.879250370005565,15.369761644270131,10.693471596307415,-7.14200205791529,384101000,0.49920434211106957,0.8973483786562003,-15106359000.0,-26.17572564228708,44.757923903640624,51.57585752245338,7.4225911119522126,30.206041799732155,21.11798585815272,0.030667971337465606,0.7518516945098709,15.979652576446533,15.579174432754517,15.255500316619873,14.93182620048523,14.531348056793213,0.02,0.0,19.22964595398724,0.11135177897651016,0.08861383019324387,14.897038187299456,15.00783177784511,1.2546930315863831
2023-01-11,1,15.857999801635742,14.027250051498413,18.276000499725342,14.58193761110306,16.476624965667725,0.5330519690822406,1.2300344741550606,-0.8538470980351387,2.9926914470693733,15.570250034332275,1.0497587513923645,0.07845126684676096,14.443949890136718,17.287400341033937,0.8792535956979011,-0.08790109832742245,1.011418948195412,1.0794051469672428,1.059977120983107,0.08597841760400837,49.39040705737103,18.139031488936645,15.678962540626525,13.218893592316405,15.032285724367414,0.636069245568324,14.991250021117073,0.696512581102341,15.0907102166776,15.432204904407211,8.521109251260027,-4.162853835639423,353285000,0.5021032229040804,0.8355094039003368,-14753074000.0,-22.821769355531256,44.757923903640624,51.57585752245338,18.502181987152372,29.478845482714878,20.158927607251147,0.014328834674251747,0.7313622986368224,15.979652576446533,15.579174432754517,15.255500316619873,14.93182620048523,14.531348056793213,0.02,0.0,19.22173283546732,0.0848870068011105,0.1177784864348025,15.095067705426898,15.001835209982735,1.179012594564199
2023-01-12,1,16.184999704360962,14.027250051498413,18.276000499725342,14.58193761110306,16.350749969482422,0.666651027250921,1.1790341260951231,-0.47162535453457366,2.9929214562449507,15.570250034332275,0.9747499704360962,0.07552815329321431,14.443949890136718,17.109875011444093,0.8022299672114275,-0.13230469643103468,1.0368004722392399,1.092219476844915,1.0639766267226498,0.12653995881749291,47.85206732843128,17.968593264206547,15.610525012016296,13.252456759826046,15.263785702841622,0.7259803407397765,14.98046428816659,0.6749213246241818,15.283928139148646,15.490355253051826,9.72496072052842,-1.3667938365924066,551409000,0.43062066048316006,1.320490728876714,-14201665000.0,-4.576806482354249,44.757923903640624,51.57585752245338,54.49612379884563,32.02717950872665,17.992158450438467,0.0920146242880712,0.7609078133407629,15.9872912940979,15.585353395462036,15.260499477386475,14.935645559310913,14.533707660675049,0.04,0.0,19.210733343346643,0.15744806438048853,0.11946551743547136,15.408602033342634,15.002548967088972,1.050725565405788
2023-01-13,1,16.56600046157837,14.027250051498413,17.833250045776367,14.58193761110306,16.222749769687653,0.4548463579666264,1.020026391575086,-0.6896923230307959,2.9935867234875277,15.570250034332275,0.872327438592911,0.06578279620602284,14.443949890136718,16.752299928665163,0.7688711438638614,-0.09242568444812321,1.0683623887712625,1.101885897154047,1.063600324384218,0.1351045947605467,54.00327900342603,17.546027755398246,15.505974972248078,13.46592218909791,15.544285774230957,0.803117586568631,15.048517891338893,0.783012594717819,15.508114436767844,15.540852464018766,11.126367986872696,-0.9243404849663921,447287000,0.4352184345765796,1.0775434667602026,-13754378000.0,-0.7571003664958446,44.757923903640624,51.57585752245338,98.78690247601916,32.42681148158845,16.713135327006764,0.16647527228518189,0.7606286816363435,16.205032634735108,15.761484479904174,15.403000354766846,15.044516229629517,14.600968074798583,0.06,0.0,19.20319653247667,0.1372904386377205,0.184647597952931,15.715568814958845,15.11391360419137,0.9785998594925686
2023-01-17,1,17.307000160217285,14.027250051498413,17.029500007629395,14.58193761110306,16.222749769687653,0.09194471057579545,0.9065380710407349,-1.3787903951117344,2.994010721894555,15.570250034332275,0.8153012073040007,0.05870367280467728,14.443949890136718,16.58155040740967,0.7864098314941266,-0.027217448888303988,1.1207300686991666,1.1354101501692861,1.0837364476846867,0.11462107603188376,61.951061345304424,17.255688635119647,15.442612493038178,13.629536350956709,15.964285782405309,0.8520903271699752,15.20216075011662,0.9895265899259035,15.771911617495114,15.640170420493064,13.446331140932786,6.102191685681846,511102000,0.412292237416658,1.226467796167657,-13243276000.0,-0.6764040333170667,44.757923903640624,51.57585752245338,155.98379715533227,37.43915306628513,15.420332022333609,0.234044192198068,0.765512381025165,16.82081644821167,16.259592329025267,15.806000232696533,15.352408136367798,14.791184017181397,0.08,0.0,19.19726890694882,0.13271047667370972,0.19133185729576105,16.20628765651158,15.292097227913994,1.0500218893867923
2023-01-18,1,17.549749851226807,14.027250051498413,17.307000160217285,14.58193761110306,16.222749769687653,0.1930493015232534,0.9324726418977364,-1.1849226441854939,2.993917587881048,15.570250034332275,0.8277887141704557,0.060328884027335605,14.443949890136718,16.58155040740967,0.749285870468875,0.035014815843729154,1.135429369089764,1.130171157774767,1.0749768648969713,0.11692918025191013,70.26280424753782,17.321432784463045,15.456487500667572,13.591542216872101,16.386500017983572,0.7900624818438109,15.413732154028756,1.151457844248928,16.15691213006267,15.829423711155789,20.46356258191438,14.192399072300669,439624000,0.4399278451490864,1.0598549071303416,-12803652000.0,-12.434155460174827,44.757923903640624,51.57585752245338,150.58369510783473,36.71574273427366,14.555900310261672,0.2274070943911554,0.7530471826044729,16.93159534072876,16.34920143318176,15.878499507904053,15.407797582626342,14.825403675079347,0.1,0.0,19.192397549642518,0.09227479009126904,0.11191447673110451,16.565796034676687,15.52453545161656,1.106815533530671
2023-01-19,1,16.932250022888184,14.027250051498413,17.549749851226807,14.58193761110306,16.222749769687653,0.3847821972165737,1.0034265171848753,-0.899483986451068,2.993650694122811,15.570250034332275,0.865059961080551,0.06474596670283976,14.443949890136718,16.64010043144226,0.7849155629558453,0.07043305103041761,1.0925512505507071,1.0698382649094982,1.0143232419971338,0.06774184857422139,73.60917810898927,17.504753031604096,15.497899997234345,13.491046962864594,16.587214299610682,0.7097794674296485,15.621232151985168,1.1441118013333365,16.5067502055427,16.00082963626073,20.25112361446694,20.3047050770674,452932000,0.43391607828011974,1.0790748248235429,-13256584000.0,-28.86168662535319,44.757923903640624,51.57585752245338,99.39453493252394,34.44291354631672,18.93482441408123,0.20100648996695633,0.7454009487305675,16.966995475769043,16.406501651763914,15.953499794006348,15.50049793624878,14.940004112243653,0.1,0.0,19.185589382817636,0.04774705286493419,0.05380594792087401,16.728131430489675,15.71935238157,1.1295911542544876
2023-01-20,1,17.382750511169434,14.027250051498413,17.549749851226807,14.58193761110306,16.222749769687653,0.3747377877280589,1.0338141816295776,-1.0218489433112086,2.993530381795534,15.570250034332275,0.889236212968826,0.06659130416159552,14.443949890136718,16.969725036621096,0.8546220143071187,0.05314801879719111,1.1196789974672334,1.0823697820058262,1.0280784522114057,0.074003758337156,63.91660266911526,17.592390862591582,15.524762499332429,13.457134136073275,16.825821501868113,0.6444559075065931,15.828660760607038,1.1836125351668403,16.612426653846324,16.0672514255466,9.04860787795573,20.709689787553575,564967000,0.452466319488181,1.3205519808969246,-12691617000.0,-0.8856082327532454,44.757923903640624,51.57585752245338,128.4956211011513,37.06996179817365,17.01872087034179,0.2602348144370459,0.7700867031678382,16.966995475769043,16.406501651763914,15.953499794006348,15.50049793624878,14.940004112243653,0.1,0.0,19.17939903841619,0.08043137181470805,0.11486786837682539,17.003687722342356,15.950362954820905,1.234430445286937
2023-01-23,1,18.580000400543213,14.027250051498413,17.549749851226807,14.58193761110306,16.393500089645386,0.3604747133470938,1.1053643901236514,-1.196444944971853,2.9932364510202203,15.570250034332275,0.9542375087738038,0.0709020846874528,14.443949890136718,17.3145751953125,0.8396896272564663,0.06407630678878516,1.1917886749950894,1.1355944560402509,1.0835367257889064,0.1215743017535178,67.24850735448577,17.80074133060131,15.590012550354004,13.379283770106701,17.214678730283463,0.7717874984736419,16.12348222732544,1.3205877910611266,16.80382675682473,16.18791507680973,10.630074180839289,20.056983666538617,655163000,0.4592218450829351,1.4744854819569004,-12036454000.0,-0.9978898745088421,44.757923903640624,51.57585752245338,181.10876213828095,44.58877631723259,14.895496055792842,0.29989979079161955,0.8170090848120124,18.015204734802246,17.254398670196533,16.639500617980957,16.02460256576538,15.263796501159668,0.12000000000000001,0.0,19.177579378022667,0.13574789917864405,0.1624374881668767,17.45942715236119,16.277247428894043,1.4571328167548518
2023-01-24,1,19.101749897003174,14.027250051498413,18.580000400543213,14.58193761110306,16.657562851905823,0.6030170776112328,1.2760948617159151,-0.7419957454883819,2.992476223796168,15.570250034332275,1.0753337860107421,0.08126847448132794,14.443949890136718,17.39945044517517,0.7963499969482837,0.19001491554386518,1.2165005287819273,1.1397191402255704,1.0883970798912084,0.10370079853072323,77.64451829800662,18.25440229552961,15.702212572097778,13.150022848665948,17.63135732923235,0.8999432356994747,16.447571516036987,1.4581483415368337,17.244148762717128,16.434842002876803,17.164841928089178,28.559076783865063,496204000,0.4873275333312431,1.1254566744066705,-11540250000.0,-4.211709045008958,44.757923903640624,51.57585752245338,169.43360167193893,44.13751735532873,14.005413659327106,0.3376134185909169,0.8068656604916471,18.206204734802245,17.408898670196532,16.764500617980957,16.120102565765382,15.322796501159669,0.14,0.0,19.177630014009722,0.08829489049426598,0.1400081537052492,17.852630342755997,16.630616188049316,1.6444313278721063
2023-01-25,1,19.046500205993652,14.027250051498413,19.101749897003174,14.58193761110306,17.02593755722046,0.6463335604440914,1.474937626454404,-0.7135494779482094,2.9914902595063406,15.619875073432922,1.2591400480270387,0.09289987381236649,14.443949890136718,17.65277490615845,0.8165966141016557,0.26034242042237277,1.199655791518125,1.1126916959360205,1.0634977392056555,0.08528613612473901,81.73531854407345,18.826512818998438,15.87663756608963,12.926762313180825,17.985714435577393,0.8988926854151966,16.765000104904175,1.5084389329074908,17.705680781031255,16.72968424424568,18.021317552797417,31.15280364667723,449537000,0.47123823543624055,1.0081524676509492,-11989787000.0,-3.1496222500006112,44.757923903640624,51.57585752245338,138.86393965366514,41.04611808486536,15.152270262605146,0.36190813494147,0.8056610358506916,18.206204734802245,17.408898670196532,16.764500617980957,16.120102565765382,15.322796501159669,0.14,0.0,19.177378489704214,0.1119871785086044,0.09157164799426627,18.198718207223074,16.95714351109096,1.7916650958496083
2023-01-26,1,19.73675012588501,14.027250051498413,19.101749897003174,14.58193761110306,17.325937747955322,0.5092455453326269,1.6167982457860008,-1.0117929779451749,2.9907422978479343,15.785249948501587,1.4010538089275362,0.10060244483196727,14.443949890136718,18.626650381088258,0.8491609392485555,0.30565028530716737,1.2280847785905373,1.1309875141629897,1.0839216471814273,0.1656306810498216,83.24479477923212,19.30475906109486,16.07116256952286,12.837566077950857,18.332821573529923,1.0496140341404894,17.148553677967616,1.5342588177097092,18.03931108149729,16.976094542469326,14.973437615001412,30.433146760828276,489535000,0.4396450090079317,1.094829742664075,-11500252000.0,-5.936078314515943,44.757923903640624,51.57585752245338,145.49558943729963,44.844086925431235,13.967997751854453,0.4162879797128566,0.8115424253129555,18.718848373413085,17.82357637786865,17.100000381469727,16.376424385070802,15.481152389526368,0.16,0.0,19.179179082098038,0.1811512027334934,0.13955222085684474,18.49854632786342,17.3524169921875,1.8923167013472129
2023-01-27,1,19.96500015258789,14.027250051498413,19.73675012588501,14.586812615394592,17.424500346183777,0.4302793654263101,1.7633936203052223,-1.066053631977167,2.9899704751828526,16.021499752998352,1.5245238542556763,0.10799408787355522,14.443949890136718,19.052025175094606,0.8247920710763047,0.4070291791637876,1.2227003410055008,1.1191912002096185,1.063690920130738,0.14855241923648443,88.06784704401736,19.85539980660471,16.328612565994263,12.801825325383817,18.677857330867223,1.142190556107266,17.5321786744254,1.5178147784950498,18.462776974375195,17.301196269868207,14.039116791902888,37.37558282447637,542142000,0.4081657461367697,1.1871187557787086,-10958110000.0,-4.793155931733881,44.757923903640624,51.57585752245338,142.17900989864637,44.10984142181445,12.516984319342516,0.44893128521123266,0.8409322215723725,19.333068149566653,18.531966081619267,17.88450002670288,17.237033971786502,16.435931903839112,0.18,0.0,19.18249566828119,0.14159983627566075,0.21473305272283855,18.92515890938895,17.74547747203282,1.9882648492860022
2023-01-30,1,19.600500106811523,14.367000102996826,19.96500015258789,14.60043752193451,17.807312488555908,0.36445755902591587,1.8487204040405805,-1.1602562581250782,2.98961090843988,16.375500082969666,1.597225068807602,0.11119788253827623,14.47612497806549,19.16524991989136,0.8501204672933029,0.3789173903643803,1.1789419880935421,1.0759588299417697,1.01630716311617,0.05492463316838658,88.37733536583578,20.3229408791299,16.625500071048737,12.928059262967576,19.05903591428484,0.8769873269611106,17.823125106947764,1.4941429062510614,18.836971816809648,17.658501999422732,13.762306140176962,36.80045138329251,488611000,0.40686103559687753,1.054468912804657,-11446721000.0,-28.43288526425254,44.757923903640624,51.57585752245338,103.10229321420069,39.69781055797056,13.364260857087364,0.366149985847457,0.8676513595135624,19.41118422698975,18.6584082069397,18.050000190734863,17.44159217453003,16.68881615447998,0.18,0.0,19.183437905746338,-0.0016153088924022452,0.07416335996064796,19.267391477312362,17.997761453901017,1.9845636874734738
2023-01-31,1,19.336000442504883,14.367000102996826,19.96500015258789,15.296062529087067,18.696625351905823,0.20194512020326674,1.8879329402536849,-1.3040027315001252,2.9895042688034987,16.749125242233276,1.6386375665664672,0.11183385043956603,14.553299856185912,19.614125108718873,0.8726642853053193,0.3562013691668529,1.145389931750386,1.0440478068033392,0.9920934395216422,0.01226330293113409,81.46098458899884,20.65745345737352,16.88158757686615,13.105721696358778,19.338071618761337,0.4719446924672311,18.081946560314723,1.4119880564762801,19.025761765063034,17.905807089756244,15.758390528822398,26.23291337360818,498017000,0.42714911460682403,1.053451310211783,-11944738000.0,-21.24220149449814,44.757923903640624,51.57585752245338,89.4087892488293,37.26304611697764,14.20897101028181,0.35976865443128925,0.8583190846673427,19.415904109954838,18.666048017501833,18.05999994277954,17.453951868057253,16.704095775604248,0.18,0.0,19.18409801050985,0.014119198496149954,0.017923216895862543,19.50982448032924,18.2567561013358,1.9747947712057838
2023-02-01,1,20.35925006866455,14.367000102996826,19.96500015258789,15.666187584400177,19.060312628746033,0.03473432261831968,1.8737270646280175,-1.3662851602525374,2.989734947577076,17.119625091552734,1.6348375797271728,0.10940984689394093,14.59127516746521,19.614125108718873,0.8834746010323755,0.32761170208063983,1.1888083781990204,1.0873852458925795,1.0420894690934708,0.06892341629554566,76.54453029602672,20.873216734923147,17.125762605667113,13.378308476411078,19.59225014277867,0.4747415361089666,18.403464436531067,1.3787166046933197,19.10199484684316,18.065979243489963,11.23671383352348,23.061259030354947,660477000,0.4425196748474415,1.3598231859471122,-11284261000.0,-4.368397373681232,44.757923903640624,51.57585752245338,124.35078869122897,44.19573963116564,12.373681841621048,0.4179487889065303,0.9152247771620177,19.846799480438232,19.01459950828552,18.341999530792236,17.669399553298952,16.83719958114624,0.19999999999999998,0.0,19.189959825134135,0.08383787564624567,0.08710121347758966,19.759681156703405,18.609554154532297,2.008039595502377
2023-02-02,1,21.339499950408936,14.367000102996826,20.35925006866455,15.821624875068665,19.1603125333786,-0.059973036762827905,1.903069626262997,-1.3151615726344519,2.9897282942367838,17.34487533569336,1.6536000204086303,0.10927447466619399,14.60167498588562,19.759575128555298,0.8443871974725969,0.3942304483376286,1.2253165173463572,1.122890734394391,1.0777797296483738,0.08120636955432192,81.13636811371197,21.22163936887426,17.415500116348266,13.609360863822273,19.911928721836635,0.7582004790336596,18.771643025534495,1.428073347933226,19.41496212581729,18.34080919668707,9.576155165579646,28.384728990629117,564276000,0.4712972263214185,1.146074097664371,-10719985000.0,-4.149374719907561,44.757923903640624,51.57585752245338,138.59326043856814,45.755008038768,11.198143316578077,0.4186721887268874,0.9390657675135089,20.583975761413573,19.73951198196411,19.057000160217285,18.37448833847046,17.530024559020994,0.2,0.0,19.198037091303686,0.0963034238508127,0.12347968171513374,20.108624594552175,18.980627468654088,2.0884801690083656
2023-02-03,1,21.15850019454956,14.367000102996826,21.339499950408936,16.103249728679657,19.402125358581543,-0.031500533534242724,1.9703924283543552,-1.1098040902521293,2.9895410671828424,17.46625018119812,1.7294100308418272,0.11099332851729404,15.433950066566467,20.004425144195558,0.7991074073516078,0.4853135517106114,1.1918703752776114,1.0881315308970014,1.0516126969322483,0.05977961596994863,85.17771176465567,21.69313497248477,17.75235011577606,13.81156525906735,20.21364300591605,0.7764192547056331,19.09967872074672,1.4097964805296783,19.895026231260402,18.728305443206562,11.714895574864777,31.847391660187185,429366000,0.47634716161604607,0.8685193444930926,-11149351000.0,-16.27058771064731,44.757923903640624,51.57585752245338,116.59061613227723,42.432133230429244,10.384898386202448,0.4190182955406856,0.9402754471013801,20.7175517578125,19.955723976135253,19.34000015258789,18.724276329040528,17.96244854736328,0.2,0.0,19.203490924715858,0.03609132854503394,0.06554891491495717,20.362336022513254,19.280527114868164,2.0111615576789004
2023-02-06,1,21.0627498626709,14.594250202178955,21.339499950408936,16.470750272274017,19.634562611579895,-0.02853348466182712,1.942729605603283,-1.1526866929014072,2.9899402644186015,18.06487512588501,1.7304500341415405,0.10738103284639851,15.69397509098053,20.439175081253055,0.8112931670900428,0.4497832983150137,1.164207220765853,1.0625744744768575,1.034579711662384,0.07460267584454217,82.1966098382668,21.97738433156027,18.0919251203537,14.20646590914713,20.403071539742605,0.8020114923985401,19.367946556636266,1.3997319676592448,20.2104034554004,19.046958325213552,11.088651278261048,27.722441174757936,452197000,0.491142918229089,0.9103602278250973,-11601548000.0,-16.481390369092903,44.757923903640624,51.57585752245338,105.32167159252664,39.87463935343006,9.782039300323131,0.3785393662875372,0.9291129434999987,20.7175517578125,19.955723976135253,19.34000015258789,18.724276329040528,17.96244854736328,0.2,0.0,19.209023677838385,0.1005637580416816,0.035551361014306795,20.546088354928152,19.522317341395787,1.9320564480318723
2023-02-07,0,21.741000175476074,15.527250051498413,21.339499950408936,16.84068763256073,19.79381263256073,-0.02868386705560418,1.8706143620906461,-1.3044067700155062,2.9905529405608493,18.813250303268433,1.6717650270462037,0.10157908221074124,15.843449831008911,21.072324895858763,0.8475393918989548,0.35650226490931647,1.180591194488759,1.083223516248193,1.0527717549702063,0.12437937928903131,79.7742282112103,22.156578827559585,18.415350103378294,14.674121379197002,20.656785828726633,0.9134991803194047,19.667321579796926,1.4288519628376897,20.424104140166307,19.319162419148583,6.718429976203744,21.70075499904809,664150000,0.4799683787824618,1.315880457070081,-10937398000.0,-1.555724392256819,44.757923903640624,51.57585752245338,123.53871979412318,41.55383552039731,8.918166855937477,0.42491110237714214,0.9463191672757462,20.954392807006833,20.1473048248291,19.4950008392334,18.842696853637694,18.03560887145996,0.2,0.0,19.22005683172135,0.134923267721335,0.15713387224239853,20.804226194109237,19.864692551749094,1.9552338095628672
2023-02-08,0,22.369499683380127,15.712500095367432,21.741000175476074,17.21331262588501,20.063562631607056,-0.07096415490530719,1.881120062561261,-1.2488741622881494,2.9906596245961388,19.074125051498413,1.6461087477207184,0.10045478396343642,16.15229971408844,21.176600170135497,0.8262959028822796,0.38367542043077185,1.1945666322884851,1.1000721451990034,1.0585504410368003,0.09873888320717694,82.23255123062059,22.488277734699704,18.72603760957718,14.963797484454656,21.05235719680786,0.9771725185065142,20.05569655554635,1.3658046793910037,20.754855189435965,19.64850255200415,8.895567289329453,23.882108632769373,559651000,0.4868088151027949,1.0898825815010265,-10377747000.0,-11.118460130171172,44.757923903640624,51.57585752245338,133.3528188683495,43.50857155996833,8.329135251913009,0.3585228232694133,0.9408678581284666,21.449492378234865,20.56575445175171,19.851500511169434,19.13724657058716,18.253508644104006,0.2,0.0,19.23104042026259,0.060258643298203296,0.13656112559430592,21.238691329956055,20.253041403634207,1.949537484119172
2023-02-09,0,22.520750522613525,15.857999801635742,22.369499683380127,17.363812923431396,20.535125017166138,-0.05114224834222807,1.9072215282100897,-1.1364891026903738,2.9907009888392833,19.21887516975403,1.6122737181186675,0.10006992901899894,16.52790038585663,21.37964997291565,0.8075932899876767,0.41061293752019895,1.181640345874005,1.0897027460356636,1.0458107689164788,0.055355119611504966,84.17317136789447,22.873330645397996,19.058887588977814,15.244444532557633,21.507321493966238,0.7627305831630821,20.422696556363785,1.2799247569593297,21.159460026269166,20.03550046262884,14.127188395597758,32.11179644254093,523876000,0.489776276830639,1.0035435964271138,-9853871000.0,-13.129577252024497,44.757923903640624,51.57585752245338,127.21191276504989,41.60794385237166,7.758268014418537,0.29677583689386705,0.9379486981564721,21.792328536987306,21.032836585998535,20.41900062561035,19.80516466522217,19.045672714233397,0.2,0.0,19.24167202027921,0.028928150338999092,0.06656161112780733,21.63846206665039,20.574143273489817,1.9085450925005563
2023-02-10,1,21.460999965667725,16.184999704360962,22.520750522613525,17.508000016212463,21.086687445640564,-0.042060191302483854,1.9009087187315354,-1.1193288161453396,2.9909065622989606,19.468250274658203,1.5933249592781067,0.09802528134507653,16.8956250667572,21.80385012626648,0.8147258993890696,0.39145819796001785,1.106692046204647,1.0246224910795172,0.9857835088388882,0.014296843743021537,84.3937980790428,23.19384256248977,19.392025125026702,15.590207687563634,21.664714336395264,0.5775260157788373,20.628482239586965,1.1892587338476417,21.498602211388363,20.37444273880236,16.47057306177882,29.55803805699579,550737000,0.49164169351787146,1.0550667820833841,-10404608000.0,-39.527046329234885,44.757923903640624,51.57585752245338,73.10296225936843,36.979899066237415,16.436598017792658,0.24065415332128517,0.9799522960984304,21.972160331726073,21.323920253753663,20.800000190734863,20.276080127716064,19.627840049743654,0.02,1.0,19.24899115504329,0.007819815644569461,-0.020452469976049926,21.684435163225448,20.722058159964426,1.8013436232056261
2023-02-13,1,21.58400011062622,16.56600046157837,22.520750522613525,18.32243776321411,21.203750133514404,-0.13390304252316754,1.8010124242149907,-1.132409696691836,2.991506106908972,19.668625116348267,1.5155749320983887,0.09162741383594808,17.269525146484376,21.80385012626648,0.8420849058615979,0.295484689587107,1.098096872504094,1.023186912038869,0.9886858169181125,0.02474749267564169,68.48522450051028,23.257849986522018,19.65582513809204,16.053800289662064,21.69964293071202,0.5617573817777416,20.805785826274327,1.127569314208523,21.487892881461953,20.509446641539636,5.411544596620018,15.50591766962654,474919000,0.5813797544651069,0.9074177622261245,-9929689000.0,-27.74775231448567,44.757923903640624,51.57585752245338,74.72649718540472,34.07508300256889,15.14548324572078,0.22353079578479917,0.9875271637004465,21.972160331726073,21.323920253753663,20.800000190734863,20.276080127716064,19.627840049743654,0.02,0.0,19.255893043022766,0.03314510151278949,0.03260666943254985,21.69571440560477,20.902169500078475,1.7164102415086644
2023-02-14,1,22.240999698638916,16.932250022888184,22.520750522613525,18.929875254631042,21.369874954223633,-0.23200708328544897,1.6997755912584065,-1.1034912343407344,2.9920540594938743,19.85087513923645,1.4493999481201172,0.08538700268203227,17.37517547607422,21.80385012626648,0.8553162852718089,0.247125435420071,1.1172606023320948,1.044510617655894,1.01393873358225,0.02299800005184882,68.13528165283329,23.306276303061242,19.906725120544433,16.507173938027623,21.854285717010498,0.5363859129536191,21.033964361463273,1.0656958726682773,21.51193326334851,20.656868160417197,1.1457633064761656,12.994883856229743,675474000,0.5706148842597274,1.2706606702217065,-9254215000.0,-1.9028820095893266,44.757923903640624,51.57585752245338,103.93196335912182,37.01923229638056,13.390086669362,0.23266188406783667,1.0372038352009703,22.081636016845703,21.483182159423826,20.999500274658203,20.51581838989258,19.917364532470703,0.02,1.0,19.269228065934435,0.035989778955451746,0.08924072391712105,21.962847300938197,21.162591661725724,1.741694255537564
2023-02-15,0,22.56850004196167,16.932250022888184,22.520750522613525,19.087937474250793,21.49175000190735,-0.366852025993968,1.662194206118681,-0.9456573138068696,2.992288417984635,20.16212511062622,1.4302999258041382,0.08247700815519034,17.53304991722107,22.253849697113036,0.8311639518898536,0.26731149373528934,1.1198344664897617,1.0456258137847068,1.024199863667019,0.008896057640904509,71.61674812130373,23.477813509702877,20.153425097465515,16.829036685228154,22.069392885480607,0.46294969515422746,21.236232212611608,1.0692723269915894,21.69204623379008,20.870850692920236,5.116144784062756,16.772107516319466,420575000,0.5787288804906712,0.7925802092302451,-8833640000.0,-6.952913279132791,44.757923903640624,51.57585752245338,100.40014109693051,34.78754999193861,12.58287329346817,0.2911854498665154,1.0249035449071637,22.081636016845703,21.483182159423826,20.999500274658203,20.51581838989258,19.917364532470703,0.02,0.0,19.277766933032563,0.02517458091855973,0.026654055616350023,22.201995577130997,21.374041966029576,1.6796839908217212
2023-02-16,1,22.152999877929688,16.932250022888184,22.56850004196167,19.277437806129456,21.623250126838684,-0.4885446910167817,1.6286783154278361,-0.6980001243803104,2.9924969292466828,20.710999965667725,1.4002874135971068,0.07982010253380398,18.460275411605835,22.384624767303468,0.7739294307177093,0.33287070598737206,1.085699186228309,1.015975943525864,1.0035311272132252,-0.016329413369886248,75.44382746481139,23.66171923785793,20.40436260700226,17.147005976146588,22.128249985831125,0.4398548568999667,21.39251790727888,1.0282899159150631,21.909662767058887,21.08998652872415,7.148877469030685,14.347599772075862,412026000,0.5417276621356172,0.7794738883266017,-9245666000.0,-25.542796465052565,44.757923903640624,51.57585752245338,75.16299551319199,32.73136060193603,13.103200531862683,0.2993137768901215,1.0114818554964797,22.081636016845703,21.483182159423826,20.999500274658203,20.51581838989258,19.917364532470703,0.02,0.0,19.285041209277786,-0.0149976286527439,-0.009142040209368882,22.177580969674246,21.49090358189174,1.4458744201871474
2023-02-17,1,21.433500289916992,17.382750511169434,22.56850004196167,19.534375190734863,21.844000101089478,-0.4616628323065765,1.46101362346428,-0.7999774939717121,2.993201082743691,21.11062502861023,1.2880098986625672,0.07069854038207798,18.999850225448608,22.384624767303468,0.7633435495199892,0.27442431298171654,1.0371684161184855,0.9793246950946539,0.9741835942720469,-0.001281379050124598,68.87679527888707,23.587427346682897,20.665400099754333,17.743372852825768,21.994535786764963,0.4933141468700648,21.523446491786412,0.8899568530752444,21.974072938015254,21.243622553124123,1.8950356429247925,10.959177103027397,465888000,0.5628833514746658,0.8897087040826918,-9711554000.0,-40.52207108609547,44.757923903640624,51.57585752245338,26.958193139344942,30.36013500776204,18.869386230344702,0.2535257320782816,1.0125903249073356,22.081636016845703,21.483182159423826,20.999500274658203,20.51581838989258,19.917364532470703,0.02,0.0,19.290968296076095,0.0057843770753684964,-0.04248552051349942,22.06093406677246,21.649812698364258,1.2645860449791537
2023-02-21,1,20.941750049591064,18.580000400543213,22.56850004196167,19.702687621116638,21.844000101089478,-0.3106021276732419,1.2586694770898879,-1.2685166782143869,2.993899946737122,21.249000072479248,1.1217749309539797,0.060315949850835195,19.09622492790222,22.384624767303468,0.8129026252633846,0.15357910806559258,1.003537122946896,0.9556551909881057,0.9520708331496274,-0.029755840332810424,57.6834850278361,23.38527654287148,20.86793758869171,18.35059863451194,21.768964290618896,0.5679541422319133,21.638142892292567,0.6601618937026038,21.843913921037263,21.28518039241767,-4.184266106579731,9.351803133168366,410015000,0.5559857860869416,0.8017757313907083,-10121569000.0,-69.63348723052735,44.757923903640624,51.57585752245338,-7.474788687119387,28.465827332959716,20.234835568407874,0.16351096161617393,1.0028338338899714,22.23763185119629,21.735683891296386,21.329999923706055,20.924315956115723,20.42236799621582,0.02,1.0,19.295044097906796,-0.052001169870628194,-0.02868558505196241,21.820785522460938,21.729623794555664,1.193830180886874
2023-02-22,1,20.74650001525879,19.046500205993652,22.56850004196167,19.90793764591217,21.844000101089478,-0.3244518309492953,1.1440471074957297,-1.1930406304062113,2.9942362257237605,21.249000072479248,0.9800699520111081,0.05451471174828627,19.312575387954713,22.384624767303468,0.8123556952740497,0.09632626133779312,0.9885864495504361,0.9472682100628813,0.9487345415110923,-0.06719570629154703,51.22886778503053,23.274119286135562,20.986025071144105,18.69793085615265,21.666892869131907,0.6847253207703923,21.665803602763585,0.6085497889905828,21.61834643796754,21.267927407843395,-7.011313727919306,8.304455783712037,513184000,0.5663010433533192,1.0018572615392634,-10634753000.0,-87.32876140653157,44.757923903640624,51.57585752245338,-26.607813402751525,27.04874261710257,20.66338619755964,0.14656569201051922,0.9799886003644807,22.428791725158693,22.045103687286378,21.734999656677246,21.424895626068114,21.0412075881958,0.04,0.0,19.299609772625473,-0.09651298859097623,-0.04745727883151682,21.747827802385604,21.716131482805526,1.1179915316341709
2023-02-23,0,23.504250049591064,19.046500205993652,22.56850004196167,20.260687589645386,21.844000101089478,-0.3597980336712043,1.061802591264611,-0.9850266755692831,2.9944534972440913,21.249000072479248,0.8819362163543701,0.05039820380921694,19.57405014038086,22.384624767303468,0.7672227257017152,0.08925523276607909,1.1156235576438536,1.0780801727385387,1.0897413602487769,0.041462658390657436,49.381436818068394,23.19186775958611,21.068262577056885,18.94465739452766,21.941214288984025,0.9708533273079231,21.820428609848022,0.7722601075732093,21.397602051947604,21.21954952932674,-3.3292947744837527,1.9020835506621372,1117995000,0.5691357660671453,2.04890246236843,-9516758000.0,-6.460942275075136,44.757923903640624,51.57585752245338,170.10871473687743,39.24674296203217,16.583779933619937,0.15056093066251142,1.1338466130856955,23.069788261413574,22.56360612106323,22.154500007629395,21.74539389419556,21.239211753845215,0.02,1.0,19.32811614705454,0.03953610558096665,0.030168424856841985,22.015674318586075,21.855694362095424,1.1617129314905927
2023-02-24,0,23.2330002784729,19.336000442504883,23.504250049591064,20.64968752861023,22.174999833106995,-0.06969387926355562,1.0816984342739997,-0.6525187470356082,2.9944388685223027,21.386500120162964,0.8713349604606627,0.05080507303534197,19.72312512397766,22.52552547454834,0.5566678815790256,0.19088755239217062,1.0912045710504803,1.060120906281993,1.0678991449720057,0.048751880399691805,67.4110319899406,23.45454693778476,21.291150069236757,19.127753200688755,22.08292865753174,1.0873205686377956,21.968607187271118,0.8321809520059134,21.924028175364707,21.53977743817877,8.896636068953073,10.144333767018027,589716000,0.8171898204806658,1.0709168521092514,-10106474000.0,-17.36374454188711,44.757923903640624,51.57585752245338,132.2095227513676,37.42621708822569,16.31913338543753,0.1565245272174626,1.1040717874301296,23.069788261413574,22.56360612106323,22.154500007629395,21.74539389419556,21.239211753845215,0.02,0.0,19.34197004056733,0.05835838657689685,0.02293097309461665,22.06064850943429,22.011747905186244,1.173204850999427
2023-02-27,0,23.62624979019165,19.336000442504883,23.504250049591064,20.892937541007996,22.27312469482422,-0.13025427337603876,1.0987462138492552,-0.5769556736500747,2.9944179829683075,21.44725012779236,0.8721337246894837,0.05118550868216704,19.928550148010252,22.634950065612795,0.6100199911547096,0.16368645634402398,1.100637798355879,1.0745725133028396,1.075298775855516,0.10230477852962716,64.52433908565122,23.66345500456466,21.46596257686615,19.26847014916764,22.234035764421737,1.2301641596934532,22.151714324951172,0.8970307066081545,22.25072839088856,21.76455021303266,4.460233772201759,9.80457057375802,452994000,0.8238108729503544,0.8293446150105674,-9653480000.0,-11.162415064694144,44.757923903640624,51.57585752245338,140.45625716225456,38.65514178250009,15.670601480829454,0.09720113683125989,1.0676380785149167,23.069788261413574,22.56360612106323,22.154500007629395,21.74539389419556,21.239211753845215,0.02,0.0,19.353566691315496,0.09879350084272831,0.06813010570068975,22.165873663766043,22.18393462044852,1.2141893020873273
2023-02-28,0,23.404749870300293,19.336000442504883,23.62624979019165,21.03249990940094,22.407312393188477,-0.14709909167933077,1.1377297580814427,-0.4552406038162631,2.99434613935708,21.522500038146973,0.9116024589538576,0.05255339466761774,20.28337507247925,23.260125255584718,0.5831294001302588,0.20539015134522548,1.0810994863181902,1.0541172534553396,1.0443723472437618,0.11761193858568308,67.43428696746203,23.924484574909222,21.64902505874634,19.373565542583457,22.41285719190325,1.305117372824099,22.270553588867188,0.947235911157744,22.59268991710377,22.027205607975368,4.686841155873468,12.170775156305648,455963000,0.8151693895510062,0.8372825918496413,-10109443000.0,-19.382771810858408,44.757923903640624,51.57585752245338,114.59534586148052,37.00476950668461,16.712102175982373,0.10075508665808877,1.03559260065713,23.069788261413574,22.56360612106323,22.154500007629395,21.74539389419556,21.239211753845215,0.02,0.0,19.36464153668922,0.12398937149218225,0.08546832070839692,22.339202880859375,22.25839192526681,1.0986344998577553
2023-03-01,0,22.91349983215332,19.336000442504883,23.62624979019165,21.134562611579895,22.53268790245056,-0.1587163353624076,1.0966102172271053,-0.40318558316115594,2.9944668474481153,21.662500143051147,0.9067861890792848,0.05021284350568923,20.707775020599364,23.41469988822937,0.5390096571576594,0.21042352785901797,1.0491895508222084,1.0235981209080998,1.0004606319880203,0.10445134433763426,65.79354886297477,24.03245798137499,21.839237546920778,19.646017112466566,22.62428569793701,1.2381826171656136,22.309410742350988,0.9626397030636938,22.794930250024294,22.264044008035327,5.650476230163678,7.652590411645065,460026000,0.8139023819964432,0.8477003511768779,-10569469000.0,-34.32362861561297,44.757923903640624,51.57585752245338,62.95873735381622,35.056969701606434,20.744226198953516,0.05304776917722261,1.0150503505106696,23.069788261413574,22.56360612106323,22.154500007629395,21.74539389419556,21.239211753845215,0.02,0.0,19.37412187358861,0.09366874596086139,0.09891085328904198,22.526238577706472,22.293586322239467,0.9565037202305957
2023-03-02,0,22.903499603271484,20.35925006866455,23.62624979019165,21.294250011444092,22.654749989509583,0.16026821579577913,0.9565301284575257,-1.1106415311389841,2.9947902637419777,21.94700002670288,0.8353374481201172,0.043442875848005755,20.922225046157838,23.41469988822937,0.5572042819311455,0.1254589316833473,1.0402117613945647,1.020086831913737,0.981451668254227,-0.025559226312350747,59.22599811582487,23.93117277331825,22.0181125164032,20.10505225948815,22.904535634177073,0.9912812559465622,22.336749962397985,0.9744659517080956,22.826660100502053,22.432107100924217,6.905076269472269,2.43188339691553,389415000,0.8048705060222058,0.7359642759238108,-10958884000.0,-16.556133634298597,44.757923903640624,51.57585752245338,74.1136996256188,33.583931636279665,19.35381288861873,0.043327692143243314,1.0102610364897628,23.069788261413574,22.56360612106323,22.154500007629395,21.74539389419556,21.239211753845215,0.02,0.0,19.382619246624717,-0.014790339209629133,0.12334972345350426,22.905878611973353,22.363332067217147,0.9556988492034079
2023-03-03,1,23.559999465942383,20.74650001525879,23.62624979019165,21.410000205039978,22.905999660491943,0.1336530986990889,0.8946346494882056,-1.2718072219176,2.99491734744688,22.1969997882843,0.7839424324035644,0.040398352689138634,21.050649881362915,23.41469988822937,0.5965844898500577,0.07329129813243714,1.063881404912661,1.0477630304151238,1.0148086074774225,0.014074772244223377,57.3578385420632,23.934594292109956,22.145324993133546,20.356055694157135,23.30646412713187,0.29931050723180935,22.486678498131887,0.9906987414898686,22.849884317700926,22.55705889045945,9.367648592094277,1.6995396324542256,412393000,0.7800931439932964,0.7907399027473118,-10546491000.0,-0.2874454906199534,44.757923903640624,51.57585752245338,111.86731420711037,35.46407710094935,18.28195627161983,0.04916069554140387,0.9930995665794118,23.078955596923826,22.57102158355713,22.160499572753906,21.749977561950683,21.242043548583986,0.04,0.0,19.393038743045874,0.025938277998564185,0.0095503517519207,23.353621891566686,22.550724846976145,1.0196661672841794
2023-03-06,1,23.795000076293945,20.74650001525879,23.62624979019165,21.45412504673004,22.993374943733215,-0.028980748811128308,0.9250092453837507,-1.315858112742543,2.9948678237915627,22.30524969100952,0.8040499448776245,0.04156158789181027,21.050649881362915,23.509824991226196,0.5619047375141063,0.11350044895958408,1.0691330837955486,1.0516336962846944,1.0220517649244394,0.007142491406839868,62.653070674574046,24.106368459677718,22.256349968910218,20.406331478142718,23.347999845232284,0.34760904039596763,22.644607067108154,1.01173837348987,23.028722299891157,22.652434171513796,13.561320939022488,9.780529815164888,437429000,0.7875945113582868,0.838097132160056,-10109062000.0,-18.1342669889606,44.757923903640624,51.57585752245338,111.54656946354679,36.035479189171106,17.264308430847223,0.028967298670541472,0.9765210032200641,23.344827270507814,22.786085319519042,22.33449935913086,21.882913398742676,21.324171447753905,0.06,0.0,19.404353681643705,0.0022553569498460213,0.011509082306628952,23.337916782924108,22.67679555075509,1.0149295890042769
2023-03-07,1,23.563499927520752,20.74650001525879,23.795000076293945,21.553250074386597,23.27593767642975,-0.15486502400194843,0.9467696532281393,-1.2374976975968108,2.9948356740810516,22.445125102996826,0.8147749900817871,0.042288826793293086,21.050649881362915,23.56662449836731,0.5573465603445615,0.12971953953958124,1.0524975781396144,1.0306457868281267,1.0106432097472586,0.006782813663900988,64.4935224151932,24.281714269453715,22.388174962997436,20.494635656541156,23.395214080810547,0.35180566761894383,22.739071369171143,1.0326785594540866,23.220750344578533,22.787756553434253,1.2370104389182135,10.2436988247568,515154000,0.786146039322092,0.9810980823837937,-10624216000.0,-25.084901193650477,44.757923903640624,51.57585752245338,86.34082635189966,33.68950951103402,17.952026410994712,-0.0052687075728086175,0.9699124157180586,23.344827270507814,22.786085319519042,22.33449935913086,21.882913398742676,21.324171447753905,0.06,0.0,19.41696073885576,0.003271707677686697,-0.00889506999093813,23.33876691545759,22.69970771244594,0.981245491613605
2023-03-08,1,23.822999954223633,20.74650001525879,23.795000076293945,21.70175015926361,23.429624915122986,-0.32378564307794966,0.9284235309595621,-1.1080025166168086,2.994877693233478,22.544625282287598,0.7947662329673768,0.04123905161699137,21.3843252658844,23.569774913787843,0.6105325134358519,0.08382777872843514,1.0581786135562758,1.0301826729535173,1.020383695518953,0.039692763162878286,60.515488661085925,24.37005952815905,22.513212466239928,20.656365404320805,23.42332124710083,0.3800650232783323,22.82867850576128,1.0704750759814607,23.30730615353677,22.875123740476592,1.4225439895254683,5.946226549172469,513573000,0.7798158983299245,0.9923154306882145,-10110643000.0,-1.7507039796655786,44.757923903640624,51.57585752245338,105.63785563799675,31.97180997513519,16.74113765305377,-0.012370848968752703,0.9657758614613613,23.344827270507814,22.786085319519042,22.33449935913086,21.882913398742676,21.324171447753905,0.06,0.0,19.430612312695164,0.0655170056662151,0.041743126392890184,23.436440876552037,22.80115727015904,1.0432048228059545
2023-03-09,1,23.861999988555908,20.74650001525879,23.822999954223633,22.01074993610382,23.518187403678894,-0.4724416484838892,0.9524153596127342,-0.9995968404423214,2.9948392278716,22.735999822616577,0.8153624296188354,0.04211001468455717,21.3843252658844,23.64312481880188,0.6440179406875002,0.0649768788491686,1.0550325126314326,1.0183216429993798,1.014152755572225,0.0418495165318542,61.35636584489642,24.52214317440277,22.617312455177306,20.71248173595184,23.488642692565918,0.4141099763392542,22.950749942234584,1.0848435239214844,23.43713131903251,22.981068731370716,0.8327608730932089,5.558632208296821,501257000,0.7708537912535998,0.9740134887082565,-9609386000.0,-25.241740893866695,44.757923903640624,51.57585752245338,82.03437434269176,31.32291708505752,15.425295788689386,-0.026572087327503293,0.9732919465614479,23.50221224975586,22.913394111633302,22.4375,21.961605888366698,21.37278775024414,0.08,0.0,19.44333575006471,0.005403702755665041,0.03268926319864258,23.4684203011649,22.903811591012136,1.0528172462237657
2023-03-10,1,23.181750297546387,20.74650001525879,23.861999988555908,22.01074993610382,23.560874581336975,-0.5496127049968198,0.9878855797196324,-1.014183027049162,2.9947764685477427,22.908499717712402,0.8577436661720277,0.04353465106303447,21.3843252658844,23.797800064086914,0.6726598676052536,0.0595561619758457,1.0215853242037372,0.9877836166160024,0.9772793556838353,-0.01605471888667831,61.37312869928675,24.667708629875357,22.691937470436095,20.716166310996833,23.52696418762207,0.3610254627160595,23.07562494277954,0.9935373116050422,23.544298140871255,23.078665358115842,1.9536637682073572,7.714531305210912,474866000,0.7706883858731467,0.9271467967459484,-10084252000.0,-36.92040592985234,44.757923903640624,51.57585752245338,28.93377282780673,29.240697587504176,19.24723254776821,-0.02198280162366011,0.9681283058469581,23.50221224975586,22.913394111633302,22.4375,21.961605888366698,21.37278775024414,0.08,0.0,19.453510218945162,-0.03855586672353384,-0.01480232932307476,23.507097789219447,23.01666818346296,1.0508891821162631
2023-03-13,1,22.828250408172607,20.74650001525879,23.861999988555908,22.01074993610382,23.560874581336975,-0.6353921985668709,0.9926510960990721,-0.971155107814639,2.9947687930852536,23.047625064849854,0.8670649623870851,0.04368104043542433,21.3843252658844,23.797800064086914,0.6821987355570207,0.08018034269751809,1.0045440266655963,0.9729333129188156,0.9654557871956799,-0.04062826917510598,55.8810176625429,24.71028965138088,22.72498745918274,20.739685266984598,23.516214302607946,0.3831275344308669,23.210374968392507,0.7886736281749344,23.45455504562927,23.070428846397704,1.1707092646608463,8.156623901751724,421890000,0.7456456057065459,0.8342073043412236,-10506142000.0,-36.89562411856678,44.757923903640624,51.57585752245338,4.148893764888162,27.086385473655284,20.9866896762772,0.007207416317911911,0.9704762447639783,23.50221224975586,22.913394111633302,22.4375,21.961605888366698,21.37278775024414,0.08,0.0,19.461881100286135,-0.024798391834069178,-0.03851400723226561,23.45796857561384,23.181923593793595,0.9934582393275304
2023-03-14,1,23.809499740600586,20.74650001525879,23.861999988555908,22.21899974346161,23.560874581336975,-0.8246134645965943,0.9493854363739475,-0.5259763999247338,2.9948542569490044,23.047625064849854,0.7885199785232544,0.0416518606151577,21.3843252658844,23.797800064086914,0.6590276999785611,0.05764688154045265,1.0445809747196402,1.0182168770214004,1.0152568736440888,0.010439867330256813,51.38806063003057,24.69212085405588,22.793349981307983,20.894579108560087,23.551857198987687,0.39915046056351894,23.42916066305978,0.36206771343334965,23.30162668699083,23.032556971429386,-0.3285488960304063,9.008322390030537,474910000,0.7521181406743696,0.9390451146410739,-10031232000.0,-18.127066405279415,44.757923903640624,51.57585752245338,88.90627549428473,31.279903525645363,19.090665115599,0.01038818349581274,0.9906565315245934,23.944948570251466,23.630026630401613,23.375500679016113,23.120974727630617,22.806052787780764,0.08,0.0,19.47418518029814,0.033278979960262856,0.021783404810075506,23.483252389090403,23.418437140328543,1.0001322393129846
2023-03-15,1,23.90875005722046,20.74650001525879,23.861999988555908,22.48662495613098,23.579187393188477,-1.059126671156285,0.9313711647195395,0.020075953568389426,2.994892942644053,23.207375288009644,0.7420999717712405,0.04066301745747557,21.3843252658844,23.810849761962892,0.63629603257214,0.07052291098487166,1.0438394034411955,1.020694592266599,1.017354653568591,0.0035994670344454693,59.09214624415973,24.76736729224578,22.9046249628067,21.04188263336762,23.568107196262904,0.41278165285477114,23.458053520747594,0.38399617268802894,23.42419943188259,23.129151356694017,1.0589994919943573,14.763934750868817,524486000,0.7688389154241129,1.052787829487979,-9506746000.0,-10.47750928694153,44.757923903640624,51.57585752245338,85.40707898140803,29.181668955526828,18.534464981840994,-0.004918333124656783,0.9860381141115042,23.944948570251466,23.630026630401613,23.375500679016113,23.120974727630617,22.806052787780764,0.08,0.0,19.48782878715075,0.0019437843642187147,0.040364282582588465,23.580070768083846,23.458993775503977,1.0417600057948047
2023-03-16,1,24.762499809265137,20.74650001525879,23.90875005722046,22.763312816619873,23.668437361717224,-1.2092286124951392,0.9428107996963883,0.3090104246630907,2.9948765092182903,23.318875074386597,0.7415599727630614,0.041013149809557246,21.3843252658844,23.82689995765686,0.6544300153892547,0.05938587025131749,1.0771918551034543,1.0526696088218879,1.0529146636578344,0.03773781833631307,59.25433821737927,24.873634080128557,22.98801248073578,21.102390881343002,23.73939289365496,0.6114890451120962,23.567303487232753,0.511462696857553,23.54103150868402,23.221209573515086,0.4780415236889974,1.7209653861576075,583253000,0.76669796797402,1.1519416560599374,-8923493000.0,-1.4281069483508773,44.757923903640624,51.57585752245338,159.37646810081307,34.746959155205246,16.37099228942429,0.018121335343950752,1.0366068376870463,24.811323707580566,24.33083793258667,23.942500114440918,23.554162296295168,23.073676521301273,0.1,0.0,19.50644381963926,0.08981893080641634,0.056242465103338024,23.901798248291016,23.620282581874303,1.1852940340166818
2023-03-17,1,25.94350004196167,20.74650001525879,24.762499809265137,22.884687304496765,23.798624992370605,-1.0295198978942743,1.0126691691851177,0.3316261860662695,2.9947556418259067,23.45449995994568,0.7763987207412721,0.043842833810483164,21.3843252658844,23.866674995422365,0.622537916123265,0.11779442719788073,1.1232064680287142,1.0942272987225763,1.0947479011430474,0.11913465156716807,67.05106982775375,25.123050807471188,23.09771246910095,21.072374130730715,24.042321477617538,1.0370029898318778,23.732821362359182,0.8161830599651166,23.84082220335938,23.40344384473472,5.0883777258573755,6.583306126886381,848547000,0.776669146099476,1.6066471557104196,-8074946000.0,-16.431006928670648,44.757923903640624,51.57585752245338,209.82524449445359,38.32499714896759,15.391055271655985,-0.020816844926182278,1.023849192254334,25.430928337097168,24.83203644180298,24.348000526428223,23.86396461105347,23.26507271575928,0.12000000000000001,0.0,19.537809263772424,0.12018288678487776,0.0976700879137449,24.12228066580636,23.7793607711792,1.286966338339239
2023-03-20,1,25.66724967956543,20.74650001525879,25.94350004196167,22.91099977493286,23.812874794006348,-0.4137946278810052,1.1618435217277794,0.8102421440978542,2.994477112047793,23.532124757766724,0.8116149044036867,0.04989185698218594,21.3843252658844,23.99412503242493,0.5705428182745116,0.21041825604968156,1.1022024275993498,1.0718010189784029,1.0584214621328532,0.12436341903698622,75.69754953967583,25.61092452075811,23.28723747730255,20.96355043384699,24.300214290618896,1.1968407097163167,23.894428491592407,0.9579127207433014,24.36378672984896,23.735463068146768,8.901062384303488,9.807947822222795,432747000,0.7822379811400452,0.8219462206973666,-8507693000.0,-12.164813177912146,44.757923903640624,51.57585752245338,179.83093877738412,35.91282534240933,18.20999906104216,0.00528625814526687,1.0145743218844228,25.430928337097168,24.83203644180298,24.348000526428223,23.86396461105347,23.26507271575928,0.12000000000000001,0.0,19.5530765589228,0.12775420764529732,0.12780330796821118,24.474138804844447,23.971279553004674,1.3261825926882715
2023-03-21,1,26.038000106811523,20.74650001525879,25.94350004196167,23.11468768119812,23.8327499628067,-0.335403702242818,1.1901573889180126,1.0135275843967788,2.994440179468145,23.561749696731567,0.7838399219512937,0.05064731223293026,22.639600372314455,24.852974796295168,0.5804402038717406,0.22564970065940795,1.1080506944797037,1.0788481506981653,1.0491451972007733,0.09359710999768889,73.59024834499661,25.879239724621,23.498924946784975,21.118610168948948,24.708249977656774,1.2381472780254474,24.11760708263942,1.0692957715943312,24.691701955271085,24.03289913919009,7.565374620213351,9.666840371304971,547408000,0.7730927274904412,1.0263381057795264,-7960285000.0,-4.875689856316458,44.757923903640624,51.57585752245338,184.75203213033248,35.94748252499893,16.913541367862944,0.07213213050568766,1.0143189902902006,25.430928337097168,24.83203644180298,24.348000526428223,23.86396461105347,23.26507271575928,0.12000000000000001,0.0,19.573239182162304,0.08876705563561438,0.14077345631602928,24.93595314025879,24.22152546473912,1.2693642330619268
2023-03-22,0,26.679749965667725,20.74650001525879,26.038000106811523,23.220187783241272,23.873687505722046,0.027457033391687934,1.1605744954345245,1.0899766971314966,2.994537237346176,23.5948748588562,0.7825862407684326,0.048858605846543134,22.895974683761597,25.694874715805053,0.500871250791385,0.25505507375513475,1.1231811424296658,1.0942194060270676,1.0560382374177955,0.11589898684855848,75.998572016869,26.074886440515048,23.753737449645996,21.432588458776944,25.258464200156077,1.1129028169217412,24.38733925138201,1.2069050626921405,25.033276125265857,24.371323385587647,12.321113689018768,13.636067373146352,797295000,0.7662865635175039,1.45607144784504,-7162990000.0,-21.18292382282851,44.757923903640624,51.57585752245338,199.1760644694141,40.731531246618445,15.300643079275748,0.02350182563054666,1.0411534407700649,26.34008874511719,25.567456771850587,24.94300079345703,24.31854481506348,23.545912841796877,0.14,0.0,19.605895716347415,0.09245483402619525,0.09994591170261888,25.43603733607701,24.447002955845424,1.1834600560055297
2023-03-23,0,27.12375020980835,22.828250408172607,26.679749965667725,23.361812472343445,24.12218749523163,1.115152225921806,1.1112282100787556,-0.03545235185231377,2.9946821223237614,23.710624933242798,0.8838999867439273,0.04620414681335383,22.912499809265135,25.952950048446656,0.7439156074684149,0.1351032221567056,1.1277879066208212,1.0995464875957235,1.0505670532092217,0.09535589777812858,75.84390437775637,26.272856367323953,24.050399947166444,21.827943527008934,25.73192855290004,1.0986302470947606,24.641892875943864,1.3820927815485886,25.450550299863448,24.737973870781005,16.87163706648436,16.487656593129763,564889000,0.50816082103706,1.0865119009414215,-6598101000.0,-7.520799904272149,44.757923903640624,51.57585752245338,174.4530337048165,37.848500276710936,14.217643582154825,-0.01399104027947636,1.040428204809976,26.34008874511719,25.567456771850587,24.94300079345703,24.31854481506348,23.545912841796877,0.14,0.0,19.630015110605562,0.06460203119119079,0.12229637164019064,25.882714407784597,24.6829833984375,1.3634924833764879
2023-03-24,0,26.83299970626831,22.828250408172607,27.12375020980835,23.361812472343445,24.98868727684021,0.9743862014848866,1.2881910912839276,-0.4065142275775466,2.99434192909067,23.802249908447266,1.0826500082015997,0.053162112908029226,22.912499809265135,26.102175092697145,0.7751767606310922,0.16746652970776735,1.10736595657091,1.0735647596562863,1.0206367599447568,0.03428603167914668,78.92693240512605,26.807757137745163,24.23137495517731,21.654992772609454,26.149678502764022,0.8071248594425433,24.858892849513463,1.4743139689334503,25.866935482989128,25.041223832910607,13.919866042192464,15.126276844859934,454920000,0.5007296590465251,0.8864885615557785,-7053021000.0,-15.30614892890045,44.757923903640624,51.57585752245338,127.0961679449054,35.64530317789213,15.722642493384981,-0.02867270481723395,1.0258262217878071,26.34008874511719,25.567456771850587,24.94300079345703,24.31854481506348,23.545912841796877,0.14,0.0,19.648400399803734,0.040971894415881005,0.0484711529223606,26.24699592590332,24.91353334699358,1.4502858261944558
2023-03-27,0,26.683249950408936,22.828250408172607,27.12375020980835,23.52118706703186,25.73631227016449,0.7440989422568296,1.384059704450351,-0.9319910526463695,2.9941458777802525,23.81624984741211,1.21681250333786,0.05669732690656718,22.912499809265135,26.695074939727782,0.8437688857651355,0.1357282659987761,1.0930662459888467,1.052202484059025,1.0081191316165754,0.0395835270053253,73.87184856774007,27.17949433546778,24.411374926567078,21.643255517666375,26.424071380070277,0.5388408603367562,25.08173213686262,1.4990216030754837,26.108293296781255,25.252720560943633,12.230876319545304,12.767386510752774,361026000,0.5103803697438074,0.7098812981083222,-7414047000.0,-19.99245278122582,44.757923903640624,51.57585752245338,103.1728073302384,34.02514748998527,15.00801457908566,-0.011159589755653095,0.9979100794367125,26.34008874511719,25.567456771850587,24.94300079345703,24.31854481506348,23.545912841796877,0.14,0.0,19.6626483222354,0.0243628970402896,0.03133147048674842,26.388367789132253,25.145083018711635,1.5026112051272178
2023-03-28,1,26.30500030517578,22.828250408172607,27.12375020980835,23.52118706703186,25.967125058174133,0.5210781379469045,1.4558529708537422,-1.3035311811353194,2.9939923641219686,23.84249997138977,1.3217199993133548,0.05926720565094664,22.912499809265135,26.69822492599487,0.8667319180613897,0.14007840708731223,1.0708662852271569,1.0217547877887132,0.9862569036000927,0.01025425137372249,72.36442551550459,27.475930876285428,24.564224934577943,21.65251899287046,26.47571427481515,0.5011082761294162,25.259017876216344,1.4854113649613716,26.250159454074065,25.3793404866065,7.756689170877372,13.239756540769664,356104000,0.5077373275257389,0.7071456854668797,-7770151000.0,-22.278928482353074,44.757923903640624,51.57585752245338,74.9288039202842,32.328106015460776,18.031304184823878,0.05691058075413138,0.9752736277521139,26.34008874511719,25.567456771850587,24.94300079345703,24.31854481506348,23.545912841796877,0.14,0.0,19.675893369732943,0.008053726468996603,0.019691104586840726,26.48618589128767,25.304233278547013,1.516583739370927
2023-03-29,0,26.870999813079834,22.828250408172607,27.12375020980835,23.56262481212616,26.104750156402588,0.30914035860151345,1.477421762595603,-1.5023182484284436,2.9939541639730214,23.885375022888184,1.3652862668037415,0.059792284776380794,22.912499809265135,26.69822492599487,0.8724474686923737,0.14801320173111857,1.087488023884972,1.0337196589056126,1.0054649226832573,0.007168352314328885,68.31048685482467,27.664080981512917,24.709237456321716,21.754393931130515,26.64767857960292,0.3656707596033479,25.47394643511091,1.4854141300651906,26.262816074005485,25.46194734916114,1.393413620480705,10.418504620414563,393694000,0.5005378048209576,0.7869743662730868,-7376457000.0,-11.432378505636272,44.757923903640624,51.57585752245338,94.83420526940826,34.94336574320313,17.128831846445653,0.10387742421478623,0.9533254591678043,26.34008874511719,25.567456771850587,24.94300079345703,24.31854481506348,23.545912841796877,0.14,0.0,19.69186752726183,0.01949526593284756,0.029962877695955438,26.640980311802455,25.55755955832345,1.5115579278932696
2023-03-30,0,27.303249835968018,22.828250408172607,27.12375020980835,23.737125039100647,26.398687720298767,0.14196988711299297,1.4886395443342346,-1.612281837432071,2.9939497736086222,24.335624933242798,1.3980487680435183,0.05976764857836418,23.153925228118897,26.836799716949464,0.8470567645921402,0.1732268115585987,1.0962029374096938,1.038513614272479,1.0201788216312457,0.006617802655281668,72.04982128196973,27.88439154403651,24.907112455368043,21.929833366699576,26.828428540910995,0.3244643326495147,25.768339259283884,1.4022719121193001,26.41759515356309,25.62328096865246,4.689829056647042,12.61000681404336,364516000,0.505620276280021,0.7304668560453298,-7011941000.0,-3.8926925333713966,44.757923903640624,51.57585752245338,104.50070521688123,36.81072172633486,16.445440779780984,0.08573092655700493,0.9220165904407234,26.34008874511719,25.567456771850587,24.94300079345703,24.31854481506348,23.545912841796877,0.14,0.0,19.707498915253456,0.007061177432723165,0.03457009868962938,26.810054779052734,25.87300395965576,1.5486054879372497
2023-03-31,0,27.46399974822998,22.828250408172607,27.303249835968018,23.805874824523926,26.680624961853027,0.017783460577892235,1.5013339674973905,-1.632516461262807,2.993946444105448,25.214874744415283,1.417674994468689,0.05974959185377363,23.522174549102782,26.896274852752686,0.8598810808229118,0.15888159825456546,1.0930031632896733,1.0346292175425347,1.0248105282632833,0.023515821893526967,73.64256052682393,28.12976790199765,25.12709996700287,22.12443203200809,26.94046422413417,0.392777311717416,26.099464212145126,1.1851288297832485,26.642903318240737,25.816814551457046,4.85924312146195,17.77906967990187,433933000,0.49758577720166175,0.8677013970449806,-6578008000.0,-1.2740102589287345,44.757923903640624,51.57585752245338,104.76346761994937,37.3348881314316,15.50257610066555,0.08198645876920471,0.9082296976627645,26.778135864257813,26.124932006835937,25.597000122070312,25.069068237304684,24.41586437988281,0.16,0.0,19.726616997648122,0.03726803006415591,0.02155131730681445,26.99697984967913,26.216508592878068,1.6197139100551312
2023-04-03,0,27.702500343322754,22.828250408172607,27.46399974822998,23.81962490081787,26.72068738937378,-0.13802116599413533,1.5382345291940906,-1.5734256092491796,2.9938804237563525,25.80537486076355,1.4366449570655824,0.060746240678814595,23.525324964523314,27.141700172424315,0.8697064040000771,0.15419204287338162,1.0939962153509126,1.0376702253463561,1.028865060547302,0.03819813533988947,74.24340417123791,28.398769039505428,25.322299981117247,22.245830922729066,27.02314281463623,0.48732247172883025,26.377535683768137,1.0561959903963332,26.847282288541948,25.98969881707366,2.939494498904417,20.307072408833204,398716000,0.4975636600627433,0.8003786741266647,-6179292000.0,-0.7543071555179927,44.757923903640624,51.57585752245338,104.33393661444654,36.67813871143071,14.677163901595097,0.15427860111398167,0.8907846876505014,26.904960144042967,26.227520233154294,25.68000030517578,25.132480377197265,24.455040466308592,0.18,0.0,19.744536333697802,0.05404996431675024,0.0442884245931419,27.107506888253347,26.495110648018972,1.6578084365518493
2023-04-04,0,27.681499481201172,22.828250408172607,27.702500343322754,23.85224997997284,26.84249973297119,-0.28415765645778424,1.5794396187291833,-1.4538525369916622,2.9938035552024225,25.990750074386597,1.4402149772644044,0.06189590623250546,23.525324964523314,27.319324827194215,0.8596196593037149,0.17565304086970113,1.0847970862236282,1.0290386364032944,1.020359999183885,0.05232842273545035,76.60137427435083,28.67655423192705,25.51767499446869,22.358795757010327,27.14435706819807,0.5353080080035291,26.647017785481044,0.8362406850274737,27.059353158247912,26.18622834794723,2.1337393577128565,16.35061906018849,368592000,0.4874189252121944,0.7509548600323003,-6547884000.0,-13.32198648504905,44.757923903640624,51.57585752245338,89.70891466016494,34.60712417234917,14.084721701779637,0.1817526047905458,0.8766572666364654,27.03098378753662,26.431507656097413,25.946999549865723,25.462491443634033,24.863015312194825,0.18,0.0,19.76066014037932,0.03949260414988354,0.034751809927919194,27.203753880092076,26.725374902997697,1.6132626364508655
2023-04-05,0,26.775750160217285,22.828250408172607,27.702500343322754,23.89706254005432,26.934187412261963,-0.4541047896951706,1.5796839934797762,-1.261346157967502,2.9938270175895014,26.171500205993652,1.394559984207153,0.06140997101646553,23.746724796295165,27.4857497215271,0.8718205259272148,0.16196530808007903,1.040903147762456,0.989323739912875,0.9770584818263576,-0.0035447007377888973,75.83406979385938,28.882942959112263,25.72357497215271,22.56420698519316,27.157571383884974,0.5230291470778794,26.790821381977626,0.6364886646732053,27.21186514335961,26.37694974747691,3.1621502784671813,15.779785287609965,515015000,0.49017378579543697,1.049117219036258,-7062899000.0,-38.98951756056162,44.757923903640624,51.57585752245338,45.2639165301031,31.667290045776955,20.210860370579162,0.16407862019593428,0.8896102231073709,27.322679801940918,26.90365967941284,26.5649995803833,26.22633948135376,25.807319358825684,0.02,1.0,19.78070461343958,-0.0038170122394857176,0.017834139038947695,27.253733771187918,26.821050780160085,1.5827184348751047
2023-04-06,0,26.782000064849854,22.828250408172607,27.702500343322754,24.549062371253967,26.934187412261963,-0.675770113702978,1.5324323953078176,-0.9393258693988296,2.993952368462146,26.492375135421753,1.3078487396240235,0.05923311079243839,23.746724796295165,27.4857497215271,0.8826547900168578,0.1221083803980721,1.0352046732643558,0.9892037876879534,0.9779663670847402,-0.01909112557112136,60.98281900089593,28.936077273068026,25.871212482452393,22.80634769183676,27.225714206695557,0.41292234812459416,26.850714240755355,0.5882461456463157,27.096942263060242,26.436133355801303,0.34666020810906506,8.130238733808573,397654000,0.5487180404671003,0.8186846393227581,-6665245000.0,-33.553974295327926,44.757923903640624,51.57585752245338,45.62622900013879,30.645950059820073,19.130670325792476,0.24786379501407307,0.8727094841658842,27.322679801940918,26.90365967941284,26.5649995803833,26.22633948135376,25.807319358825684,0.02,0.0,19.796301606939775,-0.012635536035771278,0.0019641925373977604,27.343269075666154,26.914727483476913,1.484452955852684
2023-04-10,0,27.17300033569336,22.828250408172607,27.702500343322754,25.441062211990356,26.934187412261963,-0.9220587566070789,1.4719589001755273,-0.4387852312950473,2.9941016847585757,26.68149995803833,1.2018987369537348,0.05657634925157663,23.746724796295165,27.4857497215271,0.8346579223503952,0.1553053467099301,1.0444239693255508,1.0049140081679253,0.996035738081747,-0.01059566760866193,63.487478497528016,28.961130286618143,26.01721248626709,23.07329468591604,27.268857138497488,0.3844815679784467,26.958267859050206,0.4835578789923239,27.01468257907846,26.482247914399988,1.8133425361725528,3.232023518538256,395279000,0.5141511515165172,0.8205172169350632,-6269966000.0,-16.074822847404796,44.757923903640624,51.57585752245338,66.99702152751094,32.67283877577503,17.649653693837884,0.3104559536381187,0.8783730684617221,27.38191612243652,26.999542198181153,26.690500259399414,26.381458320617675,25.999084396362306,0.02,0.0,19.812704152463382,-0.007128184565759921,0.007157791107893815,27.4282351902553,27.03460775102888,1.317185256914691
2023-04-11,0,27.452250480651855,22.828250408172607,27.702500343322754,25.87443745136261,27.136062741279602,-1.1693260915317087,1.3385207499696286,0.33008848867321117,2.9944009713015096,26.72950005531311,1.0559675073623656,0.05105588885640561,23.898825025558473,27.4857497215271,0.747029485474505,0.1903233865861798,1.0471253803350984,1.0139663046094336,1.0084230549204225,-0.009033475663550283,68.24236631466172,28.893816488113696,26.21677498817444,23.539733488235182,27.290142944880895,0.39077596269569925,27.059285742895945,0.42007585441412215,27.053634570667402,26.59574169464129,1.1238901593327482,5.866427743236974,314378000,0.499435321024615,0.6599476329334395,-5955588000.0,-38.651140550327845,44.757923903640624,51.57585752245338,69.34387049989178,32.27601603038755,16.679733965235993,0.2703277703706799,0.8630608110602638,27.492600090026855,27.178700145721436,26.925000190734863,26.67130023574829,26.35740029144287,0.02,0.0,19.825823571537686,-0.02846414005531883,-0.021888631278240717,27.39767619541713,27.103865487234934,1.0584196643632207
2023-04-12,0,26.945250511169434,23.809499740600586,27.702500343322754,26.01437509059906,27.205562710762024,-1.1851497507525772,1.11373219383536,0.4625763858261238,2.994829928239086,26.77887511253357,0.8701325201988223,0.04211030123027308,24.67712483406067,27.4857497215271,0.7416548455143788,0.1529956857446927,1.018802026224134,0.9924211131904309,0.9916221826717944,-0.026597149136799225,68.56176704115036,28.67543937946912,26.4479749917984,24.220510604127682,27.2160359110151,0.40135536074789324,27.078250067574636,0.40742625518040165,27.154650771282228,26.75445253917208,0.5457249432906388,5.431486166521541,446259000,0.4673285971892086,0.9396201231935575,-6401847000.0,-69.99997338582831,44.757923903640624,51.57585752245338,18.216336200843187,29.586300893751158,20.82903793294188,0.19904679750483392,0.8742707858249116,27.492600090026855,27.178700145721436,26.925000190734863,26.67130023574829,26.35740029144287,0.02,0.0,19.842995272430482,-0.03489596025211361,-0.05256564137810475,27.21460723876953,27.10579354422433,0.8810346838909189
2023-04-13,0,26.603249549865723,23.90875005722046,27.702500343322754,26.238250255584717,27.205562710762024,-1.3692476583461661,0.9381383863250845,1.5004687606351803,2.9950999496649997,26.807499885559082,0.7003575181961054,0.0352620469833436,25.576774692535402,27.4857497215271,0.6455093672108128,0.1270037307128881,0.9999431312172248,0.9775197721175672,0.9843703757061392,-0.00644241932791334,59.90483325278235,28.481039302977017,26.604762530326845,24.728485757676673,27.059000083378383,0.39428299396622496,27.04107144900731,0.42626767752332134,27.10247040083518,26.807153692252363,-1.8888335341394678,0.9951388069354578,353615000,0.49256811581147275,0.7581926791197104,-6755462000.0,-71.48841529463219,44.757923903640624,51.57585752245338,-24.09004154215977,28.201716665966416,20.85230060608165,0.13380627234466178,0.8516799194962359,27.492600090026855,27.178700145721436,26.925000190734863,26.67130023574829,26.35740029144287,0.04,0.0,19.856067325684958,-0.015550078756590091,-0.03606169585477166,27.0001220703125,27.053814479282924,0.669526333172278
2023-04-14,0,26.591249465942383,24.762499809265137,27.702500343322754,26.528687238693237,27.205562710762024,-1.0076129517289643,0.7060656943976269,0.9470074965062465,2.995380394573093,26.807499885559082,0.5233400630950925,0.026405356283162866,25.915875005722047,27.4857497215271,0.5782469259102606,0.07433618393858002,0.994456212409111,0.9780410642436091,0.9851840058792735,-0.007122343306907197,52.58633736331876,28.15161889375436,26.739487504959108,25.327356116163855,26.903250081198557,0.31470440457532944,27.023803574698313,0.4400196832374089,26.98105017442196,26.820485825056362,-3.968056239811538,-1.918984859823721,395660000,0.4759956721182892,0.8657534090708927,-7151122000.0,-57.767479079043206,44.757923903640624,51.57585752245338,-31.815844234816648,26.608363653968723,20.60304609587425,0.10324682049369216,0.8382027900186333,27.492600090026855,27.178700145721436,26.925000190734863,26.67130023574829,26.35740029144287,0.06,0.0,19.87076528827653,-0.010319231508089333,-0.004575761426094092,26.900876181466238,27.05231503077916,0.6012931838516236
2023-04-17,0,26.751500606536865,25.66724967956543,27.702500343322754,26.600249528884888,27.205562710762024,-0.3132349515542777,0.5439142027034399,-0.47847708719472726,2.9955263275514663,26.807499885559082,0.4240250587463379,0.02027191395566496,26.028550100326537,27.4857497215271,0.6675977800365342,0.02496769606772512,0.9970398194884359,0.9865186637059036,0.9925240432747986,-0.015511711034825626,48.35336652723051,27.918753393199847,26.83092498779297,25.74309658238609,26.89978585924421,0.3164703358737594,27.02867862156459,0.4363189193149512,26.886949771894354,26.843584723966817,-3.9385511467656964,-0.9009437743535389,321471000,0.40173962268672125,0.7464637588177455,-6829651000.0,-46.41857527241823,44.757923903640624,51.57585752245338,-9.65757123362962,26.351469604779172,19.573759356620617,0.2295202949973294,0.8192597303188298,27.492600090026855,27.178700145721436,26.925000190734863,26.67130023574829,26.35740029144287,0.06,0.0,19.883001053603408,-0.02092176049066541,-0.001294544198066462,26.918154852730886,27.085944311959402,0.5393838665284156
2023-04-18,0,27.66675043106079,25.66724967956543,27.702500343322754,26.660624861717224,27.205562710762024,-0.36060362573847493,0.5051235071884358,-0.0093976702045806,2.995555162990243,26.807499885559082,0.38749008178710936,0.01879786377810776,26.278300285339355,27.4857497215271,0.558876285013017,0.04224258307794639,1.0296012725299106,1.0229582691162558,1.029701857722151,0.007813565250692767,51.92083790166422,27.8815720303986,26.87132501602173,25.861078001644856,27.026178768702916,0.4210019455732903,27.125946487699235,0.4137850976131251,26.85502157518089,26.857185014687584,-0.09056535684460217,0.2557808972099507,604812000,0.3957720877571823,1.3768827610322592,-6224839000.0,-23.439179336061336,44.757923903640624,51.57585752245338,124.26654804678547,33.25740491577366,17.729310689643487,0.17727128100322967,0.8398840211273428,27.66396030426025,27.38802011489868,27.164999961853027,26.94197980880737,26.6660396194458,0.02,1.0,19.9088712890035,0.018329694878248315,0.0031907807069228,27.00811849321638,27.17569378444127,0.5070833745916304
2023-04-19,0,27.63100004196167,26.038000106811523,27.702500343322754,26.682374954223633,27.340499997138977,0.04003897157793161,0.4519955288801597,-0.7051867421643094,2.995591868034152,26.851999759674072,0.3796600437164308,0.016758388656904516,26.562624549865724,27.66822533607483,0.376789467018731,0.0625528196316117,1.0244593322181073,1.0217714846536745,1.0267319641354729,0.02544973669879136,62.27359722705922,27.875291111356816,26.971300053596497,26.06730899583618,27.091607298169816,0.47919059914165013,27.180232218333654,0.4273945672194926,27.059691464817618,26.99249393107588,3.303526114810715,5.176772895216699,358660000,0.4351982553224166,0.8344337827261551,-6583499000.0,-9.470938182772144,44.757923903640624,51.57585752245338,112.19108156096408,31.07183242143607,17.63380688963221,0.17602263524085476,0.8347494231216273,27.66396030426025,27.38802011489868,27.164999961853027,26.94197980880737,26.6660396194458,0.02,0.0,19.924150917304875,0.05419880440032876,0.02804663140675488,27.058383669172013,27.24330942971366,0.5092611702051535
2023-04-20,0,27.451250076293945,26.30500030517578,27.702500343322754,26.734437942504883,27.455187797546387,0.21775214009948946,0.41971847748603247,-1.2135379197504876,2.9956120297069555,26.908125162124634,0.3739450454711914,0.015515849783639662,26.602049541473388,27.66822533607483,0.46046485898125905,0.03565438497429854,1.0147980024803123,1.015314082411468,1.0148805418711266,0.031875824975392986,59.90101896538181,27.89038700532607,27.050950050354004,26.21151309538194,27.091464383261545,0.479065246364865,27.19080366407122,0.4324716333719991,27.202919088800655,27.092524487050053,1.6854955308954256,2.8283288086359004,427713000,0.4154886490709922,1.0397906576299765,-7011212000.0,-53.22750415024641,44.757923903640624,51.57585752245338,48.73280954732239,28.378287524418557,18.05775157614658,0.20623577556362413,0.8486959419448562,27.66396030426025,27.38802011489868,27.164999961853027,26.94197980880737,26.6660396194458,0.02,0.0,19.941496213580525,0.02422262593065172,0.02298548181880314,27.049101965767996,27.223389080592565,0.48737684969609285
2023-04-21,1,26.99399995803833,26.30500030517578,27.702500343322754,26.76968777179718,27.455187797546387,0.019852930718590518,0.4192828397231078,-1.253441026276208,2.9956124982554715,27.03450036048889,0.3754000425338745,0.01547767407727279,26.602049541473388,27.66822533607483,0.53145102061721,0.012074284121934101,0.9964737256319586,0.9959139930187441,0.9917573928876748,0.01514597847731003,55.262778739840925,27.92809073533153,27.089525055885314,26.2509593764391,27.098428589957102,0.4769350721386525,27.1572322504861,0.4278505597029758,27.263888638736113,27.15483378375187,-0.00364416155467922,0.5420608946373818,345103000,0.40763369745268996,0.8619903286075393,-7356315000.0,-52.433886194942914,44.757923903640624,51.57585752245338,-12.694853417914086,27.240098136160437,19.752137823259563,0.22619878942018753,0.8210034062703978,27.66396030426025,27.38802011489868,27.164999961853027,26.94197980880737,26.6660396194458,0.02,0.0,19.954739242865514,0.013491239689977563,0.02478929989195065,27.138208389282227,27.17640781402588,0.4871526730899747
2023-04-24,1,27.02299976348877,26.30500030517578,27.702500343322754,26.76968777179718,27.455187797546387,0.06555168652769224,0.41970667855607013,-1.2577340261294017,2.9956122268417626,26.969625234603882,0.377816288471222,0.015497031227944725,26.602049541473388,27.66822533607483,0.5234597742602798,0.006000083983618468,0.9977831962270826,0.9962047271457916,0.9898933489247549,0.010148931865360922,49.011801874802735,27.922450900408954,27.083037543296815,26.243624186184675,27.158392906188965,0.42819768989411083,27.108696494783675,0.39879147356571115,27.193854712346152,27.144472435977434,0.18092036980204992,-1.7113304489523282,339282000,0.41586700833307044,0.8598689067528761,-7017033000.0,-56.50793971167762,44.757923903640624,51.57585752245338,-12.15007065133116,27.184504212502517,18.544565985224413,0.2298651984865758,0.8120031411670469,27.66396030426025,27.38802011489868,27.164999961853027,26.94197980880737,26.6660396194458,0.02,0.0,19.967744312793116,0.0014813665318293978,0.010613660972122864,27.220889500209264,27.11050578526088,0.4808537773698739
2023-04-25,1,26.697749614715576,26.30500030517578,27.702500343322754,26.76968777179718,27.455187797546387,0.009475179405258171,0.4160741841584602,-1.2065827139451644,2.9956143442324907,27.00849986076355,0.3692662858963011,0.01535751988714938,26.602049541473388,27.66822533607483,0.5035034576080556,0.012732699866442886,0.9854281670452738,0.9847589083954436,0.9760375225511052,-0.035024019852267885,50.04718212049639,27.924685914474757,27.092537546157835,26.260389177840914,27.173607213156565,0.4060048858476753,27.03842864717756,0.37612379338369406,27.150110505870018,27.146373878643345,1.5778155703733026,-2.452849278631151,378527000,0.4141997363830839,0.957207772478459,-7395560000.0,-98.88889449543579,44.757923903640624,51.57585752245338,-89.88147837846554,24.784914522246673,20.75974053706955,0.2047760240391723,0.8270028710216862,27.66396030426025,27.38802011489868,27.164999961853027,26.94197980880737,26.6660396194458,0.02,1.0,19.981265018956293,-0.05154157684256033,-0.02818313429965947,27.147062029157365,27.023969105311803,0.5039061317616542
2023-04-26,1,26.998250007629395,26.30500030517578,27.702500343322754,26.76968777179718,27.455187797546387,0.009193015649881972,0.41537243512466365,-1.2008474591930065,2.995614747807527,27.00849986076355,0.3686138010025026,0.015331207700598534,26.602049541473388,27.66822533607483,0.41950008382784154,0.01493059513337156,0.9964931310269197,0.9986221821577065,0.9940665153163322,-0.022900004826873932,46.371862515351616,27.924007399622496,27.09326252937317,26.262517659123844,27.208857127598353,0.3725851291750521,27.05432149342128,0.3688001942934416,27.039523491975945,27.104008343381594,0.40050825332445145,-3.5538171158454466,406337000,0.41169346084326536,1.021047801693031,-6989223000.0,-61.058224552303116,44.757923903640624,51.57585752245338,-25.101753597439547,23.206307176463625,18.85034024897581,0.16259687002187356,0.8457170017991098,27.66396030426025,27.38802011489868,27.164999961853027,26.94197980880737,26.6660396194458,0.02,0.0,19.996651893141674,-0.03490745655653538,-0.025698510734822686,27.14049312046596,27.029323986598424,0.4773568222075064
2023-04-27,1,27.177250385284424,26.591249465942383,27.702500343322754,26.78043758869171,27.455187797546387,0.19761389239798377,0.37512167925366263,-1.3942793405089233,2.9956367506322032,27.010624885559082,0.33741756439209,0.013827879539375598,26.68829960823059,27.66822533607483,0.45258138016952404,0.0047355958257876115,1.0018182507789377,1.0050460945673036,1.0053416677069076,-0.009981319256791799,49.17091675196988,27.878168373003174,27.12792501449585,26.37768165598853,27.1389285496303,0.3135869729388851,27.08255365916661,0.3614043508400518,27.033054644667736,27.09507346686833,0.9223759247069483,0.8309752148146866,377161000,0.397197414535048,0.9497067930320271,-6612062000.0,-46.77249584975341,44.757923903640624,51.57585752245338,-5.133904641505863,22.895339958190693,17.468060500801762,0.1508625492819549,0.8474515616158528,27.66396030426025,27.38802011489868,27.164999961853027,26.94197980880737,26.6660396194458,0.02,0.0,20.01111408178507,0.0045010834533649735,-0.02524076051425093,27.077518463134766,27.042818478175572,0.4759858090958666
2023-04-28,1,27.45074987411499,26.591249465942383,27.702500343322754,26.78043758869171,27.455187797546387,0.0977700639449013,0.3705440896407432,-1.3514019532133552,2.9956391294327256,27.098000049591064,0.3270375728607178,0.013651433033818588,26.68829960823059,27.66822533607483,0.4773665429680558,-0.00461481513887801,1.0113292428922878,1.0130100832735454,1.0175216492382815,0.016920423678842278,50.430616566074,27.884325722387565,27.14323754310608,26.40214936382459,27.113178525652206,0.27094817348092276,27.10239291191101,0.3741501005452981,27.070441622180944,27.100498405583238,-1.7692719171920435,1.47580583779222,292216000,0.38680660611451917,0.7425712319209878,-6319846000.0,-19.100519222326913,44.757923903640624,51.57585752245338,70.3298170772335,23.798524352216553,16.442710614687805,0.1691552184312949,0.8359907554045423,27.66396030426025,27.38802011489868,27.164999961853027,26.94197980880737,26.6660396194458,0.02,0.0,20.022924111348907,0.023231058370769553,0.02379718372524931,27.05152920314244,27.054956436157227,0.4916777755205902
2023-05-01,0,28.397000312805176,26.591249465942383,27.702500343322754,26.78043758869171,27.455187797546387,0.05893068422331429,0.3750953568192144,-1.4159947474002927,2.995636862626387,27.098000049591064,0.3344125747680664,0.013815355222551165,26.68829960823059,27.66822533607483,0.45257024187747524,-0.0004824451731887367,1.0459064327084828,1.0446160808230451,1.0490443226387878,0.050845596763570367,54.32694324057817,27.900803258651855,27.150612545013427,26.400421831375,27.248285702296666,0.5547680956678199,27.169875042779104,0.504571573243344,27.164935146674363,27.136365671497085,-0.6523476080233931,1.022152633092895,570329000,0.3901791375325256,1.4246153165960993,-5749517000.0,-5.2149630694992375,44.757923903640624,51.57585752245338,224.25289864006567,31.916190538984022,14.675138893825004,0.17528566798276704,0.8697771311085536,28.38823226928711,27.973884086608887,27.638999938964844,27.3041157913208,26.88976760864258,0.02,1.0,20.049098752784637,0.06907776314651226,0.06604235909121593,27.30942508152553,27.179263523646764,0.6139537505420548
2023-05-02,0,28.452250003814697,26.591249465942383,28.397000312805176,26.78043758869171,27.49693787097931,0.7075160201329015,0.45965622806793327,0.04550569276513938,2.995590003512274,27.098000049591064,0.3854900455474855,0.016900826942788074,26.68829960823059,27.68359956741333,0.3580072582299063,0.025069938123827875,1.0461438877237306,1.0403510936679798,1.0405223032060937,0.06571716397145533,65.42434042020865,28.116575029378055,27.197262573242188,26.27795011710632,27.456607137407577,0.698532974303474,27.277517863682338,0.6039303211738201,27.4732392829893,27.301343792848602,3.4451991580811514,3.441429447903271,402730000,0.4416289360730976,1.005468497313562,-5346787000.0,-29.880236301438913,44.757923903640624,51.57585752245338,171.75737155624134,29.74094279014086,13.674954902450395,0.09735707523275824,0.8667215977655484,28.38823226928711,27.973884086608887,27.638999938964844,27.3041157913208,26.88976760864258,0.02,0.0,20.0670408245319,0.0750352304705395,0.04319201845091823,27.465219497680664,27.301713943481445,0.6314178300279317
2023-05-03,0,27.87025022506714,26.591249465942383,28.452250003814697,26.78043758869171,27.49693787097931,0.8973347164223046,0.5252284730924921,0.0866969651541254,2.995547351315603,27.098000049591064,0.43047502517700165,0.01928523199248659,26.68829960823059,27.75304956436157,0.5092186674548407,0.02784352499173504,1.0233341656335166,1.0161518278788733,1.0063242273037172,0.032298397755088804,66.07671433184142,28.285207002451767,27.234750056266783,26.1842931100818,27.577642917633057,0.6841329702287187,27.36801791191101,0.589885523303179,27.717900753420313,27.441814978199364,5.402126576436207,5.59282049361752,383387000,0.44143410989959647,0.9554116159463955,-5730174000.0,-44.25651744369695,44.757923903640624,51.57585752245338,91.72149971451326,27.552378157028937,17.692335568888684,0.11120991703348398,0.8687415163368499,28.38823226928711,27.973884086608887,27.638999938964844,27.3041157913208,26.88976760864258,0.02,0.0,20.08303417324658,0.031384549389945615,0.059487140332889904,27.573747362409318,27.39731843130929,0.6420591245744556
2023-05-04,1,27.577999591827393,26.591249465942383,28.452250003814697,26.78043758869171,27.49693787097931,0.8519151705452529,0.5347800039568602,-0.11463545970634348,2.995540660835675,27.098000049591064,0.44180006980895997,0.019629141156157402,26.68829960823059,27.922925233840942,0.6622768130846786,0.04087654158336274,1.0122525950616872,1.0046200051400325,0.9895405168117798,0.014745759812404113,59.382745843959555,28.313747601373805,27.244187593460083,26.17462758554636,27.703392914363317,0.5661748841535436,27.43850006375994,0.5473515895004735,27.755066046137678,27.492382133075346,3.1352938940668738,4.762578619677726,321850000,0.4096838614881622,0.8218401891726226,-6052024000.0,-52.80621931612836,44.757923903640624,51.57585752245338,39.401619216680885,26.120713224684916,18.720528260519682,0.07537441320033544,0.8509027995413867,28.389412521362306,27.975794494628907,27.64150047302246,27.307206451416015,26.89358842468262,0.02,0.0,20.095849602359237,0.012341157272417025,0.02248111154408756,27.762385777064733,27.45472390311105,0.6385592465842046
2023-05-05,1,28.248000144958496,26.591249465942383,28.452250003814697,26.90443789958954,27.591249704360962,0.7034526777739187,0.5281860309827839,-0.23911530443666473,2.995545714539851,27.17512536048889,0.43908004522323624,0.019358606587806495,26.68829960823059,27.922925233840942,0.6705897256107063,0.0297214369744645,1.0353206817701253,1.028552084723425,1.010674557406491,0.029042932324238047,54.537330405535826,28.340672127006158,27.28430006504059,26.22792800307502,27.881928648267472,0.49992823741883646,27.545392887932913,0.5489904005096868,27.711618420208055,27.51280254002946,3.297094286278833,3.71080767433972,361494000,0.41700994746055076,0.9273519890234591,-5690530000.0,-13.342754499403492,44.757923903640624,51.57585752245338,141.1073603886923,30.88931962274927,16.898084213245312,0.07101118466766686,0.8753382342962467,28.389412521362306,27.975794494628907,27.64150047302246,27.307206451416015,26.89358842468262,0.02,0.0,20.1117969880305,0.033550719819256614,0.053404853034471136,28.00857244219099,27.574532781328475,0.7049702676508274
2023-05-08,1,28.810749530792236,26.591249465942383,28.452250003814697,26.981812596321106,27.63993763923645,0.5089010574250875,0.5544621000846303,-0.6780809795759248,2.995527567610606,27.314000129699707,0.46215004920959474,0.020267205408561438,26.68829960823059,28.262900161743165,0.6372888539538824,0.03956132175264651,1.053116847167833,1.044274474252088,1.0249616484948798,0.014570173378505968,61.21195068090021,28.466524269215284,27.357600069046022,26.24867586887676,28.115285669054305,0.49741293021191296,27.6271071093423,0.6451591790880149,27.8441613561594,27.61584681810735,4.62900423907452,5.594076984436356,344979000,0.433625716779028,0.8907323724629204,-5345551000.0,-2.3038487061230053,44.757923903640624,51.57585752245338,172.76504962591778,32.491548844180016,15.697917670896302,0.06241679994894999,0.8749568555525684,28.513179565429688,28.07590972137451,27.72249984741211,27.369089973449707,26.93182012939453,0.04,0.0,20.127908212210787,0.00833618131851055,0.05052429038008215,28.283461706978933,27.68049008505685,0.8079654053958883
2023-05-09,1,28.723249912261963,26.591249465942383,28.810749530792236,26.981812596321106,27.717625379562378,0.5460948524023336,0.6360825254604257,-0.6787991025863622,2.995464666428162,27.450999975204468,0.5173887896537781,0.023181282988349632,26.68829960823059,28.40252528190613,0.6445482571557302,0.04948589009479718,1.0467852171843057,1.0344001758938182,1.0188494197744475,0.009524726811093398,65.85889121688716,28.711652579721815,27.439487528800964,26.167322477880113,28.297071388789586,0.4436981146789179,27.705124957220896,0.7085898058246197,28.08377057799833,27.762770895704463,6.010538676099102,4.134923986038871,314869000,0.4457394768516151,0.812937119358096,-5660420000.0,-21.669462414073752,44.757923903640624,51.57585752245338,123.94601361103686,30.6053628701311,14.786628637719819,0.07590074041461736,0.8625312448898109,28.513179565429688,28.07590972137451,27.72249984741211,27.369089973449707,26.93182012939453,0.04,0.0,20.142157311622388,0.012796831104975759,-0.01172617470643312,28.4008423941476,27.72618579864502,0.8413234538456604
2023-05-10,1,28.866000175476074,26.591249465942383,28.810749530792236,26.981812596321106,27.964687705039978,0.45882337334067647,0.6949507381971084,-1.0067347400326248,2.9954142009148423,27.450999975204468,0.5849912691116333,0.025268144952624572,26.68829960823059,28.479349994659426,0.719292829332676,0.06598563262032049,1.049556805319256,1.0320131129466277,1.0219482121254786,0.035728059216107555,66.4925767815463,28.89293897677568,27.50303750038147,26.11313602398726,28.364071369171143,0.49387570883869036,27.806178535733903,0.7679897297445681,28.24150098418901,27.846284707205562,4.635574780224462,3.9529871110041386,369350000,0.4265125724858935,0.9631601353144157,-5291070000.0,-11.185282268592994,44.757923903640624,51.57585752245338,122.971717474709,30.103497987163763,13.97407372215398,0.14396226205200252,0.847493329343795,28.513179565429688,28.07590972137451,27.72249984741211,27.369089973449707,26.93182012939453,0.04,0.0,20.159114281515798,0.03895401528511422,0.023927762916198345,28.39727238246373,27.85334873199463,0.8558830559134846
2023-05-11,1,28.667500019073486,26.591249465942383,28.866000175476074,26.99718749523163,28.285250186920166,0.31685418910657426,0.7423344103277925,-1.181375173018876,2.9953714962656903,27.51462483406067,0.6273575925827025,0.026897075745074446,26.68829960823059,28.73199987411499,0.7222214322481019,0.08505542232233704,1.0387123494577877,1.018117827251139,1.0078150320271224,0.039506144150098566,69.37949770803185,29.083743804252386,27.5990749835968,26.114406162941215,28.394821371350968,0.5068125607199473,27.925714254379272,0.7620672566753238,28.398370104528517,27.955406053668124,1.651582411890915,5.153681873321549,322149000,0.4140090859372447,0.8435340875631163,-5613219000.0,-21.4357404782194,44.757923903640624,51.57585752245338,89.87428713998064,28.295450146985736,14.969027146087093,0.16621970978098646,0.8372438396065339,28.513179565429688,28.07590972137451,27.72249984741211,27.369089973449707,26.93182012939453,0.04,0.0,20.17346171163375,0.036862272325046685,0.027911547978999737,28.449822562081472,27.957521029881068,0.831650916618562
2023-05-12,1,28.423749923706055,26.591249465942383,28.866000175476074,27.016812324523926,28.410812735557556,0.17068889282389538,0.7402031747135602,-1.3193305291373136,2.9953757678356454,27.60449981689453,0.6416700267791746,0.02671992969984853,26.746125507354737,28.73199987411499,0.7384817464624741,0.07808021792245338,1.0260434239037146,1.004146590468539,0.9916495412858506,0.006221671546505103,65.52853473863999,29.18269385648431,27.70228750705719,26.22188115763007,28.473892756870814,0.45148824565591056,28.025767837251937,0.7255078089849233,28.467525166893388,28.05521196461508,0.7565307321211142,6.199526056296143,274222000,0.4191793982394599,0.7296397420071014,-5887441000.0,-29.382286297271378,44.757923903640624,51.57585752245338,61.30728377821351,26.507828576603803,15.744776870531718,0.12885900928550656,0.8298693624680498,28.513179565429688,28.07590972137451,27.72249984741211,27.369089973449707,26.93182012939453,0.04,0.0,20.18534311087417,-0.011854942648706013,0.02822728428868201,28.526648657662527,28.050198010035924,0.8064859578960538
2023-05-15,1,28.64549970626831,26.697749614715576,28.866000175476074,27.13868772983551,28.430874943733215,0.04843342321620002,0.7097962521233842,-1.3843533438105187,2.995406260318131,27.64887523651123,0.631353747844696,0.025537831399542767,26.969750022888185,28.73199987411499,0.7477995055297532,0.06251048648689886,1.0306393414531125,1.008513853310406,0.9981619016436568,-0.005735700292951784,60.54497203309376,29.213505034192142,27.793912529945374,26.374320025698605,28.626392773219518,0.21873896650202926,28.164892843791417,0.6319782735759594,28.459678712477455,28.12235332416229,1.985987546466611,5.183547986814781,293926000,0.4262415215790333,0.7849438703950383,-5593515000.0,-10.289027707645777,44.757923903640624,51.57585752245338,83.53324820596747,26.270267883964593,14.636363254147515,0.12471690727125725,0.8289500819649588,28.607579475402833,28.228709575653077,27.922499656677246,27.616289737701415,27.23741983795166,0.04,0.0,20.198508601311776,-0.0067922712321313305,0.009518763284633323,28.725282669067383,28.243834223066056,0.8181597427877954
2023-05-16,1,29.189000129699707,26.697749614715576,28.866000175476074,27.38237500190735,28.5005624294281,-0.0955822048963278,0.6904864539544685,-1.4007168004308144,2.9954254842377606,27.768500328063965,0.6236487364768983,0.024758723809853726,26.99782500267029,28.73199987411499,0.8200014999846692,0.03537637272025635,1.0466279075543952,1.0267504279038826,1.018273034317028,0.01621509470064919,60.51881997240594,29.26958539284088,27.888612484931947,26.507639577023014,28.76082134246826,0.2359128326415548,28.32137499536787,0.590767553582166,28.508012904306472,28.19166525187358,3.8708395468874635,7.295559062697745,449405000,0.38114833684358684,1.2255905588578955,-5144110000.0,-20.24657397366155,44.757923903640624,51.57585752245338,127.26230984234738,31.588508036996043,13.350423264763025,0.12563223465652232,0.843882226596883,29.104180641174317,28.63041051864624,28.2475004196167,27.86459032058716,27.39082019805908,0.06,0.0,20.22000850962885,0.02247045059511521,0.00212687214888654,28.801394871303014,28.404983656747,0.863367621520669
2023-05-17,1,29.847749710083008,26.697749614715576,29.189000129699707,27.38237500190735,28.650999784469604,-0.11596834637712809,0.7436852126524612,-1.359987046870414,2.9953782292338893,28.059125185012817,0.6775750160217285,0.026593689494672005,26.99782500267029,28.81627459526062,0.7868722888642465,0.05638594641424446,1.0673357146279234,1.0472086287092006,1.0378811621523867,0.034010584377429876,66.74731981807122,29.45209539516881,27.96472496986389,26.47735454455897,28.908964225224086,0.47595963484097126,28.512124947139196,0.6231732046959538,28.676786121396063,28.287776744798407,3.3312092180414195,8.114415273031518,432535000,0.39583250531873015,1.1678198122891683,-4711575000.0,-0.6713525161694736,44.757923903640624,51.57585752245338,159.945797459396,31.735172216353806,12.249469618126838,0.1398632925562337,0.8540335004853479,29.460791343688964,29.00410330581665,28.63499927520752,28.26589524459839,27.809207206726075,0.08,0.0,20.242035509345502,0.044763693390655,0.056245950318023874,28.948050090244838,28.615755898611887,0.9892969860059707
2023-05-18,1,31.05899953842163,26.697749614715576,29.847749710083008,27.38237500190735,28.681437492370605,0.08267320467779721,0.8440990700319736,-0.9219424178046074,2.9952805478890574,28.322500228881836,0.7439562582969664,0.03006525947385469,26.99782500267029,28.898300170898438,0.7530960468359079,0.08730020043271566,1.1062645526734296,1.0821969955873696,1.0726755811003197,0.08342197672475793,73.12845515976873,29.763760593333906,28.07556245326996,26.387364313206014,29.242642743246897,0.9280802777971274,28.76985706601824,0.85388588078807,28.96706326306662,28.466900945487247,3.599351617639974,9.826230714806124,748725000,0.41065460005574705,1.937549685737709,-3962850000.0,-3.2693905837326667,44.757923903640624,51.57585752245338,233.1586466040824,40.403081354913155,10.664547209247653,0.2558247323230066,0.91088822320293,30.745231269836424,30.0753833656311,29.5339994430542,28.992615520477294,28.32276761627197,0.1,0.0,20.285166405089765,0.1084750438787514,0.09669367603032376,29.39172853742327,28.896285465785436,1.2383345060650213
2023-05-19,1,31.323999881744385,26.697749614715576,31.05899953842163,27.38237500190735,28.74512481689453,0.6757795192837135,1.0514371804467348,0.4569226488900684,2.99504520973097,28.410375118255615,0.8266299772262574,0.037211177935491745,26.99782500267029,29.25487508773804,0.678566816606452,0.150589004471448,1.1085806693231743,1.078351215043522,1.0642476163779797,0.10203614814452955,81.76804330193372,30.358824287269808,28.255949926376342,26.153075565482876,29.593785558428085,1.1898933418420263,28.978928463799612,1.0831309935639604,29.485632085484266,28.789745945952195,8.131912765075151,13.144448442587292,473908000,0.4527537758791411,1.2062747116373764,-3488942000.0,-12.292921898053214,44.757923903640624,51.57585752245338,202.23166675515117,37.96034716137927,10.019778215077414,0.2228119564478109,0.9002532879919214,30.745231269836424,30.0753833656311,29.5339994430542,28.992615520477294,28.32276761627197,0.1,0.0,20.312238113577713,0.10317567510246528,0.09398842910965144,29.731448582240514,29.06436048235212,1.3616901838012874
2023-05-22,1,31.069250106811523,26.697749614715576,31.323999881744385,27.546187162399292,28.824562191963196,0.7896377138423868,1.2040218172358093,0.2951359163554028,2.9948472751209296,28.437999963760376,0.888069930076599,0.042287257349138026,27.020524787902833,29.96887469291687,0.7401810091156505,0.1591607207156464,1.0912039600144197,1.0583737802656124,1.0351913691159067,0.08461190851604661,82.7824694896244,30.880493557033265,28.472449922561644,26.064406288090023,29.93689271381923,1.2240649548611018,29.1658570425851,1.2042906626194871,29.94302245743898,29.129635080733923,8.5152071340891,10.30742520934271,372000000,0.4507422582294765,0.9429539477261312,-3860942000.0,-14.210954950730217,44.757923903640624,51.57585752245338,166.19182081002572,35.41821586690623,11.2302570741202,0.22751149299728873,0.8959494926059135,30.745231269836424,30.0753833656311,29.5339994430542,28.992615520477294,28.32276761627197,0.1,0.0,20.33314743534587,0.07677969019341235,0.10007057474722161,30.10244233267648,29.276132447378977,1.43115742300533
2023-05-23,1,30.901750087738037,26.697749614715576,31.323999881744385,27.797187566757202,28.946750164031982,0.6669722598738108,1.2809611443919413,-0.2371785609985282,2.9947434969991455,28.548874855041504,0.949089946746826,0.04467207521193685,27.15935034751892,31.06002459526062,0.7800686588657552,0.16374041090288796,1.0776636825742225,1.0446309410065202,1.0132452247723924,0.058677924917873936,79.54486099736589,31.23668472851167,28.674762439727782,26.112840150943896,30.29089273725237,1.0609859105971595,29.382392747061594,1.2257621704684463,30.22499809175787,29.402509201484715,8.377954429720308,9.197866961825358,356253000,0.4464558185188185,0.9055946211309988,-4217195000.0,-24.84741832343693,44.757923903640624,51.57585752245338,126.77212815693689,33.5270337657514,11.028840742105153,0.23733696477521513,0.8788816422778054,30.745231269836424,30.0753833656311,29.5339994430542,28.992615520477294,28.32276761627197,0.1,0.0,20.35262217570206,0.050491196619276035,0.05992475349943415,30.43773569379534,29.482192175728933,1.362028452486251
2023-05-24,1,30.290249824523926,26.998250007629395,31.323999881744385,28.153562664985657,29.353687524795532,0.6096458436978334,1.2842204317037453,-0.6544110333371256,2.994752120716296,28.6564998626709,1.0080974674224847,0.04445982691969612,27.423399925231934,31.06002459526062,0.8126723599184278,0.14458344814962298,1.048651174912437,1.016473510254734,0.9821629766573821,0.014825242061428767,76.05885542071312,31.453403326786397,28.884962463378905,26.316521599971413,30.525857039860316,0.781064576645208,29.576124906539917,1.129170130977279,30.39717144822475,29.626347514245698,8.718062080771665,10.877189254455628,721419000,0.4547246384502335,1.7632340194016625,-4938614000.0,-31.486443014384903,44.757923903640624,51.57585752245338,78.4042571889407,31.1243576986419,16.941728640697647,0.31094362646263435,0.8791043799352782,30.861107536315917,30.26294579696655,29.779500007629395,29.296054218292234,28.69789247894287,0.1,0.0,20.389780716492474,0.01192917798645654,0.04535646544575825,30.664073126656668,29.694677897862025,1.315446134087374
2023-05-25,1,38.15449905395508,27.177250385284424,31.323999881744385,28.359750270843506,29.958374738693237,0.5215002071009897,1.2421297814861976,-0.8862814600719386,2.994824326443385,28.695374965667725,1.0334062099456787,0.042758984182414056,27.56527462005615,31.06002459526062,0.836063296931309,0.11454431169847439,1.313427667424562,1.274289823851459,1.2336216572005858,0.22845228825725505,65.53081873530486,31.53382201719603,29.049562454223633,26.565302891251235,31.806642600468226,2.8456540622639404,30.283731971468246,2.502153017748921,30.371447968425713,29.723315127760493,5.7417400119422775,9.834833101891464,1543911000,0.4900338560691728,3.3026045768310004,-3394703000.0,-13.118768567415032,44.757923903640624,51.57585752245338,363.0571781596945,61.020051174060946,9.504797977601477,0.24775041047114818,1.4550254553280002,36.78157553863525,35.11221153640747,33.762999534606934,32.413787532806396,30.744423530578615,0.12000000000000001,0.0,20.529461255345005,0.1989393860449875,0.25853267196907154,31.915997096470424,30.35869598388672,2.3047875956290422
2023-05-26,1,38.38899898529053,27.45074987411499,38.15449905395508,28.417062520980835,30.443124890327454,2.5487137697385553,2.28283865468019,7.0138360884734166,2.9929275752912172,28.7669997215271,1.5457523989677433,0.07712703170337135,27.841025161743165,31.09472508430481,0.3060193937566216,0.3899255659290137,1.296994658702231,1.2427455142222252,1.1867521507043142,0.2255458795242693,87.94313539956556,34.16410219701755,29.598424887657167,25.032747578296785,33.02682106835501,3.5975637130986104,30.96789264678955,3.2624037963372086,32.31723810342845,30.842063069787628,30.71533414785595,35.06973540838297,714397000,1.78906284950342,1.4621548167294627,-2680306000.0,-4.670285079726138,44.757923903640624,51.57585752245338,276.5889622576954,56.20627810870648,8.754979850348526,0.26081652211494194,1.4668092750820665,36.78157553863525,35.11221153640747,33.762999534606934,32.413787532806396,30.744423530578615,0.12000000000000001,0.0,20.595259810310715,0.24571402972693246,0.22943384429490826,33.168064389910015,31.058057240077428,3.0449533480899253
2023-05-30,0,40.648250579833984,27.577999591827393,38.38899898529053,28.445124983787537,30.941062450408936,2.025480412861789,2.9232385019642493,3.071355767666879,2.991299655532949,28.838374853134155,2.017038607597351,0.09697149740545562,28.21022515296936,32.00704979896546,0.5991420710240463,0.3518681044624146,1.3484092122452784,1.2747593363795282,1.2040019918690534,0.30831128656440887,87.94641378101855,35.99181434714444,30.145337343215942,24.298860339287444,34.39671407427107,4.448453032796771,31.819678408758982,4.084454429444323,33.83588616347257,31.81363653534561,28.616057686660916,33.2454018395505,923401000,1.7881046448058768,1.8240181888036535,-1756905000.0,-13.151451470046563,44.757923903640624,51.57585752245338,250.4337184665638,61.13050171070076,7.567568881968331,0.1320939795890309,1.575751511135875,38.65948767852783,36.631255649566654,34.99199962615967,33.35274360275268,31.324511573791504,0.14,0.0,20.689511679318358,0.2865986233843494,0.2829772438228796,34.37229374476841,31.88201114109584,3.73407319647646
2023-05-31,0,38.85974884033203,27.577999591827393,40.648250579833984,28.597187280654907,31.061562180519104,1.681176605975924,3.6786975563103583,1.4536374292256227,2.9889941776490714,29.02750015258789,2.624044923782349,0.11960171446897042,28.21022515296936,38.177949047088624,0.6781157509192315,0.428648018149149,1.2634070928621854,1.17446205791175,1.0892177443368525,0.25752582717804606,90.09671095218452,38.1152949691881,30.757899856567384,23.40050474394667,35.47324963978359,4.4925310490007275,32.533517599105835,4.390377861265602,35.53718995593786,32.93586964492676,30.87430755633304,41.5168920787102,1002580000,1.8249210696426503,1.8696548920442042,-2759485000.0,-29.54218278830696,44.757923903640624,51.57585752245338,159.60502956429525,54.54555422819238,16.0172433758939,0.057015143918967066,1.6398406583943603,38.65948767852783,36.631255649566654,34.99199962615967,33.35274360275268,31.324511573791504,0.14,0.0,20.780623085959352,0.23285968238255972,0.21356161046648983,35.31048692975725,32.52096775599888,3.990418334293231
2023-06-01,1,39.16224956512451,27.577999591827393,40.648250579833984,28.661999940872192,31.13293755054474,1.2994601974183084,4.034627915475604,0.1152422423983901,2.987814930712912,29.518374919891357,3.098412334918975,0.12899138272430746,28.21022515296936,38.43607397079468,0.7802918195550798,0.3943092913238607,1.252059131059756,1.1499925840639322,1.05081792287403,0.2928995235099561,78.9751992659096,39.347530629344455,31.278274798393248,23.20901896744204,36.62939241954258,4.202258460832677,33.28314256668091,4.5717131968141125,36.36675805432016,33.68682776167125,24.05742876719738,34.62117579194927,635873000,1.8863595909241855,1.158529197578336,-2123612000.0,-15.606098737555449,44.757923903640624,51.57585752245338,139.42889247855018,49.40944071174517,14.509029161863,0.10383064116873907,1.680994868742759,38.65948767852783,36.631255649566654,34.99199962615967,33.35274360275268,31.324511573791504,0.14,0.0,20.840293208197956,0.30231192223969394,0.29594630809053357,36.537706647600444,33.32007449013846,4.320656465177499
2023-06-02,1,39.74549961090088,27.577999591827393,40.648250579833984,28.709312438964844,33.03162467479706,1.0106694300772343,4.299601216984944,-0.6736877088965127,2.9869736514281526,30.068999767303467,3.599937319755554,0.13502553549773563,28.4061749458313,38.88999891281128,0.8029198169117454,0.42005403382231016,1.2481756092603988,1.136046624991638,1.0179995060979319,0.04169889780746261,79.92699663452373,40.44207719936601,31.842874765396118,23.243672331426225,37.89278520856585,3.4565147427551675,34.09183897290911,4.646750755802361,37.06733763598932,34.41056300839672,26.048261321050376,36.60852721398275,482731000,1.8765614484468474,0.8668082164981599,-1640881000.0,-18.939505251504123,44.757923903640624,51.57585752245338,119.0159595096561,48.28265482598238,13.61089229819297,0.07399340354600008,1.6639239026020807,38.68450389099121,36.67174799346924,35.045000076293945,33.41825215911865,31.40549626159668,0.14,0.0,20.88592453457221,0.03546595990301249,0.2878052828191098,37.77135195050921,34.10454382215227,4.4954837604268585
2023-06-05,1,39.08800029754639,28.248000144958496,40.648250579833984,28.788874626159668,38.21312403678894,0.7806785219259973,4.5088320487068865,-1.1754518905658393,2.986377500560669,30.59599995613098,4.025174803733824,0.13894170736630007,28.623324728012086,39.22057456970215,0.8220132612204176,0.4070199450205814,1.204514481845274,1.0901854769814863,0.993065481851829,0.01820837559540678,80.62082015488873,41.46891386376356,32.45124976634979,23.43358566893602,39.149606704711914,0.8423932110755232,34.83773187228611,4.5421939222635315,37.73948188496732,35.15268816843415,28.618927724330035,39.83200569095997,396094000,1.8765147064342578,0.7090372833776392,-2036975000.0,-21.112456154699867,44.757923903640624,51.57585752245338,95.16648116610843,46.44058091083766,14.652364420711834,0.04904115989281847,1.6063577591509721,38.844983963012695,36.93150811004639,35.385000228881836,33.838492347717285,31.925016494750977,0.14,0.0,20.92224507406186,0.005777166464370875,0.03135863469242387,39.00414112636021,34.83410712650844,4.636871482537479
2023-06-06,1,38.69799995422363,28.423749923706055,40.648250579833984,28.852187514305115,38.5066864490509,0.5574037520986951,4.621121070352592,-1.512171229151681,2.986134438838286,30.980374813079834,4.309449851512909,0.14006262196084532,28.66529998779297,39.22057456970215,0.8494278885210172,0.35671584162605946,1.1729065860236543,1.0564319494693155,0.9796776053867253,-0.04797870997621456,75.89676025188413,42.23549191468437,32.99324977397919,23.751007633274007,39.22724969046457,0.7560057671993979,35.5169461454664,4.338953118305219,38.0764636402467,35.492565594551465,29.044826384692044,36.45424481456335,388729000,1.8976288957475944,0.6931392093970326,-2425704000.0,-26.255201063040406,44.757923903640624,51.57585752245338,76.8361659658173,44.27178753656926,16.519954676134514,0.022972057887821914,1.5646895352481418,38.98611186218262,37.15994394683838,35.68400001525879,34.208056083679196,32.38188816833496,0.14,0.0,20.9567883549496,-0.036324107524358884,-0.007497538790687119,39.10038866315569,35.50819287981306,4.706122344414432
2023-06-07,1,38.31124973297119,28.423749923706055,40.648250579833984,29.1082501411438,38.73843717575073,0.3463098521022998,4.675778968391747,-1.7154051527696061,2.986102607804668,31.064124822616577,4.484434852600097,0.13962712322337872,28.66529998779297,39.22057456970215,0.8582419974833039,0.34727094156930505,1.1440424415842552,1.024536872453263,0.9795593040335654,-0.014114839229006026,73.42377934310188,42.83917023193425,33.487612295150754,24.13605435836726,39.216142654418945,0.770800064206834,36.12148186138698,4.069554316816006,38.22891157726943,35.751921240345816,1.4244739512894107,32.57734003313307,511998000,1.9040924225885043,0.8971713234187337,-2937702000.0,-36.78701996741849,44.757923903640624,51.57585752245338,61.197121967940646,40.052135556865075,18.46790701036306,-0.002479026902834163,1.605997536758762,39.074847732543944,37.30357573699951,35.871999740600586,34.44042374420166,32.66915174865723,0.02,1.0,21.00068847631214,-0.009386258428896177,-0.0656209436871628,38.89088385445731,36.029474122183665,4.6368780753072505
2023-06-08,1,38.15074920654297,28.423749923706055,40.648250579833984,29.683062314987183,38.73843717575073,0.1503441228372499,4.654191774159358,-1.8143376223628938,2.986374998590079,31.196624994277954,4.535338604450226,0.13702093475121846,28.66529998779297,39.22057456970215,0.8624929951486157,0.3272101953882615,1.1231705893090338,1.0004215208920126,0.9781992608069144,-0.02582845392728217,70.72257857284475,43.275395834504934,33.96701228618622,24.658628737867506,38.8593567439488,0.5412721467767483,36.628035409109934,3.8249523689496403,38.24465366569874,35.90716781293178,-0.2025300330157789,28.355571542564526,417772000,1.913335396331794,0.7289669855980111,-3355474000.0,-28.255863933659736,44.757923903640624,51.57585752245338,57.42727515421549,37.55370765901543,17.315890184092346,0.005304351109137109,1.5904977083449023,39.074847732543944,37.30357573699951,35.871999740600586,34.44042374420166,32.66915174865723,0.02,0.0,21.03672462749491,-0.03158195336690317,0.017972937355714834,38.66283089773996,36.51756232125418,4.584227962404906
2023-06-09,1,39.021249771118164,28.423749923706055,40.648250579833984,30.179624795913696,38.73843717575073,-0.04067368950617016,4.584773839840426,-1.827976829858893,2.986819562081281,34.73737454414368,4.489474844932556,0.133157346153925,28.66529998779297,39.22057456970215,0.8557414667811986,0.3308014016276252,1.1333091324985387,1.0025828190385437,1.005736017239116,-0.018222184822758614,69.94585044643966,43.60079741742042,34.43124973773956,25.26170205805871,38.882428305489675,0.5447226115343499,37.17783897263663,3.5470040967421017,38.217157905714316,36.11103675141694,-6.14417923936449,22.833155521794794,427717000,1.9126269605784805,0.7395088832632122,-2927757000.0,-26.1127536724951,44.757923903640624,51.57585752245338,62.050059551675794,39.36369759488222,16.365305522843553,-0.017014667423037366,1.5626764587218986,39.074847732543944,37.30357573699951,35.871999740600586,34.44042374420166,32.66915174865723,0.02,0.0,21.07500261850762,-0.014061175423941918,-0.025043689501124046,38.79706464494978,37.053775787353516,4.465911697036889
2023-06-12,1,39.207499504089355,28.423749923706055,40.648250579833984,30.74887502193451,38.900124073028564,-0.23154967646803465,4.488264174713296,-1.778332963838333,2.9873752150994375,38.15262413024902,4.379018611907959,0.12842348097094108,29.13465008735657,39.22057456970215,0.8335798680471491,0.37283961039122265,1.121850980797769,1.0051297920772428,1.0143232747729203,0.003057183934540353,72.89779947891374,43.92546557476839,34.948937225341794,25.9724088759152,38.88889258248465,0.5488495816670763,37.75914250101362,3.1086723070217763,38.41756890913608,36.44219500499522,0.41559952291434543,24.573010849293656,388701000,1.906021236144078,0.6654656813964985,-2539056000.0,-20.243993471119772,44.757923903640624,51.57585752245338,59.823524745603684,37.67245561401978,15.662178189260148,0.017592025749547383,1.5161994794402625,39.074847732543944,37.30357573699951,35.871999740600586,34.44042374420166,32.66915174865723,0.02,0.0,21.110022454617297,0.008043894244394778,0.004045342615910594,38.756522042410715,37.64711434500558,4.292575135343451
2023-06-13,1,40.512250900268555,28.64549970626831,40.648250579833984,31.019687175750732,39.03793740272522,-0.4162633695275138,4.316440238496409,-1.6715072140780056,2.988184521858828,38.232874393463135,4.157849864959718,0.12163055316264663,29.78187475204468,39.261299514770506,0.8180823321094711,0.3687141053961028,1.1415720395980857,1.0364039014484345,1.047430403367544,0.04688229231978447,73.26763695013167,44.12100518135378,35.48812470436096,26.855244227368143,38.99842848096575,0.7772756927425499,38.4456068447658,2.474306035993002,38.61773103705051,36.788464053522574,0.11554478986094956,26.193903519717164,613208000,1.9063670741519823,1.0218977737267545,-1925848000.0,-7.550283288123154,44.757923903640624,51.57585752245338,77.96430482162219,42.178329229017514,14.47335504038598,0.038755298484489935,1.5235426091872775,39.074847732543944,37.30357573699951,35.871999740600586,34.44042374420166,32.66915174865723,0.02,0.0,21.169280429924132,0.06137122989674815,0.04736276886496088,38.999174390520366,38.38526317051479,4.172734626934439
2023-06-14,0,41.8432502746582,29.189000129699707,40.648250579833984,31.06668746471405,39.10656261444092,-0.5879553499323158,4.147363407172598,-1.490831075758777,2.9889535849272892,38.35012435913086,3.8889236569404604,0.11494443813890518,30.245999813079834,39.82217473983765,0.7914803190959223,0.3879286964354589,1.1596883177413868,1.070826731094197,1.0717880991677071,0.09219225596410974,76.35251473632628,44.37618907840617,36.081462264060974,27.78673544971578,39.39203562055315,1.3307546029961956,39.27082116263254,1.077350954891716,39.09694693028875,37.31875818929502,1.9291524748059306,31.1001829515928,740465000,1.913671114294939,1.2047508638862479,-1185383000.0,-0.04710685404726388,44.757923903640624,51.57585752245338,101.51485382095085,46.07187557543883,12.881249743682535,0.10764876535442588,1.589575412929089,41.497859603881835,40.568569358825684,39.8174991607666,39.06642896270752,38.13713871765137,0.02,1.0,21.24606563918432,0.1473515783574344,0.11247079377547307,39.54616110665457,39.275151116507395,4.115368271425751
2023-06-15,0,42.67275047302246,29.847749710083008,41.8432502746582,31.26031243801117,39.17356204986572,-0.7253442059142747,4.010599263775833,-1.1895858914537647,2.989584824417743,38.54349946975708,3.579304947853089,0.10923844233889753,30.840600061416627,40.5258508682251,0.7651188804235155,0.4018896124863624,1.1622963266593704,1.0837799207900016,1.0736093427615006,0.11852981554826081,78.9626080295978,44.73537329886056,36.7141747713089,28.692976243757236,39.9598571232387,1.7630419972812315,39.59355340685163,1.3575336403885427,39.76864181148797,37.991736159510516,7.048838406002488,38.14098766785545,568622000,1.9207065568981367,0.9150288723405487,-616761000.0,-10.719725635102144,44.757923903640624,51.57585752245338,110.37990517258376,44.98439929560191,12.206660692046858,0.06836077970709085,1.5576058909850627,41.888812881469725,41.022594520568845,40.322500228881836,39.62240593719483,38.75618757629395,0.04,0.0,21.30608751237865,0.10758249188675872,0.138172180855819,40.1178468976702,39.609117780412944,4.0064333993857035
2023-06-16,0,43.13100051879883,30.290249824523926,42.67275047302246,36.44406187534332,39.341999530792236,-0.8413028335834526,3.8847839588266386,-0.76341640330297,2.990143291113345,38.77887439727783,3.213287460803987,0.10399517549706125,31.04327459335327,40.76775054931641,0.7601201879039566,0.37392546789003955,1.154611431640873,1.085738106021755,1.0609966771846868,0.10532083856326202,80.04378198292167,45.12499272710915,37.35542480945587,29.585856891802585,40.6483929497855,1.9437753437556853,39.932267802102224,1.6032194805320474,40.48456238425853,38.714165902896255,10.271203998916254,11.841988575654023,655709000,1.916527333973299,1.0631261608782725,38948000.0,-16.16652093108555,44.757923903640624,51.57585752245338,118.93095912325005,44.757187148104684,11.59509253999245,-0.029792597597780458,1.5226340983044768,42.218860275268554,41.2895700302124,40.53849983215332,39.78742963409424,38.85813938903809,0.06,0.0,21.375942372643298,0.1011606864022756,0.10859516075077803,40.862909589494976,39.876896721976145,3.93463121882677
2023-06-20,0,43.36750030517578,30.290249824523926,43.13100051879883,38.15356159210205,39.9371874332428,-0.97826844294891,3.796423127973605,-0.18845639178792162,2.99054192608878,38.9404993057251,2.825084953308104,0.10001371589834229,31.052500104904176,41.92620029449463,0.743631124942385,0.37693144814291607,1.142481938534139,1.082466384364603,1.0456714964126692,0.10610217059755467,80.82676519302615,45.55187111442194,37.959024858474734,30.366178602527523,41.39364310673305,1.8228691436360274,40.12649992534092,1.8433683738084128,41.13345074943684,39.40307630169928,12.580510475176936,12.352501130142228,451153000,1.9151751054728035,0.7328234925584759,490101000.0,-2.7434873012149064,44.757923903640624,51.57585752245338,131.98342616146056,43.24131454663765,10.872260398599696,-0.005196310451037573,1.5078746550034268,42.42437704467773,41.45581265258789,40.67300033569336,39.89018801879883,38.921623626708985,0.08,0.0,21.424773800171362,0.10956886293751378,0.12994581547498538,41.61954007829939,40.14118548801967,3.8102077287183174
2023-06-21,0,43.0602502822876,30.290249824523926,43.36750030517578,38.27206206321716,40.54625082015991,-1.1381886336579428,3.6485087804850544,0.5777672658351634,2.991068754465049,39.054625034332275,2.4661652159690854,0.09461605945542273,31.052500104904176,42.7185754776001,0.7065570339521323,0.39583350599337536,1.1166729877878105,1.0634379324608503,1.0178440736001708,0.06289453993291083,81.83582982638778,45.858217440616414,38.5611998796463,31.26418231867619,41.97064317975725,1.5682228390640562,40.426535742623464,1.9595137242658678,41.69103130421152,40.029429458593356,13.674046269419328,6.68970911798808,551603000,1.906468292580603,0.8831062501040639,-61502000.0,-14.244846653142151,44.757923903640624,51.57585752245338,112.88583844146426,39.73828747256896,12.776239051216196,0.0008521732135009253,1.523597667229749,42.42437704467773,41.45581265258789,40.67300033569336,39.89018801879883,38.921623626708985,0.08,0.0,21.48263095547512,0.04931494514696255,0.09024360212439084,42.23007147652762,40.5135680607387,3.508843900238201
2023-06-22,0,42.73449993133545,30.290249824523926,43.36750030517578,38.36956167221069,40.94700050354004,-1.341117923474297,3.3403238263074524,1.7601357054671727,2.9919318284697343,39.12512493133545,2.1743003129959106,0.08529774929808459,37.42584929466248,43.06732530593872,0.6403811063817471,0.3934566864345367,1.091258468060442,1.0441442230896953,0.9981209731937932,0.02129972339211461,79.43438577355211,45.841397541035015,39.160749888420106,32.4801022358052,42.474500383649556,0.9939271291969339,40.68169648306711,2.0140430743978897,42.03889270169461,40.56519131530734,10.350771784246968,10.809389065314598,417737000,1.9098641150602291,0.6655137639379886,-479239000.0,-14.546273167635004,44.757923903640624,51.57585752245338,102.50977185188698,37.48253883830426,12.050994315626758,0.03518936622559824,1.499911943004487,42.42437704467773,41.45581265258789,40.67300033569336,39.89018801879883,38.921623626708985,0.08,0.0,21.52620282271211,0.0006513116043689315,0.048827523826205275,42.73606327601841,40.74629265921457,2.9839297743876205
2023-06-23,0,42.37424945831299,30.290249824523926,43.36750030517578,38.620749711990356,42.05062532424927,-1.4927654467291007,2.8347414212804174,3.6839853147595987,2.993082866615425,39.184874534606934,1.9950654220581057,0.07130996672325225,38.154124069213864,43.06732530593872,0.454806500144899,0.41083352494294295,1.0659548331678952,1.0242723449725755,0.985603517778125,-0.0069951201035935995,77.80762314154421,45.421870223160816,39.75238738059998,34.08290453803914,42.7405001776559,0.5150538497807746,40.86946432931082,2.042386987086981,42.22430171983874,40.9897719928319,8.995729061676649,9.121667947778372,358140000,1.9010551950655619,0.5875703137375118,-837379000.0,-26.846568038899086,44.757923903640624,51.57585752245338,75.19742227775717,35.63663179587998,12.525357504758217,-0.027767207868801623,1.464918385377762,42.42437704467773,41.45581265258789,40.67300033569336,39.89018801879883,38.921623626708985,0.08,0.0,21.562458500878016,-0.010409664371121452,-0.018326891510425245,42.90558351789202,40.952378954206196,2.085459008232932
2023-06-26,0,41.48924922943115,38.15074920654297,43.36750030517578,38.81931161880493,42.448874711990356,0.39403737553669704,1.8809058958043656,-1.4857949602911757,2.9946522249805554,39.47649955749512,1.7134716463088993,0.046607159295187287,38.29557466506958,43.06732530593872,0.8302605491463791,0.1105964043294258,1.0280663440883537,0.992745079279964,0.9663607470526614,-0.03806429875541861,66.79877905355126,44.11839915389816,40.35658736228943,36.5947755706807,42.689928599766326,0.6237456699403758,41.04098211015974,1.9811834498053287,42.284548534458,41.33208773602259,4.596137012056495,6.613955977775984,594322000,0.8633743479255097,1.0574228944310056,-1431701000.0,-50.61803360888386,44.757923903640624,51.57585752245338,25.29992969117946,31.263299400909123,19.809904880236036,-0.05438444527889371,1.550567176768211,42.42437704467773,41.45581265258789,40.67300033569336,39.89018801879883,38.921623626708985,0.08,0.0,21.618948262490683,-0.04825259905567536,-0.047382411086465216,42.56782749720982,41.0569943019322,2.008001734763094
2023-06-27,0,41.26574993133545,38.15074920654297,43.36750030517578,38.98087453842163,42.448874711990356,0.25609927752133027,1.8252923304003212,-1.5348676257849487,2.9947212418754896,40.12887525558472,1.6611077213287353,0.04504300513859662,38.38122406005859,43.06732530593872,0.8400463276284317,0.08075881961205982,1.0183209315285568,0.9816005243959334,0.968562487986499,-0.04846371958379847,57.81571557881066,44.17390953186387,40.52332487106323,36.87274021026259,42.488928522382466,0.8245740858601875,41.22439282281058,1.8629204644726474,42.09025052831389,41.297591020586346,-0.8460170825722081,6.143186946392588,462175000,0.8980220200378384,0.8411800089728294,-1893876000.0,-31.86616478749488,44.757923903640624,51.57585752245338,30.962437971844913,29.108745183503967,18.444677443465036,-0.0642152467201594,1.5463835759373892,42.42437704467773,41.45581265258789,40.67300033569336,39.89018801879883,38.921623626708985,0.08,0.0,21.663225445471024,-0.044101567457426105,-0.019113697747839626,42.4568601335798,41.287353515625,1.9949241896507663
2023-06-28,1,41.035000801086426,38.15074920654297,43.36750030517578,39.07131266593933,42.448874711990356,0.1309883514082038,1.7637446670582304,-1.5077298603284905,2.9947931282135007,40.58025074005127,1.5934038639068604,0.04337024179148814,38.659324932098386,43.06732530593872,0.9105317411067305,0.015191289728168834,1.009045095867196,0.9713558485660345,0.9727437614539519,-0.047032924052330394,51.75487482100688,44.19465175248194,40.66716241836548,37.13967308424902,42.18949999128069,0.9267849257819067,41.4189464705331,1.6672339024353287,41.88930191948916,41.23700963570734,-3.2971873762309083,6.635355781046155,582639000,0.7523284563180771,1.094366549561381,-2476515000.0,-44.30224870059129,44.757923903640624,51.57585752245338,18.804725762231435,27.26681594289224,17.277543975409433,0.0010048571264695933,1.5329274558195098,42.45954153442383,41.5127314453125,40.747501373291016,39.982271301269535,39.035461212158204,0.08,0.0,21.71802738573777,-0.044790304354968,-0.06142710547310076,42.23192759922573,41.54741859436035,1.9931851537644856
2023-06-29,1,41.14499855041504,38.15074920654297,43.36750030517578,39.07131266593933,42.448874711990356,0.09817969898281849,1.7655505323129546,-1.51875277862726,2.9947916547219924,40.77362585067749,1.610850191116333,0.043394013625535556,38.659324932098386,43.06732530593872,0.9110810727308719,0.05597699485120523,1.0112690602972045,0.97275593939466,0.984807201530508,-0.03719480474732062,53.756917898772336,44.217600994054,40.6864999294281,37.1553988648022,41.871999740600586,0.8317887800897569,41.63282142366682,1.3836750029451834,41.673578091171585,41.09828961708676,-4.85961302195819,7.109533327938234,380514000,0.623213297187662,0.7590618779238018,-2096001000.0,-58.41790311949786,44.757923903640624,51.57585752245338,8.232903360274273,25.96393263940342,16.45197550353501,0.0789937206702251,1.4948612089752518,42.71017359924316,41.918415550231934,41.27850151062012,40.6385874710083,39.84682942199707,0.08,0.0,21.75337208482995,-0.05120292715867181,-0.05164365653598019,41.80548368181501,41.7125118800572,1.8751058298625058
2023-06-30,1,42.008249282836914,38.15074920654297,43.36750030517578,39.14368724822998,42.448874711990356,-0.03200973745532382,1.7169079296088166,-1.42551464786087,2.994846088156567,41.08999967575073,1.5310113191604615,0.04208029036684038,38.659324932098386,43.06732530593872,0.9122018921327283,0.050629088147587965,1.0295947133444434,0.994807281138248,1.013178372264373,-0.008637325266047213,54.08993549867134,44.23457827414988,40.80076241493225,37.36694655571462,41.721713883536204,0.6582500999119106,41.84617853164673,1.1626421065423196,41.541019789314,41.065900504003466,-5.1248094520575656,7.848468001667835,501148000,0.6216371443044664,1.0133232880171894,-1594853000.0,-31.42224538749842,44.757923903640624,51.57585752245338,51.8158114830121,28.33309850349223,15.108524796243715,0.06354522566915193,1.511514025539104,42.72220928955078,41.9378970489502,41.30400085449219,40.67010466003418,39.88579241943359,0.08,0.0,21.80239799100517,0.002203313033538601,-0.016804325108238125,41.69937242780413,41.964721952165874,1.8835173759645452
2023-07-03,1,42.5074987411499,38.15074920654297,43.36750030517578,39.17762470245361,42.448874711990356,-0.222669994600528,1.6929821504166669,-1.333111016815257,2.994874341139379,41.205374240875244,1.4810000228881832,0.04134967076578151,38.659324932098386,43.06732530593872,0.9082149259815908,0.056930965620958944,1.038210047040858,1.0082166764830487,1.027032754005018,0.024542490660362182,60.25899890958179,44.3290267016512,40.94306240081787,37.55709809998454,41.689285142081125,0.603340708767424,42.08189276286534,0.8887950922719651,41.65605003565753,41.16927124885487,-2.4430907682935916,7.654802266045301,198209000,0.6359691261428563,0.4126493560974137,-1396644000.0,-37.105964211856616,44.757923903640624,51.57585752245338,63.61108236207851,29.074294857324812,14.591681929137415,0.08880643732523552,1.4532629626797162,42.9870016784668,42.3665016784668,41.8650016784668,41.3635016784668,40.7430016784668,0.08,0.0,21.822090962417224,0.04383237917001748,0.004833059169785285,41.611968994140625,42.17401613507952,1.8672118128927437
2023-07-05,1,42.42849922180176,38.15074920654297,43.36750030517578,39.17762470245361,42.54881167411804,-0.4067318277579447,1.7022873391406597,-1.2533854959173223,2.9948684926854736,41.3774995803833,1.46252986907959,0.04143717561674376,38.659324932098386,43.06732530593872,0.8811312607962943,0.08748205120685498,1.0327969508932608,1.007833362487731,1.0201046773385,0.028177103103689483,65.81243128928311,44.48573703561164,41.08116235733032,37.676587679049,41.697035108293804,0.6138622229306326,42.21876764297485,0.7677896100995014,41.86187284725242,41.33163885755914,-0.5311895319947251,8.41675515857969,323618000,0.6136893892637252,0.6788586620830174,-1720262000.0,-43.0076852847929,44.757923903640624,51.57585752245338,59.206264806903285,28.88168631098953,13.794355571870067,0.06657177473524954,1.4274583977708095,43.07196092224121,42.504020454406735,42.045000076293945,41.585979698181156,41.01803923034668,0.08,0.0,21.854197610117442,0.010531192273991019,0.04146983066790243,41.627393450055806,42.26648848397391,1.8250170211241519
2023-07-06,1,41.868000984191895,38.15074920654297,43.36750030517578,40.186063051223755,42.54881167411804,-0.6267117807015605,1.6619313866195822,-0.9680626622225139,2.994913299190472,41.66624975204468,1.3904500007629395,0.040291016290958985,38.659324932098386,43.06732530593872,0.8595063272129011,0.0964003119538731,1.0150264465220649,0.9967426703885571,1.001031723136748,0.02029974818675795,66.03176175152781,44.572050076782254,41.24818730354309,37.92432453030393,41.751142501831055,0.6091691146508731,42.22053555079869,0.7668863975608895,41.99598417401506,41.51554996591299,0.1280253082526912,4.7300465388865875,303582000,0.6023106750599219,0.6425674079630591,-2023844000.0,-48.50898414401304,44.757923903640624,51.57585752245338,23.192832745734847,27.44558458684247,16.89275977155379,0.09343746090996004,1.3948542744576555,43.07196092224121,42.504020454406735,42.045000076293945,41.585979698181156,41.01803923034668,0.08,0.0,21.883281389864994,0.023980290568778928,0.005420777499632035,41.83747318812779,42.202650342668804,1.7225523518930337
2023-07-07,1,42.554749488830566,38.15074920654297,43.36750030517578,40.90431332588196,42.54881167411804,-0.8431063858666258,1.5591437847776608,-0.4527706759357084,2.9950154025726863,41.85562562942505,1.260475044250488,0.037654395566802716,38.95024976730347,43.06732530593872,0.8191600497297197,0.09283829882896548,1.0277264907464103,1.01597565468372,1.0134146389655379,0.034262996429278214,59.92300017445807,44.524974924596826,41.406687355041505,38.288399785486185,41.93528529575893,0.632368606067753,42.2121069090707,0.7621678464649153,41.95799305968418,41.62756476904356,0.9128913195471076,0.059151020466212054,355881000,0.6123297445326167,0.7659189823645218,-1667963000.0,-38.226275103187966,44.757923903640624,51.57585752245338,57.43593403707847,31.239366433483955,15.917507530733428,0.12961346116430264,1.374578973498903,43.07196092224121,42.504020454406735,42.045000076293945,41.585979698181156,41.01803923034668,0.08,0.0,21.918553853070755,0.04117876182728453,0.033708606561142475,41.92701775687082,42.19193894522531,1.4562850812374937
2023-07-10,1,42.32425022125244,38.15074920654297,43.36750030517578,41.117499113082886,42.58424973487854,-1.0474035233995873,1.4045379118099524,0.20613750184555668,2.9951557520879954,41.938125133514404,1.1124150848388665,0.033747628665101455,39.18887453079223,43.06732530593872,0.7321045866453166,0.11543679675712104,1.0169487544519442,1.0109064141329862,1.001202900122513,0.0075223543901563605,65.53472700234647,44.427938166454375,41.618862342834475,38.809786519214576,42.119463784354075,0.5004447781604962,42.15448188781738,0.716477461872708,42.10470547166608,41.84433276667183,3.1236547491320543,-0.27652537716427317,353908000,0.6162229359916913,0.7669434267943692,-2021871000.0,-46.52955995689101,44.757923903640624,51.57585752245338,25.825793417846192,29.331993491485772,17.73575447845794,0.10552616029675836,1.359394944211591,43.07196092224121,42.504020454406735,42.045000076293945,41.585979698181156,41.01803923034668,0.08,0.0,21.952804902087586,-0.0028840248907260335,0.03326637713696875,42.07882908412388,42.155378341674805,1.2475759717853316
2023-07-11,1,42.42774963378906,39.021249771118164,43.36750030517578,41.23556208610535,42.58424973487854,-1.0518386932868344,1.163043264697008,0.4333546455358528,2.9953417499049353,42.16624975204468,0.9116763067245479,0.02780568346048027,40.38177576065063,43.06732530593872,0.710701406240587,0.08464619840492692,1.0143496910796233,1.013499511637053,1.0021529811775614,-0.0018761185607855113,61.01052538660891,44.15362392296396,41.82753739356995,39.501450864175936,42.302713939121794,0.262381145847666,42.08735683986119,0.6332820592318638,42.161147125966906,42.01443002539577,3.1418286706403133,-1.870465066523929,298244000,0.6051029687151364,0.6555117171367727,-1723627000.0,-34.42394868015936,44.757923903640624,51.57585752245338,33.786047626230975,28.228241107631444,17.06836440520106,0.13663857285173092,1.31165231086737,42.785460922241214,42.27227045440674,41.857500076293945,41.442729698181154,40.92953923034668,0.08,0.0,21.981858487497853,-0.00018857425358653757,0.002434895654803184,42.304904392787385,42.0551940373012,1.0101502549613075
2023-07-12,1,43.41175079345703,39.207499504089355,43.36750030517578,41.43337440490723,42.58424973487854,-1.1141554890055776,0.9736063156842558,1.1426194293868965,2.9954611478699396,42.349249839782715,0.7616898918151861,0.023182282629520195,40.98272581100464,43.06732530593872,0.5917859705455397,0.08213352471926536,1.03366572312026,1.034685376183075,1.0257817610505733,0.02317431890567634,61.49481160458418,43.945075018072,41.99786238670349,40.05064975533498,42.50321415492466,0.4609617028365715,42.11246401923044,0.6800606688267962,42.23160718932471,42.13873816081353,3.1176355050839684,-2.1669468260188434,481277000,0.6052957607000538,1.047147382430712,-1242350000.0,-0.8605194549413472,44.757923903640624,51.57585752245338,136.19696981057268,32.238196322534954,15.662952236118878,0.14680068775999608,1.327248759662141,43.029940689086914,42.470030265808106,42.017499923706055,41.564969581604004,41.005059158325196,0.08,0.0,22.03114793001356,0.03745531490659726,0.03510719987476366,42.533407483782085,42.11638995579311,0.8879973239945255
2023-07-13,0,45.28550052642822,40.512250900268555,43.41175079345703,41.75475001335144,42.68818783760071,-0.40981404296533985,0.7838161175836882,-0.6367581638640782,2.9955593846695465,42.400999546051025,0.649784965515137,0.018570288232534666,41.133998775482176,43.15465049743652,0.5484136390398815,0.07157094036385067,1.0729108252109685,1.073852178807256,1.0651076217803133,0.08162557232017531,66.61853812312033,43.77570718633925,42.208074951171874,40.6404427160045,42.900071552821565,1.1484440694848084,42.294678347451345,1.082329247966288,42.534076572348255,42.37099290217202,3.3410140498131597,0.8162992757011908,478204000,0.5772197153612153,1.055970145133955,-764146000.0,-2.9396792756422614,44.757923903640624,51.57585752245338,294.1238219554037,39.89520966351815,13.853951083910587,0.13064069340232318,1.3933737305470502,44.726018707275394,43.84198866271973,43.127498626708984,42.41300859069824,41.528978546142575,0.1,0.0,22.084441085857073,0.09201254877650311,0.08649006999928223,43.04239872523716,42.327183859688894,1.1613047724351804
2023-07-14,0,46.30000114440918,41.035000801086426,45.28550052642822,41.86181330680847,42.815937519073486,1.0231909738143403,0.9418834185719953,1.879668556850869,2.995487848199086,42.42812442779541,0.6704864168167113,0.022189771830408683,41.253674793243405,43.371925354003906,0.5227637068600591,0.08226536488382624,1.0907787958511233,1.086953365411005,1.071739435430228,0.0880101915900513,74.97076433014453,44.330504269623844,42.44673743247986,40.56297059533587,43.4531432560512,1.68866146628948,42.575089182172505,1.5232589469237567,43.22884741012852,42.79801163621561,6.535321690403396,5.969417213707068,772075000,0.6443556922348792,1.6989666357126825,7929000.0,-32.78666212672641,44.757923903640624,51.57585752245338,265.8237247977297,43.32431016713625,11.869746978161219,-0.013084416971286374,1.510132741074392,46.20283259582519,45.03658419036865,44.0939998626709,43.15141553497315,41.985167129516604,0.12000000000000001,0.0,22.172398918208632,0.06978336808195595,0.079946835820476,43.49254935128348,42.559971400669646,1.3306072747581754
2023-07-17,0,46.126999855041504,41.035000801086426,46.30000114440918,41.97318720817566,43.077937841415405,1.368908171592207,1.2496639658700601,1.923535791989237,2.995308850790956,42.46799898147583,0.8606654167175293,0.02928700289548004,41.253674793243405,43.599125766754156,0.6472748255845888,0.08500156730417112,1.0810278724599767,1.0699434282739284,1.0495371285270751,0.08984800944871951,78.06865834139894,45.168902907707526,42.66957497596741,40.17024704422729,44.061571666172576,1.786756953468811,42.90635708400181,1.7555366209641357,44.002865976153416,43.28551117269402,9.124767535067708,9.264474855084512,510488000,0.6553824539758755,1.1305705717410952,-502559000.0,-21.295848770209407,44.757923903640624,51.57585752245338,197.70965449079944,40.76211360328349,11.167771001996316,0.0473210450780124,1.4904087842098412,46.28496139526367,45.169521484375,44.268001556396484,43.36648162841797,42.2510417175293,0.12000000000000001,0.0,22.22988519035104,0.10149364153399287,0.09312289700357433,44.114934648786274,42.97620391845703,1.5771218585913602
2023-07-18,0,46.95625019073486,41.035000801086426,46.30000114440918,41.97318720817566,43.190125465393066,1.1679259112867855,1.4592872459334691,0.5861518045693872,2.995159474252997,42.46799898147583,1.0786991310119625,0.03406184246825154,41.253674793243405,45.36965045928955,0.7705339476879327,0.0694627831537749,1.0960257491139183,1.0788711874018815,1.0502310375323944,0.10673440368704701,75.47269777078607,45.7608619369353,42.84228744506836,39.92371295320142,44.69035748073033,1.9363217684966592,43.31282138824463,1.9896244693206582,44.537582881128074,43.6419214586408,10.172443801311841,11.178198477306934,569164000,0.6569860461708021,1.2727165597002084,66605000.0,-7.846787238652905,44.757923903640624,51.57585752245338,195.941110079554,43.170608763104894,10.046706967856885,0.1567736846520277,1.5383794959648063,46.301481323242186,45.196261367797845,44.303001403808594,43.40974143981933,42.304521484374995,0.12000000000000001,0.0,22.296243643888648,0.12000947728353983,0.12598394922925107,44.82772173200335,43.37736974443708,1.8850067448331254
2023-07-19,0,47.27525043487549,41.035000801086426,46.95625019073486,41.97318720817566,43.378562927246094,1.0776269560945615,1.7131855241630782,-0.005707251036479732,2.994950567257415,42.46799898147583,1.3273403596878048,0.039810462464819917,41.253674793243405,46.14429998397827,0.7887207046595459,0.08275205765389193,1.098567292571531,1.0752103122616878,1.036372024671159,0.08899663272739411,78.3916669736126,46.45992097699133,43.03354992866516,39.60717888033899,45.39764322553362,1.8292752706261493,43.75855350494385,2.1338439406612104,45.14377144204635,44.05307705465535,10.343147955928087,13.789886937395245,427502000,0.6738451940321343,0.9584784589980527,494107000.0,-13.50161874947464,44.757923903640624,51.57585752245338,163.75527650628237,40.96649343832278,9.53376305935278,0.10252029657808011,1.5053524043689637,46.320832595825195,45.22758419036865,44.3439998626709,43.460415534973144,42.3671671295166,0.12000000000000001,0.0,22.346195681413814,0.07232016198587066,0.11017567079091675,45.52708380562918,43.802956444876536,2.0807924550089556
2023-07-20,0,46.04400062561035,41.035000801086426,47.27525043487549,41.97318720817566,43.88018822669983,0.9488077377576435,1.9470113967391585,-0.520234284753958,2.99473162506343,42.46799898147583,1.5982128334045398,0.04503953861137499,41.253674793243405,46.36562604904175,0.8304234657504168,0.09788610435275823,1.065119879355888,1.035789451715808,0.9925671756654803,0.01674929260723257,80.43310810442307,47.12296022862846,43.228937435150144,39.33491464167183,45.91425051007952,1.2784636894579007,44.10848222460066,2.0731074230489175,45.6753018770969,44.4388160174884,11.697785992052806,15.207139056821582,537865000,0.6640157863497411,1.2077772533281717,-43758000.0,-38.08959615248603,44.757923903640624,51.57585752245338,93.77223896045923,37.12491832861189,16.419478207057452,0.05366976558822792,1.5424701987625336,46.49688911437988,45.51255702972412,44.71700096130371,43.9214448928833,42.93711280822754,0.12000000000000001,0.0,22.40543156692169,-0.009939838930871248,0.03685481027232814,45.97195053100586,44.138427461896626,2.1396579022209163
2023-07-21,0,45.01574897766113,41.035000801086426,47.27525043487549,41.97318720817566,45.475125551223755,0.7359395062012483,2.0404417988002326,-1.010362256121231,2.9946379452306027,42.46799898147583,1.775287890434265,0.04703849696230999,41.253674793243405,46.36562604904175,0.8904532115533706,0.0774432999003735,1.0377523008923282,1.0032337103490994,0.967238180558311,-0.027737627105936302,67.1383021908647,47.459008549916746,43.378124952316284,39.29724135471582,46.143393107822966,0.8148693446326453,44.32330363137381,1.9930098280998572,45.76309695435399,44.588651119802314,8.523315573026151,11.906676990625135,963769000,0.7307489590667758,2.039134962577983,-1007527000.0,-56.051658533135196,44.757923903640624,51.57585752245338,46.23632869103453,34.119951876740814,19.499640595507376,-0.04171382865286885,1.5584368027815891,46.49688911437988,45.51255702972412,44.71700096130371,43.9214448928833,42.93711280822754,0.02,1.0,22.505753156881333,-0.025511969008022772,-0.036279146431218955,46.03007561819894,44.28174155099051,2.147367971352796
2023-07-24,0,44.623000144958496,41.035000801086426,47.27525043487549,41.97318720817566,45.475125551223755,0.5706774760704683,2.0648899378176138,-1.228033955937121,2.994614678473911,42.46799898147583,1.855843992233276,0.04747726111374367,41.253674793243405,46.36562604904175,0.910754483646786,0.06233737595628221,1.0260003648426632,0.9890561688788012,0.9641201618449724,-0.0326056260933828,58.619608326984675,47.621967280267796,43.49218740463257,39.36240752899734,46.04875019618443,0.9571647723166495,44.474410874503,1.92374133255732,45.570822517427324,44.5435335903989,3.694847949891609,7.159307388829881,382516000,0.7705989754269643,0.8072427219297043,-1390043000.0,-51.55742273145201,44.757923903640624,51.57585752245338,35.6738411635008,32.40984890069517,18.803612261056983,-0.019451566227466223,1.5234770485929467,46.49688911437988,45.51255702972412,44.71700096130371,43.9214448928833,42.93711280822754,0.04,0.0,22.545016551675836,-0.039796886075993076,-0.018848076235886666,45.83513314383371,44.43876593453543,2.141238990771314
2023-07-25,0,45.43150043487549,41.035000801086426,47.27525043487549,41.97318720817566,45.475125551223755,0.425409762488395,2.0621774575110687,-1.3291156236732322,2.9946207960734217,42.531124114990234,1.8789752388000494,0.04729263146736342,41.253674793243405,46.36562604904175,0.9028071460085805,0.07553163708019958,1.0418963699026833,1.0018716983180869,0.9880096679741233,-0.03247171036157892,57.155366611920186,47.72897985398697,43.60462493896485,39.48027002394272,45.92467866625105,0.9752863190926614,44.68891096115112,1.8438311120133475,45.32966061628912,44.44665177931,-1.462941501735411,4.976772255387158,348081000,0.7435347326114486,0.7541681657145884,-1041962000.0,-35.731239833085795,44.757923903640624,51.57585752245338,63.90438441603155,35.05222232408837,17.421680125292795,0.02624048511962279,1.526871484086866,46.49688911437988,45.51255702972412,44.71700096130371,43.9214448928833,42.93711280822754,0.04,0.0,22.582252586331723,-0.03821543672254002,-0.01683138237755842,45.8651237487793,44.67883655003139,2.072539447195976
2023-07-26,0,45.539000511169434,41.035000801086426,47.27525043487549,42.24524998664856,45.584625482559204,0.2410633954791231,2.038836798055064,-1.426380019286859,2.9946524092325455,42.9832501411438,1.8842614841461185,0.046546938876353396,41.253674793243405,46.36562604904175,0.8754348210720538,0.10094934686687339,1.039661965737378,0.9976340219314379,0.9969591506603649,-0.03672640351419909,62.32420331984732,47.879411095347194,43.80173749923706,39.72406390312693,45.84067875998361,0.9802654667111727,44.95112521307809,1.66407289862786,45.355390594206355,44.517656358239385,-1.875811421310439,7.077792682166442,364237000,0.7508338113084925,0.797635280103704,-677725000.0,-40.9380394870452,44.757923903640624,51.57585752245338,50.14113922560641,32.707423940257605,17.633639519014746,-0.013548298802825185,1.5194521163444725,46.56839654541016,45.62830210876465,44.868499755859375,44.1086974029541,43.1686029663086,0.04,0.0,22.620722678598682,-0.03451787791761529,-0.042994917222383314,45.72102410452707,44.91797937665667,2.049513501655591
2023-07-27,0,46.391000747680664,41.035000801086426,47.27525043487549,42.40187478065491,45.66525053977966,0.0747976132686135,1.9850809314010702,-1.4545757634467815,2.994715895271315,44.017375469207764,1.8443252563476562,0.04509969079294887,41.79570074081421,46.36562604904175,0.8554320576953909,0.10975995180104302,1.053972035195144,1.0115847938426907,1.0233914714564574,0.007536272203882088,63.431391432931896,47.98556189103089,44.01540002822876,40.04523816542663,45.75992883954729,0.8923968789016038,45.22514316013881,1.55113420548036,45.400894926580264,44.59725549594648,-1.2747400561924997,8.768031529290349,455976000,0.7439313752409925,1.0125759222087576,-221749000.0,-33.980411695634814,44.757923903640624,51.57585752245338,78.48680723624993,35.96377308323412,16.054437465341273,-0.048845360398911214,1.5497055932810853,46.56839654541016,45.62830210876465,44.868499755859375,44.1086974029541,43.1686029663086,0.04,0.0,22.670744377869436,0.008348070951477826,-0.02500150154908801,45.49337823050363,45.16054998125349,1.9723495450238686
2023-07-28,0,46.70650005340576,41.14499855041504,47.27525043487549,42.428311824798584,46.06475043296814,-0.05859217543931699,1.9253219021498287,-1.5086662289571198,2.9947858798493594,44.819374561309814,1.7873053312301637,0.04347747906742536,41.99422445297241,46.44752569198609,0.8206849302777766,0.12750036169858384,1.0547227848585616,1.0160152346661446,1.0287763975026112,0.03755910129549678,67.63822287110294,48.13384382985813,44.28320002555847,40.432556221258814,45.678678785051616,0.745186739793966,45.53816100529262,1.3498074280688472,45.65048677322819,44.80142304329285,-1.2037789234833982,9.014860397326522,331194000,0.7556204951021378,0.739525047510656,109445000.0,-22.222243341069166,44.757923903640624,51.57585752245338,86.52937041700288,34.058503220835654,15.20391391794587,-0.020228091086912297,1.519512258144377,46.667045272827146,45.787979286193845,45.07750129699707,44.367023307800295,43.487957321166995,0.04,0.0,22.707512377226163,0.05509048032869157,0.027021122834236563,45.446678161621094,45.48688098362514,1.8739237320415265
2023-07-31,0,46.77975082397461,41.868000984191895,47.27525043487549,42.487748861312866,46.17025017738342,-0.16442728006454882,1.8522263376264327,-1.5614711969602748,2.9948660862286505,45.15062475204468,1.695945243835449,0.04156582892748066,42.29265012741089,46.731475067138675,0.8340665083566744,0.11184114669802217,1.0497848348875312,1.0167096319639617,1.0227720032038712,0.04833271344396106,68.13736615450343,48.265727775960876,44.56127510070801,40.85682242545514,45.78378595624651,0.8498418116176364,45.849018233163015,1.0451270279626383,45.91701260850124,45.07458796956915,-1.2030615940431972,10.353992827385856,251055000,0.7430132603750725,0.57668420650649,360500000.0,-25.588419296288663,44.757923903640624,51.57585752245338,82.76203022853406,33.52102930662085,14.738342764010765,-0.05937693450912729,1.4555471360852335,46.8346050567627,46.0591989364624,45.4325008392334,44.805802742004396,44.0303966217041,0.04,0.0,22.735388673481793,0.047453625000609456,0.05461648223312353,45.61934062412807,45.795645577566965,1.8568935383463887
2023-08-01,0,46.47350025177002,41.868000984191895,47.27525043487549,42.5429368019104,46.32275104522705,-0.34090716206000066,1.8149405014503022,-1.4484395572349071,2.994907522787276,45.358500480651855,1.6253302192687982,0.04051220024729224,42.4173996925354,46.79740076065063,0.8437916463544003,0.10050584507078751,1.0373583855161148,1.008622671894298,1.0065833375929272,0.022935624113674224,67.88748878420705,48.4297311806655,44.799850177764895,41.16996917486429,45.992036138262065,0.8078401935046444,46.06771462304251,0.783477859152978,46.13087357859354,45.34171327722557,1.5979284779068974,10.257440537736308,237858000,0.7414973665561309,0.5438933588704228,122642000.0,-39.05635253529396,44.757923903640624,51.57585752245338,64.45882086361215,32.04268997462671,16.508144138447854,-0.04747628486577061,1.4139367048386304,47.13267317199707,46.54166512298584,46.06400108337402,45.58633704376221,44.99532899475098,0.04,0.0,22.76140015555858,0.01812655382126538,0.04247743208670214,45.93324715750558,45.98166138785226,1.8093218370111896
2023-08-02,0,44.83175086975098,41.868000984191895,47.27525043487549,43.197500467300415,46.411625623703,-0.5543025967373562,1.769745059863821,-1.211578563379082,2.994952891707225,45.48525047302246,1.5349051284790043,0.03932928464618822,42.4173996925354,46.79740076065063,0.8381663825164848,0.09533688686046547,0.9963020839165998,0.9740119846150959,0.9666608896700618,-0.015530636014837174,64.68060292053109,48.53764037302354,44.9981502532959,41.45866013356825,46.021857670375276,0.7507120793364397,46.035303933279856,0.8265279274137849,46.209433614891594,45.53971735731939,3.2383139394887985,7.052812665584664,530142000,0.7481055449783945,1.184275514692364,-407500000.0,-81.23803596250707,44.757923903640624,51.57585752245338,-27.725200576151416,27.39302997208424,26.391070818770867,-0.042225869259138966,1.5357982924847873,46.97856520080566,46.2922191696167,45.73750114440918,45.18278311920166,44.4964370880127,0.06,0.0,22.814349041555275,-0.02602741255585095,-0.030867460074609318,45.88426262991769,45.8596978868757,1.708744063988501
2023-08-03,0,44.30824947357178,41.868000984191895,47.27525043487549,44.32018780708313,46.411625623703,-0.6938347262839198,1.6699663611172635,-0.855993021384422,2.9950410817921305,45.48525047302246,1.3889501571655274,0.03701304982743378,42.4173996925354,46.79740076065063,0.7801682431199637,0.07078794821558607,0.9820457966796857,0.9677760887080984,0.9582959122590186,-0.044895588380102214,51.05935208534376,48.45824555792788,45.11831283569336,41.77838011345884,45.86139324733189,0.9822678967213596,45.89303595679147,0.94095775290084,45.85795914284345,45.48214091867484,0.4678097037723832,-1.0019755802686596,324176000,0.8402259302243539,0.7225095089914741,-731676000.0,-74.9833968834364,44.757923903640624,51.57585752245338,-39.11860249991068,25.696681101722355,24.75676956707709,-0.06671648657245767,1.5202413282685185,46.831876174926755,46.17356233978271,45.64150047302246,45.10943860626221,44.45112477111817,0.06,0.0,22.8465685631521,-0.030174309027601987,-0.020615119814181418,45.71802738734654,45.79157556806292,1.5681065578251383
2023-08-04,0,44.92500019073486,42.32425022125244,47.27525043487549,44.544312477111816,46.411625623703,-0.6910778743620873,1.5094649354888885,-0.6746570846527784,2.9951711210685255,45.48525047302246,1.242535247802735,0.033365474868017594,42.54204950332642,46.79740076065063,0.7612510380766637,0.04120574097613842,0.9930299999477423,0.9849813629750168,0.9804681127323855,-0.03814243971682474,46.05914218139432,48.25925513114012,45.24032526016235,42.22139538918458,45.77367891584124,1.0414844836455976,45.807178837912424,0.9722841194552799,45.469105440608715,45.38870570273494,-2.472405600853648,-4.301839355522155,362666000,0.8434427957416855,0.8076836692186325,-369010000.0,-71.32402769188339,44.757923903640624,51.57585752245338,-25.301746463697988,26.66301585197503,23.285185369779754,-0.07362054740461346,1.50086671443642,46.831876174926755,46.17356233978271,45.64150047302246,45.10943860626221,44.45112477111817,0.06,0.0,22.883210019760654,-0.0442781019631453,-0.026579605678334405,45.607774462018696,45.66439928327288,1.4427176286201842
2023-08-07,0,45.15775012969971,42.32425022125244,47.27525043487549,44.779563188552856,46.411625623703,-0.7926051542338073,1.3815914027989737,-0.17265104257031938,2.9952644517945153,45.48525047302246,1.1076539325714108,0.030459144677278838,43.313350677490234,46.79740076065063,0.69349066323198,0.06144822308456387,0.9955667368184004,0.9902814423811322,0.9932715435277536,-0.034673136682113914,51.145634228454476,48.12202060085552,45.35883779525757,42.59565498965962,45.59750025612967,1.023812251881417,45.67871454783848,0.9265204948506953,45.33082494825865,45.361640666483126,-1.3482955566492358,-2.605848349305264,322154000,0.8475849781972065,0.720006374150807,-46856000.0,-54.18643892696029,44.757923903640624,51.57585752245338,-21.356521274218355,25.391566375926452,22.174810725648587,-0.04354265149588596,1.4634477484184996,46.77228485107422,46.12535888671875,45.602500915527344,45.07964294433594,44.43271697998047,0.06,0.0,22.916051816568835,-0.02807670385413763,-0.02851333919489789,45.53879492623465,45.51608657836914,1.242775093317047
2023-08-08,0,44.70375061035156,42.42774963378906,47.27525043487549,44.90168786048889,46.411625623703,-0.7624126124054317,1.1959551518375466,0.23979173270504983,2.9953843976918355,45.48525047302246,0.9587126731872558,0.02628443238298007,44.2185996055603,46.79740076065063,0.5873544637972052,0.06434469231751329,0.9824889406413113,0.9791772593429846,0.9903520866875875,-0.038080833847909945,52.64588730439603,47.89242309435503,45.500512790679934,43.10860248700484,45.31139319283621,0.9385322121909395,45.49503598894392,0.836155185024134,45.289006921701905,45.38340022999477,-2.6583833030215755,-3.8301611685977983,353843000,0.8478084048882867,0.785947334600736,-400699000.0,-68.13870728571115,44.757923903640624,51.57585752245338,-74.36026541434134,23.69637226318508,23.181396548613293,-0.04156049947838111,1.4561300564625461,46.44911259460449,45.86394467926026,45.391000747680664,44.91805681610107,44.332888900756835,0.06,0.0,22.95117370205707,-0.03962837841718536,-0.044190866286789386,45.240884508405415,45.343781335013254,1.0365239110569946
2023-08-09,1,43.31849956512451,43.41175079345703,47.27525043487549,44.90168786048889,46.411625623703,-0.22144766285756445,0.9884361900377127,-0.6827862503399023,2.995497072832494,45.48525047302246,0.8524438571929934,0.021669430678819643,44.591525077819824,46.79740076065063,0.5146570435804212,0.029761522935151004,0.9496690154587824,0.9503500416471754,0.96724816666738,-0.033754008604814256,47.203150354399746,47.59118521958349,45.61431283950806,43.63744045943263,44.816928727286204,0.9477289876796576,45.30035734176636,0.9997835607047656,45.15112709866602,45.354356610107104,-4.287945876407329,-5.43942084043811,586449000,0.8334791406499782,1.2875669060600385,-987148000.0,-92.01669156140784,44.757923903640624,51.57585752245338,-196.90272852672683,20.902675150288008,29.40474247715377,-0.13045143579033128,1.5328352377148047,46.15340408325196,45.3852978515625,44.76449966430664,44.14370147705078,43.375595245361325,0.08,0.0,23.004717164844216,-0.03874047742596143,-0.0849979512437027,44.64463479178293,45.131987707955496,1.1838921442390926
2023-08-10,1,42.48925018310547,43.31849956512451,47.27525043487549,44.90168786048889,46.411625623703,-0.2714973028317328,0.9989786351588635,-0.5710956802005542,2.99549188475749,45.48525047302246,0.8566401624679564,0.021902790945948613,44.591525077819824,46.79740076065063,0.5728943566080464,-0.04343555748391886,0.9315846520207842,0.936720635691276,0.9551870266033041,-0.04105328718868195,34.311449704281905,47.60760754840916,45.60965027809143,43.611693007773695,44.24775014604841,0.9827893799842772,45.11989314215524,1.251453067471795,44.70375050100459,45.14029874165567,-7.399037399481417,-5.919340247271815,492705000,0.7776910491105324,1.0800297898435047,-1479853000.0,-90.05393404280282,44.757923903640624,51.57585752245338,-185.0500397224754,19.224929696411255,28.424632122627447,-0.19109309797138863,1.547561451291119,46.08284013366699,45.271079933166504,44.614999771118164,43.958919609069824,43.14715940856934,0.1,0.0,23.04858338803739,-0.047781695766994425,-0.04249028994826477,44.05638231549944,44.99481473650251,1.3659517214450168
2023-08-11,1,41.31575012207031,42.48925018310547,47.27525043487549,44.79975080490112,46.411625623703,-0.6649183932169211,1.2083054076316089,-0.029852982926186655,2.9953769843122466,45.48525047302246,0.9893877029418945,0.026573778731842572,44.209274482727054,46.79740076065063,0.6416714217158469,-0.08230563427888526,0.9086408079857982,0.9187525278167309,0.9364647989441106,-0.08033945583396807,27.948841665610594,47.88644857618851,45.469837760925294,43.053226945662075,43.74546432495117,1.4308959760265731,44.88366099766323,1.6125248916962212,44.15690705914807,44.842923890705954,-8.573165453602355,-5.6124775260529995,533085000,0.7465371643554496,1.1999763644600263,-2012938000.0,-96.80284803604661,44.757923903640624,51.57585752245338,-224.73632661688586,17.687272395444527,31.620509950263237,-0.17401391006725803,1.561949958292925,45.80058433532715,44.81420825958252,44.01700019836426,43.219792137146,42.23341606140137,0.12000000000000001,0.0,23.092372668692203,-0.08560871692142036,-0.08221948374434503,43.568813868931365,44.72653824942453,1.6906888656921673
2023-08-14,1,42.08749961853027,41.31575012207031,47.27525043487549,44.683562994003296,46.411625623703,-0.9350369487278283,1.4920652485324124,0.48391438134524467,2.9951819744197974,45.2946252822876,1.1517501831054688,0.03299523705410388,43.235574626922606,46.79740076065063,0.6769234320692136,-0.10430441494333043,0.9307146777219149,0.9472696724190479,0.9698250915994983,-0.06798944815344476,23.82300456809672,48.20475570687317,45.22062520980835,42.23649471274352,43.428214345659526,1.5281997450137041,44.64480379649571,1.7655403743703701,43.447336266171,44.40992682140612,-7.842657668882148,-7.411536678718445,690286000,0.7773840789219275,1.5230162024807599,-1322652000.0,-51.41166422908001,44.757923903640624,51.57585752245338,-124.82482640631312,22.58292674911469,26.983950476725813,-0.1495845522701272,1.6995962764924284,45.72317654418946,44.68891259765625,43.85300064086914,43.01708868408203,41.982824737548825,0.14,0.0,23.153286323536907,-0.036638341164778265,-0.020747559502499256,43.45998873029436,44.589008058820454,1.6836731853124793
2023-08-15,1,44.369500160217285,41.31575012207031,47.27525043487549,44.544312477111816,46.411625623703,-0.7190551311309252,1.6233338686592347,-0.2755214147529754,2.9950761269135704,45.08674955368042,1.2568002223968506,0.03605914130077524,42.44907512664795,46.79740076065063,0.76326015697325,-0.10368695439750561,0.9855804197835636,1.0092900327290188,1.0370837013260013,-0.007477011337318928,29.462689723389804,48.26531793530126,45.01865019798279,41.77198246066431,43.34885719844273,1.4499387909453703,44.56126805714199,1.7475529226505417,43.1076721607492,44.11858204777892,-5.0120460217371,-7.360533516031958,676512000,0.7732651250165455,1.4751564831977424,-646140000.0,-48.77190866265883,44.757923903640624,51.57585752245338,-30.90584714235357,27.3018688191254,25.20652272234588,-0.23879219921376027,1.6894824333089562,45.72317654418946,44.68891259765625,43.85300064086914,43.01708868408203,41.982824737548825,0.02,1.0,23.217751101652336,-0.016209968888232784,-0.03252087780853859,43.35430635724749,44.48104040963309,1.5865329067154905
2023-08-16,1,44.02174949645996,41.31575012207031,47.27525043487549,44.35418748855591,46.13075065612793,-0.651150290812728,1.565835164318424,-0.22463050517444483,2.995118932923411,44.970374584198,1.1956563520431516,0.034882137200599524,42.44907512664795,46.713825130462645,0.7585779539083027,-0.061464513628776,0.9806732794983197,1.0061953158137438,1.0305657484834947,0.016234401892849304,46.108533376753286,48.020983025093756,44.88931269645691,41.75764236782007,43.186571393694194,1.2655873877339843,44.392035824911936,1.6697176340644304,43.41794222724781,44.13429365882569,-1.2365053492690736,-2.5681291592363844,527451000,0.9533827377671962,1.1377261912722363,-1173591000.0,-53.438933518315565,44.757923903640624,51.57585752245338,-49.977845504750846,25.81057696131364,25.138211830208448,-0.2685346186541881,1.6594480457211787,45.520717010498046,44.525142974853516,43.72050094604492,42.91585891723633,41.9202848815918,0.02,0.0,23.26667241828394,0.02190157638085677,-0.02637477513683147,43.07853153773717,44.30866323198591,1.5143157396742875
2023-08-17,1,43.59425067901611,41.31575012207031,46.77975082397461,44.23662447929382,45.66525053977966,-0.6669226497846495,1.4759318892294384,-0.18663131429678392,2.9951835280087895,44.87837553024292,1.130248947143555,0.032998945746701924,42.44907512664795,46.49680023193359,0.787094848655556,-0.04391997006501613,0.9746820456437382,0.998272274001236,1.017208508913617,0.02600658969383307,45.862290795948255,47.678501427995,44.72663764953613,41.77477387107726,43.02807140350342,1.102934155781607,44.16973229816982,1.5400123168733473,43.561341779994834,44.09653929445258,-2.5156271735792526,-5.107135463852124,452395000,0.9206388092187312,0.9849072829299356,-1625986000.0,-55.52132515831636,44.757923903640624,51.57585752245338,-65.93041404521708,24.600660258456493,25.749165312838805,-0.2563733919426834,1.616701815596423,45.520717010498046,44.525142974853516,43.72050094604492,42.91585891723633,41.9202848815918,0.02,0.0,23.30766330680601,0.02255358406054353,0.018564667286050846,42.89001628330776,44.06545039585659,1.5227989349363316
2023-08-18,1,42.792999267578125,41.31575012207031,46.77975082397461,43.914874792099,45.458375453948975,-0.4925384616196261,1.463118076798965,-0.3087275316914151,2.995191115491877,44.76775074005127,1.1328451919555662,0.032802285702255206,42.44907512664795,46.49680023193359,0.8057431102897592,-0.03157779956855615,0.9593950141758568,0.9815290778182233,0.9933898416797582,0.035755108914715894,44.88667704432943,47.530386305804356,44.60415015220642,41.67791399860849,42.952999932425364,1.0977433537015229,43.884964329855784,1.3806127725696251,43.56552644878352,44.07004697574699,-2.481894508150138,-6.663418091338463,583768000,0.8984864683864162,1.3257588188063225,-2209754000.0,-54.651712792521366,44.757923903640624,51.57585752245338,-91.0369707323324,22.54337682359447,29.442761401044628,-0.1368982160323252,1.6382230621665448,45.34499736022949,44.38300325775146,43.60550117492676,42.82799909210205,41.866004989624024,0.02,0.0,23.358684777543605,0.05982130048059675,0.02149195827242616,42.99641309465681,43.82052394321987,1.5456838281085963
2023-08-21,1,45.68699932098389,41.31575012207031,46.77975082397461,43.52531290054321,45.458375453948975,-0.31300869443101104,1.5112596278139718,-0.6572972416957286,2.995153112811222,44.66337537765503,1.2139365434646607,0.03396622384586176,42.44907512664795,46.49680023193359,0.793781701208064,-0.0410102608841984,1.026835374426672,1.0530573708176103,1.053346294138462,0.08552419922966448,41.11232444576885,47.51553192233022,44.49301266670227,41.47049341107432,43.40982123783657,1.473608480040086,43.828785691942485,1.2794776127650869,43.37324567688418,43.98213033799822,-1.2131082628020295,-8.522387328222525,692573000,0.9106424929324695,1.5193658692719638,-1517181000.0,-1.4509861509612996,44.757923903640624,51.57585752245338,81.02453024066668,33.06895983363758,25.018636049559916,-0.06445494863768596,1.7902070463212243,45.47105514526367,44.48497146606445,43.6879997253418,42.89102798461914,41.904944305419924,0.04,0.0,23.428875110189544,0.07345794182233556,0.14960228597302902,43.65036065237863,43.853371483939036,1.6458959921956393
2023-08-22,1,46.83074951171875,41.31575012207031,46.77975082397461,43.52531290054321,45.57600021362305,-0.3801561287565325,1.5334636599375049,-0.7261587236486653,2.9951369078995005,44.76775074005127,1.261816506385803,0.03442410857302756,42.44907512664795,46.49680023193359,0.7263559693964936,0.005623826720727558,1.0512846491669476,1.078104946461135,1.0620879398415133,0.055471649277407886,56.2574159121892,47.613139945378556,44.54621262550354,41.47928530562853,44.19767829350063,1.633080777279511,43.9715713092259,1.4936336146530205,43.95928386678601,44.3242776649158,7.526019226269857,-1.6923643076705366,755293000,1.1156898062148275,1.5861138883586394,-761888000.0,-31.983255240850006,44.757923903640624,51.57585752245338,92.4046037353425,33.751072617417414,22.285676576045375,-0.1296968982326966,1.8661922638377615,46.328264404296874,45.17836848449707,44.249000549316406,43.31963261413574,42.16973669433594,0.06,0.0,23.505974481488128,0.03932633154901888,0.043768472302785424,44.33772604806082,43.953269958496094,1.6455035921083092
2023-08-23,1,46.347500801086426,41.31575012207031,46.83074951171875,43.52531290054321,45.86299967765808,-0.32767825973970205,1.602618097162913,-0.8463630947802634,2.9950843105406726,44.76775074005127,1.32478271484375,0.0359201140463701,42.44907512664795,46.713825130462645,0.7011107696598718,0.028365774084841557,1.0388048890040826,1.0617807842006446,1.0395230980482275,0.05283186904721937,60.76160620242838,47.82141127367153,44.6161750793457,41.410938885019874,44.80624989100865,1.5043317452991058,44.11723211833409,1.6228390990503085,44.683515742944195,44.71524166238934,13.348418879855698,4.458890414018035,779046000,1.1439252199479886,1.567713528236848,-1540934000.0,-13.598263334247129,44.757923903640624,51.57585752245338,91.28877722879204,31.190091522321335,21.07081777594401,-0.05820052252249623,1.8751785721232062,46.328264404296874,45.17836848449707,44.249000549316406,43.31963261413574,42.16973669433594,0.06,0.0,23.58534455604651,0.08347523758395559,0.07228045463545447,44.81801169259207,44.13900021144322,1.7328426495166918
2023-08-24,0,48.70099925994873,41.31575012207031,46.83074951171875,43.52531290054321,46.358375787734985,-0.33227346805826463,1.6352506481925349,-0.9262491916722224,2.995058785686783,44.76775074005127,1.3611652278900146,0.03661834185218339,42.44907512664795,46.713825130462645,0.7164831324831087,-0.0009376807116283879,1.0905666610894753,1.1080087103836491,1.0810312726978055,0.11714270807252869,57.13512133285458,47.927101390226625,44.656600093841554,41.386098797456484,45.42503547668457,2.076701595949648,44.38694633756365,2.030098120919186,45.102989689215924,44.91303246997056,10.121773023267364,4.6024190793883335,1156044000,1.1345780680307282,2.1732815913981933,-384890000.0,-31.170278846570206,44.757923903640624,51.57585752245338,157.79218231708825,38.75897571719255,18.65964844237368,-0.12771151351833332,1.9662370820559523,47.91661930847168,46.463189598083495,45.28849983215332,44.113810066223145,42.66038035583496,0.08,0.0,23.710718429501444,0.08810905285506099,0.08455595040514428,45.278302328927175,44.31630434308733,1.8027369861228817
2023-08-25,1,46.46475028991699,41.31575012207031,48.70099925994873,43.52531290054321,46.379000663757324,0.0723346785620708,1.8243232714998592,-0.5367656068098055,2.994902372525387,44.76775074005127,1.471950101852417,0.04074687742382266,42.44907512664795,46.784850692749025,0.6313592509721978,0.042702818756755315,1.0378059164016546,1.0423995278414813,1.008527998350183,0.08580260989373434,65.34238558839857,48.42074656245467,44.77210001945495,41.12345347645524,45.774035590035574,2.005630611904308,44.48030349186489,2.097214121163334,46.00196475466318,45.37686507850405,9.762334676051111,8.405117536299116,925341000,1.2500152711890675,1.647563457226586,-1310231000.0,-42.6720053279319,44.757923903640624,51.57585752245338,72.67908811808607,34.95584005873357,24.36168829648611,-0.14864527366410804,2.0244345793860803,47.91661930847168,46.463189598083495,45.28849983215332,44.113810066223145,42.66038035583496,0.08,0.0,23.80238408471625,0.06279588859818519,0.06169248283008784,45.63990838187082,44.35921995980399,1.7660744327588427
2023-08-28,1,46.29624938964844,41.31575012207031,48.70099925994873,43.52531290054321,46.37681317329407,0.07373475622207376,1.812227183303158,-0.4954944365053646,2.9949129074383687,44.76775074005127,1.4598626136779784,0.04048763797902612,42.44907512664795,46.784850692749025,0.6812090556798549,-0.0067336941413586905,1.0343216360204173,1.0267588729437012,0.9891050662335049,0.013335304960260919,54.27405002643956,48.38446689788683,44.760012531280516,41.1355581646742,46.16003540584019,1.7613252064868465,44.594053404671804,2.152718785481002,46.116172279011735,45.472789859119075,5.549531359841768,2.8942986673680338,685192000,1.3550648970074652,1.1745834118669451,-1995423000.0,-34.46509733323676,44.757923903640624,51.57585752245338,73.29125520908377,32.381799619205594,23.04647133650706,-0.08638785248079427,2.0292606132838658,47.91661930847168,46.463189598083495,45.28849983215332,44.113810066223145,42.66038035583496,0.08,0.0,23.869637984657203,-0.0028105121098679353,0.08166472433317329,46.13847351074219,44.51424489702497,1.7727322178752734
2023-08-29,0,47.73050022125244,41.31575012207031,48.70099925994873,43.52531290054321,46.309062242507935,0.07696538497284247,1.7881881823544394,-0.4091542880564183,2.994933658788336,44.76775074005127,1.43568754196167,0.03997216289894529,42.44907512664795,46.50922517776489,0.685062346171128,-0.003814020057910984,1.0669410238356452,1.0487782325863675,1.0170995891230423,0.019212818904564832,53.864577846514,48.31221382427309,44.73583745956421,41.15946109485533,46.86539268493652,1.021463332667214,44.90919630868094,2.2712996370785166,46.161280858833656,45.539699171585184,6.198062057602744,3.562338187633226,701397000,1.3538636443327605,1.1564172280194465,-1294026000.0,-14.886978793651156,44.757923903640624,51.57585752245338,147.90639798918005,36.612670005375726,20.913886831176796,-0.03998782559661164,2.076456458149751,47.91661930847168,46.463189598083495,45.28849983215332,44.113810066223145,42.66038035583496,0.08,0.0,23.943729454154106,0.06823164989264296,0.03868672803434864,46.92181069510324,44.959111894880024,1.9599089345332463
2023-08-30,0,49.16499900817871,41.31575012207031,48.70099925994873,43.52531290054321,46.309062242507935,0.1321579275151643,1.8684468167558748,-0.558473261463833,2.9948634974255794,44.76775074005127,1.498537540435791,0.04170762410184442,42.44907512664795,46.92072458267212,0.6936060596094571,0.0646584015851435,1.0974651669031639,1.0723787318747473,1.0436655985425245,0.06079072567870236,60.86013768845383,48.535581091550085,44.79868745803833,41.061793824526575,47.36224978310721,1.1854558567327214,45.38603551047189,2.4200585683212936,46.55388839204128,45.7061844795142,11.538104452087765,10.185026490806731,735206000,1.332728240227888,1.1920086137808497,-558820000.0,-10.065284791827777,44.757923903640624,51.57585752245338,163.48910034255343,37.65167777160692,19.811531796827293,-0.020267871495911773,2.0354237755224247,47.91661930847168,46.463189598083495,45.28849983215332,44.113810066223145,42.66038035583496,0.08,0.0,24.024487666262107,0.04558946071672443,0.0787421700635419,47.24985449654715,45.45010757446289,2.194642784326122
2023-08-31,0,49.35925006866455,41.31575012207031,49.16499900817871,43.52531290054321,46.37681317329407,0.23378844516627706,2.0969811817603308,-0.6820679183110641,2.994650293977351,44.81437540054321,1.7242349147796632,0.0465836917418393,42.44907512664795,47.82755012512207,0.6947426752979442,0.10961276042972097,1.096498199319476,1.0646718213215243,1.0354037621606356,0.013516166376839722,65.79336628668052,49.209312228480385,45.01534986495972,40.82138750143905,47.72346414838518,1.3677244122884946,45.9605712209429,2.3326250974661686,47.212147183878955,46.058253483944355,7.612668240169125,15.71161834182625,528570000,1.3520284000724536,0.8430159674946747,-30250000.0,-9.151175084101542,44.757923903640624,51.57585752245338,143.13924816839483,36.56551319271892,19.240014526819888,-0.021705302554016974,1.946179169991944,47.91661930847168,46.463189598083495,45.28849983215332,44.113810066223145,42.66038035583496,0.08,0.0,24.08256684705043,0.0464770578351732,0.04752086680676002,47.77641078404018,46.057068416050505,2.3920727851004573
2023-09-01,0,49.05324935913086,41.31575012207031,49.35925006866455,43.52531290054321,46.55625009536743,0.1891391702837894,2.2917291419232293,-0.8865315325264187,2.994453725517484,45.041375160217285,1.9170898818969726,0.050625921398019615,42.44907512664795,48.74739923477173,0.7501572560543829,0.0987033914102061,1.0836210531794186,1.0450758915180711,1.026150987308277,0.05570887722548634,65.91622346790557,49.851358178560815,45.267899894714354,40.68444161086789,48.109999656677246,1.2944243306861436,46.45812477384295,2.180912986065168,47.75123308987337,46.425869637881256,5.399231452217262,19.468362362607838,463830000,1.3493778184949505,0.7338420427271591,-494080000.0,-20.415990879477093,44.757923903640624,51.57585752245338,108.49515261003266,34.31664780990559,21.08360894213081,-0.02647534523419758,1.925595011138585,48.23498307800293,46.97850722503662,45.96299934387207,44.94749146270752,43.691015609741214,0.08,0.0,24.132238370084217,0.05413105365857218,0.02853938458697987,47.97535106113979,46.396681376865935,2.492780837366066
2023-09-05,0,48.370500564575195,41.31575012207031,49.35925006866455,43.52531290054321,47.05568718910217,0.09135410755588728,2.4331010819503023,-1.1178862830017218,2.994301932404861,45.4223747253418,2.0892123699188234,0.05350495600803977,42.44907512664795,49.06442432403564,0.7948518402612527,0.08626424519030963,1.0636884443452488,1.0169662750231607,1.0010275265356792,0.04480387077296477,63.98764944262212,50.340514517034755,45.47431235313415,40.60811018923355,48.06278555733817,1.2751589496312097,46.74391051701137,2.1480645743158435,48.069261254586365,46.63149454199141,5.837960000598367,16.550638084315437,382653000,1.3547430491718604,0.6025253906208482,-876733000.0,-19.962801599814895,44.757923903640624,51.57585752245338,85.58228916663732,33.009847111870826,21.364348330252493,-0.033622263782542565,1.8588383052822852,48.23498307800293,46.97850722503662,45.96299934387207,44.94749146270752,43.691015609741214,0.08,0.0,24.17240953790579,0.03657518755336553,0.054978502009829074,48.17314910888672,46.72572571890695,2.58586728672456
2023-09-06,0,47.65775108337402,41.31575012207031,49.35925006866455,43.52531290054321,47.89050030708313,-0.03232728452242831,2.5116849299494084,-1.2705145542482628,2.9942154182107066,45.99162435531616,2.202129917144775,0.05503862580841997,42.44907512664795,49.06442432403564,0.8245228815349863,0.0820233180473802,1.04432570242856,0.9963596709392313,0.9778817424510409,-0.0015241645811628901,60.72662479050394,50.65831973477674,45.63494987487793,40.611580014979126,48.23321424211775,1.092641808794563,47.00362491607666,2.0089220299678874,48.13671909537885,46.785525672012874,-0.6786281603986191,9.01745656342845,468670000,1.3615455888683803,0.7313560540011576,-1345403000.0,-37.24144075538639,44.757923903640624,51.57585752245338,49.973346896906385,30.522796514523595,24.652549982258677,-0.05272123471783978,1.8667068517137126,48.23498307800293,46.97850722503662,45.96299934387207,44.94749146270752,43.691015609741214,0.08,0.0,24.2193619478114,-0.03523949036833829,0.0049082438747775755,48.32265853881836,46.981283460344585,2.5945904367047894
2023-09-07,0,45.81550121307373,41.31575012207031,49.35925006866455,43.52531290054321,47.89050030708313,-0.17823816632707778,2.5392864200972607,-1.3041054066755047,2.9941877211633408,46.32187509536743,2.2367350673675537,0.05546394596479758,42.44907512664795,49.06442432403564,0.828988616540374,0.10017086376054954,1.0007175494345018,0.9561913302726077,0.9403616539693761,-0.06812768967101546,58.62241787362269,50.861222738723576,45.78264989852905,40.704077058334526,48.1645359311785,1.2398711769312023,47.16228566850935,1.7953007109717556,48.0107902301598,46.84742261907818,2.5675394487505003,8.259557215476987,433330000,1.328395189517172,0.6843846259602615,-1778733000.0,-46.76967443864414,44.757923903640624,51.57585752245338,0.8016568366185322,28.29680289828391,28.31001176819643,0.003396537970389013,1.86972781921477,48.23498307800293,46.97850722503662,45.96299934387207,44.94749146270752,43.691015609741214,0.02,1.0,24.259835904406163,-0.061285959005440316,-0.052049785499842544,48.23837007795061,47.188421794346404,2.484633300303016
2023-09-08,0,45.84774971008301,41.31575012207031,49.35925006866455,43.914874792099,47.89050030708313,-0.29445481746380675,2.475649429418105,-1.1278378905425646,2.9942691709401905,46.32187509536743,2.0993999767303464,0.05392690585300177,42.44907512664795,49.06442432403564,0.8004590917920925,0.07828453116103334,0.9986984638486449,0.9579279673062577,0.9541426970851152,-0.07114168780312968,50.3793753691174,50.85879883976273,45.90749998092652,40.956201122090306,47.89557157244001,1.5218629934597832,47.380482128688264,1.3550806321723716,47.46158065082877,46.666165372323285,-1.03841711350855,5.095283206982167,473069000,1.3887321816607445,0.7483072018966583,-1305664000.0,-77.66381931812587,44.757923903640624,51.57585752245338,-8.42358107427437,27.845327695968173,26.836077026972866,-0.002957113385050149,1.831532909590333,48.83961514282227,47.95719132995605,47.24399948120117,46.53080763244629,45.648383819580076,0.02,0.0,24.30365433402967,-0.0765726238039115,-0.0748668747263833,47.780186244419646,47.35099846976144,2.3437877678424943
2023-09-11,0,45.450249671936035,41.31575012207031,49.35925006866455,44.282562494277954,47.89050030708313,-0.4055371571888742,2.3487439665541516,-0.8282529229949063,2.994422780250003,46.32187509536743,1.9146825027465824,0.050976067366325636,42.72244930267334,49.06442432403564,0.7346392056037861,0.10969181425056017,0.9864314808616728,0.9553178455378899,0.9598998351889373,-0.0734507853050953,51.89877235948267,50.77291289038369,46.07542495727539,41.37793702416709,47.364893095833914,1.647888421026622,47.36357143947056,1.3791043769647904,47.05273765367926,46.51865079146771,-3.944543850246769,7.1384350122411195,473966000,1.3527401785727733,0.7532480989451227,-1779630000.0,-85.4551337290693,44.757923903640624,51.57585752245338,-42.6648159425492,25.836762444506412,28.637510106331643,0.023697774408032043,1.8329232678199299,48.860855178833006,47.99157138824463,47.28899955749512,46.586427726745605,45.71714393615723,0.04,0.0,24.346160811010243,-0.06859102407402828,-0.08455631423065778,47.197178431919646,47.2235164642334,2.0115226984114445
2023-09-12,0,44.952999114990234,42.08749961853027,49.35925006866455,45.18006229400635,47.89050030708313,-0.28427262877353265,2.0882241221024778,-0.8197114967306289,2.994709270627631,46.32187509536743,1.6872850275039675,0.04511942779334317,43.51412553787232,49.06442432403564,0.6921422037177936,0.07989902189212521,0.9712815670479487,0.946885262593859,0.9640701136218691,-0.07065259630758947,48.935128771237764,50.45859817897364,46.282149934768675,42.10570169056371,46.73542867388044,1.5999693809120707,47.22944641113281,1.5191136553674383,46.65051501227599,46.39517031807069,-7.555678655916822,-0.5181991651159135,349256000,1.35367844590489,0.5705137116143162,-2128886000.0,-90.62816943820657,44.757923903640624,51.57585752245338,-59.708523266327184,24.655119204787027,27.3277747905302,-0.04209278126828122,1.7835717562408555,48.860855178833006,47.99157138824463,47.28899955749512,46.586427726745605,45.71714393615723,0.04,0.0,24.377083954557015,-0.0756839829854502,-0.07494089693183217,46.55718394688198,47.16679736546108,1.951413363444205
2023-09-13,0,45.129499435424805,42.792999267578125,49.35925006866455,45.325937032699585,47.89050030708313,-0.08137861189358016,1.8838072611151258,-0.9346217269919053,2.994907647080855,46.32187509536743,1.5503925180435183,0.040577060194572905,43.978999614715576,49.06442432403564,0.74042670242115,0.013150902143723671,0.9720858672442839,0.953300322695003,0.9822537080771747,-0.05305016687686781,43.22159707470628,50.19303943182192,46.425424909591676,42.65781038736143,46.174892970493865,1.3144533835839212,47.14244631358555,1.6059065227391407,46.22782555884427,46.23898306433412,-8.926900120128852,-4.009652666905607,398355000,1.2656064908022,0.6658445744210079,-1730531000.0,-80.29894829911488,44.757923903640624,51.57585752245338,-50.888641683358486,24.269845617632736,25.743404777061336,0.009302970041874041,1.7581024845897228,48.860855178833006,47.99157138824463,47.28899955749512,46.586427726745605,45.71714393615723,0.04,0.0,24.412720656227307,-0.033488423906341436,-0.06301495320432882,46.12584849766323,47.05059977940151,1.879703670371841
2023-09-14,0,45.66225051879883,42.792999267578125,49.35925006866455,45.37006211280823,47.89050030708313,-0.09617736402606146,1.8493013850531517,-0.8350517487947151,2.994938735715155,46.32187509536743,1.51619255065918,0.03980122838757357,43.978999614715576,49.06442432403564,0.7214645227908527,0.025163696391801153,0.9827568812084553,0.9698827711140617,1.0049087723933556,-0.0033449529136914125,44.79993423407592,50.16202764345836,46.463424873352054,42.76482210324575,45.78800010681152,0.8907892704417956,46.92539283207485,1.5842612009697061,45.94481253325836,46.10410447590834,-7.998960262508443,-2.627976362499076,370097000,1.2627662332212974,0.6268553548760926,-1360434000.0,-77.39979537181593,44.757923903640624,51.57585752245338,-45.02106114644817,23.634071836451916,24.814046223061272,0.05007475372814138,1.6936665208990225,48.60185864257812,47.782068954467775,47.11949920654297,46.45692945861816,45.637139770507815,0.04,0.0,24.44613201403308,-0.01427284211707569,-0.031448466821570764,45.70265524727957,46.93790217808315,1.7610619088726849
2023-09-15,0,44.66199970245361,42.792999267578125,49.35925006866455,45.60925030708313,47.89050030708313,-0.12199828689427154,1.774032860113476,-0.6111934662692851,2.9950043828167963,46.32187509536743,1.4504399681091313,0.03811399101291886,44.81712427139282,49.06442432403564,0.6826356912058433,0.0474374443320375,0.9595352451190884,0.9557478109673544,0.9835592637755326,-0.025862774402832245,48.81695616391106,50.09351564469595,46.545449924469,42.997384204242046,45.360035623822895,0.456593574083313,46.79662493297032,1.6940417461364072,45.876288122648326,46.10361298272337,-5.598970476149654,-6.239602446204717,506831000,1.2615270697732217,0.8545105254909868,-1867265000.0,-98.49643934543555,44.757923903640624,51.57585752245338,-103.99772218748558,21.85620520390547,28.504224558372385,0.024987880273431996,1.700618938421302,48.482914260864256,47.589540336608884,46.86749839782715,46.14545645904541,45.25208253479004,0.06,0.0,24.48927612121941,-0.03668922084070991,-0.05062599171395401,45.25118146623884,46.786920002528596,1.7113111960841654
2023-09-18,0,43.23900032043457,42.792999267578125,49.35925006866455,45.60925030708313,47.89050030708313,-0.03924686036863641,1.698891625867341,-0.5404614046855625,2.9950670029099227,46.32187509536743,1.4077300071716308,0.03645781142933453,44.92389917373657,49.06442432403564,0.5750785562487969,0.04367537837647024,0.9278986935205679,0.9346916713024114,0.9572207329947171,-0.048652083706084315,44.29646583456117,49.99662062737555,46.59883737564087,43.20105412390619,44.99196406773159,0.8750115536159789,46.578249999455046,1.9423577529666165,45.57878472435682,46.045760242955495,-6.285968835750443,-3.8798241165939977,500271000,1.2698382212171244,0.8494293653360772,-2367536000.0,-75.19868720870629,44.757923903640624,51.57585752245338,-158.32351929618062,19.84382201695566,33.30476472958825,0.022037886895552018,1.739289055665065,48.05622657775879,46.89888484954834,45.96349906921387,45.028113288879396,43.87077156066894,0.08,0.0,24.529483533319105,-0.026827251251037354,-0.035241026018862295,44.92625209263393,46.58231108529227,1.6492839465574087
2023-09-19,0,43.58024978637695,43.23900032043457,49.35925006866455,45.60925030708313,47.89050030708313,0.10777749699251092,1.6510422558893039,-0.803854862583921,2.995105705350459,46.32187509536743,1.3898899650573724,0.035414027777187274,44.92389917373657,49.06442432403564,0.6626641368827579,-0.05358196066566706,0.9347744862170198,0.9540595935527187,0.9743142886304019,-0.030537435891691556,32.62561884898387,49.9232219400623,46.62113742828369,43.31905291650508,44.66803550720215,0.9237542488858332,46.28180353982108,2.065761081251892,45.001268495670104,45.83825871177746,-5.623644453122211,-6.603664680226665,373064000,1.1275364256851346,0.6511010402652616,-1994472000.0,-80.82501810622156,44.757923903640624,51.57585752245338,-137.38014752633913,19.03238386741021,31.94289217095856,-0.031186199880358704,1.6839113161107249,48.05622657775879,46.89888484954834,45.96349906921387,45.028113288879396,43.87077156066894,0.08,0.0,24.5595037872159,-0.030086865911288507,-0.03669924054344672,44.63317271641323,46.20667948041643,1.783751271845489
2023-09-20,0,42.991249084472656,43.23900032043457,49.35925006866455,45.37006211280823,47.89050030708313,0.020062213800331883,1.7701874841631036,-0.9230093171423417,2.995007977706247,46.32187509536743,1.474159946441651,0.03805561736026836,44.553824710845944,49.06442432403564,0.7447333761737339,-0.06940951744811183,0.9242289529417629,0.9511396149312709,0.9670821271638438,-0.04738032501361422,33.129776016226,50.05617491987955,46.51579995155335,42.97542498322714,44.31674970899309,1.0372940115017055,45.8408214024135,2.061892596999072,44.644159694967584,45.63908375256451,-4.945716939314424,-8.695174816180852,367108000,1.0935944914913995,0.6631707796449485,-2361580000.0,-96.93591748124318,44.757923903640624,51.57585752245338,-146.99853641460373,17.675860270993137,32.971105702683055,-0.012601180598239007,1.6836319581868004,47.959199417114256,46.820399528503415,45.89999961853027,44.97959970855713,43.84079981994629,0.08,0.0,24.587851639949655,-0.07136419542130323,-0.058635956975297894,44.21340724400112,45.70529283796038,2.0109716116509406
2023-09-21,1,41.41999912261963,42.991249084472656,49.35925006866455,45.08537435531616,47.89050030708313,0.009218986378429992,1.9268815738701182,-1.0168843216604886,2.994866777047373,46.07199954986572,1.5935076284408567,0.041595908299322984,43.54612483978271,49.06442432403564,0.7677058985509286,-0.072414944896772,0.8941403086864834,0.9259367762250995,0.9407873866610169,-0.09290500025689041,31.2037825691202,50.177588077931276,46.32382493019104,42.4700617824508,43.81203542436872,1.4525304521810587,45.27373204912458,2.1109654868313097,44.22765269162985,45.36540150621922,-5.410312606009131,-12.557205427135344,450736000,1.095436691462859,0.8391261051629407,-2812316000.0,-99.5805130378745,44.757923903640624,51.57585752245338,-173.73478066144435,16.714411983691594,36.54790737879338,-0.1185714324192829,1.653301023377001,47.71847930908203,46.4307593536377,45.38999938964844,44.34923942565918,43.06151947021485,0.1,0.0,24.619825622311023,-0.10012953915451739,-0.09823023741061387,43.6630984715053,45.110141209193635,2.3137133525471105
2023-09-22,1,41.63199996948242,41.41999912261963,49.35925006866455,44.88024926185608,47.89050030708313,-0.20823135709035231,2.20329736257932,-0.7813473550202077,2.994584244656805,45.83162546157837,1.8101200628280636,0.047817259200115834,43.21422519683838,49.06442432403564,0.748186991457768,-0.14950412205026214,0.9035222241765326,0.9399116530350141,0.9641835717313372,-0.06784290343373789,20.7948069389803,50.48404457142634,46.0774498462677,41.67085512110906,43.31239264351981,1.5236147310498247,44.743642807006836,2.018640359336349,43.527024310915394,44.9211291042204,-7.8593198717023425,-16.084626356762886,479236000,0.9605982061344451,0.9521707245788819,-2333080000.0,-91.99592310704607,44.757923903640624,51.57585752245338,-144.4305008207,15.968441345447042,34.77154183088586,-0.018780624699926023,1.613636906525156,46.993445220947265,45.844278900146485,44.91550064086914,43.9867223815918,42.837556060791016,0.1,0.0,24.654266924643036,-0.05216405019284043,-0.08711979002519213,43.109646388462615,44.61774744306292,2.487659075551524
2023-09-25,1,41.88149929046631,41.41999912261963,49.35925006866455,44.39156222343445,47.67593836784363,-0.1429544133910127,2.318090387490674,-0.8222414449881406,2.99444283581423,45.73887586593628,1.85205020904541,0.050697454148498224,42.85532417297363,49.06442432403564,0.8480532565402663,-0.10400895927085814,0.9159631571775019,0.9546304552890363,0.9837688561446132,-0.031395291748378185,24.51466503620245,50.36018065672573,45.72399988174438,41.087819106763035,42.772285325186594,1.1840624588406363,44.280142715999055,1.8606022874944144,43.050599350522305,44.474233147804604,-7.74991858916341,-15.128965943347916,419091000,0.8625935387377607,0.8767660174846506,-1913989000.0,-83.59095600775741,44.757923903640624,51.57585752245338,-116.107502924661,16.88169237891265,32.65594497798795,0.031405811196493834,1.5954486388924995,46.762715728759765,45.65764169311524,44.76449966430664,43.87135763549804,42.766283599853516,0.1,0.0,24.684847867554552,-0.03966693517494968,-0.038223216904774836,42.62989262172154,44.16627393450056,2.6023709174736163
2023-09-26,1,42.0967493057251,41.41999912261963,49.35925006866455,43.49493741989136,47.67593836784363,-0.032324647545293156,2.4559789395686953,-1.036848795034307,2.994272908954124,45.55625009536743,2.0009627819061278,0.053983684382876866,41.85654935836792,49.06442432403564,0.8793946516026112,-0.09535869875820309,0.925308271765736,0.96740611522011,0.995171505458243,-0.03404066034324549,27.255749633851593,50.40679521090924,45.49483733177185,40.58287945263446,42.405820982796804,0.852181428731815,43.882928303309846,1.6676558809524031,42.76477888250246,44.20185209558004,-8.279817979571574,-13.415203891566085,402282000,0.8698029759684568,0.8672657528529103,-1511707000.0,-83.45183350939978,44.757923903640624,51.57585752245338,-98.76091373493759,17.280346587023022,30.919229217727796,-0.055562644508074355,1.5647023729378453,45.27826312255859,44.45686720275879,43.792999267578125,43.12913133239746,42.30773541259766,0.1,0.0,24.714355176827386,-0.03697149017291901,-0.046740575003458476,42.345811571393696,43.798496518816265,2.6992916579056665
2023-09-27,1,42.324750900268555,41.41999912261963,49.35925006866455,43.17706251144409,47.67593836784363,0.09929657324896254,2.5559695022692286,-1.1786753380209598,2.9941408640609883,45.28987455368042,2.1263378143310545,0.05644202876846997,41.85654935836792,49.06442432403564,0.8869779044211993,-0.11803251357962649,0.9346335336984208,0.9790721658358873,1.007629017758645,-0.015503112805457464,25.75823182024357,50.396801332114144,45.28486232757568,40.17292332303722,42.27521392277309,0.7692264778735797,43.63358899525234,1.6166605486613848,42.610499441230544,44.02964184752339,-5.743698029238909,-11.668619796851782,444935000,0.785364586541489,0.9864912983190837,-1066772000.0,-73.55138450606242,44.757923903640624,51.57585752245338,-83.35722331840682,16.52612228612325,29.138633877698368,-0.10046656213668602,1.5417236341935403,45.27826312255859,44.45686720275879,43.792999267578125,43.12913133239746,42.30773541259766,0.1,0.0,24.747237932770126,0.005421443449720842,-0.024172823642788308,42.13185828072684,43.52905518668039,2.631878107190231
2023-09-28,1,42.77750015258789,41.41999912261963,49.35925006866455,42.82462453842163,46.30025005340576,0.29497943486373557,2.568848093987156,-1.110244767799983,2.994111448583059,45.04124927520752,2.136525201797485,0.05706702999838225,41.85654935836792,49.06442432403564,0.8642024854349324,-0.13912840935422913,0.9503033247382593,0.9960074798450943,1.0216498397694578,0.03277404777217696,24.235774873309207,50.152271049500804,45.01457486152649,39.87687867355218,42.16053540366037,0.5784131968467474,43.414285455431255,1.4970162920884686,42.54643257419004,43.84609116637484,-2.1144092448731873,-7.619146839779784,424663000,0.685229658189357,0.9751145032734164,-642109000.0,-59.30924742325707,44.757923903640624,51.57585752245338,-58.808158545804325,18.182551073712524,27.324068140154406,-0.09133820805649828,1.5266717651112172,44.93981051635742,44.18309271240234,43.57149887084961,42.95990502929688,42.2031872253418,0.1,0.0,24.77950507828107,0.050515589354743984,0.020123485372888304,42.0702999659947,43.35173634120396,2.4526259531803003
2023-09-29,1,43.69425010681152,41.41999912261963,49.35925006866455,42.66431283950806,45.82356333732605,0.4578447568103694,2.426088273068182,-0.8799324367531582,2.994269790869005,44.807499408721924,2.0347001552581787,0.05428073434012281,41.85654935836792,48.43877544403076,0.842921260221708,-0.1333437989215936,0.9776049818827282,1.0242320260909716,1.0368215028988486,0.04953521663241722,29.378056074043855,49.547376464883314,44.69519991874695,39.84302337261059,42.26096412113735,0.7744853170368129,43.28885691506522,1.3824929705459241,42.60611553961193,43.702662504307725,-1.8420032875534353,-6.6966199582526,397830000,0.6985364758457872,0.9274212395385949,-244279000.0,-49.69041297317065,44.757923903640624,51.57585752245338,-26.81858375955011,20.604244462305484,25.944904992319742,-0.11845392595644015,1.4929809465444004,44.8053475189209,44.074325523376466,43.48349952697754,42.89267353057861,42.16165153503418,0.1,0.0,24.810905095763115,0.04539778064994149,0.06051147029570528,42.250260489327566,43.23183386666434,2.1935756652305893
2023-10-02,1,44.46199989318848,41.41999912261963,49.05324935913086,42.66431283950806,45.700563192367554,0.5272220978316428,2.183598081963076,-0.6355757400011806,2.994532911788096,44.17812490463257,1.8482251167297363,0.04916690408469474,41.85654935836792,47.72902603149414,0.8198725677058646,-0.10924860885534389,1.0011269483241245,1.044598425020568,1.044813821757628,0.0616143320186624,39.86072071647309,48.77914608458045,44.411949920654294,40.04475375672814,42.69553565979004,1.0339515159088801,43.25378554207938,1.342683986694065,42.87751982947112,43.711013258784455,1.6352188813066453,-3.8635641779736605,433298000,0.7534606290195326,1.0137118436504275,189019000.0,-24.06626769925832,44.757923903640624,51.57585752245338,18.21159574433312,23.856221985806155,23.88257915619396,-0.06827266487561165,1.506053642344382,44.8053475189209,44.074325523376466,43.48349952697754,42.89267353057861,42.16165153503418,0.02,1.0,24.846715314374702,0.060631892211013616,0.07623173561464021,42.78800092424665,43.22554969787598,1.9663842334297583
2023-10-03,1,44.175249099731445,41.41999912261963,48.370500564575195,42.66431283950806,45.50324988365173,0.43341873167077066,1.9074705451235476,-0.5705742277466581,2.994805463781944,44.078125,1.6186626434326172,0.04317264537585882,41.85654935836792,46.028749847412115,0.7935955280057962,-0.08080339516372843,0.999838434542854,1.034887866622922,1.025636686966688,0.049374353798944615,47.95027907808034,47.997328537604275,44.18238744735718,40.36744635711008,43.05885696411133,1.044729752302051,43.18562480381557,1.2619323953805954,43.26986117193164,43.79227723244918,7.3442801424580395,-1.0922501979139962,470850000,0.7819391903505507,1.090316961867736,-281831000.0,-49.330961369237855,44.757923903640624,51.57585752245338,0.9008483544270552,21.762115176652433,24.651602836854845,-0.12361988041154147,1.5330500025731317,44.8053475189209,44.074325523376466,43.48349952697754,42.89267353057861,42.16165153503418,0.02,0.0,24.884223505614116,0.038319209885642636,0.030671138204292254,43.06037030901228,43.085008348737446,1.6730404572594115
2023-10-04,1,43.804500579833984,41.41999912261963,47.65775108337402,42.66431283950806,45.20968699455261,0.235348284363804,1.6484633805609392,-0.7055047761026052,2.9950312791238702,43.934749603271484,1.4089000701904297,0.03748840068747697,41.85654935836792,45.81872606277466,0.7643308147060617,-0.07307314979152447,0.9961766145468388,1.0247739592604301,1.0073068359694257,0.03496180480901634,47.077688188764675,47.26955163523688,43.97262487411499,40.6756981129931,43.333571434020996,0.9300805128413582,43.05292837960379,1.0635560574965508,43.49006138349033,43.808642865647386,6.108880505652637,-2.114471349408126,361821000,0.773137040837078,0.8483405038329612,-643652000.0,-33.73021935957015,44.757923903640624,51.57585752245338,3.2324746221836853,20.870920902626946,23.642079308676607,-0.0648201075203195,1.4843322694966186,44.50891514587402,43.83454122161865,43.289499282836914,42.74445734405518,42.07008341979981,0.02,0.0,24.91273728031347,0.03703964918875613,0.05082192511626103,43.32017081124442,42.97503171648298,1.4987110979499583
2023-10-05,1,44.381500244140625,41.41999912261963,45.84774971008301,42.66431283950806,44.99712419509888,-0.10003061308650121,1.4151742643401914,-1.2406195070345074,2.995209106294248,43.749375343322754,1.2162375450134277,0.032324702635897096,41.85654935836792,45.67757558822632,0.8391813986090019,-0.0438934548350176,1.0137400276959634,1.0363008348221274,1.013676641188622,0.03749634938533686,47.74282041755389,46.61031087761836,43.779962348937985,40.94961382025761,43.659964425223215,0.8178220755252151,43.03289270401001,1.0331185804960072,43.56519158958622,43.76313238632102,4.591529247868683,-4.068458995905209,393483000,0.6698823300555602,0.9269064415360598,-250169000.0,-11.609047607789076,44.757923903640624,51.57585752245338,46.98322214100315,23.558420503041177,22.463950928095837,-0.08041467589261636,1.4505943243609782,44.18497930908203,43.5725093536377,43.07749938964844,42.582489425659176,41.970019470214844,0.02,0.0,24.9447385652522,0.037109300286051417,0.0522747063066312,43.71679905482701,43.03130531311035,1.3990183230058177
2023-10-06,0,44.942501068115234,41.41999912261963,45.84774971008301,42.66431283950806,44.73474955558777,-0.12538687730460296,1.3448043612739509,-1.1466949734107064,2.9952581988931772,43.749375343322754,1.1445374965667725,0.030767737962871005,41.85654935836792,45.47144975662231,0.8050662574565389,-0.03198083821374378,1.0282381111181815,1.0421932870121062,1.0190234580852835,0.028567854082684363,52.85232759458195,46.39787102303923,43.708262300491334,41.01865357794344,44.0339287349156,0.6947610658793819,43.15457132884434,1.1526620074382166,43.77312187901278,43.827960809949275,5.427380916808236,-0.6280494831886768,434436000,0.6866275197844237,1.0280551312773698,184267000.0,-0.5614559461738419,44.757923903640624,51.57585752245338,92.72953276743482,25.85545337313215,20.543361172866405,-0.00022067809643802229,1.4729090503552833,44.6540770111084,43.951962730407715,43.38450050354004,42.81703827667236,42.11492399597168,0.04,0.0,24.981210715163627,0.052024169406890586,0.06203440481031202,44.1872683933803,43.15956333705357,1.4132672886102464
2023-10-09,0,45.02199935913086,41.41999912261963,45.66225051879883,42.66431283950806,44.73212504386902,-0.22380186013568515,1.2859809603284187,-1.1631958267921993,2.9952974819213503,43.749375343322754,1.1024000883102416,0.029452418849015522,41.85654935836792,45.16157445907593,0.7874683641484503,-0.011171525073806537,1.0311247393636294,1.0360829265104519,1.0150800829131574,0.012595012983844134,58.23508640308285,46.23496178904978,43.662999868392944,41.09103794773611,44.35457147870745,0.5122086202407528,43.25755344118391,1.253603943918833,44.06615563717796,43.93200503006529,6.184915710466874,3.9397320360239614,409675000,0.6963811875543232,0.9768915402992947,593942000.0,-10.72993239207362,44.757923903640624,51.57585752245338,86.98021090084745,24.10086052844594,19.149255488486006,0.026036088418154194,1.4672727615499115,44.6540770111084,43.951962730407715,43.38450050354004,42.81703827667236,42.11492399597168,0.04,0.0,25.015296835264625,0.010964160034953263,0.040782497091362786,44.49920054844448,43.284750257219585,1.4187586955793314
2023-10-10,0,45.61375045776367,41.41999912261963,45.66225051879883,42.66431283950806,44.73212504386902,-0.2673857318402113,1.2593329274974159,-1.157670157081075,2.9953147534212543,43.749375343322754,1.0831288242340087,0.02885625853428046,41.85654935836792,45.03274936676026,0.8011885552403747,0.0015349419504607838,1.045189994788001,1.0421688486321838,1.0258314744414472,0.032563514351319656,60.159135049021664,46.160253207747516,43.64158735275269,41.12292149775786,44.62878581455776,0.6051582295988561,43.444874967847554,1.398331215202572,44.30672994264901,44.008368808164455,5.24691531421147,3.308263674075114,368582000,0.687725793215298,0.8768826180816031,962524000.0,-8.7326878913877,44.757923903640624,51.57585752245338,119.75247625021746,25.937209476805407,18.041666918548266,0.052179255570745195,1.4461102514126967,45.013155029296875,44.24242112731933,43.61949920654297,42.996577285766605,42.22584338378906,0.06,0.0,25.046829535957084,0.05241641016918086,0.022687727287521473,44.82755824497768,43.53890936715262,1.474073412782347
2023-10-11,0,46.477749824523926,41.41999912261963,45.66225051879883,42.66431283950806,44.73212504386902,-0.19565922790787604,1.3012721723637792,-1.1557197963030645,2.995287427035835,43.749375343322754,1.1128626346588135,0.029794695999120584,41.85654935836792,45.17792453765869,0.7758456745898388,0.010730254675919362,1.0641820029313154,1.0534442501647256,1.038542784862936,0.061026817091954344,64.08325824694349,46.27716926461891,43.67462491989136,41.0720805751638,44.91675009046282,0.9135722279699393,43.80614287512643,1.4855793258054055,44.6386991580329,44.14127509003042,4.393027334855018,6.100081828602176,378137000,0.6993716763283777,0.9017834295562853,1340661000.0,-0.9327943616092078,44.757923903640624,51.57585752245338,157.85911118479922,27.572663571329528,17.07782980514708,0.07361126377357387,1.4186024351671191,45.51804844665527,44.6884760055542,44.01799964904785,43.3475232925415,42.51795085144043,0.08,0.0,25.080416734038746,0.06278232966826569,0.07557961271327358,45.116637638636995,43.952319281441824,1.582923978674325
2023-10-12,0,46.91525077819824,41.41999912261963,46.477749824523926,42.66431283950806,44.73212504386902,0.04187214673333245,1.4056341229282312,-0.9338526350961929,2.995216005075363,43.749375343322754,1.178312635421753,0.03213462849958269,41.85654935836792,45.61860046386719,0.7350494656962685,0.017859376103010128,1.0725437936733508,1.053444377477892,1.0359426018351172,0.057090240756161315,68.54547516275423,46.55330568520278,43.74203743934631,40.930769193489844,45.30817890167236,1.1090048823319496,44.183517932891846,1.5599848281323099,45.099539598663924,44.371858719902704,4.533646566006716,12.210890412941218,481325000,0.7157368406739901,1.132842076177731,1821986000.0,-10.323401009779309,44.757923903640624,51.57585752245338,166.0499829951997,29.58751689230921,15.970242966098636,0.06823873123491357,1.408630784698988,46.09104844665527,45.1519760055542,44.39299964904785,43.63402329254151,42.69495085144043,0.1,0.0,25.123790480220332,0.05050567146083362,0.065938556712499,45.606245858328684,44.33330808367048,1.6901083346404293
2023-10-13,0,46.20424938201904,41.41999912261963,46.91525077819824,42.66431283950806,44.73212504386902,0.2679174230645724,1.513600176593358,-0.6815188364187401,2.995136876020899,43.749375343322754,1.240981335639954,0.03455338377293507,41.85654935836792,45.700150394439696,0.788630250290709,0.050451190962254235,1.0547786565607804,1.0279289356392844,1.0089530690383335,0.02807472401216593,73.92440336350735,46.83188780550301,43.80468745231629,40.777487099129566,45.65100015912737,0.9218242676397486,44.49228579657419,1.4957767233744508,45.54913444918032,44.61978047179434,6.202572106115083,12.690360330007232,474115000,0.6763678074530285,1.120185404783827,1347871000.0,-35.91977907925449,44.757923903640624,51.57585752245338,101.8531612456587,26.891358244744147,19.72635477661647,0.07725912695195668,1.4391573250671688,46.197721267700196,45.324641334533695,44.619001388549805,43.913361442565915,43.04028150939941,0.1,0.0,25.164380418875357,-0.00657757438093598,0.017297592670859056,45.80905859810965,44.564614704677034,1.7280120979362463
2023-10-16,0,45.57374954223633,41.41999912261963,46.91525077819824,42.66431283950806,44.96237564086914,0.24788037759117507,1.5925403660222588,-0.9167210108051576,2.9950754107892674,43.749375343322754,1.3258050680160522,0.036291591692552055,41.85654935836792,46.23159942626953,0.8694222602405254,0.06857811326833818,1.0385569782551778,1.0082715820122028,0.9897310459730312,0.01225512396071693,69.16254562442457,47.06688066833908,43.881799936294556,40.69671920425003,45.82132148742676,0.7404764256882568,44.74064295632498,1.34887288935996,45.70821921414666,44.74748801728966,5.47831563063138,10.321383342971066,375099000,0.6059804877597723,0.8995432245940713,972772000.0,-25.317726669902996,44.757923903640624,51.57585752245338,81.29503375651547,25.127884729653747,20.270719983797974,0.06927265600235173,1.430146067943928,46.197721267700196,45.324641334533695,44.619001388549805,43.913361442565915,43.04028150939941,0.1,0.0,25.196060770259102,0.018156634334754562,0.0072768621946097895,46.010015215192524,44.863407135009766,1.794566178896917
2023-10-17,0,43.79300022125244,41.41999912261963,46.91525077819824,42.66431283950806,45.15993690490723,0.07641652450333218,1.6263555234736926,-1.0801861327008806,2.995049456110796,43.989874839782715,1.3782625675201416,0.03696385424780884,41.85654935836792,46.23159942626953,0.9019185399960307,0.04574319251567339,0.9953285452587699,0.966497138971791,0.9487845324300653,-0.0399166965715122,61.170634119279,47.25124844433203,43.998537397384645,40.74582635043726,45.657107080732075,1.0362455670877317,44.84551790782383,1.1948757477066074,45.671980430600115,44.80132429586895,2.68636547105707,8.259545674797183,812333000,0.6287718710840255,1.8506202560987626,160439000.0,-66.81837970475324,44.757923903640624,51.57585752245338,-14.522056638376354,21.037383886392,27.922451184049685,0.08875596273318702,1.5862071829812758,46.31241728210449,45.51029335784912,44.86200141906738,44.213709480285644,43.411585556030275,0.02,1.0,25.257624160160493,-0.040613203275462806,-0.029487748905015983,45.7495002746582,44.968384334019255,1.7906578421109272
2023-10-18,0,42.45775032043457,41.41999912261963,46.91525077819824,42.66431283950806,45.15993690490723,0.05781504208908913,1.624279280827972,-1.0723302153843468,2.9950513702436243,43.989874839782715,1.3676250457763672,0.03690774216541799,41.85654935836792,46.23159942626953,0.8898152952303512,0.018649170560372418,0.964747700870449,0.9378197667977232,0.9271708733058763,-0.08649298899509561,46.87326080162752,47.25773348078436,44.00917491912842,40.76061635747248,45.290785789489746,1.5987501417542607,44.8226786340986,1.2396618162727966,45.196527693763855,44.60500966653392,-2.557714456346343,3.469008770881084,627294000,0.7437883753894347,1.3879381862662723,-466855000.0,-93.58578220744592,44.757923903640624,51.57585752245338,-74.93660188148029,19.082049501791104,28.208360197531523,0.09358204511904579,1.623835167225638,46.24397706604004,45.39951300811767,44.71700096130371,44.03448891448975,43.19002485656738,0.04,0.0,25.30153059938937,-0.09849160149924407,-0.07864981508476125,45.31002426147461,44.90461240495954,1.7929804408945398
2023-10-19,0,42.52275085449219,41.41999912261963,46.91525077819824,42.424500465393066,45.15993690490723,0.07421119430241505,1.64502549944601,-1.1322890374725203,2.99503316955,43.989874839782715,1.3942999839782715,0.03740181890887042,41.85654935836792,46.23159942626953,0.8267773729489662,0.025054351033248122,0.966810683179279,0.9420578987320279,0.945185264073293,-0.09362626972778054,40.89303437885646,47.27255097981854,43.98249998092651,40.692448982034485,44.84921441759382,1.8942380343039855,44.739000116075786,1.35579060024693,44.50511004570484,44.26496043337232,-5.695546788675072,-0.7474719911466742,501233000,0.718273481625156,1.102857096336762,34378000.0,-95.22819921107528,44.757923903640624,51.57585752245338,-79.46824160536302,18.229604352530288,26.436324371756072,0.10129963657230309,1.608918434961474,46.24397706604004,45.39951300811767,44.71700096130371,44.03448891448975,43.19002485656738,0.04,0.0,25.33647961026623,-0.10318449439517285,-0.10052115188988175,44.781996045793804,44.80477714538574,1.7108190563282815
2023-10-20,0,41.70625019073486,41.63199996948242,46.91525077819824,42.50650072097778,45.15993690490723,0.15492921703899673,1.5752115996072842,-1.1208423773139096,2.9950934665728033,43.989874839782715,1.3391623973846436,0.03576966628130565,42.07522430419922,46.23159942626953,0.8196468088784102,0.021395822580291945,0.9470592087686196,0.9277895284048487,0.9454991267377629,-0.09735033576878394,41.00505278085819,47.188060766734715,44.03763756752014,40.88721436830557,44.167571612766814,2.0616524339190536,44.54216085161482,1.5805205864388088,44.00677183169273,44.01439554933802,-6.776464492069369,-2.6811290946877016,477266000,0.7173276558806753,1.0503504278507723,-442888000.0,-95.26869046290936,44.757923903640624,51.57585752245338,-117.35614071419566,17.092088040277112,28.390815141235777,0.07963652410957858,1.5934244114437182,46.06768467712402,45.114158378601076,44.3435001373291,43.57284189605713,42.61931559753418,0.06,0.0,25.368109169469754,-0.08961520106771925,-0.11839384639392442,44.008021763392854,44.562329701014924,1.7285970821650247
2023-10-23,1,42.099249839782715,41.70625019073486,46.91525077819824,42.50650072097778,45.15993690490723,0.1656549515667685,1.5696150939564772,-1.1280141426351271,2.9950981842262387,43.989874839782715,1.3354498863220214,0.03563957715092341,42.07522430419922,46.23159942626953,0.7915683621783381,-0.00418440367943891,0.9559027996340991,0.9433233976824189,0.9742783528098679,-0.07623905729401426,35.85064864240789,47.18058026649572,44.04135007858277,40.902119890669816,43.47957147870745,1.7756346010605357,44.39387519018991,1.709699439818876,43.43148445588747,43.690890815753754,-10.266201896184283,-6.197988639903242,478530000,0.7405967433892725,1.0462888754761437,35642000.0,-69.53784013994853,44.757923903640624,51.57585752245338,-83.36337512398201,18.76198501985,25.550192403903754,0.09438605753917184,1.6441084823269236,46.036296813964846,45.06335260009766,44.277000427246094,43.49064825439453,42.51770404052734,0.08,0.0,25.40114417025031,-0.06768630865215663,-0.0546841047838048,43.4410024370466,44.52362414768764,1.6934218322522363
2023-10-24,1,43.281999588012695,41.70625019073486,46.91525077819824,42.50650072097778,45.15993690490723,0.18582986505862636,1.5552854723338345,-1.1279571971304299,2.995110158009276,43.989874839782715,1.3245623588562012,0.03530548178375135,42.09899978637695,46.23159942626953,0.8122192051264397,5.939969472362842e-05,0.9825153485976356,0.976218724472298,1.0180215190007267,-0.011668545901355243,38.96049877594363,47.16280855071625,44.052237606048585,40.94166666138092,43.06210722242083,1.3110110320639388,44.3565536907741,1.7291470256401975,43.10052365299198,43.495341183640726,-10.265320676178817,-4.699462486927666,401463000,0.744485673755003,0.877863213026198,437105000.0,-59.21371687900131,44.757923903640624,51.57585752245338,-40.76064157909005,19.924895846455637,24.40166289295889,0.15997363472010517,1.598529069596541,46.036296813964846,45.06335260009766,44.277000427246094,43.49064825439453,42.51770404052734,0.08,0.0,25.430322347165664,-0.006258822826527899,-0.05276069089845655,43.18420137677874,44.496629987444194,1.6158023180477195
2023-10-25,1,42.595499992370605,41.70625019073486,46.91525077819824,42.713812828063965,45.15993690490723,0.19186894135394278,1.5012885999899594,-1.0238556406105508,2.995154160273581,43.989874839782715,1.2652998447418213,0.03403395023747411,42.30220079421997,46.23159942626953,0.8252073801687742,0.02261675892670326,0.9656325419978313,0.9658142706210365,1.0042887147754167,0.003244394036340026,47.95727383618085,47.11407732014288,44.111500120162965,41.10892292018305,42.63664300101144,0.7017521043443858,44.2289822442191,1.7919089055253627,43.14742286085926,43.51103457185324,-6.32463427734761,-1.1928020749124342,398379000,0.7890568782378115,0.8755763305879286,38726000.0,-87.48500224393906,44.757923903640624,51.57585752245338,-93.19041590962932,18.089871756282708,27.11745834056867,0.10926396692848872,1.6349196999315818,46.036296813964846,45.06335260009766,44.277000427246094,43.49064825439453,42.51770404052734,0.08,0.0,25.457536277646074,-0.009882514087133143,-0.04913749923581817,42.567762647356304,44.288888931274414,1.6618842619789762
2023-10-26,1,41.07875061035156,41.70625019073486,46.91525077819824,42.73200011253357,45.15993690490723,0.2042310499136759,1.4862615444181704,-1.0009645482481755,2.9951660911248412,43.989874839782715,1.2517623901367188,0.03368295249380267,42.421900272369385,46.23159942626953,0.81553111608589,-0.0042545768118307115,0.9309623938732132,0.9396951626685597,0.9678990913361409,-0.03395829797281513,42.91714060819922,47.09756066360441,44.125037574768065,41.15251448593172,42.248893056597026,0.7061813553695566,43.95300006866455,1.9629395502261497,43.01070912216628,43.4869465124334,-6.535011009145899,-4.024199817368302,541001000,0.7994204630087243,1.1740282004958686,-502275000.0,-94.22953628897923,44.757923903640624,51.57585752245338,-154.17249784483565,16.27092947070406,31.479246384043268,0.04986088780204972,1.6878539678424398,45.78495713806152,44.65652312469482,43.7445011138916,42.83247910308838,41.70404508972168,0.1,0.0,25.491063440346526,-0.04216054712419126,-0.04431691465108868,42.05187497820173,43.90068762642996,1.8610230407343238
2023-10-27,1,40.71275043487549,41.07875061035156,46.91525077819824,42.577312707901,45.15993690490723,0.008748441913700122,1.6046679911022284,-0.9192682722111916,2.995068228058232,43.989874839782715,1.336699867248535,0.03643652007020816,42.05994987487793,46.23159942626953,0.7816137084082277,-0.05985912311268226,0.924447272930748,0.9439253346319475,0.9658477022547083,-0.023821363736030277,33.665777463331935,47.24943607986071,44.04010009765625,40.83076411545179,41.999607358660015,0.9012271192906713,43.64519657407488,2.114433332711458,42.52946862486035,43.291085273256925,-6.19790742170634,-8.597097103936736,416784000,0.8349026401667088,0.9026081352197008,-919059000.0,-91.97827759683452,44.757923903640624,51.57585752245338,-143.5866448547838,15.433224845061657,29.85854546740972,0.06469874977172127,1.6523645338601114,45.78495713806152,44.65652312469482,43.7445011138916,42.83247910308838,41.70404508972168,0.1,0.0,25.516378375028207,-0.02143182446759473,-0.038027643499972945,41.80964224679129,43.559833254132954,2.0217028944335316
2023-10-30,1,41.12374973297119,40.71275043487549,46.91525077819824,42.50650072097778,45.15993690490723,-0.07580716624120054,1.760772043464364,-0.9958973719014264,2.9949263397971313,43.989874839782715,1.485774850845337,0.040116904057006006,41.64350023269653,46.23159942626953,0.8098889603520961,-0.08432480471683346,0.9369512246775521,0.9657503304840137,0.9802186375138706,-0.023171436795762168,30.567032318662392,47.412569200988166,43.891025114059445,40.369481027130725,41.79975005558559,0.9207885022604528,43.3244822365897,2.133311804394979,42.07432499787561,43.0417950620323,-4.109967844243569,-9.57142949135025,388028000,0.8081463875166436,0.8444722722956693,-531031000.0,-83.42608080208834,44.757923903640624,51.57585752245338,-105.13891695804018,17.021930778387404,28.173195972383528,0.048535754378905796,1.6261241991138256,45.78495713806152,44.65652312469482,43.7445011138916,42.83247910308838,41.70404508972168,0.1,0.0,25.540747778679986,-0.04221066935270146,-0.005460680372453213,41.67538506644113,43.22869055611746,2.0993269248175914
2023-10-31,1,40.334750175476074,40.71275043487549,46.91525077819824,42.368125200271606,45.15993690490723,0.03826074769376579,1.8544671594649447,-1.1586756965108231,2.9948328363509513,43.79875040054321,1.5938261890411376,0.04241291701385854,41.11924982070923,46.23159942626953,0.8531508616072291,-0.06907712868513977,0.9224829909960565,0.9572248259306609,0.9659039910678174,-0.06809411396401577,34.517541622422854,47.433046924978484,43.724112606048585,40.01517828711869,41.60382148197719,1.0767137640114768,42.885696547372,2.065526405121152,41.83254084344379,42.87399599404023,-3.290006157664193,-9.843524550672551,517969000,0.819028759856572,1.121514854519667,-1049000000.0,-81.50138515505314,44.757923903640624,51.57585752245338,-120.23683948310695,15.597203040897117,31.23759250160971,0.13394051474510624,1.6479010245956505,45.6315567779541,44.40822254180908,43.41950035095215,42.430778160095215,41.207443923950194,0.12000000000000001,0.0,25.571414548229264,-0.06602843008832082,-0.05107627098705119,41.588689531598774,42.79835564749582,2.2000459642828374
2023-11-01,1,41.614749908447266,40.334750175476074,46.91525077819824,42.00099992752075,45.15993690490723,0.07400909587561066,1.9915791581200484,-1.2237747296842205,2.99468629124202,43.53749990463257,1.7407374858856202,0.0457496817906472,41.04215059280396,46.23159942626953,0.8486173993277283,-0.07920990670888411,0.9559557592006425,0.9957742388133465,1.010824859353013,-0.023024734633916855,31.470245496938205,47.5152459760759,43.53208765983582,39.54892934359573,41.534607206072124,1.0549100308031314,42.50708934238979,1.7283692076594026,41.45552272694434,42.610618801158694,-3.2884759693967185,-13.217076283255231,437593000,0.8299291745204053,0.939774341022633,-611407000.0,-60.753225996822856,44.757923903640624,51.57585752245338,-56.6685846499138,21.036322688383823,29.065421772244825,0.14682017780576204,1.6445510756603865,45.25490475463867,44.10354852294922,43.17300033569336,42.2424521484375,41.091095916748046,0.12000000000000001,0.0,25.599961204510418,0.01306898969354231,-0.03064365740930886,41.49585287911551,42.468427658081055,2.214681149930096
2023-11-02,1,43.40299987792969,40.334750175476074,46.91525077819824,41.683375120162964,45.15993690490723,0.18919423066324953,2.0333466959047963,-1.3024251189767593,2.994638457157207,42.93874979019165,1.8120349740982058,0.046826921694972795,41.04215059280396,46.23159942626953,0.8838203236993502,-0.06234017147851224,0.9995486164283162,1.0406633828041087,1.059308633995822,0.05658033005006802,40.66961929279891,47.489293518076074,43.42260012626648,39.35590673445689,41.551892961774556,1.0887630976533298,42.30700009209769,1.3980080595595004,41.498151971699336,42.52484257656318,-1.1508516973088894,-11.298033756251701,409172000,0.8772891113627967,0.8772595212862551,-202235000.0,-38.870598577627604,44.757923903640624,51.57585752245338,1.7675580708571812,26.158975822832968,27.08998287841378,0.1324326655538517,1.638440149392513,44.57417872619629,43.55290888214111,42.72749900817871,41.90208913421631,40.880819290161135,0.02,1.0,25.629131729224326,0.07885720838616894,0.04133660927198526,41.47342899867466,42.328815187726704,2.1969604526946296
2023-11-03,1,44.51424980163574,40.334750175476074,46.91525077819824,41.683375120162964,45.15993690490723,0.25984872044304574,2.0214227328824754,-1.2429049292054015,2.994649970276971,42.93874979019165,1.758217453956604,0.04660482949280197,41.04215059280396,46.23159942626953,0.875364530702303,-0.034254906905431586,1.0262964733986906,1.065059693379118,1.074242594292408,0.09337368087771836,50.94955504093404,47.41652057372088,43.37367510795593,39.330829642190984,41.82600007738386,1.5423429111495317,42.23132153919765,1.225613279854409,41.9788691328465,42.68737164825158,0.27956261510270936,-6.062752975226336,424610000,0.9674805370117804,0.9113183241924635,222375000.0,-5.000774988030154,44.757923903640624,51.57585752245338,49.97757653123267,30.28556157976338,24.975808668193395,0.11547810535659142,1.6501942522295718,43.87435444641114,42.98682065582276,42.26949882507324,41.55217699432373,40.66464320373535,0.04,0.0,25.66142263005752,0.11123461059836015,0.1160293865242315,41.93418720790318,42.25097492762974,2.1610733072833797
2023-11-06,1,45.46749973297119,40.334750175476074,46.91525077819824,41.683375120162964,45.15993690490723,0.28283138406860714,2.0069071114716808,-1.19358253549411,2.9946647464765594,42.93874979019165,1.7346636343002317,0.04629301894925398,41.04215059280396,46.23159942626953,0.8555253429902271,-0.011277810064473317,1.0487918522398123,1.0806073489165318,1.077477418212711,0.10562631151597968,56.337233244074234,47.36607676757531,43.352262544631955,39.3384483216886,42.45296423775809,2.009290069499895,42.35092864717756,1.4507661054337888,42.62085985598688,42.99199644279131,4.504583370564518,-2.324802657763928,400733000,1.0032599729755007,0.8608984702533264,623108000.0,-2.7442486556111594,44.757923903640624,51.57585752245338,80.076619684567,31.674020171841995,23.82522135211847,0.12295972078760442,1.6063234565555287,44.35262094116211,43.37369067382812,42.58250045776367,41.79131024169922,40.812379974365236,0.06,0.0,25.693154028118414,0.11151333621561021,0.12965426916257894,42.70901870727539,42.38044684273856,2.1853621208308898
2023-11-07,1,45.76250076293945,40.334750175476074,46.91525077819824,41.683375120162964,45.494062185287476,0.2701102534148075,2.0276810262661855,-1.2428535935118572,2.994643485838715,42.93874979019165,1.7591661548614503,0.046748187765827,41.04215059280396,46.23159942626953,0.823113223647368,-0.0032062858967911926,1.0550544935753887,1.0789810782756157,1.062592246007103,0.1345676014813526,59.85381907815284,47.42989961585634,43.374537563323976,39.31917551079161,43.17435714176723,2.179652624404035,42.58698225021362,1.7143894402484507,43.342819024412066,43.3747062668785,10.683745385171706,3.8236693153216,343165000,1.0181262495051422,0.7392428601233338,966273000.0,-3.7635476908195047,44.757923903640624,51.57585752245338,89.04783439829876,31.43363086180246,22.674257747926077,0.1334753312519858,1.5673001781296874,44.56883074951172,43.54858290100098,42.7239990234375,41.89941514587402,40.87916729736328,0.08,0.0,25.720586190585514,0.1269005464397024,0.11646959778890313,43.48813574654715,42.64888899666922,2.1945936907805255
2023-11-08,1,46.3772497177124,40.334750175476074,46.91525077819824,41.683375120162964,45.494062185287476,0.2699540842446542,2.03613597788834,-1.2544255965454565,2.9946347781198113,42.93874979019165,1.767347421646118,0.046935068636226276,41.04215059280396,46.23159942626953,0.7932425032541757,-0.01538906389153703,1.0690442201790942,1.087117540262249,1.0503902324694003,0.11444259114238742,60.2108836709725,47.45424703435944,43.38197507858276,39.309703122806084,43.9248571395874,2.258911675983485,42.8623035975865,1.990544590526662,43.95368916556945,43.69963795538358,12.403363256288948,7.783621170607179,346719000,1.000257105488726,0.7494349554962271,1312992000.0,-3.8365749347900144,44.757923903640624,51.57585752245338,115.33201506969525,33.135746890540034,21.70282021303155,0.11146254651752419,1.520492933176088,45.064668334960935,43.94966618347168,43.048500061035156,42.147333938598635,41.03233178710938,0.1,0.0,25.749181035142342,0.10038971989046264,0.14207946864836943,44.26125390189035,42.96831948416574,2.1763709628610615
2023-11-09,1,47.349249839782715,40.334750175476074,46.91525077819824,41.683375120162964,45.494062185287476,0.2636544896896259,2.0285997422071556,-1.2593022795814615,2.994642517513249,42.93874979019165,1.761819915771484,0.046766767575448606,41.04215059280396,46.22154941558838,0.7524761363082638,-0.011467508998925605,1.0915762809472147,1.1001494520759365,1.0497584489092753,0.09092113386060396,62.397007404139536,47.4341495576565,43.376950073242185,39.31975058882787,44.92692852020264,1.9332468262752618,43.265375001089915,2.2876117254216988,44.56205239325911,44.03963717107829,12.77485642445973,9.064556703798052,540496000,1.0054580477531818,1.1608613504622325,1853488000.0,-14.222208658854166,44.757923903640624,51.57585752245338,144.4519324670971,36.93677450000759,20.025145387324685,0.07037899910199893,1.5301718829478295,46.105999542236326,44.791999542236326,43.72999954223633,42.66799954223633,41.35399954223633,0.12000000000000001,0.0,25.79540178289549,0.07916158073213242,0.10927337897899717,45.142491476876394,43.36559050423758,2.1767972963745734
2023-11-10,0,47.89750003814697,40.334750175476074,47.349249839782715,41.683375120162964,45.494062185287476,0.3211774832649905,2.068266352273703,-1.1511431490673711,2.9946016733754046,42.93874979019165,1.7856898641586305,0.04765738913582089,41.04215059280396,46.22154941558838,0.7478736561593294,0.02478128036009742,1.1036633630100705,1.0969066885560375,1.0436515344200556,0.07600375725947672,67.45110007324314,47.53518273086882,43.39865002632141,39.26211732177401,45.82446425301688,1.5620197925081656,43.679535729544504,2.567945949930075,45.25479117066947,44.39229196097432,17.390710575347818,13.530345267773454,421245000,1.0154974323170765,0.9099036711079853,2274733000.0,-1.4823742588438273,44.757923903640624,51.57585752245338,156.6752202190724,35.44161528128381,18.60187436687355,0.1469010315809153,1.5295881312466173,46.29088798522949,44.94155590057373,43.85099983215332,42.76044376373291,41.41111167907715,0.14,0.0,25.832488490277346,0.07399167731503709,0.11099621288992578,46.000875745500835,43.748364312308176,2.4016714977861304
2023-11-13,0,48.53874969482422,40.334750175476074,47.89750003814697,41.683375120162964,45.494062185287476,0.4669582808674529,2.211101794060366,-0.937556807855191,2.9944485568798713,42.93874979019165,1.886849918365479,0.050849433125724965,41.04215059280396,46.474449729919435,0.7779671229750047,0.05098879331306864,1.1162615458245533,1.0935980898688409,1.0422571584714009,0.06754824830682038,70.5542226598003,47.90551614724855,43.48331255912781,39.06110897100707,46.55814279828753,1.4361581434728865,44.05501788003104,2.871700283868012,45.90672402087659,44.724245384800874,15.097411719454762,13.772811203122815,384136000,1.007375809438026,0.8289379033504964,2658869000.0,-5.017217455459192,44.757923903640624,51.57585752245338,157.75145015702338,36.79825010702738,17.696771306504832,0.11531877264713669,1.4929748437084938,46.78290475463867,45.339548522949215,44.17300033569336,43.0064521484375,41.56309591674805,0.16,0.0,25.867083799105725,0.06270901531747652,0.0803243208781311,46.73128890991211,44.102358954293386,2.599768585262884
2023-11-14,0,49.552499771118164,40.334750175476074,48.53874969482422,41.683375120162964,45.54124999046326,0.5830823031792752,2.434413475884156,-0.8580149309031495,2.994190956636033,42.93874979019165,2.064749927520752,0.05579478094921428,41.04215059280396,47.40407485961914,0.8274145768291674,0.10836776310358151,1.1357030749311763,1.098093221761472,1.0501737257860508,0.08281887888539563,76.28451123894561,48.500389518525516,43.631562566757204,38.76273561498889,47.277892793927876,1.5020927614380741,44.551946435655864,3.18459749408925,46.5573939013145,45.07606653586475,11.832707027944505,12.145349468251979,416954000,0.9067081164165178,0.9398508019479824,3075823000.0,-1.678625068575694,44.757923903640624,51.57585752245338,151.96674544137522,38.11363478696811,16.65501051781185,0.12053266178642678,1.4730481192939082,47.331455612182616,45.783271598815915,44.531999588012695,43.280727577209475,41.732543563842775,0.18,0.0,25.905994405788192,0.08053517809172295,0.08535330740000541,47.395572662353516,44.66487993512835,2.9225426160508348
