date,buy?,todays_price,Minimum,Maximum,25th Percentile,75th Percentile,Skewness,Standard Deviation,Kurtosis,Shannon Entropy,Median,Mean Absolute Deviation (MAD),Coefficient of Variation (CV),10th Percentile,90th Percentile,Autocorrelation,Cumulative Return,curr_to_avg_one_month,curr_to_avg_one_two_week,curr_to_avg_one_one_week,momentum,rsi,upper_band_current,middle_band_current,lower_band_current,rolling_mean_7,rolling_std_7,rolling_mean_14,rolling_std_14,ema_7,ema_14,roc_7,roc_14,Volume,Volatility,Relative Volume (RVOL),On-Balance Volume (OBV),Williams %R,Stochastic Oscillator %K,Stochastic Oscillator %D,Commodity Channel Index (CCI),ADX1,ADX2,Chaikin Money Flow (CMF),Average True Range (ATR),Fib_23.6,Fib_38.2,Fib_50,Fib_61.8,Fib_76.4,Parabolic SAR 2,Parabolic SAR 3,VWAP,Adj Close Momentum,Adj Close Return,Adj Close 7d MA,Adj Close 14d MA,Adj Close Volatility
2021-12-30,0,169.43912506103516,166.8508758544922,176.05974960327148,170.12359809875488,172.88296794891357,0.4540799045807672,2.508058664088233,-0.6601249125786004,2.9956252823647906,170.68256378173828,2.0152377700805686,0.014643764850629818,168.5185104370117,175.27171249389647,0.6490001803487158,-0.028100397599742845,0.9893017015183213,0.9980361197559487,0.9939666030604902,-0.004554569968658884,43.723481954753474,176.2875553546047,171.27143802642823,166.25532069825175,170.06216049194336,0.7915258528956179,169.96592957632882,1.602227624171862,170.1642397206018,170.87584620633703,0.8325685532067899,-3.462673623844271,37584000,1.951124830336235,0.6452809197107361,-297744000.0,-67.85785375896447,77.07053933241427,82.84087432937385,-60.788460228781865,16.245584408283694,15.721507898170705,-0.0002567082377756775,3.972121431998291,173.39425122070313,171.8273800048828,170.56100463867188,169.29462927246095,167.72775805664062,0.04,0.0,171.08062283348343,-0.0139882118792789,-0.010400996593170637,170.09978594098772,170.06085859026228,2.4161041813699575
2021-12-31,0,167.8953742980957,166.8508758544922,176.05974960327148,169.83231258392334,171.52428245544434,0.6707055393253121,2.394598484733622,-0.19701755400062604,2.995634522065325,170.60224723815918,1.804789085388188,0.014003539287904834,168.5185104370117,175.27171249389647,0.6762818958125476,-0.018726174244824246,0.9818470550408008,0.9893730765464028,0.9858072783583951,-0.017612075474258693,43.772064340358114,175.78871612687692,170.99951915740968,166.21032218794244,169.9532312665667,1.0327128976669053,169.56459890093123,1.3247982172542574,169.9789671630824,170.6704621095027,1.5512350134740298,-3.319900514340667,47830000,1.8982666459217188,0.8332810681607538,-345574000.0,-83.03434293266295,77.07053933241427,82.84087432937385,-122.41314082124498,15.183527115798197,19.296780146286306,-0.003069801353337986,3.8652501071734355,172.04884600830079,170.73908102416993,169.68050384521484,168.62192666625975,167.3121616821289,0.04,0.0,170.94917224631956,-0.025437187727034072,-0.02525773522378864,169.5712127685547,169.6683578491211,2.5875669068002076
2022-01-03,0,168.70462799072266,166.8508758544922,176.05974960327148,169.24381351470947,170.96440505981445,0.799545003120581,2.453338265144175,-0.0842270929290958,2.995629451484269,170.47543334960938,1.7713815307617211,0.014367116594686789,168.12015113830566,175.27171249389647,0.6860303942433916,-0.016232749224043934,0.9879595874902859,0.9960471584613926,0.9940725815371982,-0.011783410171200326,40.402655361997454,175.6673332685696,170.76065673828126,165.85398020799292,169.73755264282227,1.1228065305670945,169.42211668831962,1.3004076801107032,169.46756569694327,170.2874351743324,-0.45210136799985146,-3.2381417833820354,63520000,1.87738445710932,1.123452423063318,-282054000.0,-41.92964044611284,77.07053933241427,82.84087432937385,-59.83556257434576,16.6853847061407,17.31307988918549,0.06137015224084689,3.9254515843078432,172.04884600830079,170.73908102416993,169.68050384521484,168.62192666625975,167.3121616821289,0.04,0.0,170.8617460962228,0.004331954969036156,-0.003881494709059601,169.48085457938058,169.72814287458147,2.572224884495467
2022-01-04,0,168.92737579345703,166.8508758544922,176.05974960327148,168.6929407119751,170.96440505981445,0.851048290635881,2.494026060592645,-0.12223773072541144,2.9956259241188774,170.3132495880127,1.839257659912107,0.014613782107186772,168.12015113830566,175.27171249389647,0.7111902499302684,-0.010019785096048431,0.989832424284219,0.9972771227532297,0.9977504116213783,-0.009448703743855202,44.175525373125296,175.65065282919306,170.6626007080078,165.67454858682254,169.45498166765486,1.0245182255962935,169.47799164908272,1.257413028081223,169.29796654335064,170.09607595012048,-0.8869699380184227,-1.1685754152303025,70726000,1.8891370493430564,1.2488412294533429,-211328000.0,-74.06088892593078,77.07053933241427,82.84087432937385,-77.234342972917,16.368142170533787,15.415794120424994,0.00887341676226132,4.0236751193520925,172.04884600830079,170.73908102416993,169.68050384521484,168.62192666625975,167.3121616821289,0.04,0.0,170.74048141375897,-0.0183931442605213,-0.012656909598127966,168.97421264648438,169.61603546142578,2.6688210056010777
2022-01-05,0,165.68087005615234,166.8508758544922,176.05974960327148,168.6929407119751,170.96440505981445,0.8948260824286504,2.5223140343549053,-0.13783648610231802,2.9956234319823634,170.19569206237793,1.8986474609375024,0.014785967713411776,168.12015113830566,175.27171249389647,0.7286930898233543,-0.036900032100941366,0.9712319568513907,0.9769135220094027,0.9804415391385792,-0.025196634469594192,39.330048284404185,175.6329915254359,170.58836345672609,165.54373538801627,168.73564202444894,1.5983744721795985,169.15683909824915,1.5942131891518254,169.22000424426932,169.97353606443414,-1.1573637480514742,0.4652227915835833,64302000,1.4677415290588107,1.1375267788118788,-275630000.0,-100.0,77.07053933241427,82.84087432937385,-176.28764382436734,15.24095379180451,18.689520226840305,-0.06907122799098353,3.9498794918131344,171.85107501220702,170.41896017456054,169.2614974975586,168.10403482055665,166.67191998291017,0.06,0.0,170.50423209265236,-0.02862872727754784,-0.036938732465705254,168.2152840750558,168.97617776053292,2.6789342596942776
2022-01-06,0,163.3603744506836,165.68087005615234,176.05974960327148,168.63340854644775,170.76352882385254,0.7821256327318376,2.4844906647266027,0.4793484443735845,2.99562600124742,170.0701904296875,1.8199628829956054,0.014605850894391977,167.79092445373536,173.68835334777833,0.5614569519644041,-0.05895089349216184,0.9603647561063734,0.9649248334050761,0.9716343597728854,-0.03587572001544437,29.33432320474505,175.07140690470956,170.10242557525635,165.13344424580313,167.7101603916713,2.3667782476379986,168.60104424612862,2.1190547098269237,168.33032447270256,169.2893889197274,-2.949559619808975,-2.642034798640269,51958000,1.5823081533487102,0.9137384349428715,-327588000.0,-88.03378396176844,77.07053933241427,82.84087432937385,-225.22129545754325,14.282784719415057,22.82856047046513,-0.0786326687967833,3.8578076181869174,170.34557794189453,168.7387024230957,167.43999481201172,166.14128720092774,164.5344116821289,0.08,0.0,170.26189948427563,-0.031963704160388184,-0.035147582366535764,167.15714154924666,168.57496316092355,2.6739796036142294
2022-01-07,0,163.41687774658203,163.3603744506836,175.25749969482422,168.45627975463867,170.7035961151123,-0.10859428589871294,2.5035546188424833,0.9009820232465993,2.995623077877631,169.70125007629395,1.845294189453125,0.014773070097680719,166.7338752746582,171.3787525177002,0.48625412337184415,-0.0678836869455349,0.96429651341522,0.9691822899463148,0.979049974582127,-0.026674329595061774,25.15106501804914,174.47456605531193,169.46745681762695,164.46034757994198,166.77494648524694,2.609047069730954,168.23367854527064,2.5322473884528693,167.0836584678394,168.36255742221704,-4.209231979745585,-4.546604897971229,46606000,1.630811133167605,0.819225773110706,-280982000.0,-94.3939253198094,77.07053933241427,82.84087432937385,-198.41333425617404,14.249076965483232,21.216751602772334,-0.06663764972614938,3.8038580583442956,170.34557794189453,168.7387024230957,167.43999481201172,166.14128720092774,164.5344116821289,0.08,0.0,170.0564552281058,-0.024970425953222408,-0.03611442917781896,166.2075696672712,168.04185594831193,2.831879885700558
2022-01-10,0,160.00937271118164,163.3603744506836,173.5140037536621,168.082688331604,170.5789041519165,-0.7682744351214832,2.46404757218357,0.36263490464147763,2.9956254154987882,169.1832504272461,1.8606828308105463,0.014590918493173143,165.4544708251953,170.92898559570312,0.562480666231147,-0.058191994816827415,0.9474994483583297,0.9532066871280188,0.9638072282282169,-0.0515412966621116,26.262047796824955,173.803520864582,168.87542572021485,163.9473305758477,165.42783900669642,3.3370398751411785,167.7449997493199,3.34828732942085,166.16349463205336,167.58026868019076,-3.8517106061493287,-3.051210184209869,87798000,1.6153610259603373,1.5073730764674473,-368780000.0,-68.85842152565067,77.07053933241427,82.84087432937385,-243.6546918972382,12.41296948261384,30.290242740565194,0.02457157117330007,4.005859417190362,169.01630981445314,166.58709045410157,164.62374877929688,162.66040710449218,160.2311877441406,0.1,0.0,169.5189659031119,-0.05233725081662366,-0.031376542026264956,165.18492562430245,167.6423557826451,3.1464913298032995
2022-01-11,0,163.47837829589844,160.00937271118164,171.1415023803711,167.63424968719482,170.29547023773193,-1.3737787084635225,2.9103465907568964,1.1107499191576231,2.9955813612514075,168.81600189208984,2.2042487716674772,0.017302872955357245,163.41122741699218,170.73516006469725,0.610487138856292,-0.06262475189293029,0.9719274053425072,0.980123737509264,0.9951266078946048,-0.03225645027612889,21.570236439637434,174.0208873496046,168.20019416809083,162.37950098657706,164.7968395778111,3.2077914381383468,167.3750354221889,3.521339828106803,164.6156803552176,166.5177380357364,-5.565274458574277,-4.100369931097578,62806000,1.6641540476835182,1.077705804126807,-305974000.0,-45.56299407567726,77.07053933241427,82.84087432937385,-100.14237098589385,20.28016595242124,26.91449295876789,0.09721786808240376,4.140037285348485,169.01630981445314,166.58709045410157,164.62374877929688,162.66040710449218,160.2311877441406,0.1,0.0,169.3242114523241,-0.012893850486422775,-0.029591330442657077,164.9913548060826,167.28128378731864,3.193748922662104
2022-01-12,0,165.7692527770996,160.00937271118164,171.1415023803711,166.55837440490723,170.1863489151001,-1.0838254337170656,3.0236139262657304,0.19913611181709934,2.9955689194973396,168.68125343322754,2.423811569213865,0.01801495081411004,163.41122741699218,170.73516006469725,0.7723397378548826,-0.027754286718733482,0.9876674099591279,0.9980834064670406,1.0158103509653775,0.0005334515742059232,38.3906531886575,173.88637198705297,167.8391441345215,161.79191628199,164.37750026157923,2.774389253471295,167.05752645220076,3.4452101282685037,164.32354134335782,166.10070151194293,-2.630802677359625,-3.071010150465757,50030000,1.8208855318612402,0.8628807765409571,-255944000.0,-46.49456172850828,77.07053933241427,82.84087432937385,-56.69068932499849,20.338532024740203,25.577033328913345,0.04686005884221323,4.004278447028256,169.01630981445314,166.58709045410157,164.62374877929688,162.66040710449218,160.2311877441406,0.1,0.0,169.21706803776686,0.00517170629357655,-0.01381909479081445,164.2488555908203,166.86485508510046,3.243931788914964
2022-01-13,0,163.44425201416016,160.00937271118164,171.1415023803711,165.7471570968628,170.1863489151001,-0.9488844077106449,3.0557602152485797,-0.07947419110448939,2.995565316857333,168.68125343322754,2.5476451301574743,0.018219376521311885,163.41122741699218,170.73516006469725,0.7989203878275176,-0.025900990388421155,0.9745045939240786,0.9865761117600477,1.0014546008095309,0.0005134510970521422,44.6851734753519,173.83187088673495,167.72035045623778,161.60883002574062,163.59419686453683,1.917378845875502,166.52458926609583,3.380676652555598,164.68365418793928,166.108138561093,-1.739949430305177,-2.6114865399400697,52188000,1.8387657128666541,0.9188044345148495,-308132000.0,-70.49311274554759,77.07053933241427,82.84087432937385,-108.55196123965426,18.29720884928419,29.516561656008044,-0.058099004209436755,4.094488280255337,169.01630981445314,166.58709045410157,164.62374877929688,162.66040710449218,160.2311877441406,0.1,0.0,169.0360171736986,-0.012495824381573817,-0.019122947090880395,163.34771292550224,166.1609627859933,3.297519487311743
2022-01-14,0,161.08462524414062,160.00937271118164,171.1415023803711,165.13024711608887,170.02612590789795,-0.7050890109404065,3.136373493168113,-0.5863886818903152,2.9955559258763444,168.6089382171631,2.70594482421875,0.01873762650673694,163.41122741699218,170.73516006469725,0.7474331419879745,-0.04497594247538735,0.9623673807909617,0.9758642858527957,0.9868952705685347,-0.014271796980836582,38.32698529101645,173.65645975489093,167.3837127685547,161.11096578221844,162.93759046282088,1.870110102531209,165.8366162436349,3.4415289891711844,164.36841604484624,165.8314031792583,-3.2458467750075886,-4.365644269167827,45974000,1.8725123251545563,0.8201616989089249,-354106000.0,-63.24544250178339,77.07053933241427,82.84087432937385,-124.33073185156321,17.399312715722033,30.653465274625713,0.019838873982486054,3.963856905394225,168.43032312011718,166.1130855102539,164.24024963378906,162.36741375732421,160.05017614746095,0.1,0.0,168.8495417042318,-0.002559151814314986,-0.006835957033049961,163.0307137625558,165.6229989188058,3.4615525415967694
2022-01-18,0,158.85537338256836,160.00937271118164,170.9053726196289,163.46984672546387,169.57018756866455,-0.569613065591848,3.295734028709256,-0.925565177184239,2.995536503656682,168.22768592834473,2.883294105529785,0.019749022462558257,163.1327995300293,170.55649604797364,0.7581961057720331,-0.04434843629998621,0.9519088342389973,0.9663464440042163,0.97602684614699,-0.007212073324581181,34.80519007023497,173.47233696916163,166.88086891174316,160.2894008543247,162.29401888166154,2.4003586573300733,165.00208963666643,3.625245103028874,163.53971669393712,165.29048224183924,-2.7741554051798287,-5.641889657366871,67292000,1.8595500280975161,1.2203335733184868,-421398000.0,-82.69025106691817,77.07053933241427,82.84087432937385,-153.9582164323862,15.867823224026884,32.158122198224866,-0.018686343475044637,4.004007511263012,167.83745837402344,165.6335169067383,163.8522491455078,162.07098138427733,159.86703991699218,0.1,0.0,168.50193305566714,-0.015905383900023717,-0.022371058896349705,162.41121346609933,164.78417750767298,3.8080058318036607
2022-01-19,0,157.6402473449707,158.85537338256836,170.9053726196289,163.43740844726562,169.57018756866455,-0.5204333375032646,3.7021438026910736,-0.9712873566950679,2.9954837661534706,167.37312507629395,3.2461362648010263,0.02224904362757594,160.97709999084472,170.55649604797364,0.7669738922016592,-0.04792005094954713,0.9473820919896845,0.9647348007399243,0.9699363936626648,-0.03571194559050872,31.534703020078638,173.79992530832408,166.39563770294188,158.9913500975597,161.46878596714564,2.8925202979897686,164.1218662261963,3.8188448693655044,162.37059370923157,164.56970281880126,-2.7577073591216803,-6.850861038799318,53242000,1.8824053383491604,0.969167646598393,-474640000.0,-99.67659411604743,77.07053933241427,82.84087432937385,-154.58265459217012,14.919420450038585,33.05418062509586,-0.08132348551586918,3.9254867174675683,167.82459533691406,165.61269622802735,163.8249969482422,162.03729766845703,159.82539855957032,0.12000000000000001,0.0,168.20343845171575,-0.054807050995998585,-0.03212041107625275,161.51764133998327,163.86260550362724,4.41350549127714
2022-01-20,0,154.44612503051758,157.6402473449707,170.9053726196289,163.40275192260742,169.57018756866455,-0.49888254453685676,4.161281109135058,-1.0436907898451062,2.995416449503748,166.83231353759766,3.6611438751220704,0.025077762038955374,159.89397277832032,170.55649604797364,0.7904864780384591,-0.065325329621153,0.9307622027388398,0.9517615934439454,0.9571598991964586,-0.06830656202454866,27.86153522019307,174.2576684957359,165.93510627746582,157.61254405919573,160.67403629847936,3.9362954744687477,163.0509376525879,4.286623055003324,161.19829570673085,163.90337275156438,-3.534904399880538,-7.250460718342429,71974000,1.8138734436471278,1.2913215170614694,-546614000.0,-98.42137829155412,77.07053933241427,82.84087432937385,-183.78703090758927,13.056770933083063,38.12623748036706,-0.18283923055841772,4.137051552559709,166.66843084716797,163.74127743530272,161.37549591064453,159.00971438598634,156.0825609741211,0.14,0.0,167.69968087117618,-0.08195478971748982,-0.08281530112490684,160.11499895368303,162.64996228899275,5.287422679180791
2022-01-21,0,146.39087295532227,154.44612503051758,170.9053726196289,162.79143714904785,169.57018756866455,-0.5724227022396989,4.800050580399617,-0.7300910755204262,2.995307795882674,165.72506141662598,4.128504104614256,0.029051684468514676,158.7338607788086,170.55649604797364,0.763727149352409,-0.0926376107507824,0.8860117990286627,0.9084109819534829,0.9201526035004312,-0.10433758819099037,22.08213481814335,174.82461974600434,165.2245185852051,155.62441742440583,158.23296410696847,6.42130723079527,161.51490184238978,5.948072014499262,159.52053440523045,162.7266986700791,-3.4768261298703886,-8.848605671869953,163972000,1.8295092732178344,2.680003595740682,-710586000.0,-98.04800695891763,77.07053933241427,82.84087432937385,-253.46188724108754,10.934741403994872,47.646182909087706,-0.3024894840205047,4.558549393643046,164.4782322998047,160.1961255493164,156.73524475097656,153.27436395263672,148.99225720214844,0.16,0.0,166.0530095090047,-0.11519470160916079,-0.13658014043771657,156.86942836216517,160.9303915841239,7.059231747229626
2022-01-24,1,140.96025466918945,146.39087295532227,170.9053726196289,160.81581211090088,169.05531311035156,-1.1290865437824107,6.173488674069764,1.043034190076865,2.995013308135802,164.5796241760254,4.820693397521973,0.03763557182523478,157.3208351135254,170.55649604797364,0.6722995165925091,-0.14343902294322075,0.8593390332744159,0.8840208668808517,0.9054286487317467,-0.12493042426892431,14.899279296817056,176.38032066326406,164.0333433151245,151.68636596698497,154.68882152012415,8.175403527092604,159.5331608908517,7.72485243327508,156.24041095816557,160.50477058081634,-10.452455865232231,-12.808275053839495,155624000,2.4002333531483813,2.31841049499965,-866210000.0,-74.50065419623178,77.07053933241427,82.84087432937385,-235.0982454275097,9.306541614560869,50.97996093978012,-0.1696645451618873,4.944970285516501,162.89266851806642,157.6296621398926,153.3759994506836,149.1223367614746,143.85933038330077,0.18,0.0,164.46540127237648,-0.10851246523110192,-0.1034029160117331,153.91757202148438,159.08321380615234,7.9835535380406615
2022-01-25,1,140.9933738708496,140.96025466918945,170.71624755859375,159.72087287902832,168.76031494140625,-1.3354031350020612,7.754180732434848,1.2566937265811973,2.9945681321906505,163.4613151550293,5.8365740585327135,0.047707440579101056,153.64059982299804,170.02091217041016,0.707712637073176,-0.17430088415686007,0.8674588893517325,0.8968594828597799,0.9296762426495645,-0.1124418968737182,12.232490551201867,178.04444888247227,162.53608741760254,147.02772595273282,151.48155321393693,8.562759195568919,157.5378750392369,8.662428140680664,152.41847066898856,157.8771528568686,-14.965982950571293,-16.445531845788434,90824000,2.5541054030059174,1.3214204134603773,-775386000.0,-85.41601336552097,77.07053933241427,82.84087432937385,-195.58473117722403,8.407259389756245,46.053816020098104,-0.15487954249961222,5.055983579977145,159.62771563720702,154.98864004516602,151.23925018310547,147.48986032104492,142.85078472900392,0.18,0.0,163.5928228490846,-0.11912787329820584,-0.1366244063077717,150.88499886648995,157.1163558959961,9.176786445981804
2022-01-26,1,141.53149795532227,140.96025466918945,170.53874588012695,158.55159187316895,168.09768772125244,-1.1660422433565532,8.819147925501612,0.3299702643623519,2.994198343431928,163.4305648803711,6.805398616790768,0.054760329131879906,145.851123046875,169.4915500640869,0.7869497292524686,-0.1732472691575029,0.878805013367617,0.9113057244234584,0.9557374155363019,-0.1021867807299045,12.3556113652203,178.68823958421856,161.04994373321534,143.41164788221212,148.6882493155343,8.083850678958486,155.8129198891776,9.297347647138862,149.56752256912856,155.64181182818862,-13.736107490256368,-16.536101263279892,95602000,2.560557071397452,1.3506865610911511,-679784000.0,-88.83305067354344,77.07053933241427,82.84087432937385,-161.6361715026656,9.738937453036584,40.83049884726846,-0.1913829597527689,5.269512078142799,159.43786975097657,154.83507360839843,151.11500549316406,147.3949373779297,142.79214123535155,0.18,0.0,162.736273589426,-0.11149462800287913,-0.12613462147246562,147.5613555908203,155.29603467668807,10.059994588605175
2022-01-27,1,141.00775146484375,140.96025466918945,169.96337509155273,156.84171676635742,166.30078315734863,-0.9553955322632135,9.498443926323803,-0.40744761860348033,2.9939248580593176,163.3886260986328,7.637932415008547,0.05951421580655024,141.477685546875,168.97855072021486,0.8325383267447721,-0.1672823755171684,0.8835095323158966,0.9209476156881965,0.9733773600098241,-0.08701010506426421,14.213182823277856,178.5964691896227,159.5995813369751,140.6026934843275,146.13858904157365,7.097019487666302,154.2163039616176,9.806862355458502,147.56607919051083,153.80124648473532,-12.138419330326247,-14.575836119550438,77516000,2.5948215645631265,1.0637807334866691,-757300000.0,-86.40648413813933,77.07053933241427,82.84087432937385,-131.18812367479097,8.989278023197206,37.68755141244775,-0.2195875437871685,5.277187874067465,159.43786975097657,154.83507360839843,151.11500549316406,147.3949373779297,142.79214123535155,0.18,0.0,162.10499529406113,-0.07931823968998608,-0.10660016668601281,144.80707005092077,153.60914175851005,10.64484191099962
2022-01-28,1,141.69150161743164,140.96025466918945,169.43912506103516,152.43231201171875,165.70296573638916,-0.7577600598642474,10.001837957237216,-0.9168768882840439,2.993697628645874,162.2224998474121,8.409247779846192,0.06324201145604572,141.00631370544434,168.7269027709961,0.8521052855611617,-0.1677969806911473,0.8959208904229407,0.940625287578172,0.9965870048017774,-0.032101532308813074,13.986889700659889,178.15547607011408,158.15180015563965,138.14812424116522,143.86019679478235,5.05564136828157,152.664491380964,9.956735424817177,145.92977829773167,152.1383968497261,-11.235138942856231,-13.68301404854322,74392000,2.5948314961444243,0.9957595356905746,-682908000.0,-72.63848393679262,77.07053933241427,82.84087432937385,-106.48837790013903,8.219430635993412,36.46462477225083,-0.14212904364815368,5.336784876436598,159.43786975097657,154.83507360839843,151.11500549316406,147.3949373779297,142.79214123535155,0.18,0.0,161.5570783011049,0.009358968928094846,-0.0506997156146158,143.04692731584822,152.28228432791573,10.723027898804913
2022-01-31,1,147.2461280822754,140.96025466918945,168.92737579345703,145.2160301208496,164.0290012359619,-0.5666301732352468,10.261034169529873,-1.278103898990033,2.99356085934658,160.54699897766113,9.032955532073974,0.06545512199813999,141.00631370544434,167.9762996673584,0.8766133077968833,-0.15607263029259807,0.9392828362270881,0.9918224912865894,1.042547331408988,0.044593232523861825,16.72909839685691,177.2864873225192,156.76441898345948,136.24235064439975,142.83162580217635,2.7493636818893616,151.75283105032784,9.815808205373212,144.87838842022404,150.83835148901636,-10.11717882720506,-13.294450627578945,78308000,2.6399708291963306,1.0272232257285916,-604600000.0,-54.889627160120966,77.07053933241427,82.84087432937385,-54.39022470498072,16.307278053796818,33.2402941314763,-0.07345834976379964,5.415238043919539,159.43786975097657,154.83507360839843,151.11500549316406,147.3949373779297,142.79214123535155,0.02,1.0,161.18175888486903,0.03479559869927029,0.048586302551535836,142.74778529575892,151.431392124721,10.53321550453532
2022-02-01,1,150.1322479248047,140.96025466918945,168.92737579345703,145.2160301208496,163.45278358459473,-0.3904074076740436,10.127083912865167,-1.4408141639857701,2.9935976066828163,159.432373046875,9.158814773559573,0.06502893901314803,141.00631370544434,166.06279029846192,0.8929732977013489,-0.12719568018980074,0.964042648230294,1.0207778889249903,1.0536036227098426,0.06481775563670333,33.21296014435325,175.9861244983988,155.73195667266845,135.4777888469381,143.36610794067383,3.7413266122543725,150.79953602382116,9.219403498030598,145.46691097890943,150.6497887535099,-4.661817800103119,-7.976560630572574,59220000,3.030741117978716,0.7790290945398243,-545380000.0,-49.75102706177084,77.07053933241427,82.84087432937385,-33.47513944353901,17.266512820595782,31.332760631775777,-0.08081720645447361,5.3154599749598335,159.43786975097657,154.83507360839843,151.11500549316406,147.3949373779297,142.79214123535155,0.04,0.0,160.95479052363885,0.0800616124355007,0.04600322437757816,143.9692840576172,150.4193562098912,9.961074202457544
2022-02-02,1,152.40037536621094,140.96025466918945,168.92737579345703,145.2160301208496,163.42372131347656,-0.2797160199042643,9.739035998067878,-1.4903218372501872,2.9937396725816123,158.24781036376953,8.88302854537964,0.06291231277498949,141.00631370544434,165.68970832824706,0.8870979224621693,-0.11126158670476621,0.9844773223927908,1.0423817082349187,1.0559759408141134,0.07679475995032359,39.977055549923136,174.2814096655083,154.80333766937255,135.3252656732368,145.0004108973912,4.849714489693188,149.84461620875769,8.183803291847159,146.61750739125682,150.9023602557914,2.5557433287690485,-8.163850479931385,87330000,3.1493120874120852,1.1364006043105928,-458050000.0,-50.56446586191334,77.07053933241427,82.84087432937385,-18.182776446396456,20.44279760910951,28.63857390757714,-0.08011516445051964,5.382220897550113,158.9362965698242,154.42935079956055,150.78675079345703,147.1441507873535,142.63720501708985,0.06,0.0,160.67623441624974,0.08453801652275073,0.07591124251454254,144.83621215820312,149.37689208984375,9.50669286739359
2022-02-03,1,140.79087448120117,140.96025466918945,165.7692527770996,145.2160301208496,163.3745002746582,-0.24464311892039411,9.191314191063634,-1.512114635842168,2.993940381532508,156.04318618774414,8.343888492584227,0.05969277832655669,141.00631370544434,163.69862747192383,0.8990566503734778,-0.0801570796039422,0.9143630917306136,0.9664391956359596,0.9610587186563214,-0.0015380500815704856,46.09636330689207,172.35961603013752,153.97698764801027,135.594359265883,144.97148241315568,4.878120828351733,148.2265178135463,7.49889747564443,148.05015809563767,151.30409251563665,8.11584848783763,-8.06475096371764,225532000,3.1818524947915074,2.6561487891799964,-683582000.0,-87.01204399624004,77.07053933241427,82.84087432937385,-95.40178788141199,17.279566166407502,37.476788659699785,-0.14443477134198376,5.894536661986607,155.90207318115233,151.97496591186524,148.8010025024414,145.62703909301757,141.69993182373048,0.06,0.0,159.2455118530856,-0.005671773018056547,-0.00019437108373581002,144.67328534807478,147.77914210728235,9.707363179346688
2022-02-04,0,156.26350021362305,140.79087448120117,165.7692527770996,141.6515007019043,161.65356254577637,-0.08496236080550773,9.207394458301376,-1.5985798142312608,2.9939105098246475,153.42325019836426,8.418000030517579,0.060284452815191514,140.99006195068358,163.447664642334,0.8270172667310034,-0.13815773895826777,1.0231189342465428,1.0827984255345837,1.0669930053033878,0.10284313759011421,32.15828188674607,171.14727678586544,152.73248786926268,134.31769895265992,147.0760541643415,6.1569472148771975,147.8821517399379,6.953897363561105,146.23464315927652,150.07574180875588,-0.1436233378129724,-13.860002572006255,253456000,4.001502664797063,2.6683988827627303,-430126000.0,-13.774768680038774,77.07053933241427,82.84087432937385,35.115282304153276,30.90846372513994,28.753969250627147,-0.08320531906726332,7.113672938480009,155.09987084960937,151.3260640258789,148.2760009765625,145.2259379272461,141.45213110351563,0.08,0.0,159.04180683825138,0.09488601956263754,0.12891951871666518,147.35428510393416,147.45782034737724,9.454833308360866
2022-02-07,0,159.09912490844727,140.79087448120117,165.7692527770996,141.6515007019043,160.2781858444214,-0.055353872284830706,8.923340316290822,-1.529113797952161,2.9940142967970202,153.42325019836426,8.065429439544678,0.05856069219099361,140.99006195068358,163.447664642334,0.7778986973972227,-0.04377379883644608,1.0441106750810123,1.0949566972886553,1.06515846281527,0.0804978506433045,53.40170831009141,170.2243247899913,152.37764415740966,134.53096352482802,149.66053608485632,6.933266413020032,147.89956256321497,6.983726143345806,148.7508135001337,151.06070332827866,10.408991970784681,-2.9929144530153997,102624000,5.466374715657806,1.049483970989475,-327502000.0,-17.394546371912966,77.07053933241427,82.84087432937385,61.38635194579111,30.706898613429797,27.100593885852057,-0.10400249476431056,6.990108967527931,156.23899279785155,152.24750036621094,149.02149963378906,145.79549890136718,141.80400646972657,0.1,0.0,159.04906375992846,0.055905621136105976,0.0969419257118306,149.9682856968471,147.38767787388392,9.240514638334224
2022-02-08,0,158.87675094604492,140.79087448120117,165.7692527770996,141.6515007019043,159.32668685913086,-0.06423424628812822,8.703164722612462,-1.4962284339269796,2.9940931886819735,153.42325019836426,7.871130561828613,0.05719679452915453,140.99006195068358,163.447664642334,0.7766921397072213,-0.005688715525292262,1.0441306316666885,1.0799446853531716,1.0470519108742304,0.058245334644026814,57.0938653859307,169.56808596072784,152.16175651550293,134.75542707027802,152.11557170322962,6.6791192749704456,147.987884249006,7.1228241788706,151.34592629575474,152.18256395208297,12.830055976117087,0.1534424178978725,76040000,5.461940408691045,0.7823262580339165,-403542000.0,-4.672800175030474,77.07053933241427,82.84087432937385,64.05298227384357,28.67016918716778,27.108964373784968,-0.11247077234192655,6.934978627754743,156.23899279785155,152.24750036621094,149.02149963378906,145.79549890136718,141.80400646972657,0.1,0.0,159.0603428227444,0.06759550803103997,0.0791583817472552,152.45907156808036,147.75299944196428,9.23656474064635
2022-02-09,0,162.0368766784668,140.79087448120117,165.7692527770996,141.6515007019043,158.9323444366455,-0.05959190668598894,8.655470675887328,-1.4802998139359491,2.9941100499778157,153.42325019836426,7.820162582397461,0.056904530018795155,140.99006195068358,163.447664642334,0.7563683020347166,-0.028148232187161153,1.0652953095651678,1.0881971173458473,1.0557102571008323,0.0632314801659759,55.97274056369085,169.41606677902075,152.1051254272461,134.79418407547143,154.22853578839982,7.20106816605669,148.5300807952881,7.898878940146707,153.25146118311574,152.99494315336526,12.128638014588633,0.7843831901432675,68786000,5.398672612620537,0.7055242096366734,-334756000.0,-9.286419529536936,77.07053933241427,82.84087432937385,84.69196565112455,29.78517498225182,26.040789934485737,-0.14985186711145948,6.688633418820998,157.11263360595703,152.954188873291,149.59325408935547,146.23231930541994,142.0738745727539,0.12000000000000001,0.0,159.1106948436449,0.07022654583978727,0.06611396928552188,154.11849975585938,148.43314252580916,8.959069423289272
2022-02-10,0,158.9550018310547,140.79087448120117,165.7692527770996,141.6515007019043,158.9323444366455,-0.0753322676320735,8.566003613643502,-1.4837923007157314,2.9941414819714134,153.42325019836426,7.755295009613036,0.05634303589994222,140.99006195068358,162.17761421203613,0.7109492949676087,-0.02251549087725891,1.045529254783154,1.052999334003337,1.0227880981024944,0.1290149479984859,58.61787588664883,169.16505757366153,152.03305034637452,134.90104311908752,155.4889292035784,7.136433077956671,149.4275185721261,8.338635726717042,155.47465408105174,153.8881364203183,10.044915128720337,4.914821687141282,68268000,5.423570505573513,0.6937226775817462,-403024000.0,-16.961324398153035,77.07053933241427,82.84087432937385,67.86708550904189,28.61984886553747,27.86571538108715,-0.14473625844973992,6.450239230847001,157.11263360595703,152.954188873291,149.59325408935547,146.23231930541994,142.0738745727539,0.12000000000000001,0.0,159.11153096870228,0.14518287456759404,0.05571244777768514,155.23421369280135,149.60174887520927,8.564632043410793
2022-02-11,0,155.79050064086914,140.79087448120117,163.44425201416016,141.6515007019043,158.89631366729736,-0.17188784117176215,8.137680297602305,-1.5575206844613032,2.9942879001413085,153.42325019836426,7.448653717041014,0.053645954803473755,140.99006195068358,161.17985038757325,0.7151368384932622,-0.027466552832439393,1.0270162811204424,1.0199101643428976,0.9795295377544775,-0.003026935734239178,55.16738972946649,167.9676983942769,151.69233779907228,135.41697720386765,155.97323281424386,7.005735662908308,150.4868218558175,8.119351289580118,156.36312996700428,154.06862053354374,5.876654768180764,8.58259030914238,77100000,5.441807145478873,0.7736784748800347,-480124000.0,-39.75334814556499,77.07053933241427,82.84087432937385,36.00274554273523,26.578574096230412,31.584589488399068,-0.14977356984815407,6.437003875235222,157.57672564697265,153.70538870239258,150.57649993896484,147.4476111755371,143.57627423095704,0.12000000000000001,0.0,159.02896198505275,-0.027569188917847987,0.10405809011801795,155.6172136579241,150.2267129080636,8.263068731756764
2022-02-14,0,154.2541275024414,140.79087448120117,162.0368766784668,141.6515007019043,158.8607177734375,-0.2180988829079758,7.746596891456878,-1.5620738457445695,2.994415996041811,153.42325019836426,7.104234905242919,0.05119697837950652,140.99006195068358,159.2976749420166,0.7151350521223252,-0.032865486667319636,1.019459943682045,1.000616177518296,0.9704468404766283,-0.030452696762435894,51.78759645125244,166.80284401332148,151.30965023040773,135.81645644749398,157.89655467442103,2.615312051062001,151.43401854378837,7.688736742288548,156.225118306956,154.12407061844613,2.2244861710556103,10.520870586169014,83230000,5.461269483094539,0.8198659135550245,-563354000.0,-32.68778704453395,77.07053933241427,82.84087432937385,41.365557700434685,24.535021180140106,30.382079435285704,-0.16617804295459,6.46342896565612,157.57672564697265,153.70538870239258,150.57649993896484,147.4476111755371,143.57627423095704,0.12000000000000001,0.0,158.9451666023356,-0.01752926753697248,-0.015684447542759883,157.9488568987165,151.31107112339564,7.906482441838411
2022-02-15,0,156.69012451171875,140.79087448120117,162.0368766784668,141.6515007019043,157.94402885437012,-0.21703937013867386,7.4531278430302,-1.520971993935016,2.994508536728433,153.32725143432617,6.796862506866455,0.04936888383611268,140.99006195068358,158.96941413879395,0.7126163295060307,-0.02896499993768458,1.0379020349850896,1.0118183339439248,0.9918185509888415,-0.013763035946453561,50.51106548419974,165.87438102938316,150.96812534332275,136.06186965726235,157.95750100272042,2.575582407521136,152.51677758353097,7.241283040827724,155.7251058700736,153.5413929718414,9.562589245113248,9.405231797445099,56440000,5.45042518373739,0.5589557707924813,-506914000.0,-28.272555383428266,77.07053933241427,82.84087432937385,56.10588613962129,23.567832329030768,29.184395182740108,-0.17096653880904664,6.237647288268231,157.72092346191405,153.9387936401367,150.8820037841797,147.82521392822267,144.04308410644532,0.12000000000000001,0.0,158.90877254735625,-0.030375401939519153,-0.009022689907241813,157.7875714983259,152.57092830113,7.791018995580115
2022-02-16,0,156.86487197875977,140.79087448120117,162.0368766784668,141.6515007019043,156.92765522003174,-0.22001829172069085,7.3528241873716285,-1.5007216436170174,2.9945395486703013,153.32725143432617,6.699426307678223,0.048739433047584574,140.99006195068358,158.96941413879395,0.699442939160785,-0.00602715898543828,1.0398052136834353,1.0086753044723276,0.9956808985044442,-0.03191868916339302,53.945539454358226,165.56551127452352,150.85986289978027,136.15421452503702,157.63832201276506,2.5488283215386742,153.64942904881067,6.505370520340628,155.95140448200732,153.33483858806915,0.273015961828884,10.710426142159296,52704000,5.477032832921928,0.5220952360196578,-454210000.0,-22.13475799753786,77.07053933241427,82.84087432937385,64.47823470211549,23.40110327892945,27.75104065680383,-0.12873909847183312,6.0818553617167765,157.72092346191405,153.9387936401367,150.8820037841797,147.82521392822267,144.04308410644532,0.12000000000000001,0.0,158.88668785549393,-0.019163807429488533,-0.020524947310059796,157.81114196777344,153.88971383231026,7.871586326806643
2022-02-17,0,156.91187286376953,140.79087448120117,162.0368766784668,141.6515007019043,156.733811378479,-0.21933556459434964,7.318937529020399,-1.4917481389632972,2.9945499429518394,153.32725143432617,6.664534416198731,0.048527280425644775,140.99006195068358,158.96941413879395,0.7155406492510947,0.01566078105076614,1.0403841303988322,1.0060892808930004,1.00256178646986,-0.012853505355287287,55.33811274763631,165.45896918951053,150.82109413146972,136.18321907342892,157.35762514386857,2.4973866972597425,154.7365984235491,5.555748115451004,156.15205564756337,153.22272105537806,-1.4043150337710462,11.245566537432188,64032000,5.426676813588889,0.6368175037294879,-390178000.0,-36.00573696482968,77.07053933241427,82.84087432937385,54.8451858314158,23.57657746967726,25.803791524328552,-0.12704520184941834,6.064913023885014,157.81614666748047,154.09292611694335,151.08374786376953,148.07456961059572,144.3513490600586,0.12000000000000001,0.0,158.84930331657935,-0.027364165454227374,-0.040554766954617766,156.84528459821428,154.65217808314733,7.921227264189572
2022-02-18,0,153.62337493896484,140.79087448120117,162.0368766784668,141.6515007019043,156.8766222000122,-0.24024948103218727,7.399289398320588,-1.521781307367029,2.994525357682954,153.32725143432617,6.775493068695067,0.049019972281556176,140.99006195068358,158.96941413879395,0.7482642775685413,0.07186923403112856,1.0177482155268027,0.9749267431923676,0.9841198715938542,-0.013910512470205028,58.86096765108875,165.74296031977354,150.94438152313234,136.14580272649113,156.15569632393974,1.7962201677158254,155.1921160561698,5.140260056222216,156.29746380309626,153.15059197833128,-1.2367310324357463,10.74190835201467,63604000,5.073796325397449,0.6657901678606869,-453782000.0,-44.04837766796089,77.07053933241427,82.84087432937385,17.512153781536846,22.25226681283197,28.752672096132105,-0.06762367258053861,5.958941018569078,157.81614666748047,154.09292611694335,151.08374786376953,148.07456961059572,144.3513490600586,0.02,1.0,158.7596388380971,-0.004514224869933914,-0.04026322080239698,155.61842782156808,154.86846378871374,7.695264249542952
2022-02-22,0,150.5359992980957,140.79087448120117,162.0368766784668,141.6515007019043,156.8766222000122,-0.37916260484200554,7.344442739921708,-1.4235063021506313,2.994546221071306,153.93875122070312,6.609442291259768,0.04854032502658462,140.99006195068358,158.96941413879395,0.7271649684706137,0.08983468637662193,0.9949109269261146,0.9569369266407248,0.9670269661667013,-0.02410391387606048,55.16970799213655,165.99489210215785,151.30600662231444,136.61712114247104,154.95298167637415,2.344414177759883,155.22095543997628,5.110735823959317,155.5982787185248,153.00490955695525,-5.192337640645248,4.331011578875675,66128000,4.962138366246205,0.7262280247054586,-519910000.0,-53.47529748388497,77.07053933241427,82.84087432937385,-12.797908552441871,21.011465576491418,30.13459521080693,-0.1579211760257849,5.852843748981044,157.81614666748047,154.09292611694335,151.08374786376953,148.07456961059572,144.3513490600586,0.04,0.0,158.630975462634,-0.032026865899139834,-0.02019660484023729,154.3604278564453,154.79732077462333,7.53869111875414
2022-02-23,0,148.22287368774414,140.79087448120117,162.0368766784668,145.85747146606445,156.8766222000122,-0.48863938238950855,6.9562574950314815,-1.1795858348118275,2.994673566091517,153.93875122070312,6.0348976135253904,0.045829739056295934,141.00631370544434,158.96941413879395,0.6880428406646086,0.06768137512609046,0.9765330895435584,0.9473897819453404,0.9567380069680822,-0.05403819066683646,49.85250561724868,165.69730884382275,151.78479385375977,137.87227886369678,153.871892111642,3.4007180618023725,154.92256246294295,5.401751907454282,154.31787806113618,152.7650933881593,-5.296469086205366,0.26893047887569016,64244000,5.0315390192277025,0.7159876872050802,-584154000.0,-74.53482896509055,77.07053933241427,82.84087432937385,-58.04307582371449,19.189095580057696,32.1972050169299,-0.17783789116133958,5.944119514221412,157.81614666748047,154.09292611694335,151.08374786376953,148.07456961059572,144.3513490600586,0.06,0.0,158.4576386245805,-0.07464995858467216,-0.06663795201604873,153.1509268624442,154.38407026018416,7.219837215430314
2022-02-24,0,145.61112213134766,140.79087448120117,162.0368766784668,147.97868728637695,156.8766222000122,-0.532997072192512,6.562810424600978,-0.964170154282677,2.994794232254165,153.93875122070312,5.601127624511719,0.04313487589566816,141.4791233062744,158.96941413879395,0.6407450139145643,0.04727835025482571,0.9570469472377824,0.9370774778319887,0.9502670040157488,-0.07174168254149293,46.04148808295633,165.27188969380643,152.1462688446045,139.02064799540256,152.63717705862862,4.597315665211632,155.26686586652482,4.512075216481442,152.81844147315883,152.34798715867782,-4.857566361231497,-2.741136082131331,100786000,5.07059870666579,1.1200062231211174,-684940000.0,-51.27082881339565,77.07053933241427,82.84087432937385,-61.023064670665086,16.52993425591451,33.56291150125105,-0.09276784250609112,6.400673163249752,158.0915604248047,154.53872296142578,151.66725158691406,148.79578021240235,145.24294274902343,0.08,0.0,158.20642245049683,-0.042646879138607874,-0.03292109093121312,152.6067831856864,155.27782004220145,6.555908948813193
2022-02-25,0,151.88550186157227,140.79087448120117,162.0368766784668,147.97868728637695,156.8766222000122,-0.5190781016906705,6.287337386549186,-0.8700364263019704,2.9948741004263875,153.93875122070312,5.356350173950193,0.04126896663671497,141.62312660217285,158.96941413879395,0.5753417175007981,0.032646224187552024,0.996949475359111,0.9878989682010445,1.0059905086503937,-0.032033082713639804,42.48903670712252,164.92492482650414,152.35025005340577,139.7755752803074,151.95080239432198,4.23581415313411,154.9541516985212,4.588748583130843,150.99954364239832,151.611588705752,-5.603095042599074,3.42369323857712,62396000,5.11085854172797,0.6992637088007531,-622544000.0,-41.282968373186115,77.07053933241427,82.84087432937385,-8.938972148825023,18.2010778036183,31.717136967521153,-0.023208692705979445,6.283178179011458,158.0915604248047,154.53872296142578,151.66725158691406,148.79578021240235,145.24294274902343,0.08,0.0,158.12392775931957,-0.005586708482210656,-0.027273769615589742,152.21792602539062,155.00274876185827,5.8311094292037
2022-02-28,0,152.82200241088867,140.79087448120117,162.0368766784668,149.65490436553955,156.8766222000122,-0.583931575009295,5.728261831531394,-0.5096731279030244,2.995024901175381,153.93875122070312,4.75306137084961,0.037465542645723326,145.21916007995605,158.96941413879395,0.4949951248644788,0.07194503641908263,0.9995282019082062,0.9985818354912769,1.0189779185274608,-0.005216475216708094,52.24614318861584,164.35066123630497,152.89413757324218,141.43761391017938,151.37324959891183,3.695237209506184,154.50578580583846,4.457377517287489,151.2110246000335,151.8824057215504,-3.06632129186109,-2.8016768765999442,57684000,5.2857450789885085,0.6525664173329895,-564860000.0,-42.20961307661341,77.07053933241427,82.84087432937385,-8.935557550545905,17.969333245532386,30.36187426568367,-0.048679740856531185,6.089249137562584,158.0915604248047,154.53872296142578,151.66725158691406,148.79578021240235,145.24294274902343,0.08,0.0,158.05768832973718,0.006300737974172632,-0.007044779901070574,151.56971304757255,154.69042750767298,5.421976714629515
2022-03-01,0,151.9876251220703,140.79087448120117,162.0368766784668,150.43506145477295,156.8766222000122,-0.6210499944533501,5.121383704328152,-0.04815489855866817,2.99517117245558,153.93875122070312,4.140883827209473,0.03337479041877474,147.0826274871826,158.96941413879395,0.4803120528217046,0.0378677144264038,0.9904657466710634,0.9950598979188742,1.0144986683347883,0.009643047714454456,51.63514793201912,163.69343002157134,153.45066261291504,143.20789520425873,150.66978563581193,2.8333062838577363,154.01370538984025,4.3157366728512425,151.6173559696806,152.2840470396261,-2.5772944043319765,-3.9454161053184484,44874000,5.153941220073772,0.5174352168202767,-609734000.0,-52.15847141873581,77.07053933241427,82.84087432937385,-32.90954681639392,17.069935030950628,29.902259340294705,-0.09428696691969257,5.947184880425732,158.0915604248047,154.53872296142578,151.66725158691406,148.79578021240235,145.24294274902343,0.08,0.0,157.9953297594004,0.006288412381850295,-0.009564146878098473,151.0682133265904,153.95674896240234,5.372192690641143
2022-03-02,0,151.16275024414062,140.79087448120117,162.0368766784668,151.54812622070312,156.8766222000122,-0.7402604580524184,4.9350357708326555,0.42744517440561447,2.995212322586807,153.93875122070312,3.8865377426147463,0.032110797206313164,147.9616985321045,158.96941413879395,0.47213844999741483,0.012358285597607984,0.9835706656730453,0.9911301716269567,1.0070412004405238,0.019834162455855564,49.1256394605655,163.55780900657012,153.68773746490479,143.81766592323945,150.31826782226562,2.5436233313120233,153.23698207310267,3.6945183879693557,151.70119573798502,152.50044851944756,-3.1382250761702637,-4.336144705221332,47334000,5.12229772083483,0.5495671639018409,-657068000.0,-40.836135194128495,77.07053933241427,82.84087432937385,-42.36734558185815,16.171306967308478,29.848134437722475,-0.10541527422060168,5.824683507500513,155.70941131591798,152.61180130004882,150.1082534790039,147.604705657959,144.50709564208984,0.08,0.0,157.92600977245735,0.04989062709729741,0.01235047889726082,150.98978533063615,153.30410657610213,5.354910952985839
2022-03-03,0,150.55374908447266,140.79087448120117,162.0368766784668,151.70481395721436,156.8766222000122,-0.7741925795719934,4.902920145340481,0.5397056305452907,2.9952192499602797,153.93875122070312,3.8350126266479494,0.031891138691792505,147.9616985321045,158.96941413879395,0.4772278401053718,-0.008120879749123698,0.9792797659952138,0.9907276624652359,0.9990706235478682,0.033944020764200555,46.742356322116365,163.54510287155256,153.73926258087158,143.9334222901906,150.32080350603377,2.5438853921710494,152.63689259120397,3.361610711211506,151.568455888243,152.5973818406141,-1.6017254508318375,-6.710896097993749,65198000,5.099831395360052,0.766827799536596,-722266000.0,-59.71749758482391,77.07053933241427,82.84087432937385,-68.14306960737326,14.776921566788717,29.58339688643471,-0.11139123323454221,5.914693440117871,155.42863525390624,152.38468139648438,149.92449951171875,147.46431762695312,144.42036376953126,0.08,0.0,157.80895973765405,-0.022856427375935517,0.021208081183541026,150.66135733468192,152.5108925955636,5.470273446057816
2022-03-04,1,146.11425399780273,140.79087448120117,162.0368766784668,151.01049995422363,156.8766222000122,-0.7111863280183857,4.944476184909015,0.3753302120792714,2.9952102103074583,153.93875122070312,3.9273439407348634,0.032180767582814136,147.9616985321045,158.96941413879395,0.45325008103197234,0.06934309229377685,0.9509741118362945,0.9655231943536113,0.9632912290901938,-0.03799735849067032,50.989066322698214,163.5358836366027,153.64693126678466,143.75797889696662,150.01957212175643,2.9293538578106846,151.94573211669922,3.6460439754983667,151.3244937879799,152.59384683199517,0.011791057594007457,-5.285302538331761,60934000,4.321377714015635,0.7934827477989559,-783200000.0,-70.54531748587488,77.07053933241427,82.84087432937385,-145.43880505488983,14.023633514614906,31.874165449807496,-0.00561403988615465,5.7833200549558095,155.42863525390624,152.38468139648438,149.92449951171875,147.46431762695312,144.42036376953126,0.08,0.0,157.65349591417507,-0.05297854888381748,-0.037771344591677844,150.77764456612724,151.96428571428572,4.6591902633516415
2022-03-07,1,141.60187530517578,145.61112213134766,162.0368766784668,151.01049995422363,156.8766222000122,-0.19697986341534748,4.3531770418468465,-0.7115543992328544,2.9953314340195605,153.93875122070312,3.6611749649047853,0.028283343230594993,148.01201171875,158.96941413879395,0.7275989086515222,-0.06494956405011784,0.9200118448784889,0.9424296896259643,0.9407007576679106,-0.07341957917516106,33.42965577060367,162.61945432630841,153.91310024261475,145.20674615892108,149.44682257516044,4.094988364282971,151.04199981689453,4.498287812994253,150.07783701535135,152.40190047402774,-1.4226007346096665,-6.211063321102133,86934000,2.662743453250527,1.2697211795463508,-870134000.0,-99.84084146425853,77.07053933241427,82.84087432937385,-202.68041473957487,12.561035748408177,36.23017585636327,-0.12990386202757276,5.991768998178705,154.93693017578124,151.58878588867188,148.88275146484375,146.17671704101562,142.82857275390626,0.1,0.0,157.3400567504514,-0.10490808488355163,-0.10622052504280569,148.79121616908483,150.69899967738561,5.842438649903479
2022-03-08,1,136.74249649047852,141.60187530517578,162.0368766784668,150.54931163787842,156.8766222000122,-0.40836007652902845,5.070979808389856,-0.384450922747539,2.9951815759843234,153.22268867492676,4.1302436828613285,0.033104708052574414,146.06394081115724,158.96941413879395,0.6873932034267776,-0.10997703232711169,0.8926914710265499,0.9174283973397631,0.9221659092679129,-0.10030506509557946,25.733110055149794,163.3219786139721,153.18001899719238,143.03805938041265,147.2835360935756,6.100651113006706,149.6171692439488,5.596717477390123,147.96745987579348,151.0204319396652,-2.7533932624702646,-8.202213063676611,91662000,2.6787931483094067,1.349580161045011,-961796000.0,-90.88005926516888,77.07053933241427,82.84087432937385,-214.82760330503996,11.500214223059078,37.725481644762105,-0.09567666766037794,6.073470669542181,154.02974395751954,150.1203742980957,146.96074676513672,143.80111923217774,139.8917495727539,0.12000000000000001,0.0,156.95502362479056,-0.10008801400309053,-0.11427562163991016,146.25207301548548,149.23499952043807,6.820331524246253
2022-03-09,1,138.96425247192383,136.74249649047852,162.0368766784668,149.9577178955078,156.733811378479,-0.7468091977478778,6.018563424942319,0.29028642203056876,2.9949405816995287,152.4048137664795,4.620362854003906,0.03957961884457721,145.21019744873047,158.8845760345459,0.6844890925533568,-0.13931713937858203,0.9138646147794072,0.9410432213514225,0.9568232762624849,-0.0806977760891171,21.406071675958124,164.0993144261786,152.06218757629395,140.0250607264093,145.30385753086634,6.250461907780609,148.33855356488908,5.8524789805793205,145.16012567898036,149.0471781448329,-9.970013717895876,-12.730622356323652,82656000,2.8119542857938367,1.2110822465153692,-879140000.0,-78.68835923810067,77.07053933241427,82.84087432937385,-158.4193881244491,10.910496101463893,35.790961144507904,-0.11796572996700228,5.941265038336941,154.02974395751954,150.1203742980957,146.96074676513672,143.80111923217774,139.8917495727539,0.12000000000000001,0.0,156.6535459734913,-0.08400715590793417,-0.07848904650689,144.2115020751953,147.89060756138392,6.971322315043516
2022-03-10,1,146.28874969482422,136.74249649047852,162.0368766784668,147.6957187652588,156.01540660858154,-0.621500570381556,6.441096041454878,-0.22766972692621845,2.9948144785079642,151.9365634918213,5.018587875366211,0.04263747005528716,141.33811302185057,157.11618576049804,0.7361968104791337,-0.14239119316232232,0.9683727962437899,0.9968938323293349,1.024464555918451,-0.028328749138325615,25.475001035022615,163.94875473549763,151.0665626525879,138.18437056967815,144.48973246983118,5.568771714062527,147.57975905282157,5.319837746073727,143.6088033986499,147.63654462301298,-9.067902344130959,-11.411490208757359,135062000,2.7429506224485194,1.8873028848505173,-744078000.0,-39.59497789852249,77.07053933241427,82.84087432937385,-50.039034796041705,19.505149589028502,31.885030685463253,-0.06989529753393486,6.189604319185372,150.32472399902343,147.1233817138672,144.53599548339844,141.94860925292969,138.74726696777344,0.02,1.0,156.38525779796922,-0.007309023844395468,-0.03442890068382935,143.59371730259485,147.33096531459265,6.560327745061445
2022-03-11,1,147.53575134277344,136.74249649047852,158.9550018310547,146.24512577056885,154.63822078704834,-0.7041270197169942,5.999307859925369,-0.32858648942355284,2.9949273739922146,151.52412605285645,4.840847034454347,0.039921090905069234,141.33811302185057,156.86957206726075,0.7872328996022779,-0.07968451442435762,0.9817446076480925,1.0049275540806621,1.0394063273755891,0.009728669900967324,42.8322443534936,162.27777202325652,150.27915630340576,138.280540583555,143.97158976963587,4.982253040773293,147.14492879595076,5.0286740731865045,144.27241432439436,147.2887799906528,-3.7495654153875932,-6.770120689444756,68900000,3.2981367096598615,0.9623563623767548,-675178000.0,-42.751719742616,77.07053933241427,82.84087432937385,-38.45182056320654,19.695787691751914,30.255385820055643,-0.10712172774533855,6.05424692156982,149.5229063720703,146.474791015625,144.01124572753906,141.54770043945314,138.49958508300782,0.04,0.0,156.2586430180257,-0.0007999179442391702,-0.016051501154067258,142.66114589146204,146.8254656110491,6.269146628835476
2022-03-14,1,144.04199981689453,136.74249649047852,156.91187286376953,146.24512577056885,153.78106307983398,-0.7102296347327604,5.681416667680416,-0.29398728543641184,2.9950052202073794,150.85824966430664,4.658417510986328,0.037949937971115115,141.33811302185057,156.70759925842285,0.807631050778709,-0.052986217157904185,0.9621517445433752,0.9840456820011741,1.0127639586123929,0.017232289519188093,46.23407838015469,161.07102711435255,149.7081937789917,138.34536044363085,143.04133987426758,4.073484471305492,146.68107169015067,4.991183299198145,145.09305252605463,147.21902357671428,-2.3993999153291914,-3.9626935670499637,74086000,3.269273893392603,1.036974206515836,-749264000.0,-60.33767763852224,77.07053933241427,82.84087432937385,-77.84090449041739,18.170718930101962,33.20172949693095,-0.09957105642312775,6.091005623587516,149.5229063720703,146.474791015625,144.01124572753906,141.54770043945314,138.49958508300782,0.04,0.0,156.07745454852133,0.032010896835299674,-0.026009224567821673,141.79750279017858,146.22943006243025,6.405476054371751
2022-03-15,1,145.05037689208984,136.74249649047852,156.91187286376953,145.98847103118896,153.02234554290771,-0.5300074955747583,5.629297650282205,-0.49587405680064833,2.9950145569948132,150.54487419128418,4.696354370117189,0.03774992375596253,141.33811302185057,156.70759925842285,0.7880554473049337,-0.0662032702196915,0.9727040580587383,0.9969142579409183,1.0163664131840024,0.06075565837127894,41.67617587483614,160.37936403835738,149.12076873779296,137.86217343722853,142.88935743059432,3.9579328003783742,146.45446477617537,4.987815475711463,144.8445778566371,146.87107073434086,-4.325199011765901,-4.313917940878426,75584000,3.3326004167355747,1.0636330758590022,-673680000.0,-33.92884811595728,77.07053933241427,82.84087432937385,-39.26104690445472,17.488255783289755,30.802926158256483,-0.05994556676372275,6.093949331632065,149.5229063720703,146.474791015625,144.01124572753906,141.54770043945314,138.49958508300782,0.04,0.0,155.93162210007551,0.08346172908977789,0.07212281807968811,142.04400198800224,146.41082327706474,6.227402889607831
2022-03-16,1,150.52687454223633,136.74249649047852,156.91187286376953,145.4709358215332,152.1962194442749,-0.35827862666110627,5.566691598317404,-0.5626953438348008,2.995027641953649,149.37943649291992,4.643206024169922,0.03744564667452661,141.33811302185057,156.70759925842285,0.7667674009924702,-0.0742851386193032,1.0125540564943627,1.0395098532054827,1.0426015325866285,0.08320572999627074,42.484003063441634,159.7939644039102,148.66058120727538,137.52719801064057,144.16435732160295,4.818126825968664,146.8055899483817,5.0957387320646825,144.91575748735235,146.82978422452567,-0.7281131557013522,-2.1403557472092216,84958000,3.2803973145176446,1.172028473678402,-588722000.0,-6.447097998286836,77.07053933241427,82.84087432937385,44.87924831148045,22.394812649522347,28.692591472248726,-0.005444812187913449,6.072599664818878,149.5229063720703,146.474791015625,144.01124572753906,141.54770043945314,138.49958508300782,0.06,0.0,155.85749454992904,0.09926116828511256,0.12564475536149042,144.2798592703683,146.53553771972656,6.03557310737879
2022-03-17,1,154.87950134277344,136.74249649047852,156.91187286376953,145.4709358215332,151.91103267669678,-0.41922035018530485,5.276700245610052,-0.3668154987735006,2.99509620494282,149.37487411499023,4.3350435256958,0.03556868362198804,141.33811302185057,153.94752464294433,0.7138104892527595,-0.040404185822952327,1.0439971433616062,1.0700381417970426,1.0558376212180507,0.058724622815292005,51.92955065541331,158.90581920002143,148.35241870880128,137.79901821758114,146.75535801478796,5.033609998797446,147.01944705418177,5.380216209738521,146.30669480348618,147.5268809217877,6.302882089538487,3.375945696273425,72934000,3.549923014786979,0.9923060701093205,-515788000.0,-1.0846197262143538,77.07053933241427,82.84087432937385,115.56419722331846,26.146486860202167,26.860542294338885,0.016416629801357475,6.021363785370786,151.8519662475586,148.35876876831054,145.5354995727539,142.71223037719727,139.2190328979492,0.08,0.0,155.85441865420538,0.07098263615494438,0.12894973799240977,147.31193106515067,146.78200204031808,5.963553161915326
2022-03-18,1,158.9171257019043,136.74249649047852,156.91187286376953,145.4709358215332,151.91103267669678,-0.5228604856700123,5.132324872072041,-0.348070988885651,2.9951291068374535,149.37487411499023,4.235774993896484,0.034618656439640384,141.33811302185057,153.7489875793457,0.6399339692007291,-0.012952311918172013,1.0719308528160816,1.0946619537001965,1.0708203247880668,0.07714316194918913,57.880777702555434,158.51779992114604,148.25315017700194,137.98850043285785,149.60576847621374,5.512966032077768,147.45481300354004,6.086169336004041,148.43100103186154,148.5673071088793,13.263619809338362,1.9712213769618965,102962000,3.701188222583528,1.3647111841582058,-412826000.0,-1.225810913316529,77.07053933241427,82.84087432937385,168.94959991938939,29.302650856544776,25.064816760740513,0.11605519652376577,5.98992098114114,154.98092022705077,150.88978128051758,147.58324432373047,144.27670736694336,140.18556842041016,0.1,0.0,155.9236751581517,0.10806425940648179,0.09830570727071518,150.45071629115515,147.33110918317522,6.502198388035538
2022-03-21,1,161.31237411499023,136.74249649047852,158.9171257019043,145.4709358215332,151.91103267669678,-0.33941319252193314,5.316770708484221,-0.21640698996649776,2.99508708028653,149.37487411499023,4.336037635803223,0.035838546666764386,141.33811302185057,153.7489875793457,0.6415147145454185,0.03445927916270997,1.0873519594180165,1.101447433430707,1.0705400480797673,0.11989818469647551,63.93277335423228,158.98695423587714,148.35341281890868,137.71987140194022,151.75200053623743,6.784229069718546,148.1208665030343,7.053715747373847,151.0321708498962,149.74155631621082,14.358277668576473,3.988380727159837,66538000,3.7311472951184723,0.8802172696569907,-346288000.0,-5.39619640694785,77.07053933241427,82.84087432937385,172.74134857264724,29.864252007001653,23.97320704919829,0.13100612512051746,5.813604291222335,156.11928442382813,151.81060467529298,148.3282470703125,144.84588946533202,140.53720971679687,0.12000000000000001,0.0,155.98774531094335,0.13844264462304978,0.10972031941805334,152.5470014299665,148.07035936628068,7.079299063546827
2022-03-22,0,163.64012908935547,136.74249649047852,161.31237411499023,145.4709358215332,151.91103267669678,0.04760173699052371,5.926918073678692,-0.12363134289720401,2.9949382376681943,149.37487411499023,4.720487594604492,0.039848078780965974,141.33811302185057,155.28326377868652,0.6985771167953284,0.07158669598728239,1.1001914780362085,1.1025034963465228,1.0616520571021713,0.12816066111358992,67.79418201934304,160.59169892506733,148.73786277770995,136.88402663035257,154.05262592860632,7.7744805537569555,149.0121078491211,8.167891520567608,153.59094269207833,151.1025579448323,10.26984265810398,6.1352027741934,64086000,3.671195755880264,0.8489268862613358,-282202000.0,-3.9209049704276087,77.07053933241427,82.84087432937385,177.73419079782246,31.973660611970075,22.57143636736066,0.1597981697268567,5.732019470242586,158.47470239257814,153.71590350341796,149.8697509765625,146.02359844970704,141.26479956054686,0.14,0.0,156.08022647763121,0.11890427344250165,0.16239354301704365,155.3133588518415,148.98725237165178,7.932577900926844
2022-03-23,0,164.04249954223633,136.74249649047852,163.64012908935547,145.4709358215332,152.1962194442749,0.27598454298423025,6.755832637210359,-0.27617605276330215,2.9947130815275407,149.37487411499023,5.37569408416748,0.045221861163611134,141.33811302185057,159.1566505432129,0.7444177588225384,0.10401400956569168,1.0980596378855747,1.0855423022647888,1.039196038815476,0.08978878383745115,71.11293641898898,162.90473454169367,149.39306926727295,135.88140399285223,156.9098401750837,7.130854485968814,149.97559002467565,9.10548322000057,156.10190093467696,152.75298999684156,10.91557646198333,8.254268214267617,55812000,3.625536665949549,0.7434760020780882,-226390000.0,-9.031146585329882,77.07053933241427,82.84087432937385,149.9879435577218,30.72308781119936,21.504735819500716,0.17874879270199417,5.585172588653946,158.62978497314452,153.8413498840332,149.97124481201172,146.10113973999023,141.3127046508789,0.16,0.0,156.15816448331614,0.06730066224003939,0.10885448058571451,158.39264569963728,150.09507424490792,8.41421139790017
2022-03-24,0,162.89187622070312,136.74249649047852,164.04249954223633,145.4709358215332,153.33637714385986,0.2641877068161156,7.461732084502205,-0.6064038392040016,2.9945022252931075,150.5403118133545,5.970557689666748,0.049683918210218274,141.33811302185057,161.54514961242677,0.789607429205627,0.12657946138388218,1.0846150147989841,1.0603314968578963,1.0145339723027378,0.05173295890330243,72.92585913648861,165.107514729002,150.18405055999756,135.26058639099313,159.45862579345703,5.078684921509211,151.17399161202567,9.646210594312056,158.10487817985802,154.2543674870057,13.885186092088649,8.959425148685874,56798000,3.5371471002484323,0.7794471219822807,-283188000.0,-8.294807382653063,77.07053933241427,82.84087432937385,117.40785788583248,29.0877390795437,23.81007948399577,0.1493910819463074,5.476503089299494,158.62978497314452,153.8413498840332,149.97124481201172,146.10113973999023,141.3127046508789,0.16,0.0,156.22088267592318,0.04076919381861788,0.06887802696160507,160.71878923688615,151.3813956124442,8.910095090512696
2022-03-25,0,164.0979995727539,136.74249649047852,164.04249954223633,145.8482847213745,155.88890743255615,0.11460650004534866,7.871451103615794,-0.8559879678585691,2.994375817034164,150.85824966430664,6.3060503005981445,0.05211221932073658,141.33811302185057,162.96670150756836,0.8553378337985471,0.07246494381775831,1.086395739649746,1.056761528409487,1.0119461585522533,0.032601104808350545,68.57546189428072,166.7909904716969,151.04808826446532,135.30518605723375,161.39735794067383,3.4204062982724137,152.7808576311384,9.801484339383862,159.33801608929846,155.32473292489,12.300208872870737,11.482536278187268,49032000,3.3338522355806375,0.6791004052552998,-234156000.0,-4.867738554221912,77.07053933241427,82.84087432937385,116.10252084860632,29.550532932653272,22.807940367269467,0.132207724192971,5.307590025728244,158.62978497314452,153.8413498840332,149.97124481201172,146.10113973999023,141.3127046508789,0.16,0.0,156.28674832748715,0.021847962752205685,0.047917502643181856,162.3858598981585,153.3328595842634,9.404768412246185
2022-03-28,0,166.97574996948242,136.74249649047852,164.0979995727539,145.8482847213745,159.51593780517578,0.06548075608375055,8.370592924448612,-1.0791239711744967,2.994209448053882,150.85824966430664,6.966271476745606,0.055193616974503944,141.33811302185057,163.68036613464355,0.8664776690315057,0.0737851682609664,1.1009967479039995,1.0639458993642996,1.023154683137239,0.0351081303313725,69.6816013682204,168.39989899892166,151.65871315002443,134.9175273011272,163.1253934587751,2.5142371674496644,154.94037573678153,9.314483843232761,160.55207319931395,156.12894536859807,9.015748896526551,15.886883008501975,59854000,3.3359157366626366,0.8277428125332769,-174302000.0,-0.1459579455412477,77.07053933241427,82.84087432937385,126.55241084957761,32.84756130413862,21.4768870902684,0.15222447563549768,5.232849454313263,161.43606335449218,156.73347589111327,152.93275451660156,149.13203314208985,144.42944567871095,0.18,0.0,156.40101980153418,0.046435836438715405,0.04799978954765331,164.06464494977678,155.68828800746374,10.165734823485753
2022-03-29,0,169.59975051879883,136.74249649047852,166.97574996948242,145.8482847213745,161.70724964141846,0.061734089503348015,9.012708984159962,-1.210095441058023,2.9939831152047347,150.85824966430664,7.782605133056643,0.05915155147677347,141.33811302185057,164.04804954528808,0.8647981056352848,0.09861411305936424,1.1131046604181147,1.0651012697046387,1.032070290490522,0.03641907069255068,73.24851834873148,170.39181849627403,152.3664005279541,134.3409825596342,164.65148271833147,2.7638582342846068,157.1286255972726,8.860011940235673,162.16037149993105,157.08745026071693,7.810103029669515,22.109625211580855,66154000,3.3552178341398857,0.9016012505809287,-108148000.0,-5.063845159502078,77.07053933241427,82.84087432937385,119.83095285394349,34.00662205237338,20.578187621454735,0.1622461734753374,5.07031539035626,163.76388848876954,159.3915542907715,155.85774993896484,152.3239455871582,147.95161138916015,0.19999999999999998,0.0,156.54332447456102,0.026842267646082885,0.04844528377975278,165.21671622140067,157.8337162562779,10.82925763898196
2022-03-30,0,167.31525039672852,136.74249649047852,169.59975051879883,145.8482847213745,163.0789394378662,0.05231388891563947,9.761951643274246,-1.2816585029744394,2.9937032680732907,150.85824966430664,8.71339448928833,0.063700765497855,141.33811302185057,164.38577461242676,0.8678647295917145,0.12196788061133373,1.0918010987157551,1.0348006582455633,1.010836504124298,0.01995062781672341,76.19517783448245,172.77091008433902,153.24700679779053,133.72310351124204,165.50903647286552,2.470887051293283,158.63051850455147,8.661064126794777,163.99502528483714,158.25504164550597,6.722135685321247,22.04559626085461,56168000,3.35629720178086,0.7609231652929733,-164316000.0,-15.12815143284119,77.07053933241427,82.84087432937385,90.09128594147127,32.1417018764178,22.85435359613889,0.1231208478022685,4.980443889821184,163.76388848876954,159.3915542907715,155.85774993896484,152.3239455871582,147.95161138916015,0.19999999999999998,0.0,156.63931102067977,0.017704090546485363,0.008563259161482435,165.9037867954799,159.22539411272322,11.198302339970025
2022-03-31,0,164.72275161743164,136.74249649047852,169.59975051879883,145.8482847213745,163.74072170257568,-0.06095672277843655,10.213814633209168,-1.4045478148641475,2.9935288687897597,152.71662521362305,9.312593841552735,0.06629995160489441,141.33811302185057,167.00970001220702,0.8981833228231614,0.11133234086951445,1.0692489390743292,1.0082974168477843,0.991254016090905,0.011239820175242166,70.56751528767157,174.48226107183825,154.05463180541992,133.62700253900158,165.66369683401925,2.366068722447057,159.85816138131278,8.171735344265786,164.7946806412403,158.9638913894589,3.7212745238373213,14.373286220415503,59966000,3.4180780670319137,0.8152649753922289,-224282000.0,-26.159115354377448,77.07053933241427,82.84087432937385,64.22797522025363,30.471145082754045,25.40372811542467,0.11506332069143199,4.877441830726802,163.76388848876954,159.3915542907715,155.85774993896484,152.3239455871582,147.95161138916015,0.19999999999999998,0.0,156.71276587184673,-0.003984173702141214,-0.002512160911269259,165.6335710797991,160.4734649658203,11.266051169806616
2022-04-01,0,163.9640007019043,136.74249649047852,169.59975051879883,145.8482847213745,164.05637454986572,-0.2058274357914061,10.435407888745448,-1.453611168586204,2.993445741087143,156.89831352233887,9.600110683441162,0.0674282765532286,141.33811302185057,167.00970001220702,0.9086808837979434,0.1273557993863401,1.0594516383039922,0.9976419451417172,0.9845186495760573,-0.0008165783324506348,66.81823575700311,175.63389770955874,154.76308193206788,133.89226615457702,165.6524827139718,2.375201506654284,161.28116144452775,6.830149803252945,164.75418000540054,159.29079496918575,0.661587432190919,11.64937997619792,57090000,3.2891808269282543,0.7781979177173951,-281372000.0,-25.220679957300895,77.07053933241427,82.84087432937385,57.33852809143164,28.870684495777923,25.01883058660382,0.10782939232298329,4.779394221613447,164.02726385498048,159.8178652648926,156.4157485961914,153.01363192749022,148.80423333740234,0.02,1.0,156.77910041094208,-0.007364661109647952,-0.0005469497527910195,165.65528433663505,162.02396501813615,11.20600566466491
2022-04-04,0,166.01787567138672,136.74249649047852,169.59975051879883,145.97915649414062,164.05637454986572,-0.40125306827542684,10.420841532218953,-1.344887317369322,2.9934683043124144,160.11474990844727,9.526824550628664,0.06694808018289113,141.33811302185057,167.00970001220702,0.8916764927148979,0.15792252290821987,1.0665720247138788,1.007046366639272,0.9970115396610694,-0.005736607251476733,67.7055552705774,176.49725233171088,155.65556926727294,134.813886202835,166.09905406406946,2.0398560076155228,162.77883992876326,5.069196758117946,164.5410921867724,159.6919401138107,-0.04785274581348354,13.83068890346879,49882000,3.057996517263158,0.6975605936019421,-231490000.0,-10.584380893950167,77.07053933241427,82.84087432937385,70.85656685896213,30.46210690256311,23.086893511290416,0.20512952080965186,4.808705314259592,165.29068994140624,161.86290240478516,159.09249877929688,156.3220951538086,152.8943076171875,0.02,0.0,156.85803169783287,-0.0038108486341396075,0.02168430044053875,166.32628304617745,163.52253614153182,10.665320340187678
2022-04-05,0,165.79325103759766,136.74249649047852,169.59975051879883,147.22400093078613,164.25418758392334,-0.613184446564335,10.129024610323292,-1.0680290224179434,2.9936173716632233,162.10212516784668,9.098095169067381,0.06456692398256644,143.53422508239746,167.00970001220702,0.8358776085073065,0.21409130250116992,1.0568401843606001,1.0028214587135644,0.9968093902235671,-0.022444015805195727,73.57944380169555,177.13441850623008,156.8763692855835,136.61832006493694,166.34123284476144,1.8549401460196984,163.86929539271765,3.6835031390379873,164.89521693934375,160.48610089065957,1.919064058448292,14.45532181891236,53728000,2.7095519450581356,0.7718154067157479,-285218000.0,-36.25447563442577,77.07053933241427,82.84087432937385,55.725879130056455,28.16860882280699,21.34867671279237,0.2054179872212159,4.828151700213347,166.4203037109375,163.69134503173828,161.48574829101562,159.28015155029297,156.55119287109375,0.02,0.0,156.9287953426803,-0.031066412838669177,-0.029205791334163615,166.22363935198103,164.30474962506975,9.497915918682462
2022-04-06,0,159.96524810791016,138.96425247192383,169.59975051879883,149.7790937423706,164.99037647247314,-0.7295916243041246,9.175738173555262,-0.9346498325807988,2.994027247009234,163.2660026550293,8.101484298706055,0.05795365070514491,144.9495391845703,167.00970001220702,0.8187463366604588,0.19306402969421455,1.0103350747873032,0.9663115763343038,0.9661917794116939,-0.04392906367704352,72.23005593958634,176.68038336004997,158.32890701293945,139.97743066582893,165.33973257882255,2.9965081783124865,164.23256301879883,2.8951450191698886,165.1176399250706,161.3068060320611,1.0330725964103842,10.141960724148124,79056000,2.7321655573733556,1.1386022395852087,-364274000.0,-81.47838513460644,77.07053933241427,82.84087432937385,-0.28107758451992665,25.410731323395197,27.91322155456081,0.1578459033298622,4.969256704184195,167.3338602294922,165.17006787109375,163.42124938964844,161.67243090820313,159.5086385498047,0.04,0.0,156.95950743123296,-0.04536953116068321,-0.06236308410389549,164.7615683419364,164.41310664585657,8.327024003157527
2022-04-07,0,157.6937484741211,144.04199981689453,169.59975051879883,153.79134464263916,164.99037647247314,-0.7815227134952796,8.02969207502337,-0.8635030509350052,2.994445290275634,163.2660026550293,6.841231822967529,0.05038113083752118,146.16491241455077,167.00970001220702,0.8713751432772908,0.09348974847086153,0.9894264063806866,0.9549419865478621,0.9610044818500263,-0.042671720052585016,53.618113596936155,175.43834094478552,159.37895679473877,143.31957264469202,163.63887514386857,3.510395883617806,164.14517893110002,3.0804539992970494,163.82502734320514,161.22694849476773,-4.198514971697118,3.2836797129667517,68136000,2.811504562994104,1.031017065590093,-432410000.0,-79.94487385781083,77.07053933241427,82.84087432937385,-27.790973102225642,23.39156257848163,29.610106917504517,0.1535212129770956,5.012050596443932,166.9799790649414,164.59726022338867,162.67150115966797,160.74574209594726,158.36302325439453,0.06,0.0,156.96478648937523,-0.03198207036675205,-0.051211327734256795,163.1143537248884,164.16553497314453,7.778127642076556
2022-04-08,0,155.70249938964844,144.04199981689453,169.59975051879883,156.99018669128418,164.99037647247314,-0.9332467702276775,7.4649239838771955,-0.3623280412634542,2.9946262963487076,163.2660026550293,6.099906902313231,0.04667059084766456,147.28721389770507,167.00970001220702,0.8551743827178981,0.06885108889808907,0.9734496504810715,0.9458610278699953,0.9570688934547554,-0.05038606814233404,48.276767171217465,174.879054701458,159.94920673370362,145.01935876594925,161.97991071428572,4.1661825016096845,163.7444735935756,3.765896633568459,162.27366699739918,160.81673837626948,-7.020058701889449,-0.7698208876984134,46002000,2.885581867545812,0.7083627830055758,-478412000.0,-98.61755811495226,77.07053933241427,82.84087432937385,-60.79229879200798,22.18012590575757,28.485425528720825,0.17520741045470886,4.907725674401601,166.91378051757812,164.49010833740235,162.53125,160.57239166259765,158.14871948242188,0.08,0.0,156.9533541951222,-0.05563403460076943,-0.05237505293851344,161.42285374232702,163.66332026890345,7.117362031467875
2022-04-11,0,152.1264991760254,144.04199981689453,169.59975051879883,157.19593620300293,164.99037647247314,-1.0462999328034783,6.982505501400201,0.17730453220669196,2.9947688625489155,163.2660026550293,5.60829788208008,0.04354335518805553,149.97922477722167,167.00970001220702,0.7727117349300109,0.08095208055689782,0.9486706721260414,0.9288749044902015,0.9446825121149183,-0.08367398052278241,46.06147405548429,174.32255513884778,160.35754413604735,146.39253313324693,160.1804460797991,5.339202370942869,162.92207145690918,4.882175703997689,160.61492430813541,160.31084349717608,-6.940641082952436,-3.4776468675260106,52112000,2.7932103601752383,0.8162574832478627,-530524000.0,-97.10551322223091,77.07053933241427,82.84087432937385,-118.021598826585,20.8927217051851,32.29706767674559,0.191619854855922,4.837512962854868,166.04140588378905,163.07804431152343,160.68299865722656,158.2879530029297,155.32459143066407,0.1,0.0,156.91331295297073,-0.1023157767651165,-0.07604551067312942,159.72635323660714,162.67996215820312,6.048453786372306
2022-04-12,0,152.4905014038086,145.05037689208984,169.59975051879883,157.19593620300293,164.99037647247314,-0.8894442639369112,6.218491857962649,0.040831332103497875,2.994974974689194,163.2660026550293,5.123227920532225,0.03868140971961829,151.96653671264647,167.00970001220702,0.6841312060536469,0.04878389450307892,0.9485495354629727,0.9396168536492171,0.9635670132392994,-0.08023697919267136,39.300241434772744,173.1987528199292,160.76176910400392,148.32478538807862,158.54137475149972,5.730860487365244,162.09692873273576,5.601466582175219,158.5013646020811,159.59061637616102,-7.64694149273382,-7.035945264405821,55178000,2.9427005143497413,0.878318686199009,-475346000.0,-98.02180860867703,77.07053933241427,82.84087432937385,-129.86932470909474,20.858944658742306,30.04137568548763,0.11062617845037372,4.828823472285092,166.0056508178711,163.02016958618165,160.60724639892578,158.1943232116699,155.20884197998046,0.12000000000000001,0.0,156.87293558187397,-0.08087219020810843,-0.10430267831537288,157.9017116001674,161.77849796840124,5.675205710212035
2022-04-13,0,152.79612350463867,150.52687454223633,169.59975051879883,157.19593620300293,164.99037647247314,-0.5049390019465779,5.441466122494752,-0.91170232749695,2.995158599619522,163.2660026550293,4.676820449829103,0.03376986675428257,152.45410118103027,167.00970001220702,0.7260017941729177,0.01304502513284624,0.9482563366501097,0.9515314504876414,0.9820073702674719,-0.04481676294113146,36.777286026030644,172.01670757457936,161.13377532958984,150.25084308460032,156.65255301339286,4.986529931223748,161.37580353873116,6.117354236245948,157.02367177294877,159.01095369079215,-6.997572179856214,-7.042076395241356,53390000,2.6862526739945887,0.8717602895961883,-421956000.0,-72.01800741253403,77.07053933241427,82.84087432937385,-111.91136458225088,20.259761491108044,27.249138191265228,0.08223857947447975,4.94296007256215,165.82086529541016,162.72106759643555,160.21575164794922,157.7104356994629,154.61063800048828,0.14,0.0,156.8476188535968,-0.020251180457031337,-0.05189718502743987,156.07235499790735,161.1993190220424,5.513512287420865
2022-04-14,0,153.61637496948242,152.1264991760254,169.59975051879883,157.19593620300293,164.99037647247314,-0.41734554875218455,5.239006061954139,-1.0557144639748388,2.995201887682023,163.2660026550293,4.540665512084962,0.03249051663865683,152.76556129455565,167.00970001220702,0.790121006757641,-0.013451604764170262,0.952676009131101,0.9653681255590386,0.9964615153887708,-0.025856278667304333,34.49596493621296,171.72524990161824,161.24723777770996,150.76922565380167,154.9129992893764,2.991002372767126,160.62711606706893,6.393730201249428,155.98528897041467,158.47407785471208,-7.964053336593093,-6.197824563323011,51598000,2.494474451119301,0.8574358019911229,-370358000.0,-90.07845902084695,77.07053933241427,82.84087432937385,-116.27803694585387,18.95316853218885,25.491786205016552,-0.009361386194342817,4.905925521401028,165.82086529541016,162.72106759643555,160.21575164794922,157.7104356994629,154.61063800048828,0.14,0.0,156.8181662429924,-0.03852091254201295,-0.04440461877391635,154.30828421456474,160.26596178327287,5.862882340997806
2022-04-18,0,152.14962768554688,152.1264991760254,169.59975051879883,157.19593620300293,164.99037647247314,-0.42417982765073714,5.322339315682868,-1.0868008553720199,2.995184367185503,163.2660026550293,4.616453094482421,0.033020254031941726,152.76556129455565,167.00970001220702,0.8541744228556085,-0.033355440510326045,0.9439494664006627,0.9628710901037486,0.9921956302488798,-0.02281833443925929,33.92968640986054,171.82876009041115,161.18408145904542,150.53940282767968,153.79648208618164,2.1237271091432905,159.56810733250208,6.488444642097441,155.40098203316157,158.20089992105753,-7.344615050315788,-6.3874176593020495,46514000,2.3095415411888833,0.8109884630204673,-416872000.0,-84.99870995747531,77.07053933241427,82.84087432937385,-110.30606240414856,17.889283234236423,25.87046429472868,-0.07483791210734553,4.826069905591385,165.82086529541016,162.72106759643555,160.21575164794922,157.7104356994629,154.61063800048828,0.14,0.0,156.78740211578048,-0.010847377726329155,-0.03168559938455974,153.45528520856584,159.1084267752511,6.154293533105885
2022-04-19,0,155.08612442016602,152.1264991760254,169.59975051879883,155.18096828460693,164.99037647247314,-0.3732369265999235,5.660115859838241,-1.2916639251625501,2.9951101832883875,163.2660026550293,5.022502975463868,0.03518972300195797,152.45641403198243,167.00970001220702,0.8633777485555445,-0.05680126202167088,0.9641918813917704,0.9888478428229048,1.0160532369558766,0.01945502762616025,29.239559923421933,172.16593827790402,160.84570655822753,149.52547483855105,153.42396436418807,1.4470894284337685,158.53141975402832,5.89463308880042,154.58594589920676,157.726479817727,-4.885823961646333,-8.879206882822965,54926000,2.233947418241269,0.9674481849998503,-361946000.0,-55.99343612841974,77.07053933241427,82.84087432937385,-55.28010890824085,22.675342431098514,23.23867799549836,-0.04024416375969238,4.9885283157947,164.38378381347655,161.55861163330079,159.27525329589844,156.9918949584961,154.16672277832032,0.14,0.0,156.7818884898539,0.04627718024287519,0.023663000558249,153.50257001604353,158.30846187046595,6.178731109508864
2022-04-20,0,155.70162200927734,152.1264991760254,169.59975051879883,154.71868705749512,164.99037647247314,-0.23548613708596985,5.795493635011929,-1.4649273458698777,2.9950785573648893,163.2660026550293,5.3182799530029286,0.03610125835314132,152.45641403198243,167.00970001220702,0.8944760738909573,-0.05227327011284959,0.9698957217728885,0.9997407391219796,1.0161450625369337,0.021057840166486264,37.66302356595564,172.1253813435102,160.53439407348634,148.94340680346247,153.42383902413505,1.4468591995146862,157.70187486921037,5.35598255558227,154.7155427023981,157.6816469535441,-1.653600145336777,-8.557575146329055,59630000,2.2779503463810395,1.0544408351355319,-302316000.0,-76.5995570407464,77.07053933241427,82.84087432937385,-61.529748884137184,21.19912234738455,21.725783392907147,-0.10697012473871487,4.954462401049182,163.959,161.2150037841797,158.99725341796875,156.7795030517578,154.0355068359375,0.02,1.0,156.76698546592098,0.021291518628295147,0.019031029194367367,153.4364994594029,157.42967660086495,6.2572201403046375
2022-04-21,0,151.83437728881836,152.1264991760254,169.59975051879883,154.71868705749512,164.99037647247314,-0.06169632657472384,5.840864792871241,-1.5371349937785328,2.995066379760119,161.42856216430664,5.404631805419922,0.03647406718475648,152.45641403198243,167.00970001220702,0.8991768205133432,-0.05084583297763909,0.9481502268203774,0.9812679733465114,0.9867706663669582,-0.006294310312074836,39.36115641587456,171.8191983052249,160.13746871948243,148.45573913373997,153.3821073259626,1.4939609791556372,156.78127670288086,5.160463176382681,154.97040683037696,157.72556829632097,-0.0005634979364705566,-6.941165470519627,63970000,2.2826409762590245,1.1230845938847456,-366286000.0,-96.6041231351904,77.07053933241427,82.84087432937385,-101.50902423136155,18.56062519257517,27.203599063497045,-0.12387447834924621,5.254263923023499,163.48451885986327,160.44698770141602,157.99199676513672,155.53700582885742,152.49947467041017,0.02,1.0,156.71252656322045,-0.046579326995002224,-0.016523257920200447,153.0327867780413,156.37957000732422,6.722069605752461
2022-04-22,0,146.4781265258789,151.83437728881836,169.59975051879883,153.41131210327148,164.99037647247314,0.1048019634720381,6.035537174534033,-1.5656859873488067,2.9950172726124817,158.82949829101562,5.607312774658203,0.037833939119219555,152.14731483459474,167.00970001220702,0.8718069505744195,-0.06788244563469142,0.9182023672491576,0.9516525766551117,0.9531519390938525,-0.04646801778144816,32.70709359642175,171.59813695587957,159.5270626068115,147.45598825774346,152.52319662911552,3.030330375686119,155.53228569030762,5.398850464278227,154.19622806061687,157.17980721287634,-0.19202564233665653,-7.824283046549946,73078000,2.4045637869870373,1.264911758393165,-439364000.0,-97.35793241205208,77.07053933241427,82.84087432937385,-140.17237436683376,17.079828412869084,30.280558262463956,-0.20924994481300185,5.3016719603010225,162.5660072631836,158.96024435424806,156.0459976196289,153.13175088500975,149.52598797607422,0.04,0.0,156.5994302529296,-0.048491602040868664,-0.07194883816065771,152.11314392089844,155.00742776053292,7.409904008633687
2022-04-25,0,144.65625,146.4781265258789,169.59975051879883,152.71971797943115,164.99037647247314,0.06296681517641688,6.610735144216045,-1.3091725606045497,2.994865083607202,156.69812393188477,6.009450149536133,0.04165387268867646,152.0972869873047,167.00970001220702,0.8157249750649499,-0.10737408800076881,0.9114709468270349,0.9467144357977973,0.9501233050664679,-0.0492500560108744,24.82894744238172,171.92784541050236,158.7063751220703,145.48490483363827,151.3603575570243,4.231753189631411,154.00645528520857,5.223209737442419,152.27514180615964,155.9728365913671,-3.9427864834730766,-10.664459333250647,61874000,2.5872814269035085,1.0592088031731413,-501238000.0,-85.3995438447724,77.07053933241427,82.84087432937385,-135.99128264300978,16.161173533397456,30.56289638795864,-0.18393336525194942,5.202558940886034,162.02075994873047,158.2533758239746,155.20850372314453,152.16363162231445,148.3962474975586,0.06,0.0,156.4965595180032,-0.04392445838465875,-0.03712755992439126,150.7607160295759,153.41653551374162,7.723476305963719
2022-04-26,0,141.9941291809082,144.65625,169.59975051879883,152.40528297424316,164.99037647247314,0.059632800540310484,7.153578486833009,-1.117694894753747,2.994704127272496,155.7020606994629,6.247957687377931,0.04535208288386912,151.29875221252442,167.00970001220702,0.8070277943935176,-0.13366911047599234,0.9002109262501888,0.9360590301597509,0.9419098152713544,-0.08441757951077822,20.75739642481578,172.04144461709865,157.73428764343262,143.4271306697666,149.7000367300851,5.335203417512303,152.30651800973075,4.958096482264463,150.37798862066157,154.5851105717977,-5.3272774975809885,-12.86706361287841,77530000,2.4316478036879214,1.3074397419185113,-578768000.0,-98.01679283697965,77.07053933241427,82.84087432937385,-161.32195189643107,14.616174702979635,32.159809376471316,-0.28570383584923964,5.341352996012919,156.7081607055664,153.3106687927246,150.56475067138672,147.81883255004882,144.42134063720704,0.08,0.0,156.32878905566827,-0.11842284938503267,-0.08766565350879733,149.00136021205358,151.65482221330916,8.20019175901944
2022-04-27,0,139.02262496948242,141.9941291809082,169.59975051879883,152.1438455581665,164.15368843078613,0.012912762941529933,7.598083959084606,-0.8639683152124538,2.994552745037495,155.39387321472168,6.319022369384766,0.04855464694699261,146.29593887329102,166.1476131439209,0.7744931490694122,-0.16276923317072187,0.88840746027379,0.9226328940072176,0.9384993072441477,-0.10712153685079218,16.409010046826033,171.6813745221731,156.4852066040039,141.28903868583473,147.82475062779017,6.508662347666218,150.81061635698592,5.5888139135183454,148.29609984268328,152.93653639351317,-7.565759699044523,-14.35469882383356,71336000,2.278697746376828,1.1977527863501582,-650104000.0,-90.18948267524163,77.07053933241427,82.84087432937385,-170.7414288529746,13.423637444875515,33.699442746161274,-0.29672915975481073,5.400218588038962,154.34525634765626,150.79811309814454,147.93124389648438,145.0643746948242,141.5172314453125,0.1,0.0,156.1535947073774,-0.10279999441164367,-0.12616402005856447,146.91307503836495,150.1841801234654,8.469153079887377
2022-04-28,0,143.25299835205078,139.02262496948242,167.31525039672852,152.05346870422363,160.9649362564087,-0.17443136943275775,7.876611142783061,-0.6896653479396555,2.994435240290959,154.35124969482422,6.239886856079101,0.05083116068612065,144.39003791809083,165.81571350097656,0.778774256757249,-0.16909770842861133,0.924473234237739,0.9592821560210235,0.9893360901290219,-0.05651802371767323,14.830140048009197,170.70957261210424,154.9563503265381,139.20312804097193,146.13430404663086,5.807268654416709,149.77913420540946,5.553222478466269,145.9827353210071,150.89528265651475,-8.627692959718905,-13.091983031402018,117316000,2.2969834507211617,1.8735906068136374,-532788000.0,-61.4572169495914,77.07053933241427,82.84087432937385,-108.23085773730682,17.20365496871389,30.339400240171127,-0.2091004842459161,5.569612191350478,153.25274194335938,149.91437762451173,147.21624755859375,144.51811749267577,141.17975317382812,0.1,0.0,155.95265746739975,-0.024946785726155274,-0.061049523042705445,144.9817897251674,149.24217987060547,8.241980758501093
2022-04-29,0,126.62912559509277,139.02262496948242,166.01787567138672,150.4953145980835,158.26162338256836,-0.0911982795995883,7.733357937251413,-0.780106868152322,2.99446423883012,153.20624923706055,6.086798191070557,0.0502972038294123,143.12711143493652,164.82980155944824,0.8394205913988364,-0.13033872403518568,0.8235867255176257,0.8534154638839156,0.8850181349042785,-0.1355082932964693,28.584177260167163,169.219953598807,153.7532377243042,138.2865218498014,141.9810902731759,7.858332480444916,147.70246464865548,8.044866934502418,145.30802526635273,149.68467408671793,-7.630035318992445,-9.157465189205116,272662000,2.608600479775006,3.7223277961622054,-805450000.0,-92.82491999480717,77.07053933241427,82.84087432937385,-245.02609294022074,13.058500008388688,42.61729818277755,-0.21670827117459301,6.81320601627119,149.91133758544922,144.5058332824707,140.13700103759766,135.76816879272462,130.3626644897461,0.12000000000000001,0.0,154.86146097561644,-0.1390266954273952,-0.1619362803379497,140.73657553536552,147.0865374973842,10.1552749473789
2022-05-02,0,122.48600006103516,126.62912559509277,166.01787567138672,146.02265739440918,156.2003116607666,-0.7428296115962297,9.324504025102398,0.6755257498836063,2.9938135346848,152.64331245422363,6.907226305007933,0.06140660303095609,141.6969787597656,164.14692573547364,0.6514711525772746,-0.22770165979719176,0.8066326275745322,0.8407851397700812,0.8804909568854444,-0.15326161115724235,17.234019206900516,170.49756447339203,151.84855642318726,133.1995483729825,137.78846495492118,9.402525052623618,145.5852861404419,10.358579754967957,140.65407251697334,146.5520107105517,-18.671929064716046,-18.672387346717535,148788000,4.328402728968257,1.9115748253042,-954238000.0,-84.79167779610268,77.07053933241427,82.84087432937385,-212.59046017449353,12.191851888561786,43.21641543542985,-0.10273456513934892,6.7760316790668345,149.14433758544922,143.26433328247072,138.51200103759766,133.7596687927246,127.87966448974609,0.14,0.0,154.23997901201835,-0.1476922954786043,-0.13751302573053498,137.33714621407645,145.18496649605888,11.359648167510993
2022-05-03,0,124.3381233215332,122.48600006103516,166.01787567138672,144.3054370880127,155.70184135437012,-0.940007135368486,10.881824308163315,0.6194826978656502,2.9930236830274506,152.32006454467773,8.390334005355836,0.07265464378529371,137.78327503204346,160.5480484008789,0.6937043101275454,-0.26221197828430176,0.8301679757943704,0.8712390040900876,0.9232322209369093,-0.12434321025258932,14.549106894942025,171.5383050074704,149.7746563911438,128.0110077748172,134.62560735430037,9.710995989218734,143.57440199170793,11.576006446377262,136.1187875641859,143.3960776807721,-19.32920446069793,-19.484113074010367,79134000,4.245976975097428,0.9979331104606806,-875104000.0,-85.40373047328613,77.07053933241427,82.84087432937385,-164.8946068809511,13.43689764842455,41.61170820197906,-0.13962311442670608,6.534464300460968,149.14433758544922,143.26433328247072,138.51200103759766,133.7596687927246,127.87966448974609,0.14,0.0,153.9384766829018,-0.10859742648407045,-0.1493797833221527,134.46621704101562,143.28968048095703,11.751933627993427
2022-05-04,0,123.6778736114502,122.48600006103516,165.79325103759766,142.93828105926514,155.23999881744385,-0.9145703336677291,11.542523466930364,-0.014769461060816447,2.9925954853311287,152.13806343078613,9.266797218322756,0.07815336989651182,126.40002536773682,157.9208984375,0.7525515129529852,-0.2500411051512796,0.8374115618705564,0.8856950743366225,0.9430564890165365,-0.11037592882022351,18.440788212751357,170.77571570751184,147.6906687736511,124.60562183979039,131.6286964416504,9.329071190869172,141.49452699933732,12.379637133849746,133.1628711294879,140.82294227152164,-15.114886931895688,-18.461725696425745,110746000,4.323785421356698,1.3481146407494693,-985850000.0,-81.24473127763652,77.07053933241427,82.84087432937385,-146.45296621316953,12.438317322176596,42.48964487701311,-0.046736003853317755,6.554653343759244,149.14433758544922,143.26433328247072,138.51200103759766,133.7596687927246,127.87966448974609,0.14,0.0,153.5164520834854,-0.08857765944300067,-0.09658090214161179,131.58828735351562,141.17450169154577,11.956110442384857
2022-05-05,0,119.49462509155273,122.48600006103516,159.96524810791016,141.25125312805176,153.98381233215332,-0.8898915398022264,11.884491061430204,-0.5997018746993117,2.992310021654211,151.98043823242188,9.862207412719727,0.081632717880784,124.2720983505249,155.9016242980957,0.8055030689413892,-0.2268453612623477,0.8207899663475264,0.8758229629264458,0.9329917871474813,-0.16584904702734915,18.820329577259,169.35388202520411,145.58489990234375,121.81591777948339,128.41448157174247,9.033868373639486,139.05725915091378,13.144794360642988,130.7683275337322,138.49528084808153,-14.502226062510127,-19.056929734414688,144392000,4.247739642927457,1.6904640370143158,-1130242000.0,-96.93757978198632,77.07053933241427,82.84087432937385,-152.813793453844,11.032241610232344,41.966725794039085,-0.08452313977230566,6.862002675772695,148.3649480895996,142.00277909851076,136.8607521057129,131.71872511291505,125.35655612182617,0.16,0.0,152.88747026268973,-0.19495284856625117,-0.15749063519439668,128.3048575265067,138.65310886928015,13.129739639437094
2022-05-06,0,115.43862342834473,119.49462509155273,157.6937484741211,135.924250125885,153.0011863708496,-0.7577690395830224,12.682344055037582,-0.9731987658160728,2.99173203799062,149.15625190734863,10.759544982910153,0.08834092461871142,123.55868625640869,155.70170974731445,0.8129531307470403,-0.24223613017124243,0.8041064558819049,0.8666368934123031,0.936050950374259,-0.0883722612326221,17.031192580145305,168.92605686160107,143.5613687515259,118.19668064145071,125.04533849443708,8.81331359777691,136.43504456111364,13.968037009726062,127.93978906640336,136.0785124770234,-15.845376297698818,-22.21231290265009,124260000,4.277651209676444,1.4084954058974086,-1254502000.0,-96.28901802624773,77.07053933241427,82.84087432937385,-142.18883127365228,10.340109554648935,41.42649681711344,-0.11914398205432859,6.7981955701108925,147.89507092285157,141.24221520996093,135.86524963378906,130.4882840576172,123.83542834472655,0.18,0.0,152.32314272711406,-0.07651181028648246,-0.2062567088590497,124.96278490339007,135.93792997087752,14.090065046445599
2022-05-09,0,110.5146255493164,115.43862342834473,155.70249938964844,126.05637502670288,152.5669069290161,-0.6354099735399336,13.63584776034134,-1.174846092965053,2.990976596348532,145.56718826293945,11.905329141616818,0.09640142465458887,122.18686256408691,155.14767417907714,0.8229709765006857,-0.2585949237753891,0.7813058297048512,0.8494653595517101,0.9126874126357434,-0.0977366760752525,15.47277055534128,168.72030801991977,141.44861249923707,114.17691697855439,120.36842809404645,5.665028455158546,133.25136607033866,14.460776583965275,124.79798806166156,133.3164420599382,-16.964146336838873,-24.128224837377918,128124000,4.3019402400866396,1.3877062079826359,-1382626000.0,-98.32411626992771,77.07053933241427,82.84087432937385,-144.2351955591539,9.599555259703376,43.844544054095465,-0.14285677087749382,6.799431866806971,145.88615704345705,138.63791513061523,132.77974700927734,126.92157888793946,119.67333697509765,0.19999999999999998,0.0,151.67605833373094,-0.12619275931852403,-0.12465652638993951,119.84742845807757,132.41460909162248,15.427261345601913
2022-05-10,0,109.98062515258789,110.5146255493164,155.70162200927734,124.17306089401245,152.2348461151123,-0.5396481932212014,14.782367778686286,-1.2335898552882345,2.9899646327821046,143.9546241760254,13.191212882995604,0.10620339639351038,119.08902492523194,153.7633499145508,0.8354811456678122,-0.27353468233407474,0.7901518960668427,0.8681432982859664,0.9265991623623259,-0.11547140800748146,13.916795835271264,168.75395436459306,139.18921880722047,109.62448324984788,117.99007088797433,6.078230555841399,129.98558058057512,14.160294421571832,121.21361672733426,130.7041894272665,-22.85353408260142,-28.7398366794534,105434000,4.336359286864125,1.1099016780007158,-1488060000.0,-96.59450191762254,77.07053933241427,82.84087432937385,-125.60155498267929,9.039816739597116,42.125650247700655,-0.1416194464655186,6.704552547778787,145.04019247436523,137.8034091644287,131.9545021057129,126.10559504699707,118.86881173706055,0.2,0.0,151.14967271351944,-0.12389591036067149,-0.12563051277375137,117.6442140851702,129.19039481026786,16.49289412120766
2022-05-11,1,107.01499938964844,109.98062515258789,155.70162200927734,123.37990522384644,152.2348461151123,-0.38779824706214006,15.759636620124297,-1.3803945324246816,2.9890003068883138,142.6235637664795,14.40957790374756,0.11496509556553436,114.9462236404419,153.7633499145508,0.8570187911887044,-0.27877065036759713,0.7806645500992204,0.866633826751278,0.9239666873814767,-0.13472801346949337,13.51778283908518,168.60119834629717,137.08192510604857,105.56265186579999,115.77992793491909,6.9247745124949525,126.78419644492013,13.904827143691602,118.4138177181994,128.46862684040883,-13.147449581022817,-29.364496186150976,109704000,4.313095195026013,1.1226326566742018,-1597764000.0,-97.91197777494874,77.07053933241427,82.84087432937385,-120.40342914439026,8.482260354552054,42.48075227569265,-0.1519172822928516,6.634744464228175,138.95098956298827,132.35375936889648,127.0217514038086,121.68974343872071,115.0925132446289,0.2,0.0,150.57846129475064,-0.1632394263799778,-0.15195950179769258,114.91164289202008,126.12439455304828,17.5277955127488
2022-05-12,1,105.71662521362305,107.01499938964844,155.70162200927734,121.73815631866455,151.9131898880005,-0.2526656517465519,16.629067415683437,-1.4466560550564487,2.9880134969737466,140.5083770751953,15.369872884750368,0.1233535762861864,110.46122550964355,153.7633499145508,0.8595709272800977,-0.2996222879541861,0.7842005487756858,0.8789008790215841,0.9397977350135102,-0.11530225620920986,12.293420916883079,168.06628483670744,134.80815000534056,101.55001517397369,113.11971391950335,6.660895778393056,123.87266063690186,13.7303368145704,115.58471269152952,125.9564980062077,-12.630831820516198,-29.51859697353966,132026000,4.273254644135951,1.2988024841592059,-1729790000.0,-89.67273487084387,77.07053933241427,82.84087432937385,-107.01436587070667,7.731348833026774,40.858437620277776,-0.16311203352317333,6.759079327504908,135.88092193603515,129.48378677368163,124.3134994506836,119.14321212768554,112.74607696533204,0.2,0.0,149.91098312522254,-0.08140834875614911,-0.1508633987046898,112.43692779541016,123.45157241821289,17.796956281812072
2022-05-13,0,110.7770004272461,105.71662521362305,155.70162200927734,118.48062467575073,147.81718921661377,-0.11180170346657117,17.23723198259493,-1.4814955551247042,2.9871857638109036,132.8258752822876,15.925050449371337,0.13013732463155495,109.68406257629394,153.7633499145508,0.8636072173698474,-0.31181408730270577,0.8363420809598094,0.9506378836031532,1.009513088420464,-0.04038183116409222,11.371576870647285,166.92863905597966,132.4541750907898,97.97971112559992,111.27673203604562,4.768694620308775,121.452714238848,12.734993277400385,113.1367892292277,123.50065671843731,-14.976499250962425,-27.82770525471894,93684000,4.214763063430865,0.9029226148941174,-1636106000.0,-75.53639034909231,77.07053933241427,82.84087432937385,-79.85046668344046,9.771754672531747,38.14314393648302,-0.0945915579171173,6.722958318833715,135.66394854736328,129.30827688598632,124.17150115966797,119.0347254333496,112.67905377197266,0.2,0.0,149.49910177192172,-0.01496437555161012,-0.02879549719754579,110.59785679408482,121.09307207380023,17.628312811352327
2022-05-16,0,112.06424903869629,105.71662521362305,155.70162200927734,114.27321767807007,145.11171913146973,0.06775915925317551,17.135845362230327,-1.4936105210452693,2.9870744313537423,125.48362445831299,15.736602315902712,0.13149839021532073,109.68406257629394,152.4432773590088,0.8858939881512632,-0.2719206605211488,0.8599673980344181,0.974947232674532,1.0299949507512067,0.014021886077769663,23.12482144284523,164.58389708813863,130.31220636367797,96.04051563921732,110.21524974278041,3.205253355453542,119.31486565726144,11.470861741701835,112.5630263385882,122.01437279856931,-10.431027642611191,-23.420522495746923,74566000,4.540138891812129,0.709078633307658,-1561540000.0,-80.69236601326438,77.07053933241427,82.84087432937385,-72.38320012865877,10.269417227499495,36.618326652773554,-0.12735861229811402,6.502592939196315,135.66394854736328,129.30827688598632,124.17150115966797,119.0347254333496,112.67905377197266,0.02,1.0,149.18064897699844,0.018581838297709652,-0.034520447123172114,109.79835728236607,119.05160740443638,17.260925636415923
2022-05-17,0,113.93000030517578,105.71662521362305,155.70162200927734,111.74243688583374,143.6038112640381,0.2576034321727811,16.80553037402849,-1.4073379279542253,2.9872132635462427,124.0079984664917,15.156275329589846,0.130978104008741,109.68406257629394,152.15955200195313,0.871143502274654,-0.2774063478748944,0.8879419511060718,1.000248137416643,1.044168907977768,0.03590973543847831,24.32885476534708,161.91899817939242,128.30793743133546,94.69687668327849,109.99973215375628,2.823487757467034,117.52253532409668,10.02372348938413,112.45719686913014,120.91098058091985,-6.218167593030684,-21.07825183679223,76448000,4.456530992846445,0.719611503166091,-1485092000.0,-70.22191002669904,77.07053933241427,82.84087432937385,-57.46568059764156,11.716385060420746,34.57702155482326,-0.11891775403338918,6.394493504372157,135.66394854736328,129.30827688598632,124.17150115966797,119.0347254333496,112.67905377197266,0.04,0.0,148.88049847599453,0.05979752272982619,0.06047944371602529,109.88350023542132,117.4231425694057,15.90936089145555
2022-05-18,1,109.41349983215332,105.71662521362305,155.70162200927734,111.74243688583374,142.30884647369385,0.4189127717462325,15.89572186633008,-1.2633254801569616,2.9879109717397347,123.08193683624268,13.956820411682127,0.12590657698349103,109.68406257629394,147.01375160217285,0.8518797133113616,-0.26827993931632027,0.8666406820334418,0.9694542207842057,0.9955680391728692,0.02241275013955568,27.990563706454363,158.04157495824614,126.25013122558593,94.45868749292573,109.84242847987584,2.8206926071677376,115.10542828696114,6.950824315599616,112.81239042386451,120.09560388149873,-1.3068616710466758,-18.04931008158913,108380000,4.5075056906897775,0.9973075089765038,-1593472000.0,-83.4000428347108,77.07053933241427,82.84087432937385,-79.70432626619123,10.557911997959216,36.609133856445524,-0.1310530147059248,6.589172735161629,124.06910375976562,119.92920086669922,116.583251953125,113.23730303955078,109.09740014648438,0.04,0.0,148.39875877709056,0.016517683792547144,-0.0160436719913358,109.64400046212333,114.74571446010044,14.946907855755095
2022-05-19,1,107.45662498474121,105.71662521362305,151.83437728881836,110.71140670776367,139.76550102233887,0.5256885864863973,14.768940056071607,-1.1941996130465038,2.9887517843435254,120.99031257629395,12.671995429992677,0.119166124554977,109.17364978790283,144.83843765258788,0.8312245553237169,-0.2793891489802229,0.8670351093966847,0.9643031304495964,0.9735129308238479,0.016459093048062368,25.251272069124425,153.47360522887297,123.93572511672974,94.39784500458651,109.48185702732631,2.9580601271519624,113.73596395765033,6.370207092874078,111.97984619834543,118.60224314909459,-0.9963619852937167,-23.622192141999953,88142000,4.522463036796567,0.8021572389089308,-1681614000.0,-79.36804956881018,77.07053933241427,82.84087432937385,-78.64250272077707,10.104728110795522,35.100317469273165,-0.12159117198858228,6.392840700970875,120.60015835571289,117.12316911315918,114.3129997253418,111.50283033752441,108.0258410949707,0.04,0.0,148.00682079989934,0.0036332388052906506,0.018477380762836625,109.4240003313337,113.53410720825195,14.136205681282972
2022-05-20,1,108.01675033569336,105.71662521362305,146.4781265258789,110.38112545013428,129.72750043869019,0.6390424779002001,13.70618201900067,-1.0634823277839827,2.9895199988747767,117.46662425994873,11.708371410369873,0.11260711583004156,107.41246242523194,143.3933235168457,0.830334844177723,-0.2663981474001417,0.8874429582048518,0.9799154205598954,0.9755119043990622,-0.024917176678434738,24.77832609098509,149.12920153952723,121.71683750152587,94.30447346352452,109.62496430533272,2.8407308759439123,112.70244612012591,6.004652326037531,110.86522308963623,117.05741165168315,-2.2949498280673204,-15.140672037535218,99500000,4.462191623995838,0.8947656658180632,-1582114000.0,-78.2258986845658,77.07053933241427,82.84087432937385,-75.46151776985369,9.543278420507024,34.49521276421125,-0.09202271090973843,6.285370961898063,120.60015835571289,117.12316911315918,114.3129997253418,111.50283033752441,108.0258410949707,0.04,0.0,147.56961467052594,-0.04833043096243195,0.006176976873045837,109.74100058419364,112.32632173810687,13.351773405340742
2022-05-23,1,107.19674873352051,105.71662521362305,144.65625,109.83884382247925,124.9108738899231,0.8199547132583898,12.762828040918793,-0.7088252742984533,2.990199571153682,114.68431186676025,10.770697555541995,0.10653999936951097,107.41246242523194,142.12001609802246,0.8139403680602618,-0.25328666866662614,0.8948441133788656,0.9790685662066007,0.9729571768455951,-0.04343490762602631,26.431153200736112,145.31942477385417,119.7937686920166,94.26811261017903,109.83641052246094,2.5405596937645525,111.47806222098214,5.134065273014158,110.15784988741042,115.8085443338691,0.9360846159494733,-11.812982478105027,107798000,4.500245266762632,0.9497746666255501,-1689912000.0,-78.16653290555652,77.07053933241427,82.84087432937385,-76.15030733478247,9.006504672811957,33.7789121822912,-0.0924933945560765,6.184186875893499,120.43169854736328,116.98690188598633,114.20275115966797,111.41860043334961,107.97380377197265,0.02,1.0,147.09810484252347,-0.02936095279628681,-0.04863120679131184,109.83050101143974,111.13371440342495,12.02581287850483
2022-05-24,1,103.69625091552734,105.71662521362305,143.25299835205078,109.06431245803833,123.84293603897095,1.0101188616297958,11.67941953893582,-0.19900494584733108,2.9909705609529844,112.99712467193604,9.752915115356444,0.09904461443595619,107.1785737991333,139.319775390625,0.7904161687954172,-0.2450621067794567,0.8793720575019591,0.9499759445969057,0.9495756728517051,-0.08982488687997947,26.282654804403744,141.27963270656426,117.92079362869262,94.56195455082097,108.82487487792969,3.375921638457264,110.05080345698765,4.168235045025545,109.41139824537959,114.37475556340635,1.4000858586873681,-13.7860972404142,102934000,4.503235812651377,0.896882163865235,-1792846000.0,-87.22965717637943,77.07053933241427,82.84087432937385,-95.44085178574974,8.352210279313606,34.42835925641581,-0.04627246063161548,6.192245853847832,118.25059692382813,115.00370315551758,112.37950134277344,109.7552995300293,106.50840576171876,0.04,0.0,146.62312398957658,-0.097673986448506,-0.06055836367474472,108.55121503557477,109.5745359148298,11.214653579001503
2022-05-25,1,105.56387710571289,103.69625091552734,143.25299835205078,107.87671899795532,122.78396844863892,1.1758954066887102,10.671580417485304,0.5314933329391858,2.9916347020886125,111.42062473297119,8.686007299423219,0.0919917042466286,106.88516197204589,127.86847553253176,0.7511135738260569,-0.2541052153324666,0.9099871417287722,0.9726854792989172,0.9851422391032912,-0.03518416586934858,23.90591588013367,137.34906055039414,116.00589971542358,94.662738880453,107.89625031607491,3.227104944394889,109.05575002942767,3.316036635248419,107.97831854581091,112.57548742857604,-6.391894964125792,-16.15618227614235,93120000,4.511825405122961,0.8037432061171487,-1699726000.0,-69.00030705418398,77.07053933241427,82.84087432937385,-72.33940741768231,11.17184952575103,32.595838111340306,-0.023536454042263982,6.073141782504037,114.85194171142578,112.25452917480469,110.1552505493164,108.05597192382814,105.45855938720705,0.04,0.0,146.22783125897683,-0.0031509069087463093,-0.07448738822265927,107.97471509660993,108.886536189488,10.054522142070988
2022-05-26,1,109.79162406921387,103.69625091552734,143.25299835205078,107.39165592193604,120.24246883392334,1.426681721308957,9.489321304675668,1.8098070407965903,2.992407164770116,110.64581298828125,7.498663320541382,0.08299724866684588,105.70135040283203,124.56722354888916,0.6248318803510247,-0.26309481602413065,0.9602797114604451,1.0129952046522546,1.032011468053272,0.02172968939610964,26.0677545398315,133.31160493158646,114.3329623222351,95.35431971288375,107.3050537109375,2.130138754653508,108.65239293234688,2.780038282375269,107.37173428612763,111.18534798013403,-5.800575998808318,-11.658054054871988,93002000,4.372683865274754,0.8112370488354201,-1606724000.0,-32.47939040406926,77.07053933241427,82.84087432937385,-25.84244880505928,15.689542767676247,30.332455355864408,-0.03476519887010887,6.060094059936914,112.36856283569335,110.24572270202637,108.53000259399414,106.81428248596191,104.69144235229493,0.04,0.0,145.88129233185956,0.03502174952205639,0.03701711961650933,107.36171504429409,108.6226076398577,7.077281822658801
2022-05-27,1,114.12787437438965,103.69625091552734,126.62912559509277,107.39165592193604,116.45262384414673,0.7669630768917961,6.816217672526102,-0.7377510137244649,2.9939278896938264,110.24762535095215,5.7375116157531725,0.06050261059394822,105.70135040283203,123.7438985824585,0.793947042455536,-0.13296705198548261,1.013030198407634,1.049059465888936,1.0680825126345521,0.05657570719082172,41.35483504847111,126.29232895314547,112.65989360809326,99.02745826304104,107.97853578839984,3.3205229679318418,108.91048213413784,3.113894584284242,107.95189863268027,110.43342581098105,-3.632384995064298,-4.891776418865628,93660000,2.943753964990997,0.8861589466005501,-1513064000.0,-4.49452116107405,77.07053933241427,82.84087432937385,31.356525620592677,17.953909161065397,28.828485200921897,0.059172344462032955,5.920750379567667,112.36856283569335,110.24572270202637,108.53000259399414,106.81428248596191,104.69144235229493,0.02,1.0,145.57684135149282,0.07022423786186627,0.07293675278228098,108.50942884172711,109.07671465192523,6.555364869324139
2022-05-31,1,118.53975105285645,103.69625091552734,124.3381233215332,107.39165592193604,114.45556163787842,0.7974931770046206,6.034972776676762,-0.4878624384148553,2.994300537690032,110.24762535095215,4.927872085571289,0.0538669333480932,105.70135040283203,122.60518741607666,0.7976336658791982,-0.06823739596754427,1.058061586249602,1.0862674582855714,1.09682580968998,0.10581479805449523,51.658692729020416,124.10477660041163,112.0348310470581,99.96488549370459,109.5618395124163,5.161946643163429,109.5218482698713,4.042060283574098,109.50108575229567,110.77786485814175,4.308768615818389,3.269475698002392,144634000,3.0567441984447927,1.3711411355612773,-1368430000.0,-8.608822421213082,77.07053933241427,82.84087432937385,105.78851227960055,24.609518732532838,26.472929457065373,0.022356341790683736,5.986989228926748,117.10115789794921,114.07392132568359,111.62725067138672,109.18058001708985,106.15334344482423,0.04,0.0,145.19104978589735,0.11763533810559768,0.11728210868002692,110.3509292602539,109.8874647957938,6.187631058972526
2022-06-01,0,122.43537330627441,103.69625091552734,124.3381233215332,107.39165592193604,114.45556163787842,0.7980489858975643,5.747722743687216,-0.3087884494031341,2.9944281857807846,110.24762535095215,4.691097145080567,0.051393511013212226,105.70135040283203,119.91294994354249,0.6984938542151471,-0.04663390530418743,1.0947611753426616,1.1153474762593751,1.1095801443220694,0.18071166725219667,57.901903331763705,123.33296408402362,111.83751859664918,100.34207310927474,111.62164279392788,6.994226234891773,110.62330354963031,5.232202453297678,111.77342954558317,111.69796465039936,10.314046313746625,7.782394297535192,127528000,3.207487376686235,1.1818642665107257,-1240902000.0,-14.611827141048654,77.07053933241427,82.84087432937385,156.93969875836643,26.978736140882763,24.88392918655797,-0.0038897751411419265,5.914304368983146,119.53411715698243,116.04194334411622,113.21950149536134,110.39705964660646,106.90488583374025,0.06,0.0,144.90107406805453,0.16891450424142307,0.13134430121315455,112.36421421595982,111.05260740007672,5.938681602626708
2022-06-02,0,123.21249961853027,103.69625091552734,123.6778736114502,107.39165592193604,114.45556163787842,0.7137528430448765,5.552453141826101,-0.48357476389105125,2.994511102032075,110.24762535095215,4.576932144165039,0.049689769337039065,105.70135040283203,119.7886999130249,0.6198661322103524,-0.010046261864747564,1.1026478799731458,1.1137970118856269,1.0799427095775118,0.16718429633977783,63.28581907531367,122.84728737953843,111.74238109588623,100.63747481223403,113.90960720607212,7.870197055697062,111.87300886426654,6.002787370495678,114.43548521395809,112.92185700033865,13.348506528636536,14.409544460659585,100560000,3.339553648902636,0.936358184940053,-1140342000.0,-0.40656685684278426,77.07053933241427,82.84087432937385,174.81635425747282,25.157653516601172,23.90472497335177,-0.009234660625407556,5.889352034243301,119.86340097045898,116.30830119323731,113.43500137329102,110.56170155334473,107.00660177612306,0.08,0.0,144.68982845822623,0.1754717845308964,0.2056772663461246,114.92907169886998,112.37978635515485,5.886701564273435
2022-06-03,0,122.99912452697754,103.69625091552734,123.21249961853027,107.39165592193604,114.45556163787842,0.6884250260723868,5.503142404709536,-0.5433419325320452,2.994531614043763,110.24762535095215,4.549009704589844,0.04925873726235169,105.70135040283203,119.7886999130249,0.6800005501417523,0.0311133201525092,1.1009676132292376,1.0981698229692987,1.0457204124699626,0.12029606602264598,66.43208262765009,122.7253972056593,111.71911239624023,100.71282758682116,116.66716057913644,7.032282516430302,112.74601772853306,6.68151366640562,116.59986872365388,114.12881303728985,14.940519254761341,16.549785210749086,97604000,3.1983372180022474,0.9290717088317212,-1237946000.0,-13.388099961054062,77.07053933241427,82.84087432937385,146.36703471654047,23.771362774797154,22.587475775446208,0.027173930991968603,5.7875685975610525,119.86340097045898,116.30830119323731,113.43500137329102,110.56170155334473,107.00660177612306,0.08,0.0,144.4780147136908,0.10148319098299008,0.14586744767657342,117.53621455601284,113.0437147957938,6.272944714388375
2022-06-06,0,125.71000099182129,103.69625091552734,123.21249961853027,107.39165592193604,114.45556163787842,0.7464051115915127,5.795936191463012,-0.5437692774035572,2.9944066144127,110.24762535095215,4.759279670715332,0.05179829764218223,105.70135040283203,122.49174842834472,0.7659042345392006,0.06549368724347082,1.1234706237043186,1.1070115265845013,1.045293064635079,0.10148376705446349,68.36583384787049,123.4862097509375,111.89433736801148,100.30246498508545,119.54517827715192,5.733340243592623,113.72071429661342,7.517434654872107,118.16978744705553,115.14337758207633,18.614823044253193,11.033088143380853,135269000,3.0406998802689555,1.2808854812493815,-1102677000.0,-15.1460658824138,77.07053933241427,82.84087432937385,162.03306015628925,27.449756751046863,20.75558520499766,0.012719129020167474,5.848461679287179,122.44572470092774,118.39714421081544,115.12500381469727,111.85286341857912,107.8042829284668,0.1,0.0,144.23390105737735,0.08374984313381995,0.12344985799308339,120.10978589739118,114.04225049700055,6.875341284933775
2022-06-07,0,122.43499946594238,103.69625091552734,125.71000099182129,107.39165592193604,115.23084354400635,0.7638409994259885,6.499588696780859,-0.7094324594977284,2.9940831816169853,110.24762535095215,5.409928045272828,0.05782145503667746,105.70135040283203,123.02046203613281,0.7974222482427452,0.13749651113575054,1.0892027398659723,1.0616305612631074,0.9988223919161897,0.03286027158390992,74.7454050747588,125.40708363974701,112.4079062461853,99.4087288526236,121.35137476239886,3.821212039513864,114.32821423666817,7.870988053371966,120.02765764751598,116.33975985656954,19.084297051664592,12.176721898536133,85156700,2.806292147540464,0.8231081588731836,-1187833700.0,-21.601171179325977,77.07053933241427,82.84087432937385,104.92190564388319,26.02564774610013,23.644640954514216,0.07291642267393765,5.727849032271287,122.44572470092774,118.39714421081544,115.12500381469727,111.85286341857912,107.8042829284668,0.1,0.0,144.05656814074527,0.023213612505632808,0.06820442124761189,121.81300027029855,114.58735765729632,7.196262893586405
2022-06-08,0,122.07250022888184,103.69625091552734,125.71000099182129,107.39165592193604,119.51356315612793,0.5530080106039429,6.836469796142535,-1.1360501079562415,2.993920688044541,110.37881278991699,5.935822410583495,0.06049763138448858,105.70135040283203,123.02046203613281,0.8554106067549522,0.11324153046116264,1.0802500912381443,1.0446838840935384,0.9895759076205142,-0.0029637927960969312,66.23376035640091,126.67686453430167,113.0039249420166,99.33098534973152,122.48632131304059,2.118738110239866,115.23242855072021,7.989199375807103,120.62923781622125,116.95245775724702,11.515792305575141,7.465109398740363,64926600,2.93848830772753,0.6400990455537676,-1252760300.0,-28.16445814109675,77.07053933241427,82.84087432937385,85.90082701446283,25.01764127890789,22.728853911321018,0.07144690153848067,5.532989916900358,122.44572470092774,118.39714421081544,115.12500381469727,111.85286341857912,107.8042829284668,0.1,0.0,143.91906251640515,-0.004141857685243222,0.008073381103191779,122.6749289376395,115.59217888968331,7.328464738637846
2022-06-09,0,118.38500022888184,103.69625091552734,125.71000099182129,107.39165592193604,122.16312503814697,0.3515995790188281,7.072957052906271,-1.4037724035274985,2.9938064743738666,111.42062473297119,6.298545560836791,0.06225727730719724,105.70135040283203,123.02046203613281,0.8607377923753976,0.14070458276982348,1.0420433396006052,0.9974406823456045,0.9602482707246898,-0.039180273142696787,67.18479836152135,127.75443280164383,113.6085186958313,99.46260459001876,122.4642140524728,2.1670372931225454,116.01302678244454,7.699649858978189,120.99565726907308,117.3501409238286,6.961161677672466,11.569870643154784,67029800,2.8249519472847497,0.67503400482616,-1319790100.0,-46.30365096611017,77.07053933241427,82.84087432937385,38.33511170803486,23.330856736182458,27.22562880402437,0.07691963272489657,5.509203803937738,122.44572470092774,118.39714421081544,115.12500381469727,111.85286341857912,107.8042829284668,0.1,0.0,143.75314772525144,-0.07458310381303779,-0.045478425003127085,122.09500013078961,116.22296469552177,7.063963401576207
2022-06-10,0,111.65500068664551,103.69625091552734,125.71000099182129,107.87671899795532,122.16312503814697,0.17964769558722896,6.9764276764168125,-1.4409277423602758,2.993870591082635,112.99712467193604,6.237309951782225,0.061101855290495444,105.70135040283203,123.02046203613281,0.8640055066001409,0.11983332791469296,0.9779113338303284,0.9306842255294138,0.9128082402156885,-0.09222930556586129,58.74991718211492,128.12987409062657,114.17701873779296,100.22416338495935,120.92416082109723,4.626233491184703,116.27290180751255,7.466882612828348,120.35509457803371,117.22524795070346,-0.1305476201865875,10.170033951552497,87266000,2.9649260665135198,0.899089592712909,-1407056100.0,-69.74396547431144,77.07053933241427,82.84087432937385,-37.915170546807005,21.22644934701172,33.7262412074264,0.038155477407280584,5.622838408716003,122.44572470092774,118.39714421081544,115.12500381469727,111.85286341857912,107.8042829284668,0.02,1.0,143.484538248189,-0.10380054848082754,-0.12637139263088187,120.37585776192802,116.37003598894391,6.937950696162388
2022-06-13,1,104.06500053405762,103.69625091552734,125.71000099182129,109.06431245803833,122.16312503814697,0.16413459700652155,6.732124344473508,-1.3663615132061908,2.9940069558101663,112.99712467193604,5.999774932861328,0.05880923195989908,107.03346157073975,123.02046203613281,0.8804260002226014,0.007925835290837737,0.9090715563414085,0.8660736914064932,0.8668363182158765,-0.17218200848770893,44.07204102027917,127.93818620039112,114.47393751144409,101.00968882249707,118.18880380902972,7.692331280109976,116.04920550755092,7.799221390103941,118.19951642840067,116.30082017283017,-8.804949361049113,3.36822792728464,99277700,3.2045739603841987,1.019905570253736,-1506333800.0,-91.30906692763796,77.07053933241427,82.84087432937385,-106.19527589612142,19.182082530237896,39.36740272981003,-0.01932046647406206,5.777643844412776,122.44572470092774,118.39714421081544,115.12500381469727,111.85286341857912,107.8042829284668,0.04,0.0,143.11903700674668,-0.16924435124316195,-0.1526767514355701,117.2557144165039,116.09239305768695,7.3476640586772675
2022-06-14,1,103.20249938964844,103.69625091552734,125.71000099182129,107.87671899795532,122.16312503814697,0.13185371360151543,7.06702215171084,-1.4116208006883764,2.9938187411396697,112.99712467193604,6.268254928588869,0.06191628777378674,105.41398944854737,123.02046203613281,0.8213545279266941,-0.0713809138352098,0.9041878621586892,0.8661493759627933,0.8918101422413903,-0.15708335165749587,34.158528483710086,128.27238182020633,114.13833751678467,100.004293213363,115.36071450369698,9.133229385473378,116.01393754141671,7.86025573624468,114.67832448366784,114.41068782902056,-15.540224525720935,-2.9214955084580754,69728800,3.610951682651308,0.7181263757331107,-1576062600.0,-96.80697718518022,77.07053933241427,82.84087432937385,-106.22662820534028,18.33964393634478,38.18584992712981,-0.008195333577655858,5.611375259703313,122.48584426879883,118.46208351135255,115.21000289916992,111.9579222869873,107.93416152954102,0.06,0.0,142.85891182379524,-0.16821140196265227,-0.18014266521362324,114.39285714285714,115.964535849435,7.778309118781131
2022-06-15,1,106.02999877929688,103.20249938964844,125.71000099182129,107.39165592193604,122.16312503814697,0.13411131296784112,7.45057119971785,-1.4718538158915022,2.9935890702830177,112.79250049591064,6.689462375640869,0.06553106833810576,104.02812557220459,123.02046203613281,0.8385347097216389,-0.09415870171853233,0.9325807256440287,0.9014837869925407,0.9477457057531244,-0.13141781662131768,32.37609900120416,128.59639243376796,113.69525003433228,98.79410763489658,112.5492856161935,8.417450845673002,116.04723194667271,7.813434259024024,111.80667472753257,112.59682322510032,-16.094931743182517,-0.47615176201608705,85011100,3.57118831556954,0.8716728298706037,-1491051500.0,-77.35850257934938,77.07053933241427,82.84087432937385,-61.87157062462549,22.03134246810726,34.95156094783199,-0.018201805264069698,5.692709273995039,122.48584426879883,118.46208351135255,115.21000289916992,111.9579222869873,107.93416152954102,0.06,0.0,142.57662422325402,-0.11148706141448506,-0.12463416122808678,111.94714246477399,116.02846418108258,7.877477298599076
2022-06-16,1,103.68000221252441,103.20249938964844,125.71000099182129,106.9050612449646,122.16312503814697,0.229382511835814,7.634791064426773,-1.5318861035309923,2.993471085601374,110.72331237792969,7.02148741722107,0.06738547414727133,104.02812557220459,123.02046203613281,0.8696473184344714,-0.03092398157491473,0.9150906750066583,0.8939729772067878,0.9541031337365514,-0.12421335463046201,39.31179792756128,128.5698320868919,113.30024995803834,98.0306678291848,109.87000029427665,7.700733010107379,115.61068752833775,8.342636370492048,110.33720330297226,111.48631607908395,-15.65508078693341,0.441554143674739,82186300,3.519603622243959,0.8541791601665824,-1573237800.0,-91.90855247768417,77.07053933241427,82.84087432937385,-87.83476118229999,20.46601004906151,34.37630416832815,0.03527421805956714,5.690372515842482,122.48584426879883,118.46208351135255,115.21000289916992,111.9579222869873,107.93416152954102,0.06,0.0,142.2828503721779,-0.10753334222717759,-0.1445782851868676,109.18428584507534,115.49864305768695,8.054716651475196
2022-06-17,1,104.62750244140625,103.20249938964844,125.71000099182129,105.91346836090088,122.16312503814697,0.23289152513361758,7.879084281644986,-1.571554927509104,2.9933123598530433,110.72331237792969,7.27949481010437,0.06971803410583845,103.69462604522705,123.02046203613281,0.8567752527552128,-0.03514555545321729,0.9257958822209394,0.9175966580879809,0.9896052751609342,-0.06293939547733829,37.031406590872265,128.77174364034684,113.01357507705688,97.25540651376691,107.3778577532087,5.640849394167216,114.93208953312465,8.843855961105284,108.64838023392363,110.3910825305051,-15.318329999776761,-5.56656476165852,99772100,3.5311363968765948,1.030722625486702,-1473465700.0,-82.61973870159134,77.07053933241427,82.84087432937385,-68.9466410206926,22.35935233645739,32.4173710496208,0.08790877317719806,5.603199740745712,122.48584426879883,118.46208351135255,115.21000289916992,111.9579222869873,107.93416152954102,0.06,0.0,141.94851154121875,-0.03128135209707461,-0.08549289862009445,107.0471431187221,114.8610360281808,8.099639033620335
2022-06-21,1,108.01749801635742,103.20249938964844,125.71000099182129,105.32978343963623,122.16312503814697,0.23455475703592282,8.002017575427345,-1.5939379658503692,2.993230278018118,110.72331237792969,7.406805324554443,0.07089454552527592,103.69462604522705,123.02046203613281,0.8712397350480979,-0.03137705850022371,0.9569900788724633,0.9628407896589326,1.0354338754534647,0.037981045135403235,38.69022778734175,128.87615410074483,112.87211894989014,96.86808379903545,105.89678600856236,3.0224722475431123,114.18050003051758,8.960027415252066,107.6180493555392,109.77526438737245,-14.29068607161056,-8.324322156231524,70901200,3.53657339320586,0.7434464703746052,-1402564500.0,-73.69376402309304,77.07053933241427,82.84087432937385,-44.87480460082352,25.876393390030522,29.183998281606836,0.09629312131971796,5.779406113274706,122.48584426879883,118.46208351135255,115.21000289916992,111.9579222869873,107.93416152954102,0.06,0.0,141.7318977060811,0.048326441831955336,-0.00884634023898478,105.98000008719308,114.03750010899135,8.06484222033037
2022-06-22,1,108.88249778747559,103.20249938964844,125.71000099182129,105.32978343963623,122.16312503814697,0.23454789536639592,8.001994893617399,-1.5939305806352582,2.9932302934085975,110.72331237792969,7.406771678924559,0.07089432109318555,103.69462604522705,123.02046203613281,0.8809805053872439,0.007656475523126245,0.9646532973584321,0.986102661654166,1.0358761659153108,0.0550374112198766,45.47916509538266,128.87614612115811,112.87215633392334,96.86816654668856,105.5007141658238,2.216279131735139,113.21243749346051,8.72870177401593,107.69038682583137,109.89724839130136,-8.757445784922254,-8.876560768047495,60040100,3.620326156815719,0.6457287704920942,-1342524400.0,-72.71409569130297,77.07053933241427,82.84087432937385,-33.88939930067886,24.85160730615042,27.32543566964059,0.0629497143733837,5.731589827905269,122.48584426879883,118.46208351135255,115.21000289916992,111.9579222869873,107.93416152954102,0.06,0.0,141.55818135084914,0.0649007872944738,0.05093082736137749,105.87999943324498,113.12792859758649,8.020622987155999
2022-06-23,0,110.94000053405762,103.20249938964844,125.71000099182129,105.32978343963623,122.16312503814697,0.21920022774313302,7.950482632967844,-1.5769169463597623,2.993265098285623,110.72331237792969,7.330912971496582,0.07038538366156959,103.69462604522705,123.02046203613281,0.8655648102421268,0.050013831996424285,0.9821484885238365,1.017221899547866,1.0441657516024816,0.04630766586144164,48.39814262699913,128.8574090525568,112.9564437866211,97.0554785206854,106.48285702296666,2.893777506966245,112.33583041599819,8.250303575998881,107.97392857940126,110.35690732762498,-2.4830978300298616,-11.069411684559537,64345300,3.5254191399877923,0.7066956533724778,-1278179100.0,-60.050798027320255,77.07053933241427,82.84087432937385,-22.31564435752178,24.361556205948016,25.584506454704794,0.07078646242692013,5.684331915416035,122.48584426879883,118.46208351135255,115.21000289916992,111.9579222869873,107.93416152954102,0.06,0.0,141.38411393057348,0.04430207442723533,0.09901285431085008,107.13285718645368,112.1942858014788,7.737746901330172
2022-06-24,0,114.24499893188477,103.20249938964844,125.71000099182129,105.91346836090088,122.16312503814697,0.18825644649030704,7.680803206360067,-1.5205364603661407,2.993442369365731,111.29750061035156,7.004944238662719,0.06778058577345092,104.0265007019043,123.02046203613281,0.8711334014458961,0.05092768071563925,1.0081748928130803,1.0583287296005919,1.0654250809762473,0.10190004334398162,51.24711454068895,128.68023768026774,113.3186312675476,97.95702485482748,108.06035695757184,3.7039224268536315,111.71053573063442,7.692867791587637,108.72697297589576,111.14555184586878,6.60644785923967,-9.960433496981796,69867600,3.5301912653285,0.7772712170653104,-1208311500.0,-45.46445591437141,77.07053933241427,82.84087432937385,9.824271442821578,27.422799750675313,23.878313147412563,0.08713929007228333,5.655450140395307,122.48584426879883,118.46208351135255,115.21000289916992,111.9579222869873,107.93416152954102,0.06,0.0,141.22045173542818,0.12348056116307116,0.0816383492617406,109.15428597586495,111.77357155936105,7.5927241222011235
2022-06-27,0,115.24749946594238,103.20249938964844,125.71000099182129,107.52062320709229,122.16312503814697,0.08594066106019575,7.472779298987815,-1.4469853433058812,2.9935761321908316,112.89143753051758,6.663524913787842,0.06569321105718934,104.0265007019043,123.02046203613281,0.8892931803737695,0.040562063822495616,1.0131408948816347,1.0717258139437293,1.054004618043555,0.10150292013788209,55.0395949537723,128.69824595683184,113.7526873588562,98.80712876088057,109.37714276994977,4.42924818749698,110.96321419307164,6.668231372616062,110.12114500440407,112.13701629373585,10.699837317451566,-7.117225938606352,62133200,3.4816005367395366,0.7033028231688595,-1146178300.0,-47.99293397527497,77.07053933241427,82.84087432937385,5.501876479046341,27.197007639938526,22.278317193176306,0.03986152637605437,5.628632009542487,118.74987890625,115.44005917358399,112.76499938964844,110.08993960571289,106.78011987304687,0.02,1.0,141.07532125262563,0.06590095951378738,0.09222455354869137,109.9471435546875,110.94714300973075,7.563779280752352
2022-06-28,0,110.69750022888184,103.20249938964844,125.71000099182129,107.52062320709229,122.16312503814697,-0.014602901695855909,7.422616523374099,-1.4145081070328422,2.9936104673928687,114.1864366531372,6.512932977676391,0.06509612105908773,104.0265007019043,123.02046203613281,0.9024149404010121,0.009810268505307225,0.9708137087704569,1.0259862172236407,0.9931010776733342,0.024810815485825977,54.942802100455104,128.87071417544084,114.02548112869263,99.18024808194443,110.37964248657227,3.650578277345657,110.12482139042446,5.795735414848736,111.4284803453204,113.06551353556854,8.693295098335218,-8.322728059289092,74942900,3.352054246049535,0.8573817667787603,-1221121200.0,-73.2526823372336,77.07053933241427,82.84087432937385,-40.783961861738284,24.57403999368736,27.119078037829322,-0.050508698896980474,5.784447726732012,118.48248007202149,115.22376011657715,112.59000015258789,109.95624018859863,106.6975202331543,0.02,0.0,140.8705095644461,-0.011777684723064175,0.01110902176252084,110.48142896379743,109.83285740443638,7.70691925843381
2022-06-29,1,108.54999923706055,103.20249938964844,125.71000099182129,107.52062320709229,122.16312503814697,0.05016746139318235,7.4578191189353635,-1.440808456317959,2.993586886071058,112.94999980926514,6.67421236038208,0.06550337783880644,104.0265007019043,123.02046203613281,0.889106026872163,-0.06615713930829649,0.953414329448415,0.9999355127564203,0.9691747936751224,-0.003053737351470742,44.49690207231213,128.76960065928796,113.85396242141724,98.93832418354651,110.93999917166573,2.8290991668063064,109.15892846243722,4.66862592284689,111.26841554903638,113.08277466888025,6.768420010228083,-9.58671890248634,66375300,3.3368438477776023,0.7949510447106591,-1287496500.0,-62.304998347028636,77.07053933241427,82.84087432937385,-44.32644556474488,23.30931900179354,25.887355519413433,-0.09114336106562894,5.6626982223170375,116.61068240356444,113.70966200256346,111.3650016784668,109.02034135437012,106.11932095336914,0.02,0.0,140.68659452287474,-0.000275344471199257,0.002208298335440065,110.86714281354632,108.95714296613421,7.622672041517327
2022-06-30,1,106.2549991607666,103.20249938964844,125.71000099182129,107.52062320709229,122.16312503814697,0.2208660996482899,7.461792591296621,-1.4069048715822292,2.993573711747398,111.29750061035156,6.655172328948976,0.0658270668400689,104.0265007019043,123.02046203613281,0.8609089090356108,-0.1134098234378666,0.9373692509230998,0.9739966531944694,0.9492477796681891,-0.04223004642813899,39.145402717744,128.27806001322068,113.35447483062744,98.4308896480342,110.68821362086705,3.1881879108137876,108.2924998147147,3.88440183321414,110.6126453049712,112.55059345371679,3.7490112103660156,-11.07743428410744,97679400,3.1960603131425716,1.1911591013839566,-1385175900.0,-71.11783747502584,77.07053933241427,82.84087432937385,-71.64418739172399,21.44488465093105,29.303304430283774,-0.03317511254933722,5.715363878353514,114.07420263671875,111.65790219116211,109.70500183105469,107.75210147094727,105.33580102539062,0.02,0.0,140.3919968441873,-0.05540735700517352,-0.025149132083695323,110.51428549630302,108.24714279174805,7.500089757491794
2022-07-01,1,107.86249923706055,103.20249938964844,125.71000099182129,106.19874906539917,119.30687522888184,0.42671890521141276,7.308955417151247,-1.2287764898630646,2.9936404550014744,110.81875038146973,6.394297447204591,0.06494225239213999,104.0265007019043,123.02046203613281,0.8304745741749356,-0.1376280857077376,0.9583905290573536,0.9885280743179666,0.9717429870119351,-0.05586677539057616,35.50592550791611,127.16336695765455,112.54545612335205,97.92754528904956,110.54249954223633,3.3056183709675118,108.02160685403007,3.7621867133702316,109.55084565164026,111.60030078077888,-1.6316790223412874,-10.246231401498054,73021200,3.1933921746293326,0.9056700375303645,-1312154700.0,-50.8761585844271,77.07053933241427,82.84087432937385,-38.49684098853922,22.38307697217933,27.841850945086684,-0.05301316401548231,5.585692545427167,114.07420263671875,111.65790219116211,109.70500183105469,107.75210147094727,105.33580102539062,0.02,0.0,140.1921532553149,-0.059247823974943326,-0.025613703488785274,110.60142844063895,108.24071393694196,6.855364968262389
2022-07-05,0,110.375,103.20249938964844,125.71000099182129,106.19874906539917,116.03187465667725,0.6336911218321579,6.945429174944396,-0.888983314391055,2.993824658435144,109.78999900817871,5.864843111038207,0.06213594716712255,104.0265007019043,122.4914119720459,0.8172246845529104,-0.12306287014747865,0.9874487228683111,1.0076917855405938,1.00594682528409,-0.04227856993445911,39.35333421975874,125.66881445416735,111.77795610427856,97.88709775438977,110.46178518022809,3.3011897422842718,108.47232110159737,3.6272722780473985,109.1639063297915,110.85885608658486,-0.9367883462831125,-3.396624805214446,76583700,3.239327442545004,0.9624005820872452,-1235571000.0,-27.069501696906105,77.07053933241427,82.84087432937385,1.6245609642906815,25.60939551683319,25.153709098830742,0.0008653238837748255,5.741003257724878,114.07420263671875,111.65790219116211,109.70500183105469,107.75210147094727,105.33580102539062,0.02,0.0,140.004178132046,0.0024730504882353177,-0.025416444339190332,110.7528566632952,108.94285692487445,6.396913751362185
2022-07-06,0,113.75750160217285,103.20249938964844,125.71000099182129,106.19874906539917,114.49562406539917,0.8210329239208936,6.453158015807841,-0.3605868059831998,2.994071210182345,109.6287488937378,5.17227508544922,0.05805979952535921,104.0265007019043,122.10875015258789,0.7460103849861461,-0.12198712012434863,1.0234892313730315,1.0331517894303794,1.0460652338351062,0.027642913046492135,43.45891673454091,124.05306590954538,111.1467498779297,98.240433846314,110.39214270455497,3.2120142229242132,109.22624983106341,3.5436481307406567,109.48850048073675,110.42150285240032,-0.5092847767601795,6.063517449247784,66958900,3.2283062467719104,0.8791849863304578,-1168612100.0,-22.855361596010084,77.07053933241427,82.84087432937385,50.873644712687714,26.264125781387502,24.036147653120434,0.07092949944846871,5.578786029049339,114.21108306884766,111.879462890625,109.99500274658203,108.11054260253907,105.77892242431642,0.02,0.0,139.85675250542812,0.06452514158955514,0.009803926853770219,110.44857134137835,109.80142865862165,5.604280564352038
2022-07-07,0,115.16499900817871,103.20249938964844,122.43499946594238,106.19874906539917,113.87937593460083,0.7114156800347554,5.56978274718187,-0.34239870704992503,2.9944768514462403,109.6287488937378,4.449287719726563,0.05038287505029606,104.0265007019043,118.75375022888184,0.7077300050711017,-0.07087432434859725,1.0417540537164283,1.0405104695248921,1.0530815578718562,0.060939657463025654,51.54760790803096,121.688690402811,110.54912490844727,99.40955941408353,110.38035692487445,3.1913139376563042,109.87874984741211,3.7451392104412964,110.54437697198286,110.34978334556443,-0.42671218370142405,10.227467624280344,57872300,3.301887837210739,0.7737354850979615,-1110739800.0,-10.331881025405933,77.07053933241427,82.84087432937385,89.10024931456906,27.04119371554127,22.929554220299686,0.0754849719803078,5.430298934912964,114.21108306884766,111.879462890625,109.99500274658203,108.11054260253907,105.77892242431642,0.02,0.0,139.7387621649039,0.06803161757876386,0.08314711525422103,110.89285714285714,110.42000034877232,4.99677153363836
2022-07-08,1,115.10250091552734,103.20249938964844,122.07250022888184,106.19874906539917,113.87937593460083,0.5723158591664815,4.989184459364896,-0.3111559488979858,2.9947150897540427,109.6287488937378,4.068375205993652,0.04527981272100385,104.0265007019043,115.56124954223634,0.619303283497678,-0.0565852358864756,1.0446235707704614,1.0340761676565442,1.0399293579123456,0.08326668697605699,54.2159240036692,120.16399380428888,110.18562488555908,100.20725596682928,111.00964273725238,3.663626787980185,110.69464261191231,3.528809443041899,111.68855746912732,110.65155375787688,-0.07158546445344108,8.615486498209327,45719700,3.3280965691845705,0.619209181258425,-1156459500.0,-15.772477368268442,77.07053933241427,82.84087432937385,97.94105558411569,25.97769203779337,22.0277589948439,0.11650735044082004,5.248846269276643,114.32908306884767,112.07046289062501,110.24500274658203,108.41954260253907,106.16092242431642,0.02,0.0,139.64508103206467,0.08784485370001938,0.06077857930472749,112.0557141985212,111.26857158115932,4.484870202312604
2022-07-11,1,112.75000190734863,103.20249938964844,118.38500022888184,106.19874906539917,113.87937593460083,0.15630363002931058,4.34906916096041,-1.0401954583184547,2.9949495864278775,109.6287488937378,3.7198752403259276,0.03959562091717497,104.0265007019043,115.17324905395508,0.6032703719196525,-0.02772732446685147,1.0265199675390426,1.0091675565447484,1.0026455770601548,0.04531234400147088,56.07498079401853,118.53526324181217,109.83712491989135,101.13898659797053,111.6096431187221,3.535344588065635,111.27482114519391,3.095707465643858,112.51397369380973,110.92469160152203,3.9793136046772344,11.01707027319402,53487600,3.2346699524616356,0.7311192189235102,-1209947100.0,-40.29754625750231,77.07053933241427,82.84087432937385,53.17812687651996,24.313643437809983,24.484831474436824,0.1447175287926286,5.207499405501957,114.33144177246093,112.07428079223632,110.25,108.42571920776368,106.16855822753907,0.02,0.0,139.52317581439686,0.019989069826649164,0.0521608225523209,112.46000017438617,111.66357149396624,4.272444978560962
2022-07-12,1,110.73750114440918,103.20249938964844,115.24749946594238,106.19874906539917,113.00187683105469,-0.06360746677671476,3.950437134534372,-1.2511022882714091,2.9950814098853575,109.6287488937378,3.4381253242492678,0.03605881623240136,104.0265007019043,115.10875072479249,0.7209058303321728,0.009807005633148435,1.0107902158205686,0.9924827287947816,0.9762628975937816,0.0032842685790186454,54.385594897657725,117.45624927288345,109.5553750038147,101.65450073474595,112.25000054495675,2.714466933909862,111.4691070829119,2.9578365498896693,112.53399550907515,110.96498784316329,3.86918719466388,7.7632546667078906,54280300,2.8977672909697723,0.7590669932352094,-1264227400.0,-56.662343673971336,77.07053933241427,82.84087432937385,13.644874530774239,22.6756834684081,26.320841263613975,0.17134441358408736,5.184821087134854,114.33144177246093,112.07428079223632,110.25,108.42571920776368,106.16855822753907,0.02,0.0,139.39136553744072,-0.03770924034622802,-0.0031032890239779884,112.89000047956195,111.70214298793248,4.274445485103073
2022-07-13,1,108.80500030517578,103.20249938964844,115.24749946594238,106.19874906539917,113.00187683105469,-0.03579991135188283,3.9310683981071652,-1.2225272404327647,2.9950874515502117,109.6287488937378,3.392250347137451,0.03589705365423649,104.0265007019043,115.10875072479249,0.7780412816890111,0.06411858526986541,0.9935667707244091,0.9791204075233371,0.9586132413606673,-0.043535601848190275,53.99898572304094,117.3716368229172,109.50950002670288,101.64736323048857,112.3846435546875,2.473221319000594,111.46357154846191,2.96311751126282,112.05772924881722,110.84415983036284,4.218626906071906,2.5181134334733986,61353800,2.3362806341709295,0.8813549875138336,-1325581200.0,-49.0297447559039,77.07053933241427,82.84087432937385,-9.89935702565901,20.887581963433927,27.429577786721985,0.215151025268243,5.226619838760195,114.33144177246093,112.07428079223632,110.25,108.42571920776368,106.16855822753907,0.02,0.0,139.23941044514456,-0.034374182123981134,-0.02731276188652946,113.01000104631696,111.80571474347796,4.023865066475097
2022-07-14,1,109.90749931335449,103.20249938964844,115.24749946594238,107.46062421798706,113.00187683105469,-0.07776473820108602,3.733606435155183,-1.0460820911583795,2.9951528540134746,109.6287488937378,3.155250358581543,0.03402027795543434,104.53275241851807,115.10875072479249,0.7260540957477186,0.054286484810553856,1.0014670107754993,0.9907288802906059,0.9768513462778641,-0.04565188850868518,49.78845652965166,117.21371288556915,109.74650001525879,102.27928714494843,112.31785774230957,2.5418922124696084,111.38982146126884,2.989879559587059,111.23557439948748,110.63029572387534,0.8737986554936044,-0.07117533476415067,51163100,2.377392028701462,0.7448974666940283,-1274418100.0,-47.542062817624085,77.07053933241427,82.84087432937385,-9.716014784414629,19.836565077305167,26.04938215260332,0.268788366269943,5.110431313964648,114.33144177246093,112.07428079223632,110.25,108.42571920776368,106.16855822753907,0.02,0.0,139.1155497328926,-0.0489985772192697,-0.03236249906742949,112.6000006539481,111.67642865862165,3.57721817209826
2022-07-15,1,113.30749893188477,103.68000221252441,115.24749946594238,107.9787483215332,113.00187683105469,-0.045738348939326275,3.4187019878880753,-0.931565300705429,2.995249645450518,110.14124965667725,2.8200003623962404,0.03105602870169367,105.8897491455078,115.10875072479249,0.7460803608111561,0.03656984418276469,1.0293032125679809,1.0201288686570973,1.016570876703744,-0.015594813052410728,50.77492056521346,116.91915398722024,110.08175001144409,103.24434603566793,112.25357164655414,2.504834739891085,111.32285717555455,2.930930629649282,110.89493089672015,110.55478760680768,-0.4235566809925326,-0.9306843480554663,84317800,2.31094990837752,1.2282256294201508,-1190100300.0,-28.654582026812513,77.07053933241427,82.84087432937385,72.92699679200099,24.63537275625077,24.239659570089636,0.23690589486960711,5.099686044411189,114.33144177246093,112.07428079223632,110.25,108.42571920776368,106.16855822753907,0.02,0.0,138.93970916405402,-0.017223453764938612,-0.02389752201099635,112.4885722569057,111.46857179914203,3.5692935293968073
2022-07-18,1,114.78750038146973,103.68000221252441,115.24749946594238,108.41687393188477,113.41999959945679,-0.24253728336156644,3.354781164746588,-0.7985021651387951,2.995269663231282,110.53625011444092,2.749375247955322,0.030374957488512846,106.09224948883056,115.10875072479249,0.6395635361585842,0.0928577981665722,1.039312334568675,1.026933091231546,1.0331768702529143,0.018070939597813807,59.61144746854051,117.15518734856666,110.44562501907349,103.73606268958032,112.19964327131,2.434789864615664,111.29000009809222,2.885779828437989,111.48666942318451,110.86277294967756,-0.3955806552976288,-0.8206048481465319,59115400,2.3330551205244223,0.8758285331493634,-1130984900.0,-23.641273362427135,77.07053933241427,82.84087432937385,91.58743599781519,25.548086464073165,22.831123820094557,0.19293242431980595,5.027564663618803,113.76607757568358,111.61695739746092,109.87999725341797,108.143037109375,105.99391693115234,0.02,0.0,138.82334056496413,0.017986596297364432,-0.015405909340421754,112.12142944335938,111.50714329310826,3.193407084775857
2022-07-19,1,116.72249794006348,104.62750244140625,115.24749946594238,108.74125003814697,113.87937593460083,-0.1931955172882076,3.0983910113976885,-0.9734743746337693,2.9953418965613827,110.71750068664551,2.6354501724243162,0.027913181083240826,107.70174922943116,115.10875072479249,0.571486007569251,0.09710637932653801,1.0515445628082507,1.0378146748748789,1.0467540550457028,0.05404670264185807,61.91317064612155,117.19778195031613,111.00099992752075,104.80421790472538,112.4310714176723,2.8054687383924373,111.72035707746234,3.2204694441502206,112.32785179301413,111.4366628960016,-0.3277893717362646,-0.39914018664551926,60990000,2.3413654751294675,0.9303291891812737,-1069994900.0,-4.503943092054786,77.07053933241427,82.84087432937385,133.93876074093234,26.09247650757636,21.151502892814335,0.18094351010674073,5.039166919769935,115.07251687622072,112.67373683166505,110.7349967956543,108.79625675964355,106.39747671508789,0.04,0.0,138.71602147520846,0.08231091158480441,0.05780759807134368,112.5028577532087,112.27928597586495,3.3025499409011356
2022-07-20,1,120.79750061035156,106.2549991607666,116.72249794006348,108.86312341690063,114.380624294281,0.011573096110422067,2.9732151005821574,-1.2395234839706508,2.995377382145421,110.8387508392334,2.663325176239013,0.026640339843680944,108.00199813842774,115.17324905395508,0.6015286827697657,0.08058879425616607,1.0823591161961066,1.0680191102945567,1.0717929948793885,0.11022012105637846,63.877083004151494,117.55217990361791,111.60574970245361,105.6593195012893,113.58071408952985,4.240039345744331,112.59517860412598,3.887430363071064,113.4506927009229,112.27116460594522,1.4074385974680372,5.442758597731796,71268300,2.269415166223027,1.0868080211608566,-998726600.0,-3.387435526904891,77.07053933241427,82.84087432937385,204.48237977015862,30.549942509952107,19.576612750211897,0.20574223930253305,5.055655437624461,118.53344177246093,115.47328079223632,113.0,110.52671920776368,107.46655822753905,0.06,0.0,138.61750615582008,0.1120470556722577,0.1240614838941681,114.07714298793248,113.26857158115932,3.9973568132389508
2022-07-21,1,123.48499870300293,106.2549991607666,120.79750061035156,109.65124893188477,114.86625051498413,0.4360798679320737,3.4658799168576304,-0.1572519988793064,2.9952574810551784,111.84500122070312,2.9435001373291017,0.030877880008110672,108.48124923706055,115.39499931335449,0.5792765897144048,0.10942991816859773,1.1001405311843795,1.085026776646986,1.072807746948934,0.12353569569386691,69.74684621404391,119.1765096658686,112.24474983215332,105.31298999843804,115.40178516932896,5.395437835652872,113.82589285714286,4.417122219763375,115.30923863801969,113.52069739174044,7.137471012741884,11.282820321853618,60239900,2.4086290329450093,0.9184901880796273,-938486700.0,-1.1579011615954695,77.07053933241427,82.84087432937385,206.22195042852155,30.944173593789667,18.562661665126512,0.2572034607645409,4.9509647029350505,120.3659984741211,117.5919984741211,115.3499984741211,113.10799847412109,110.33399847412109,0.08,0.0,138.5450249698608,0.1265479557766822,0.1288948870549009,116.27857099260602,114.58428573608398,4.706660214317964
2022-07-22,1,123.56999969482422,106.2549991607666,123.48499870300293,110.25812482833862,115.11812543869019,0.7400028786251219,4.151043701160219,0.34089758749554555,2.9950628749348254,113.0287504196167,3.286874771118164,0.03674306969266801,108.48124923706055,117.12999820709229,0.6586227535643816,0.11307912482922791,1.09378301882027,1.0778936689197456,1.0488032627311177,0.09057212328999342,72.47043955730686,121.27696228025013,112.9748748779297,104.67278747560925,117.51107079642159,5.271354247634647,114.94785717555455,4.766912342930029,117.36649969709225,114.99744822193708,11.511454951444273,16.215707193378154,51463800,2.432311818301702,0.7924614242526106,-887022900.0,-15.802987012021031,77.07053933241427,82.84087432937385,167.42004164802108,30.01852308853023,17.438259861335542,0.2019664596203794,4.893752641980155,120.9003605041504,118.05482081604005,115.75500106811523,113.45518132019043,110.60964163208008,0.1,0.0,138.48164498521237,0.07811532257858644,0.10657146531894283,117.99571337018695,115.50285720825195,5.106913639651134
2022-07-25,1,121.87749862670898,106.2549991607666,123.56999969482422,110.25812482833862,115.18562412261963,0.6716770799094834,4.715736360999286,-0.18952825444501098,2.9948780899679557,113.53250026702881,3.6816248893737793,0.04150943437644376,108.48124923706055,121.06625041961671,0.764531489135155,0.08162283557374106,1.072805102730224,1.055335221621749,1.0167260978931723,0.06176629181467752,71.55704564808855,123.03784755796659,113.60637483596801,104.17490211396944,119.22107069832938,4.232921541749745,115.76946422031948,4.907320016659249,118.91645197682891,116.19712193846934,13.570147831658135,14.562522256453262,50221300,2.3530190228207073,0.7852059888934222,-937244200.0,-22.37045196632107,77.07053933241427,82.84087432937385,123.592188465896,28.40660025690025,18.465324441498737,0.14050501966155665,4.802055464869282,120.9003605041504,118.05482081604005,115.75500106811523,113.45518132019043,110.60964163208008,0.1,0.0,138.41436855084206,0.06487339235964695,0.06684276648086927,119.4971422467913,116.04857145036969,5.330747791716362
2022-07-26,1,115.81999969482422,106.2549991607666,123.56999969482422,110.25812482833862,115.61624908447266,0.5397705380557102,5.049031015825299,-0.6987603928347137,2.9947583749032485,113.53250026702881,4.086299695968629,0.04429440839182087,108.48124923706055,122.03824863433839,0.8279273379373522,0.05752835585578914,1.0160718661350012,0.9950193202952217,0.9548975438300433,-0.007731999067589257,65.65310652733457,124.08606185235985,113.98799982070923,103.88993778905862,119.5799993787493,3.723817329530051,115.91678551265171,4.873112866060061,119.6354848233263,116.81777970703463,10.890975946261074,10.421289809022863,67075100,2.3986829344696994,1.044677882251467,-1004319300.0,-54.848658866598285,77.07053933241427,82.84087432937385,28.07849636662749,25.68676133836688,24.664152115157446,0.13466565702274577,4.93119519294887,120.9003605041504,118.05482081604005,115.75500106811523,113.45518132019043,110.60964163208008,0.1,0.0,138.29477454859685,-0.028762385180709282,0.009229917393161483,119.67714146205357,116.08285685947963,5.327618968061491
2022-07-27,1,119.33500099182129,106.2549991607666,123.56999969482422,110.25812482833862,116.04562425613403,0.5216227154391808,5.057705904519007,-0.7258406480505508,2.9947552695321877,113.53250026702881,4.11778720855713,0.04435937225790169,108.48124923706055,122.03824863433839,0.8613263990659834,0.046274752865700965,1.0466456200356506,1.0207599273248416,0.9853439147721221,-0.01210703541994429,52.714740872924764,124.13203664119133,114.01662483215333,103.90121302311532,120.22964232308524,3.091348651399075,116.21464279719761,4.950453947452388,118.6529860414899,116.47506546921478,2.217417899630679,1.813065568075004,61582000,2.5776691289563676,0.9692084847213368,-942737300.0,-23.242684842556148,77.07053933241427,82.84087432937385,85.2475720215191,28.395945332908852,22.207960408996893,0.21906344528151436,5.08539669464116,120.9003605041504,118.05482081604005,115.75500106811523,113.45518132019043,110.60964163208008,0.1,0.0,138.2063083976187,-0.01466152538552612,0.02334829673975529,120.70714133126395,116.41428538731166,5.272605937663636
2022-07-28,1,121.1924991607666,106.2549991607666,123.56999969482422,110.25812482833862,117.37562370300293,0.31762946316968493,5.124187721992247,-0.9421172053177811,2.9947340413764407,114.27250099182129,4.217749786376953,0.04477286926258776,108.48124923706055,122.03824863433839,0.8152533626428398,0.09935515274585636,1.0589260610502453,1.0273946447210462,1.0031038518422506,-0.018565004383650496,60.09091731320308,124.69687531428478,114.4484998703003,104.20012442631581,120.86821392604283,2.6805234137142326,116.64964267185756,5.11020074612468,118.81039358288092,116.73181703049559,3.9616688186771167,3.6208935176098387,82245500,2.608143142046006,1.2784548518694947,-860491800.0,-16.521301044823982,77.07053933241427,82.84087432937385,91.71223731889539,27.815090352432364,20.716354609006533,0.26600224275283796,5.062153558763008,120.9003605041504,118.05482081604005,115.75500106811523,113.45518132019043,110.60964163208008,0.1,0.0,138.0962684317522,-0.0188558013793636,-0.003991185771505065,121.28856985909599,116.89571380615234,5.316895520221299
2022-07-29,1,134.97749710083008,106.2549991607666,123.56999969482422,110.64687585830688,119.70062589645386,0.1329910063953749,5.137331859524733,-1.0580291347039734,2.9947371884870355,114.94500064849854,4.226124668121338,0.04464115367365245,108.71075019836425,122.03824863433839,0.7643263323051377,0.14058162079884046,1.1728950660237418,1.1334122462306944,1.1214574523842842,0.09231607537572617,64.2871069529664,125.35528858553506,115.08062486648559,104.80596114743612,122.89392771039691,5.964526966564893,118.23732089996338,6.933180596275292,119.4098378017533,117.18442072787515,3.8295969496801314,5.290934772745425,148892900,2.5319781985675127,2.2258490957823005,-711598900.0,-8.53349447338959,77.07053933241427,82.84087432937385,246.4186839467846,40.79257888979475,16.793965993861725,0.23023383230007732,5.798431558003657,130.18295584106446,125.5635170440674,121.82999801635742,118.09647898864748,113.4770401916504,0.12000000000000001,0.0,138.06073288654233,0.10235254833123641,0.08280510248138682,123.02856990269252,118.5528564453125,6.415607400864177
2022-08-01,1,135.67250061035156,107.86249923706055,134.97749710083008,112.24687671661377,120.89625024795532,1.058005733486794,6.342666371149794,1.2218727436093548,2.994276225271854,115.13374996185303,4.982349472045899,0.054435661688336134,109.79724941253662,123.49349880218506,0.5421954867511024,0.2513848469631331,1.1644034088295978,1.1188884835389497,1.1062618106531208,0.11318743934755693,77.12234646663939,129.20208250578835,116.51674976348878,103.8314170211892,124.63499941144671,7.693901669212373,120.01839229038784,7.98182595432169,123.32214569374972,119.46307062514565,11.738650567132167,19.71396436139017,76846900,3.8545744772053396,1.1455339182276407,-634752000.0,-10.481421308327272,77.07053933241427,82.84087432937385,207.35174632695404,39.565603093869825,15.686842650913194,0.16365973784416796,5.764258243198286,131.08448190307618,126.29276194763185,122.42000198364258,118.54724201965332,113.755522064209,0.14,0.0,138.0480545187149,0.11763249192502201,0.10594675228473621,124.56571306501117,120.4221420288086,7.3612860331723
2022-08-02,1,135.10250091552734,108.80500030517578,135.67250061035156,113.16812467575073,121.3637490272522,1.1188746904928,7.273119218836128,0.6712176490645159,2.9938693945960435,115.49249935150146,5.764949684143067,0.06168508916279334,110.32824993133545,124.71074943542482,0.6750827210373365,0.22919592851960646,1.1458370974461052,1.0953220776490764,1.0773767155498244,0.16648680082464917,77.17538218507883,132.45348826982558,117.90724983215333,103.36101139448105,126.28249958583287,8.60824510708925,121.89678519112724,8.230418379371287,126.43339411749022,121.54921780750036,9.869621440140369,22.517213417544486,61922400,3.8489996997576217,0.9332570720646383,-696674400.0,-14.943994140624994,77.07053933241427,82.84087432937385,166.92330001112396,37.8724949225283,15.015564586181132,0.07167112293735951,5.591810934323705,131.4550018310547,126.89250183105469,123.20500183105469,119.51750183105469,114.95500183105467,0.14,0.0,138.03473191096447,0.1685393825885264,0.10747898578554486,126.24285670689174,122.11928503853935,8.064025929184231
2022-08-03,0,138.0675048828125,108.80500030517578,135.67250061035156,113.64500093460083,122.27937364578247,0.931497846247874,7.957181255438387,-0.11171564482353613,2.993543801852437,116.27124881744385,6.371737251281738,0.06678646267134336,110.65450096130371,134.9899974822998,0.7679353211160894,0.1876359713665405,1.1588325017328587,1.1029253597689765,1.0681709564244324,0.1569740959090038,75.20717775119468,135.05798738880645,119.14362487792968,103.22926236705291,128.59535762241907,9.368817368096632,123.90821416037423,8.511189809281133,128.61379671126022,123.31295318070039,9.332767863708401,24.16938609125725,71827800,3.839323050607841,1.0785878880465662,-624846600.0,-3.3564045446889663,77.07053933241427,82.84087432937385,170.01608763206497,38.69842088030114,13.81277216019714,0.08482369284923341,5.644539062064183,133.66960333251953,129.4502019958496,126.04000091552734,122.62979983520508,118.41039849853516,0.16,0.0,138.03828754165374,0.15334382792899492,0.21522521765803818,128.86857169015067,124.18285696847099,9.133048993547131
2022-08-04,0,141.56500244140625,108.80500030517578,138.0675048828125,114.41750001907349,123.50624895095825,0.7631127438934394,8.848414457292106,-0.6047871850836248,2.9930749299513644,118.02874946594238,7.151037492752076,0.07351677285961675,110.65450096130371,135.15950088500978,0.7919957905875452,0.1988668959481979,1.1761883645469458,1.1154755527448919,1.0643785032083366,0.1681003644756489,77.21973878912412,138.0559539565459,120.35912504196168,102.66229612737747,132.2732151576451,8.533892209567213,125.9266072681972,9.131841310334485,130.96981870064275,125.33979927500009,13.283835358067924,25.621550617917098,70585000,3.8610789433739776,1.0499044101339983,-554261600.0,-3.255476368066527,77.07053933241427,82.84087432937385,165.7442796518105,40.644434174646726,13.091970894508556,0.08378859387951432,5.529928232614676,136.38323849487304,131.94337907409667,128.35499954223633,124.76662001037597,120.32676058959962,0.18,0.0,138.0588387775667,0.16593072250142327,0.1785567155951962,132.83428737095423,126.2557144165039,10.294945659385997
2022-08-05,0,140.84000396728516,108.80500030517578,141.56500244140625,114.41750001907349,126.42187404632568,0.6456009235382308,9.883701356582083,-0.8578947340880196,2.992483607491305,120.06625080108643,8.08845012664795,0.08122758393627501,110.65450096130371,135.91200103759766,0.8050452917106938,0.22990379284025714,1.1574705498582667,1.0941748901979442,1.027451744234459,0.04343321659073074,79.63613852856703,141.4465279267872,121.67912521362305,101.9117225004589,135.3453584398542,6.793255622924277,127.78750038146973,9.339435037627322,133.6022836416953,127.43624710809982,22.22846038198749,24.93877614094067,50686900,3.881330703034209,0.7511586319096112,-604948500.0,-9.346409146386204,77.07053933241427,82.84087432937385,133.62774411032177,38.881257223492995,12.524034305031515,0.06407725147766306,5.367789561710726,136.5909178466797,132.27953802490234,128.7949981689453,125.31045831298829,120.99907849121094,0.18,0.0,138.07038563195874,0.04334943487074927,0.15145571195079652,135.66714477539062,128.18714305332728,10.994967564827625
2022-08-08,0,140.99499893188477,108.80500030517578,141.56500244140625,114.41750001907349,135.0087480545044,0.4659008951260146,10.593671187103471,-1.1643969897606126,2.99206280260777,120.99499988555908,8.955200538635253,0.08615122192763813,110.65450096130371,138.34475479125976,0.8347253094548643,0.24913526904433445,1.1466177521589773,1.0808769828263,1.0198589963616513,0.039230487369133815,79.25471538865966,144.15334274041786,122.96600036621093,101.77865799200401,138.17428697858537,2.9576197334215233,129.5212504523141,9.380203775478627,135.39034915954687,129.1264963660388,18.020700378540013,22.696289665020977,52229000,3.8151246759019126,0.7747344225410945,-552719500.0,-16.2289311807992,77.07053933241427,82.84087432937385,111.0024185737532,37.6404493553567,11.541575491227986,0.05932296569862244,5.4086620384492115,137.2207964477539,132.88459689331054,129.37999725341797,125.8753976135254,121.53919805908203,0.19999999999999998,0.0,138.080456694807,0.029692032576878136,0.03304932800834185,138.11428833007812,129.70142909458704,11.216760133496297
2022-08-09,0,137.76000213623047,108.80500030517578,141.56500244140625,115.5618748664856,135.2450008392334,0.2872864595793869,11.01205375107912,-1.3519817758191315,2.991837848904406,121.5349988937378,9.657225732803344,0.08853681195729861,110.65450096130371,140.85550346374512,0.839971273275984,0.2732362341102294,1.1075891636632513,1.0408233900497958,0.9888453416978727,0.01967025926755217,80.72864273770305,146.40235771959598,124.37825021743774,102.35414271527951,138.5717876979283,2.6246017342346293,130.7328577041626,9.261451229732996,136.7691331003084,130.34621586968996,16.33970741444103,20.795049300851254,40434700,3.740714858752025,0.6060076962874016,-593154200.0,-21.548803212463504,77.07053933241427,82.84087432937385,79.29140461572914,36.001959100060965,13.868607265578577,0.0915035357429929,5.250899786842307,137.2207964477539,132.88459689331054,129.37999725341797,125.8753976135254,121.53919805908203,0.19999999999999998,0.0,138.07919650540242,0.02735538214644384,0.018022028601861462,138.52571759905135,130.77714375087194,10.976610075051456
2022-08-10,0,142.79999923706055,108.80500030517578,141.56500244140625,116.49687337875366,136.1943759918213,0.11170714251722401,10.912829668521471,-1.4477626085926487,2.991970307540234,122.68124866485596,9.914500885009767,0.08679618144402922,112.96749897003174,140.85550346374512,0.8421460447822976,0.2661183010876506,1.1357727574306045,1.0613095657577287,1.0211268629517054,0.034276670374139506,73.13567223024094,147.55503460407178,125.72937526702881,103.90371592998585,139.59000178745814,2.6939992965454405,132.11250059945243,9.533361933693568,137.0012893496093,131.10436054248495,2.0614584617181193,14.042096434257953,54773800,3.8158658414513384,0.8249801789557141,-538380400.0,-6.351856324860402,77.07053933241427,82.84087432937385,100.47577946291628,40.28372725112646,12.617259137687318,0.06521119791717866,5.359407543534867,137.503484375,133.11326330566408,129.56500244140625,126.01674157714844,121.6265205078125,0.2,0.0,138.09830193191243,0.02272074306100791,0.06358078821151665,139.5685751778739,132.0671441214425,10.93437743460415
2022-08-11,0,142.1875,109.90749931335449,142.79999923706055,118.68187522888184,137.83687782287598,0.02989842410030215,10.791167139705351,-1.5342909958138755,2.9921433010812,123.52749919891357,10.091788330078126,0.08468367903817095,114.63950023651122,141.0519992828369,0.8093077822744748,0.2992743910033571,1.1158163391739204,1.0386439393437077,1.0099117751286812,0.004397256015669537,77.13525865807901,149.01145949303375,127.42912521362305,105.84679093421235,140.6021445138114,1.9572129784352141,133.44232204982214,9.548573017922406,138.45256406974485,132.60749552033195,5.253458581985603,15.641576496682516,44867300,3.8934817475081456,0.6789918596280318,-583247700.0,-13.169290819153709,77.07053933241427,82.84087432937385,83.9917506621694,37.722745509882685,13.495194136041931,0.017320461373632582,5.3144505336996986,137.503484375,133.11326330566408,129.56500244140625,126.01674157714844,121.6265205078125,0.2,0.0,138.1100539155219,-0.01353726475009065,0.008027487692734894,140.4942888532366,133.36857278006417,10.531185862480228
2022-08-12,0,142.32250213623047,113.30749893188477,142.79999923706055,120.431875705719,138.76062965393066,-0.058201384720786224,10.458699954274536,-1.641997383346029,2.9924377647283698,129.27374839782715,9.953625774383545,0.08104809872031718,115.71674976348876,141.62725219726562,0.8276336874635578,0.2548816392591682,1.1029065040292456,1.0239268262706163,1.0099775489258713,0.01052611564317818,74.89161415541382,149.9605251565044,129.04312524795532,108.12572533940624,141.21000126429968,1.6799255610450896,134.90267944335938,9.200893152067783,139.40098937675413,133.82352641204136,5.244165753010407,15.066359432835366,47643500,3.9060367131720146,0.7415841480133067,-535604200.0,-3.491861642854098,77.07053933241427,82.84087432937385,81.68781598231088,35.92858963946308,12.85334048900851,0.0557762494131347,5.181276056980635,137.503484375,133.11326330566408,129.56500244140625,126.01674157714844,121.6265205078125,0.2,0.0,138.1252058898747,0.019531249576671517,0.00687378605031879,141.07000296456474,134.9692873273577,10.330618198909287
2022-08-15,0,142.80749893188477,114.78750038146973,142.79999923706055,121.09374952316284,140.87875270843506,-0.19799667008993466,10.184121192094285,-1.6392984854273664,2.9926669276056748,135.0399990081787,9.685738286972045,0.07804290554050378,116.63224811553955,142.20100021362305,0.8268793778740349,0.23987804999023873,1.0943616969393872,1.0220154573326505,1.0112914422757828,0.01285506587985874,74.68201185570084,150.86211779236118,130.4938754081726,110.12563302398405,141.38750076293945,1.785979180635778,136.83035796029228,7.579567344060763,140.1600947654912,134.81440778346388,3.081823820188162,16.7750435805556,39014600,3.9182887033502927,0.6169239396852035,-496589600.0,-5.174975588163985,77.07053933241427,82.84087432937385,78.48368800779271,35.03009758901728,12.43429063110595,0.10454286220288705,4.973326532208646,138.12416552734376,134.11792517089845,130.8800048828125,127.64208459472655,123.63584423828125,0.2,0.0,138.13867481286846,0.027042456887163224,0.016903335031523813,141.15714372907365,136.99571555001395,9.88788367050236
2022-08-16,0,144.31500244140625,115.81999969482422,142.80749893188477,121.70624876022339,141.13749980926514,-0.348036775539071,9.848871968330426,-1.5693596902054137,2.992916315840847,135.38750076293945,9.235900726318357,0.07467213523848812,119.07375068664551,142.37025184631347,0.8254159265330959,0.22347877617574488,1.0941668664085824,1.02755710730341,1.0193501131458247,0.047582754090650825,74.69369470618996,151.59261927235423,131.89487533569337,112.19713139903253,141.88392911638533,2.0689673498078216,138.61464377811976,5.897906146315009,140.83883466887622,135.82609945866307,0.8776862000145728,23.30124271125047,59102900,3.9222026721538215,0.9359695234137678,-437486700.0,-6.282935064197765,77.07053933241427,82.84087432937385,85.38604452284609,36.77681881039785,11.613397183768749,0.08107125086888886,4.94451795943166,139.84636602783203,135.68682522583006,132.32500457763672,128.96318392944335,124.80364312744139,0.2,0.0,138.1660437237009,0.0504244130879512,0.038519438893372795,141.72571454729353,138.69642966134208,9.707292890991019
2022-08-17,0,142.2375030517578,115.81999969482422,144.31500244140625,123.08312368392944,141.7206268310547,-0.50731207246561,9.555094942555801,-1.392787841053009,2.993127332431554,136.71625137329102,8.684400644302372,0.07169484711893245,120.65125064849853,142.80074920654297,0.8380783312692841,0.19468533464871532,1.0672521934299881,1.0061648595265122,0.9954579509256398,-0.0039390489377310045,75.23280511265543,152.38469044587208,133.2745005607605,114.16431067564888,142.0614297049386,2.0329792509896074,140.117858341762,3.1643165472718646,141.71732861514852,136.94640603838624,2.4673376712828547,20.9326695788916,48149800,3.870669632200682,0.7767317621132548,-485636500.0,-31.567797066778734,77.07053933241427,82.84087432937385,63.445866455990746,34.6223038362999,12.719842375175164,0.041516351553473135,4.877052264947584,143.22824645996093,141.16088592529297,139.49000549316406,137.81912506103515,135.7517645263672,0.02,1.0,138.17984586176635,-0.0041348120246399445,0.030980223577845564,142.11000061035156,140.11214447021484,9.551694973922038
2022-08-18,0,141.6925048828125,115.81999969482422,144.31500244140625,123.5487494468689,142.20000076293945,-0.732978751042347,9.294280466722137,-1.0656180804350257,2.9932948710997676,137.91375350952148,8.079900722503657,0.06918141090004531,121.00674934387207,142.80074920654297,0.8578717763620061,0.15186058667625718,1.054679535102476,0.9993617257086193,0.99242511648127,-0.0034812843406593075,67.94471445318402,152.9350616162751,134.34650068283082,115.75793974938655,142.62321581159318,0.8389108810288574,140.59750175476074,2.8148381363288473,141.8116981501285,137.69981505733998,0.8812398519704273,17.36493927984288,37458700,3.9226321006798566,0.6155787080270158,-523095200.0,-32.695253306165085,77.07053933241427,82.84087432937385,57.94153481415543,33.364584997463126,12.865742154220902,0.017535763785441257,4.699405323034027,143.4878442993164,141.58108242797852,140.04000091552734,138.49891940307617,136.59215753173828,0.04,0.0,138.18977893741112,0.011803211528110591,-0.0027331935172443885,142.74857221330916,140.63714490618025,9.417582474475271
2022-08-19,0,139.43000030517578,115.81999969482422,144.31500244140625,132.1256227493286,142.20000076293945,-0.9771388199155028,9.074934920609092,-0.621227554834912,2.9934279698081823,139.45375442504883,7.492313575744629,0.0670940745456655,121.00674934387207,142.80074920654297,0.8515100661434356,0.14665780717605156,1.0308533247034837,0.9833157817476359,0.9772559878634263,-0.020323573487248003,66.27024179591682,153.40674583303948,135.2568759918213,117.10700615060311,142.14178739275252,1.4586288328132917,140.86589459010534,2.4667327488300446,141.74736695083618,138.1350032437218,2.854604156214509,4.974909096859469,47792800,3.932765889159568,0.7877807025474617,-570888000.0,-66.82695717027963,77.07053933241427,82.84087432937385,29.431355329236148,31.127784901418373,15.7752294720601,0.006620360445794585,4.677304863644674,143.62472473144533,141.8026431274414,140.3300018310547,138.85736053466798,137.03527893066405,0.06,0.0,138.19288193435924,-0.03706030798411475,-0.017135976056373327,142.1114283970424,140.84000178745814,8.932864329127238
2022-08-22,0,134.52750396728516,115.81999969482422,144.31500244140625,135.07124996185303,142.20000076293945,-1.2548385098443462,8.704435031210204,0.057948941874512716,2.993626180455284,140.13500213623047,6.837163505554196,0.06397973512141215,121.00674934387207,142.80074920654297,0.8265450607464221,0.14401757400869591,0.9888101915300257,0.9496857876103116,0.9467333970019565,-0.05798011327506647,60.88630275825426,153.4587460847593,136.04987602233888,118.64100595991846,141.0475022452218,3.223832889166511,140.8248233795166,2.572590569871578,141.14499558682328,138.30194385449425,-2.3599432422196807,2.769536698977544,50461500,3.9549497776679736,0.831604925901441,-621349500.0,-97.30324282603425,77.07053933241427,82.84087432937385,-28.7711987295143,28.59749062394362,22.138153212967495,-0.010160155559076282,4.727496707268063,143.3320870361328,141.32896685791016,139.7100067138672,138.09104656982421,136.08792639160157,0.08,0.0,138.17803959824832,-0.06956273197772589,-0.07196100042805394,141.05142865862166,140.77285875592912,8.253124664518017
2022-08-23,0,133.74250030517578,115.81999969482422,144.31500244140625,135.07124996185303,142.20000076293945,-1.5298124840774248,8.089511691459519,1.070002269825923,2.9939234683889997,140.13500213623047,6.014913158416746,0.059184745766589296,121.00674934387207,142.80074920654297,0.7170586189644943,0.1615222269189571,0.9784911847159582,0.9484745453041501,0.9523071871377082,-0.07325989645825659,52.4020232057556,152.86139967228672,136.68237628936768,120.50335290644863,139.8217876979283,4.1549044623093465,140.51589448111397,3.12874102303412,139.47557499037657,137.9157822414675,-5.387249957074176,-0.4256005213417208,36252100,3.8547842627797357,0.6130033216091614,-657601600.0,-94.38783567664716,77.07053933241427,82.84087432937385,-52.114048004981896,27.678726245578297,21.426910858093233,0.02699509309975107,4.535533000655982,143.3320870361328,141.32896685791016,139.7100067138672,138.09104656982421,136.08792639160157,0.08,0.0,138.16671924464652,-0.07708249589863392,-0.06676908819405754,139.63285609654017,140.35142953055245,6.521046382700904
2022-08-24,0,133.53000259399414,119.33500099182129,144.31500244140625,135.07124996185303,142.20000076293945,-1.664084886623414,6.5808331552649015,2.0397733047853572,2.994555532734793,140.13500213623047,4.8499506187438985,0.04783329584295831,132.48750019073486,142.80074920654297,0.6325402224926863,0.12073154727121442,0.9705731732280038,0.949673297914621,0.9653282837522712,-0.06121803512393742,48.790127962370754,150.74016763041507,137.57850131988525,124.41683500935542,138.49643107822962,4.508426990672989,139.94196592058455,3.6199002016599717,138.05265133251527,137.72957854856068,-6.028563088949875,-3.132528962052042,38627000,3.8256979135817755,0.6660889308994167,-696228600.0,-88.25157702260663,77.07053933241427,82.84087432937385,-75.63405856198816,26.182265225410994,21.632110945804378,-0.004435238484352099,4.452280187393419,143.1550870361328,141.04246685791014,139.3350067138672,137.62754656982423,135.51492639160156,0.1,0.0,138.15454618206152,-0.05840958969214616,-0.07583917543939896,138.29285757882255,139.72500065394811,5.318120710290769
2022-08-25,0,136.05999755859375,121.1924991607666,144.31500244140625,135.07124996185303,142.20000076293945,-1.6538375724782493,5.19440773591111,3.185654651915155,2.9950111024903405,140.13500213623047,4.0021750926971436,0.037562176709332075,133.72125053405762,142.80074920654297,0.4435996520393555,0.1018008830469067,0.9838868897477415,0.9740888195294364,0.9961598509125359,-0.039751625033922156,47.177272559737574,148.67706687181612,138.2882513999939,127.89943592817167,137.3171446663993,3.7483530623619026,139.6005368913923,3.75170710059214,136.94409400105735,137.50284597541088,-6.496505020591205,-5.675837748625615,37496300,3.8223165591707486,0.6725396229944796,-658732300.0,-64.20185045755274,77.07053933241427,82.84087432937385,-58.89890186762733,27.811870668698628,20.35879887274893,-0.030388375637264084,4.392831182659257,143.1550870361328,141.04246685791014,139.3350067138672,137.62754656982423,135.51492639160156,0.1,0.0,138.14962436038977,-0.03527761183979061,-0.0339198248922489,137.22142900739397,139.47357177734375,3.783521639795998
2022-08-26,0,133.90750122070312,133.53000259399414,144.31500244140625,135.5300006866455,142.20000076293945,-0.23477383844905853,3.473367815709008,-1.471047694659045,2.995419548972887,140.13500213623047,3.184462680816651,0.02498257344496173,134.44900360107422,142.80074920654297,0.7363198593378871,0.008019858724710453,0.9631441763660846,0.962902637682504,0.9885536497326621,-0.0396076817929093,44.7759391829588,145.9783619513033,139.03162631988525,132.0848906884672,136.12714440482003,3.209463649615247,139.09428705487932,4.017816728217023,136.75672249243024,137.74276464408044,-5.720129399688808,-3.393926635930601,53322700,2.3160341400776225,1.0460603217845843,-712055000.0,-98.44430686958536,77.07053933241427,82.84087432937385,-123.45398362678024,24.648131060968733,23.909100284011206,-0.07751282302110021,4.602629319265957,142.77748559570313,140.4312645263672,138.53500366210938,136.63874279785156,134.29252172851562,0.12000000000000001,0.0,138.13008264859087,-0.05411268146374437,-0.08116656924846874,135.5999995640346,138.85500008719308,4.121650593842936
2022-08-29,0,130.10249710083008,133.53000259399414,144.31500244140625,135.5300006866455,142.20000076293945,-0.2522565854547079,3.542944604507388,-1.4712160083421497,2.9954065808220736,140.13500213623047,3.243312454223633,0.025492821734416325,133.8910011291504,142.80074920654297,0.7156601233651186,-0.013009264086002784,0.9361365011392918,0.9412370820373759,0.9683595589799037,-0.032892953009305614,39.26224000608852,146.0640157348937,138.9781265258789,131.8922373168641,134.47142900739397,2.8265799433169696,138.54732240949357,4.680077680218283,136.05632127262987,137.34567830382932,-5.856403305971662,-5.0267724138255705,48101600,2.3615805835195207,0.9710134863432808,-760156600.0,-94.26972562473158,77.07053933241427,82.84087432937385,-160.98385637800857,23.404268701189405,25.44794314113649,-0.07442261317840221,4.5010123112985925,142.36920660400392,139.77040615844726,137.67000579833984,135.56960543823243,132.97080499267577,0.14,0.0,138.10278563750896,-0.02574694417610668,-0.0610576770764146,133.81285531180245,138.2807137625558,4.534402964685277
2022-08-30,0,129.72500038146973,130.10249710083008,144.31500244140625,134.9587516784668,142.20000076293945,-0.4919373536769814,3.983387487144219,-1.0014890603366289,2.9953178100281934,140.13500213623047,3.549662647247314,0.028719525725907982,133.72125053405762,142.80074920654297,0.6736523190990787,-0.03700896564323048,0.9352945194945217,0.947212388855993,0.971952188110024,-0.030039066972270323,32.56158184488576,146.66640132469126,138.69962635040284,130.7328513761144,133.08500044686454,2.324621523582562,137.61339391980852,5.0556719407322595,134.56694252616694,136.55961728450023,-8.179690091277585,-5.558583708374152,49203000,2.502267587530745,1.0061644262809666,-809359600.0,-90.46654964656034,77.07053933241427,82.84087432937385,-157.23211252421808,21.487360949542353,26.376221908614365,-0.028794355294973473,4.552369256138233,141.91608523559572,139.03696394348145,136.71000289916992,134.3830418548584,131.50392056274413,0.16,0.0,138.07172425049734,-0.036596314685985454,-0.03370368902583594,132.4557124546596,137.283570425851,4.951969463398783
2022-08-31,1,128.3874969482422,129.72500038146973,144.31500244140625,134.37250328063965,142.20000076293945,-0.5885813061134276,4.378962444136016,-0.93933565615135,2.9952286728319066,140.13500213623047,3.845425176620483,0.03163287349280115,133.18725204467773,142.80074920654297,0.7554738459619733,-0.06042337411995413,0.9274492532950783,0.9475406627607347,0.9677571112934399,-0.038511986413930055,29.43829819547978,147.188676211972,138.43075132369995,129.6728264354279,132.20785658700126,2.7995012836900894,136.62767941611153,5.426923688553119,133.36507536926115,135.9890524100335,-6.960481892321845,-9.156161712497752,53648700,2.383822065615057,1.1178537022221866,-863008300.0,-99.84872029760389,77.07053933241427,82.84087432937385,-147.3463885285384,20.174885415891495,24.939647468027463,-0.12649657827279734,4.5021998699261845,141.89012509155273,138.99494371032714,136.65500259399414,134.31506147766112,131.41988009643555,0.18,0.0,138.0336099012527,-0.052541152827716986,-0.0512647711752534,131.53428322928292,136.29285594395228,5.56161526136002
2022-09-01,1,126.37500190734863,128.3874969482422,144.31500244140625,133.8662509918213,142.20000076293945,-0.5548135801786347,4.896713819163525,-1.075390645071663,2.995097852974774,140.13500213623047,4.37782561302185,0.035497130496069666,130.06474742889404,142.80074920654297,0.7855724683390807,-0.09308448603755884,0.9161143778895607,0.9423199630997187,0.9600301072354588,-0.07118180086012649,24.09829639545123,147.74017856529846,137.94675092697145,128.15332328864443,131.1553568158831,3.438410888261324,135.48857225690568,5.800464092711612,132.1249040297526,135.24475608061522,-4.564127660122287,-9.705496651785714,56636100,2.201072634210774,1.1975033380801203,-919644400.0,-81.84201061654555,77.07053933241427,82.84087432937385,-144.97936371378154,18.77618060962859,28.108150351127723,-0.11175651608617522,4.492042771564587,141.16324645996093,137.81838592529297,135.11500549316406,132.41162506103515,129.0667645263672,0.19999999999999998,0.0,137.987564498412,-0.06891025035395992,-0.04469359656606548,130.7057124546596,135.1692842755999,5.8391961427943535
2022-09-02,1,128.69500160217285,126.37500190734863,144.31500244140625,133.68937587738037,142.20000076293945,-0.48491480138461424,5.426015803865385,-1.0884906569097086,2.9949446959969155,138.59500122070312,4.83277561187744,0.03955189544405954,129.59125003814697,142.80074920654297,0.800485996726297,-0.1027052091201056,0.9380973870212667,0.9707061001857075,0.9922551905494813,-0.0389261211732953,21.79250434405132,148.0392825079993,137.18725090026857,126.33521929253781,130.46464238848006,3.3667693932427674,134.48053673335485,5.655154244741529,130.6821573581396,134.21362384855604,-5.508718904623342,-11.20518539901509,57429800,2.2207285311649567,1.2056903829639114,-862214600.0,-83.19512065164537,77.07053933241427,82.84087432937385,-104.88651391288124,22.598867868043918,25.895379567446003,-0.13015230061317282,4.527611564681598,141.16324645996093,137.81838592529297,135.11500549316406,132.41162506103515,129.0667645263672,0.19999999999999998,0.0,137.94901585633434,-0.024780098384470484,-0.0711683910980614,129.80714089529855,134.04999923706055,6.117340543422723
2022-09-06,1,126.84749794006348,126.37500190734863,144.31500244140625,132.67312622070312,142.20000076293945,-0.28701397567676473,5.657886483157457,-1.3304792497465843,2.9948704220025606,136.9099998474121,5.0747504234313965,0.04142543894246762,128.6642511367798,142.80074920654297,0.8502598862854984,-0.08723711779063945,0.9287413765835093,0.9645812436703664,0.9859354589820715,-0.02501872933494864,30.675624780233957,147.89577374832783,136.58000078201295,125.26422781569806,129.1485710144043,2.505402307448935,133.23285784040178,5.229375111159563,130.1797748410346,133.5524586999643,-3.6209098314199806,-9.882182263021907,43888600,2.3182258646151053,0.9295423991494278,-906103200.0,-87.5760811532301,77.07053933241427,82.84087432937385,-114.75243523597732,21.201273363650493,26.923866654134137,-0.11050558795454776,4.48135336663688,138.72608459472656,135.8469644165039,133.52000427246094,131.19304412841797,128.31392395019532,0.19999999999999998,0.0,137.9138163783751,-0.028353439141247216,-0.03548756703364006,128.2114268711635,132.71642793927873,6.463153463353354
2022-09-07,1,127.70500183105469,126.37500190734863,144.31500244140625,130.00812292099,142.20000076293945,-0.12971218286229044,5.9390883257256775,-1.4267290710910254,2.9947746715231047,135.29375076293945,5.288625335693359,0.04371070547662563,128.23349704742432,142.80074920654297,0.8667278850860741,-0.07921387940583544,0.9398876421402796,0.9768065495452355,0.9976485639315442,-0.015571389820582149,29.03209226970319,147.75080238387324,135.87262573242188,123.99444908097053,128.26249967302596,1.390615131134079,132.19482203892298,4.722214545816297,129.3488225568043,132.7655977817781,-6.770909733820143,-12.103734335198315,47900300,2.2565977257288066,1.00655083979751,-858202900.0,-69.54478346653167,77.07053933241427,82.84087432937385,-83.65364917646677,21.620745186048154,25.025202277201323,-0.07480672010392322,4.476971394574059,138.26004412841797,135.46998403930664,133.21500396728516,130.96002389526367,128.16996380615234,0.19999999999999998,0.0,137.88147051645316,0.0058261479444727815,-0.0023884550013831547,128.02999768938338,131.81499862670898,6.575811358568287
2022-09-08,1,128.73000144958496,126.37500190734863,144.31500244140625,129.4675006866455,142.20000076293945,0.0125299452818473,6.1787868621724495,-1.5404786856938006,2.994690267667152,134.21750259399414,5.552362709045411,0.04564373594522745,127.61925144195557,142.80074920654297,0.8740677211414678,-0.1057072653127038,0.9509501339762529,0.9892149334348979,1.0088399978323532,0.002667740313379907,27.546263724178946,147.727449441508,135.3698757171631,123.01230199281817,128.0664288657052,1.166670740755582,131.2689289365496,3.919263496473003,128.9534050373249,132.36711333077716,-4.631928258765449,-10.217067165060536,43988500,1.868874016036779,0.9349450331769087,-814214400.0,-64.69911324122096,77.07053933241427,82.84087432937385,-68.04290795632457,21.250028143308207,23.728698757697583,-0.03871180726199351,4.384330545568106,136.9918013305664,134.44410177612303,132.38500213623047,130.3259024963379,127.77820294189453,0.02,1.0,137.85450525202975,0.024059404921654703,0.008467425097929235,128.03428540910994,130.92357036045618,6.423736330996828
2022-09-09,0,132.15750122070312,126.37500190734863,144.31500244140625,128.72125148773193,141.81625366210938,0.20561097015153845,6.093156385012745,-1.4819383358359468,2.9947113083184345,133.82500076293945,5.372150268554686,0.04524630849800728,127.61925144195557,142.3710018157959,0.8849630624786312,-0.09464614365127061,0.9813697027809339,1.0193130261094003,1.0351451607177014,0.04575667043387188,32.01975491698858,146.8526885978148,134.6663758277893,122.48006305776381,128.4139289855957,1.8844735300018325,130.7494647162301,3.163454956043128,128.90508223430083,131.9848747506442,-1.0549341341092218,-9.148333882549569,49387600,1.9125259292896981,1.0446807270730458,-764826800.0,-32.1806503023222,77.07053933241427,82.84087432937385,-20.63796482060336,25.501363332384038,22.2199818995261,0.028528608748954073,4.34759227972866,134.48588226318358,132.41706253051757,130.74500274658203,129.0729429626465,127.00412322998046,0.04,0.0,137.83642884578592,0.04263812072170903,0.05127402225698524,128.68285805838448,130.56928525652205,6.260728003821907
2022-09-12,0,135.26000213623047,126.37500190734863,144.31500244140625,128.72125148773193,139.99562644958496,0.37867629446197215,5.861860599882373,-1.2759937801332482,2.9947825509154926,133.63625144958496,5.00735061645508,0.04369146962681794,127.61925144195557,142.3710018157959,0.882618971171895,-0.0714223033108106,1.008162540606481,1.0463917777758212,1.0499351943857365,0.051012086346225116,43.753264822410046,145.88859708858922,134.16487588882447,122.44115468905973,129.3957154410226,3.1996908531525343,130.80178601401192,3.2359739509478413,129.73741339515226,132.11145895050893,1.8751210885183112,-5.21587826762896,53826900,2.119091287832331,1.1311861694386667,-710999900.0,-9.738920685514916,77.07053933241427,82.84087432937385,26.88393168357735,28.81388918354242,21.022292521877194,0.03360353783254332,4.267050018567847,134.48588226318358,132.41706253051757,130.74500274658203,129.0729429626465,127.00412322998046,0.06,0.0,137.82829037236095,0.07011210620528652,0.06751679920217854,130.06571524483817,130.79999923706055,5.887163137519431
2022-09-13,0,128.87499618530273,126.37500190734863,144.31500244140625,128.72125148773193,136.90249824523926,0.47607092819414415,5.565009811500591,-1.0117813323308054,2.9948727009682523,133.63625144958496,4.593175649642944,0.041588349113854714,127.61925144195557,142.2945026397705,0.8521360766182804,-0.05285084363289805,0.9631067176781555,0.9959543266309214,0.9902796625071049,0.015983746452746583,51.652887919531516,144.94177051182564,133.81175088882446,122.68173126582329,129.75285748073034,2.9348967775589965,130.45410714830672,3.1562178746126475,131.13232767124651,132.6278449625508,5.352939617444871,0.5444969596131389,72694000,2.2612389865993068,1.4754677156951066,-783693900.0,-77.69938997140996,77.07053933241427,82.84087432937385,-74.61941524972806,24.345981225269416,29.53683308425674,-0.04486018180200961,4.689403818188486,134.48588226318358,132.41706253051757,130.74500274658203,129.0729429626465,127.00412322998046,0.06,0.0,137.7800210702287,0.005629998263709357,-0.005411359343160171,129.92285810198103,130.3142852783203,5.6393780859037665
2022-09-14,0,127.77000045776367,126.37500190734863,144.31500244140625,128.72125148773193,135.4600009918213,0.6722240349655274,5.258940085945559,-0.6455856583650532,2.99495832871305,132.84375190734863,4.355126094818115,0.039506705614831175,127.61925144195557,141.74700469970702,0.7450317754220088,-0.10698822710668876,0.9598458457402491,0.9883524195327625,0.9787392128046679,0.0005089747917232934,38.14961241888889,143.63300592338646,133.11512575149536,122.59724557960425,129.62071446010046,3.0103196130969976,130.04267842429024,3.0993263801682875,130.57387685259306,132.0841465303705,1.97823480927578,-3.639459490263976,45316800,2.576183103487929,0.9328448383400777,-829010700.0,-65.49047267793398,77.07053933241427,82.84087432937385,-71.89171640731624,23.383224845228217,28.368805628926058,-0.022809940323370498,4.5337316534272025,134.48588226318358,132.41706253051757,130.74500274658203,129.0729429626465,127.00412322998046,0.06,0.0,137.74937701045468,-0.0071825201302772035,0.01934820735545985,130.07142966134208,129.9392852783203,4.973199345776286
2022-09-15,0,127.38249778747559,126.37500190734863,142.2375030517578,128.61812543869019,134.71062850952148,0.7240902730983462,4.704122067696829,-0.52284803529023,2.9951051325619686,131.1299991607666,3.9796635150909423,0.03555973700916083,127.61925144195557,139.65625076293946,0.7119631279514781,-0.10171369915520566,0.9629189157309453,0.9868473110474805,0.9756737210109736,-0.010467673789603005,37.22040573471308,141.6961197877069,132.28787565231323,122.87963151691959,129.69714300973075,2.9340001074244006,129.4228570120675,2.6365134820618708,129.8593618838441,131.41148917591633,-0.7187545226259683,-4.31363890087241,52887200,2.560154992315476,1.0833986636761177,-881897900.0,-81.51026495593041,77.07053933241427,82.84087432937385,-74.38861006475263,23.99636728798992,26.20363972068173,-0.06027591993111833,4.557750482452775,134.48588226318358,132.41706253051757,130.74500274658203,129.0729429626465,127.00412322998046,0.02,1.0,137.71196459135197,-0.027268589933760246,-0.024714218827870883,130.09571511404855,129.15357099260603,4.541878934667564
2022-09-16,0,122.71999931335449,126.37500190734863,141.6925048828125,128.23312282562256,134.06250190734863,0.8017626581959435,4.222613977708678,-0.2572556057718507,2.9952212499380355,129.9137487411499,3.640138568878174,0.03210011747085687,127.32899780273438,136.39699783325196,0.6414849784425382,-0.10099339486708966,0.9329117970001498,0.9514671804977416,0.9419060682801504,-0.07141101958025065,36.809174863917434,139.99035334451648,131.54512538909913,123.09989743368178,128.98499979291643,3.9330228352910304,128.6237497329712,2.8587503573885895,129.23212565924277,130.74674568128412,0.4217661807290053,-6.37770096047608,115667800,2.561097184860559,2.1937332608965914,-997565700.0,-82.0772621939789,77.07053933241427,82.84087432937385,-153.00801010050026,21.930992314462213,31.352184742897716,0.008801073580015207,4.630768464676986,132.7635634765625,130.45822222900392,128.59500122070312,126.73178021240236,124.42643896484375,0.04,0.0,137.5943970292078,-0.07308475411504689,-0.048451765444850914,129.24571555001395,128.63785661969865,4.0706135756941535
2022-09-19,0,123.3325023651123,122.71999931335449,139.43000030517578,127.75375080108643,133.78375053405762,0.3096999016710428,3.9593251784806167,-0.4256674068800135,2.995273964875827,129.29999828338623,3.384300842285154,0.030317238020366056,126.800248336792,135.3400016784668,0.5341795656231283,-0.11984509040556171,0.9443783122873838,0.9589334181276832,0.96052229262554,-0.0881820167288263,30.871261439977577,138.5151504675875,130.5965001106262,122.67784975366494,128.21392849513464,4.482109959418606,128.14017868041992,3.147388762940671,127.60054108908942,129.47992670409892,-3.9035295769346807,-8.354649146136826,47279700,2.6884432516240286,0.8971342186201692,-950286000.0,-74.92080702425756,77.07053933241427,82.84087432937385,-128.4486343052024,22.250760103939168,29.906537656525124,0.08839576889869034,4.507856103165591,132.7635634765625,130.45822222900392,128.59500122070312,126.73178021240236,124.42643896484375,0.04,0.0,137.55013474035582,-0.08640522938673978,-0.06460569021029695,128.5085721697126,128.27142878941126,3.818437165263655
2022-09-20,0,122.77000045776367,122.71999931335449,136.05999755859375,127.62437582015991,133.58312702178955,-0.012674167391763712,3.7101454347654492,-0.8288366588444918,2.9953235401003835,128.80249881744385,3.095450439453123,0.028585399317243694,126.070751953125,134.6007537841797,0.6503635634449753,-0.08321719553270898,0.9459007871709556,0.9585565076901952,0.9742413758246301,-0.047371452246337986,34.31201242151322,137.21191608315394,129.79162521362304,122.37133434409213,126.87285695757184,4.5098251015998425,127.64339297158378,3.4154708885624245,126.5287841982427,128.38994105522025,-4.192883573132328,-5.203585547225119,47698400,2.5315618036658116,0.9074579661168181,-997984400.0,-90.56361819612044,77.07053933241427,82.84087432937385,-141.8602226647641,20.989972795274515,29.274383134846012,0.11024805397875609,4.4372952341577,132.7635634765625,130.45822222900392,128.59500122070312,126.73178021240236,124.42643896484375,0.04,0.0,137.50208624659743,-0.03650841558555018,-0.10450710755416881,126.92571476527623,127.80428641183036,4.07329021481686
2022-09-21,0,120.80999946594238,122.71999931335449,136.05999755859375,127.24874782562256,132.50062656402588,0.05240124950997853,3.8423059817387433,-0.7791882121839495,2.9952901736873794,128.7125015258789,3.0855002212524427,0.0297383472275713,123.27625217437745,134.04275131225586,0.6781598952144404,-0.08204198233452256,0.9350347759277392,0.946265861958648,0.9680676260433886,-0.054472888525362584,33.728604361208276,136.88836200162447,129.20375003814698,121.5191380746695,124.8085708618164,3.125599457227726,127.1021431514195,3.8599620863353077,125.59614968257299,127.40793990194538,-7.103267446970203,-5.361341224323886,58498900,2.5311436041570596,1.0898724815903569,-1056483300.0,-99.50108689216515,77.07053933241427,82.84087432937385,-173.52196354971673,19.220670843347918,31.07696168410962,0.06690491396278217,4.4996316790846365,132.23256347656252,129.5987222290039,127.47000122070312,125.34128021240235,122.70743896484376,0.06,0.0,137.43445660256847,-0.07786854841380408,-0.06528937706372506,124.36714390345982,127.21642957414899,4.569981669321867
2022-09-22,0,117.36000061035156,120.80999946594238,136.05999755859375,126.72937393188477,130.61624813079834,0.024058168731184423,4.103404811435247,-0.6265961279215717,2.9952227896522365,128.54124927520752,3.1471251487731933,0.0319189217365977,122.76500034332275,134.04275131225586,0.67839337991898,-0.09525951382422779,0.9129015650733788,0.9242345830591385,0.9510303698163265,-0.07868033168768218,30.821938065664984,136.76393461905585,128.5571249961853,120.35031537331477,123.16357149396624,3.6198401263053728,126.45821448734829,4.659701081228102,124.4092507806248,126.48974896418449,-10.683130594463844,-5.902052506993401,55229200,2.5479034589393557,1.01328490239584,-1111712500.0,-94.80971207054492,77.07053933241427,82.84087432937385,-198.04661375054377,18.423815117939448,33.377238030577665,0.0569594468643636,4.3589435736264655,131.71572470092775,128.76214421081542,126.37500381469727,123.98786341857911,121.03428292846681,0.08,0.0,137.36077957762885,-0.07103263626396006,-0.08743683567738625,123.00857216971261,126.46571513584682,5.012034865845445
2022-09-23,1,114.47249984741211,117.36000061035156,136.05999755859375,125.61437702178955,129.81937456130981,-0.2321746602059578,4.606144025275872,-0.17588410091831497,2.9950800271807223,128.07874870300293,3.4435122394561772,0.03605631003065244,122.52899932861328,134.04275131225586,0.6295769146906025,-0.13743934502269192,0.8960761803871088,0.9096399292568134,0.9429482195426873,-0.06720583044401052,24.44534810751036,136.9609129475549,127.74862489700317,118.53633684645143,121.26392854963031,4.236242253761722,125.44232150486538,5.591698402165203,122.64514158014119,125.24975814106972,-8.93501137986018,-7.133532075913546,65126700,2.502178260347948,1.1653360710187812,-1176839200.0,-92.95947334397228,77.07053933241427,82.84087432937385,-215.89322347067122,16.86162377760501,37.33048065471045,0.01696426981271264,4.422590478526797,130.72452362060548,127.15774246215821,124.2750015258789,121.39226058959962,117.82547943115236,0.1,0.0,137.2594848844704,-0.0789281963599765,-0.09898638043104992,120.89857155936105,125.48500061035156,5.361499812171922
2022-09-26,1,114.72999954223633,114.47249984741211,135.26000213623047,123.19187688827515,129.08749723434448,-0.6624769651651925,5.040867155424365,0.16037389832663917,2.9949327900533085,127.73750114440918,3.8844746112823487,0.03979550802557797,120.4649995803833,132.33250122070314,0.6633071926470975,-0.14513751056603405,0.9057446817745499,0.9246807858071767,0.9580873244531749,-0.06975049283772106,22.048600987645983,136.75098432229285,126.66925001144409,116.58751570059533,119.4564288003104,3.874283631506615,124.57678590502057,6.255848820489787,120.5921982557715,123.70044051429493,-10.407373063090231,-11.051324121138682,62723300,2.525514162042984,1.1129705977049205,-1114115900.0,-87.35160473315871,77.07053933241427,82.84087432937385,-159.0542803036759,17.80179342478011,34.783447136683925,0.05865704345791462,4.407405375118336,130.72452362060548,127.15774246215821,124.2750015258789,121.39226058959962,117.82547943115236,0.1,0.0,137.16791658597643,-0.07628751690082813,-0.06783775063731663,119.30857195172992,124.70214353288922,5.81237104584597
2022-09-27,0,115.7450008392334,114.47249984741211,135.26000213623047,122.75750017166138,128.7662501335144,-0.6699165749254653,5.38503215514764,-0.1967983350547713,2.9948051889235083,127.54374980926514,4.377762289047243,0.04283681564272178,117.09700050354004,130.3079975128174,0.7702353992276897,-0.11815682174555027,0.9207275127925364,0.9485565232205833,0.98065298511967,-0.057220816097879434,23.920449304928983,136.48043923781603,125.71037492752075,114.94031061722546,118.46000044686454,3.791089568887406,123.72250011989048,6.602801338905135,119.11417176014605,122.5444717314079,-9.932681855829701,-9.552808368007991,60094700,2.451818481557673,1.0551017086605505,-1054021200.0,-90.38065763298351,77.07053933241427,82.84087432937385,-133.38108521710785,17.868681626752597,31.853614461401918,0.04765097964257332,4.469019051556795,130.72452362060548,127.15774246215821,124.2750015258789,121.39226058959962,117.82547943115236,0.1,0.0,137.0811075299585,-0.06367132027047473,-0.08222364590797382,118.00571550641742,123.62571552821568,6.234806932576831
2022-09-28,0,116.22249984741211,114.47249984741211,135.26000213623047,122.24249935150146,128.70375156402588,-0.47532620415231,5.699484559276506,-0.6513347339766233,2.994684281305134,127.11499786376953,4.79999984741211,0.04559861234920622,115.6435007095337,129.96825046539308,0.8187922896091573,-0.10776642513876816,0.9298357880752913,0.9628301044145318,0.9965615830993481,-0.037972846939905325,27.69193263563612,136.39146923299396,124.99250011444092,113.59353099588787,117.4442858014788,3.1695835956591383,122.8291071483067,6.718296672122304,118.26444428319846,121.73191847198947,-5.683668931834869,-9.365334810960329,55763800,2.4842219296867674,0.973456101011882,-998257400.0,-75.64468831294559,77.07053933241427,82.84087432937385,-97.9956888505944,17.082032639470384,29.376005183598714,0.09435503888422538,4.499802975751928,130.72452362060548,127.15774246215821,124.2750015258789,121.39226058959962,117.82547943115236,0.1,0.0,137.00694371955413,-0.004471054287189857,-0.034209020555345256,117.05571528843471,122.78214372907367,6.344337680312851
2022-09-29,1,114.88249969482422,114.47249984741211,135.26000213623047,119.94749975204468,128.46437311172485,-0.2749407062145521,5.895264857075009,-0.9288173615292528,2.99460212599623,126.61124992370605,5.069387350082397,0.04742108537052344,115.6435007095337,129.20324668884277,0.8503242418270762,-0.09475219464504589,0.9241065427398617,0.9609215854484187,0.9928828198924214,-0.021110266723267324,29.903743109049643,136.10790480188808,124.31737508773804,112.526845373588,116.31749997820172,2.220718668755179,121.59517846788678,6.454426903494438,117.73791565483276,121.09023205680194,-5.7649057477580525,-9.716073534786073,58969700,2.4941240605287067,1.0246618616030472,-1057227100.0,-88.78426277837298,77.07053933241427,82.84087432937385,-111.27480899793947,15.74933659403149,28.25049371341843,0.14780266661202085,4.531960239528688,130.72452362060548,127.15774246215821,124.2750015258789,121.39226058959962,117.82547943115236,0.1,0.0,136.9206407939571,-0.021396254019886762,-0.0315505132013176,116.00000108991351,121.46285792759487,6.658186293183648
2022-09-30,1,114.20999908447266,114.47249984741211,135.26000213623047,117.0756254196167,128.00125074386597,-0.10521721076469241,6.157981361132023,-1.1127409055219502,2.994488877043988,124.85375213623047,5.337625026702881,0.04980488122411825,114.86724967956543,129.20324668884277,0.8629204042863902,-0.09093967983438765,0.9237142994474976,0.9653901490896268,0.991315888133907,-0.0022931338381650956,28.5797782244305,135.95808794733117,123.64212522506713,111.32616250280309,115.37464278084892,1.1273641043061957,120.09160682133266,5.390436170256777,117.0067252330299,120.41926755823448,-6.424615731473403,-13.071525540596928,59479600,2.479126018261241,1.0309749564827015,-1116706700.0,-95.13959348810943,77.07053933241427,82.84087432937385,-102.32086204344466,16.078606687109357,26.42080563392421,0.05535167542418312,4.499677490007668,126.83575476074219,124.01211529541015,121.72999572753906,119.44787615966797,116.62423669433595,0.1,0.0,136.83275159478495,-0.0068553242016627935,-0.03674024080037181,115.20857238769531,119.78785814557757,6.9945755045432945
2022-10-03,1,114.70499992370605,114.20999908447266,135.26000213623047,116.10312509536743,128.00125074386597,0.03215125701714386,6.451789336178325,-1.2482350972611154,2.9943570214417075,123.05125141143799,5.641625213623047,0.052439129725674806,114.70424957275391,129.20324668884277,0.8626411499273728,-0.11255295339656482,0.9323042117096936,0.9765992478073131,0.9960662752157037,-0.00021789957840168128,25.238694410580667,135.93745375628,123.03387508392333,110.13029641156666,114.99535696847099,0.7217421855859883,119.07946423121861,4.9245380556907135,116.31912112982926,119.86893319764513,-5.4631242534938815,-15.562622149419145,50941900,2.381437552897493,0.887981804547399,-1065764800.0,-79.13708244580685,77.07053933241427,82.84087432937385,-83.24223446630293,14.939542609831017,25.168545672826955,0.10714113545887013,4.496843862646681,126.04883569335938,123.37557604980469,121.21499633789062,119.05441662597657,116.38115698242189,0.1,0.0,136.76075415791672,0.006339519911990443,0.018456657555380375,115.00428662981305,119.00642939976284,7.0813518883960525
2022-10-04,0,120.9424991607666,114.20999908447266,135.26000213623047,115.5293755531311,127.72125148773193,0.21722872198921495,6.557619664936235,-1.2319791078438909,2.9942999621061275,122.74499988555908,5.787187614440919,0.05360406398394756,114.68174991607665,129.20324668884277,0.8870969581813458,-0.09572516772932214,0.9886223652245463,1.0373249956106643,1.0502765823641085,0.04490473267828121,28.14644723215171,135.44961432987247,122.334375,109.21913567012753,115.91964258466449,2.3180618369286012,118.5917855671474,4.2956134006113915,115.92422828612038,119.42711860497644,-2.2622705119612343,-10.995147764134456,62812600,2.382704173973642,1.0771374059022834,-1002952200.0,-50.68268714728112,77.07053933241427,82.84087432937385,-9.581878188119457,22.604043969977354,22.435960301860256,0.10622452259575338,4.6842123846762975,126.04883569335938,123.37557604980469,121.21499633789062,119.05441662597657,116.38115698242189,0.02,1.0,136.6978870330755,0.058386438789998385,0.051584843537121096,116.04857199532645,118.47357177734375,7.031797770564763
2022-10-05,0,119.74250030517578,114.20999908447266,135.26000213623047,115.5293755531311,127.72125148773193,0.3444963093221467,6.4802511623767645,-1.1073532055057205,2.9943298576453445,121.83124923706055,5.631125259399414,0.053099783853217654,114.68174991607665,129.20324668884277,0.8886116550254991,-0.05295409399260988,0.9811812420425764,1.0286449428666602,1.0305527532063203,0.030286738474779584,48.30240076968952,134.9996273857887,122.03912506103515,109.07862273628162,116.63571412222726,2.641027121325741,118.04607146126884,3.505579037108378,117.1939052141193,119.86764639023585,5.652011899782723,-5.34358712728815,48217500,2.822769112673346,0.8266295492698127,-1051169700.0,-29.723333459987217,77.07053933241427,82.84087432937385,-19.310971215334128,21.19117785685176,24.26661788628346,0.09649626657507036,4.639625604685021,121.72459872436524,119.87769850158692,118.3849983215332,116.8922981414795,115.04539791870118,0.02,0.0,136.64635493759246,0.024913098540730427,0.05716277490426093,116.87714276994977,118.09285736083984,6.819351774973514
2022-10-06,0,120.52499961853027,114.20999908447266,135.26000213623047,115.5293755531311,127.47937345504761,0.5141064254257081,6.36347136678718,-0.8899676660274487,2.99437491781816,120.87624931335449,5.422850151062012,0.05231354039826556,114.68174991607665,129.20324668884277,0.8715561500072458,-0.06981667865457913,0.9908254587980128,1.0363173202104652,1.0310402791880724,0.04911539998428727,44.90926442190891,134.3679427183156,121.64099998474121,108.91405725116682,117.31857109069824,2.969827760914538,117.88928576878139,3.32488791836052,117.85557487368457,119.98795339878818,4.368953876875217,-5.997682267972436,42253800,2.8091715370291386,0.7254680157040686,-1008915900.0,-34.86162451200544,77.07053933241427,82.84087432937385,-10.97079415709976,20.501178969961718,23.476480620519926,0.062118804151824525,4.453223662577513,121.72459872436524,119.87769850158692,118.3849983215332,116.8922981414795,115.04539791870118,0.02,0.0,136.6023110524219,0.04790940639191721,0.01940514256481195,117.71857125418526,117.86214338030133,6.551528769484258
2022-10-07,0,116.15249824523926,114.20999908447266,135.26000213623047,115.5293755531311,124.34500122070312,0.6918999224398112,6.154269936454087,-0.5182612229481349,2.994457506773126,120.66749954223633,5.042150077819824,0.05076492508605586,114.68174991607665,129.20324668884277,0.8264389198440398,-0.08801998747499444,0.9581108617044483,0.9960104568816501,0.9841347055340551,0.017008135682847536,44.75004648451189,133.53928976609666,121.23074989318847,108.92221002028029,117.3085708618164,2.9742482315005856,117.3764283316476,2.9537322046914367,118.5381844839363,120.10473460138383,4.1297669399442665,-1.788624272413402,54678000,2.6747501440345567,0.9345384671589922,-1063593900.0,-79.74068722645629,77.07053933241427,82.84087432937385,-70.75665278170541,18.454626513214805,29.871581664596672,-0.00018171679480309712,4.593708119047703,121.48776058959962,119.68612001037599,118.22999954223633,116.77387907409668,114.97223849487305,0.02,0.0,136.52847196623867,0.013805288129148385,-0.0020906401287796757,117.22571345738002,117.14071437290737,6.062153317544931
2022-10-10,0,114.36249923706055,114.20999908447266,135.26000213623047,115.5293755531311,122.91062593460083,0.905372144853243,5.7056441714725645,0.10761768614570189,2.994624791022018,120.13374996185303,4.608249950408935,0.04737706962589559,114.68174991607665,127.88050003051758,0.6999158985847902,-0.14126499770232603,0.9496140884557267,0.9792504616628643,0.9657893717150874,-0.002985926392688354,33.74224745629545,131.8417880873604,120.43049974441529,109.01921140147016,117.23428508213588,3.0504590727448444,116.7758925301688,2.607136419153277,117.94223594259682,119.50387531206079,-0.06023068017359486,-5.821664185988406,42339700,2.6490411933152402,0.7308306836793426,-1105933600.0,-86.23931640651745,77.07053933241427,82.84087432937385,-84.80229333422403,17.34511018419445,30.357750035661923,-0.057964557494425466,4.538443224954381,120.99880105590822,119.29060038757325,117.90999984741212,116.529399307251,114.82119863891603,0.02,1.0,136.46780582877264,-0.019071445778856777,0.005929187335799352,117.0642841884068,116.53214263916016,4.89911240365833
2022-10-11,1,112.69750022888184,114.20999908447266,128.87499618530273,114.84437465667725,122.73249959945679,0.6169390539452939,4.72312775513505,-0.8549982943328449,2.994955641870687,118.55125045776367,4.101374912261963,0.03956194701817174,114.46149978637695,127.42124805450439,0.7419501956681872,-0.11260909701502853,0.9439788132531546,0.9652973526043688,0.9522793601990804,-0.06817288371827712,33.362559714457895,128.83188010972688,119.38562459945679,109.9393690891867,117.01821381705147,3.3401872900292093,116.1964282989502,2.5422801072032004,117.03426920296022,118.59848120994829,-0.4526367890192238,-6.8481723461388615,56432200,2.3384374580223564,0.9879487382611257,-1162365800.0,-85.56701342797574,77.07053933241427,82.84087432937385,-99.8478401376451,15.967562798895154,31.129777023510822,-0.022873978517496497,4.577840425236378,120.02403985595703,118.1829797668457,116.69499969482422,115.20701962280273,113.36595953369141,0.04,0.0,136.38233940592283,-0.07333386342368975,-0.03167067877055071,116.95142691476005,116.07999965122768,4.786978725013256
2022-10-12,1,112.65500068664551,112.69750022888184,127.77000045776367,114.72374963760376,121.38687419891357,0.6430485367191073,4.403157852936678,-0.7037425279716665,2.9950479637419156,116.79125022888184,3.8804250717163087,0.03713339976262309,114.34724922180176,123.73750190734864,0.6961813258207079,-0.11796587755248762,0.9500597787939323,0.9674586863404081,0.9653715735182692,-0.05918950748871177,31.06109731862919,127.38306550750909,118.57674980163574,109.7704340957624,116.72535678318569,3.6521094453257463,115.86035687582833,2.6836834453707317,115.95523568765435,117.68713079609037,-1.3243138671878785,-6.715089208611036,45728700,2.3460686861601947,0.8002758781453022,-1208094500.0,-80.09514659206278,77.07053933241427,82.84087432937385,-94.49729330145449,15.341150459968564,29.90854641486027,-0.04397042130297125,4.424423257888806,120.02403985595703,118.1829797668457,116.69499969482422,115.20701962280273,113.36595953369141,0.04,0.0,136.3135812226627,-0.06655639210812136,-0.0676356021116582,116.52571323939732,115.76499993460519,4.302575662313069
2022-10-13,1,109.79999923706055,112.65500068664551,127.38249778747559,114.64687490463257,120.84312438964844,0.653060487170201,4.042796529680937,-0.5982662111522892,2.9951477095323567,116.18749904632568,3.5656999969482426,0.034313038729044364,114.05874919891357,122.82625064849853,0.6413177649862041,-0.11561633157328545,0.9319221480997071,0.9458382650834001,0.9524759570512707,-0.08898569106338994,31.14785464497859,125.9065928724417,117.82099981307984,109.73540675371797,115.13357107979911,3.9257108832705536,115.52660683223179,3.1239814235446466,115.13666563936027,116.70426276172581,-1.7871925708766545,-4.009031952314984,86868100,2.3504701135129022,1.4763389290810716,-1294962600.0,-59.3201151022663,77.07053933241427,82.84087432937385,-132.44635917680085,13.44944650210466,35.44206078545708,0.04505498182624291,4.686250476637623,118.83459963989257,116.25769941711425,114.17499923706055,112.09229905700684,109.51539883422852,0.06,0.0,136.17160305843626,-0.06458856255488177,-0.06961553023063302,115.3028564453125,115.67571422031948,3.935786549601393
2022-10-14,1,110.63999938964844,109.79999923706055,123.3325023651123,114.44499969482422,120.5962495803833,0.22046247921424938,3.770550818980994,-0.992949404249198,2.9952135209089734,115.94874954223633,3.2667502212524426,0.03224294823963535,112.6932502746582,122.72499942779541,0.6708346029808561,-0.10528031411818937,0.9461110444648014,0.9572652513200793,0.9779596658129142,-0.04745915015923263,28.351746917643638,124.48297652352107,116.94187488555909,109.4007732475971,113.83321380615234,3.641901753440729,115.2344639641898,3.384578872781708,113.79836485915415,115.48743061368359,-9.21305579182264,-4.081766901727353,67737300,2.224407340613062,1.2000863161143434,-1227225300.0,-91.21811378041438,77.07053933241427,82.84087432937385,-140.8653832917336,14.020485315698428,31.16535322337827,-0.0892131268527011,4.948661223945568,118.83459963989257,116.25769941711425,114.17499923706055,112.09229905700684,109.51539883422852,0.06,0.0,136.05790726255916,-0.06686449193399302,-0.11138820603448932,113.29571424211774,115.08642850603376,4.223853045061467
2022-10-17,1,112.04500007629395,109.79999923706055,123.3325023651123,114.32437419891357,119.9381251335144,0.2916212801754698,3.7641178417087384,-0.831975322759896,2.9952102985698588,115.31375026702881,3.111737775802612,0.032355050711456224,112.4535005569458,121.12524929046631,0.6744233178002165,-0.10291287967132223,0.9630999378563349,0.9724250347661384,1.000124968271863,-0.020264502579317445,31.035626625270336,123.86611057279126,116.33787488937378,108.8096392059563,112.62178530011859,2.1496312900350114,114.97017819540841,3.4846259963128454,113.00714442379865,114.63460771809626,-7.601729454728861,-3.564891631575586,62782000,2.2319319540850504,1.097226689722024,-1164443300.0,-52.1812934178431,77.07053933241427,82.84087432937385,-71.12601843779157,12.593430677533277,27.993233224245294,-0.08374314260043253,5.1158997872343885,118.83459963989257,116.25769941711425,114.17499923706055,112.09229905700684,109.51539883422852,0.06,0.0,135.96599072182707,0.0010557116962706115,-0.0067213395554813265,112.36571393694196,115.04214259556362,3.7419768629328884
2022-10-18,0,117.43249893188477,109.79999923706055,122.77000045776367,113.83187437057495,117.95562553405762,0.3590099631414287,3.5107352347180494,-0.7359251509635327,2.9952740064679566,114.80624961853027,2.8336999511718743,0.030324169533986825,111.9045000076294,120.8232494354248,0.6599703832769023,-0.08735847797898663,1.0143296968665285,1.021540797664952,1.0525690636806366,0.042015117401773994,36.54093603907281,122.79497024436895,115.77349977493286,108.75202930549676,112.80464254106793,2.5221836587446016,115.05660670144218,3.532749787786387,112.75576695904547,114.17013107354877,-7.035884313691016,-3.196682998066285,65607400,2.2795596358446697,1.1289381581162832,-1098835900.0,-37.62038989012376,77.07053933241427,82.84087432937385,37.77286558988988,18.97300222952829,25.772739560094465,-0.08682493268246265,5.159763786353368,118.83459963989257,116.25769941711425,114.17499923706055,112.09229905700684,109.51539883422852,0.02,1.0,135.88790041121374,0.036984239904990446,0.023665017020657833,112.62285723005023,114.92428534371513,3.414196055484554
2022-10-19,0,114.89749908447266,109.79999923706055,120.9424991607666,113.83187437057495,117.37812519073486,0.21108292678418872,3.1534270883975823,-0.7011684494284185,2.995360215637949,114.80624961853027,2.537287473678589,0.02730083314809857,111.9045000076294,120.55349960327149,0.5932168128272686,-0.02795712729896808,0.994726487629991,1.0025500532467901,1.0211794873307514,0.019905893073177916,52.89876679751524,121.81347887543409,115.50662469863892,109.19977052184375,112.88107109069824,2.584592302287486,115.05767808641706,3.5326951983116612,113.91339586118329,114.52092285047026,1.1020001342915335,1.041105711941541,47198100,2.609381616633592,0.8201345578736391,-1146034000.0,-44.92917631507625,77.07053933241427,82.84087432937385,-7.333724457213055,18.065383761207574,26.768467461870767,-0.034559741479977264,5.031923157972006,118.83459963989257,116.25769941711425,114.17499923706055,112.09229905700684,109.51539883422852,0.02,0.0,135.8264492215989,0.019220532680399582,0.025487930074738967,112.82285744803292,114.94357081821987,3.3283454716144685
2022-10-20,0,115.20750045776367,109.79999923706055,120.9424991607666,113.83187437057495,116.50687503814697,0.27130253567172863,2.9101496103302957,-0.33375143780631866,2.9954138962044436,114.80624961853027,2.243450012207032,0.02525930352504752,111.9045000076294,119.82075023651123,0.6185805963001859,-0.0209824600636693,0.9999696277107959,1.0095228167463408,1.0198693477238427,0.0492486453394978,48.84976372768491,121.03129890022602,115.21099967956543,109.39070045890485,113.23964255196708,2.725168652366378,115.12892818450928,3.5243327215253974,114.14953907342445,114.5560141128916,0.46781055938897864,0.013056287675043743,48795100,2.556452620596027,0.8526511113274018,-1097238900.0,-43.90934464587293,77.07053933241427,82.84087432937385,17.32486143282547,19.199477047176753,24.963424322751244,-0.03781912207141492,5.010356911506944,118.83459963989257,116.25769941711425,114.17499923706055,112.09229905700684,109.51539883422852,0.02,0.0,135.7654357449609,0.024171343199228312,0.020814866628521948,113.25714329310826,115.10428510393415,3.2890891295718068
2022-10-21,0,117.04999923706055,109.79999923706055,120.9424991607666,113.83187437057495,116.16999864578247,0.37497945953415357,2.86818374140152,-0.142173317455772,2.995422687975761,114.80624961853027,2.1143000030517585,0.024918328846363764,111.9045000076294,119.82075023651123,0.6454740741932037,0.006420761417207565,1.0169119677913243,1.0304694969851687,1.0263537448969942,0.05793564608435675,51.35296252460856,120.83974215473907,115.10337467193604,109.367007189133,113.86749948774066,3.0544188409962443,115.29642813546317,3.558197320866277,114.40899584686503,114.70055973171672,2.2272013343545125,0.8733923310455838,55660500,2.473253883101449,0.9807291795144677,-1041578400.0,-20.84985828346851,77.07053933241427,82.84087432937385,75.15451883329338,19.730267719443336,23.154034440232426,0.013608723522859592,5.016045442314184,118.83459963989257,116.25769941711425,114.17499923706055,112.09229905700684,109.51539883422852,0.04,0.0,135.70363819184703,0.1161833301371713,0.06033947382194906,114.17428588867188,115.3499995640346,3.409317822076683
2022-10-24,0,119.19000053405762,109.79999923706055,120.9424991607666,113.83187437057495,116.42937469482422,0.24683189620221954,2.89472562159997,-0.2912952836465421,2.9954173091922325,114.88999938964844,2.1954499053955088,0.025120794140597123,111.9045000076294,119.82075023651123,0.6326241355776423,0.020221386769640328,1.0343458615531238,1.048480924482588,1.0335005483682125,0.06376902541745255,55.58379886839539,121.0217008846184,115.23224964141846,109.44279839821853,115.20892824445453,3.032196345631948,115.17124966212681,3.3701449314026792,115.0558832350221,115.21480327618964,3.9012902433331895,2.0443741030593485,49531500,2.505744506445845,0.882999275687985,-992046900.0,-11.768293448816305,77.07053933241427,82.84087432937385,95.02461178241445,19.79735135462955,21.872704355336683,0.047000530593324576,4.9306135983092245,117.87959963989258,115.48519941711426,113.54999923706055,111.61479905700683,109.22039883422852,0.06,0.0,135.65243059094396,0.052992343182888924,0.12086059854561904,115.21571459089007,115.25928551810128,3.554781176888257
2022-10-25,0,120.1299991607666,109.79999923706055,120.9424991607666,113.83187437057495,117.1456241607666,0.10906167371520452,3.0166677394987667,-0.6203915253000991,2.9953911572830036,115.05249977111816,2.3905249500274666,0.026128458840738826,111.9045000076294,119.82075023651123,0.6231949108242204,0.029763701843237515,1.040489709062758,1.0522811927449982,1.028902274598302,0.022970644867623013,59.605683203687164,121.48858517000706,115.45524969100953,109.421914212012,116.5646424974714,2.758060556594037,115.19892815181187,3.4119083079953114,116.08371930031225,115.89712835625154,8.551913808964477,-1.4490345733466452,50934600,2.5392123143569663,0.9154872048716848,-941112300.0,-5.74783861331749,77.07053933241427,82.84087432937385,113.67725864486775,20.49062135184623,21.09280443007284,0.09148163692685625,4.747712813447688,117.71151870727539,115.34923866271973,113.43999862670898,111.53075859069824,109.16847854614258,0.08,0.0,135.60436312162096,0.036438620157521084,0.05984706480184661,117.17285701206752,115.23428562709263,3.7168990070298498
2022-10-26,0,116.44250106811523,109.79999923706055,120.9424991607666,113.83187437057495,117.87187433242798,0.04397826888356865,3.1844434472428342,-0.891997651558095,2.9953533928864595,115.05249977111816,2.6316998577117916,0.027529347073551175,111.9045000076294,120.16949920654297,0.6451510430488281,0.033620850682824985,1.0066393324685885,1.0133828357212225,0.9927320122006309,0.013446785142875006,61.25002070646492,122.04338650157183,115.67449960708618,109.30561271260052,117.19285692487445,1.9350523485129836,114.90732111249652,3.080003608170357,117.08841238311805,116.52972519270848,8.577367880938416,0.32361012556380614,68802300,2.5441470634470287,1.222314741564578,-1009914600.0,-35.44142517270043,77.07053933241427,82.84087432937385,21.57316002381951,18.71938550525001,25.471378198274756,0.017689770701783736,4.8257330690509175,117.55107940673828,115.21945922851563,113.33499908447266,111.45053894042968,109.11891876220703,0.08,0.0,135.524337067001,0.005127348299729828,-0.006015786735737733,117.44000026157924,114.9028570992606,3.6820198960752313
2022-10-27,0,112.1924991607666,109.79999923706055,120.9424991607666,113.83187437057495,117.87187433242798,0.03397503055339756,3.1866965915164127,-0.8983688088734945,2.995352894095295,115.05249977111816,2.643799924850464,0.027546205882832426,111.9045000076294,120.16949920654297,0.6632101492526183,0.013579103670576713,0.9698060645683733,0.9731878320443555,0.9539854007808122,-0.026170182366749617,51.95441563104323,122.05889285115417,115.68549966812134,109.3121064850885,116.44428552900042,2.6922791176318874,114.62446403503418,3.1381421170979538,116.93362265140303,116.41559759502702,3.9247632547877482,-3.3872628610963877,129605400,2.6700933022143567,2.166578360545243,-1139520000.0,-64.87163317759241,77.07053933241427,82.84087432937385,-95.04400590707063,17.11271066334676,30.55664338760237,-0.04011032853428108,4.90175264039743,117.55107940673828,115.21945922851563,113.33499908447266,111.45053894042968,109.11891876220703,0.08,0.0,135.33628526206374,-0.03722343527572536,-0.03571739481404055,116.66857147216797,114.64571435110909,3.8303628464518753
2022-10-28,0,100.7350025177002,109.79999923706055,120.9424991607666,112.68687534332275,117.87187433242798,0.0946675648661606,3.2733403563580903,-1.0421266040802397,2.9953312865681005,115.05249977111816,2.7648499488830565,0.0283281007218979,111.9045000076294,120.16949920654297,0.6120427257856215,-0.017664827422105657,0.8717795850343507,0.871992769999898,0.8609755699713001,-0.13938485113799703,43.34062272064803,122.09768035413464,115.55099964141846,109.00431892870228,114.42107173374721,6.57299357318082,113.65107141222272,4.864366337296162,115.76407460221462,115.86196144546956,-4.462137669536914,-3.4093102983559502,223133400,2.8375553187940725,3.2812285280628406,-1362653400.0,-75.6973754684936,77.07053933241427,82.84087432937385,-258.88439209974,14.157753923571315,41.00285312080883,0.14043502551965742,5.501627150395752,115.73624063110351,112.28188121032714,109.4900016784668,106.69812214660645,103.24376272583008,0.02,1.0,134.88655806634793,-0.13333888764169166,-0.10273315694482105,115.0028577532087,113.91285760062081,4.672809890749957
2022-10-31,0,102.90250015258789,100.7350025177002,120.9424991607666,112.53937530517578,117.87187433242798,-1.1941829464979048,4.598542450732746,2.060991951641512,2.9949171463402817,115.05249977111816,3.406274785995484,0.04003005345458018,110.55599937438964,120.16949920654297,0.42749767090318,-0.12179065790765659,0.8957604775534198,0.8984587322088216,0.9047328044349631,-0.1366515673168044,28.62806475338754,124.07433471454533,114.87724981307983,105.68016491161433,112.66321454729352,7.849140664164336,112.95142854963031,5.652611802410372,112.02861871788267,113.86676099601665,-12.326200900474076,-11.916053610469014,99251400,3.797190728748873,1.4094510418287927,-1263402000.0,-79.7971277227286,77.07053933241427,82.84087432937385,-189.9857473376778,14.587737754850952,38.764394447304724,0.10369749671322158,5.403654127404472,115.73624063110351,112.28188121032714,109.4900016784668,106.69812214660645,103.24376272583008,0.02,0.0,134.69630223135403,-0.14505088714475045,-0.14146829782593598,113.17285810198102,113.21500069754464,5.45058411802142
2022-11-01,0,100.35499954223633,100.7350025177002,120.9424991607666,112.15562438964844,117.87187433242798,-1.0295351405452298,5.28834502840219,0.6736693083454215,2.994643214373833,115.05249977111816,4.062949714660644,0.04627244789403791,109.11024932861328,120.16949920654297,0.6210465757229267,-0.1491617845948303,0.8780954083526125,0.883266731638307,0.9083503348374375,-0.16461333352767238,30.040908466097477,124.86381488132831,114.28712482452393,103.71043476771955,110.27821459089007,8.775769274419442,112.07285703931537,6.5817462385447785,109.7660460962624,112.36729689362197,-10.680728473652572,-8.69140846638203,153370000,3.5010469078312165,2.046397189456191,-1416772000.0,-97.11004237847418,77.07053933241427,82.84087432937385,-204.6021639678155,13.009833417734962,40.51292290391077,0.020609902067954277,5.626250574519017,115.35863919067383,111.67067887878419,108.68999862670898,105.7093183746338,102.02135806274416,0.04,0.0,134.37466121696585,-0.19742950132543335,-0.1922049644295875,109.95428684779576,112.06428636823382,6.488003940567469
2022-11-02,1,94.79750061035156,100.35499954223633,120.52499961853027,111.69374990463257,117.1456241607666,-0.9661215724610185,5.864936969342524,0.07363119581164668,2.994367175415028,114.6299991607666,4.529724760055542,0.051783979263597166,102.68575038909913,119.78125019073487,0.6630564195893761,-0.16190993768735798,0.8370067455980856,0.8470850572918799,0.8899042968662713,-0.18588573982194023,27.94810570197172,124.98762378228245,113.25774984359741,101.52787590491236,106.79357174464634,9.463246310827452,111.00124999455043,8.040030903465235,107.41659987145104,110.49262423750801,-14.263135244462456,-10.918291304814897,135761800,3.519005694902697,1.7114939299563756,-1552533800.0,-99.62469935341461,77.07053933241427,82.84087432937385,-220.05481372195797,12.06466912251181,42.70460448590379,-0.08123183773856402,5.6336609428448,114.4028402709961,110.12358062744141,106.66500091552734,103.20642120361329,98.92716156005861,0.06,0.0,134.05355891069942,-0.20352758231183699,-0.23615253804211628,105.9971444266183,110.60642950875419,7.7495833398319105
2022-11-03,1,91.07250022888184,94.79750061035156,120.52499961853027,110.42999935150146,116.59437561035156,-1.0366906403199423,6.912184444164839,0.15336190797131266,2.99378349385264,113.52999973297119,5.283299770355223,0.06171014728864565,100.6970022201538,119.28400039672852,0.6577289540654725,-0.21346192980384132,0.8130710990812627,0.8286832834917717,0.8911508698961009,-0.18824786941969085,23.17214146477162,125.83486874718588,112.0104998588562,98.18613097052653,102.6425004686628,8.99990952405096,109.6035714830671,9.647728916475653,104.25762086736509,108.1314987399932,-20.465223436873874,-13.66347789704285,136683300,3.631035453464505,1.626310130853647,-1689217100.0,-99.13310717574014,77.07053933241427,82.84087432937385,-203.28248536069177,11.369205508633403,44.09018236535226,-0.1424946214678811,5.551256826953762,113.69719897460938,108.98139852905274,105.16999816894531,101.35859780883789,96.64279736328125,0.08,0.0,133.70880802568038,-0.19520544530849648,-0.2279093876510674,101.52571650913784,109.34928676060268,8.95268452145608
2022-11-04,1,90.73750114440918,91.07250022888184,120.1299991607666,108.07562446594238,116.22499895095825,-1.0701144563327036,7.994049387311608,0.05813678768690611,2.993042130528624,112.67625045776367,6.35647470474243,0.07231955015701222,99.79924964904785,117.60824909210206,0.7298628572326235,-0.21592301840468917,0.8208724949273649,0.8441738256820833,0.9261527528554483,-0.09924555639470356,21.440592324775128,126.52597366399701,110.53787488937378,94.54977611475056,98.97035762241909,7.559616275862271,108.08160727364677,10.839960040645103,100.94318124731268,105.66313398126775,-24.188378535654472,-17.685736866153086,129101300,3.605494922401185,1.4709682388568583,-1818318400.0,-91.1658577246247,77.07053933241427,82.84087432937385,-162.88191797092458,10.715856753817006,42.83640297023985,-0.09043918403361523,5.469024303028346,113.46591998291015,108.60704016113282,104.68000030517578,100.75296044921875,95.89408062744141,0.1,0.0,133.38727524077396,-0.12020113978325175,-0.18006485122921195,98.000002179827,107.72000122070312,9.85328381120031
2022-11-07,1,90.90499877929688,90.73750114440918,120.1299991607666,102.36062574386597,115.51625061035156,-0.8827946292472275,8.961950717521926,-0.5020125569899667,2.9922773037715724,112.42374992370605,7.500274600982664,0.08201872900660685,94.4250005722046,117.60824909210206,0.7988223735539367,-0.20657993879339254,0.8319519594821779,0.8669549849280431,0.947193465467687,-0.11659096091446419,21.50764292608158,127.19102646937614,109.26712503433228,91.34322359928842,95.92928613935199,5.297404482103594,106.1867858341762,11.384515010836678,98.36753306087135,103.70657657660206,-22.075272935497523,-19.016911881276286,77495700,3.6101478621789385,0.8656415673092374,-1740822700.0,-92.51803499067876,77.07053933241427,82.84087432937385,-133.85432152828272,10.2736819380989,41.06881881672404,-0.0814999102462951,5.296950959437831,113.46591998291015,108.60704016113282,104.68000030517578,100.75296044921875,95.89408062744141,0.1,0.0,133.19686721937597,-0.11626321142389329,-0.12455279399174689,95.08143070765904,105.87500108991351,10.606356283319123
2022-11-08,1,90.18000221252441,90.73750114440918,120.1299991607666,100.64000177383423,115.51625061035156,-0.6721428666085202,9.721171069422573,-0.9748510496210687,2.991594997526873,112.11874961853027,8.51547471046448,0.08993236058711152,91.05575008392334,117.60824909210206,0.8436733309693064,-0.19337164893032857,0.8342719636148725,0.8838836974867045,0.9637344136288878,-0.10139003912236155,22.23053391332753,127.53659215028922,108.09425001144409,88.65190787259895,94.4214289528983,5.202866007965317,104.42125034332275,11.837340998930701,96.49128508734643,102.37198143035613,-18.974085202403536,-22.58957306867397,88703400,3.622055306301874,0.9732913096811397,-1829526100.0,-94.17066552714807,77.07053933241427,82.84087432937385,-117.50449228356291,9.778105568018146,40.20731190217888,-0.07109787263616524,5.167882877900642,113.46591998291015,108.60704016113282,104.68000030517578,100.75296044921875,95.89408062744141,0.1,0.0,132.97805272951203,-0.0703584822210831,-0.12163216309565716,93.16285923549107,104.08285849434989,11.269162137730675
2022-11-09,1,87.7400016784668,90.18000221252441,120.1299991607666,98.96562480926514,115.51625061035156,-0.4821875612682886,10.402888577242605,-1.2971414139188389,2.9909159005799872,111.34249973297119,9.406199569702148,0.09725200150496802,90.8882490158081,117.60824909210206,0.863940969678462,-0.19950289234506527,0.8202424463092617,0.8859762622035803,0.9585038110529243,-0.07444815408048966,21.6799877675064,127.77415226511141,106.96837511062623,86.16259795614104,92.25535774230957,4.128937282259124,102.45928614480155,12.183295503661894,94.90816564634244,101.05720685296383,-10.477986838111368,-21.512650030594603,90796200,3.614299770173402,0.9722163627435381,-1920322300.0,-99.23837329672945,77.07053933241427,82.84087432937385,-118.08771361084115,9.214399242637816,41.1996744659474,-0.11646466240817384,5.092319857009504,112.95380041503907,107.7781008605957,103.59500122070312,99.41190158081055,94.23620202636718,0.12000000000000001,0.0,132.74185433381336,-0.06491536233866957,-0.11003204282613455,90.83428737095424,102.00357273646763,12.059621687907397
2022-11-10,1,94.97750091552734,87.7400016784668,120.1299991607666,93.86625051498413,115.51625061035156,-0.3232721882595753,11.114757286230665,-1.4692729228302697,2.9901270280159786,110.21999931335449,10.207861957550048,0.10513130249449266,90.6817512512207,117.60824909210206,0.8760323158410224,-0.20091072597337403,0.8983649504691521,0.9876848156385237,1.0538185012625256,0.042877934358138026,20.356786746995773,127.95213973267863,105.72262516021729,83.49311058775595,91.48714365277972,2.5808117082902644,100.8826791218349,11.562251268317882,93.1084099049196,99.62098528375239,-14.734820292643564,-23.841762619758217,173414900,3.6053717473200027,1.774641346532092,-1746907400.0,-69.64740357369914,77.07053933241427,82.84087432937385,-57.49040570101814,19.441161621091073,34.63389678767159,-0.10895236296460656,5.62501152543248,112.95380041503907,107.7781008605957,103.59500122070312,99.41190158081055,94.23620202636718,0.12000000000000001,0.0,132.38024827970932,0.08208279900518844,0.04895781993453365,90.81142970493862,100.38285827636719,12.088731430860243
2022-11-11,0,99.13000106811523,87.7400016784668,120.1299991607666,93.86625051498413,115.51625061035156,-0.15512315981463684,11.310623288490937,-1.5991362676289698,2.989879881694132,106.77124977111816,10.541249465942382,0.10773920416632855,90.6817512512207,117.60824909210206,0.9108180414559546,-0.14156271294761494,0.9442616159759826,1.0496583845476153,1.0904430857186067,0.09249207679137372,37.06020995586567,127.6027468211225,104.98150024414062,82.36025366715874,92.10607228960309,3.758032111893387,99.44982201712472,10.292208619244425,93.57593931905777,99.52382161095663,-5.3584760612208076,-18.857324618029196,111590500,4.048084393731218,1.116899710882512,-1635316900.0,-57.91255443342109,77.07053933241427,82.84087432937385,-30.079122345345255,21.518111913997263,32.600937565966035,-0.029112697807536534,5.54893964264091,112.95380041503907,107.7781008605957,103.59500122070312,99.41190158081055,94.23620202636718,0.12000000000000001,0.0,132.1755200122708,0.10782586498823354,0.12866738489482457,92.0500008719308,99.02357264927456,12.104808019009386
2022-11-14,0,98.66749954223633,87.7400016784668,120.1299991607666,93.86625051498413,115.51625061035156,-0.015834706037946754,11.300888041305203,-1.6126441749641738,2.98985492122698,101.81875133514404,10.493349475860594,0.10823983301530193,90.6817512512207,117.60824909210206,0.9166620674829415,-0.11526617876196706,0.9450366763615486,1.0465396745274125,1.0656791060286002,0.0853913521497931,43.92067298995917,127.00777641067437,104.40600032806397,81.80422424545357,93.19107219151088,4.4437280707577616,97.91678633008685,8.399284682549782,94.9674350225115,100.00502379806947,4.570268656735637,-16.8302704724046,99533100,4.172304955833354,0.978226754115626,-1734850000.0,-62.305864015368215,77.07053933241427,82.84087432937385,-32.224061754752334,20.52238000428298,31.09235754041465,-0.06085055037333281,5.402586808262634,111.44871948242188,106.56064010620118,102.61000061035156,98.65936111450195,93.77128173828125,0.12000000000000001,0.0,131.99000349898577,0.08792664522042393,0.08254555099731799,93.36285727364677,97.4442868913923,11.955841770106169
2022-11-15,0,100.81999969482422,87.7400016784668,120.1299991607666,93.86625051498413,115.51625061035156,0.1403806151169124,11.224592661942904,-1.5697050105752437,2.989891805703914,100.54500102996826,10.264549522399903,0.1082022721309748,90.6817512512207,117.60824909210206,0.8960274197909815,-0.1597939204251528,0.9718796371302705,1.0741959015000535,1.070969508222561,0.11798621890943028,40.938262019638046,126.1863106252469,103.73712530136109,81.28793997747528,94.63142912728446,5.101281575115151,96.80089337485177,6.592053977686255,95.90810124500067,100.24769063213529,8.33950895634453,-17.866061573685364,111336300,3.9215269755643587,1.0701818062277924,-1623513700.0,-53.73451435460461,77.07053933241427,82.84087432937385,-19.216402653398788,23.582099093450918,28.477120835236715,-0.07587571573083274,5.477402364528565,107.45300274658204,103.32850274658205,99.99500274658203,96.66150274658204,92.53700274658203,0.02,1.0,131.7934506775114,0.09957767003997575,0.09289742378780003,94.5,96.25000108991351,11.601399522722536
2022-11-16,0,97.0,87.7400016784668,120.1299991607666,93.86625051498413,114.97499942779541,0.28633337272600085,10.786512909440317,-1.3998936794840917,2.990278049229512,100.54500102996826,9.476449632644654,0.10481857680373509,90.6817512512207,117.26399936676026,0.9017896321569803,-0.1225222437548328,0.9426032338091239,1.0329835856048941,1.007614233493835,0.10553907162513543,45.87925770460182,124.4795261583887,102.90650033950806,81.33347452062742,95.50214358738491,4.8743423726545005,95.71571486336845,4.895593187407313,97.14799055406507,100.49154740097194,11.11172164017245,-13.416494175225882,87958800,3.9636421675908227,0.8292291226865278,-1711472500.0,-40.7894736842105,77.07053933241427,82.84087432937385,-35.84293188166612,22.507401017863575,29.592004763960496,-0.07364488214586319,5.329016587925516,100.38600274658204,97.61200274658204,95.37000274658203,93.12800274658204,90.35400274658204,0.02,0.0,131.62549573000712,0.1274669541993645,0.07935095713794797,95.4414291381836,95.26142992292132,11.280785326398632
2022-11-17,0,95.30500030517578,87.7400016784668,120.1299991607666,93.86625051498413,112.94624948501587,0.4839739630970027,10.493006925079635,-1.1720532649376516,2.9905135811187815,99.74250030517578,8.903362207412718,0.10286089340748111,90.6817512512207,117.26399936676026,0.8813220523335085,-0.15804092950040818,0.9342562668247016,1.0125580333408057,0.9713205400384939,0.003448178636956456,40.34455115445959,122.9976392354437,102.01162538528442,81.02561153512514,96.23428617204938,4.291789228765634,95.32785756247384,4.677591395522319,97.15622928725845,100.1822463825621,6.704803148945456,-13.541457115592426,82617900,4.012987343632404,0.7666550224070415,-1794090400.0,-52.7368645918997,77.07053933241427,82.84087432937385,-44.76436805208381,21.54635871312938,30.41504042500584,-0.08345602435707675,5.169087112606893,100.38600274658204,97.61200274658204,95.37000274658203,93.12800274658204,90.35400274658204,0.02,0.0,131.461225833279,-0.018420768186805492,0.10111445491279338,96.13714272635323,94.65000098092216,10.91346124808306
2022-11-18,0,94.63999938964844,87.7400016784668,120.1299991607666,93.86625051498413,105.22499990463257,0.7082236099931304,10.131895459428751,-0.8111890790444316,2.990804110992808,98.89875030517578,8.180849704742434,0.10029941070567852,90.6817512512207,117.26399936676026,0.8508119295847997,-0.18577530178231588,0.9368766393196385,1.0009915660860296,0.9638995897721627,-0.04529407475121061,37.30427676785345,121.28029129651253,101.01650037765503,80.75270945879754,97.22000013078961,2.3841205902219844,94.7376789365496,4.138559611712009,96.72007260099429,99.64305585471763,5.683076033390909,-5.390382763499019,72428200,3.9604424383873686,0.6669109827121843,-1866518600.0,-55.79905372668006,77.07053933241427,82.84087432937385,-49.63008451041758,20.47678432258779,31.097322931681152,-0.10752399318674892,5.05058049624678,100.16444204711912,97.43278218078612,95.22500228881836,93.01722239685058,90.28556253051758,0.02,0.0,131.3141702561298,-0.06597878227476461,-0.025768373533524465,97.27999986921039,94.05714362008231,10.078083035721338
2022-11-21,0,93.0099983215332,87.7400016784668,120.1299991607666,93.74812459945679,101.34062480926514,0.9552068298404938,9.517306306233134,-0.21483879270029993,2.9913139795646315,97.83374977111816,7.3599498748779295,0.0952721457268185,90.6817512512207,116.71725101470948,0.8016512597269082,-0.20597366418665472,0.9310682906503472,0.9797074673094983,0.9560421900856322,-0.057339055382480186,35.33340037556272,118.93061299775069,99.89600038528442,80.86138777281816,96.9389283316476,2.776283155044505,94.21303599221366,3.8253895732216607,96.21649560287705,98.73061368962028,7.864141302923,-8.029446078265826,84330300,3.8868536400531553,0.7642598804231626,-1950848900.0,-63.22546310684986,77.07053933241427,82.84087432937385,-58.769497847059924,19.182514995323334,31.828402201414587,-0.12752673058422062,5.006253339164381,99.56088134765625,96.94456161499023,94.83000183105469,92.71544204711914,90.09912231445313,0.02,0.0,131.1374822357135,-0.06122447872968284,-0.08264710542106363,96.68428584507534,93.74785777500698,8.968277508309168
2022-11-22,0,92.51000022888184,87.7400016784668,120.1299991607666,92.52562379837036,100.7562518119812,1.1883239519859772,8.521946207944628,0.6282208845158994,2.992108859639955,96.15250015258789,6.409199943542481,0.0864408713542651,90.6817512512207,112.61749935150146,0.7191878373770232,-0.22575544017893034,0.9383590125589969,0.9722849898025798,0.9620924618511031,-0.0824241171503296,32.795392489341005,115.63089269054747,98.58700027465821,81.54310785876895,95.99321392604283,3.0221532937654465,94.04964310782296,3.8472951603974335,95.42403055474016,97.45971475312601,-2.071545971444364,-7.319018737688141,62192000,3.8513787853847297,0.5607666576108935,-2013040900.0,-59.096010320119476,77.07053933241427,82.84087432937385,-55.94082776650065,18.47837573989158,30.660065962232686,-0.11124377452613944,4.825806364723113,99.56088134765625,96.94456161499023,94.83000183105469,92.71544204711914,90.09912231445313,0.02,0.0,131.0074818728687,-0.05801501264934117,-0.05371104711408764,95.5999995640346,93.8250002179827,7.288405966516191
2022-11-23,0,93.6949996948242,87.7400016784668,116.44250106811523,92.15062522888184,100.4500002861023,1.24419578039638,7.02551512318374,1.2071548846765703,2.993190024918947,95.14125061035156,5.359700012207031,0.07227450053981319,90.6817512512207,103.83150005340578,0.6458075871534746,-0.20553063202613306,0.9638808240089052,0.9823338182260958,0.9915549304478908,-0.03407216809459579,33.3003732337259,111.25703057443145,97.20600032806396,83.15497008169648,95.28285680498395,2.869326216077834,94.23696449824742,3.7539003577636403,94.69027728867596,96.19432619336577,-6.678100239991519,-2.413038705389601,59414700,3.8185581271019666,0.5380015362753771,-1953626200.0,-53.90627594398873,77.07053933241427,82.84087432937385,-30.937482464921047,19.884322867229432,29.828016425124197,-0.0797164969945447,4.606105907632778,99.56088134765625,96.94456161499023,94.83000183105469,92.71544204711914,90.09912231445313,0.02,0.0,130.88849804542605,-0.03078671137361888,-0.04861537365371341,94.97714233398438,94.16999980381557,5.782208691457534
2022-11-25,0,93.67500114440918,87.7400016784668,112.1924991607666,92.15062522888184,99.43625068664551,1.0725103508794966,5.4934915068191925,1.373912740853374,2.9941271392796436,94.88750076293945,4.325349960327149,0.05718299280317542,90.6817512512207,101.02824974060059,0.5392846738707796,-0.16487287121963784,0.9750842264211953,0.976030353854066,0.998326813408082,-0.017102976292400096,37.96042178194492,107.05560827303779,96.06862525939941,85.08164224576103,94.26214272635323,1.5291852643462056,94.44678592681885,3.6230691541841242,94.42492537612306,95.22418728830979,-5.039653250038589,2.8795733721502628,35088600,3.7872727381173896,0.3319323633155548,-1988714800.0,-57.924097734597524,77.07053933241427,82.84087432937385,-25.28462982437042,19.442732951121343,29.16559752563283,-0.06381632986583866,4.374241241123392,99.56088134765625,96.94456161499023,94.83000183105469,92.71544204711914,90.09912231445313,0.02,0.0,130.8181904882981,-0.01518181165184318,-0.038200154237570144,94.18714250837054,94.34357125418526,4.537378214837292
2022-11-28,0,94.42749977111816,87.7400016784668,102.90250015258789,92.15062522888184,98.78312492370605,0.21353157576874773,4.075378625890329,-0.9226421610375026,2.9948171004365642,94.71875,3.377299995422363,0.042834357957182434,90.6817512512207,100.74350223541259,0.7099604944415888,-0.0700848880412794,0.9924823427453203,0.9852079245580818,1.0098549827568797,-0.002245346786778568,43.27792499322906,103.2935076103622,95.14275035858154,86.99199310680088,93.89464269365583,0.9675167543189588,94.69839314052037,3.4775767463260907,94.21309949493269,94.54653212757484,-7.086886105973516,3.2373604771470994,74943100,2.871240077358555,0.7623871986506692,-1913771700.0,-54.910742035328454,77.07053933241427,82.84087432937385,-0.3675817082808628,21.762774427599265,27.708661932380014,-0.18707676630621917,4.275366713212135,99.56088134765625,96.94456161499023,94.83000183105469,92.71544204711914,90.09912231445313,0.02,0.0,130.67275193610706,-0.002018296607585568,-0.009488682555165762,93.73428453717914,94.58785683768136,4.059699813188748
2022-11-29,0,93.07750129699707,87.7400016784668,102.90250015258789,92.15062522888184,97.41687488555908,0.3433014978990854,3.8692588988982584,-0.5894409824966913,2.994903161265361,94.5337495803833,3.0538499450683596,0.0408031846275451,90.6817512512207,100.40149955749511,0.6317997295041299,-0.08235951865992237,0.9815467430141082,0.9759108936633007,0.9958700611912731,0.00072576042019179,43.953313520603174,102.56589301904896,94.82737522125244,87.08885742345592,93.57642854963031,0.7731237286579902,94.90535736083984,3.26788305384569,94.26502381674004,94.38951106227593,-2.652062091630759,3.8749255146830492,65567300,2.822350944614631,0.6786355148718587,-1979339000.0,-63.44868252434204,77.07053933241427,82.84087432937385,-33.387625640159186,20.658833816488183,29.701923916012007,-0.19279831948965956,4.182126320051698,99.56088134765625,96.94456161499023,94.83000183105469,92.71544204711914,90.09912231445313,0.02,0.0,130.5400341438796,-0.00043262941729849125,-0.01827067380342729,93.38714163643974,94.76214218139648,3.5966916007576923
2022-11-30,0,94.27000045776367,87.7400016784668,100.81999969482422,92.15062522888184,95.72875022888184,0.2659515058175972,3.4091873995320556,-0.5424212142096709,2.995081014757119,94.06124973297119,2.67587480545044,0.036138726171637846,90.6817512512207,99.25250091552735,0.5950296932619511,-0.07251754549783425,0.9992990509148638,0.9942414832194418,1.0084833705285052,0.019024972700544485,42.18458996150733,101.15450007753702,94.3361252784729,87.51775047940879,93.52357155936105,0.6972115686739782,95.37178584507534,2.554684300887874,93.95636636911647,94.0033508356281,-2.3372320455863225,3.2130173135771387,102805800,2.787879711982476,1.0926539534836264,-1876533200.0,-54.92422337703472,77.07053933241427,82.84087432937385,26.04956665461275,22.502944103907485,27.19581736267017,-0.07580948374215554,4.241260307415331,100.67479983520508,98.74759916687012,97.18999862670898,95.63239808654785,93.70519741821289,0.02,0.0,130.34533569052658,0.03583695361213346,0.044127210376966854,93.72999899727958,95.50499943324498,3.5862401037940796
2022-12-01,0,96.15999984741211,87.7400016784668,100.81999969482422,92.15062522888184,95.05937576293945,0.2816865690028711,3.117509734536375,-0.12734807361987155,2.9951841119202878,93.98250007629395,2.3716248512268074,0.03315375476439552,90.6817512512207,98.71374969482422,0.6871039305100488,-0.005564494308305523,1.0226319481114723,1.0212295938348277,1.02484305878394,0.026308769524699294,49.79042247696467,100.26689479332201,94.03187532424927,87.79685585517653,93.97357177734375,1.1680552999956186,95.45625005449567,2.56018773761775,94.00035655781565,93.9141998078021,-0.3909540725601859,7.442442049667148,68488000,2.523388281305535,0.7549010757516688,-1808045200.0,-62.8030154593443,77.07053933241427,82.84087432937385,48.79405406127192,22.799191211751634,26.102232881648547,-0.025462783472640003,4.103313512101064,100.67479983520508,98.74759916687012,97.18999862670898,95.63239808654785,93.70519741821289,0.02,0.0,130.22047664785177,0.014554369346189366,0.024678145140230902,94.16428484235492,95.42428534371513,3.5822447594874283
2022-12-02,0,94.4375,87.7400016784668,100.81999969482422,92.15062522888184,95.51875019073486,0.22331769719502564,3.1482316512401014,-0.24972254432289853,2.9951737222592474,93.98250007629395,2.4397498130798345,0.03345623423664395,90.6817512512207,98.71374969482422,0.6869684937701231,0.05586208356797559,1.0035866069380612,1.0038319669424856,1.0012245233969101,0.008139832893253596,58.34446342963822,100.3964635885825,94.1000002861023,87.8035369836221,94.24892888750348,0.9771178754025739,95.12107140677315,2.3399190530878156,94.50957808588097,94.24062377592334,3.386734311067753,1.245030581438941,72496400,2.398806172486787,0.8283870930881948,-1880541600.0,-73.18182054629925,77.07053933241427,82.84087432937385,6.518460193548538,22.08701457300953,27.357231166932113,0.018863961813823795,3.9330769186328127,100.67479983520508,98.74759916687012,97.18999862670898,95.63239808654785,93.70519741821289,0.02,0.0,130.0837140174617,0.007707885270115122,0.0,94.2971420288086,94.94857079642159,3.4091136238318303
2022-12-05,0,92.23500061035156,87.7400016784668,100.81999969482422,92.88499879837036,95.51875019073486,0.12406196029092208,3.070905720506813,-0.054506667365519235,2.9952021064688106,94.34875011444092,2.2884247970581066,0.03257624610151859,90.6817512512207,98.71374969482422,0.6658620440737227,0.040776953397716496,0.9784312357725682,0.9813251969792369,0.9762951943879469,-0.0232188627897697,52.669600590634644,100.41006171567183,94.2682502746582,88.12643883364457,94.04035758972168,1.2364675292804324,94.66160719735282,2.21836087028689,94.4783648036459,94.36628938316879,2.0835582816444465,-4.733684068953933,71535500,2.4368622009204337,0.8452052820736976,-1952077100.0,-96.81813899480439,77.07053933241427,82.84087432937385,-65.6197366035294,20.74410553252892,31.131065680073686,-0.043452030817054114,3.88857124976108,100.67479983520508,98.74759916687012,97.18999862670898,95.63239808654785,93.70519741821289,0.02,0.0,129.9405455681654,-0.03129318688143634,-0.025693195929639208,93.85142844063895,94.41428538731166,3.407620958617338
2022-12-06,0,89.42250061035156,87.7400016784668,100.81999969482422,92.88499879837036,95.51875019073486,0.12388182769519876,3.001374921839601,0.12675060562075036,2.995226625433179,94.34875011444092,2.21337480545044,0.03181339301566808,90.83249912261962,98.71374969482422,0.6263536031681742,0.014630678718600767,0.9478433152954046,0.9538425486933162,0.9509390041000937,-0.03926835847239729,46.0523108085712,100.34587509163453,94.34312524795533,88.34037540427613,93.43285751342773,2.151775819205183,93.84750011989048,1.8442901358531176,93.90643208410802,94.20278109800464,-1.5582465331426791,-6.51936956113013,75503600,2.4950268858023414,0.893140217629558,-2027580700.0,-96.69500854434848,77.07053933241427,82.84087432937385,-141.6613059604901,19.53094200876931,34.74892995876711,-0.07700655986921266,3.8351018308497022,95.99075872802733,94.4446192626953,93.19499969482422,91.94538012695313,90.39924066162109,0.02,1.0,129.7791471614769,-0.04512008495523334,-0.06067053893979768,93.11428506033761,93.65071378435407,3.5716830842248823
2022-12-07,1,88.54249954223633,87.7400016784668,100.81999969482422,92.88499879837036,95.51875019073486,0.052418064047430726,3.101991067021393,-0.016900411591229236,2.995190899388913,94.34875011444092,2.2875997257232674,0.03290573842779312,90.10425205230713,98.71374969482422,0.5688055663578431,-0.008399884493101598,0.939253617025238,0.9480838538514167,0.9489577112977592,-0.0607563475943067,39.72702057809541,100.47298247355084,94.26900033950805,88.06501820546526,92.59214319501605,2.7616275082528796,93.24339294433594,2.0997036107452174,92.7920673180897,93.67311929732129,-4.539632220022043,-11.30479976093252,68086900,2.572378175566341,0.8153494333757991,-2095667600.0,-89.94876176883014,77.07053933241427,82.84087432937385,-147.70174717001998,18.6303717527281,33.950232693929344,-0.08572163776918297,3.733308558967623,94.92900335693359,93.50550335693359,92.3550033569336,91.2045033569336,89.7810033569336,0.04,0.0,129.63308350162737,-0.08369589552961265,-0.04284785936950274,92.32999965122768,93.03214209420341,3.6786250114347268
2022-12-08,0,89.58249855041504,87.7400016784668,100.81999969482422,92.88499879837036,95.51875019073486,-0.054906400429466325,3.2278925520107413,-0.09869134209289143,2.995144317870378,94.34875011444092,2.377662372589112,0.0342710592870429,89.33450050354004,98.71374969482422,0.5345084588698378,0.009146316941164143,0.9511119312166288,0.963312229130134,0.9720375916943789,-0.06840163589261994,39.10553459052044,100.64291031001514,94.18712520599365,87.73134010197217,92.09285708836147,2.967515825612517,92.83464281899589,2.220995408029556,91.7482399750603,93.16831931664069,-6.232294875059095,-8.719072636869765,73305900,2.5187984283396347,0.8871381254864193,-2022361700.0,-70.56415264423077,77.07053933241427,82.84087432937385,-128.97146371155037,19.4356352814635,31.986227894648533,-0.010732482306247092,3.6795010442486293,94.92900335693359,93.50550335693359,92.3550033569336,91.2045033569336,89.7810033569336,0.04,0.0,129.48111309827917,-0.05392671754847023,-0.06411852478458657,92.03428540910993,92.71071352277484,3.304974709203465
2022-12-09,0,89.22999954223633,88.54249954223633,100.81999969482422,92.88499879837036,95.51875019073486,0.14152858525807233,3.064745109046152,-0.17662113400074908,2.9952044666584583,94.34875011444092,2.277250003814698,0.0325071010581235,89.56649875640869,98.71374969482422,0.7555972796673447,-0.056802951363298146,0.9464436712776265,0.9637838411561759,0.98223327547362,-0.05514229472152132,36.338577390956175,100.40874026768337,94.27925004959107,88.14975983149877,91.37285695757184,2.9626592731216097,92.44821425846645,2.349635490295621,91.23969145866556,92.92375814807062,-3.7549383018243847,-6.004408726128473,67398500,1.8882568562683824,0.8715578356797598,-2089760200.0,-83.48725147736377,77.07053933241427,82.84087432937385,-121.33071153805868,18.761024878555986,30.875986743535734,-0.07754543213874822,3.5395367704426213,94.92900335693359,93.50550335693359,92.3550033569336,91.2045033569336,89.7810033569336,0.04,0.0,129.34116279772522,-0.05354298377337219,-0.06712045719486257,90.96999904087612,92.34999901907784,3.444901194921501
2022-12-12,0,89.5525016784668,88.54249954223633,100.81999969482422,92.44125032424927,95.51875019073486,0.19665071545082724,3.249684134503601,-0.4526326459607346,2.995135643689574,93.98250007629395,2.4938750267028817,0.03457409627335394,89.40325050354004,98.71374969482422,0.7603476012682026,-0.09986887339057239,0.9527685419259847,0.9719335745233644,0.997216134369438,-0.029083308008171715,30.906921460240387,100.49124324993372,93.99187498092651,87.4925067119193,90.42892864772251,2.1143971373717876,92.20125021253314,2.4649216376531204,90.75559551374275,92.42251456089927,-5.346346548269557,-5.716398861266102,61999800,1.5727822805157077,0.8283036546945898,-2027760400.0,-68.51282364282866,77.07053933241427,82.84087432937385,-101.89158472313991,17.717547652164953,30.71847814886968,-0.1009930836234734,3.4802840783141744,94.92900335693359,93.50550335693359,92.3550033569336,91.2045033569336,89.7810033569336,0.04,0.0,129.2143260123979,-0.005054379449240365,-0.038032447743752196,90.26285661969867,92.21357073102679,3.1051615579158662
2022-12-13,0,93.62249946594238,88.54249954223633,100.81999969482422,91.57187509536743,94.80624961853027,0.3183788686886382,3.161725876666851,-0.25678853818067937,2.9951624547848668,93.6850004196167,2.4454499721527094,0.033810549081731096,89.40325050354004,97.16674995422363,0.764162272367832,-0.0923809552898186,1.0011709543537786,1.0215109409359866,1.0488035700260554,0.04696803183677267,32.823002448464685,99.83645176477779,93.51300001144409,87.18954825811039,90.3125,1.864555907884803,92.28071444375175,2.4934085691946635,90.45865927166773,91.9553730486711,-6.871358339673641,-3.717338679132031,100212000,1.5840481332273146,1.3382033472977672,-1927548400.0,-48.615440955528996,77.07053933241427,82.84087432937385,-2.138983156959332,26.849281161406957,27.265383785476068,-0.11175156422112097,3.6409783131899007,94.92900335693359,93.50550335693359,92.3550033569336,91.2045033569336,89.7810033569336,0.04,0.0,129.02860340464284,0.04804530157245912,0.016261901909678755,90.02857099260602,92.16285651070731,2.862760514367382
2022-12-14,0,91.85250091552734,88.54249954223633,100.81999969482422,91.57187509536743,94.48812484741211,0.3859897268997702,2.9334342826523576,0.3138050951169906,2.9952393311534693,93.64875030517578,2.2184249687194812,0.03145411421645635,89.40325050354004,96.2439998626709,0.6477281024717504,-0.07138960772335068,0.9848998738270189,1.001602966942668,1.0193827399329687,0.0373831932733284,47.66640648932695,99.12761857293413,93.2607500076294,87.39388144232467,90.25785718645368,1.8034275590888056,92.14910738808769,2.461437979078944,91.24639299912957,92.14602140475313,-0.8630051982079335,1.2025718671582297,70298000,1.7955040167683012,0.9651868613049491,-1997846400.0,-57.94873359875816,77.07053933241427,82.84087432937385,-37.65972053578015,24.956435845787514,26.619635835764637,-0.07867301168340768,3.637336743511176,94.92900335693359,93.50550335693359,92.3550033569336,91.2045033569336,89.7810033569336,0.04,0.0,128.89424563624857,0.03527021002569364,0.03773373179665352,90.10999952043805,91.98071398053851,2.51799289022654
2022-12-15,0,88.94499969482422,88.54249954223633,97.0,91.28500032424927,94.42999982833862,-0.32120542287766246,2.3761401659731662,-0.8752771602190634,2.995403579095747,93.35000038146973,1.9571498870849602,0.02560154466702579,89.40325050354004,95.39050025939942,0.6857203565202112,-0.05306700087085213,0.9583312530147067,0.9724617634924357,0.9799158256755636,-0.007116332608562481,45.13391835723279,97.56465540061089,92.81237506866455,88.06009473671821,90.18964276994977,1.8487521693944462,91.81125014168876,2.558585683721917,91.38322016723384,92.05791666645672,-0.414701243880396,-1.9664857092674093,84802900,1.640367693155222,1.1668662058895283,-2082649300.0,-89.95906236637813,77.07053933241427,82.84087432937385,-123.32510672444786,22.960712292920842,29.160592589353826,-0.09575413856484098,3.6710984484102376,94.9266428527832,93.50168254089355,92.35000228881836,91.19832203674316,89.77336172485352,0.06,0.0,128.7204680744652,-0.021029347625535655,-0.00011306959455106326,90.13857051304409,91.62642778669085,2.459271695054962
2022-12-16,0,88.05249977111816,88.54249954223633,96.15999984741211,89.57499933242798,94.3093752861023,-0.3500630289617971,2.314055746820342,-1.2104469929859998,2.995417765318422,93.04374980926514,1.9914499282836906,0.025041284882207814,89.20149955749511,94.70649948120118,0.6335696129890628,-0.06673312617371836,0.9528498759759115,0.9703583469871223,0.9714476367531646,-0.013196231952918525,38.55277213271684,97.03773654704645,92.40962505340576,87.78151355976507,90.11964280264718,1.9290458314902903,91.3558929988316,2.623609222065129,90.76395214608556,91.68660347411641,-0.533982959845867,-5.04937431737332,146144100,1.7163531639877172,1.9266986482110973,-2228793400.0,-89.23812139601934,77.07053933241427,82.84087432937385,-126.13112644876601,21.76580076883565,29.112904469256605,-0.08090040199154575,3.596019638779585,94.7520033569336,93.2190033569336,91.9800033569336,90.74100335693359,89.20800335693359,0.08,0.0,128.41968563617485,-0.013806215940048716,-0.02755946769033693,90.0528564453125,91.19142804827008,2.5644683033974705
2022-12-19,0,86.14249992370605,88.05249977111816,96.15999984741211,89.52000141143799,93.83874988555907,-0.24496632709906738,2.3986296573773864,-1.2973484333494305,2.9953919561326665,92.75999927520752,2.119599990844727,0.0260587488639667,88.90474967956543,94.45774993896484,0.6474515575139709,-0.06960587131249288,0.9358534216076143,0.9560367896700875,0.9528510550624302,-0.038078241152929015,36.85828294592272,96.84425934145766,92.04700002670288,87.24974071194809,89.62821442740304,2.4551284934392053,90.86053575788226,2.9123537748511663,90.08338241588496,91.235689201939,-0.5534063005352876,-6.751211263087868,83531500,1.719406212989379,1.0932405690062506,-2312324900.0,-96.77676105842245,77.07053933241427,82.84087432937385,-165.39227392128308,20.310352842051444,31.597460866581727,-0.118042791856113,3.5784466983908487,94.22808306884765,92.370962890625,90.87000274658203,89.36904260253907,87.51192242431641,0.1,0.0,128.2401170960902,-0.06217564542316367,-0.04680658143850189,89.27714211600167,90.6557137625558,2.941340458175535
2022-12-20,0,85.3650016784668,86.14249992370605,96.15999984741211,89.37437534332275,93.68000078201294,-0.3021277852491661,2.6419461158053177,-0.9923250876854786,2.9953152135036714,92.3725004196167,2.350700111389158,0.02883524164349331,88.49349956512451,94.42849979400634,0.6726360580100417,-0.07383613075753835,0.9317072882637054,0.9538575187031183,0.9514283040248289,-0.08819992880535588,33.5681259990518,96.9060172850164,91.62212505340577,86.33823282179513,89.07607187543597,2.945287580182374,90.2244644165039,3.07815740823487,89.09278671263294,90.59651080255678,-3.840034250410006,-7.45078163536257,74348300,1.7314993411290645,0.9794508876484862,-2386673200.0,-93.33332939049424,77.07053933241427,82.84087432937385,-146.07452786044337,19.361423250774017,30.490035521323637,-0.122195410275861,3.485700418181183,94.18560299682618,92.30220277404786,90.78000259399414,89.25780241394042,87.3744021911621,0.12000000000000001,0.0,128.08039932113067,-0.07892740394605247,-0.059193820317022035,88.72000013078961,89.84499958583287,3.2421667368512144
2022-12-21,0,86.34749984741211,85.3650016784668,96.15999984741211,89.1587495803833,93.68000078201294,-0.30917250395164186,2.94873436929792,-0.9563988920624782,2.9952081031873337,92.04375076293945,2.632387599945067,0.03231848314289533,87.86149978637695,94.42849979400634,0.724187950414288,-0.07723487766444037,0.9463789778101235,0.9692301191055629,0.9804249894511796,-0.05993305585852193,32.225098171302605,97.13734395984828,91.23987522125245,85.34240648265661,88.61821447099958,3.1037343022875508,89.52357155936105,2.7188579565980726,88.15587264735223,89.95793338564961,-4.331500485932497,-9.446270007484122,59267200,1.7337752921391334,0.7822823356936445,-2327406000.0,-79.5302417212736,77.07053933241427,82.84087432937385,-105.5927763427543,19.836629210679586,29.176533792627758,-0.13721100478604467,3.382436167707946,93.4368804321289,91.69656069946289,90.29000091552734,88.8834411315918,87.14312139892579,0.12000000000000001,0.0,127.95696994101063,-0.052522440399834114,-0.06184453835892852,88.17999921526227,89.22142791748047,3.33765271178146
2022-12-22,0,84.30999946594238,85.3650016784668,96.15999984741211,88.84437465667725,93.68000078201294,-0.160924740070651,3.1170818591236027,-1.1836912045313661,2.99514344507805,90.71749973297119,2.8135001182556145,0.03427935624457946,86.3269998550415,94.42849979400634,0.7735420286365853,-0.07841933797261091,0.927178892724338,0.948697095616432,0.9694091592946834,-0.05211085777485869,35.17765609674746,97.16591392042616,90.93175020217896,84.69758648393176,87.28785732814244,2.5471519075729687,88.80017866407123,2.65745585340287,87.70756576261473,89.42991432657364,-3.57890820578309,-10.20434693798939,81431300,1.7247452430493893,1.0594379708190191,-2408837300.0,-88.99999346051898,77.07053933241427,82.84087432937385,-145.3296025480033,17.987620844104963,32.56107560793099,-0.15942373068755086,3.463690487583677,92.946,90.902,89.25,87.598,85.554,0.14,0.0,127.77845126306187,-0.05268508980776687,-0.08506224896018455,86.93714250837054,88.48285675048828,3.5790450345967906
2022-12-23,0,84.30249977111816,84.30999946594238,96.15999984741211,88.41999959945679,93.63562488555908,-0.11641426910291232,3.3625296275199488,-1.1117760649731583,2.9950401538131883,89.56750011444092,2.959500179290771,0.03717042554019901,86.06475009918213,94.42849979400634,0.7530515064014768,-0.09997332867954525,0.9319054812034965,0.9542742928824823,0.979766044344637,-0.042588228724314114,30.92052438442056,97.18755944577475,90.46250019073486,83.73744093569496,86.20928573608398,1.772995062532054,88.23357146126884,2.713831133513128,86.8651804615071,88.71568437925006,-9.946861121121493,-10.724024390795623,57433700,1.760630559687849,0.7365184324850517,-2466271000.0,-78.57142857142857,77.07053933241427,82.84087432937385,-117.14643657138876,17.12574552863734,30.622835396560554,-0.1227612008764257,3.4198553436610903,92.946,90.902,89.25,87.598,85.554,0.14,0.0,127.65553738843046,-0.02970635775347419,-0.036178598741102415,86.03285653250558,88.07142802647182,3.66225520555785
2022-12-27,1,84.09000015258789,84.30249977111816,96.15999984741211,87.62624979019165,93.2137508392334,-0.003159735676847502,3.5310434974076093,-1.1260527540106158,2.9949621198356566,89.48750114440918,3.0131501388549795,0.03923648684555476,85.25950145721436,94.42849979400634,0.7694244269486187,-0.10722512006080731,0.9343969246632148,0.9572079436170859,0.9858898980250138,-0.02382679598265669,30.08083113899412,97.05596211688552,89.9938751220703,82.93178812725509,85.51571437290737,1.4434346088535868,87.85267857142857,2.901829020503599,86.23750466107049,88.16512508967712,-8.219701226592164,-8.60031526724263,57284000,1.7403989727595406,0.7430117124478263,-2523555000.0,-94.35713631766183,77.07053933241427,82.84087432937385,-125.39057536940332,16.265948601934596,29.08541796168981,-0.12846903016524858,3.3434369956687244,92.946,90.902,89.25,87.598,85.554,0.14,0.0,127.53121144497067,-0.0221384514125611,-0.05486000069815993,85.25999995640346,87.69928523472377,3.824807524334859
2022-12-28,1,82.44750213623047,84.09000015258789,96.15999984741211,86.2962498664856,92.44562578201294,0.11679627111911971,3.600145002775388,-1.0762628441484354,2.994923679183683,89.32625007629395,2.949700155258179,0.04023542359596776,84.30924949645996,94.2867504119873,0.8010338140099509,-0.0965593297969113,0.9214379338397042,0.9443833782502871,0.9713075876015073,-0.03417676430471228,30.33023141626313,96.67729014669459,89.4770001411438,82.27671013559302,84.71500042506626,1.3534934557819642,87.41732161385673,3.2291286206349166,85.70970084328968,87.64118703202838,-5.458428870531375,-5.9632647503332965,58228600,1.7307995935208993,0.7588755911956325,-2581783600.0,-99.10716157132018,77.07053933241427,82.84087432937385,-139.6405286053768,15.622566265462414,30.829697846183656,-0.14698607203142508,3.2324772754320046,92.81384057617187,90.68808093261718,88.97000122070312,87.25192150878907,85.12616186523438,0.16,0.0,127.40134175670487,-0.039558664749422046,-0.03650492865006612,84.3971426827567,87.2249995640346,4.09216393852419
2022-12-29,1,83.53750228881836,82.44750213623047,96.15999984741211,85.94812536239624,91.9481258392334,0.16335429227052706,3.808026196995346,-0.9486062485479456,2.994817362474855,89.08749961853027,3.090999984741211,0.0428130280807466,84.28124980926513,94.2867504119873,0.77067366534374,-0.12541103494350894,0.9391987466127678,0.9692755969790623,0.9909608244016019,-0.032542894276723744,25.50524545135476,96.56155257709617,88.94550018310547,81.32944778911477,84.34285790579659,1.2497322292382298,86.98553616659981,3.320210800139315,84.90016472527411,87.03334534564898,-6.365517900635655,-6.883697024047123,54995900,1.702758675454358,0.7397927390117287,-2526787700.0,-82.89836345267888,77.07053933241427,82.84087432937385,-98.28482401715584,17.060491101416893,28.949004520567396,-0.19755529650871814,3.19658628118548,92.81384057617187,90.68808093261718,88.97000122070312,87.25192150878907,85.12616186523438,0.16,0.0,127.28323551272722,-0.029848985111117776,-0.011855876362078391,84.2914287022182,86.78428540910993,3.775140584289722
2022-12-30,1,83.41000175476074,82.44750213623047,96.15999984741211,85.1012511253357,90.14999914169312,0.30968601680356567,3.7759639997126206,-0.8108885417815865,2.994823616754838,88.74374961853027,3.108487243652344,0.04271023681708317,84.03475036621094,93.70399951934814,0.7477347366882221,-0.13126557382095763,0.9434573338438301,0.9772242811410327,0.9960889803828054,-0.01067486320581934,28.815254435971884,95.96080327408346,88.4088752746582,80.85694727523294,84.06357220241001,1.2007236045044776,86.569822038923,3.3813603546965028,84.5593972986023,86.6081956513002,-3.0240562291492203,-6.747965684608238,62401200,1.6491639934219935,0.8428577921616138,-2589188900.0,-84.13462949222598,77.07053933241427,82.84087432937385,-93.70228350327443,16.386204595911515,27.98975356133093,-0.13586525788564216,3.0904014812332843,92.81384057617187,90.68808093261718,88.97000122070312,87.25192150878907,85.12616186523438,0.16,0.0,127.14922231412756,0.002506254710324729,-0.031923438403034105,84.12142835344586,86.42071424211774,3.456508230243031
2023-01-03,1,85.61249923706055,82.44750213623047,94.4375,84.30812454223633,89.56000089645386,0.25044041603913275,3.4780652976904167,-0.9979743515906745,2.9949493389317525,88.29749965667725,2.998987131118774,0.03962641901220786,83.52475223541259,92.37375049591064,0.75082786123256,-0.11677033217989949,0.9754034145658111,1.009575398158532,1.0245938184643588,0.015539271901770846,29.475574747782613,94.72750596540648,87.77137537002564,80.8152447746448,83.95857211521694,0.9794639170977045,86.28839329310826,3.2763491783162526,84.2604349238138,86.10381443710355,-2.2901656243968667,-6.522467575179954,76706000,1.633686505790703,1.0331366464165723,-2512482900.0,-71.63462949222598,77.07053933241427,82.84087432937385,-38.4563996634621,22.00797869134089,26.069057474944255,-0.09945937079648914,3.0810870243065795,92.81384057617187,90.68808093261718,88.97000122070312,87.25192150878907,85.12616186523438,0.02,1.0,126.99369328613038,0.006686213429023091,0.024227219920231444,83.98571450369698,86.08285685947963,3.1068247614462385
2023-01-04,1,85.50750160217285,82.44750213623047,93.62249946594238,84.30812454223633,89.45500087738037,0.27012855552983717,3.148557296221619,-0.9793203227722205,2.995084175477288,87.19999980926514,2.7736247062683104,0.03605350712891146,83.52475223541259,91.89075088500977,0.7878681302752107,-0.07180030714444176,0.9791294960040497,1.0112469292074093,1.0201385174792157,0.0168569562018408,42.091336524537624,93.6272399243219,87.33012533187866,81.03301073943543,84.12964384896415,1.1421412635550283,85.70875058855329,2.5063751080095904,84.57671734973007,86.02633474915272,-0.8512123821192386,-4.399656478110021,68885100,1.6983227352247454,0.9294575968054285,-2581368000.0,-70.68820788258637,77.07053933241427,82.84087432937385,-45.19698978973479,20.18381102004331,25.85450915101819,-0.05780690347335655,3.119581004527562,90.68227987670899,88.9638603668213,87.57500076293945,86.18614115905761,84.46772164916992,0.04,0.0,126.8533235411692,0.025288998686998188,-0.0012903297401942815,84.17857142857143,85.55785696847099,2.997684793620071
2023-01-05,1,84.23500061035156,82.44750213623047,93.62249946594238,84.30812454223633,89.27812480926514,0.4282618331249074,2.9603163223654634,-0.6668369221261754,2.9951558424695444,86.24499988555908,2.585874633789062,0.034029068862813754,83.52475223541259,89.80949878692627,0.8364842738597719,-0.04378091622865565,0.9682879544907425,0.9969464904704219,1.0015694945999514,0.0216804442561227,44.13305657835409,92.91438302620065,86.99375038146972,81.0731177367388,84.12000111171177,1.140722723844025,85.16464342389789,1.7962877273356188,84.79896869700809,85.9711761434299,1.4203560002561832,-8.667785959636308,67930800,1.5961164301951483,0.9212881580604272,-2649298800.0,-82.72946236717664,77.07053933241427,82.84087432937385,-72.24514231242684,19.07828903059498,25.114308766392842,-0.06242214074456827,3.064610823706736,88.01592150878906,86.80704168701172,85.83000183105469,84.85296197509766,83.64408215332031,0.04,0.0,126.7115634252557,0.01588857316801051,0.0009634131764529912,83.87428610665458,84.95357131958008,3.0896533643227015
2023-01-06,1,84.23500061035156,82.44750213623047,93.62249946594238,84.28562498092651,89.01624965667725,0.622305031102915,2.9634086739945156,-0.4897186528002462,2.995152458987233,85.8774995803833,2.55049961090088,0.034166484291390076,83.52475223541259,89.80949878692627,0.8304107172128662,-0.048648942080407535,0.9711835732934541,0.9982815824233943,0.9973301071465593,0.008349523296994343,40.314038600256055,92.66119272945876,86.73437538146973,80.8075580334807,84.14071546282086,1.1414034659802732,84.82821491786412,1.4394178594175202,84.66415356295292,85.81239496607905,-0.0800678045726547,-8.293187696850255,83303400,1.607206843964477,1.118235338257753,-2649298800.0,-41.28784594784653,77.07053933241427,82.84087432937385,-48.145559021932506,16.962260403726464,25.988708332677753,-0.004539693482866298,3.2007101379560967,87.48087890625,86.32455917358398,85.38999938964844,84.4554396057129,83.29911987304688,0.02,1.0,126.5420827399282,0.022570699916736547,0.052065535958440594,84.30857195172992,84.78428595406669,3.0596683802978166
2023-01-09,1,87.84500122070312,82.44750213623047,93.62249946594238,84.23500061035156,89.01624965667725,0.7880761338851432,2.9806513826298375,-0.3329299842520732,2.99514391147373,85.5600004196167,2.5204496574401873,0.034450830079497174,83.52475223541259,89.80949878692627,0.8211003678674926,-0.059693556515997635,1.0153261223449495,1.0436771417472714,1.0383569790602791,0.05317107508260244,38.944902985824804,92.48030320013517,86.5190004348755,80.55769766961582,84.91178676060268,1.5550839321278886,84.81339359283447,1.4043043840757319,84.56789548471502,85.72298646945006,0.17243484064758852,-5.295406263008549,65266100,1.580624151771784,0.8808622951943641,-2584032700.0,-26.335427861969613,77.07053933241427,82.84087432937385,45.20936856291299,22.523974160935584,24.02551896957944,-0.07086708098419081,3.2149452371107468,87.58020263671875,86.40490219116211,85.45500183105469,84.50510147094727,83.32980102539062,0.02,1.0,126.42074687036553,0.04000000726608999,0.03777619735860538,85.1000006539481,84.7485716683524,2.930667781442417
2023-01-10,1,88.73000144958496,82.44750213623047,93.62249946594238,84.23500061035156,88.27562475204468,0.8788991255026066,2.9146866540592886,-0.04259027128107151,2.995168987995539,85.5600004196167,2.407512331008911,0.03372226050084846,83.52475223541259,89.78250160217286,0.7889849219058276,-0.015521666800834454,1.0265859003939093,1.049782755007735,1.037935601536683,0.03641410121543198,55.13403067068213,92.26149887650847,86.43212556838989,80.60275226027132,85.6535723549979,1.9726505325398496,84.99821513039726,1.7260891298647507,85.39911843340855,86.0421627158901,6.546588974344192,-0.23565321933438174,67756600,1.803228245578257,0.9142543329241516,-2516276100.0,-3.6529636619689763,77.07053933241427,82.84087432937385,77.86137417290158,22.651067556264877,22.46661642606403,-0.014804253083208636,3.192449257711647,88.12264193725585,86.8436816253662,85.81000137329102,84.77632112121582,83.49736080932617,0.04,0.0,126.2993079694604,0.0471918325117644,0.06988098507835752,85.91285814557757,85.10214342389789,2.9742657517918234
2023-01-11,0,93.05249977111816,82.44750213623047,93.62249946594238,84.23500061035156,88.22187519073486,0.9048947034707917,2.892642396790905,0.05557974399240262,2.9951772720709067,85.5600004196167,2.375012454986573,0.03347689643151962,83.52475223541259,89.78250160217286,0.7673993274822247,-0.009184558928738547,1.0769077093620785,1.095186236209675,1.0806173298716941,0.08823785080341517,57.785392252251356,92.19241045733914,86.40712566375733,80.62184087017552,87.0310720716204,3.1563713429315423,85.5473221370152,2.7630487276941067,86.24404235878038,86.42640021597619,6.215770185244845,3.003745570619128,103126200,1.8140617574719662,1.3539370949436602,-2413149900.0,-1.2292536213416612,77.07053933241427,82.84087432937385,182.45434335106822,30.859547575365834,19.88418311535083,0.00817790521232786,3.3494171244431064,91.99612170410157,89.97694143676759,88.34500122070312,86.71306100463867,84.6938807373047,0.06,0.0,126.13887975501736,0.11686630279036558,0.10801674057364832,87.4971433367048,85.80928584507534,3.4463458081786684
2023-01-12,0,95.72249984741211,82.44750213623047,93.62249946594238,84.23500061035156,88.22187519073486,0.9333589059062364,3.1701948531177755,-0.18943054820730243,2.9950691785688863,85.5600004196167,2.6025123310089127,0.036614888261361604,83.52475223541259,91.97250080108643,0.6116646763383229,-0.006088276835971154,1.1055688367433572,1.1148509794188042,1.0924794029554643,0.13637441863624633,66.56672886925061,92.92251527462545,86.5821255683899,80.24173586215434,88.47535787309918,4.44790058880315,86.21696499415806,3.881551561456452,87.9514851241405,87.24471303653455,11.560361843305037,9.005444785916906,85254800,1.8448105953037797,1.1304036467354024,-2327895100.0,-12.18277625690135,77.07053933241427,82.84087432937385,207.6515559526774,32.53484213415949,18.330744260157452,0.02671533812704899,3.37374464710701,93.47064193725585,91.1696816253662,89.31000137329102,87.45032112121581,85.14936080932617,0.08,0.0,126.01377535873124,0.14617412770699167,0.11898047129478372,88.8471429007394,86.4164287022182,3.740314344510429
2023-01-13,1,96.19750213623047,82.44750213623047,95.72249984741211,84.23500061035156,88.22187519073486,1.163047256017512,3.426089501150346,0.5535489112145688,2.994962539321235,85.5600004196167,2.7390123558044452,0.03952247208489543,83.52475223541259,91.97250080108643,0.6230319341877877,0.04213275515975152,1.1097092155763262,1.1033246973982715,1.0698477653379936,0.14201343193685267,73.47732066401068,93.53930458976407,86.68712558746338,79.8349465851627,90.00250080653599,5.053070028688185,87.06607232775006,4.655390516861027,89.88822100940767,88.17358007424914,11.809024033227935,10.857291776330424,85549400,1.8902526227626983,1.1229555715362172,-2242345700.0,-1.475796717649389,77.07053933241427,82.84087432937385,212.53874859792387,32.113441081442915,16.71137614390505,0.07817486611780189,3.4363343152273673,94.37216217041016,91.89892181396485,89.9000015258789,87.90108123779298,85.42784088134766,0.1,0.0,125.89554359512685,0.1398698961363607,0.1804619767125408,90.70142909458706,87.44000026157924,4.412184932686832
2023-01-17,0,97.3375015258789,82.44750213623047,96.19750213623047,84.23500061035156,88.22187519073486,1.2750990411201695,3.8573565652984687,0.5920530068219323,2.9947646877508913,85.5600004196167,3.021437435150145,0.044386218030036714,83.52475223541259,93.31949977874756,0.7463326059028196,0.08153918113766973,1.120052940942573,1.1004214089029658,1.0544689397371192,0.10805965249322136,77.62655195738962,94.61908877909546,86.90437564849853,79.1896625179016,91.87428665161133,4.986886162392297,87.99714388166156,5.316686333506244,91.45764836295609,89.09613684587337,12.501827715412949,14.09975417576669,72755000,1.7423518348100113,0.9626228963338959,-2169590700.0,-16.265730164993393,77.07053933241427,82.84087432937385,174.1800910515258,31.07902210998336,15.607355725748226,0.052532985349144384,3.416595866459906,94.76943960571289,92.22027973937988,90.15999984741211,88.09971995544433,85.55056008911133,0.12000000000000001,0.0,125.79581505407482,0.09947347047495936,0.11582250242362657,92.54857199532645,88.21142905099052,4.844561796166566
2023-01-18,1,96.85249900817871,82.44750213623047,97.3375015258789,84.23500061035156,88.22187519073486,1.1723728784293896,4.465133022445314,-0.004985395192312669,2.994449491834053,85.5600004196167,3.5669500541687027,0.05113294151211941,83.52475223541259,95.77000007629394,0.7971748918341047,0.10544847424997567,1.1091166023931056,1.0779654207922897,1.0280708436181376,0.09154172687812734,80.37676052576994,96.2542667849419,87.32400074005128,78.39373469516065,93.67678642272949,3.934782303437729,88.90875094277519,5.677148218404143,92.92372140248064,90.10494811890472,15.554699140011865,15.462177029329922,79570400,1.723124056226391,1.1013009805017282,-2249161100.0,-21.57630375652806,77.07053933241427,82.84087432937385,141.189424527434,29.43596219134584,14.335676114593696,0.016020974048249675,3.4539820504137833,95.09795983886718,92.48601992797852,90.375,88.26398007202148,85.65204016113282,0.14,0.0,125.6868896782714,0.062200914287868114,0.09271976210541943,93.88857160295758,89.09857177734375,5.1668344310440055
2023-01-19,1,94.18000030517578,82.44750213623047,97.3375015258789,84.23500061035156,89.81062602996826,0.9667876145088908,4.925128562999455,-0.6696468106176856,2.9941843108197888,85.5600004196167,4.1389500045776355,0.05611786750387497,83.52475223541259,96.2630018234253,0.8528576884704419,0.12432886315068864,1.0731051405127237,1.0352692821326575,0.9827563702846698,0.012116821545159251,80.27718634488599,97.6142578279032,87.7640007019043,77.91374357590539,94.58178629193988,2.9834376949724484,89.74678652627128,5.513593253671659,93.9051161132859,90.8278914491455,14.978925988488205,15.177189716294764,69002700,1.6463912613256753,0.964737632739733,-2318163800.0,-31.5259898382773,77.07053933241427,82.84087432937385,85.33772598308836,27.824791393176124,18.85607504831746,0.04165548678574296,3.39298322349159,95.09795983886718,92.48601992797852,90.375,88.26398007202148,85.65204016113282,0.14,0.0,125.58425974671167,-0.01482801647930021,0.042394541472723535,94.7914287022182,89.94571467808315,5.278420070344493
2023-01-20,1,95.41499900817871,82.44750213623047,97.3375015258789,84.23500061035156,93.33437490463257,0.7343562141884726,5.101193697350834,-1.11916987994673,2.9940804619737604,85.5600004196167,4.491137399673461,0.057859048703772814,83.52475223541259,96.2630018234253,0.896155045440361,0.10326244307838578,1.0822214176167493,1.038940516224658,0.9933061113846084,-0.0032124196476646105,67.67200451762874,98.36826311567944,88.16587572097778,77.96348832627612,95.53678594316754,1.4984486494963616,90.59517914908272,5.397242022014124,93.97198960670164,91.13186814158688,7.211564683750766,14.230265156559087,67481500,1.776847998748312,0.9480202684700567,-2250682300.0,-11.570708582706649,77.07053933241427,82.84087432937385,98.43844503435476,29.389826216112876,17.23455177917387,0.09980008347062191,3.4470559594127343,95.09795983886718,92.48601992797852,90.375,88.26398007202148,85.65204016113282,0.14,0.0,125.49065737378325,0.020783073650687545,0.022715361713066717,95.84571402413505,90.8792860848563,5.589540424054338
2023-01-23,1,97.17999839782715,82.44750213623047,97.3375015258789,84.23500061035156,94.48874998092651,0.5079776514805656,5.291967089242448,-1.4510576021541808,2.9939676740735526,85.97999954223633,4.814049835205077,0.05968268905549531,83.52475223541259,96.2630018234253,0.8968577566403999,0.10501171634141253,1.0959938958390845,1.0454323961128387,1.0123285536056787,0.010213324044581862,69.7234825821822,99.25230976594827,88.66837558746337,78.08444140897848,96.12642860412598,1.1230026895352796,91.57875033787319,5.239510966297966,94.33164742034684,91.48056781049505,7.534089315204242,14.21816117783327,76501100,1.781614540692007,1.0618782982819057,-2174181200.0,-10.061504265893577,77.07053933241427,82.84087432937385,99.00415055591196,29.102475774258835,16.526460917434367,0.11492159356038445,3.337980402882713,95.09795983886718,92.48601992797852,90.375,88.26398007202148,85.65204016113282,0.14,0.0,125.38925016918219,-0.006115023305342748,0.02361708910759945,96.19285692487445,91.84500013078961,5.887133963500311
2023-01-24,1,96.83499908447266,82.44750213623047,97.3375015258789,84.23500061035156,95.49187421798706,0.3240445140649273,5.5735644828754465,-1.6534202868524674,2.993792089629251,86.72875022888184,5.225749588012695,0.06247690226096663,83.52475223541259,96.88524894714355,0.8783737835707435,0.15265091938570932,1.0854724641348679,1.0274134169055973,1.0066740764688396,-0.005162475238514874,75.2975733088543,100.35712948073503,89.21000051498413,78.06287154923324,96.2853570665632,1.1349681446432827,92.3803574698312,5.113467436617632,95.03204108279682,91.94935359947512,4.43566657194747,16.50880752113216,66929500,1.6995709401942047,0.9384644290860245,-2241110700.0,-16.76914534572801,77.07053933241427,82.84087432937385,84.82705177732461,28.446762085869477,15.767063347666273,0.08936112825618378,3.248838683903056,95.09795983886718,92.48601992797852,90.375,88.26398007202148,85.65204016113282,0.14,0.0,125.30034453216183,0.0028110008796244923,-0.018344914404525216,96.34285736083984,92.59500013078961,5.925793785416343
2023-01-25,1,94.62499809265137,82.44750213623047,97.3375015258789,84.23500061035156,95.8412504196167,0.12524805871606276,5.690251457656751,-1.7547616145765181,2.9937299252053,88.28750133514404,5.424624462127686,0.06334025993121531,83.52475223541259,96.88524894714355,0.8893387432553573,0.1486610639943099,1.0533052923547683,0.9944797626862822,0.984728245378861,-0.022998899753110535,73.57887464218695,101.21675341122415,89.83625049591065,78.45574758059715,96.06071363176618,1.29902122512905,93.03160721915108,4.73759624520622,95.4776451978687,92.39668054303289,1.1622128954362276,13.1084829288035,94261600,1.7083769242721871,1.2884397302086352,-2335372300.0,-11.961986934927959,77.07053933241427,82.84087432937385,59.90055126371712,25.05366774120926,23.22850490219167,0.12552919523786707,3.425350293769458,95.09795983886718,92.48601992797852,90.375,88.26398007202148,85.65204016113282,0.02,1.0,125.16956811315335,0.018018030978411037,0.01176467691322268,96.2085712977818,93.45500019618443,6.0198546225256715
2023-01-26,1,98.46749877929688,82.44750213623047,97.3375015258789,84.23500061035156,95.8412504196167,-0.0684016479497754,5.632766819727856,-1.7489770370285704,2.9937846483364723,90.89125061035156,5.387374305725098,0.06234221063966118,83.52475223541259,96.88524894714355,0.900694705822706,0.125282410761647,1.0898163809230954,1.0284912909175887,1.0294886387631932,0.045524511151286084,63.72777144244434,101.61790905144302,90.35237541198731,79.0868417725316,96.22214181082589,1.5332292110049963,94.04821423121861,4.201486990977582,95.26362858941052,92.5079941523998,-1.6346620324425825,10.662803051945128,68523600,1.8168300178897958,0.9294930683359225,-2266848700.0,-1.4949982257218848,77.07053933241427,82.84087432937385,90.42056063267717,28.46372303155111,21.961035338542917,0.19881095267515717,3.3642538223857006,95.2278384399414,92.59107879638671,90.45999908447266,88.32891937255859,85.6921597290039,0.02,1.0,125.08542148838987,0.059137498905636354,0.039388248190776104,96.66142817905971,94.60500008719308,6.034972174484313
2023-01-27,1,101.1974983215332,82.44750213623047,98.46749877929688,85.18937635421753,96.35687637329102,-0.23581525104004808,5.7046625708608145,-1.6553857594731576,2.9937589964757336,93.61625003814697,5.40812421798706,0.06263955473714515,83.52475223541259,97.19574871063233,0.838907490974063,0.19430542136493217,1.111190391479597,1.051061330450958,1.048629853671121,0.06060367210042972,72.69030545120754,102.48057548504438,91.07125034332276,79.66192520160114,96.84285599844796,2.441467126348696,95.25982121058873,3.5490370197739827,96.06440523482757,93.18855994892961,1.160906367745158,16.89618100055702,87775600,1.8794954659401022,1.167246961638031,-2179073100.0,-7.617308361976509,77.07053933241427,82.84087432937385,120.18553280153428,34.26433295581822,20.007635310264156,0.2495154873698945,3.428949738178621,99.61723880004882,97.22137937927245,95.28499984741211,93.34862031555176,90.9527608947754,0.04,0.0,124.99134964584321,0.051311032018195535,0.09137486689483709,97.62999943324498,95.75928551810128,6.051333560014515
2023-01-30,1,100.59749984741211,83.41000175476074,101.1974983215332,85.58624982833862,96.83937406539917,-0.2819958062101706,5.75090100800321,-1.4465634449783107,2.9937654198708783,94.40249919891357,5.295749244689941,0.06250384880205284,84.16525077819824,97.4505012512207,0.816250501530899,0.21140201165768713,1.0933470966683123,1.0389218119851409,1.0300683113658597,0.035166716463553405,76.13029499398607,103.51055216859433,92.0087501525879,80.50694813658146,97.75964164733887,2.479504281152845,96.17071396963937,3.10878071658035,97.34399612721505,94.31371076388844,4.486202584186887,20.13711353745409,70691900,1.9259344145787607,0.9303570341636109,-2249765000.0,-18.148119542273932,77.07053933241427,82.84087432937385,97.9372770247138,31.94929181854838,19.743550846667095,0.23010313062517015,3.4147387374125286,99.66679858398436,97.30159902954101,95.38999938964844,93.47839974975585,91.1132001953125,0.04,0.0,124.91186427811209,0.031070616417077312,0.03393319333427042,98.61142839704242,96.70142854963031,5.980765363081602
2023-01-31,1,102.19499969482422,83.41000175476074,101.1974983215332,87.28687572479248,96.93437385559082,-0.40695312111391463,5.696093631573348,-1.263339579700194,2.9938332474394884,95.01999855041504,5.045724372863768,0.06133950339834662,84.23500061035156,98.6804988861084,0.8178399310123962,0.2060603972073453,1.1005069327386077,1.0506457674885648,1.0391531902216504,0.05535189405718732,73.81809244296042,104.25393729366425,92.86175003051758,81.46956276737092,98.7282131740025,2.7232267982949208,97.13249955858502,2.683512372508607,98.15231726986421,95.19080193448212,6.814078914250807,14.517045306504592,66527300,1.9424019880053238,0.8731770720881356,-2183237700.0,-2.866247454843212,77.07053933241427,82.84087432937385,121.68250950260752,33.46528601512635,18.572116668222662,0.22608751970998126,3.3708285006057332,100.5258384399414,98.69207879638671,97.20999908447266,95.72791937255859,93.8941597290039,0.04,0.0,124.84392740711382,0.07070180211970745,0.05752666943667717,99.45142800467353,97.6485710144043,5.950343248490316
2023-02-01,1,103.78999900817871,84.23500061035156,102.19499969482422,88.5087513923645,97.21937417984009,-0.4637064233735044,5.608207599762188,-1.0301828629607388,2.9939262707594088,95.56874942779541,4.73894949913025,0.05978835624455606,85.38025150299072,100.65749969482422,0.8231866629212294,0.19369251692847814,1.1064913922919413,1.0617414033382992,1.043991692599841,0.09685602219567291,75.32056040248303,105.01741512704513,93.80099992752075,82.58458472799637,99.6724989754813,3.2010092753037855,97.89946378980365,2.9490118984335942,99.151768932538,96.16944126635539,7.10580176819406,15.175248535175406,80450100,1.9257520530265249,1.0533270199255313,-2102787600.0,-7.404865811815105,77.07053933241427,82.84087432937385,137.51518112268536,35.957534860590016,16.670045430746466,0.24665499267674318,3.4871978934628336,102.76607757568358,100.61695739746092,98.87999725341797,97.143037109375,94.99391693115234,0.06,0.0,124.76843208679821,0.08201277213083769,0.09167360734044074,100.54142870221817,98.36714281354632,6.081950336594071
2023-02-02,0,111.51000022888184,84.23500061035156,103.78999900817871,91.97187519073486,97.6200008392334,-0.5087213281953765,5.679997067868413,-0.6942784843748222,2.993913055027953,95.96000099182129,4.526899566650391,0.059972596024453775,85.38025150299072,101.2972484588623,0.8027114507972745,0.213811619605797,1.177385149412265,1.1326763177653691,1.1013387837645847,0.13245488725999,77.52892897955718,106.06986905181347,94.70987491607666,83.34988078033984,101.76892771039691,5.2087858228862745,99.02714238848004,4.605690703638476,100.2940175944606,97.22821887998211,6.801811812439128,11.539184077237735,158154200,1.9177207211517722,1.9563711744310623,-1944633400.0,-4.848737433815521,77.07053933241427,82.84087432937385,229.5532238320383,44.40614900532481,13.947266667626915,0.28991206194990254,3.8702550779276854,108.69471920776367,105.41263871765136,102.7599983215332,100.10735792541504,96.82527743530274,0.08,0.0,124.676748485875,0.1379762373813569,0.1618646152247009,102.9114292689732,99.62714331490653,6.7949270172173595
2023-02-03,0,104.98749923706055,84.23500061035156,111.51000022888184,93.89812517166138,98.99999904632568,0.08885864603668593,6.3600368434301675,0.3568308539443006,2.9935371831112927,96.51625061035156,4.604999771118164,0.06624348352815458,87.48400115966797,102.35449962615967,0.6759293067784312,0.3237965147610918,1.093505878595108,1.0479755466865097,1.0108754243601887,0.03745152773920779,85.50550824327266,108.73007353427244,96.0099998474121,83.28992616055177,103.24928501674107,4.218450870877143,99.65499932425362,4.785885966598114,103.0884297359177,99.2816022574152,15.154645823466831,16.492987966921078,144374800,2.3652380930737102,1.7052922541295887,-2089008200.0,-47.19750456389091,77.07053933241427,82.84087432937385,116.98365068660542,36.80557333763214,22.03723337904936,0.25367002540838207,4.335951645299355,108.69471920776367,105.41263871765136,102.7599983215332,100.10735792541504,96.82527743530274,0.08,0.0,124.54863453225533,0.011248058977967101,0.042027798000824915,103.79857199532644,100.00357164655414,6.164291707253388
2023-02-06,0,102.42749977111816,84.23500061035156,111.51000022888184,94.51374864578247,100.74749946594238,0.11814879489447856,6.039093273379568,0.39167254259006246,2.9937966477984395,96.84374904632568,4.383387203216553,0.0622281409477841,88.64150142669678,103.9097490310669,0.7153912501711042,0.2463643197761042,1.055435411269836,1.012744906378551,0.9790806392860305,0.018191306210212366,66.61718682609342,109.12581132550669,97.04762477874756,84.96943823198843,103.8149994441441,3.7045374919534466,100.018570627485,4.789624553260743,103.56410073454461,100.16604868059879,10.951124283524754,9.137448380293794,81945200,2.94978170282399,0.9686780098275452,-2170953400.0,-52.5800619650643,77.07053933241427,82.84087432937385,66.34967784283147,34.76998453827053,23.95246357250504,0.2074548845064918,4.261954772210488,108.69471920776367,105.41263871765136,102.7599983215332,100.10735792541504,96.82527743530274,0.08,0.0,124.46699692329616,0.016210812570328192,-0.0005868305931860445,104.22142900739395,100.44142859322685,5.607957193591706
2023-02-07,0,100.94250106811523,87.84500122070312,111.51000022888184,95.21749877929688,101.44687366485596,0.3827313332416222,5.3742176959014785,0.411091189912391,2.9942353345648356,97.01624870300293,4.151449699401854,0.05486288876364093,92.62024993896485,103.9097490310669,0.7370770721081502,0.1660025994396397,1.0304750423205105,0.9929104357370732,0.9615219891433777,-0.01225596781103977,59.74238063805414,108.70568512858884,97.95724973678588,87.20881434498293,103.77857126508441,3.7356890012317763,100.31071363176618,4.705653851132514,103.29320578031971,100.57706011711971,4.021632559893857,5.2292263161141355,119501300,2.9940212194855027,1.3687538542314766,-2290454700.0,-52.89144846137739,77.07053933241427,82.84087432937385,36.18449531852301,32.24963543537228,26.518542025256938,0.28862175177843064,4.266815276414988,108.69471920776367,105.41263871765136,102.7599983215332,100.10735792541504,96.82527743530274,0.02,1.0,124.34160764951444,-0.00989039726782881,0.015514644567347854,104.20285797119139,100.9164287022182,5.0190551806526456
2023-02-08,0,100.88500022888184,88.73000144958496,111.51000022888184,95.64562463760376,101.44687366485596,0.564006422549898,4.8770956890671595,0.700810986002014,2.994518847337726,97.25874996185303,3.8750499343872065,0.049457363407008674,94.06725025177002,103.9097490310669,0.6993825937636645,0.13763664396499792,1.02304864139139,0.9883515960679774,0.9632727532897668,-0.027989197485857598,56.29769220802633,108.36631610729081,98.61212472915649,88.85793335102217,103.81964274815151,3.6962585541263606,100.78964219774518,4.362376375777686,102.72404117683203,100.71019809453254,-0.2519797995477813,4.222918460360164,75878300,3.0356081146092264,0.8650774445783095,-2366333000.0,-62.05513730023332,77.07053933241427,82.84087432937385,22.028075149390308,30.574198095520316,24.78067900583884,0.24217441338634027,4.2398998559247625,108.69471920776367,105.41263871765136,102.7599983215332,100.10735792541504,96.82527743530274,0.02,0.0,124.26144719068479,-0.04850212458499992,-0.02986516322784134,104.13142939976284,101.37142889840263,4.521603097793039
2023-02-09,0,99.72749900817871,93.05249977111816,111.51000022888184,96.07875156402588,101.44687366485596,0.9793404043183843,4.334995097832961,0.9150889013032777,2.994790320245884,97.90250015258789,3.5553625392913815,0.04369079392947233,94.5804983139038,103.9097490310669,0.7271982227996465,0.08417291826688508,1.005116155828208,0.971056469119838,0.9575325985559666,-0.10566317995263874,54.34055086922353,107.88986486378725,99.21987466812134,90.54988447245542,103.46714265005929,3.9835148821424746,101.0976779120309,4.097909542994922,102.28202040507512,100.80068998624908,0.2857927701044377,7.119345829241384,64622500,2.9111729379934053,0.7532853838681002,-2430955500.0,-70.10676059961337,77.07053933241427,82.84087432937385,-8.180555448182332,28.404635100357286,25.06171117589659,0.1665471620310409,4.237764086534818,108.69471920776367,105.41263871765136,102.7599983215332,100.10735792541504,96.82527743530274,0.04,0.0,124.1898801695152,-0.12992653726449976,-0.06571567819149046,103.43285805838448,101.44214303152901,4.4080804582708435
2023-02-10,0,97.55500030517578,94.18000030517578,111.51000022888184,96.67562484741211,101.44687366485596,1.0851247119938965,4.097786222916051,1.2535149143276447,2.9948967868514402,99.0974988937378,3.2723750114440917,0.041161597462140605,95.33599891662598,103.9097490310669,0.7421798175255319,0.041839684161517204,0.9799241430713631,0.9487386521441653,0.9583570783816934,-0.07079413250050148,50.47144164905867,107.74919707580646,99.55362462997437,91.35805218414227,102.57642854963031,4.555325354548803,101.1244637625558,4.071472245519467,101.64763879419294,100.60644989446664,-2.4145023670570813,4.51972964924555,52740100,2.8802336550559207,0.6266512463700131,-2483695600.0,-72.90923906643104,77.07053933241427,82.84087432937385,-45.031020284663356,27.129206607944276,26.259505564463723,0.1738799156078686,4.120066390177066,108.69471920776367,105.41263871765136,102.7599983215332,100.10735792541504,96.82527743530274,0.06,0.0,124.1279541359731,-0.05590481490877708,-0.13550617797820713,102.355715070452,101.4485718863351,4.311484041621565
2023-02-13,0,98.4950008392334,94.18000030517578,111.51000022888184,96.8481240272522,101.44687366485596,1.1085507186422199,4.031042779295084,1.4006346658232882,2.994925316691776,99.0974988937378,3.1807499885559083,0.04045393827942788,95.33599891662598,103.9097490310669,0.724274972606997,0.014111573988926304,0.9884565614754711,0.9612855625952901,0.9819305711369343,-0.03839299934756024,45.72405752044778,107.7073352114527,99.64524965286255,91.58316409427239,100.71714292253766,2.488529767414672,101.24303531646729,3.959577097188207,100.62404645338651,99.90844653716773,-6.007321285851066,0.38588383775587454,52841500,2.927730553051055,0.6402980573128044,-2430854100.0,-64.32382973827583,77.07053933241427,82.84087432937385,-23.43871243211973,27.321858555015766,24.968228586889115,0.16037067652784615,4.0236328367922205,108.69471920776367,105.41263871765136,102.7599983215332,100.10735792541504,96.82527743530274,0.06,0.0,124.06888512784647,-0.025836752610723046,-0.03723762933406653,100.44571467808315,101.67857197352818,4.291964747344573
2023-02-14,0,99.13749885559082,94.18000030517578,111.51000022888184,97.09812355041504,101.44687366485596,1.1110680886299107,3.963321221844365,1.547072607534461,2.9949538148923502,99.11124992370605,3.0691376113891606,0.0397285111482369,95.33599891662598,103.9097490310669,0.7294180210933693,0.011891606988152972,0.9937587715032115,0.9695456684231253,0.9961465275348018,-0.017881488901353992,47.26852076341077,107.68676703170144,99.7601245880127,91.83348214432397,99.8814285823277,1.6596729364587972,101.56535679953438,3.5409435010104064,100.09630953308482,99.64928086164431,-11.671598388426391,1.714258037336958,56202900,2.924227235176023,0.6879280547616333,-2374651200.0,-80.47273918499839,77.07053933241427,82.84087432937385,-12.201194507298705,27.880231794846825,23.444332716601743,0.20721549207712245,3.9790877431470637,109.80628079223632,107.21186128234864,105.1150016784668,103.01814207458496,100.42372256469727,0.06,0.0,124.00801109262324,-0.023602033568737912,-0.024270927280550796,99.91857147216797,101.85857173374721,4.192097623102439
2023-02-15,0,99.96749877929688,94.18000030517578,111.51000022888184,97.09812355041504,101.44687366485596,1.0844712970291943,3.9275619850779004,1.60518700200587,2.994968798860519,99.43249893188477,2.9881377315521234,0.03933457275626823,95.33599891662598,103.9097490310669,0.7209005139116439,0.023592575006445137,1.0011755050425808,0.9805950608185477,1.0081433938395254,-0.00909452790309151,49.05545786817078,107.70524842465409,99.85012445449829,91.99500048434248,99.52999986921039,1.2374368760787908,101.67249965667725,3.4618065877081636,99.84614729803505,99.57846030839356,-5.5720923195441525,4.768825208874585,47957600,2.923986865029873,0.5985858512860348,-2326693600.0,-72.25660530949287,77.07053933241427,82.84087432937385,3.579968588598378,26.946604626536764,22.273152003806672,0.2886544947828884,3.8891529915280043,109.80628079223632,107.21186128234864,105.1150016784668,103.01814207458496,100.42372256469727,0.06,0.0,123.9581520690406,0.011094458535672036,-0.009303662154183554,99.77285766601562,101.9971433367048,4.046144122758882
2023-02-16,0,99.02249908447266,94.18000030517578,111.51000022888184,97.46124982833862,101.44687366485596,1.0387125756264002,3.8668961724461717,1.7059123421537228,2.994993892807625,99.8474988937378,2.8479627418518065,0.038666690271760756,95.33599891662598,103.9097490310669,0.6819877807543653,0.06145145949636437,0.9901668240585056,0.9749811620131248,1.0004647520086403,-0.007069263048983476,52.64813923466127,107.73966678794653,100.0058744430542,92.27208209816186,99.25571387154716,1.074187125510997,101.51714256831578,3.5328386742188456,99.86168142463339,99.7019261022262,-2.401699736221565,1.5233452850895204,56339200,2.8516185095339885,0.7088030079641452,-2383032800.0,-89.19528119497721,77.07053933241427,82.84087432937385,-35.49668846055685,25.4087773810291,21.654786929113502,0.27272930255034206,3.8299281484082885,109.80628079223632,107.21186128234864,105.1150016784668,103.01814207458496,100.42372256469727,0.06,0.0,123.89664743560097,-0.0009160865212498592,-0.018990519419534495,99.20714351109096,101.70500074114118,3.76587378795615
2023-02-17,0,97.14750099182129,94.62499809265137,111.51000022888184,98.2393741607666,101.44687366485596,1.2501084029908724,3.639446716697933,2.3099745794602606,2.9950825085186428,99.8474988937378,2.6300502967834474,0.03630443239898433,96.69299907684326,103.9097490310669,0.6593327998516715,0.03780852186546394,0.9690717180461371,0.9684268890187753,0.9829211306845264,-0.004177123797649895,49.42275845999766,107.5268928154149,100.24799938201905,92.9691059486232,98.72178540910993,1.058119257198342,101.27071407863072,3.7174245120911737,99.65136614199847,99.78183573849925,-1.902074907324691,-2.149261862333747,60029400,2.855729132207607,0.7587863771266661,-2443062200.0,-91.55315775884534,77.07053933241427,82.84087432937385,-89.96596798771695,24.19395469614133,25.304932980476256,0.2468394306716943,3.7349332806503392,109.66940036010742,106.99030058288574,104.82500076293945,102.65970094299317,99.98060116577149,0.08,0.0,123.82613866053866,-0.004200426795877732,-0.010586328767733648,98.7999997820173,101.46571459089007,3.7682866314951244
2023-02-21,0,94.94999885559082,94.62499809265137,111.51000022888184,98.2393741607666,101.44687366485596,1.3753885793716432,3.5427148316762604,2.632151425524264,2.9951183110173476,99.8474988937378,2.5520877075195316,0.03530899577284039,97.11625080108642,103.9097490310669,0.64913997992108,-0.0003344042657093312,0.9463333255747698,0.9539765244156857,0.9614800325489623,-0.03599169453715567,43.66446650781577,107.42005414455369,100.33462448120117,93.24919481784866,98.03928538731166,1.6669317211770953,100.75321401868548,4.066732138311755,99.0220674708963,99.62113357940588,-3.7047125227547535,-3.429507553193502,56580400,2.8657127195692564,0.7243093155274152,-2499642600.0,-98.42876261914408,77.07053933241427,82.84087432937385,-136.3834483835789,22.817058736425846,26.545257392518067,0.19482362591997474,3.677438068108294,109.34371920776367,106.46313871765136,104.1349983215332,101.80685792541504,98.92627743530274,0.1,0.0,123.75483050949289,-0.04982920473028607,-0.031041888744497734,98.27714320591518,100.85500063214984,3.9508638462381214
2023-02-22,0,95.67500114440918,94.62499809265137,111.51000022888184,98.2393741607666,101.44687366485596,1.1994523738815717,3.672944663861248,2.218721223536556,2.995069842655301,99.8474988937378,2.652437686920166,0.03664767669173378,96.64649906158448,103.9097490310669,0.6293153711532845,-0.01946610468016303,0.9546200202579536,0.9685371099939496,0.9758274446882218,-0.03492621612559854,39.18063550421283,107.56901383181186,100.22312450408936,92.87723517636685,97.77071407863072,1.8939536374090875,100.17357131413051,4.177415628360799,97.99642041854783,99.20982879237043,-4.7905544610078765,-7.089388777208764,59534100,2.9069509549856987,0.7657455800628143,-2440108500.0,-92.29597560140925,77.07053933241427,82.84087432937385,-107.38669107998149,24.50018483749184,25.261236154083168,0.22162813283443158,3.5883353707442462,109.34371920776367,106.46313871765136,104.1349983215332,101.80685792541504,98.92627743530274,0.1,0.0,123.68287782952041,-0.03921761436707638,-0.0376732968204648,98.01714324951172,100.18642915998187,3.982244485807373
2023-02-23,0,95.51000022888184,94.62499809265137,111.51000022888184,98.2393741607666,101.44687366485596,1.1346154810480475,3.7346298514746032,2.02752278465253,2.995046230969676,99.8474988937378,2.7046375942230227,0.03728473224711984,95.60250091552734,103.9097490310669,0.6285351281294325,0.011096465764043766,0.9535254970583342,0.9720501282542909,0.9810739370168392,-0.044589477628684815,42.56411782357681,107.63438431003539,100.16512460708618,92.69586490413698,97.34428542000907,2.0345232150939268,99.03071417127337,2.798474553686344,97.39556435031582,98.93732909433082,-1.9271171696842875,-7.818670335597618,48467000,2.868407062139694,0.6423141172736472,-2488575500.0,-85.77100305074792,77.07053933241427,82.84087432937385,-121.09512001180681,23.13157920433467,26.13718955193429,0.18512275472342926,3.529168711128887,105.21403863525391,103.00797854614258,101.2249984741211,99.44201840209962,97.23595831298829,0.12000000000000001,0.0,123.62340061779315,-0.052787700414895444,-0.0389167238935045,97.48571450369698,98.96571459089007,4.052975241405217
2023-02-24,0,93.37249946594238,94.94999885559082,111.51000022888184,98.2393741607666,101.44687366485596,1.2258626581815129,3.673467178920049,2.1811433273080825,2.995069697856166,99.8474988937378,2.664812498092651,0.03665791937538742,95.65850105285645,103.9097490310669,0.6910448117133111,-0.030035276482892274,0.9317740953131889,0.9555228617659753,0.9679818725377247,-0.05705773607784281,39.004493298600394,107.5563090717378,100.2093747138977,92.8624403560576,96.52071407863072,2.3326411795620268,98.20107133047921,2.6121724186951596,96.94022644594521,98.73590012675317,-3.030611284753196,-14.348488895308865,57053800,2.7259716284624487,0.7619022437027398,-2545629300.0,-89.85382129106706,77.07053933241427,82.84087432937385,-149.08102099922456,21.492011566540295,27.018526024355804,0.16170338667069084,3.527085231762302,101.20531759643556,99.50733799743654,98.1349983215332,96.76265864562988,95.06467904663086,0.14,0.0,123.548814887519,-0.04737647940487144,-0.07572166256236026,96.6000006539481,98.25928606305804,4.33528415370647
2023-02-27,0,93.98999977111816,93.37249946594238,111.51000022888184,97.45312547683716,101.44687366485596,0.9238243645710207,3.9515693260808735,1.5289055074212747,2.9949594551341647,99.8474988937378,2.895374870300293,0.0395336317457472,95.45400009155273,103.9097490310669,0.705997186715586,-0.07732403454014818,0.9403266733066552,0.9681381691636612,0.9859332183205971,-0.032502135293927426,31.86578895153089,107.85776340039173,99.95462474822997,92.05148609606822,95.66678564889091,1.9177731455697213,97.59839275905064,2.5342288700097253,96.06661537021674,98.1564616923603,-5.815155169534845,-11.063221674507773,47470300,2.6709077041411593,0.6514552082087504,-2498159000.0,-86.08693088209807,77.07053933241427,82.84087432937385,-120.32588734673662,22.097439598462124,26.0855211817109,0.1360253828879682,3.3922933858828217,100.22739852905275,98.71629875183106,97.49499893188477,96.27369911193848,94.7625993347168,0.14,0.0,123.488208515584,-0.035390894238849335,-0.044727451058581245,95.54285757882255,97.65785762241909,4.530409281472393
2023-02-28,0,93.7450008392334,93.37249946594238,111.51000022888184,96.77937602996826,101.25562572479248,0.9112207736344119,4.145676165640075,1.2237303817963854,2.994875875927875,99.43249893188477,3.1087498664855957,0.04162565783770822,94.85399894714355,103.9097490310669,0.7509702252995427,-0.06568254764100805,0.9412692098991084,0.9691734812911916,0.9899207592961773,-0.012690869203591082,34.679700140843394,107.88560215198937,99.59424982070922,91.30289748942907,94.91285732814244,1.3241797354282108,97.08428559984479,2.5337019140681356,95.56365671215218,97.68482645253688,-5.979442399949935,-8.237533883824382,43959300,2.6802134458100095,0.6145449418657929,-2542118300.0,-81.54585561645152,77.07053933241427,82.84087432937385,-106.08234201654732,21.2447533668029,25.558565488952794,0.14698809331920484,3.276415592055632,100.22739852905275,98.71629875183106,97.49499893188477,96.27369911193848,94.7625993347168,0.14,0.0,123.43240595840022,-0.003700554740380224,-0.03055549058185766,94.98285784040179,97.09500067574638,4.687595291278461
2023-03-01,0,93.07749938964844,93.37249946594238,111.51000022888184,95.63375091552734,101.25562572479248,0.9149053398721037,4.327770692316577,0.9752662639362928,2.9947931255172042,99.07999897003174,3.3167873191833492,0.043604028628972134,93.96549987792969,103.9097490310669,0.7660393529376034,-0.08268505191862904,0.937793205010799,0.9670213744837981,0.9853798133992185,-0.027149221047200633,32.453306119937814,107.90716625493346,99.25162487030029,90.59608348566712,94.33142852783203,1.0431684220260455,96.52660696847099,2.4916818188332117,95.12715432275483,97.30197798165432,-5.329595085998796,-7.130297102530695,52299500,2.6411239306306076,0.7384841092020871,-2594417800.0,-94.30812863500492,77.07053933241427,82.84087432937385,-114.81806851764834,19.807768321527718,26.741141796117297,0.08778408690140412,3.2631004759993885,99.375158203125,97.88741784667968,96.68499755859375,95.48257727050782,93.9948369140625,0.16,0.0,123.36374894962798,-0.037791029460103265,-0.025481112449270846,94.26428658621651,96.5321431841169,4.8670245098604195
2023-03-02,0,91.54000091552734,93.07749938964844,111.51000022888184,95.36999988555908,100.89937543869019,0.990497567879909,4.471531688403512,1.0019792137139714,2.994722009180542,98.75874996185303,3.443999671936035,0.04526036489387839,93.7077507019043,103.9097490310669,0.7601406227034342,-0.10321321631081355,0.9265580862520889,0.9570733781089412,0.9744621613494268,-0.041566320844316995,29.134261154077066,107.73881323184855,98.7957498550415,89.85268647823446,93.84428596496582,1.4304711268633046,95.94178567613874,2.639092568170245,94.63067068638907,96.87654483303848,-4.189507255071336,-7.739010577905743,55509400,2.5971123760309416,0.7978579058784839,-2649927200.0,-83.85901613355279,77.07053933241427,82.84087432937385,-123.43892791951058,18.9843133531828,28.340676177765815,0.09230511734730132,3.161450725368367,98.62591845703126,97.05203863525392,95.77999877929688,94.50795892333986,92.9340791015625,0.18,0.0,123.28829377427415,-0.038509731299921746,-0.03820861913694909,93.91428593226841,96.0957145690918,4.85243028272495
2023-03-03,0,93.81000137329102,91.54000091552734,111.51000022888184,94.70999908447266,100.19687414169312,1.0601370550197988,4.583078431655334,1.3291960582282671,2.9946591789840995,98.02500057220459,3.526999759674072,0.04667882183539643,93.34299945831299,102.68349971771241,0.6444884235642082,-0.17908707086687037,0.9554583029251243,0.9895256616915676,1.0071394202206494,0.00468555420333594,15.481166195260405,107.3494068137196,98.18324995040894,89.01709308709827,93.57785742623466,1.1853448211362427,95.67428575243268,2.6527602537414956,93.87195639527508,96.20630134621308,-3.591361749513797,-8.20987007001941,55759600,1.7163409748425282,0.8651161592787089,-2594167600.0,-58.16324075201214,77.07053933241427,82.84087432937385,-68.84669674749861,23.94125977724255,26.526977559271714,0.07092472055465604,3.1363474726963942,98.62591845703126,97.05203863525392,95.77999877929688,94.50795892333986,92.9340791015625,0.18,0.0,123.21900488011428,0.01497327835164608,-0.009601316759292442,93.78714316231864,95.90214320591518,3.4493288641950324
2023-03-06,0,94.80750083923338,91.54000091552734,104.98749923706055,93.94500017166138,99.78749895095825,0.29850502291269926,3.5067840707133433,-0.7627337044496065,2.9950847956224154,97.35125064849854,3.016499710083008,0.03604159448333724,93.34299945831299,101.09100093841553,0.7746244682720248,-0.10646503578993602,0.9744008842070572,1.0055763765524905,1.016893254752759,0.008697745186785566,32.36969289364173,104.31181814905608,97.29825000762939,90.2846818662027,93.4775003705706,1.0114840922234207,95.41089289528983,2.5314392661082143,93.83653698917286,95.66599928711828,-1.949307289062046,-3.8388590232889115,52112400,1.3177832246667918,0.8708595343697939,-2542055200.0,-68.83115963979066,77.07053933241427,82.84087432937385,-50.9201193048649,26.091777733610183,24.816637253608555,0.12026214788609217,3.113037309501262,98.62591845703126,97.05203863525392,95.77999877929688,94.50795892333986,92.9340791015625,0.02,1.0,123.15568448383344,-0.0001066780717000615,0.00267379679144385,93.49142892020089,95.48857171194894,3.2210646910595164
2023-03-07,1,93.86999893188477,91.54000091552734,102.42749977111816,93.94500017166138,99.2849988937378,0.13351678858927926,3.0647051221181667,-1.201757274180685,2.9952315353271204,96.41125106811523,2.7414998054504403,0.031663693223576546,93.34299945831299,100.89075031280518,0.8144016154571029,-0.07439407335834841,0.9698390972839751,0.9981099882786212,1.0050751451570803,0.0013333840901632588,39.51504917284217,102.91866033197437,96.78925008773804,90.65983984350171,93.54857172284808,1.0203163221753968,95.0346429007394,2.3173470783410655,94.0688056707522,95.51966059543341,-0.735524435101005,-3.743844833321913,49100700,1.2764154314401406,0.8436841391275451,-2591155900.0,-70.68641911000785,77.07053933241427,82.84087432937385,-66.16459454026447,24.682879373222736,25.720657934722535,0.11471459349153354,3.055677327289708,98.62591845703126,97.05203863525392,95.77999877929688,94.50795892333986,92.9340791015625,0.02,0.0,123.09445817957422,-0.007216388421424802,-0.0022397512765364733,93.49857221330915,95.04928643362862,3.039356299148049
2023-03-08,1,93.46749877929688,91.54000091552734,100.94250106811523,93.85499954223633,99.0512490272522,0.17718109091801207,2.8365381761831365,-1.3041127074147247,2.9952996683702495,95.59250068664551,2.5627623748779307,0.029436464297397606,93.34299945831299,100.05924892425537,0.8139471444909462,-0.07006466118229028,0.9699685038211133,0.9949728255699781,1.000497730587722,0.004190050143223045,37.62023099053325,102.03445139814265,96.36137504577637,90.68829869341009,93.47392872401646,1.0015808706939093,94.57035718645368,1.8587895915878916,94.01024380321593,95.28224609091377,0.5328115545668195,-5.313327433627297,44899100,1.2576618434482532,0.8243228965047366,-2636055000.0,-65.52734847937325,77.07053933241427,82.84087432937385,-70.80948689599539,23.50535841959556,25.93199788478127,0.05893288616204478,2.9795573656049217,98.21335775756835,96.718318069458,95.5099983215332,94.3016785736084,92.80663888549805,0.02,0.0,123.0379643833251,0.018986655471038283,-0.0032898777135133826,93.52142878941127,94.5321431841169,2.768805660206986
2023-03-09,1,93.57999992370605,91.54000091552734,100.88500022888184,93.79375123977661,98.62687540054321,0.31770302772035813,2.6973412627172153,-1.2152601544337536,2.995338525554062,95.22999954223633,2.4036498641967774,0.02810092722522047,93.34299945831299,99.75149898529052,0.7829086706241075,-0.07352432405963799,0.9749173395075492,0.9985168415196438,1.0008663168131635,0.022285328684464423,36.35046954400059,101.3823074567699,95.98762493133545,90.592942405901,93.45035716465541,0.9960645161601643,94.18160724639893,1.3575926799535631,93.87105546990631,95.0401435165607,-0.555911259808138,-6.502113266183009,56218700,1.2554752827636364,1.0511139831587901,-2579836300.0,-75.36424028439941,77.07053933241427,82.84087432937385,-62.49432051056816,26.06061286209732,23.488229241850107,0.03390320035003436,3.0545888951587177,96.15820172119139,95.05590127563475,94.16500091552734,93.27410055541992,92.17180010986328,0.02,0.0,122.96782375582136,0.001302537177461982,0.0008679812590213131,93.23857116699219,94.11071450369698,2.715282186274605
2023-03-10,1,91.80500030517578,91.54000091552734,99.96749877929688,93.70375061035156,97.79000043869019,0.4204461629938981,2.496569843310537,-1.148070229210548,2.995392619251905,94.87874984741211,2.1748499679565447,0.02610863666063158,93.34299945831299,99.19649887084961,0.7892617586883811,-0.06164296854540086,0.9600786467157795,0.9815987028495687,0.9776161557180003,-0.02137299902743728,38.01018414820953,100.61551460269774,95.62237491607667,90.62923522945559,93.26857158115932,1.1754234278339237,93.80000005449567,1.2016895368857,93.79812824640484,94.83552473986695,-0.17601036220620406,-5.49622480859001,69827500,1.2466314155967086,1.2992341165826669,-2649663800.0,-92.8993608691187,77.07053933241427,82.84087432937385,-116.7348575835537,24.049878030818565,26.161248947021225,0.028545627243130523,3.0735468094215643,95.41464163208009,94.42768132019044,93.63000106811523,92.83232081604004,91.84536050415039,0.02,1.0,122.87518834712365,-0.04394097051524459,-0.015195853014447171,93.03285762241909,93.64857210431781,2.8467166760868077
2023-03-13,1,91.13500022888184,91.54000091552734,99.96749877929688,93.55187463760376,97.24937582015991,0.5117176791812579,2.4417127746112133,-0.9032616818677814,2.995404901925261,94.39875030517578,2.070000038146973,0.025641173259477085,92.95024948120117,99.03399906158447,0.8025999946263225,-0.058941109958614124,0.9570365340138445,0.9760708169405476,0.9746433433879309,-0.038736392984127566,33.71628927976621,100.10967553014892,95.22624998092651,90.3428244317041,93.21071434020996,1.2800038642564795,93.52750015258789,1.3448731920843189,93.30603376013032,94.46538025710436,-1.3671393116671724,-5.499370166089281,72397100,1.218443539135835,1.3228536228501055,-2722060900.0,-51.51858431382653,77.07053933241427,82.84087432937385,-108.14881561141706,20.955543228804796,27.440217571456078,0.055363306197070666,3.2754358870790474,94.91196228027344,93.61402236938477,92.56500244140625,91.51598251342774,90.21804260253907,0.04,0.0,122.7797387460831,-0.014079996744791656,-0.02602740970483087,93.07571520124164,93.49500056675502,2.853651596811893
2023-03-14,1,94.12249946594238,91.13500022888184,99.96749877929688,93.44374895095825,96.0431261062622,0.5903633280405086,2.5346957597108735,-0.688078584985691,2.995377402367437,93.92999935150146,2.066299896240236,0.02670764536547939,91.77850036621093,99.03399906158447,0.7797011262209291,-0.07472461086999516,0.991752294932491,1.0111592980692303,1.0145626602726734,0.002689895993722491,30.168036899001542,99.97464149653358,94.90524997711182,89.83585845769007,93.25535692487445,1.3094983645145786,93.41660717555455,1.211578527766283,92.77093708907329,94.0284223536325,-0.4424302846787607,-4.01790276218034,60912700,1.1845915824833722,1.1048613103190397,-2661148200.0,-19.810269725785304,77.07053933241427,82.84087432937385,-17.10537377903728,22.0541047566332,25.838247406546014,0.05822701507191333,3.2300475658318875,94.56052297973632,93.32974293518066,92.33500289916992,91.34026286315917,90.10948281860351,0.04,0.0,122.70676934636012,0.014216933813720134,0.012053304036458181,93.07285744803292,93.43000030517578,2.642719852958462
2023-03-15,1,94.78999900817871,91.13500022888184,99.96749877929688,93.44374895095825,95.55125045776367,0.7999197151971104,2.4006676215543394,-0.13476739327124632,2.995412941638891,93.92999935150146,1.8724499511718755,0.025353819759396334,91.77850036621093,99.03399906158447,0.747736791921555,-0.05058630132432092,1.001091749756963,1.0179174411134542,1.0212018624149217,0.014149305867322104,45.69327455172224,99.48796015155595,94.68662490844727,89.88528966533859,93.2528566632952,1.3060530638664318,93.3651785169329,1.1283028381494409,93.11212399901225,93.97832618217048,0.33311809836551143,-1.6226826860691583,70731800,1.3898423129093662,1.2662792317230234,-2590416400.0,-5.49709324374366,77.07053933241427,82.84087432937385,33.728865910333674,23.82212435251328,23.797966802567707,0.09004689020318946,3.2564726307108334,94.6521992492676,93.40389991760254,92.39500045776367,91.38610099792481,90.13780166625978,0.02,1.0,122.62573794530039,0.024275967033086543,0.02832703164123104,93.42285701206752,93.45714296613421,2.4011282403084504
2023-03-16,0,98.09749984741211,91.13500022888184,99.96749877929688,93.44374895095825,95.08999919891357,0.9490928035891335,2.1739304283780454,0.7019019329061287,2.9954693396346244,93.92999935150146,1.6115999603271483,0.023012042863781525,91.77850036621093,97.33500080108642,0.639674538107317,-0.05179183068837986,1.0384066766123226,1.0515018570197479,1.053831651985356,0.0482742031137966,47.74633382475156,98.81711077283276,94.46924991607666,90.12138905932056,93.85678536551339,2.264628059748368,93.70267854418073,1.6950152858537344,93.53561664139254,94.0141733247082,-0.018460386467049086,-0.7538490409147749,84446900,1.3835700258278514,1.4639965417554683,-2505969500.0,-7.3814864698237646,77.07053933241427,82.84087432937385,193.44915036265292,30.189985046568786,21.11463242534335,0.09328254837373869,3.4081529609102987,97.95267901611327,96.0736597290039,94.55500030517578,93.03634088134766,91.15732159423828,0.04,0.0,122.54217179059098,0.08444445436886006,0.06516187037794893,94.3499995640346,93.92428588867188,2.24709592403598
2023-03-17,0,99.21500015258789,91.13500022888184,99.02249908447266,93.44374895095825,95.08999919891357,0.6468430029567676,1.9656815910852632,0.1672274009662762,2.995516290779199,93.92999935150146,1.4994000244140628,0.02082824869440392,91.77850036621093,97.24250087738037,0.4612174806027592,-0.009341303699793137,1.0512764156541303,1.0560573110753042,1.0555910245153048,0.08071455610021228,60.44022455867893,98.30711315165296,94.37574996948243,90.4443867873119,94.67785699026925,3.0169259426707096,94.07589285714286,2.2481289613652353,94.67083115172903,94.45041872289259,4.503569791872439,5.060376886658336,87300200,1.5858490585593317,1.473906304514254,-2418669300.0,-15.850828978194064,77.07053933241427,82.84087432937385,199.04398549892784,28.15638709167177,19.69235039200195,0.1314571192374796,3.393285219247345,97.95267901611327,96.0736597290039,94.55500030517578,93.03634088134766,91.15732159423828,0.04,0.0,122.45691774501519,0.09059840501681671,0.07262869320587753,95.06857081821987,94.29499980381557,2.3213984389350504
2023-03-20,1,97.57500076293945,91.13500022888184,99.21500015258789,93.44374895095825,95.08999919891357,0.692672016598613,1.9887470240655591,0.2719941341798817,2.995511317675895,93.92999935150146,1.510950088500976,0.021070499784349998,91.77850036621093,97.24250087738037,0.5163460893869805,0.021282062221452937,1.03379364376396,1.0326598971619156,1.022027411471979,0.07066440465116397,65.53841548610016,98.3628690710193,94.38537502288818,90.40788097475706,95.24857139587402,3.149581989008527,94.34946428026471,2.430409554427565,95.80037621505427,94.97691793168492,6.149197794264814,5.559102451530484,62388900,1.5447137860784579,1.0512301328071305,-2481058200.0,-25.48562566986931,77.07053933241427,82.84087432937385,121.70396592959682,26.224313056958415,22.057081631759907,0.13675213628836552,3.383050560729323,97.95267901611327,96.0736597290039,94.55500030517578,93.03634088134766,91.15732159423828,0.04,0.0,122.3919073829117,0.05712429689347531,0.07693150522743424,95.84857068743024,94.54357092721122,2.3547292717556187
2023-03-21,0,99.39999961853027,91.13500022888184,99.21500015258789,93.44374895095825,95.08999919891357,0.6978956175811497,2.0203654274068836,0.17765487872333807,2.9955043651478737,93.92999935150146,1.536600074768065,0.021400645898327957,91.77850036621093,97.62725067138672,0.6707692870370489,0.02764614996300306,1.0528908113718658,1.0489021602278765,1.027283999331143,0.056070548301764056,60.45146303846388,98.44748086625786,94.40675001144409,90.36601915663032,96.3335712977818,3.072859720035887,94.80107143947056,2.74316358610823,96.241119965287,95.29590104057833,4.269075488876303,4.085551111439272,58597300,1.5054211992837236,0.9856682116522285,-2422460900.0,-2.9525827318339837,77.07053933241427,82.84087432937385,183.35838688446788,29.506492844135348,20.587223238371617,0.2030721574485871,3.365689762794415,97.95267901611327,96.0736597290039,94.55500030517578,93.03634088134766,91.15732159423828,0.04,0.0,122.33726199984825,0.06039211132805122,0.08849940796459921,97.25999886648995,95.14642824445453,2.715259427646217
2023-03-22,0,99.96499824523926,91.13500022888184,99.39999961853027,93.44374895095825,95.55125045776367,0.69937917391293,2.29439345141272,-0.29584409808812406,2.9954399209628333,93.92999935150146,1.803600120544433,0.024246133729373617,91.77850036621093,98.2092498779297,0.6671843721673675,0.038933874361795774,1.0563858235466514,1.0487443283223012,1.0219750281907476,0.05459435901686249,64.84343586275608,99.21803695241651,94.62925004959106,90.04046314676562,97.59499958583287,2.297771108021863,95.40285696302142,2.8927737772991295,97.03584587481058,95.87821507122545,8.27296910637481,6.7927267818123065,57475400,1.5474415014588705,0.9684735614876594,-2364985500.0,-24.32047614421842,77.07053933241427,82.84087432937385,154.49167976313038,29.972634987577358,19.066407501177718,0.16271825775151785,3.3745689128643317,98.80071948242187,96.75964010620118,95.11000061035156,93.46036111450195,91.41928173828126,0.06,0.0,122.28387979644296,0.025987526811929618,0.04026138074837092,98.15571267264231,95.61571393694196,2.842371068959798
2023-03-23,0,99.45499992370605,91.13500022888184,99.96499824523926,93.44374895095825,96.02625036239624,0.6942522994426874,2.566527185678194,-0.6142732357125165,2.9953683241572815,93.92999935150146,2.069999942779544,0.027060583204047625,91.77850036621093,99.23350009918212,0.7222194859059922,0.046644309555872544,1.0486194401181965,1.036329630834245,1.006115297343401,0.013838273945875335,66.4153427074112,99.97680427598898,94.84374990463257,89.71069553327617,98.35678536551339,1.7803386168808504,95.80607114519391,3.04318092457931,97.7620079813052,96.34251060553777,9.688920825348376,9.203623820679725,57559300,1.5470624638795971,0.9625140852589493,-2422544800.0,-24.248930083508604,77.07053933241427,82.84087432937385,113.92144878401692,27.79324296028431,19.772640302116773,0.12124278236804834,3.379242191374989,98.80071948242187,96.75964010620118,95.11000061035156,93.46036111450195,91.41928173828126,0.06,0.0,122.22907889248877,-0.01329470030870683,0.026091499125315908,98.70285579136441,95.88785661969867,2.9567942518881916
2023-03-24,1,97.72500038146973,91.13500022888184,99.96499824523926,93.44374895095825,97.70562553405762,0.5800104443258738,2.7548395780039483,-1.0072646618934942,2.9953144239835843,93.92999935150146,2.346149921417237,0.028985801719368882,91.77850036621093,99.40549964904785,0.7875988194941882,0.06514231162872816,1.0282404488086203,1.01210697034432,0.9859062633644724,-0.0150178881099291,66.47980006631174,100.55067904538168,95.04099988937378,89.53132073336587,98.77607127598354,0.9543074424860252,96.01446396963937,3.0693210550213688,98.17556851703526,96.6581189968166,5.66548964171229,6.0174805114353696,56095400,1.4557184980015967,0.9387868323094669,-2478640200.0,-28.397728426215973,77.07053933241427,82.84087432937385,62.91820255768261,26.404788794918286,21.423270280032117,0.1457143752247045,3.3028675747457887,98.80071948242187,96.75964010620118,95.11000061035156,93.46036111450195,91.41928173828126,0.06,0.0,122.17242276573359,-0.008287010814696294,-0.019092399486503153,98.97857012067523,96.20071356637138,3.0012321584355806
2023-03-27,0,98.38249969482422,91.13500022888184,99.96499824523926,93.55187463760376,97.81812524795532,0.3812924793200702,2.7861763563918265,-1.2145582273592446,2.9953060170837262,94.05624961853027,2.4622124385833764,0.02924854687214507,91.77850036621093,99.40549964904785,0.8308775029927796,0.03973827661928857,1.0327936159250748,1.0127074148139015,0.9955324608141027,0.008275674358912966,57.840435499479845,100.83097764793379,95.25862493515015,89.68627222236651,98.81678553989956,0.9261976045031683,96.33678545270648,3.06373200730637,98.0622837710371,96.67600851386376,3.096319658192819,3.0772876791506123,46721300,1.5232890378864095,0.7823965670626406,-2431918900.0,-29.041479251642393,77.07053933241427,82.84087432937385,68.7254349614802,27.385481833738204,20.352044740041727,0.1496147615478143,3.2283766413218746,98.80071948242187,96.75964010620118,95.11000061035156,93.46036111450195,91.41928173828126,0.06,0.0,122.1264725374178,0.003377359882783315,-0.0091965241109694,98.69285583496094,96.52142769949776,3.0315150850416988
2023-03-28,1,97.52000045776367,91.13500022888184,99.96499824523926,93.55187463760376,98.16874980926514,0.19488975918556226,2.8499127592495035,-1.3945274581796623,2.9952875556595555,94.45624923706055,2.598899917602541,0.029848816471804405,91.77850036621093,99.40549964904785,0.8256799929948246,0.049469292379055285,1.0213844569616282,0.9963958379286957,0.9851948101356695,-0.018913472514904606,60.149983866790464,101.17807544983447,95.47824993133545,89.77842441283644,98.57464272635323,1.0214121508930396,96.62624985831124,2.9615229490160466,98.1410459563847,96.75024306017745,0.2905271264358608,4.807181010211661,38720100,1.5228499647044575,0.6512651490871084,-2470639000.0,-34.76396348804247,77.07053933241427,82.84087432937385,42.24840185425001,26.05093290838755,21.150867149819017,0.12873370342533616,3.1513498473599495,98.80071948242187,96.75964010620118,95.11000061035156,93.46036111450195,91.41928173828126,0.06,0.0,122.08721063699237,-0.03349570347021058,-0.004810165030262786,98.44857025146484,96.75857053484235,3.034557645998091
2023-03-29,0,99.47999954223633,91.13500022888184,99.96499824523926,93.55187463760376,98.16874980926514,0.02488546705746077,2.85387557890638,-1.429977841948527,2.995287325193758,94.79874992370605,2.633199987411499,0.029831348129697014,91.77850036621093,99.40549964904785,0.8292374247383009,0.04772905479032782,1.039857000151268,1.0129056865005244,1.0088277478734367,-0.004851685204986467,56.97291502485248,101.37475107007472,95.66699991226196,89.95924875444919,98.84678540910993,0.9627782820699401,97.04767840249198,2.9141017438107375,97.98459459559645,96.771103137416,-1.708410716340665,4.335733523837945,49783300,1.5296009704853784,0.8391218593694311,-2420855700.0,-13.233183401313916,77.07053933241427,82.84087432937385,93.45740731979859,28.659403877614555,19.62734508459096,0.19082354436000729,3.153396308632553,98.80071948242187,96.75964010620118,95.11000061035156,93.46036111450195,91.41928173828126,0.06,0.0,122.0418282366347,0.01570418540712426,-0.0035781791886255365,98.81142752511161,97.32999910627093,3.0702238819704735
2023-03-30,0,101.9000015258789,91.13500022888184,99.96499824523926,93.75250101089478,98.59062480926514,-0.15980076203698237,2.9041002841580648,-1.421413686379719,2.995273739107927,96.16375064849854,2.694374942779542,0.030255102302332318,91.77850036621093,99.45749988555909,0.7659790815058648,0.08673802214658022,1.0616007262528417,1.03261504605916,1.0343865146644222,0.024583998834130538,64.59461706149482,101.79532548820747,95.98712491989136,90.17892435157525,99.20392853873116,1.5102359810912704,97.76874991825649,2.7620505883306645,98.36389939848327,97.03830199541828,1.9523430841933684,6.304765573135742,53633400,1.5157461665007463,0.9054487321524755,-2367222300.0,-6.970516375075809,77.07053933241427,82.84087432937385,136.23576111886067,32.81708421244019,18.376657173674886,0.1482479259340905,3.1274394948388267,99.51888134765625,97.34056161499024,95.58000183105469,93.81944204711914,91.64112231445313,0.08,0.0,121.99810550563515,0.033329966022103585,0.03343468240924368,99.00999886648995,98.13499886648995,3.180301388781366
2023-03-31,0,102.72249984741211,91.13500022888184,101.9000015258789,93.85499954223633,99.26125001907349,-0.11957515361981604,2.9874293834671564,-1.1668779135146896,2.9952523990968545,97.54750061035156,2.71586256980896,0.03095617341568446,93.30124893188477,99.52849941253662,0.7645806185789435,0.08623814128725964,1.0644253338897607,1.0369542211374903,1.037585284212198,0.05113839290288702,69.07067311166402,102.47998371734323,96.50512495040894,90.53026618347465,99.59785733904157,2.0165868015703317,98.59642846243722,2.3224371066559804,99.25922235506295,97.64977310950044,2.5150924717735905,10.996134401334988,56750300,1.52573012715496,0.9572682760946157,-2310472000.0,-1.8552594702169194,77.07053933241427,82.84087432937385,141.70192471164037,32.68582648317138,17.705987210164682,0.1381778962857644,3.0140510248859864,100.94591815185545,99.37203833007811,98.0999984741211,96.82795861816406,95.25407879638672,0.1,0.0,121.9541083315973,0.05258334664764974,0.04639856016142071,99.66571371895925,98.91071319580078,3.47690071267217
2023-04-03,0,102.35750198364258,91.13500022888184,102.72249984741211,94.05937433242798,99.41374969482422,-0.12244377222027367,3.208700005340534,-0.9907219541133743,2.9951836533499763,97.65000057220459,2.8028501510620125,0.03309618553241566,93.30124893188477,100.15849857330322,0.7929682197770986,0.08348494515850932,1.055768027751698,1.029624061195952,1.0235647820020355,0.04040355043985011,70.32409841952958,103.36814988479605,96.95074987411499,90.53334986343393,100.01250049046108,2.26537199637757,99.18464292798724,2.137647327326284,100.12068693383063,98.26805222602992,2.758467114067273,12.714653634090899,41135700,1.5227763724888492,0.700363864631767,-2351607700.0,-10.364629476412452,77.07053933241427,82.84087432937385,117.58168537196629,31.204546971014597,18.170540810289275,0.18539856064102872,2.9316188524178797,101.03087829589843,99.50955856323242,98.27999877929688,97.05043899536132,95.5291192626953,0.1,0.0,121.9214537922209,0.04457367100952281,0.043615678472286354,100.19428580147878,99.44857079642159,3.5795377361264125
2023-04-04,0,103.25249862670898,91.13500022888184,102.72249984741211,94.05937433242798,99.46124982833862,-0.2238022709024871,3.3741994648344216,-1.0104713417880693,2.995129534086804,97.91125011444092,2.852775287628174,0.03466824346697799,93.30124893188477,101.94575157165528,0.8158522493919367,0.09041763234616239,1.060868747763913,1.0336542522759162,1.024370986338346,0.05878279472966241,69.61162075618782,104.07664886100432,97.32824993133545,90.57985100166658,100.80214309692383,2.298247330195128,99.78910718645368,1.9908105325634866,100.67071657262258,98.79319901931011,2.918407382397156,8.749239092062124,48662500,1.5011957789732795,0.8288220405602896,-2302945200.0,-2.9103621255022567,77.07053933241427,82.84087432937385,128.43504444235865,31.845878973039312,17.225879617175554,0.23093259890342924,2.871502958522154,102.17275781250001,100.91861834716798,99.90499877929688,98.89137921142579,97.63723974609375,0.12000000000000001,0.0,121.88501927722774,0.06900451698768251,0.06028147671894653,101.02571432931083,100.00214222499302,3.7275582227682
2023-04-05,0,102.41750144958496,91.13500022888184,103.25249862670898,94.62312412261963,99.60124921798706,-0.31392735751651357,3.510271344020591,-0.8826076553565017,2.995085392210316,98.23999977111816,2.8456374931335446,0.03589330845570116,93.30124893188477,102.39400177001953,0.8057238649995668,0.10468879530538475,1.0472418256366594,1.0213560715047267,1.0046595006301318,0.029528567761014646,72.18526098121735,104.81791760411785,97.79737491607666,90.77683222803547,101.37857191903251,2.0864827601323834,100.09767872946603,2.0425688378969227,101.30173591297128,99.39056202856959,5.656176232962556,8.927629187758624,45175400,1.4904853088733683,0.7692485831818121,-2348120600.0,-36.47057028377774,77.07053933241427,82.84087432937385,86.75290468244931,29.331497436197143,19.221394690672547,0.17231360028606987,2.8949668149310632,102.1939969482422,100.9529969482422,99.9499969482422,98.9469969482422,97.7059969482422,0.12000000000000001,0.0,121.84858659323957,0.00847878777178157,0.03969560566794055,101.46285683768136,100.07785633632115,3.6567828853910878
2023-04-06,0,101.24749946594238,91.13500022888184,103.25249862670898,96.83750009536743,100.44874906539917,-0.4926400532063133,3.500233653693041,-0.6699262874803908,2.9950935756507757,98.79874992370605,2.785387506484986,0.035627646245427344,93.40249996185302,102.44800128936768,0.8222582377448118,0.0944379304668086,1.030562656981707,1.0072248317658126,0.9874914540903718,-0.006403356723903575,67.52332219934657,105.24534235697713,98.24487504959106,91.24440774220498,101.91107177734375,1.2425897299931827,100.24285725184849,2.047231300242694,101.56835958165126,99.84996321148161,4.101340957260734,4.403783591725062,43808000,1.5187013069709336,0.7539308463608613,-2391928600.0,-25.176463407628674,77.07053933241427,82.84087432937385,69.23652125177344,27.44971412061728,20.350553005924763,0.2491945818861762,2.8724687711257006,102.1939969482422,100.9529969482422,99.9499969482422,98.9469969482422,97.7059969482422,0.12000000000000001,0.0,121.8124884334178,0.0005882113587623028,0.01805483848971336,102.15142822265626,100.29999923706055,3.4427898116172053
2023-04-10,1,101.2249984741211,91.13500022888184,103.25249862670898,97.56125068664551,101.41062498092651,-0.7195561879717272,3.3863540762371955,-0.24069024805251082,2.995137659944418,99.30749988555908,2.650175008773803,0.034334524594326316,93.89074954986572,102.44800128936768,0.7829308313671912,0.10285386557788892,1.0263286476918647,1.0052084962341292,0.9885301998800108,-0.014578124320528185,63.67001774685603,105.40095817917728,98.62825002670289,91.85554187422849,102.16035733904157,0.7516378503745832,100.50357137407575,1.9090989647290784,101.4844961131605,100.05364498094453,3.8222918280164557,2.048580668476144,37261200,1.477174206693066,0.6597493776759403,-2429189800.0,-25.663714253471525,77.07053933241427,82.84087432937385,62.04574206763363,25.64363716950053,19.586981177625216,0.3325572214896242,2.8551493770035083,102.3332378845215,101.17837846374512,100.24499893188477,99.31161940002443,98.15675997924805,0.12000000000000001,0.0,121.78173508532002,-0.010843283344512455,0.0016666487151502619,102.42571367536274,100.61857060023716,2.9312804609661125
2023-04-11,1,100.1825008392334,91.13500022888184,103.25249862670898,97.68750047683716,101.41062498092651,-0.8653871115524607,3.0421819969774,0.3890963152042102,2.9952566469179867,99.42749977111816,2.3446499633789073,0.030698335244395723,94.72324905395507,102.44800128936768,0.692996301650259,0.11071485400667844,1.0109309697580167,0.9914102427334783,0.9812194009719236,-0.02124906433098339,64.43091927545005,105.18361392910495,99.09924993515014,93.01488594119533,101.91500009809222,1.065558281158808,100.55946431841168,1.8856144583952557,101.42074168844542,100.24122345095661,1.7541203658167384,3.7407098976605577,60417800,1.4571924932261555,1.0812285042756342,-2489607600.0,-54.108734841272735,77.07053933241427,82.84087432937385,13.593475593467868,23.63172176882667,19.440618835866662,0.3016385096470177,2.876924138125995,102.3332378845215,101.17837846374512,100.24499893188477,99.31161940002443,98.15675997924805,0.02,1.0,121.72882155221633,-0.02431408460231632,-0.03262661164402616,102.12857055664064,100.56928471156529,2.4223583756091984
2023-04-12,1,99.11250114440918,94.12249946594238,103.25249862670898,98.00437498092651,101.41062498092651,-0.4972130082701562,2.43668547239231,-0.30875907437086525,2.995431424299354,99.46749973297119,1.9305375766754154,0.024476601695177225,97.24700031280517,102.44800128936768,0.7147835988572724,0.06438419514649404,0.9955889838924278,0.9790774611187922,0.9748930444847734,-0.04009585760502732,56.18497509615202,104.42499591045235,99.55162496566773,94.6782540208831,101.39928599766323,1.4231832869692427,100.4985716683524,1.919744498651777,101.11958136883324,100.304236146107,-1.6854766054241175,0.7872245711329461,56735000,1.3751925448255553,1.0191313232486605,-2546342600.0,-80.5309521122633,77.07053933241427,82.84087432937385,-44.27442575988018,21.98573009367653,21.32038205574185,0.2102819340507083,2.8714297748139246,102.3332378845215,101.17837846374512,100.24499893188477,99.31161940002443,98.15675997924805,0.04,0.0,121.67642619142781,-0.05887441363018742,-0.04472221137854772,101.34857068743027,100.50714220319476,2.183933290308579
2023-04-13,1,100.65749931335449,94.78999900817871,103.25249862670898,98.31124973297119,101.41062498092651,-0.27132778891847553,2.1002516757335106,-0.3123970610700866,2.9955103748189273,99.46749973297119,1.7059875011444092,0.02104436873522115,97.56950073242187,102.44800128936768,0.6364267826341765,0.04560082478593035,1.0085808077147216,0.9927778599467039,0.9982198899132779,-0.01718458379983845,50.282742808346974,104.00162840105808,99.80112504959106,95.60062169812404,101.15642847333636,1.3767059223152949,100.58446448189872,1.8962184265533517,100.62486212884517,100.1820936127672,-3.51432131068204,-0.8527955942525889,67925100,1.4063901548632984,1.223222739213528,-2478417500.0,-22.75595859869861,77.07053933241427,82.84087432937385,47.51244212444422,24.40528954253589,18.91814852321829,0.21952874463322042,3.0048989240263535,102.3332378845215,101.17837846374512,100.24499893188477,99.31161940002443,98.15675997924805,0.04,0.0,121.62091330191546,0.012858586264870908,-0.014910971311861169,101.3471418108259,100.77071380615234,2.0576880267931417
2023-04-14,1,102.22249984741211,97.52000045776367,103.25249862670898,98.93000078201294,101.41062498092651,0.19190961440894835,1.7624096673813074,-1.1397394312091091,2.9955774220275098,99.7224988937378,1.5112000942230224,0.017607457614948537,97.7100004196167,102.44800128936768,0.7237961449704773,0.026096480235728633,1.021259907199532,1.0070438103440869,1.01729113800705,0.009629871222624153,53.51501752561313,103.61931939961248,100.09450006484985,96.56968073008723,101.00928579057965,1.1520529850641026,100.90571444375175,1.749839103829241,100.64673488171373,100.27178909459889,-1.660848142386044,1.2090889252133117,51450500,1.2495606212386619,0.9549125131391993,-2426967000.0,-21.36530543153359,77.07053933241427,82.84087432937385,81.24472167942142,24.696703551877427,17.957387325785792,0.19178043314988796,2.939548739301777,102.3332378845215,101.17837846374512,100.24499893188477,99.31161940002443,98.15675997924805,0.04,0.0,121.5812124782154,0.004409216033719465,0.013946623970229955,101.14142826625279,101.0835712977818,2.1161038952498665
2023-04-17,1,102.80500030517578,97.52000045776367,103.25249862670898,99.18937540054321,101.9806261062622,0.0017506966078830108,1.7580009765315894,-1.1805142077122293,2.9955786577429784,100.07374954223633,1.5295749950408932,0.017527296409996403,97.7100004196167,102.44800128936768,0.7081122240203134,0.030312953587651355,1.0249674128927928,1.012460639353138,1.0211064797683753,0.015608810618640057,58.60216406560884,103.81675201791303,100.30075006484985,96.78474811178667,101.06464276994977,1.237162411318681,101.22160734449115,1.6559639797421168,101.04398092864638,100.51413666073158,-0.9975533696483725,4.602199486709015,39919500,1.2718805718671962,0.7749738549821716,-2387047500.0,-18.457646229331743,77.07053933241427,82.84087432937385,87.47997486324284,24.700408795467432,17.00509508708921,0.20932372020849876,2.8824386164256635,102.3332378845215,101.17837846374512,100.24499893188477,99.31161940002443,98.15675997924805,0.02,1.0,121.55117842496655,0.005578934178717132,0.006662750553029919,101.37571389334542,101.41928536551339,2.1489590935874654
2023-04-18,1,102.99249839782715,97.52000045776367,103.25249862670898,99.328125,102.25625038146973,-0.15440270010197293,1.8201560373926322,-1.2413086124237502,2.995568036001736,100.42000007629395,1.6005000114440917,0.018114565161608396,97.7100004196167,102.73074989318847,0.6777313796675148,0.05359978991896422,1.025002409165341,1.0142247828692506,1.0197680908370534,0.028048786315516994,62.87685734370411,104.1205621472645,100.48025007247925,96.83993799769401,101.3139283316476,1.4394219154259342,101.61250005449567,1.3284988392709594,101.48618513841998,100.81613965130911,0.37835218600950415,4.495210656437737,39790500,1.2013602336679046,0.7897941380504696,-2347257000.0,-29.27572452821797,77.07053933241427,82.84087432937385,79.88960925442525,24.22227853272723,15.87005827939532,0.16989770099563367,2.8679787370505587,102.66835745239258,101.72081776428223,100.95499801635742,100.18917826843263,99.24163858032227,0.04,0.0,121.52131520346721,0.023819104547903924,0.0012724369691922604,101.41000039236886,101.78071430751255,2.0689757436644336
2023-04-19,1,103.09750175476074,97.52000045776367,103.25249862670898,99.44124984741211,102.37250185012817,-0.26652900505936256,1.7700679941116408,-1.171518568532295,2.9955776881301635,100.9412488937378,1.5631250381469726,0.017568716924162116,98.31674976348877,102.82375011444091,0.7413496532991306,0.03614183896462669,1.023288839718695,1.0146243483415547,1.0151588447599595,0.04020684136045882,61.92383583641292,104.29126094244691,100.75112495422363,97.21098896600034,101.5814288003104,1.5866076407744085,101.87089306967599,1.2299704020255056,101.86385161861023,101.16130780837481,1.723498299799244,5.611667262484929,58398900,1.1444823451433006,1.15937704545062,-2288858100.0,-11.066117268163666,77.07053933241427,82.84087432937385,106.2641481719115,24.262543090903453,14.426751974997954,0.15404287024873178,2.9295519241855126,103.37124188232423,102.28938134765626,101.41500091552734,100.54062048339844,99.45875994873047,0.06,0.0,121.47981106604496,0.06613514361245088,0.04383511772494965,101.71428680419922,102.07000023978097,2.2092250382748757
2023-04-20,0,103.94999885559082,97.52000045776367,103.25249862670898,99.47374963760376,102.49375104904175,-0.42634230760002545,1.8118937936664912,-1.0980109902764252,2.9955707281731594,101.23624897003174,1.5944001007080075,0.01795091733941165,98.31674976348877,103.00299873352051,0.7648999133376311,0.031336003246222904,1.0298604937062408,1.0231701912881472,1.0155830094580005,0.0327099278712113,61.78835653491663,104.55978764836814,100.93600006103516,97.31221247370217,102.11964280264718,1.6697977579580237,102.01732145036969,1.349883449258042,102.16261488092294,101.4612923959158,1.8498427353578746,3.636411569331107,57696900,1.1411345544530813,1.1451886442391486,-2231161200.0,-19.098173296515082,77.07053933241427,82.84087432937385,114.37189874129655,23.35296964967819,13.693264331820561,0.18452935290152622,2.8660125664237834,103.47055978393554,102.36971965026855,101.47999954223633,100.5902794342041,99.48943930053711,0.08,0.0,121.44010541695667,0.01376949230179969,0.061126399014753266,102.27000100272042,102.19928577968052,2.2243597469184775
2023-04-21,0,106.57250022888184,97.52000045776367,103.94999885559082,99.47374963760376,102.74312496185303,-0.4747714493468781,1.910582569592609,-1.022579836516036,2.9955532770668953,101.57375049591064,1.6566999435424805,0.018891361497233194,98.31674976348877,103.11300144195556,0.7502227777888607,0.04519630923868051,1.0537621663307999,1.0474033017117468,1.0345488737158473,0.042554235984866295,66.0767407018037,104.95641523073796,101.13525009155273,97.31408495236751,103.18535695757184,1.8057389531021715,102.29232147761753,1.816209835561923,102.59792163821652,101.84907044968814,3.7606348262390323,2.011773600603224,86774200,1.1392808442184599,1.6737962395899137,-2144387000.0,-11.3984881525177,77.07053933241427,82.84087432937385,192.14487767675297,27.887981256352806,12.264623953196171,0.21847303760058942,2.971297666485973,105.68616094970703,104.16192059326171,102.93000030517578,101.69808001708985,100.17383966064453,0.1,0.0,121.38976433884332,0.04341036831048317,0.04453122549457512,103.57428632463727,102.46142850603376,2.477531799756901
2023-04-24,0,107.04250144958496,97.52000045776367,106.57250022888184,100.00687551498413,102.85187482833862,-0.025307489596486682,2.204699786867246,-0.19265946633447806,2.9954962324082053,102.06125068664551,1.788762664794922,0.021723079575154684,98.31674976348877,103.32224864959717,0.6419582313096355,0.09053466168202483,1.0546981456450606,1.0465454642437635,1.030409078861626,0.041218823324062015,76.78235078885204,105.90052468054601,101.49112510681152,97.08172553307703,104.09750011989048,1.9247347143345952,102.62696429661342,2.2166189778359477,103.58502667109995,102.50627893452942,7.52679934249996,3.747962118512169,69575600,1.1582515138252694,1.3248265886928288,-2074811400.0,-26.215305142554392,77.07053933241427,82.84087432937385,180.67220088623372,27.700682666229078,11.072181584932068,0.1418833213563587,3.0562052376024273,106.51128234863282,104.82936172485351,103.47000122070312,102.11064071655274,100.42872009277343,0.12000000000000001,0.0,121.34994092619002,0.033774589184869086,0.036094009083377725,104.11857169015067,102.73285675048828,2.5280810959133944
2023-04-25,0,103.84499931335449,97.52000045776367,107.04250144958496,100.53874969482422,103.01874923706055,0.24977249932220943,2.3399499519093023,0.02253825325415404,2.9954693479763312,102.29000091552734,1.7905500984191889,0.022950360919135104,99.03950099945068,104.21224899291992,0.6893483083821869,0.08802380282696085,1.0185176020299769,1.0095417626047443,0.9915402237846211,0.008277310763298518,77.4691783153237,106.63690006403588,101.95700016021729,97.2771002563987,104.32928575788226,1.7511748858523632,102.66928577423096,2.2350604295231618,104.44891174081764,103.15468956220951,6.343295015062384,4.57709437525261,65026800,1.1573733932478123,1.2170002508794584,-2139838200.0,-57.81251034802477,77.07053933241427,82.84087432937385,50.68943289444331,25.305809801276084,16.13921888527503,0.09004833832330955,3.10647644464756,106.51128234863282,104.82936172485351,103.47000122070312,102.11064071655274,100.42872009277343,0.12000000000000001,0.0,121.30438034597863,0.002639263294350158,-0.0016546444664200918,104.12714276994977,102.63428551810128,2.3438046008060422
2023-04-26,0,105.18500137329102,97.52000045776367,107.04250144958496,101.08312368392944,103.1362509727478,0.15955790624224567,2.2226432200179627,0.23525760823785236,2.995496138976291,102.38750171661377,1.6523625659942625,0.021741568025562673,99.44324970245361,104.21224899291992,0.6777871698136314,0.064858478526466,1.0289041633086877,1.0189407734795424,1.0027025452637994,0.020247819617354335,59.238774307007894,106.67541158117973,102.2301251411438,97.78483870110787,104.66928591047015,1.6329565840239444,102.86696434020996,2.3313876821791233,104.30203388194931,103.27328100200707,1.5872234276840163,0.5738366572489335,73803800,1.3911836162239146,1.3373592175727926,-2066034400.0,-36.89234742872281,77.07053933241427,82.84087432937385,112.91906021470874,25.632404495144307,14.668192279673319,0.07109899938915583,3.173871202298633,106.51128234863282,104.82936172485351,103.47000122070312,102.11064071655274,100.42872009277343,0.12000000000000001,0.0,121.25798397146798,0.006519657576983473,0.02619746065716022,104.4471435546875,102.91142872401646,2.08935793258329
2023-04-27,0,108.91000175476074,99.11250114440918,107.04250144958496,101.24187421798706,103.40062379837036,0.4151915257082308,2.029917051660072,-0.103361307459509,2.995537105194623,102.57000064849854,1.533124828338623,0.019782187731008576,100.1122507095337,105.3237512588501,0.6768444390999623,0.05734822936576823,1.0613626299336774,1.0488554336771796,1.0340964261177545,0.04771527613059856,62.012733652128425,106.67320929024031,102.61337518692017,98.55354108360002,105.51464353288922,2.0884177093686977,103.41428593226841,2.7785105664563163,104.53620497522661,103.59376292300234,2.315063529060086,2.7021748085392976,149961200,1.3595473389418262,2.491251989467916,-1916073200.0,-7.908751291630237,77.07053933241427,82.84087432937385,227.54306593574984,31.429592584516183,12.838571160382658,0.09213716587913638,3.3671659202366344,107.75660025024413,105.83670002746582,104.28499984741211,102.7332996673584,100.81339944458009,0.14,0.0,121.18743138391544,0.057894251782813155,0.05292422321720527,105.52142878941127,103.46571459089007,2.5472920991885917
2023-04-28,0,106.74750137329102,99.11250114440918,108.91000175476074,101.73687601089478,103.87124919891357,0.7803853357532355,2.3215779208345944,0.34963004502514394,2.995480090362386,102.76375007629395,1.7176000976562507,0.022521033411870967,100.60999946594238,106.61950035095215,0.6280549129645964,0.06879293546528113,1.0355301984425236,1.019923621350495,1.004105883172327,0.0016420853788110534,70.01378856655954,107.72803113921556,103.08487529754639,98.44171945587722,106.03607204982212,1.8231420388986852,103.80875042506626,2.8352246808213017,105.63965131916538,104.32818637919506,5.74556734615386,7.568090401477886,130565000,1.4914653657010877,2.038749911288263,-2046638200.0,-41.140707485566416,77.07053933241427,82.84087432937385,108.21306528271138,27.92700740183052,16.421703309493452,0.030034666891527718,3.518796773346788,107.75660025024413,105.83670002746582,104.28499984741211,102.7332996673584,100.81339944458009,0.14,0.0,121.1128289067901,-0.014117447168617847,0.01579808716133307,105.68571363176618,103.7000002179827,2.580735872381727
2023-05-01,1,103.51250076293945,99.11250114440918,108.91000175476074,101.97874975204468,104.25874948501587,0.5522164316927979,2.435471946333395,-0.26075003343262404,2.9954556257887432,102.89874935150146,1.896175231933593,0.023570470901915178,100.60999946594238,106.77700138092041,0.7432574659486488,0.039183251301884166,1.001792852055026,0.9847571372201723,0.9733558360270765,-0.03297756161189924,60.0327469993397,108.19819418258378,103.32725028991699,98.4563063972502,105.9735723223005,1.9119121545677953,104.04660756247384,2.6406074539150826,105.92253193070877,104.59534089768289,3.540337599268478,5.455671012513564,74728100,1.589413501841922,1.1507149188754613,-2121366300.0,-66.9961713788085,77.07053933241427,82.84087432937385,-10.322091960861608,25.873816842985562,20.29799646864814,-0.052500386873430026,3.526739664780477,107.75660025024413,105.83670002746582,104.28499984741211,102.7332996673584,100.81339944458009,0.02,1.0,121.06070489483753,-0.03916764964291419,-0.045904974520775216,105.43428584507534,103.85214342389789,2.5968197914167708
2023-05-02,1,102.53750038146973,99.11250114440918,108.91000175476074,101.97874975204468,104.25874948501587,0.5068144220487734,2.431746919348907,-0.2786296197389202,2.9954565819784995,103.04500007629395,1.883100242614745,0.02352542680747511,100.60999946594238,106.77700138092041,0.7453958938787529,0.011283968022993094,0.9919775948113821,0.9748254262069782,0.9706313848242158,-0.01259087043699969,49.419091271683605,108.23024417439115,103.36675033569335,98.50325649699556,105.3971437726702,2.275025097157762,104.29125036512103,2.2827210038812367,105.32441710961295,104.31012494994057,-0.42087359063769425,3.323933716777374,73469400,1.763861333191158,1.1038523665408753,-2194835700.0,-59.50619299540051,77.07053933241427,82.84087432937385,-16.33079815875883,24.40969158954876,20.528055628095778,-0.008532046605987513,3.4712582601530917,107.99260025024414,106.21870002746581,104.78499984741211,103.3512996673584,101.57739944458008,0.04,0.0,121.009355306708,0.010334382000073417,-0.02429151542504706,104.9585712977818,104.26642881120954,2.5897011881474397
2023-05-03,1,104.15749931335449,99.11250114440918,108.91000175476074,101.97874975204468,104.25874948501587,0.49943925478013185,2.4283257079164615,-0.2715593512258456,2.9954573874788437,103.04500007629395,1.8759003067016606,0.023490283764932337,100.60999946594238,106.77700138092041,0.7454087370792339,-0.006924754894544553,1.007562209278646,0.9906553033606141,0.9884131791331947,-0.009768522569962412,45.98941896399773,108.23240167141765,103.37575025558472,98.51909883975179,104.98500061035156,2.18688963877142,104.54125036512103,2.032038385424877,104.626324002779,103.94719390343886,-3.7861548136210454,3.4556682532612557,65051900,1.7667371241536531,0.9654949170885977,-2129783800.0,-73.94870855869391,77.07053933241427,82.84087432937385,31.084126681316246,27.350341782365604,19.377263181029136,-0.07084626289438556,3.4147398347973725,108.55900061035156,107.13550061035156,105.98500061035156,104.83450061035157,103.41100061035156,0.04,0.0,120.96763387879973,-0.012669096861548601,0.010529412442897623,104.59285736083984,104.35571452549526,2.586837098343737
2023-05-04,1,104.18499946594238,99.11250114440918,108.91000175476074,101.97874975204468,104.41437482833862,0.44181931667301494,2.4340327050773336,-0.3314553895144452,2.995456213570776,103.04500007629395,1.9133501815795895,0.02353518819441006,100.60999946594238,106.77700138092041,0.7349598977046353,0.016989262959378536,1.0073872731252231,0.9899188471783825,0.9906059421668714,-0.04338446618941327,51.538876289409494,108.28906570007165,103.42100028991699,98.55293487976233,105.03357206072126,2.1609720932317527,104.68142890930176,1.924628843304427,104.49929038808628,103.92434903872636,-2.6951931215744724,3.4771378425607735,45345500,1.793270710397467,0.6729292146967782,-2084438300.0,-70.6488286010392,77.07053933241427,82.84087432937385,25.285295424096176,26.126180425928595,18.50996517910728,-0.05606567370859495,3.3194014059583,108.56844082641602,107.15078096008301,106.00500106811523,104.85922117614746,103.44156130981446,0.04,0.0,120.93856424539386,-0.05299580869602305,-0.009335143128178111,104.7971431187221,104.46214294433594,2.5364593052118614
2023-05-05,1,104.81000137329102,99.11250114440918,108.91000175476074,101.97874975204468,104.43499994277954,0.3409282425908947,2.4280731717171333,-0.363713937482808,2.995457813526156,103.3050012588501,1.9013751983642577,0.02345751935264769,100.60999946594238,106.77700138092041,0.7223989108938504,0.029013062203952167,1.0125652983621969,0.9956350209126904,1.0055839228656709,-0.0181503077362406,52.54700622766964,108.36552153416913,103.50937519073486,98.65322884730058,104.98000063214984,2.1612406181102344,104.82464327131,1.8473047314637712,104.41136747196836,103.9007304071802,0.3274111944109441,1.9198313692775109,56912900,1.7686989361483165,0.8364563512108746,-2027525400.0,-53.553011725382625,77.07053933241427,82.84087432937385,46.11944653418009,25.669003476255625,17.60817932121611,-0.041694570817761414,3.2401583829948035,108.56844082641602,107.15078096008301,106.00500106811523,104.85922117614746,103.44156130981446,0.04,0.0,120.90386786648786,0.0019915288757215155,-0.03788013152681609,104.89428601946149,104.6707147870745,2.5589193555465353
2023-05-08,1,105.41749954223633,99.11250114440918,108.91000175476074,102.45875024795532,104.90375137329102,0.18563469369025423,2.3859145230351606,-0.2972651003904563,2.995467843211019,103.67875003814697,1.8530001640319824,0.0230106282478772,100.60999946594238,106.77700138092041,0.7030971712612801,0.035416181311046936,1.0166847426291548,1.0030853445305385,1.0151867458159145,0.018403562519078154,54.4874075011333,108.4593293321726,103.68750028610229,98.91567124003198,104.48107174464634,1.355836290838227,104.99785763876778,1.7745558643217612,104.50549814641913,103.91246172852888,-0.35651470751914777,1.950295279571427,49430900,1.7711944032681792,0.7200529942362577,-1978094500.0,-51.80225801813312,77.07053933241427,82.84087432937385,59.09768658008542,25.624497075983545,17.04176592920775,-0.04572872015321485,3.108718607486157,108.56844082641602,107.15078096008301,106.00500106811523,104.85922117614746,103.44156130981446,0.04,0.0,120.87489863558909,0.037040653270531854,0.003603650012422367,104.32428632463726,104.92285755702427,2.5784548195845725
2023-05-09,1,106.01250267028809,99.11250114440918,108.91000175476074,102.73812532424927,105.24312591552734,0.004802384672031824,2.3441618034652403,-0.19531864156824108,2.9954776926879854,103.89749908447266,1.8006251335144043,0.022562335539170558,100.60999946594238,106.77700138092041,0.6557196540421532,0.05225462190651167,1.0203603066385865,1.0103092010692498,1.0171845795231031,0.033890062424872136,57.31666020247752,108.58544894643853,103.89712533950805,99.20880173257757,104.37607192993164,1.1662729080355831,105.20607198987689,1.7040412989935625,104.72926036845529,104.09196095457045,-3.2067782171087402,2.354541526939345,44089400,1.7490112968862017,0.6499740426997037,-1934005100.0,-43.66630549481446,77.07053933241427,82.84087432937385,75.30658431711225,26.272218804007856,16.38106598911778,-0.016754619190776896,3.0030956536238698,108.56844082641602,107.15078096008301,106.00500106811523,104.85922117614746,103.44156130981446,0.04,0.0,120.85023783196927,0.028852702619033055,0.044781965293096866,104.4914300101144,105.08857182094029,2.476821465371174
2023-05-10,1,109.25250053405762,99.11250114440918,108.91000175476074,102.9456238746643,105.56625032424927,-0.1137366690830547,2.223497596384359,0.07258051201011684,2.9955043150981266,104.05374908447266,1.718850631713866,0.021341078137705118,102.06599979400634,106.77700138092041,0.555684247017764,0.06961787308571142,1.0486029552846676,1.039040392797703,1.0413281041731857,0.04891631667706409,60.20888141327809,108.6356206238295,104.18862543106079,99.74163023829207,105.19607189723423,2.1011170093606832,105.58482210976737,1.9716525444960484,105.04878975002808,104.46556402203626,-0.688539491367272,2.8274214854025184,78627600,1.7208854538172007,1.140734240053471,-1855377500.0,-6.90008477978877,77.07053933241427,82.84087432937385,181.73454078227533,32.80728025904285,14.841430936420693,0.05727740891225801,3.077874208534008,108.56844082641602,107.15078096008301,106.00500106811523,104.85922117614746,103.44156130981446,0.02,1.0,120.81675498624378,0.06309696883018812,0.06330218432744306,105.65428706577845,105.5442864554269,2.351522241971857
2023-05-11,1,111.74499893188477,100.65749931335449,109.25250053405762,103.07125091552734,106.15250205993652,0.4475843577900458,2.163488446082549,-0.33871763341737715,2.9955193798818107,104.17124938964844,1.7689381694793695,0.0206645543957114,102.50600032806396,107.22925148010255,0.44476353477634284,0.0853885828610368,1.0673320733733827,1.058649918621563,1.0548399561562696,0.07256322411763039,67.40198457445031,109.0226022927083,104.69562540054321,100.36864850837812,106.51142883300781,2.8924456734591173,105.95428630283901,2.5660145119821185,106.09858897120432,105.29275540609112,5.545223744776201,5.101011771854973,74924800,1.8208693393947777,1.0815222388558885,-1780452700.0,-9.068414865560982,77.07053933241427,82.84087432937385,221.66018392560568,36.510689568757215,13.777452858961265,0.02371755341760193,3.0787400749166265,110.41731942749024,108.64633982849121,107.21500015258789,105.78366047668457,104.01268087768554,0.04,0.0,120.79169250277604,0.0786538490882287,0.08229617610924145,106.87571607317243,105.91714368547711,2.803178815832627
2023-05-12,1,111.09500122070312,102.22249984741211,111.74499893188477,103.40875101089478,106.61625051498413,1.0179101457041488,2.458192604592376,0.3881824442307562,2.995461607802506,104.4975004196167,1.970000343322755,0.023355749127628167,102.77825031280517,108.94425163269042,0.49526820330570315,0.09315462934957494,1.0555344495776597,1.0496727374138828,1.0339468167210224,0.05996564989086739,71.49275766761541,110.16638559065449,105.25000038146973,100.33361517228498,107.50250053405762,3.1302300681384203,106.24375057220459,2.904469764398016,107.50895268729077,106.26654972163769,8.979640147419657,4.853502256111234,49810100,1.8620113830239309,0.7198495848336192,-1830262800.0,-24.896927674203905,77.07053933241427,82.84087432937385,152.6404168831566,33.714073218850686,15.421493585325008,-0.004495402276938017,3.0959729049100617,110.41731942749024,108.64633982849121,107.21500015258789,105.78366047668457,104.01268087768554,0.04,0.0,120.77276873120742,0.04353585382063274,0.06019232823298541,107.82000187465123,106.20642961774554,2.9337537925674275
2023-05-15,1,110.97249984741211,102.53750038146973,111.74499893188477,103.76187467575073,106.8212513923645,0.897327333958144,2.663798311822992,-0.232199367544641,2.9954169809517346,104.99750137329102,2.182850456237793,0.025203017688893253,102.97374858856202,109.43675060272217,0.6186157809435036,0.08063810992576767,1.0499450593618664,1.0442259230679383,1.0208638948293818,0.05269523873453408,68.35761095270179,111.02122207378027,105.69362545013428,100.36602882648829,108.47214344569615,2.9789168037494167,106.7528577532087,3.0715278127864742,108.41247109532264,106.98987261033366,6.660588006704521,3.785879175316934,53011100,1.879435787317368,0.7589306358091864,-1883273900.0,-17.147586991155947,77.07053933241427,82.84087432937385,136.15196259969585,31.34640445931992,14.50018262590439,0.0041450996691296165,3.0919749056684314,110.41731942749024,108.64633982849121,107.21500015258789,105.78366047668457,104.01268087768554,0.04,0.0,120.75305355313579,0.05074170862965777,0.052432264756011156,108.84857286725727,106.82285799298968,3.095917662993531
2023-05-16,1,112.57250213623047,102.53750038146973,111.74499893188477,103.92374897003174,107.5093765258789,0.7094556303686906,2.811613292728463,-0.7435290808130981,2.9953832803873275,105.30125045776367,2.352150192260743,0.026499154411856542,103.08700141906738,110.98474998474121,0.6707819533695534,0.07748138528265197,1.0609837861956353,1.0518975858486221,1.0251057590164578,0.061879488746197975,67.70448326056065,111.72522701270302,106.1020004272461,100.47877384178918,109.58107212611607,2.829524961506103,107.28053637913295,3.3986144374363194,109.05547339128631,107.57431266733423,6.514853785346067,6.863595340349739,71472900,1.8828674551842688,1.0005466596018555,-1811801000.0,-10.190611817060088,77.07053933241427,82.84087432937385,165.7594532869584,34.36819767056395,13.265863221554833,0.028533627874368504,3.138262259818594,111.57096105957031,109.57952114868164,107.97000122070312,106.36048129272461,104.36904138183594,0.06,0.0,120.73242246905194,0.06359030767811724,0.07152980784134219,109.95428684779576,107.42428643362862,3.365187486404764
2023-05-17,1,115.11000061035156,102.53750038146973,112.57250213623047,104.10562419891357,108.99562644958496,0.6136516272168222,3.0472360596987387,-0.9370326912227798,2.9953258342697873,105.7150011062622,2.5689502334594723,0.028590799881209918,103.47100086212158,111.16000099182129,0.6734421495673404,0.09190329756009048,1.080023643492156,1.065616264036688,1.0358372145252508,0.05361433420435047,70.97560385841936,112.67547273356374,106.58100061416626,100.48652849476878,110.96571513584682,2.8240139494017895,107.72339344024658,3.9812752179326933,109.92962701026323,108.28064140046042,7.406259575641595,7.02334046345824,65655200,1.8992263907590186,0.9144603025781212,-1746145800.0,-2.247968829662242,77.07053933241427,82.84087432937385,176.30393627383657,34.84209515540674,12.52013147603999,0.032580649938884806,3.0876721202011654,112.36552175903319,110.22224171447753,108.4900016784668,106.75776164245605,104.61448159790038,0.08,0.0,120.7187504730574,0.048189467655356255,0.08328640991057022,111.33571515764511,107.83000074114118,3.8522095772591136
2023-05-18,0,117.44499969482422,102.53750038146973,115.11000061035156,104.17812442779541,109.68250036239624,0.6952554987115388,3.4576510976690282,-0.6209340756568498,2.995215609675659,106.29250144958496,2.9386126136779795,0.03225973742889327,103.81174945831299,111.82774925231934,0.6815779855802381,0.1073593254220658,1.0957568434379217,1.0763192713641159,1.0458240867713506,0.05100900100606687,75.00837601201306,114.09692775228386,107.1816255569458,100.26632336160775,112.59892899649483,2.787634325117452,108.48750046321324,4.734817110748392,111.22978579292585,109.22212621812629,9.194394773357207,5.692772707461463,73174100,1.9522767224296345,1.0083170819006753,-1672971700.0,-2.578779524013141,77.07053933241427,82.84087432937385,185.90837393596178,38.75028789613918,11.622522192796344,0.07894078596653466,3.0885525740525903,114.48179919433593,111.93409963989258,109.875,107.81590036010742,105.26820080566407,0.1,0.0,120.71047459070273,0.05321805316867767,0.07223885024147646,112.98285784040179,108.7371439252581,4.472856689970111
2023-05-19,1,117.10499954223633,102.53750038146973,117.44499969482422,104.65375089645386,111.00312519073486,0.7834024036467405,4.0304758245078975,-0.32329947213288257,2.9950404495793115,106.66000080108643,3.4251499938964853,0.03736891585803226,103.81174945831299,112.82625198364258,0.7366283773943307,0.10201974658182848,1.08574944125438,1.0603182978274532,1.0323169176178268,0.05409782848459255,77.46073396525773,115.91732724792328,107.85637559890748,99.79542394989167,113.7207145690918,2.796506719588375,109.45839323316302,5.021141607151894,112.79709273320537,110.25038105209593,10.784102569573896,10.021310273225556,54990200,1.9375024628195041,0.774713630662713,-1727961900.0,-13.467042321504927,77.07053933241427,82.84087432937385,141.05185516035098,36.385099063023,12.409805091473068,0.04455996262072896,3.0543702909310393,114.48179919433593,111.93409963989258,109.875,107.81590036010742,105.26820080566407,0.1,0.0,120.70234769934817,0.05432611779173224,0.03628097418213714,113.84857177734376,109.7514294215611,4.836038956047403
2023-05-22,1,115.69999885559082,102.53750038146973,117.44499969482422,104.65375089645386,111.25750064849854,0.6512064793588348,4.490193421384646,-0.7509483799170069,2.9948812777857388,106.89500141143799,3.8760499191284183,0.04142894548033262,103.81174945831299,115.30950050354004,0.8074196465497233,0.0940046986606588,1.067510571334073,1.0360629461127246,1.0092375196133758,0.04260063542480386,75.6805869918849,117.36338740734449,108.3830005645752,99.4026137218059,114.28571455819267,2.7295371430001922,110.39857169560024,4.855116292768719,113.88078298729283,110.9728393896017,7.187477604442406,13.131263063990618,70741100,1.948165027942022,0.9957981182326477,-1798703000.0,-23.433396928222344,77.07053933241427,82.84087432937385,103.01253635998431,34.21372200249259,15.103047287785486,0.04689615980968376,3.0162007446549435,114.98447854614258,112.74775859069824,110.93999862670898,109.13223866271973,106.89551870727539,0.1,0.0,120.68822660744054,0.034262637522927575,0.04307999190976971,114.25285775320872,110.56428691319057,5.024855025330927
2023-05-23,1,115.04499816894531,102.53750038146973,117.44499969482422,104.65375089645386,111.95187473297119,0.45986558648683573,4.749898168780069,-1.140232257704095,2.9947854038143102,107.82875156402588,4.174874877929687,0.04365078302956635,103.81174945831299,115.84049892425537,0.8434375917516357,0.11416052405627752,1.0572446135196316,1.0207983758456216,0.9953151795571712,0.021963587783833116,72.68066711864465,118.31567177243564,108.8158754348755,99.31607909731535,114.84999983651298,2.340554526970239,111.1762501852853,4.64600180169272,114.33315820062401,111.43533630924037,3.5393082120094363,12.836765500575613,67576300,1.8034156922637317,0.9495444346982084,-1866279300.0,-23.61020532500781,77.07053933241427,82.84087432937385,92.50156096334271,31.513311413462798,15.015049347205721,0.0755608584085951,3.040757877919018,114.99155825805664,112.75921812438965,110.95499801635742,109.15077790832521,106.91843777465822,0.1,0.0,120.67470615172641,0.01402113153876594,0.034082742981471154,114.92857142857143,111.37428665161133,4.979049390026382
2023-05-24,1,116.11499786376953,102.53750038146973,117.44499969482422,105.09125137329102,113.19062614440918,0.26165284741199396,4.790882038716572,-1.3226134229295494,2.9947761234847516,109.08125114440918,4.240712060928345,0.043801999501028234,104.09299945831299,115.84049892425537,0.8719896641151461,0.09373956996646468,1.061614341031288,1.0221008273067036,1.0002928859121054,0.00873075534783374,68.88904657128262,118.95763945508818,109.37587537765503,99.79411130022189,115.58464241027832,1.6153683185520085,112.02839292798724,4.349685276795089,114.51702357707512,111.86518405373377,3.5555127637066763,10.452918827127492,63487900,1.8166967298450245,0.8986093387126178,-1802791400.0,-12.29235240412179,77.07053933241427,82.84087432937385,97.83959037748518,30.222558515183575,14.172511890470814,0.11394261542145301,2.9914179205048255,115.04819955444336,112.85090022277832,111.07500076293945,109.29910130310057,107.10180197143553,0.1,0.0,120.6645756449957,0.010822510822510845,0.029541432354889288,115.72142900739398,112.28500093732562,5.117678621773474
2023-05-25,1,115.70249938964844,102.53750038146973,117.44499969482422,105.265625,115.06124877929688,0.06926963905732031,4.9037236870374725,-1.4256374000806606,2.994737719221527,110.11250019073486,4.368124485015869,0.044610787185212386,104.09299945831299,116.21399803161621,0.90178727231854,0.06615550448004505,1.052583690780318,1.0123544800864304,0.995016430390945,-0.014836734724369638,69.24164883062014,119.7298225762539,109.92237520217896,100.11492782810402,116.03178487505231,0.9307555513223487,112.80642850058419,3.9112858088114475,114.91657229513834,112.32661911517609,4.6340291724782166,11.450783182781521,66496700,1.6600766231063424,1.0002804684944528,-1869288100.0,-25.89926675488956,77.07053933241427,82.84087432937385,74.69270176747128,28.355904184211216,15.010135840290467,0.04303630024431079,2.9606027253250393,115.31959811401367,113.29019789123535,111.64999771118164,110.00979753112794,107.98039730834962,0.1,0.0,120.65161458988254,-0.02666103669231823,-0.004329004329004329,115.9500002179827,112.95214353288922,5.236222064901974
2023-05-26,1,118.41749954223633,102.53750038146973,117.44499969482422,105.265625,115.25750017166138,-0.06346237893695489,5.054741113033298,-1.5301573324139288,2.994679920536503,111.03375053405762,4.572549533843994,0.04584300220552865,104.09299945831299,116.21399803161621,0.9094555316132483,0.08388953278674142,1.0739647335628377,1.0325344129566776,1.0214260830966033,0.011207890398621467,69.86724546436504,120.37148230998993,110.26200008392334,100.15251785785675,116.50428472246442,1.1886260191104954,113.73499992915562,3.548482398567414,115.09860243918057,112.5220307652212,2.7804278967080065,10.392613179693349,96779900,1.5621604212823175,1.4937751586693997,-1772508200.0,-8.506730117345157,77.07053933241427,82.84087432937385,117.50609980389676,34.55060871902048,12.84141885199556,0.13789327570020035,3.213416816373501,117.64376086425781,115.25812139892578,113.33000183105469,111.4018822631836,109.01624279785156,0.12000000000000001,0.0,120.64647402889358,0.03320430632560489,0.01658907371273583,116.60857173374721,113.97214344569615,5.540508091781623
2023-05-30,0,121.70250129699707,102.53750038146973,118.41749954223633,105.265625,115.70062398910522,-0.1896311763115396,5.283744797774255,-1.4844306982622886,2.9945920882233183,111.42000007629395,4.687899589538574,0.047667652707037544,104.09299945831299,117.13899955749511,0.8579756128115329,0.14399225861069437,1.097947154421007,1.0544453597607795,1.0473897775442438,0.051879883325653076,79.73331043502436,121.41298958791913,110.8454999923706,100.27801039682208,117.11249923706055,2.310267932008589,114.85571411677769,3.3962939688484455,115.91673655441801,113.0826113876164,2.873337602595174,12.331918378306298,64314800,1.3726771386242054,1.0007260985556838,-1708193400.0,-8.47340229035841,77.07053933241427,82.84087432937385,135.51245337613383,35.359697844386076,11.96497807967107,0.1981355120146521,3.2024582979606526,119.41067932128907,117.23966003417969,115.48500061035156,113.73034118652343,111.55932189941406,0.14,0.0,120.64844453811355,0.05782107123171687,0.04653766591061828,117.11000061035156,115.04642922537667,5.6040856071141905
2023-05-31,1,120.80999946594238,102.53750038146973,121.70250129699707,105.86375188827515,115.80562400817871,-0.166013524737952,5.504166491933643,-1.1684553051811293,2.9945151804116676,112.15875053405762,4.736499691009522,0.04925208260027948,104.1822494506836,117.54224967956543,0.8009224958412234,0.18690723729589556,1.081025452510612,1.0370713723027603,1.0290766780556757,0.050110838269831426,85.09963698101386,122.76333300294077,111.75500001907349,100.74666703520622,117.64178494044712,2.6998294919153345,115.68124975476947,3.333616074385857,117.35369604532742,114.15645666051563,3.6251024847680076,14.800139824551458,72800800,1.4142575214446105,1.1333561818334807,-1780994200.0,-17.11775165564042,77.07053933241427,82.84087432937385,113.28589095168259,33.079294272997885,12.743836442454567,0.15129310100532853,3.178711472862158,119.69387860107423,117.69805886840821,116.08499908447266,114.47193930053712,112.4761195678711,0.14,0.0,120.64830635175963,0.04861295826709844,0.048430567701637554,117.72857230050224,115.788572038923,5.5527909511470135
2023-06-01,0,121.71999931335449,104.15749931335449,121.70250129699707,108.44250106811523,116.36249828338623,-0.2048424875346593,5.414118024630004,-1.1057789695802245,2.9945730678676767,113.80875015258789,4.64662446975708,0.04805346675627905,104.74750118255615,118.65674953460693,0.8343487881267454,0.15987807178904495,1.0803362457135035,1.0375462686326928,1.0267441011113028,0.04827112390908339,79.75196741435597,123.49686102255711,112.66862497329711,101.84038892403711,118.50178500584194,2.927415646299245,116.3937497820173,3.489921614232197,118.21012503533302,115.08934590707894,3.163827281660823,10.578704263415839,54375100,1.467380768096488,0.8536006536174979,-1726619100.0,-5.056189106144409,77.07053933241427,82.84087432937385,123.74390175739892,33.68614627171574,11.733035532269358,0.21493872673881134,3.2059461932715783,120.1293583679199,118.05031867980956,116.36999893188477,114.68967918395995,112.61063949584961,0.16,0.0,120.65112140611534,0.05156314041170362,0.06765804786355399,118.83714294433594,116.54500034877232,5.531455460524785
2023-06-02,0,124.89499855041504,104.18499946594238,121.71999931335449,110.54250001907349,117.1899995803833,-0.2669265111444118,5.386647968934323,-0.965961809194777,2.994601379169844,115.07749938964844,4.585824403762817,0.047439913253361325,105.3567497253418,120.89924964904785,0.8183951502742879,0.16830637747561944,1.0999434028696258,1.058645272055427,1.043657365494749,0.07944944326404957,80.96184300580668,124.32004591116576,113.54674997329712,102.77345403542849,119.90892791748047,3.328713970177556,117.37946387699672,3.8121852181058955,119.08391547206097,116.040451631712,5.2031119423583085,8.926574322623676,61215000,1.4536767297574495,0.9491530574620967,-1665404100.0,-12.485411119331035,77.07053933241427,82.84087432937385,153.9004174740322,37.39621725764869,10.795372188170699,0.18587881758092298,3.235521661365204,122.34495953369141,119.84251962280274,117.81999969482422,115.7974797668457,113.29503985595703,0.18,0.0,120.6605863488501,0.08043478260869574,0.06423982869379015,120.16000039236886,117.54428591047015,5.495354897732506
2023-06-05,0,124.37250137329102,104.81000137329102,124.89499855041504,111.06437587738037,117.68812465667725,-0.13346095776790406,5.477292656626285,-0.7174701425823757,2.9945863139519533,115.40499973297119,4.478049316406251,0.04780227880052066,105.95300235748292,121.70425109863281,0.7767780325257959,0.19163244837283563,1.085443002314609,1.0476010167725658,1.023566169980266,0.05028819096902737,84.3345398195461,125.53683524077331,114.58224992752075,103.62766461426818,121.08857127598354,3.221560019143703,118.33660684313092,3.761684339641885,120.53911288184706,117.30311466908766,8.561867563338001,12.421798621070822,47950100,1.5353954250801174,0.7486798592266208,-1713354200.0,-7.105584081518246,77.07053933241427,82.84087432937385,140.79154134791796,35.085631596896086,12.33661258160499,0.1706891015493842,3.2022704193005898,122.76976025390624,120.53012078857421,118.72000122070312,116.90988165283203,114.6702421875,0.18,0.0,120.66766211139324,0.04321041058223862,0.08956524392832868,121.38142939976282,118.55142920357841,5.52742713857385
2023-06-06,0,126.02000045776367,105.41749954223633,124.89499855041504,111.58249950408936,119.01562452316284,-0.09296048681159035,5.3908826187365,-0.6947189882914864,2.9946416741565782,115.70124912261963,4.282087068557739,0.04664992322946036,108.92850074768066,121.98524951934814,0.7879860292157465,0.17980887341631757,1.0905122152537423,1.0550197668420216,1.0270578684414318,0.035475845728350164,81.47337378534094,126.34214016499375,115.56037492752075,104.77860969004776,122.5625,2.657462949489145,119.29714243752616,3.8912755620377224,121.49945179015104,118.36780592261059,7.111487457640482,12.075065033502888,45695200,1.5730817123455128,0.7155593266865974,-1667659000.0,-5.8002992380129745,77.07053933241427,82.84087432937385,147.81576697089847,36.80707401206372,11.664157123243772,0.15963763847257,3.1449654983418616,124.18568087768554,122.19716047668457,120.59000015258789,118.98283982849121,116.99431942749024,0.19999999999999998,0.0,120.67708635015016,0.040687134631279376,0.05411705908724976,123.04000091552733,119.49500056675502,5.507704485099458
2023-06-07,0,124.06000137329102,106.01250267028809,126.02000045776367,112.36562633514404,121.03312492370605,0.041075680420023214,5.3222880471311,-0.7452073492857147,2.9946901703672424,115.90874862670898,4.317299947738647,0.04564941438925188,110.80049991607666,124.42475109100342,0.7625063094646055,0.1887277187456027,1.0640661237554059,1.0297144907425042,1.004018189366699,0.02690176245108611,83.1538616114397,127.2350760675593,116.59049997329711,105.94592387903492,123.36857169015067,1.9530265635654793,119.93642820630755,3.8856480692914266,122.62964623317289,119.46455565773957,8.917267234970648,11.945633317503782,95663300,1.5764558983676846,1.4398859329381886,-1763322300.0,-45.30100532096946,77.07053933241427,82.84087432937385,87.46782629533013,31.59799918168502,19.189346109007154,0.06800562464931612,3.4017540694007433,124.18568087768554,122.19716047668457,120.59000015258789,118.98283982849121,116.99431942749024,0.02,1.0,120.68540860184577,0.005390624614433515,-0.0035344426453416547,123.20000130789619,119.90428652082171,5.029082496745603
2023-06-08,0,123.78750038146973,109.25250053405762,126.02000045776367,114.4268741607666,121.70687580108643,0.15136915538174206,4.970657978995293,-1.1154927146301614,2.9948387826942544,116.60999870300293,4.205450210571288,0.042306037560733166,111.08275108337402,124.42475109100342,0.8252931151174895,0.13553466297659164,1.0535745293314795,1.0198218058066588,0.9965704224466689,0.016985713767486033,72.49479263936341,127.43419086643786,117.49287490844726,107.55155895045667,123.6664287022182,1.8103662448961546,120.38946396963937,3.9421543618990476,122.98755319260886,120.10202072511686,4.764922290089531,7.775172196580287,62159300,1.6236957659359894,0.9473380924806555,-1825481600.0,-23.127759843289354,77.07053933241427,82.84087432937385,91.69999625172899,28.73862019293173,17.452855999094957,0.039470600190976195,3.473056914192469,124.18568087768554,122.19716047668457,120.59000015258789,118.98283982849121,116.99431942749024,0.02,0.0,120.69296631387563,0.01205508998453797,0.03043620926534221,123.5700007847377,120.34000069754464,4.924854490460767
2023-06-09,0,124.12500190734862,110.97249984741211,126.02000045776367,115.09375,122.2368745803833,0.08304516322681191,4.771289363842354,-1.2639447231299532,2.994918353843807,117.27499961853027,4.180837764739991,0.04035953732593297,111.6799991607666,124.42475109100342,0.8589786215830157,0.10776769935740554,1.0499525946854014,1.0161790586564017,0.99597199227955,-0.006165151943659297,70.06369513067243,127.76220362850259,118.21962490081788,108.67704617313316,124.14000047956195,1.300369527512096,120.89089271000454,3.938703997464986,123.18742756893411,120.60682170490885,1.7131932887595485,5.400400786007257,51330000,1.587126838743369,0.7966173018977044,-1774151600.0,-29.14831439148869,77.07053933241427,82.84087432937385,83.94150561205667,27.52405671730921,16.499082709331212,-0.00460733794155896,3.4114100353466585,124.18568087768554,122.19716047668457,120.59000015258789,118.98283982849121,116.99431942749024,0.02,0.0,120.69935473887287,-0.006599595129369917,0.005375936142021957,123.97714342389789,120.85285786220005,4.83399563086693
2023-06-12,0,125.2249984741211,110.97249984741211,126.02000045776367,115.552499294281,123.85562562942505,-0.07986479955970117,4.693578146459042,-1.2643696933941344,2.9949511553190242,117.93124961853027,4.194487867355345,0.03949539255019505,112.42475204467773,124.42475109100342,0.8376121252811378,0.1172870115079245,1.053739879789631,1.018163915256062,1.0060414497027543,0.0068543857477900705,71.56720284977145,128.22578134250915,118.83862504959106,109.45146875667298,124.64071464538574,0.7865089235822182,121.57124982561383,3.7930376687529295,123.42348841260872,121.03664467751943,2.7439801804988586,5.99462225571367,51338000,1.560174777603676,0.7957979487330524,-1722813600.0,-6.093991656961877,77.07053933241427,82.84087432937385,98.16300754530424,27.645528996922287,15.340302032180146,0.046790535547319975,3.4070234952591165,124.18568087768554,122.19716047668457,120.59000015258789,118.98283982849121,116.99431942749024,0.02,0.0,120.70847109797211,0.010135647343454846,0.018672029737015844,124.52000100272042,121.67857197352818,4.684698341201844
2023-06-13,0,127.09250068664551,110.97249984741211,126.02000045776367,115.70187425613403,124.07625150680542,-0.17117693130371622,4.535596602066262,-1.2774209634786962,2.9950106744650262,119.61374950408936,4.12662534713745,0.03794045642091288,114.79774856567383,124.92799854278564,0.8029684598339529,0.12843270761951167,1.0631341159241985,1.0276599176454697,1.019648037464074,0.008510555665656394,73.92237567102146,128.6163181163945,119.54512491226197,110.47393170812943,124.95464352199009,1.2225869316087463,122.43178571973529,3.557848246307549,123.88276217702406,121.53246723201403,2.8795589718525827,8.232497590962604,50564800,1.5506931688160113,0.7853014104031844,-1672248800.0,-12.411342145190032,77.07053933241427,82.84087432937385,107.71265643977203,29.196524512102727,14.297628159838542,0.03195206764179804,3.3943791996644306,125.08240222167969,123.02380133056641,121.36000061035156,119.69619989013673,117.63759899902345,0.02,1.0,120.71946057790392,0.000394937615644686,0.010853955125522223,124.86428724016461,122.51214381626674,4.488307069762897
2023-06-14,0,126.04749870300294,112.57250213623047,127.09250068664551,116.01187324523926,124.18687677383421,-0.11591324925198304,4.369856919613706,-1.416227769032341,2.9950719374433317,121.25625038146973,3.994762878417968,0.03630923201819518,115.10350036621094,125.30449867248535,0.7862598730159323,0.1289835286137955,1.0473312879372416,1.014787355375484,1.0095268075177333,0.016020452262704987,76.54941221087378,129.09083879345104,120.35112495422364,111.61141111499623,125.19392885480609,1.2531928226142406,123.14125006539481,3.1705678964770705,124.69513667898431,122.28428780807414,1.7594796923300546,10.471991576729183,52422500,1.5595344717696698,0.8263773632583694,-1724671300.0,-14.11350802655236,77.07053933241427,82.84087432937385,85.13919787663237,27.43691190556593,15.693323315519418,0.04381427662991877,3.3540659855212516,125.08240222167969,123.02380133056641,121.36000061035156,119.69619989013673,117.63759899902345,0.02,0.0,120.72907997799167,0.04281114137010289,-0.0015006906286255976,125.02428654261998,123.2028579711914,4.3583285611139635
2023-06-15,0,126.08250045776367,115.04499816894531,127.09250068664551,116.85749912261963,124.50312566757202,-0.1683150705430196,4.151962874806129,-1.5449276852878446,2.9951424973086054,121.71125030517578,3.7773879909515387,0.034306690110324,115.6409990310669,126.0227502822876,0.8373251208319954,0.09501779197860415,1.0417899682547753,1.0108069566509197,1.0066025078902292,0.0185398369724048,69.81046045570262,129.3288005321745,121.02487478256225,112.72094903294999,125.20285742623466,1.2602619217558495,123.88267871311733,2.422687990953376,125.04315007673446,122.75896430199496,1.3467585770303032,8.554020601960993,60458500,1.5502803964134926,0.9569749470849054,-1664212800.0,-10.492351213036097,77.07053933241427,82.84087432937385,87.80416635889574,27.043878163451097,14.567427595146702,0.04471254568827046,3.355204325597021,125.48596200561524,123.67702098083495,122.21500015258789,120.75297932434083,118.94403829956055,0.02,0.0,120.7413060167633,0.023018113564197584,0.04850282183120694,125.09571511404855,124.06785801478794,4.349943287648845
2023-06-16,0,126.60000038146973,115.04499816894531,127.09250068664551,117.35999965667725,124.97749853134155,-0.3367027590557416,4.058016557554109,-1.4383888527613822,2.9951729399586267,122.75374984741211,3.6248005676269544,0.03337912098497331,115.70224933624267,126.05099887847902,0.8726508492742496,0.07354507033405958,1.041345364045967,1.0114184035987475,1.0070437406613473,0.019939564439793722,68.51466819937676,129.68953289004108,121.57349977493286,113.45746665982465,125.56571442740304,1.2418932270999525,124.46714305877686,1.9421577215567334,125.30004346231021,123.20389828252566,0.049595302152809655,8.971285082752415,84188100,1.497060692340136,1.3210663924987973,-1580024700.0,-31.60177556712645,77.07053933241427,82.84087432937385,78.37873548077837,25.97688041497605,13.747929293913677,-0.04662235224804416,3.3012610504915796,126.22936236572266,124.88032156372071,123.79000091552734,122.69968026733399,121.35063946533204,0.02,0.0,120.7578117049365,0.01668960182695023,0.00997986208265205,125.70428575788226,124.45214353288922,4.348299924465518
2023-06-20,0,125.625,115.04499816894531,127.09250068664551,118.08937454223633,125.42374897003174,-0.5233737256096965,4.082771492412356,-1.2541886595127985,2.995169143058761,123.92375087738037,3.596375484466553,0.033456770284609305,115.70224933624267,126.13425045013427,0.8623151061492871,0.08108108856453076,1.0294494254246507,1.0022638164166495,0.9953688134268663,0.0031942625733916152,70.34214224166799,130.19679279408984,122.03124980926513,113.86570682444042,125.82821437290737,0.9672054901738877,124.74732153756278,1.7895870797036,125.60860835400692,123.63110005456014,2.047395598953741,6.909874698304131,56930100,1.4853048806530267,0.8919805325159863,-1636954800.0,-28.463239386147908,77.07053933241427,82.84087432937385,65.77538492850181,24.412569870142594,14.671880064692937,-0.024709744204312434,3.2618852611707396,126.22936236572266,124.88032156372071,123.79000091552734,122.69968026733399,121.35063946533204,0.02,0.0,120.76813240123757,-0.006241612684144249,0.019039119082158436,125.92285701206752,124.74642889840263,4.202205246998234
2023-06-21,0,125.26250076293945,115.04499816894531,127.09250068664551,120.21187448501587,125.72375011444092,-0.7516276606073927,3.989975184979796,-0.9168303921332801,2.99519692657547,124.09250164031982,3.4445504760742183,0.03258259670577836,115.70224933624267,126.13425045013427,0.8408703078316303,0.08578220607242112,1.022908002054849,0.998374071812881,0.9918678965197847,-0.014398960708295716,66.58064762295761,130.43720020211293,122.45724983215332,114.47729946219371,125.99071420942035,0.6888607223689153,125.06535734449115,1.3862216107018224,125.60332002341544,123.8983759251976,1.4843983543312071,3.223022256075615,52137700,1.4591557468142762,0.8289746249276861,-1689092500.0,-42.2169860124825,77.07053933241427,82.84087432937385,47.55086646479209,22.859979031937854,15.17415037114175,-0.01599911194343524,3.234608091288,126.40872286987305,125.17064237976074,124.17000198364258,123.16936158752442,121.93128109741211,0.02,0.0,120.77623665239612,-0.014448142887604765,-0.013747316646637383,126.12285723005023,125.05000032697406,3.8391934594426256
2023-06-22,0,127.73249816894531,115.04499816894531,127.09250068664551,121.4793758392334,125.72375011444092,-0.9969649996232838,3.7150703857606144,-0.3457694699227254,2.9952708823129846,124.24875164031982,3.10351294517517,0.03021970192022366,116.07374801635743,126.13425045013427,0.7952903823667676,0.08881309710648684,1.0390215041378676,1.0186756028678217,1.014365849956786,0.013367972258716776,65.3744087048042,130.36551569904196,122.93537492752075,115.50523415599953,126.34892845153809,0.8560026519153499,125.49482154846191,1.1871427037473266,125.51432465301072,124.12368387376046,0.9164139682671705,3.6855403664266033,90354600,1.4481542534147227,1.411060401242357,-1598737900.0,-1.855751027018266,77.07053933241427,82.84087432937385,120.14388086462208,27.78680195232978,13.418987522477046,0.06470655117443264,3.3964217990531895,128.04080075073242,126.62460008239745,125.47999954223633,124.33539900207519,122.91919833374023,0.04,0.0,120.80111683831169,0.029504791817465126,0.027554003896014718,126.63428497314453,125.57714298793248,3.6694906676243497
2023-06-23,0,129.38999938964844,115.70249938964844,127.73249816894531,121.71562480926514,126.02687501907349,-1.1132428027685741,3.3818683638763845,0.20902237782418975,2.9953538089261884,124.63374996185303,2.695100269317629,0.02736809264290009,118.18724937438965,126.64925041198731,0.7307032246752614,0.10005167737940165,1.0471009245024898,1.0288808616350307,1.024786052934682,0.02623281517955567,71.45459364696563,130.3334866552735,123.56974992752075,116.80601319976797,126.67714255196708,1.433967953632495,125.81589303697858,1.561321126061943,126.06432658213174,124.65756087024448,2.002395468459452,4.9396145986760285,71855200,1.5077511942345934,1.114872682918012,-1526882700.0,-14.789369659516735,77.07053933241427,82.84087432937385,142.57355558859646,27.355776602310232,12.683598624016414,0.030068474529247893,3.3366772104489284,128.43043655395508,126.93977668762207,125.7349967956543,124.53021690368651,123.0395570373535,0.06,0.0,120.82318745737085,0.017465197152412903,0.02301853903067208,127.01571328299386,125.94000026157924,3.480203909766019
2023-06-26,0,128.81250190734863,115.70249938964844,129.38999938964844,123.27062511444092,126.05624914169313,-1.0420072432079914,3.1482643218569564,0.8950737015934553,2.9954082130986097,125.05999851226807,2.3542997360229507,0.025341508705464196,120.57074947357178,127.15650043487548,0.6160015781653492,0.11829908664206938,1.0368580286588829,1.0197457771641805,1.0148949919683885,0.017476315317632052,75.5746133385668,130.5300286475286,124.2335000038147,117.93697136010077,127.07214300973075,1.6025352425095836,126.13303593226841,1.691121115747548,126.8972593094626,125.38490103764352,1.8077374279286205,3.5990238931937286,59989300,1.5046104956955024,0.9354893868122215,-1586872000.0,-38.30571368154546,77.07053933241427,82.84087432937385,120.94400388436397,24.84164494064649,13.988248077194982,0.012246649921709249,3.4119150539199494,128.92704354858398,127.34148234558106,126.06000137329102,124.77852040100097,123.19295919799804,0.08,0.0,120.83974167422038,0.014662554774147463,0.0017307939552098025,127.14571380615234,126.08500017438617,2.7465531649870294
2023-06-27,0,128.86249923706055,118.41749954223633,129.38999938964844,123.9918761253357,126.21187543869019,-0.5806635306394438,2.625138505474576,0.14567843176765205,2.9955104072789815,125.24374961853027,2.0116996383667,0.021019773580926403,121.61325111389161,127.84049854278565,0.6259439872218678,0.0877826537910023,1.0318162456520132,1.0163699696784416,1.0117615127507726,0.025771138205457067,70.66837641062634,130.13927714064886,124.88900012969971,119.63872311875056,127.46928569248745,1.6598515037855546,126.33607155936105,1.8405401079616228,127.38179715650989,125.98991519989222,2.193620050216685,3.569921393420738,46801000,1.4536473330170403,0.759421534365443,-1540071000.0,-21.270820117138488,77.07053933241427,82.84087432937385,124.29149568091267,23.38641914526461,13.168815246447608,-0.015180622263109473,3.365349300556796,128.92704354858398,127.34148234558106,126.06000137329102,124.77852040100097,123.19295919799804,0.08,0.0,120.85310276627045,0.027031276271915594,0.029404692603609322,127.44142695835659,126.26857103620257,2.644771513610025
2023-06-28,0,129.4749984741211,120.80999946594238,129.38999938964844,124.10875177383421,126.72312545776367,-0.18649722814759345,2.305217102898559,-0.5155333367776267,2.995563121348573,125.44375038146973,1.8152498245239272,0.018381262452889915,121.71824951171875,128.81750164031982,0.7143734084733645,0.05883197028621913,1.0324033797284686,1.0182794714557053,1.0114286049913548,0.03362935982855575,68.57856706424859,130.02168432023802,125.41125011444092,120.8008159086438,127.87999970572335,1.7614892796292716,126.7228570665632,1.8936445698775175,127.76222860073477,126.4670651144607,2.204904542028928,2.255593373251538,52149500,1.3048282381112017,0.8546449661789244,-1487921500.0,-26.544001256411253,77.07053933241427,82.84087432937385,138.42709748441618,24.837713391878122,12.313215578152466,-0.050496706484551346,3.342109585240792,129.31172470092773,127.96414421081543,126.87500381469727,125.78586341857911,124.4382829284668,0.08,0.0,120.86924764055915,0.033725798232190574,0.025918226573973586,127.94856916155133,126.8264274597168,2.6031755681912703
2023-06-29,0,128.29750061035156,120.80999946594238,129.4749984741211,124.31062650680542,127.25250005722046,-0.21445850152341767,2.30238099748296,-0.3816212073219898,2.9955645493516894,125.82250022888184,1.8116248130798354,0.018301933908691677,123.5807502746582,128.91524925231934,0.6555758016605353,0.07172418712427414,1.0198539596131124,1.0071317057510236,0.9956773040327367,0.004423325696323088,71.92815160251781,130.40463696826305,125.79987497329712,121.1951129783312,128.26178550720215,1.454076306948252,127.04499994005475,1.732647725513185,128.19500918687558,126.92142995856538,2.270930556073029,4.364821087287105,40761000,1.2705996607196242,0.6860167681206606,-1528682500.0,-43.25304394345786,77.07053933241427,82.84087432937385,75.81206784606887,23.744686756056478,14.367759037626929,-0.06313923466941415,3.246244069909678,129.53120477294922,128.31940432739256,127.34000396728516,126.36060360717772,125.14880316162109,0.08,0.0,120.87965864046687,-0.01728768710043138,0.02459344428256262,128.25142669677734,127.08714185442243,2.3284231265331226
2023-06-30,0,130.00749969482422,121.71999931335449,129.4749984741211,124.76437425613403,127.87374877929688,-0.04912880138668656,2.0561530551737763,-0.6731833985195728,2.9955994423052092,126.0337495803833,1.6868498611450207,0.016296138512227793,124.03275127410889,128.91524925231934,0.6479660048515521,0.05403796692492604,1.0303806019324822,1.0187557772423412,1.008064045373706,0.004772395919998562,63.21767568051733,130.28655614086512,126.17425003051758,122.06194392017004,128.9396424974714,0.7660946189895064,127.46517835344586,1.6826079466645256,128.22915920131396,127.21056678539004,2.127363669931592,3.6433405755699035,54310500,1.3160370247698574,0.914107583126682,-1474372000.0,-14.196029267712929,77.07053933241427,82.84087432937385,137.07399987734078,26.367141487481366,13.311101889384684,-0.08005934634298079,3.2536550987819233,129.6114439086914,128.4492829284668,127.51000213623047,126.57072134399414,125.40856036376954,0.08,0.0,120.8973815227662,0.007964113235244374,0.001613574519521051,129.0414265223912,127.5821418762207,2.3614295729032095
2023-07-03,0,130.74000549316406,123.78750038146973,130.00749969482422,125.14249849319458,128.42625093460083,0.27207757389917075,1.9490334544964225,-1.238370709233663,2.9956139033221794,126.0649995803833,1.6972373104095453,0.015396592337841486,124.11850185394286,129.39849929809571,0.7197439762394224,0.040934394521374456,1.0327942612691046,1.0213544283565736,1.0127739773386042,0.014963637514018968,66.44773199226681,130.48669195858392,126.58862504959106,122.6905581405982,129.36928640093123,0.8178587990776781,127.85910742623466,1.7615283755043398,128.67919577737263,127.61478337839303,3.7880442295054637,4.73917236421596,28264800,1.1843708763625904,0.489296720788593,-1446107200.0,-20.375041604002377,77.07053933241427,82.84087432937385,133.54122613170384,26.663599458659778,12.77355468237695,-0.059983396840978816,3.1483939331044026,129.96200430297853,128.7940031890869,127.85000228881836,126.90600138854981,125.7380002746582,0.1,0.0,120.90709979066379,0.0226969241191326,0.006881615843561607,129.05142756870814,127.84285627092633,2.4302498242621153
2023-07-05,0,130.41500091552734,123.78750038146973,130.74000549316406,125.25312519073486,128.8250012397766,0.20625565014038272,2.1051367140337356,-1.200917018111363,2.995594781267778,126.3412504196167,1.8482125091552732,0.016591442228400755,124.11850185394286,129.52824859619142,0.7208908742012534,0.051197041545073145,1.0278538866298677,1.015531013630074,1.0072484212079826,0.012047738385166262,69.60512526262865,131.091148824796,126.88087539672851,122.67060196866103,129.5157151903425,0.9088782625603847,128.09642887115479,1.870729473320506,129.18729436545038,127.9474556045292,2.3545357425334874,4.4040783280046885,35895400,1.1733269874745826,0.6279433148180026,-1482002600.0,-18.37499773502566,77.07053933241427,82.84087432937385,109.4023976009508,25.5643078036498,13.254225389113378,-0.09241060615353594,3.0492225455137825,129.96200430297853,128.7940031890869,127.85000228881836,126.90600138854981,125.7380002746582,0.1,0.0,120.91911259371301,0.009289458701573494,0.023953530259150264,129.20142800467355,128.1085706438337,2.5224025260166725
2023-07-06,1,128.17749977111816,123.78750038146973,130.74000549316406,125.53437519073486,128.99437427520752,0.06760664680017917,2.1564383204804143,-1.252984755264309,2.995588573703338,126.84625053405762,1.908550052642822,0.016955397452032134,124.11850185394286,130.04824981689453,0.7984993070452857,0.03487542010632417,1.0078194365155297,0.9943987316345827,0.9875989024046157,-0.0100212297222948,65.99065378447138,131.49587701480115,127.18300037384033,122.87012373287952,129.42500059945243,1.0161254683680458,128.2485718045916,1.775464553654402,129.49341495552977,128.2415423176831,0.7921798676203636,2.6142378275124725,40639900,1.1393886379423095,0.7140997712643542,-1522642500.0,-43.62502706048292,77.07053933241427,82.84087432937385,28.576198519859773,23.76011530354969,17.64120961431531,-0.09026029194442992,3.0464210877078304,129.96200430297853,128.7940031890869,127.85000228881836,126.90600138854981,125.7380002746582,0.1,0.0,120.9293831026692,-0.005269627333856386,-0.006347670784342908,129.34857068743025,128.2471422467913,2.5343420539871184
2023-07-07,0,129.36750030517578,123.78750038146973,130.74000549316406,125.53437519073486,128.99437427520752,-0.06955042896095656,2.1495144182205803,-1.233516182801835,2.995589626540887,127.41249942779541,1.9001250267028809,0.016886633959326873,124.11850185394286,130.04824981689453,0.7940009543369855,0.03318957240245209,1.016314012769014,1.0013661937632228,0.998764733433293,0.008339988618125016,55.16500607065034,131.58990417594921,127.29087533950806,122.9918465030669,129.49714360918318,0.9870437350133898,128.48321465083532,1.6817779317515738,129.159370770313,128.164824534589,-0.4929662314044709,1.6898400127193283,41928700,1.1687840299822665,0.7732506367804851,-1480713800.0,-25.875066876347656,77.07053933241427,82.84087432937385,71.46479009953583,27.44788887869307,16.460793165418114,-0.01596456400650745,3.0316764627208848,129.96200430297853,128.7940031890869,127.85000228881836,126.90600138854981,125.7380002746582,0.1,0.0,120.94210368650809,0.01469896193111131,0.005734698788484722,129.43428584507532,128.43785640171595,2.1688975960600865
2023-07-10,1,127.85000038146973,123.78750038146973,130.74000549316406,125.94187402725221,129.37312507629395,-0.22350529882061126,2.060019321506727,-1.1415272598115849,2.995601696591547,127.95499897003174,1.815875082015991,0.016149889298926603,125.11499881744385,130.04824981689453,0.7309332809553624,0.045077248563146106,1.002302906323356,0.9883691700588668,0.9854210037923632,-0.016595191188346403,60.314748751453855,131.67628892911574,127.5562502861023,123.43621164308885,129.26500102451868,1.1676822596685452,128.57250036512102,1.6055614483167984,129.21172557009163,128.31173220378867,0.3918914122457104,2.6054367858230654,61889300,1.1821135753246508,1.141648994026889,-1542603100.0,-59.00005435938437,77.07053933241427,82.84087432937385,-14.00793610227316,24.999437901768527,20.099699318567303,-0.04231560661074833,3.0908424732659396,129.96200430297853,128.7940031890869,127.85000228881836,126.90600138854981,125.7380002746582,0.02,1.0,120.9561087895318,-0.024777564757675563,-0.006020361714422273,129.16142926897322,128.55499921526226,2.023516281341518
2023-07-11,1,128.41250038146973,124.12500190734862,130.74000549316406,126.07375001907349,129.37312507629395,-0.21645848344558824,1.8699092232242338,-1.0643670466229285,2.9956250441225185,128.01375007629395,1.6041878032684322,0.014636180077092496,125.25875053405761,130.04824981689453,0.6883008537372934,0.030010057739226312,1.005112150039125,0.9939009501247672,0.9930593072284456,-0.01780254714625995,52.22457844455545,131.49919373255076,127.7593752861023,124.01955683965383,129.28142956324987,1.1525119069565168,128.771607535226,1.3670459059292681,128.87717843769605,128.29770895502472,-1.2550670877020051,0.9873617663771831,49951500,1.249164325468593,0.9226098565389372,-1492651600.0,-38.37505495543007,77.07053933241427,82.84087432937385,27.343775500500787,24.602479436912212,18.860508317049664,0.004703498349414864,3.058639940821439,129.96200430297853,128.7940031890869,127.85000228881836,126.90600138854981,125.7380002746582,0.02,0.0,120.96943398886818,-0.011058227829115586,-0.01212029628457384,129.28714316231864,128.76928492954798,1.7550584995157796
2023-07-12,0,130.29999923706055,125.2249984741211,130.74000549316406,126.47062540054321,129.37312507629395,-0.17374450761135318,1.676752522552253,-1.1180951533950467,2.9956463684456827,128.23750019073486,1.4246253871917722,0.013102316059373722,125.58875007629395,130.04824981689453,0.6689251399910772,0.0254541980130857,1.0181775483131377,1.0088223466616186,1.011296554235096,-0.0008818132704019321,53.4790281142586,131.32725525491287,127.97375020980834,124.62024516470383,129.32321521214075,1.187980515786417,129.13142885480607,0.9807430512125525,128.76822942705604,128.3236839150554,0.08963523885584207,2.2189057762943096,54022800,1.234371399370731,0.9953393559113681,-1438628800.0,-15.648315963497192,77.07053933241427,82.84087432937385,94.62474878385237,26.685343021309194,17.753230458538177,-0.0055645899282471285,3.017308211301265,130.26644451904298,129.28678353881836,128.49500274658203,127.70322195434571,126.7235609741211,0.02,0.0,120.98690975925331,0.0032213388036210766,0.004454014941004896,129.35000065394811,129.19571358816964,1.822179884381137
2023-07-13,0,133.93000030517578,125.26250076293945,130.74000549316406,126.96937561035156,129.4112491607666,-0.27444937201396435,1.62477686518585,-1.0404597610538346,2.9956518985353804,128.35500049591064,1.357750291824339,0.012671048425992834,126.00524883270265,130.31149940490724,0.6671929494697338,0.025237512308639885,1.0444717400416716,1.0357741509649916,1.0396556497891416,0.044879175708136376,59.11590826991564,131.47705397832706,128.22750024795533,124.9779465175836,129.77892875671387,2.0908226684483133,129.57410757882255,1.5399779889842242,129.149337064535,128.56909221714614,0.22498666840215598,4.021553492417184,61170900,1.2358278547857322,1.1161337709612977,-1377457900.0,-4.228515625000007,77.07053933241427,82.84087432937385,222.67197570765134,32.20171867358726,16.158964018882177,0.0330823271431944,3.0782144188645733,132.60499816894531,131.3274981689453,130.2949981689453,129.2624981689453,127.98499816894532,0.02,1.0,121.01423329606703,0.04627611727299441,0.030065945866995982,129.93285805838448,129.4921428135463,2.2268635825588863
2023-07-14,0,134.86249542236328,125.26250076293945,133.93000030517578,127.44937372207642,129.60812377929688,0.47712090127007134,2.021023380364747,0.4874000007821473,2.9956090163952642,128.61250114440918,1.5606252670288079,0.015719321780687506,126.00524883270265,130.447501373291,0.5302975310398819,0.06253596210382432,1.0489472721033164,1.0394046592372677,1.0376272989236128,0.04247585447832636,70.52041453792042,132.61142198961133,128.56937522888182,124.52732846815232,130.4142851148333,2.853113939939066,129.9650001525879,2.0870278975037606,130.33423846243994,129.2400366548137,2.439953096207046,4.851938406491781,54388100,1.4211613551914912,0.9905973743972357,-1323069800.0,-18.35975773640825,77.07053933241427,82.84087432937385,227.1288493823625,34.89136640430651,15.176687162547715,-0.022652266208682603,3.043341698795002,134.11771490478515,132.55113552856446,131.28499603271484,130.01885653686526,128.45227716064454,0.04,0.0,121.040753541063,0.037756156130169805,0.04923646023198923,130.5471420288086,129.87428501674108,2.5388416605038535
2023-07-17,0,134.23749923706055,125.26250076293945,134.86249542236328,127.82062482833862,130.0806245803833,0.7470911251193209,2.3563637482286897,0.5951879892522771,2.9955661952460333,128.8375005722046,1.7396373653411872,0.018264952049648894,126.0367504119873,131.05900497436525,0.615782047018084,0.0696369038742281,1.0405191001061587,1.0293793360419614,1.0241586629551627,0.049960882569669574,72.43339892729378,133.72285256130723,129.01012506484986,124.29739756839248,131.27999932425362,2.977949093739949,130.35249996185303,2.3443503540915533,131.4630042585883,130.0495882788031,3.4102629878572612,4.229458272300339,48450200,1.4226649654529666,0.8922043027088463,-1371520000.0,-28.79774061754751,77.07053933241427,82.84087432937385,164.19730976701058,32.88800886518145,16.330356134740537,-0.09106136083455718,2.9981021776896633,134.11771490478515,132.55113552856446,131.28499603271484,130.01885653686526,128.45227716064454,0.04,0.0,121.06262376841939,0.05057815184529879,0.029126204460250608,131.28999873570032,130.3192847115653,2.685341686617957
2023-07-18,0,132.68750381469727,125.26250076293945,134.86249542236328,128.09562492370605,130.32874965667725,0.6519380183296039,2.5147391208740664,0.031954072659612365,2.9955442502274674,129.11499977111816,1.8624498748779275,0.01943115756459409,126.50250034332275,133.96075019836425,0.7082311733827217,0.06032779488607893,1.0252641206694686,1.0142036560454166,1.0025614563130396,0.033291178199380544,68.87930081915596,134.44735324556282,129.4178750038147,124.38839676206655,131.75428553989954,2.885534881716674,130.62571457454138,2.379961461617275,132.1554295353787,130.6441870898685,4.72781843674865,4.211545656968894,54969100,1.4430515364264151,1.040234672609304,-1426489100.0,-35.601058587800686,77.07053933241427,82.84087432937385,100.41193195759709,30.898179306498317,19.82583229344516,-0.01623754800424062,2.9632373440572515,134.11771490478515,132.55113552856446,131.28499603271484,130.01885653686526,128.45227716064454,0.04,0.0,121.08460476480082,0.03144900675685447,0.04483603162733086,131.72571345738,130.57999965122767,2.6282698522584664
2023-07-19,0,134.31750106811523,125.26250076293945,134.86249542236328,128.2675004005432,130.49625205993652,0.45982430969473176,2.523642478564556,-0.25677606250776286,2.9955435723989554,129.3787498474121,1.940200271606443,0.019454199068785885,127.52174835205078,133.96075019836425,0.726526223155921,0.05621893583838619,1.035423767984468,1.0251366245235891,1.0083631546330363,0.03083270801671656,62.4502399086681,134.7695351326052,129.72225017547606,124.67496521834694,132.67821420942033,2.4258672422741965,130.97160761696952,2.545961617925529,132.2862929844323,130.99024123027135,2.566335054545888,2.968283713479815,54531000,1.477235713818426,1.0342919436052844,-1371958100.0,-12.02230941082281,77.07053933241427,82.84087432937385,145.7029771478438,33.42527061873967,18.191861491360964,0.02033776439526898,2.9987208704722494,134.11771490478515,132.55113552856446,131.28499603271484,130.01885653686526,128.45227716064454,0.04,0.0,121.10997558398422,0.03486236584252489,0.05109490521374746,132.90142822265625,131.03142874581474,2.739946933897363
2023-07-20,0,132.03750228881836,125.26250076293945,134.86249542236328,128.38375043869019,131.22688007354736,0.4487447797598302,2.529093911040199,-0.566361372381655,2.995544009287238,129.43249893188477,2.0235003662109365,0.019431120381407194,127.83825016021729,134.24549942016603,0.6565261779417362,0.07228819678694154,1.0144489260104734,1.0047426538330808,0.9853030238635849,-0.014130501097925352,67.02528205085358,135.21506305096221,130.15687522888183,125.09868740680145,133.19607162475586,1.6148247813999208,131.23875059400285,2.43770281626413,132.80068552163235,131.52728815036258,5.058663017088963,3.7401063147817215,59820600,1.4920412165790515,1.1264128741938235,-1431778700.0,-62.34846082414567,77.07053933241427,82.84087432937385,29.220205468433836,28.94761563309094,22.863868759252917,-0.007452205716090395,3.2152407211025946,134.11771490478515,132.55113552856446,131.28499603271484,130.01885653686526,128.45227716064454,0.04,0.0,121.13099836758276,-0.03231568309211452,-0.00642199020101121,133.07000078473772,131.1785719735282,2.432129777794478
2023-07-21,0,130.28249740600586,127.73249816894531,134.86249542236328,128.7125015258789,132.2000026702881,0.6687482636793475,2.2936122673538986,-0.942803035015344,2.995578401840677,129.74124908447266,1.9343130493164096,0.01757616212796467,128.1447498321533,134.24549942016603,0.7351911724582634,0.033703279757192534,0.9983667812720042,0.9884844464610398,0.9749604092612331,-0.033960501783789176,55.67745542638727,135.08284983988358,130.4956253051758,125.90840077046802,133.19357136317663,1.6200612201383755,131.2583932876587,2.4281074452293456,132.61562539269931,131.66143728882182,2.822935381353053,2.915100965080717,133265000,1.5344304364073131,2.411918768117896,-1565043700.0,-61.975736667041225,77.07053933241427,82.84087432937385,-24.66892136548918,27.039259132062902,23.390192989598415,-0.07467083735464847,3.19629473732685,134.11771490478515,132.55113552856446,131.28499603271484,130.01885653686526,128.45227716064454,0.04,0.0,121.17101901459829,-0.03474898225638845,-0.032017892435197016,132.9557146344866,131.15285764421736,2.433404274735855
2023-07-24,1,129.78000259399414,127.85000038146973,134.86249542236328,128.84999990463257,132.2000026702881,0.6766280725016117,2.205658311979745,-0.8941676005428549,2.9955902395639744,130.14499855041504,1.8450630760192837,0.01688566482750115,128.28550052642822,134.24549942016603,0.7549818024477605,0.006897735687205082,0.9935453797226863,0.9839887835216197,0.9779033764559713,-0.033206046510107945,48.20649594694943,135.03444189098832,130.6231252670288,126.21180864306929,132.60071454729353,2.0164886919399008,131.1898216520037,2.457253925720894,132.03185763491996,131.39404391227978,-0.013431950235736874,0.2115244980690823,45591100,1.5559950407499075,0.8452268315131299,-1610634800.0,-73.15931006924062,77.07053933241427,82.84087432937385,-36.881239914061915,25.69069558983312,21.664416685596827,-0.09529090069283706,3.2044163674173434,134.11771490478515,132.55113552856446,131.28499603271484,130.01885653686526,128.45227716064454,0.02,1.0,121.18411947463453,-0.03563937252056093,-0.043658968991619224,132.17000034877233,131.0514292035784,2.4492379042248142
2023-07-25,1,129.13750076293945,127.85000038146973,134.86249542236328,128.84999990463257,132.2000026702881,0.6646289875692892,2.196374547651843,-0.886295384931775,2.995591462968003,130.14499855041504,1.8314129638671859,0.016812082124566516,128.28550052642822,134.24549942016603,0.7405936567355662,0.007510922249933512,0.988479069068121,0.9776866791312308,0.9796428441432858,-0.02675461478810781,47.02510282216438,135.03537452254974,130.6426254272461,126.24987633194243,131.78285816737585,2.1052843612536183,131.09857164110457,2.511364340756267,131.4661617931457,131.04568434486757,-3.0986318985480223,-0.734283967289658,39236700,1.5545001921825057,0.7416885475944085,-1649871500.0,-70.0838024974368,77.07053933241427,82.84087432937385,-57.29158594474862,25.059065034623877,21.131776084583937,-0.04110437142954589,3.050529702013083,134.11771490478515,132.55113552856446,131.28499603271484,130.01885653686526,128.45227716064454,0.02,0.0,121.19466267161756,-0.027855129844447157,-0.033168559125181026,131.37714494977678,130.96214348929269,2.360503492015103
2023-07-26,1,127.46249961853027,127.85000038146973,134.86249542236328,129.06875038146973,132.2000026702881,0.6667789198180982,2.183941276862456,-0.8713030293236099,2.9955930860127964,130.14499855041504,1.8200380039215105,0.01671483296238039,128.28550052642822,134.24549942016603,0.7278908372792179,0.002134069473330659,0.9755364819845324,0.964476026948926,0.9721724250252448,-0.051035802446240064,44.86954764371735,135.02675792375055,130.65887537002564,126.29099281630072,130.81500107901437,2.333678685951818,131.047500201634,2.5816244717827077,130.88978948936494,130.71406620691198,-4.245060601536588,-0.9795653441856397,53910100,1.5621938159518545,1.0122572844929645,-1703781600.0,-79.21717972528491,77.07053933241427,82.84087432937385,-100.79896492515999,23.285775491698974,25.306910710609188,-0.03436918474511453,3.04834931418793,134.11771490478515,132.55113552856446,131.28499603271484,130.01885653686526,128.45227716064454,0.04,0.0,121.20672222487302,-0.05326541579016375,-0.03523306384142623,130.60428728376115,130.94714300973075,2.402315469708205
2023-07-27,1,129.91750144958496,127.46249961853027,134.86249542236328,128.95625066757202,132.2000026702881,0.5773055994714352,2.2614579456927673,-0.9031306671647279,2.995582811769373,130.14499855041504,1.8690379905700667,0.017317385871917404,128.1447498321533,134.24549942016603,0.7075885034716761,-0.015543532568514144,0.9948588734108189,0.9851676129135064,1.0013681279080984,-0.01605605076197303,39.24079863832347,135.11179128048465,130.58887538909912,126.06595949771356,130.41928645542689,2.1939099762005743,131.0867859976632,2.55817083340892,130.03502245460356,130.26437086362964,-5.04702460715971,-0.557820330295598,52610700,1.5991746029400284,0.9874312059019109,-1651170900.0,-78.28515602224695,77.07053933241427,82.84087432937385,-36.52230974766761,28.73450468067524,22.552479503188223,-0.04472014171426852,3.1763246465520236,134.11771490478515,132.55113552856446,131.28499603271484,130.01885653686526,128.45227716064454,0.04,0.0,121.22161808046052,-0.013157945718117015,-0.052526600016931664,129.9500013078962,130.8378573826381,2.433462221540486
2023-07-28,1,131.06000137329102,127.46249961853027,134.86249542236328,128.95625066757202,132.2000026702881,0.5593980108370739,2.2525992935219534,-0.8951021328417759,2.9955840133906535,130.14499855041504,1.853550386428833,0.017246627651924185,128.1447498321533,134.24549942016603,0.7079504721829907,0.012626908798118007,1.003437695397552,0.9968643649760948,1.0134863512801295,0.005967831310925709,49.31520522878312,135.11619912491622,130.61100053787231,126.10580195082841,129.9539293561663,1.4478710654270948,131.31607178279333,2.3836465739085955,130.00991003480928,130.15610744155063,-2.087613592445533,0.4251463026739607,46317400,1.6749768418110929,0.8648051773220865,-1604853500.0,-42.12514241786814,77.07053933241427,82.84087432937385,28.500091566000304,26.589610624590197,20.221436821401607,-0.006348759521043273,3.289443922286594,134.16255548095702,132.62371646118163,131.37999725341797,130.1362780456543,128.5974390258789,0.04,0.0,121.23776161980146,0.017000051645132297,0.017313018496173387,129.50000217982702,131.20071520124162,2.387420088201453
2023-07-31,1,133.28249740600586,127.46249961853027,134.86249542236328,129.3100004196167,132.2000026702881,0.47838259551701395,2.190340394274577,-0.8520696079526808,2.995592315681154,130.2912483215332,1.7888624477386457,0.016752237421282668,128.1447498321533,134.24549942016603,0.7265742906277338,0.008095699716842554,1.0193758223531189,1.016709611788966,1.029435020156583,0.026987939143205075,51.681097623011645,135.12980636456845,130.74912557601928,126.36844478747012,130.1317858014788,1.7839395740590436,131.66392871311731,2.280436252028925,130.27788643727493,130.3296057674673,-2.425223570212397,2.5107555590485076,41901500,1.6506208323354352,0.7915241564902469,-1562952000.0,-28.178397652403405,77.07053933241427,82.84087432937385,82.61997125445956,27.53195676250455,19.465802748222956,0.011462014089576809,3.1730542423604264,134.16255548095702,132.62371646118163,131.37999725341797,130.1362780456543,128.5974390258789,0.04,0.0,121.25486286672252,0.03788811730122732,0.028307635967548078,130.03142874581474,131.55071476527624,2.479686654003882
2023-08-01,1,132.63750076293945,127.46249961853027,134.86249542236328,129.3100004196167,132.8362522125244,0.29555267275951824,2.250372238505411,-1.110361888360984,2.995584764669601,130.35750007629395,1.9111997222900414,0.017189846533971157,128.1447498321533,134.24549942016603,0.6945571088809577,0.019446931360078114,1.0131738401992954,1.0125270520585867,1.0189403300138056,0.027102894041793668,57.68304030490408,135.4136199385892,130.91287546157838,126.41213098456755,130.46821485246932,2.023126473195195,131.83089310782296,2.2583575190071032,131.02398228498512,130.78567695809699,0.9429102305072404,3.7924633583716796,42098500,1.7150638479385214,0.7849888377509175,-1605050500.0,-47.05877243398108,77.07053933241427,82.84087432937385,44.78141535832657,26.216358184109637,20.29006081139842,-0.003369650103360616,3.094265176778875,134.16255548095702,132.62371646118163,131.37999725341797,130.1362780456543,128.5974390258789,0.04,0.0,121.27060774308283,0.019824962919477773,0.022437882928365318,130.27285766601562,131.6142861502511,2.482812618424452
2023-08-02,1,128.8524990081787,127.46249961853027,134.86249542236328,129.3100004196167,132.8362522125244,0.18062979487408826,2.2808762376101352,-1.2335348845004133,2.995580860733324,130.35750007629395,1.9982749652862537,0.017410238964425104,128.1447498321533,134.24549942016603,0.7138554664325876,0.017041750042632527,0.9835486739281778,0.9836706850664386,0.9845688832446365,0.010905163430878995,55.62376889989531,135.5695027002874,131.00775022506713,126.44599774984687,130.33571434020996,2.104449699873769,131.46821444375175,2.302597227332136,131.41082725903632,131.0870589995776,1.807612997772509,1.7939382498584566,51027600,1.7210474051483755,0.9382482102252904,-1656078100.0,-80.0758307286728,77.07053933241427,82.84087432937385,-77.55953446547862,23.385169311719594,28.742951069253863,-0.006739839054303723,3.2211035746219623,134.16255548095702,132.62371646118163,131.37999725341797,130.1362780456543,128.5974390258789,0.04,0.0,121.2829024914466,0.0004683013674686709,-0.0071245886638061015,130.1885724748884,131.17928641183036,2.5527709187105105
2023-08-03,1,128.16000175476074,127.46249961853027,134.86249542236328,129.06625032424927,132.8362522125244,0.23213904679989422,2.3261514748539818,-1.3060448384566667,2.995574653577817,130.2912483215332,2.0685875511169427,0.017766425837923858,128.1447498321533,134.24549942016603,0.6407928082297363,0.005266128909253716,0.9788464728880469,0.9824830502695349,0.9772016908483472,-0.01352781322927632,45.58887435640745,135.58192807940767,130.9296251296997,126.27732217999171,130.19607162475586,2.226123689947167,130.98946489606584,2.238469839820768,130.75614661621,130.86640711240145,-0.7146737303720412,-3.7911605207402124,88585200,1.8614354948097105,1.560057270359419,-1744663300.0,-71.65990214611364,77.07053933241427,82.84087432937385,-79.37602234137104,21.61467754485264,27.471803327952994,0.01293493594632356,3.236024224704769,133.65832434082031,132.2158436279297,131.0500030517578,129.88416247558592,128.4416817626953,0.04,0.0,121.30404714093773,0.005146227384868363,0.005930626623665019,130.15714372907365,130.76714433942522,2.528138605413914
2023-08-04,0,140.89500427246094,127.46249961853027,134.86249542236328,129.06625032424927,132.8362522125244,0.2313690251970494,2.32718948540873,-1.3062070566218342,2.995574510133043,130.2912483215332,2.0693749618530264,0.017774472614612728,128.12900161743164,134.24549942016603,0.653676974150333,-0.009333863200313604,1.0761196759776344,1.08333064124481,1.077191284355053,0.07504198684660035,42.81088869980239,135.58312919969927,130.92875022888182,126.27437125806436,132.11500086103166,4.300241816606224,131.46500097002303,3.3916618726538807,130.10497012506025,130.68935081693908,-0.7569443441321723,-4.969872199540446,152938700,1.8473963426645,2.4535436633094725,-1591724600.0,-23.173496395634523,77.07053933241427,82.84087432937385,246.2074235524318,40.295153507492024,20.350884695462042,-0.10210974247645231,4.056308295847534,139.49528387451173,136.93736325073243,134.87000274658203,132.80264224243163,130.24472161865233,0.02,1.0,121.40392673699459,0.05566901321077977,0.08826516432139377,131.78857421875,131.19643075125558,3.1814678815481625
2023-08-07,0,141.17499923706055,127.46249961853027,140.89500427246094,129.06625032424927,133.44437313079834,1.1266391303485304,3.150878996177375,1.4793862735504923,2.995447693949009,130.68000030517578,2.5341375732421882,0.023960123120224445,128.12900161743164,134.37200050354005,0.17826522344815324,0.10203366329345684,1.073532296010502,1.0766977830568791,1.0633409926193034,0.059216341115011506,69.19069775538289,137.80688341960087,131.5051254272461,125.20336743489135,133.72321483067103,5.324512180990009,132.07125064304896,4.271442065764754,132.8053867908091,132.13059742447263,10.538397327944658,4.95949721444332,71213100,3.370478544074857,1.1339667410775065,-1520511500.0,-8.047964145338188,77.07053933241427,82.84087432937385,209.57770727878264,37.726717678143984,19.71066309016999,-0.04097566320023821,4.023000298850611,139.49528387451173,136.93736325073243,134.87000274658203,132.80264224243163,130.24472161865233,0.02,0.0,121.4510282152549,0.06388396927604756,0.07571283562899943,133.78428867885046,131.86714499337333,3.8579042440838283
2023-08-08,0,139.95499801635742,127.46249961853027,141.17499923706055,129.61937713623047,134.00687503814697,1.1226502401571758,3.673074391047871,0.7653670798332297,2.9953499596429736,131.5487518310547,2.8482623195648187,0.027790241122669486,128.38725051879882,135.46574630737305,0.4074866205552331,0.09938673273768356,1.0588903809507986,1.0581968381415547,1.0417658917943173,0.05516914305024789,69.35726755047651,139.51752415212138,132.17137537002563,124.82522658792989,134.99392863682337,5.635334957611582,132.47392899649483,4.73956796847045,134.90451617269787,133.43519149602156,8.665112599817128,6.396604938937102,51710500,3.3716160524075773,0.822264173385231,-1572222000.0,-21.06165263444845,77.07053933241427,82.84087432937385,149.6719298209767,35.17120644652407,19.32026933525387,-0.03760578775616769,4.007071924058267,139.49528387451173,136.93736325073243,134.87000274658203,132.80264224243163,130.24472161865233,0.02,0.0,121.48250231727509,0.06264712466438538,0.046828322176884166,134.8885737827846,132.1942879813058,4.155000503041938
2023-08-09,0,138.81000518798828,127.46249961853027,141.17499923706055,129.88312673568726,134.25749969482422,0.9008192268074604,3.9346136238629725,-0.07428802141776192,2.9952967467151277,132.3375015258789,3.0666992950439464,0.02963960885735513,128.78324928283692,140.04899864196778,0.5471675212952509,0.07409822590812996,1.045661569996814,1.0410249373212224,1.0221085339182603,0.07727833186361055,65.44039999997676,140.61772749949597,132.74850025177003,124.87927300404408,135.78357260567802,5.741815634892381,132.9576792035784,5.028417340965965,136.18324489951692,134.34080059666059,6.786965168519474,4.197142519338038,50017300,3.384020445708381,0.7978810504426987,-1622239300.0,-32.99085256721225,77.07053933241427,82.84087432937385,106.16713755692555,33.12370394700207,20.58198462586635,-0.08581144040648986,3.950852588104327,139.49528387451173,136.93736325073243,134.87000274658203,132.80264224243163,130.24472161865233,0.02,0.0,121.51066514266368,0.07518913411464445,0.046776547557968104,135.48428998674666,132.75785936628068,4.289998961819804
2023-08-10,0,138.88250350952148,127.46249961853027,141.17499923706055,129.88312673568726,134.45374965667725,0.6537929330401394,4.103348402160643,-0.6307111973956481,2.995260599281853,132.66250228881836,3.2898995208740245,0.030811933149377073,128.78324928283692,140.04899864196778,0.6392617649580856,0.03643698104750852,1.0428649956947948,1.0327794684858393,1.0078629148432012,0.0836649626088386,60.97855393295168,141.3806973536377,133.17400054931642,124.96730374499514,136.67571585518974,5.6560417309596955,133.5719653538295,5.1988817819783275,136.8571802102481,134.95243898687121,4.147212041761566,5.129226758891404,58928400,3.319537580638295,0.9417162041270439,-1563310900.0,-28.938390912313373,77.07053933241427,82.84087432937385,100.88384313718615,31.507643283639236,19.474796717814062,-0.1289671540086935,3.8772201295929674,139.49528387451173,136.93736325073243,134.87000274658203,132.80264224243163,130.24472161865233,0.02,0.0,121.54450093952818,0.07485837888716773,0.08072685674079376,136.46571786063058,133.36928776332311,4.462074708190082
2023-08-11,0,138.0349998474121,127.46249961853027,141.17499923706055,129.88312673568726,135.84937286376953,0.5176921197903604,4.286831395136996,-0.9935142437249569,2.995218793238115,132.66250228881836,3.576200027465819,0.032129959235166775,128.78324928283692,140.04899864196778,0.6712539246082847,0.02980819889598153,1.0345774091219815,1.0196792427760468,0.9863623378764931,-0.02029883486513251,60.70033410159011,141.9952884998077,133.42162570953369,124.84796291925966,137.98750168936593,4.482267004301165,134.16160801478796,5.203852344850214,137.3697006427899,135.49104186833642,4.708323596765902,6.601044863850741,42832100,3.3158773967122377,0.6908655057426287,-1606143000.0,-29.794520249679714,77.07053933241427,82.84087432937385,83.15083135887214,30.115504311664345,19.54352366218821,-0.10004147350126318,3.7667045368402308,139.49528387451173,136.93736325073243,134.87000274658203,132.80264224243163,130.24472161865233,0.02,0.0,121.5681981327184,-0.008311267473209427,0.07369482375394845,137.92286028180803,134.05571637834822,4.603856073015547
2023-08-14,0,139.3025016784668,127.46249961853027,141.17499923706055,129.88312673568726,138.22875118255615,0.42829714846057365,4.394555406392051,-1.1926466854769322,2.99519349421865,132.66250228881836,3.7665502929687475,0.03289824188658746,128.78324928283692,140.04899864196778,0.7017924434040828,0.028289417129599963,1.0428375505196918,1.0237674462259903,0.9995049240294678,-0.013263662608203441,58.68875249040498,142.3693617435702,133.58025093078612,124.79114011800203,139.57928739275252,1.1516150192381462,134.8876795087542,5.157874088997041,137.53716453505538,135.81428005699507,7.1263661239900005,6.36076212699967,47148700,3.3192025654063606,0.7612897006773405,-1558994300.0,-17.465735230462528,77.07053933241427,82.84087432937385,94.47658140402721,30.896700045675317,18.472174824548386,-0.03486373413742687,3.7005110940581147,139.49528387451173,136.93736325073243,134.87000274658203,132.80264224243163,130.24472161865233,0.02,0.0,121.59637340037541,-0.011601700761652012,0.007164863133359426,139.5885750906808,134.87285940987724,4.878192079660573
2023-08-15,0,139.05749893188477,127.46249961853027,141.17499923706055,129.88312673568726,138.82812976837158,0.31307859102159014,4.567667950900388,-1.4162032372662738,2.99515176004651,132.66250228881836,4.070450439453123,0.034129481146102765,128.78324928283692,140.04899864196778,0.711804925439024,0.04985396268368728,1.0390335591457416,1.0174653460782292,1.0004352416470736,-0.006412769084300662,62.35503108094409,142.96883695465718,133.83350105285643,124.69816515105569,139.31678662981307,1.0013414878508384,135.71589374542236,4.791808721037681,137.98116515920267,135.92121936082017,8.694210183476489,7.871455507093527,42781500,3.3005981946093934,0.6976387517400608,-1601775800.0,-34.61095407299762,77.07053933241427,82.84087432937385,71.09983403100316,29.820490429704932,17.037796498459475,-0.07054805861630437,3.725474805322379,139.56608459472656,137.0519644165039,135.02000427246094,132.98804412841798,130.4739239501953,0.02,0.0,121.62057720503797,-0.016221267920953464,-0.03199270856914789,139.31714521135603,135.55285971505302,4.951479780153936
2023-08-16,0,136.13500213623047,127.46249961853027,141.17499923706055,129.88312673568726,138.9262523651123,0.15371395372062763,4.696912882278237,-1.5764333807316535,2.9951202800113115,132.95999908447266,4.30620044708252,0.03501187350142809,128.78324928283692,140.04899864196778,0.7384721692721471,0.03528950305117558,1.014781749922181,0.9914246772991169,0.9806760699519798,-0.01927096716216603,60.7392037481126,143.5458265732723,134.15200080871583,124.75817504415934,138.59678704398019,1.2286924823039322,136.1600009373256,4.491801613053437,138.24617803949792,136.04767145393947,-1.3041664252501302,9.096792662984017,41675900,3.2888064903748373,0.6868084375663825,-1643451700.0,-49.709622251956084,77.07053933241427,82.84087432937385,24.83226392081185,28.267920695450606,20.495918514208075,-0.13238192389468184,3.649369723664306,139.56608459472656,137.0519644165039,135.02000427246094,132.98804412841798,130.4739239501953,0.02,0.0,121.64004417531521,-0.020166838274996435,-0.03480059334161151,138.29571751185827,136.04000309535436,4.947578138782405
2023-08-17,0,134.76499938964844,127.46249961853027,141.17499923706055,129.88312673568726,138.9262523651123,0.09768718160063396,4.716776181337518,-1.6084557070164212,2.9951155294300964,132.95999908447266,4.406163005828859,0.03513613777301696,128.78324928283692,140.04899864196778,0.7544972056779766,0.031032848822369064,1.0038893946823897,0.976269673752238,0.9745629287870585,-0.029647392694003072,53.47397161813301,143.67642822479667,134.2428758621216,124.80932349944652,137.85535866873605,1.734356683302913,136.4246436527797,4.271976623499595,137.70352304384525,135.78451696834733,-3.57003515358051,4.785729880325812,48354100,3.317815971689309,0.804464290096337,-1691805800.0,-56.03953816026158,77.07053933241427,82.84087432937385,3.6948933461800446,26.82065675241865,22.406451011413935,-0.1214489172500589,3.571557426159265,139.56608459472656,137.0519644165039,135.02000427246094,132.98804412841798,130.4739239501953,0.02,0.0,121.6605732991263,-0.03305428631461915,-0.028074067498194074,137.4442879813058,136.1664308820452,4.858119497913443
2023-08-18,0,132.51499938964844,127.46249961853027,141.17499923706055,129.88312673568726,138.9262523651123,0.017360468309571307,4.690397260654367,-1.5864144013550319,2.99512307087296,134.02374839782715,4.322000503540039,0.03490417780738008,128.78324928283692,140.04899864196778,0.743449263934223,0.034406018251811166,0.9861269405986014,0.9553987308938473,0.9640329044092354,-0.039989861005293115,50.86742524001203,143.76004523847178,134.37925071716307,124.99845619585436,136.95607212611608,2.5818285471851294,136.36982236589705,4.320054803174773,136.95334809533412,135.4955811331802,-3.7083338932293053,2.826947945624294,48469400,3.3068760907218335,0.867578915620328,-1740275200.0,-60.45297865364678,77.07053933241427,82.84087432937385,-26.058615907908,25.233701021915703,25.903359651259706,-0.12103227651345144,3.525018569128915,139.56608459472656,137.0519644165039,135.02000427246094,132.98804412841798,130.4739239501953,0.02,0.0,121.67834507912553,-0.037497307305014105,-0.0385392352192592,136.7828587123326,136.13357434953963,4.766058728400544
2023-08-21,0,134.0800018310547,127.46249961853027,141.17499923706055,129.88312673568726,138.9262523651123,-0.022713609905663023,4.6175717174690085,-1.5260670264599574,2.9951425471660666,134.02374839782715,4.21037540435791,0.03433371735770804,128.78324928283692,140.04899864196778,0.7189083531903322,0.021074100331239052,0.9969449675838858,0.9725579595630595,0.9833156212164612,-0.037490352179507136,45.47020789458037,143.72601925128325,134.4908758163452,125.25573238140717,136.27000045776367,2.6223657897248427,136.4728581564767,4.240661956922358,135.8368713197271,135.0237209286558,-4.534979873975664,-0.5758430636390803,41442500,3.350153028684993,0.7445652842764359,-1698832700.0,-51.97451552018998,77.07053933241427,82.84087432937385,-8.033895268109351,26.256779344981872,24.57347856411833,-0.06974774632055218,3.4503740804439245,139.56608459472656,137.0519644165039,135.02000427246094,132.98804412841798,130.4739239501953,0.02,0.0,121.69537317153878,-0.04190093434976094,-0.02694899853795206,136.22857230050224,136.3471450805664,4.586615365346312
2023-08-22,0,134.67749786376953,127.46249961853027,141.17499923706055,130.7743763923645,138.9262523651123,-0.11074191468474186,4.491610861162073,-1.4066910252708917,2.9951755183596966,134.42250061035156,3.9953754425048826,0.03334383771467991,128.78324928283692,140.04899864196778,0.6938278714261832,0.038273166500165524,0.9997893342494173,0.9819454217610175,0.995321852551329,-0.0314977696403177,50.08916258777393,143.68909750052242,134.70587577819825,125.72265405587407,135.7903573172433,2.551837667296405,136.8889295033046,3.6848088327411714,135.40410234487945,134.89559132924913,-3.457960187287053,1.0875514540140423,32935100,3.359130520965098,0.5950880943624179,-1665897600.0,-54.471569209502626,77.07053933241427,82.84087432937385,-7.182747125104309,26.162416205416527,23.56479499729503,-0.08884632263610229,3.3410615153368797,139.56608459472656,137.0519644165039,135.02000427246094,132.98804412841798,130.4739239501953,0.02,0.0,121.7092507369853,-0.024842000540657883,-0.044959856263234885,135.63428606305803,136.77857317243303,4.404603150391288
2023-08-23,0,134.79750061035156,127.46249961853027,141.17499923706055,132.15124988555908,138.9262523651123,-0.21077534655572328,4.306685437571396,-1.2252417831140872,2.9952219997279186,134.72124862670898,3.740163211822511,0.03190542072368525,128.78324928283692,140.04899864196778,0.6362350590576128,0.05660487019187841,0.9986266774802467,0.9866167467894739,1.0027002033551777,-0.009824817312894085,52.769848209558035,143.59624650838256,134.98287563323976,126.36950475809697,135.14678573608398,2.0339849494367606,137.36303656441825,2.794838922555789,135.2320559403227,134.88372461697514,-2.432355552833744,4.520672009024123,42801000,3.328415719682778,0.7811903968391001,-1623096600.0,-64.98392204330655,77.07053933241427,82.84087432937385,-7.913195537474649,24.615245228628964,23.27598990975707,-0.08137849766137958,3.2974139590656066,140.68472229003908,138.86264068603515,137.38999938964844,135.91735809326173,134.0952764892578,0.02,0.0,121.72773595975006,0.003331583059457577,-0.015617011150432023,134.91285705566406,137.25071607317244,4.1127956348147965
2023-08-24,0,134.21249771118164,128.16000175476074,141.17499923706055,132.6068754196167,138.9262523651123,-0.20750597435284404,3.948031064231783,-1.1200357385404591,2.9953058814775186,134.78125,3.410088167190551,0.029169131752778785,129.81100120544434,140.04899864196778,0.6198283400914308,0.03756229227253347,0.991598587983436,0.9852284346276744,1.000339113897972,-0.0040997416314998425,51.431536879513494,143.24568781129435,135.3496256828308,127.45356355436726,134.45464270455497,1.0838474084035408,136.885714667184,2.714717895875296,135.10546127442234,134.9875898247309,-3.2339699673976576,5.179072069842772,43646300,3.2924351127907734,0.8031892536865187,-1666742900.0,-93.9420326744412,77.07053933241427,82.84087432937385,-41.88259877982403,22.067051643124497,23.77338977005734,-0.08284074840426026,3.4154556011496493,139.85195343017577,138.1890135192871,136.8449935913086,135.5009736633301,133.83803375244142,0.02,0.0,121.74451560585024,-0.015972529167714966,-0.02391360636099534,134.07999965122767,136.69857243129186,3.8632154487636057
2023-08-25,0,132.5449981689453,128.16000175476074,141.17499923706055,133.12124824523926,138.9262523651123,-0.2624800062841267,3.7590006808786067,-0.8896335207818469,2.9953467998324483,134.78125,3.2168133354187005,0.027728528731296363,130.83925113677978,140.04899864196778,0.5959512920049544,0.024053840262915478,0.9777273541376923,0.9763346713431539,0.9887248934732342,0.00022638025457522026,48.71167653384008,143.08237685766784,135.56437549591064,128.04637413415344,133.9417849949428,1.0025238524860955,136.2692860194615,2.6447348276681306,134.8666169541308,135.04875608701764,-3.484171121958965,-4.742898157238245,44147500,3.2905742333822685,0.8140377183563178,-1710890400.0,-74.95333233509452,77.07053933241427,82.84087432937385,-62.93847346283374,20.54473968759918,24.754409031015417,-0.08153413798004579,3.406494007219875,138.7547994995117,137.19259994506837,135.93000030517578,134.6674006652832,133.10520111083986,0.02,1.0,121.76012253539021,0.0003002048173423866,-0.005373945690872504,133.82142639160156,136.0585719517299,3.8244877719009445
2023-08-28,1,133.18000030517578,128.16000175476074,141.17499923706055,133.12124824523926,138.9262523651123,-0.2755997928231454,3.6831964026428756,-0.7799384930145119,2.995362568833561,134.78125,3.1499884796142568,0.027154480469905214,132.14874935150146,140.04899864196778,0.5960181074201862,-0.005533353976808918,0.9818737102028814,0.9849954276673909,0.9934172573470808,-0.006712421789887291,41.905044819322256,143.0050181409791,135.63862533569335,128.2722325304076,133.71535655430384,0.9638524741562795,135.78535761151994,2.5360582597211243,134.27938841160716,134.90588288846283,-2.6370910573701205,-6.112981133170589,34108400,3.277235688071201,0.6334777591702111,-1676782000.0,-76.07478234828552,77.07053933241427,82.84087432937385,-53.667237749772376,19.787080380962877,23.633687024668617,-0.10387148659516186,3.313172352756066,138.7547994995117,137.19259994506837,135.93000030517578,134.6674006652832,133.10520111083986,0.02,0.0,121.77260585687065,-0.011434462205830997,-0.0006005241729592085,133.70142691476005,135.57285744803292,3.839554702607359
2023-08-29,1,134.17000198364258,128.16000175476074,141.17499923706055,133.0443754196167,138.9262523651123,-0.2724585930192034,3.686540978652472,-0.7879615258921793,2.9953618789366585,134.78125,3.154600849151612,0.027180165413325432,132.14874935150146,140.04899864196778,0.5970064528613728,0.004090091709477605,0.9892099039557115,0.9968312872080114,1.0021474281855471,-0.0037682306857252934,44.736803360380755,143.0065824379568,135.63350048065186,128.2604185233469,133.95178549630302,0.8112361126698434,135.45392881120955,2.41045382902701,134.00063628071288,134.8734308876165,-1.1761207224807089,-4.840840132332969,38646100,3.2772384491620135,0.7200626340704674,-1638135900.0,-59.53268162598844,77.07053933241427,82.84087432937385,-26.06791591166623,21.549314620498603,22.584961197845043,-0.04039830731877422,3.219374327559203,138.7547994995117,137.19259994506837,135.93000030517578,134.6674006652832,133.10520111083986,0.02,0.0,121.78854620833322,0.004916228395600575,0.0017078333741956506,133.94285583496094,135.36285727364677,3.7408041001367005
2023-08-30,1,134.89999771118164,128.16000175476074,141.17499923706055,133.85500144958496,138.9262523651123,-0.321784222317829,3.639093797144567,-0.6675423473101567,2.9953716099069743,134.78125,3.08563829421997,0.026815197337848765,132.14874935150146,140.04899864196778,0.5466777621807072,0.041268140054670936,0.9940304540484968,1.005907546525666,1.008364401203193,0.0007603783480107928,51.445677427058236,142.98831313597614,135.710125541687,128.43193794739787,134.06892776489258,0.8883725739907534,135.16946411132812,2.200569375434367,134.0457670592518,134.95267777841573,1.2489171804074453,-3.342700836342321,36137000,3.1560026184244894,0.6827842830944524,-1601998900.0,-58.037319871369796,77.07053933241427,82.84087432937385,-25.444733565860187,21.91785320090204,21.67352547948848,-0.021585618305479067,3.1151329117932547,138.7547994995117,137.19259994506837,135.93000030517578,134.6674006652832,133.10520111083986,0.02,0.0,121.80395235742748,-0.003320520469712207,0.006108062005353817,133.99857221330916,135.11357225690568,3.319365046770858
2023-08-31,1,136.71499633789062,128.16000175476074,141.17499923706055,134.1475019454956,138.9262523651123,-0.25982177637279325,3.2913578253424713,-0.41162551021354465,2.9954387903967756,134.8487491607666,2.8135008525848377,0.02419893622868133,132.54199829101563,140.04899864196778,0.4145509345555875,0.052590479589085436,1.0051649360065482,1.020381103388595,1.021774772179737,0.018645794314134934,54.630359251740636,142.59521612752206,136.01250047683715,129.42978482615223,134.35999897548132,1.339993728943,135.0751781463623,2.094048149714768,134.28241594746225,135.2234036808086,0.6115720979480411,-2.867536009002611,58781300,3.1489122423149927,1.1428103160554979,-1543217600.0,-30.56079630936847,77.07053933241427,82.84087432937385,22.764324700154745,27.064577516744006,19.81873664119429,-0.02800625280729559,3.1633372242460807,138.7547994995117,137.19259994506837,135.93000030517578,134.6674006652832,133.10520111083986,0.02,0.0,121.83347243033532,0.046799137896911924,0.018373599143111832,134.53571428571428,135.08500017438615,2.9038505441967217
2023-09-01,0,138.6050033569336,132.51499938964844,141.17499923706055,134.20187377929688,138.9262523651123,0.24587214910493027,2.7552957584221236,-1.3257193927621138,2.9955286859793233,135.51749992370605,2.486525516510011,0.020194156447692343,133.11650009155272,140.04899864196778,0.8293438868465052,-0.029667538293175158,1.015865942400953,1.032983894248358,1.0320397647895514,0.045720361173222424,49.53415284286879,141.95084172283788,136.44025020599366,130.92965868914945,134.90392793927873,2.102821226197083,135.02535683768136,1.9915232088129566,134.92056731780366,135.74135339395187,1.5128722365944804,-0.9562817480933492,40948300,1.276973575358464,0.8933610915820401,-1502269300.0,-29.5327529287614,77.07053933241427,82.84087432937385,56.95021742584342,27.825659363692704,18.437807463178938,0.10734818474182772,3.1573846961609813,138.7547994995117,137.19259994506837,135.93000030517578,134.6674006652832,133.10520111083986,0.02,0.0,121.85536922535594,0.036470064615695685,0.047633487209768774,134.90714154924666,134.90999930245536,2.8375417860757803
2023-09-05,1,137.15500259399414,132.51499938964844,141.17499923706055,134.20187377929688,138.82812976837158,0.20066220540839425,2.611629869733847,-1.3017959377883088,2.99554898913183,135.51749992370605,2.360575466156007,0.019157274885078717,133.11650009155272,139.36775131225585,0.765027952412471,-0.018204327211020027,1.0060828745325243,1.0175590454896146,1.012109469543873,0.029846840964933286,56.84704419572403,141.54900989968496,136.3257501602173,131.10249042074963,135.32428577968054,2.2317220181933766,134.88946424211775,1.7448567717339616,135.83853909421265,136.0989135211645,2.82460930606427,-0.5007076779878258,40636700,1.3581775012455073,0.9171536902240156,-1542906000.0,-28.67804947879387,77.07053933241427,82.84087432937385,27.8304898970055,26.349198021456086,19.90491031311508,0.0663234315865063,3.0961420602186784,137.74632556152343,136.3768448486328,135.27000427246094,134.16316369628908,132.79368298339844,0.02,0.0,121.87525616219342,0.03102001578598168,0.030091624875605825,135.682856968471,134.88142830984933,2.489918079968347
2023-09-06,1,135.93500137329102,132.51499938964844,139.95499801635742,134.20187377929688,138.65625381469727,0.0978085722072196,2.3746224528213635,-1.3941113098520805,2.9955801931556305,135.51749992370605,2.1405008316040037,0.01744445772791844,133.11650009155272,139.08199920654297,0.7705986816566315,-0.02000639821406041,0.9986060657278295,1.006212273228949,0.9972562411700696,0.013154947928402105,51.74226119731701,140.8739952337067,136.12475032806395,131.3755054224212,135.8085719517299,1.8659359240945474,134.87517847333635,1.73466363581824,136.16944737247016,136.22376413553914,2.1924224144495237,-1.368136456145047,41785500,1.3687752992790807,0.9537639443653106,-1584691500.0,-49.040551268203174,77.07053933241427,82.84087432937385,-2.048627380994877,24.612556147926412,21.401105108041353,0.029454075470631287,3.077845937195246,137.74632556152343,136.3768448486328,135.27000427246094,134.16316369628908,132.79368298339844,0.02,0.0,121.89408730235239,0.0033355343267889026,0.016674186802465383,135.98285784040178,134.90214211600167,2.319766702795687
2023-09-07,1,135.73500061035156,132.51499938964844,139.3025016784668,134.20187377929688,138.17750072479248,0.1343508759922754,2.206057847502121,-1.2993935469867601,2.995600651176374,135.41749954223633,1.9395009994506835,0.01623011312926133,133.11650009155272,138.9000030517578,0.7713128598707706,-0.020711790989444107,0.9986113546391235,1.0037974774354288,0.9932168440206964,0.006189791796421318,47.95692035495547,140.33586619091489,135.92375049591064,131.5116348009064,136.17357199532645,1.4749999918296477,134.94446427481515,1.7492350074642387,136.1159797607555,136.1547422137335,2.5576243926041755,-0.1469135489044266,48498900,1.371751879522167,1.108920530551625,-1633190400.0,-22.49466430681537,77.07053933241427,82.84087432937385,21.286765544241668,21.94192986514512,22.30963022814797,0.11139710769928711,3.205856592908979,137.74632556152343,136.3768448486328,135.27000427246094,134.16316369628908,132.79368298339844,0.02,0.0,121.91672605321861,0.020581910332053477,0.021792323486771757,136.6557159423828,135.17857142857142,2.319766702795687
2023-09-08,1,137.67250061035156,132.51499938964844,139.3025016784668,134.20187377929688,137.37500190734863,0.24532136690166564,2.1043550347392412,-1.0833255343743458,2.9956123007368296,135.3174991607666,1.7892507362365735,0.015499410993595432,133.11650009155272,138.9000030517578,0.7408094749739288,-0.0226630628022495,1.0140126709846133,1.0174204355741645,1.0061646270205273,0.0070036521091985104,47.08884985932266,139.9787103365073,135.77000026702882,131.56129019755033,136.67392894199915,1.260538544830543,135.31285721915108,1.7412991614803406,136.03108846666976,136.04960098294458,1.9184564494076564,0.7197723630736963,38348200,1.3707610318818606,0.8979534014069378,-1594842200.0,-18.443604325815645,77.07053933241427,82.84087432937385,83.0734596431729,22.762526297260557,21.239404353784607,0.15089744247191558,3.126867272238025,137.74632556152343,136.3768448486328,135.27000427246094,134.16316369628908,132.79368298339844,0.02,0.0,121.9365515531571,0.001594096293455305,0.023395189397859093,137.1300005231585,135.5364281790597,2.3004800604954854
2023-09-11,0,141.0275001525879,132.51499938964844,139.3025016784668,134.20187377929688,137.2843770980835,0.22362765172066248,2.0300840871213146,-1.0034540783301105,2.995620503547316,135.3174991607666,1.7252506256103515,0.014959041815755416,133.11650009155272,138.6502529144287,0.7056766489020515,-0.002626140018555178,1.0391866451923708,1.0395562464251251,1.0292437875619076,0.017477700926971096,55.74064959510448,139.76966829631294,135.70950012207032,131.6493319478277,137.54928643362862,1.8246798643851059,135.80910709926061,2.272022349677412,136.4422242071634,136.17674220520004,2.6104930870732144,3.892013164138466,56764500,1.437301331106656,1.3078520543987382,-1538077700.0,-3.9876478634758934,77.07053933241427,82.84087432937385,198.11104437192463,30.45832313077446,18.75282351237988,0.1898352587700509,3.2885195663387696,140.54255670166015,138.63871768188477,137.0999984741211,135.56127926635742,133.65744024658204,0.02,1.0,121.9728328573147,0.036055684639308305,0.03688147090265675,138.27714320591517,136.13785770961218,2.769461772617815
2023-09-12,0,141.79000091552734,132.51499938964844,141.0275001525879,134.20187377929688,137.2843770980835,0.5336370928197165,2.2896533631082674,-0.5294303699498077,2.995590668643738,135.3174991607666,1.8872880935668945,0.016853143731006954,133.11650009155272,139.08199920654297,0.5828517993375399,0.01238311195661565,1.0436546001028875,1.0386822923863117,1.0311625018299477,0.03379386995641509,64.66837546953428,140.43843186354565,135.8591251373291,131.27981841111256,138.27428708757674,2.365902835442065,136.317143031529,2.7454053435847237,137.58660656093946,136.69623284832656,4.542255407983859,5.181606672624666,42668500,1.601818584454431,0.9881808992762311,-1495409200.0,-18.32822561488622,77.07053933241427,82.84087432937385,178.2910608210189,28.781927947529976,17.720687144484298,0.1132172412904846,3.23148284682629,140.54255670166015,138.63871768188477,137.0999984741211,135.56127926635742,133.65744024658204,0.02,0.0,121.99977962488886,0.028848192116451843,0.02251665740150723,138.73714338030135,136.6364288330078,2.8293633414036785
2023-09-13,0,142.9124984741211,132.51499938964844,141.79000091552734,134.20187377929688,137.2843770980835,0.7676152828941551,2.528431463709293,-0.16246031653408366,2.9955602060059054,135.3174991607666,2.028950424194335,0.0185936636567314,133.11650009155272,139.25449905395507,0.6379084810293993,0.01965015914014859,1.0509546994296013,1.0403434353574383,1.0323660549438975,0.05132965778011189,66.76190644442501,141.04036302660072,135.98350009918212,130.92663717176353,138.88964353288924,2.953471519315737,136.89678573608398,3.216183327202282,138.62806253934775,137.1548535735534,3.712105265390099,5.281136911937828,60465200,1.6064941920048572,1.3722436637343514,-1434944000.0,-0.9027061050017059,77.07053933241427,82.84087432937385,204.34896952644158,30.510182062452746,16.141476915277945,0.2132150161584935,3.294234115649524,141.58159716796874,139.47919805908202,137.77999877929688,136.08079949951173,133.978400390625,0.04,0.0,122.04162969182254,0.07010937832722153,0.055219651745690115,139.69857352120536,137.302857535226,3.431883703640685
2023-09-14,0,144.6525001525879,132.51499938964844,142.9124984741211,134.20187377929688,137.2843770980835,0.9559229155935978,2.8781748723489677,0.021417436676092194,2.995510370563267,135.3174991607666,2.2643751907348615,0.02113565963768605,133.11650009155272,141.10375022888184,0.7358536381213222,0.049785112069182444,1.0622447017857009,1.0463507650674855,1.0345068029875,0.06569786349974249,72.80328628507483,141.93259982099184,136.17625007629394,130.41990033159604,139.96071461268835,3.5239454337171088,137.64250019618444,3.717218776802346,139.68827713012192,137.74462892088096,3.107748647496441,6.020139711066982,64033600,1.4460478931104819,1.4172713007851436,-1370910400.0,-7.460729585875633,77.07053933241427,82.84087432937385,182.77009846512794,30.49303431033013,15.114436169801442,0.26695297709320776,3.2667890832537987,142.2539208984375,140.02304107666015,138.22000122070312,136.4169613647461,134.18608154296874,0.06,0.0,122.08770742928185,0.04983674147992878,0.0691489403675118,140.76285879952567,138.22285788399833,3.877395382841976
2023-09-15,0,141.68500137329102,132.51499938964844,144.6525001525879,134.20187377929688,137.90562629699707,0.9557182165796236,3.419762691012352,-0.16625315839029842,2.995421319791384,135.3174991607666,2.771300277709963,0.02503447652505659,133.11650009155272,141.90225067138672,0.7616844058534653,0.07336846219508039,1.0372093508576887,1.0177057959159768,1.0005225675422387,0.02914525954820757,77.75798036286345,143.44165035913647,136.60212497711183,129.76259959508718,140.7821431841169,3.0700904432961402,138.29535756792342,3.5520359387202483,140.92849077208075,138.60055154887996,5.466441191932183,7.77871108834633,102861700,1.417056497305062,2.1471441586422326,-1473772100.0,-39.04356434996553,77.07053933241427,82.84087432937385,95.57557071079444,27.49541000615612,19.70102034867096,0.19564390457635752,3.364161640365135,142.55364190673828,140.50818270874024,138.8550033569336,137.20182400512695,135.1563648071289,0.06,0.0,122.15095516836595,0.01562615733828787,0.018425775652309052,141.48143005371094,138.73214394705636,3.88558711251103
2023-09-18,0,140.3574981689453,132.51499938964844,144.6525001525879,134.20187377929688,139.21062755584717,0.7044668968987582,3.56343807241576,-0.7231817320757492,2.9953957275518417,135.8350009918213,2.9915007019042945,0.02602034946028334,133.11650009155272,141.90225067138672,0.8245159703310562,0.06919972852793073,1.0248953615885723,1.0045842467504653,0.9855631520776211,-0.004750860526618217,65.9063313592106,144.07500122112546,136.94812507629393,129.8212489314624,141.44249997820174,2.1682139170542625,138.80803598676408,3.263154051224449,141.11676358213776,138.99259130704908,4.229962807158054,6.895773760316188,42823500,1.497649957003951,0.8992001720141467,-1516595600.0,-46.29926217129016,77.07053933241427,82.84087432937385,64.42642542007673,25.991795895098065,20.50414748617389,0.15759377911312128,3.304578578860259,142.8628013305664,141.00860177612304,139.51000213623047,138.0114024963379,136.15720294189452,0.06,0.0,122.17575362123289,-0.021803006589109497,0.012660059712722351,141.78571428571428,139.22071511404855,3.8097626968283933
2023-09-19,0,137.68249893188477,132.5449981689453,144.6525001525879,134.56124782562256,140.52499866485596,0.5640949973265139,3.4846649774044156,-0.9254149947423898,2.995411857013172,136.32499885559082,2.998050308227539,0.025372496242123208,133.9900016784668,141.90225067138672,0.8639369978895576,0.04681903529357407,1.0024919782553763,0.9842039033353865,0.9676903496925007,-0.02896891146851499,59.490229246787905,144.3095799700677,137.3402500152588,130.3709200604499,141.44392830984933,2.16531783249949,139.05892862592424,3.0038498544457926,140.9298638507614,139.1765513587761,3.4055310257546236,5.389321104762448,61482500,1.526621097814357,1.2643958508608257,-1578078100.0,-64.80313153680073,77.07053933241427,82.84087432937385,-4.664928190640204,23.56704167627954,26.31619610220048,0.14583596261658505,3.384251406723477,142.8628013305664,141.00860177612304,139.51000213623047,138.0114024963379,136.15720294189452,0.06,0.0,122.20542293326007,-0.025490270860530684,-0.03822502437034306,141.7000013078962,139.41500091552734,3.747811809743773
2023-09-20,0,137.10249710083008,132.5449981689453,144.6525001525879,134.76749992370605,140.52499866485596,0.4904233276659712,3.4036511052488136,-0.8834457383319494,2.9954271624212963,136.93499946594238,2.8701628303527826,0.024750158719818078,134.0710018157959,141.90225067138672,0.8677975550161955,0.022312569774312903,0.9969613392207204,0.979688427782956,0.9692099256515074,-0.040654256522868804,49.82642222078059,144.32767708079788,137.5203748703003,130.7130726598027,140.88321358816964,2.7265794637595016,139.21625001089913,2.82141398032832,140.1151738688613,138.86475219105415,0.007262395532061218,2.617945066938596,46263700,1.6650947924305688,0.9385560700813634,-1624341800.0,-83.22842412715501,77.07053933241427,82.84087432937385,-24.3544169777921,22.627056370709063,24.037822127892007,0.11427382307090739,3.4403761754536086,142.8628013305664,141.00860177612304,139.51000213623047,138.0114024963379,136.15720294189452,0.06,0.0,122.22660864373769,-0.06599939533693111,-0.0420590711683211,140.58428519112724,139.4307141985212,3.7038486830415933
2023-09-21,0,130.7050018310547,132.5449981689453,144.6525001525879,134.87437343597412,140.52499866485596,0.43945807811876436,3.342868962554457,-0.8230531130397312,2.9954383371815876,137.1287498474121,2.761037864685059,0.024286758941060953,134.0710018157959,141.90225067138672,0.8616185742364566,0.017099697546628746,0.9496037408047349,0.9331955523800158,0.9316374139471659,-0.09642072073984598,47.97564969339333,144.32736275726225,137.64162483215333,130.9558869070444,139.29964229038782,4.6516172521443195,138.7869646889823,3.5851185179924103,139.35320389502687,138.50714376703866,-2.783147292202632,1.6326904573889967,70234800,1.67325568123592,1.3862831104701139,-1694576600.0,-99.87912828536419,77.07053933241427,82.84087432937385,-158.1350669332,19.958483160602366,32.819103388767495,0.013878458609346556,3.6217775720311414,141.95419989013672,139.5378994445801,137.58499908447266,135.63209872436522,133.2157982788086,0.02,1.0,122.24456766373497,-0.10634327846762626,-0.1071453477286685,138.88428606305803,138.8107147216797,4.136714440051738
2023-09-22,0,130.19499969482422,130.7050018310547,144.6525001525879,134.72812271118164,140.52499866485596,0.18801587273979303,3.624125596427379,-0.748757692901711,2.995385086271775,137.1287498474121,2.9452003097534174,0.026369359046282518,133.11650009155272,141.90225067138672,0.7149093893129884,-0.026133899152036517,0.9473067645248914,0.9329046004521332,0.9468279694853514,-0.08109539871616056,34.01475962574509,144.68525108604322,137.43699989318847,130.18874870033372,137.48285675048828,5.424667078346483,138.18625014168876,4.259168510731891,137.17886322057183,137.3398433561061,-7.817899014667926,-4.396002390244196,59904300,2.2173212247347935,1.1637097803466052,-1754480900.0,-96.53984445535615,77.07053933241427,82.84087432937385,-155.01663205744217,18.57382473518252,32.10367891596573,0.01758878891909689,3.613793067374341,141.7677614746094,139.23612200927735,137.19000244140625,135.14388287353515,132.6122434082031,0.04,0.0,122.25905768739544,-0.08027640374284328,-0.10779440279111845,136.63714163643974,138.16785757882255,4.369995792529188
2023-09-25,0,130.29500198364258,130.19499969482422,144.6525001525879,134.71749877929688,140.52499866485596,0.013519070064596276,3.8982551533305987,-0.7592804333491223,2.995328768473989,137.1287498474121,3.125987720489502,0.02840545922982972,132.36099853515626,141.90225067138672,0.7316387554887749,-0.017729816338491508,0.949422041688266,0.9386504115986385,0.9636598498399317,-0.07169190329390684,33.8416322183608,145.03263529903182,137.2361249923706,129.4396146857094,135.4317855834961,4.956061887172598,137.6962500980922,4.752923299852311,135.4295140476073,136.26499537108356,-8.898800955187125,-6.067604674018914,46017800,2.191492476748665,0.8923275456280502,-1708463100.0,-84.14071176018176,77.07053933241427,82.84087432937385,-133.68102820972584,17.45544329110749,30.17062746867016,0.02012349909544247,3.5706645987644547,141.7677614746094,139.23612200927735,137.19000244140625,135.14388287353515,132.6122434082031,0.04,0.0,122.27119340117135,-0.062223115594541745,-0.06496185737472093,134.71571350097656,137.7392861502511,4.488891210075953
2023-09-26,0,127.9424991607666,130.19499969482422,144.6525001525879,134.71749877929688,140.52499866485596,-0.07749894960716852,4.061079034053086,-0.7731129502715106,2.995293235480644,137.1287498474121,3.230375289916992,0.029616187791346678,130.66400184631348,141.90225067138672,0.7675744688413298,-0.02166239912090677,0.9330449001032534,0.9288847776904262,0.9605581192281173,-0.0707424679729034,33.64452143976385,145.24578325121163,137.12362518310547,129.00146711499931,133.4685709817069,4.785090019635689,137.1253570829119,5.414683989752368,134.15376411316646,135.5172435639522,-9.925509862463619,-5.001640830162438,73048200,2.18499081697875,1.3649400574746418,-1781511300.0,-96.59861751527917,77.07053933241427,82.84087432937385,-180.5578281904064,15.460386928812422,33.38151613326208,-0.037441432099760426,3.743474662650141,141.00312017822264,137.99843991088866,135.56999969482422,133.14155947875977,130.1368792114258,0.06,0.0,122.28257998863118,-0.08464725069070878,-0.10001423630456055,132.65714263916016,137.06928634643555,5.0799767470511386
2023-09-27,0,125.8375015258789,127.9424991607666,144.6525001525879,134.71749877929688,140.52499866485596,-0.284690518526896,4.456549031284569,-0.6820796734794885,2.995200260056846,137.1287498474121,3.516325044631958,0.03256241445974093,130.28500175476074,141.90225067138672,0.7702760971322813,-0.04641501625404468,0.9194497469901851,0.9228803313059533,0.9587765266500686,-0.0821647731672348,28.725026842940814,145.77484818845414,136.861750125885,127.94865206331588,131.39428574698312,4.43545953237,136.4183928625924,6.1994407281732276,132.61005624091413,134.60801484023048,-9.699334495058986,-5.8796499295837785,66553400,2.2202488693046307,1.2119815970315162,-1848064700.0,-91.48639752545027,77.07053933241427,82.84087432937385,-173.89992526111504,14.464670027665289,33.44249583182307,-0.05678298222550896,3.715369765569105,140.73171981811524,137.5591393280029,134.99499893188477,132.4308585357666,129.2582780456543,0.08,0.0,122.29007566636439,-0.06881506682840144,-0.0846472506907088,130.65714372907365,136.22142900739397,5.625866717076833
2023-09-28,0,124.91000175476074,125.8375015258789,144.6525001525879,133.8512487411499,140.52499866485596,-0.4639172988849344,5.040007967773502,-0.636948670593799,2.995045794566076,137.1287498474121,4.00159969329834,0.03693798487830919,129.96974964141845,141.90225067138672,0.7888830995262227,-0.0671793650041816,0.9154596154349326,0.927695331532346,0.9683321131989929,-0.044336482882150086,25.046804169596637,146.52514103854384,136.44512510299683,126.36510916744983,129.56964329310827,4.0257272804922435,135.5067858014788,6.899641824713382,130.91990206352784,133.60852277876802,-10.345009588008613,-7.291781073390913,54555000,2.239329006810322,0.9770966608386535,-1902619700.0,-87.1165535463479,77.07053933241427,82.84087432937385,-153.29795316007306,13.476916653439968,33.26142201115949,-0.03348199091632109,3.7028434191375497,140.47448068237304,137.1427607269287,134.45000076293945,131.7572407989502,128.42552084350586,0.1,0.0,122.29506035539943,-0.025902717286722332,-0.0688150668284015,128.99285779680525,135.3464295523507,6.0902952310931076
2023-09-29,0,127.6974983215332,124.91000175476074,144.6525001525879,130.60250186920166,140.52499866485596,-0.4953217139594175,5.6290108249408535,-0.8229919832097763,2.9948686236224606,137.1287498474121,4.600999450683593,0.041406340309257036,127.73199939727783,141.90225067138672,0.8267811795706171,-0.08634747393734248,0.9393277498622933,0.9625107035221702,0.9989165610504969,-0.019182774907985256,22.066590140944122,147.2036469550575,135.94562530517578,124.68760365529405,128.22607203892298,2.286322925644744,134.5546428135463,6.998243522741253,129.41236585020707,132.62592445579975,-9.276776116217153,-9.270187436859276,62377600,2.1743876770876565,1.113615364270049,-1840242100.0,-82.12093827512152,77.07053933241427,82.84087432937385,-102.42063138109567,17.653299919567385,31.20637132395059,-0.08844797540189496,3.664782499167066,140.47448068237304,137.1427607269287,134.45000076293945,131.7572407989502,128.42552084350586,0.1,0.0,122.30529356720827,-0.015489408660450232,-0.017088061959201005,127.82571629115513,134.2050007411412,6.379611118879272
2023-10-02,0,128.43750190734863,124.91000175476074,144.6525001525879,130.270001411438,140.52499866485596,-0.3362358100720969,5.903766428198984,-1.148098641161454,2.9947778154136944,137.1287498474121,5.088074855804441,0.0435719200233244,127.51149864196778,141.90225067138672,0.8767483892177972,-0.07869488670125091,0.9479149673625857,0.9784037178894375,1.008646392458428,-0.014256111500939528,31.157832434490413,147.3022832607559,135.49475040435792,123.68721754795995,127.90214347839355,2.0219106809579315,133.6008928843907,6.844506063349354,128.97568605659478,132.26777879905256,-6.859830402928477,-9.452058511022312,48029700,2.2372696997219674,0.8520789356805892,-1792212400.0,-71.86675773796807,77.07053933241427,82.84087432937385,-75.42563353991315,18.867583804800148,28.828324362159673,-0.060110478071717245,3.6837266281676886,140.47448068237304,137.1427607269287,134.45000076293945,131.7572407989502,128.42552084350586,0.1,0.0,122.31508949581348,-0.01378835605761819,0.002633299330371704,127.8442884172712,133.36428724016463,6.481217861141865
2023-10-03,0,126.38750076293945,124.91000175476074,144.6525001525879,129.75562524795532,140.52499866485596,-0.14591308722594107,6.050005534740262,-1.3231423222808465,2.994725127133641,136.51874923706055,5.387099647521973,0.04481937914004778,127.51149864196778,141.90225067138672,0.8993242052376451,-0.06355948030893943,0.9362982038165115,0.9716098919359043,0.9954515042043949,-0.012153884815656157,34.43908489247929,147.0863864013592,134.98637533187866,122.88636426239812,127.35821505955288,1.8025298362360587,132.42053590502059,6.53296995202372,128.82821140169932,131.98796996055148,-1.7348226096480655,-9.41709494461008,51565000,2.245572089762824,0.9060148209371038,-1843777400.0,-92.63803537404594,77.07053933241427,82.84087432937385,-97.83677806836269,17.0163012727172,30.312441578425194,-0.11144947276656306,3.7927466342890814,140.47448068237304,137.1427607269287,134.45000076293945,131.7572407989502,128.42552084350586,0.1,0.0,122.3207517306583,-0.010001604243973228,-0.049897180152160124,127.21571786063058,131.92642974853516,6.847756369251231
2023-10-04,0,126.52499961853027,124.91000175476074,144.6525001525879,128.31375122070312,140.52499866485596,-0.0008574069791449564,6.306711045679938,-1.4519131884278087,2.9946314455446386,135.8350009918213,5.762449522018431,0.04690818037015564,126.3325008392334,141.90225067138672,0.8933327290530099,-0.07023577823148858,0.9410701489971343,0.9811866462592744,0.9989814673433798,0.0054633800283294676,31.312887003697625,147.06142233168583,134.44800024032594,121.83457814896606,126.81964329310826,1.2605419841945775,131.12571443830217,5.660256687878071,128.20925203388117,131.4794602990032,-2.924458651107573,-11.563017851915886,44203900,2.2679169183369075,0.775031121241343,-1799573500.0,-80.7111648888907,77.07053933241427,82.84087432937385,-78.69003972281415,16.151493981632342,28.771894072391294,-0.07178563708728845,3.710407545386178,138.72492581176758,135.72754487609862,133.30500411987305,130.88246336364747,127.88508242797852,0.1,0.0,122.32676334696038,0.008096496395356478,0.008096496395356449,126.60571725027901,130.6607153756278,7.037287004550194
2023-10-05,1,125.9325008392334,124.91000175476074,144.6525001525879,127.88124895095825,140.52499866485596,0.1258191851032802,6.525440384013678,-1.5356745044890667,2.9945479024582715,133.22000122070312,6.084249496459961,0.04870549440452173,126.3325008392334,141.90225067138672,0.9053984262726137,-0.0678528084164528,0.9399526091754812,0.9846688561997186,0.9932251008105086,0.008185886399074471,31.922479642824495,147.02838092061523,133.97750015258788,120.92661938456052,126.53250067574638,1.1890372028450797,130.00053582872664,4.916589854036291,127.79746274153322,131.12803858207033,-2.893435901390597,-12.53175749809763,39660600,2.2715354595663433,0.7008029337859917,-1839234100.0,-84.39338155089166,77.07053933241427,82.84087432937385,-80.63347087362162,15.304343242398707,29.914779925088606,-0.0994716883218845,3.636092589926117,137.33444021606445,134.60278034973143,132.39500045776367,130.1872205657959,127.4555606994629,0.1,0.0,122.33089897416703,-0.0001587892675654068,-0.00015878926756542685,126.60285949707031,129.63000106811523,7.192026704870093
2023-10-06,1,126.17499923706055,124.91000175476074,144.6525001525879,127.40437364578247,140.52499866485596,0.24682309127216015,6.739644649798044,-1.5718251494747837,2.9944622365266413,130.50000190734863,6.3496119403839115,0.05048900423366803,125.92300090789794,141.90225067138672,0.9044034426691209,-0.08527483498208092,0.9452204680930624,0.9902602395738311,0.9935352211803349,-0.011922700949388298,28.883043815127053,146.966664463628,133.487375164032,120.00808586443597,126.58071463448661,1.162710065473614,128.98750019073486,3.9927608507845282,127.3494326375963,130.7734901849632,-1.5710169292593954,-11.117973237375509,46795900,2.1986249942371785,0.8207579451682149,-1792438200.0,-69.87140284198551,77.07053933241427,82.84087432937385,-62.74537608444774,17.356799843587083,27.40976275636762,-0.08077822834950105,3.6849430974188397,135.51611648559572,133.1319373321533,131.20499801635742,129.27805870056153,126.89387954711914,0.1,0.0,122.3374738627991,0.006607900564360225,0.0157167461087394,126.88571602957589,128.77142987932478,7.193173020649189
2023-10-09,0,127.00749778747559,124.91000175476074,144.6525001525879,126.49062490463257,140.52499866485596,0.4154756608249966,6.847635138920246,-1.5045826744502253,2.994413737420362,130.2450008392334,6.390999450683592,0.051519873104538164,125.92300090789794,141.90225067138672,0.8938213679727047,-0.10531634538978103,0.9555722576608304,0.999948803095189,1.00249422663141,-0.011133851862866417,26.152191964354447,146.60777037320793,132.91250009536742,119.21722981752693,126.88035692487445,0.9012705842302812,128.22500010899134,3.1308087786893237,127.07819005510581,130.42429039500138,0.26820121751402787,-10.104553812161567,38773700,2.0038331148229975,0.6909570954272699,-1753664500.0,-68.03432060754857,77.07053933241427,82.84087432937385,-54.016918086926694,16.66461472507964,25.28282151207129,-0.09662792722037264,3.7095893868819463,135.51611648559572,133.1319373321533,131.20499801635742,129.27805870056153,126.89387954711914,0.1,0.0,122.34341722166295,-0.009269366173319638,0.008967839329947967,127.21142905099052,128.10214342389787,6.837170720195896
2023-10-10,0,129.27250289916992,124.91000175476074,144.6525001525879,126.49062490463257,138.3512487411499,0.6360834449747992,6.696976716874333,-1.242515675982714,2.9944622314725033,129.31625080108643,6.070199527740482,0.050653511366512735,125.92300090789794,141.90225067138672,0.8847016513487538,-0.10425631590804887,0.9777704883580423,1.0204226838226822,1.0226810008906417,0.022826641232836398,29.41334171818947,145.60545341086052,132.21149997711183,118.81754654336312,127.10535757882255,1.2631968199939885,127.66571480887276,1.8674053474449466,127.07298107237872,130.0064724464211,1.6792058307972133,-7.753346450873462,42178600,2.006731047657409,0.7519615071356259,-1711485900.0,-30.000091220976184,77.07053933241427,82.84087432937385,-25.948041984872354,19.614125793614345,23.94704031229496,-0.0759928778864047,3.6367617479193965,130.06880441284179,128.72560374450683,127.6400032043457,126.55440266418456,125.2112019958496,0.1,0.0,122.35268503103518,0.038165446281648974,0.00015440300197152598,127.54857090541294,127.68714359828404,6.5093693768320415
2023-10-11,0,130.80750274658203,124.91000175476074,144.6525001525879,126.49062490463257,137.24749755859375,0.8667385805744944,6.348407590469387,-0.7969923862315893,2.9945837307701697,128.85500240325928,5.4878743743896505,0.04824544920304594,125.92300090789794,141.80775108337403,0.860099448554448,-0.09544298588706804,0.9940865704041703,1.0314564525732641,1.0301222819521583,0.033847090622117326,38.43488650458256,144.28244025723274,131.58562507629395,118.88880989535517,127.44392912728446,1.8575455451303862,127.67303630283901,1.880393798652808,127.64569182365005,129.85007638495435,1.2333871832562995,-5.711051488655016,40741800,2.078609971584593,0.7393449609579048,-1670744100.0,-2.441744378932715,77.07053933241427,82.84087432937385,3.5080290313282365,21.230869782186286,22.71240341502643,-0.09844482510569455,3.56056500336935,129.92364254760741,128.60818223571778,127.54500198364258,126.48182173156738,125.16636141967774,0.02,1.0,122.36381146795968,0.0380315104807456,0.057007701577630555,127.88714163643974,127.86571502685547,5.70826312964423
2023-10-12,0,132.55249786376953,124.91000175476074,144.6525001525879,126.49062490463257,132.38125133514404,1.081695578194544,5.792350326102486,-0.1658796943552714,2.994769165506948,128.85500240325928,4.65781192779541,0.04422303962163397,125.92300090789794,140.4902484893799,0.7927284757214746,-0.09571211967578402,1.012002733771168,1.04113605598811,1.036870572642039,0.052567819906850666,42.82126237450472,142.56507594212195,130.980375289917,119.39567463771203,128.32464299883162,2.5901958708127406,127.84142902919224,2.201718055103599,128.4470580501307,129.88511301058278,1.8452561004674892,0.07842157078260349,55528600,2.0663193351144913,1.015519106935139,-1615215500.0,-18.793661464137497,77.07053933241427,82.84087432937385,41.46912563439993,24.743349924837602,21.2223092036074,-0.12829129481761703,3.5383817888429676,131.7801569519043,130.10991770935058,128.7599983215332,127.41007893371582,125.7398396911621,0.04,0.0,122.38153690648787,0.05057163220769878,0.04196851835476132,128.97428458077567,128.09500122070312,4.711737341844468
2023-10-13,0,131.25749588012695,124.91000175476074,141.68500137329102,126.49062490463257,131.2437515258789,1.077074291527566,4.895153288525673,-0.045379624229445525,2.995036431347463,128.85500240325928,3.826487178802492,0.037546609410996065,125.92300090789794,137.94999885559082,0.7724583221461421,-0.06445638861561989,1.006766007027505,1.02481268022471,1.016215911457487,0.0402813288987407,51.27623614067874,140.16568175252743,130.37537517547608,120.58506859842473,129.00071389334542,2.6588874440653574,127.91017859322685,2.2971827658389112,129.4673811051612,130.02518011411357,4.877853477294043,1.810744018181393,45786600,2.065529278028431,0.883463325348964,-1661002100.0,-40.99654342921433,77.07053933241427,82.84087432937385,18.79330931492403,22.60110924921583,23.91240817409493,-0.08038080988906188,3.597068847522153,131.7801569519043,130.10991770935058,128.7599983215332,127.41007893371582,125.7398396911621,0.04,0.0,122.39328200029635,0.014301298958685482,0.0304064324348847,129.37285505022322,127.98928615025112,4.06303701994545
2023-10-16,0,131.68500137329102,124.91000175476074,140.3574981689453,126.49062490463257,130.92000102996826,1.1265164430574854,4.163438260777068,0.3938566730119524,2.995224173456897,128.85500240325928,3.226899509429933,0.032062456789602865,125.92300090789794,137.16049728393554,0.714928782979699,-0.06483445777770191,1.01410046262627,1.0253006483427523,1.0115648158457775,0.036828562622676086,48.03341807371632,138.180876422372,129.85399990081788,121.52712337926377,129.8224996839251,2.4318113746625243,128.17750017983573,2.509204951437528,129.91275042999675,130.0061098127778,3.7403645729026187,0.7387036201167623,42832900,2.064840589003306,0.8264634870847534,-1618169200.0,-16.870572998466784,77.07053933241427,82.84087432937385,65.29502717326025,21.119711816296743,22.345061204819668,-0.03884262594803398,3.5744220754195664,131.7801569519043,130.10991770935058,128.7599983215332,127.41007893371582,125.7398396911621,0.04,0.0,122.40600170973349,0.03344775244546905,0.035870615818425176,130.31428418840682,128.45857184273856,3.3536335590938893
2023-10-17,0,130.78750228881836,124.91000175476074,137.68249893188477,126.49062490463257,130.92000102996826,0.9648351130740247,3.4347695957382536,0.3497790934663878,2.9953829689879896,128.85500240325928,2.7499121856689444,0.02653963561856781,125.92300090789794,133.0074977874756,0.6783582882389907,-0.04356034793907157,1.010563462106631,1.0157443961902997,0.9975022090272783,0.011719424902217002,51.86004061534407,136.28991425251166,129.42037506103514,122.55083586955864,130.48142869131905,1.828929460627391,128.53107166290283,2.5028562383125585,130.35185715680078,130.0168295888639,4.567923685880989,2.925143902200753,49344600,2.006570432263107,0.9633884997872406,-1667513800.0,-26.311152726009247,77.07053933241427,82.84087432937385,52.31904384690944,19.496007606242415,24.044059940386237,-0.03450235316717973,3.5955344355458476,131.7801569519043,130.10991770935058,128.7599983215332,127.41007893371582,125.7398396911621,0.04,0.0,122.41894618304116,0.015369211915573278,0.02502734173823859,130.81571306501115,128.85071454729353,2.7886385120207153
2023-10-18,0,129.05249977111816,124.91000175476074,137.10249710083008,126.49062490463257,130.79250240325928,0.815609961326193,2.8912120346011188,0.6440810786014768,2.9954828611459545,128.85500240325928,2.3903751373291016,0.02239936494186498,125.92300090789794,131.77175102233886,0.5626816750062607,-0.04606039237467313,0.9998208379179053,0.9988564241769925,0.9820001806537147,-0.013416684353831698,49.015009316626376,134.8580492980841,129.07562522888185,123.2932011596796,130.77357183183943,1.2547314761959028,128.82696437835693,2.2764643056071336,130.45593213898275,129.90834528959783,3.6556394528616036,3.933645139896129,42699500,2.0100213291314692,0.836562315561074,-1710213300.0,-61.35257759316516,77.07053933241427,82.84087432937385,3.3817558540666597,17.97330133507115,24.532916956796814,-0.016673857197646302,3.6215676247549045,132.03739608764647,130.5262963104248,129.30499649047852,128.08369667053222,126.57259689331053,0.04,0.0,122.42729084469127,-0.028066425675878248,-0.010426250303307922,130.7971431187221,129.00428608485632,2.3732420308947417
2023-10-19,0,129.67000198364258,124.91000175476074,132.55249786376953,126.49062490463257,130.7256269454956,-0.006665842513091035,2.230603959336477,-1.3001833364012418,2.995581996408465,128.7450008392334,1.987875270843506,0.017335430013487137,125.92300090789794,131.30024642944335,0.7728051817491908,-0.012642990220622905,1.0077473568660025,1.0016762988487167,0.9893413486400098,-0.021746069871044105,48.371867249851924,133.1343332810692,128.67312536239623,124.21191744372328,130.83035741533553,1.1823840828253984,128.96785749707902,2.262178548161514,130.08427373059627,129.49804955773715,1.6101427232780576,3.316386164568713,60961400,1.4654080785364163,1.2052958645718277,-1649251900.0,-58.743987704510104,77.07053933241427,82.84087432937385,25.550043818479747,19.347794706150584,22.27599789392308,0.014891911929242331,3.703598813876764,132.03739608764647,130.5262963104248,129.30499649047852,128.08369667053222,126.57259689331053,0.04,0.0,122.4402898477569,-0.02969854061959243,-0.0260184168014046,130.64285714285714,129.09571402413505,2.369067037491386
2023-10-20,1,126.59000015258789,124.91000175476074,132.55249786376953,126.49062490463257,130.41812705993652,0.02875914714175187,2.1945792335666963,-1.2210292318844445,2.995586723408806,128.7450008392334,1.9361252784729004,0.0170623213074281,125.92300090789794,131.30024642944335,0.7682714475743346,-0.004032395348609624,0.9842065503374243,0.9750686971217216,0.97010893437409,-0.035559841335093934,51.398567748301055,133.01053383715904,128.62137537002565,124.23221690289225,130.22785704476493,1.9927892186582163,128.8358930860247,2.347764848779015,129.971754388721,129.34656686859324,0.30748927695992545,1.5446689935481361,56343300,1.4698983247810262,1.1179247262470038,-1705595200.0,-89.95168049417818,77.07053933241427,82.84087432937385,-77.20259723331422,18.061114970326933,25.641727581063,0.005146873456522764,3.684055518298513,132.03739608764647,130.5262963104248,129.30499649047852,128.08369667053222,126.57259689331053,0.02,1.0,122.44661774612413,-0.03559592692945379,-0.05410718327693002,129.6914280482701,128.7892848423549,2.4885373099068446
2023-10-23,1,125.76249885559082,124.91000175476074,132.55249786376953,126.49062490463257,130.41812705993652,0.21680068747635892,2.2059459526639587,-1.203651405619764,2.995584957398846,128.19000053405762,1.9409878253936768,0.017174763502855933,125.92300090789794,131.30024642944335,0.7050784497640704,-0.028435486969176443,0.9791451022472061,0.9683852565166302,0.9707117158804479,-0.04497476900130426,40.53934714206578,132.85301729824175,128.44112539291382,124.0292334875859,129.2578571864537,2.3013193304558373,128.79125009264266,2.4031905455843545,129.1223895203554,128.77469013928027,-3.22420542051388,-1.4384441672600268,48260000,1.6192893532035233,0.9554162509652406,-1753855200.0,-75.42860879706146,77.07053933241427,82.84087432937385,-69.14905613568176,16.70111217292118,25.622365887584973,-0.009546422117239843,3.6994796881689305,132.00199752807617,130.46899864196777,129.22999954223633,127.99100044250488,126.45800155639648,0.04,0.0,122.45207462868613,-0.04519053455491118,-0.02488632325003866,128.8671417236328,128.92071315220423,2.428977077716574
2023-10-24,1,127.85999870300293,124.91000175476074,132.55249786376953,126.33437538146973,129.94937705993652,0.398699071489411,2.236458734294006,-1.1205237270599453,2.995580480928719,127.8199987411499,1.9592004585266125,0.017443103004484796,125.8300012588501,131.30024642944335,0.7411948506353614,-0.017038906692267236,0.9972350901586452,0.9854809833003266,0.996007697093132,-0.022383664605434728,39.8037935353976,132.68741770509925,128.21450023651124,123.74158276792322,128.77250044686454,2.163441673439419,128.88660717010498,2.331774806173976,128.27457059232023,128.20918841070076,-5.122497966924104,-0.49451243483398466,46477400,1.5465190177290011,0.9449799958217674,-1707377800.0,-56.380975909261,77.07053933241427,82.84087432937385,-11.681660356798874,17.708282615021698,24.375538012814147,0.08214053795444787,3.6109459042902343,132.00199752807617,130.46899864196777,129.22999954223633,127.99100044250488,126.45800155639648,0.04,0.0,122.45981547558746,-0.022134354872517692,-0.030101889108263957,128.6914280482701,129.03214154924666,2.3723574406277264
2023-10-25,1,123.63999938964844,124.91000175476074,132.55249786376953,126.33437538146973,129.94937705993652,0.4038151190083422,2.2370326309620063,-1.1194729609732847,2.995580397859206,127.77874851226807,1.9629129791259772,0.01744814042728353,125.8300012588501,131.30024642944335,0.7431486095296124,0.01607229285864429,0.9643525275052078,0.9539939385894595,0.9675475556433257,-0.04194029864643534,49.93829567940679,132.68444047554706,128.21037521362305,123.73630995169904,127.62321444920131,2.473080958749045,128.7228570665632,2.618102812010014,128.169374916394,128.06262916241337,-2.588421449260957,1.0551267247560918,74577500,1.5465756421837549,1.5040431843061204,-1781955300.0,-95.6172483455242,77.07053933241427,82.84087432937385,-166.67591476362375,15.193431053779916,31.057796624031123,0.015521961793454843,3.908020957059961,131.2491569519043,129.2504177093506,127.6349983215332,126.01957893371582,124.02083969116211,0.06,0.0,122.46068029916911,-0.052602866122798186,-0.07667149720439302,127.09714181082589,128.70571299961634,2.7963484060054458
2023-10-26,1,120.04749870300293,123.63999938964844,132.55249786376953,126.33437538146973,129.94937705993652,0.16757705642180523,2.398985772073504,-0.9492154248003724,2.9955570787756907,127.77874851226807,2.0618005752563477,0.01872737241519904,125.67724914550782,131.30024642944335,0.5973819963842039,-0.01016733926243741,0.9371352852089264,0.9314256933075022,0.9474604207150348,-0.07420762808234938,38.504097300306256,132.89847165095853,128.10050010681152,123.3025285626645,126.08892822265625,3.3565182489114083,128.28517845698767,3.455167786733238,127.04029978047117,127.47530600498672,-6.1092773662485635,-1.8204208082166093,100419500,1.8140470300003366,1.935689191766707,-1882374800.0,-92.43644495695989,77.07053933241427,82.84087432937385,-226.2504080150821,14.269370169427809,33.67951711330625,-0.04492567233712314,3.86387666837906,130.6733163757324,128.3183367767334,126.41499710083008,124.51165742492675,122.15667782592773,0.08,0.0,122.45271842407226,-0.0687694285155408,-0.06680718693343725,125.3971415928432,128.10642732892717,3.362805476274273
2023-10-27,1,127.36999893188477,120.04749870300293,132.55249786376953,126.33437538146973,129.94937705993652,-0.654236120661663,2.90337742785113,0.5810243035226303,2.9954730901507567,127.77874851226807,2.280875587463379,0.02270793866126703,125.55024890899658,131.30024642944335,0.61811622167168,-0.05990720036870354,0.9961881274153066,0.9979218062502268,1.0207565298007513,0.006161614490533873,29.06877828820059,133.6641298099259,127.85737495422363,122.05062009852136,125.84857095990863,3.163628535783805,128.31107139587402,3.446203006411239,125.29668339209684,126.58085617722828,-8.211796538554772,-4.8563507597453,125309300,1.8448398661913123,2.2773368730905093,-1757065500.0,-41.78548674173723,77.07053933241427,82.84087432937385,-2.2054380900198076,25.6220555556782,27.879438329045254,-0.01923963489099222,4.334314376183179,130.6733163757324,128.3183367767334,126.41499710083008,124.51165742492675,122.15667782592773,0.08,0.0,122.47286503547896,0.020532074238392095,-0.005140156262366682,125.34142630440849,128.0692847115653,3.35920351960616
2023-10-30,1,130.99750137329102,120.04749870300293,132.55249786376953,126.33437538146973,129.94937705993652,-0.6363533010134703,2.9051559495840173,0.5577644640537587,2.995472740497276,127.61499881744385,2.2972505569458006,0.02272475927074076,125.55024890899658,131.30024642944335,0.6404163751653156,-0.008311458566314496,1.0246908377510076,1.0294782281444474,1.0485168607064972,0.04162610130474098,49.42741796651932,133.65131188390924,127.84099998474122,122.03068808557319,126.0382137298584,3.4570621377573283,128.43428557259696,3.513404094643719,125.80614996611362,126.69814712471502,-1.3037336295053625,0.28541712160628563,72485500,2.521035784350301,1.288693426597695,-1684580000.0,-10.97327535686227,77.07053933241427,82.84087432937385,93.11350242570867,28.271590826873776,25.499058280827324,0.016446182892580066,4.400434930472272,130.6733163757324,128.3183367767334,126.41499710083008,124.51165742492675,122.15667782592773,0.02,1.0,122.49247564024607,0.048593625742021196,0.060238145364074444,125.95714242117745,128.2999997820173,3.517758634794143
2023-10-31,1,132.78000259399414,120.04749870300293,132.55249786376953,126.33437538146973,130.79250240325928,-0.6572462737325441,2.9839456130853783,0.36088055790561935,2.9954589416573003,127.61499881744385,2.4361506557464594,0.02331772237076033,125.55024890899658,131.30024642944335,0.6028551682179044,0.0364751307093126,1.0375950631600885,1.044050571566671,1.0539517490860766,0.03847961787032039,57.36627151332574,133.9368911842091,127.96899995803832,122.00110873186756,126.92249979291644,4.308541665284135,128.5751784188407,3.6526838802428445,127.09004314152787,127.34982389301196,1.0237521164038363,1.3343893213443538,51589400,2.602170364055504,0.9171693467381352,-1632990600.0,-8.617480634436529,77.07053933241427,82.84087432937385,114.35391579410211,28.346347574263135,24.69608294429023,0.07438110304441072,4.218975336177936,130.6733163757324,128.3183367767334,126.41499710083008,124.51165742492675,122.15667782592773,0.04,0.0,122.50850849153879,0.035236456637549596,0.0515960722603021,127.08857073102679,128.38999938964844,3.6063998033401417
2023-11-01,1,135.5050048828125,120.04749870300293,132.78000259399414,126.43749952316284,130.85500240325928,-0.6861200902226039,3.135921165408204,0.2462562074619794,2.99543174294099,128.45624923706055,2.5976258277893067,0.024444265141948373,125.55024890899658,131.77175102233886,0.6028719742598728,0.04943689384961506,1.05625112772416,1.0638106159990823,1.0672458565698888,0.09596413419391725,60.222392704987925,134.5604673804075,128.28862504959108,122.01678271877466,128.3142863682338,5.325027230506199,128.78607177734375,3.971320789876053,128.5031149525584,128.2285780401702,4.889803644794219,1.5079409101123982,61529400,2.624502401040107,1.0772939226321034,-1571461200.0,-1.8421366472197493,77.07053933241427,82.84087432937385,168.31787265104313,32.69854804774755,22.916156576338857,0.09464607143245937,4.221906366852726,132.86600430297852,130.0920031890869,127.85000228881836,125.60800138854981,122.83400027465821,0.06,0.0,122.53355214633682,0.12859379428980144,0.0656503002620201,128.57999965122767,128.72357068743025,4.066333468084755
2023-11-02,1,138.02000045776367,120.04749870300293,135.5050048828125,126.48624992370605,131.0625,-0.43958690419627283,3.475728482074059,0.20362643255775126,2.995366226348148,129.16250133514404,2.825363521575929,0.026998544315453815,125.55024890899658,132.575248336792,0.599211190364237,0.07601297504446013,1.0721030477485063,1.0780938458535436,1.0671099356249052,0.1497115887372602,64.58922051841364,135.6890822769533,128.73762531280516,121.78616834865706,129.7657151903425,6.447008083330556,129.26910781860352,4.648564898053571,130.25222988980104,129.29179216103495,7.746749719412539,2.227424655608829,52236700,2.667378566869249,0.9046321686324263,-1519224500.0,-3.616765725745255,77.07053933241427,82.84087432937385,180.4028797119144,33.91278886974964,21.979084851397516,0.09793355316228232,4.087484221926862,133.9814377746582,130.9942779083252,128.57999801635742,126.16571812438966,123.17855825805664,0.08,0.0,122.55751111636854,0.15472114808573778,0.13740841929679345,129.9385724748884,129.31500026157923,4.485882391514745
2023-11-03,1,138.63250350952148,120.04749870300293,138.02000045776367,126.90312337875366,131.36437225341797,-0.09587950660212123,3.9534930902312846,0.338450286148662,2.995264426521456,129.47125244140625,3.06425085067749,0.030566197223276456,125.55024890899658,133.052502822876,0.6295450642418143,0.09387756126273843,1.0718289743060363,1.0758611026891274,1.0428632280629622,0.08842352729907543,67.76738886158569,137.24898647419425,129.3420002937317,121.43501411326913,131.9075014931815,6.5621170417306445,129.7653579711914,5.257287697533767,132.19775308219442,130.68259898954707,7.946192599579718,5.152090196671653,44007200,2.7036818371939955,0.7639589130261373,-1475217300.0,-4.210024097185606,77.07053933241427,82.84087432937385,166.11729773934357,33.891374528237115,21.16647680208753,0.07163496501253915,3.9412359592836483,134.5009638366699,131.41452281188964,128.92000198364258,126.4254811553955,123.33904013061523,0.1,0.0,122.57860212249959,0.08501650556881923,0.1591536878586707,132.3971448625837,129.7471433367048,4.904637264599709
2023-11-06,0,139.39749908447266,120.04749870300293,138.63250350952148,127.27937364578247,131.90187549591064,-0.0011119530021803528,4.365353570816777,0.1358851535052361,2.995167830963813,130.22875213623047,3.337625789642334,0.0335887181346143,125.55024890899658,135.75650444030762,0.6984878229633718,0.09153007440157804,1.07257825270324,1.0717814133413768,1.0311457199372334,0.06412334298839006,68.27788144644128,138.69558264898828,129.96487550735475,121.2341683657212,134.6717872619629,4.478090133645541,130.38035774230957,5.8556099236397685,133.81636358400837,132.0472796939186,12.125933511714551,5.2758492339884615,44970400,2.703232690740096,0.7765033589471834,-1430246900.0,-4.4235494006765546,77.07053933241427,82.84087432937385,161.9711136496042,34.706144895286684,20.230678792547533,0.052970581700042596,3.829004470562495,135.44831637573242,132.1808367767334,129.53999710083008,126.89915742492676,123.63167782592774,0.12000000000000001,0.0,122.6015765723211,0.05297263524712248,0.09394087858207228,135.27857426234655,130.33785792759485,5.338543194056839
2023-11-07,0,141.78250122070312,120.04749870300293,139.39749908447266,127.73749876022339,132.60937404632568,0.007108558583887713,4.762766706061926,-0.13058970395148384,2.9950667751270386,130.7975025177002,3.5994380760192883,0.03647271494152399,125.55024890899658,138.08125076293945,0.7566542618409835,0.0783228912431597,1.0857539472040951,1.0788092097975044,1.0359144208564868,0.06780010883292586,68.55457864231789,140.10990898432846,130.58437557220458,121.05884216008072,136.73071616036552,3.827348303010317,131.28964356013708,6.577447703753501,135.22707484124993,133.089989133097,16.118620204942008,6.583195370335019,53553500,2.6755615153884444,0.9157148542582446,-1376693400.0,-2.6378436925298705,77.07053933241427,82.84087432937385,174.11549472035756,37.29039171180332,18.855632666433735,0.07490456824175773,3.8147891243811336,137.46527590942384,133.81235639953613,130.8599967956543,127.90763719177247,124.25471768188477,0.14,0.0,122.63299845609349,0.07228199444497063,0.0753522680588869,137.41714695521765,131.37928662981307,5.973224766321212
2023-11-08,0,142.3474998474121,120.04749870300293,141.78250122070312,127.73749876022339,133.46125316619873,0.11457616388022994,5.3363420952770015,-0.3461928166411883,2.9949059160791207,130.90250205993652,4.072362747192384,0.04067027786908925,125.55024890899658,138.7090030670166,0.7746532928357267,0.08390190351224229,1.0848840403032436,1.0717546008511134,1.0265382873980158,0.05049625266990798,71.13749772353219,141.88255967883526,131.20987548828126,120.53719129772723,138.3521445138114,3.3706297149091227,132.19517912183488,7.1821876864691,136.87383495627427,134.14941880540533,11.31546079114432,9.864203693971316,44521700,2.698947358322288,0.7588272510163329,-1332171700.0,-5.155849157518964,77.07053933241427,82.84087432937385,144.65301829163326,35.91442711146959,18.159885534936134,0.042609875344099934,3.678018036674222,137.46527590942384,133.81235639953613,130.8599967956543,127.90763719177247,124.25471768188477,0.14,0.0,122.65897339467838,0.037080305336165686,0.0675483187356931,138.75571768624442,132.35643005371094,6.4448592782545635
2023-11-09,0,141.2775001525879,120.04749870300293,142.3474998474121,127.73749876022339,136.1337537765503,0.13350249398730216,5.85985125683234,-0.6331850925625551,2.9947449068090597,131.12749862670898,4.672250671386718,0.04446460424504815,125.55024890899658,139.6359992980957,0.8149792007139884,0.0738952652081243,1.0720149467429194,1.0489241732019086,1.0088655725763966,0.023601649645125677,71.3119451456824,143.50657785698743,131.78687534332275,120.06717282965808,139.56607273646765,2.4276345132857333,133.24428626469202,7.3706873825953165,138.25312224043958,135.05666539080235,8.664286230756487,9.776739160818979,36235400,2.6849106425769342,0.6279197034123728,-1368407100.0,-11.071100660756883,77.07053933241427,82.84087432937385,112.13893896957057,33.920926204018095,19.877862297585928,0.04445314531538903,3.6160165739541883,137.46527590942384,133.81235639953613,130.8599967956543,127.90763719177247,124.25471768188477,0.14,0.0,122.67886126754594,0.018324028717952245,0.026277416813982664,139.82857622419084,133.4585734776088,6.740329262060989
2023-11-10,0,141.89500045776367,120.04749870300293,142.3474998474121,127.73749876022339,138.17312622070312,0.0789631953269681,6.2146465435430045,-0.908951335085026,2.994628227626571,131.12749862670898,5.19575080871582,0.0470012074062503,125.55024890899658,141.3280002593994,0.8547468222794053,0.07633852988946148,1.073148134764743,1.0371607488251977,1.0085828498500293,0.023533420126241378,68.86775244213933,144.65241854484967,132.22312545776367,119.79383237067766,140.47892924717493,1.7539925472865403,134.39660780770438,7.3720851161230145,139.01269334910415,135.5839389093927,6.399681723592695,11.60241723856238,49287800,2.677384558877998,0.851520296768674,-1319119300.0,-0.3557168149171879,77.07053933241427,82.84087432937385,111.34152674346883,33.39156891195886,18.41292358982379,0.10915727772746657,3.6248718354128173,137.67919497680663,133.9853956451416,130.99999618530273,128.01459672546386,124.32079739379883,0.16,0.0,122.7078191354076,0.03578637255884165,0.03976236650356145,140.7657187325614,134.67285919189453,7.17108907547213
2023-11-13,0,142.14249801635742,120.04749870300293,142.3474998474121,127.73749876022339,138.82375240325928,-0.01589841915324178,6.555118357344421,-1.108135987271907,2.994511933836295,131.34125137329102,5.684250602722168,0.049377562603589616,125.55024890899658,141.79375114440919,0.8682983013479045,0.07753350023158748,1.0707129470163623,1.0280551021797182,1.0056777830968102,0.019691880771988135,69.63109590238435,145.8652374013343,132.7550006866455,119.64476397195669,141.06785746983118,1.4578645475452647,135.41678633008684,7.386162550873976,139.73004170132646,136.10838125531586,4.715689712330088,12.827752111300924,35680600,2.6773477116918376,0.620267831943969,-1283438700.0,-4.189714428393898,77.07053933241427,82.84087432937385,95.0641909681308,31.462051171308456,17.348940558134572,0.10277889800579737,3.5723809464296474,137.67919497680663,133.9853956451416,130.99999618530273,128.01459672546386,124.32079739379883,0.16,0.0,122.72850604433589,0.020394953003390226,0.028787807061097907,141.41143144880022,135.67500196184432,7.490697677319375
2023-11-14,0,145.68499755859375,120.04749870300293,142.3474998474121,127.73749876022339,139.86749935150146,-0.11464075515677825,6.858949552805657,-1.2462589968428466,2.9944043772821978,131.88875198364258,6.149912796020507,0.0514635270565834,125.55024890899658,141.91975021362305,0.8800507546854109,0.08682018945865178,1.0930921354463285,1.0452510187403536,1.026753290397859,0.02752452738731037,70.80333702396432,146.99577462441013,133.27787551879882,119.5599764131875,142.07535661969865,1.8723366044558514,136.99142905644007,7.023316218341765,140.33633543487775,136.5941822119268,2.986884179771685,11.170420349002438,56674600,2.6571829580093667,0.9789880137682875,-1226764100.0,-5.050126791529075,77.07053933241427,82.84087432937385,117.50456363719246,36.472174328889686,15.76377104180611,0.07750723603088774,3.650782176609338,140.43723544311524,136.21637602233886,132.80499649047852,129.39361695861817,125.17275753784179,0.18,0.0,122.76759735307037,0.0216522751910877,0.043366232434348936,142.44000244140625,137.418573651995,7.967832582686325
