date,buy?,todays_price,Minimum,Maximum,25th Percentile,75th Percentile,Skewness,Standard Deviation,Kurtosis,Shannon Entropy,Median,Mean Absolute Deviation (MAD),Coefficient of Variation (CV),10th Percentile,90th Percentile,Autocorrelation,Cumulative Return,curr_to_avg_one_month,curr_to_avg_one_two_week,curr_to_avg_one_one_week,momentum,rsi,upper_band_current,middle_band_current,lower_band_current,rolling_mean_7,rolling_std_7,rolling_mean_14,rolling_std_14,ema_7,ema_14,roc_7,roc_14,Volume,Volatility,Relative Volume (RVOL),On-Balance Volume (OBV),Williams %R,Stochastic Oscillator %K,Stochastic Oscillator %D,Commodity Channel Index (CCI),ADX1,ADX2,Chaikin Money Flow (CMF),Average True Range (ATR),Fib_23.6,Fib_38.2,Fib_50,Fib_61.8,Fib_76.4,Parabolic SAR 2,Parabolic SAR 3,VWAP,Adj Close Momentum,Adj Close Return,Adj Close 7d MA,Adj Close 14d MA,Adj Close Volatility
2021-12-30,0,47.71749973297119,45.545000076293945,48.40416622161865,46.18812561035156,47.258750677108765,0.5773156838520017,0.8284749874890737,-0.6484944560877404,2.9955754369245295,46.519165992736816,0.6845833206176763,0.017740047220297168,45.76224975585937,47.99633235931397,0.7623752924012263,0.02846546062588289,1.0217697713035552,1.0135102780513825,1.0168922589498055,0.025778379998182332,60.825449556615546,48.35778324791211,46.70083327293396,45.043883297955816,46.958214214869905,0.5561666284355684,47.16583320072719,0.7227237599895078,47.04209303574338,46.81258748047092,1.3088814648518683,3.9110805816901153,14949000,0.5354524148623402,0.45185086110550665,99369600.0,-37.50007982762342,19.18618833600314,16.367993510430818,84.91266111873205,28.646020475192945,17.676377139272716,0.20856955731827514,0.775627990807904,48.13848063659668,47.70242716217041,47.35000038146973,46.997573600769044,46.56152012634277,0.04,0.0,46.72915806357407,0.024105774095098065,0.02542603755838893,45.1982182094029,45.38732092721121,0.9369514391520068
2021-12-31,0,47.98750019073486,45.545000076293945,48.40416622161865,46.18812561035156,47.37354135513306,0.37052008813138887,0.8510197771275839,-0.9563886043639327,2.995567100277041,46.522499561309814,0.7256665992736814,0.01819487472700204,45.76224975585937,47.99633235931397,0.7450366419958815,0.04724018816382293,1.0259768079414555,1.0207337400220535,1.0174459717288697,0.031434725076754155,64.6236461208597,48.474539497034705,46.77249994277954,45.070460388524374,47.189880916050505,0.6039807032655845,47.27065467834473,0.7282484318644953,47.20815818366623,46.95147391371593,3.234353195899835,4.222711805476142,17947800,0.502163593105638,0.5610261002890654,117317400.0,-20.60475577170758,19.18618833600314,16.367993510430818,103.48040866657266,31.519541350130787,16.206716493968436,0.28775486006243445,0.7693857030437593,48.14084114074707,47.70624797821045,47.35500144958496,47.00375492095947,46.56916175842285,0.02,1.0,46.762812696342806,0.03727875995629848,0.03497870530468696,45.430079868861604,45.47101048060826,0.8876969427880999
2022-01-03,0,48.03749942779541,45.545000076293945,48.40416622161865,46.31000018119812,47.630624771118164,0.24401905327681173,0.8428949748451251,-1.135755586920858,2.9955709501579624,46.62916660308838,0.7381541395187377,0.017974617577169515,45.80741701126099,48.00983352661133,0.7141722111612854,0.053628282146215935,1.024392963947584,1.0222828990123747,1.0122285547931926,0.027906544216517615,67.09646474326244,48.579414875303655,46.8936249256134,45.20783497592315,47.40690476553781,0.5953347128757497,47.32351180485317,0.7566480269050231,47.40086896508369,47.125939147031886,3.4975472097840106,3.154558689357911,20706600,0.5022875575015927,0.6718728326231435,138024000.0,-21.052651813690627,19.18618833600314,16.367993510430818,90.11733036959761,29.315644020374435,15.073516654275116,0.27585138755549043,0.753747822136376,48.14084114074707,47.70624797821045,47.35500144958496,47.00375492095947,46.56916175842285,0.02,0.0,46.7989794714613,0.027635805453560147,0.0369919785787894,45.6518805367606,45.49570655822754,0.8738595300569678
2022-01-04,0,47.74499988555908,45.78416633605957,48.40416622161865,46.359166622161865,47.78124952316284,0.1668646370708222,0.818183078964046,-1.3195996899141855,2.9955810030420125,46.860000133514404,0.7310749435424804,0.0174013937316407,46.05750007629395,48.05483283996582,0.7487286743339652,0.04236735137316375,1.015456764001671,1.0137911242750093,1.0005658211790989,0.010565281401723192,66.35096551926485,48.65461605111657,47.018249893188475,45.38188373526038,47.58119051797049,0.4565200761349796,47.30726187569754,0.7439748855315967,47.55772156249867,47.2880867952998,3.2657381840139554,1.5645642507313688,33930000,0.4929934276604467,1.0985467324305371,104094000.0,-50.72797524076815,19.18618833600314,16.367993510430818,49.184320161733545,25.64830525698666,17.814233212214482,0.19217642377477487,0.7863061759261507,48.14084114074707,47.70624797821045,47.35500144958496,47.00375492095947,46.56916175842285,0.04,0.0,46.836681155171874,-0.005462835857368509,0.008809418814551575,45.766668047223774,45.428480693272185,0.8480522612987157
2022-01-05,0,47.95500087738037,45.78416633605957,48.40416622161865,46.480207681655884,47.80187463760376,-0.019380173899570165,0.8033648392501069,-1.305865683230082,2.9955867898500457,47.11625051498413,0.7207499504089355,0.017056125712205633,46.181250762939456,48.05483283996582,0.7739914129444185,0.030337905193848182,1.0181258670182984,1.0149689874765921,1.002868547796252,0.007422732295460754,60.37032950090447,48.7079795640593,47.101249885559085,45.49452020705887,47.755714416503906,0.27632292457506374,47.275178636823384,0.7015059726205551,47.601364315701765,47.37176001107799,2.622246699692393,-0.47422797107700404,35418000,0.49923039789244983,1.1510485549251297,139512000.0,-29.22742738509448,19.18618833600314,16.367993510430818,78.75566760814742,24.948866900918055,15.39105264549174,0.20656061304188347,0.8318867223695959,48.14084114074707,47.70624797821045,47.35500144958496,47.00375492095947,46.56916175842285,0.06,0.0,46.89075889127814,0.008478708830779613,0.007984311633440919,45.911180768694194,45.38617869785854,0.8228356220938746
2022-01-06,0,47.84833335876465,45.78416633605957,48.40416622161865,46.519582748413086,47.95937538146973,-0.21936820134532975,0.8039115364792614,-1.2597637404572357,2.9955869250537206,47.27166700363159,0.717254166603088,0.01703850679755526,46.181250762939456,48.05483283996582,0.7259886150988077,0.04682384715380056,1.014121723834763,1.0093165524929344,0.9991612461425116,0.002741837408196224,65.09055018104517,48.78986467032486,47.182041597366336,45.57421852440781,47.84178570338658,0.16065951249967583,47.24928576605661,0.6703103893069591,47.68819387845049,47.453756226169055,2.614124000896916,-0.9279476939686887,21828900,0.4791073029807296,0.7243263475289206,117683100.0,-29.101851065054536,19.18618833600314,16.367993510430818,52.96727565596827,23.035287244605705,15.374770017524975,0.21572866821484094,0.8246674460759013,47.99313497924805,47.58676838684082,47.25833511352539,46.92990184020996,46.523535247802734,0.06,0.0,46.91578016214818,0.0024447757265972925,0.005675852651277998,45.94502258300781,45.39029475620815,0.7327400432575231
2022-01-07,0,48.059165954589844,45.78416633605957,48.40416622161865,46.523749589920044,47.95937538146973,-0.3388953707470094,0.7509721309414493,-1.1676921587974103,2.995605915729297,47.44958305358887,0.6653957557678225,0.015882175664335398,46.351500034332275,48.05483283996582,0.6816215603590403,0.04508473535488058,1.016394729609152,1.0109276997942842,1.0030157614849498,0.0014934256539751445,63.09602983907134,48.78590250620663,47.28395824432373,45.78201398244082,47.90714277539934,0.13818162185558794,47.325892857142854,0.6986737061469365,47.73314918578832,47.5209388855402,1.275242603840774,-0.751906084267706,19723500,0.4806766257805045,0.6684704030649284,137406600.0,-12.694720914869647,19.18618833600314,16.367993510430818,77.94325549448264,23.60156072384484,14.12472488243406,0.1885377068641893,0.8226054517737577,47.99313497924805,47.58676838684082,47.25833511352539,46.92990184020996,46.523535247802734,0.06,0.0,46.94412973364969,0.001382126636797265,0.012013800876750027,46.04471806117466,45.530691146850586,0.7051635813649173
2022-01-10,0,48.230000495910645,46.222500801086426,48.40416622161865,46.68125009536743,47.97624921798706,-0.3520730990436238,0.6845426535929139,-1.3483503166784176,2.9956277974746044,47.65958309173584,0.6164374065399173,0.01444252642637765,46.50308256149292,48.07433271408081,0.7159028764885207,0.033086123536290826,1.0175597576723554,1.0112577563912415,1.0062801351105939,0.004007308257262254,63.46646374108331,48.76679353243607,47.39770822525024,46.028622918064414,47.98035717010498,0.15562516651632138,47.469285692487446,0.6597178790682375,47.82260498778878,47.61224894172715,0.961099764364542,2.2825608858909128,22731600,0.458402040675237,0.7916770059789522,160138200.0,-16.876571039826626,19.18618833600314,16.367993510430818,73.90811096371246,22.420293088934677,12.957128421385677,0.14446391978553466,0.8226652908262312,48.025388000488284,47.638974548339846,47.32666778564453,47.014361022949224,46.627947570800785,0.06,0.0,46.97552881514856,-0.0002766335818504828,-0.0005530318416215635,46.110572814941406,45.65439551217215,0.7133446571338382
2022-01-11,0,48.017499923706055,46.222500801086426,48.40416622161865,46.923333406448364,48.0,-0.5438836821209412,0.6763174382920433,-1.114795918312271,2.9956305693441556,47.73124980926514,0.5970665740966794,0.0142432970067523,46.50308256149292,48.21275024414062,0.7740479491703268,0.01971564767698565,1.0112522230126526,1.0036525879252776,1.0010423684608505,0.0057074047292937635,63.21683771155307,48.8358431514254,47.48320827484131,46.13057339825722,47.98464284624372,0.1562664108613793,47.587261881147114,0.5913500932598353,47.9299152079558,47.692609718666446,1.0740310490017821,4.343122202459963,21668700,0.42895919974577085,0.7997395800174167,138469500.0,-23.584990051976497,19.18618833600314,16.367993510430818,52.81039443931848,21.314090586103816,12.317832234115414,0.07963067072204352,0.7946751819302562,48.06629440307617,47.70518745422363,47.413333892822266,47.1214803314209,46.76037338256836,0.06,0.0,47.00040843056248,0.015492912005345305,-0.0031110156596191006,46.088163648332866,45.75912175859724,0.7193229761113957
2022-01-12,0,47.84000015258789,46.222500801086426,48.40416622161865,46.923333406448364,48.022499799728394,-0.6575502459944136,0.6845862035828052,-1.0642467888234082,2.995628165006162,47.796666622161865,0.6036957216262813,0.014406515349139486,46.50308256149292,48.21275024414062,0.8087529984323278,0.0009380589088748937,1.006750783019145,0.9983322909799537,0.9962100710295327,-0.0023980966049095276,55.93261311066775,48.888380695358364,47.51920828819275,46.15003588102714,47.95642866407122,0.1628243210058142,47.681666714804514,0.5070676545592314,47.95411499558637,47.71499975442675,0.06251572357791535,3.5622494503076014,18946800,0.40596253690336603,0.7370584998462419,119522700.0,-35.352219829531535,19.18618833600314,16.367993510430818,34.83733450698821,20.410354121300795,12.431536301084913,0.0097276539282604,0.7627634973822591,48.09146771240234,47.74593408203125,47.46666717529297,47.18740026855469,46.841866638183596,0.06,0.0,47.01749657335249,-0.0033350337349355996,0.010140883790824036,46.032828194754465,45.84235436575754,0.7012463320802811
2022-01-13,0,48.14083480834961,46.222500801086426,48.40416622161865,46.923333406448364,48.022499799728394,-0.6489207783818094,0.680798158564077,-1.0539916648901675,2.9956292912589286,47.792500019073486,0.5990582656860347,0.014328796932230168,46.50308256149292,48.21275024414062,0.7907864108680503,-0.01165532046245204,1.0132228435690678,1.0041107507933695,1.0029549538804023,0.006113095881350672,50.23373110047199,48.87417966826341,47.512583351135255,46.1509870340071,48.01297651018415,0.14490827123300645,47.79708351407732,0.39506483622386285,47.92492094354914,47.70096628879722,-0.41113562854032054,2.8411759422643077,24252600,0.3946904424042664,0.9607234957871345,143775300.0,-7.523502537251589,19.18618833600314,16.367993510430818,84.4028650955036,24.55410090288137,11.324102477494831,0.014008615483253897,0.770285135961383,48.14810810852051,47.83761472320557,47.58666801452637,47.335721305847166,47.025227920532224,0.06,0.0,47.049479318563876,0.013587045868256764,0.01076999213167517,46.19151796613421,45.97909300667899,0.6941454026217703
2022-01-14,0,48.34416675567627,46.222500801086426,48.230000495910645,46.923333406448364,48.022499799728394,-0.7124629089417492,0.6658091078145669,-1.0525870133993127,2.995633699151535,47.792500019073486,0.5898416662216178,0.014017205956269712,46.50308256149292,48.1478346824646,0.7773955985029494,-0.0014519297011953243,1.0177844283669555,1.0074622311712973,1.0059650728201555,0.005930206973540075,56.83108513920005,48.83103499610094,47.499416780471805,46.16779856484267,48.068571635655,0.18738575244120032,47.91214302607945,0.2789245020119644,47.97501057215888,47.709422569483614,0.8290604748964536,3.473047185530273,26867400,0.3993051991411619,1.090663753618476,170642700.0,-26.036564188503135,19.18618833600314,16.367993510430818,101.01679391074474,25.781005881125463,10.389442094539895,0.05753034545245934,0.7729095361272864,48.40230741882324,48.108847663879395,47.87166786193848,47.63448805999756,47.34102830505371,0.08,0.0,47.088146649423784,0.0011733753106768496,0.01073026406902972,46.243652888706755,46.07741682870047,0.7152937663395816
2022-01-18,0,47.81333351135254,46.222500801086426,48.34416675567627,46.923333406448364,48.022499799728394,-0.6782343189970266,0.6735219066644101,-1.0525121476444173,2.995631442724225,47.792500019073486,0.5945083284378043,0.014177592802488087,46.50308256149292,48.149751377105716,0.8597627478047529,0.02889117641727955,1.0064675942177996,0.9956599530011393,0.9937406205360285,-0.0086391660848818,67.82930721589842,48.85312725410947,47.50608344078064,46.15903962745182,48.06357165745327,0.1945709486380273,47.95267868041992,0.2064680141063759,48.06134474335929,47.75069949752102,0.8115230344609626,3.44686125377453,21123900,0.27866935944732285,0.9707170537559401,149518800.0,-84.39420322549603,19.18618833600314,16.367993510430818,16.64945369122657,23.266692208240627,16.332831844066657,0.18849332180593298,0.7889619419390174,48.493560440063476,48.25655382537842,48.06500053405762,47.87344724273682,47.636440628051766,0.08,0.0,47.10140828618111,-0.014452789238926012,-0.01635734693978258,46.19792011805943,46.07147135053362,0.6530054594887176
2022-01-19,0,47.78250026702881,46.222500801086426,48.34416675567627,47.117709159851074,48.022499799728394,-0.860273192232135,0.6656979460096069,-0.7850808683311414,2.9956338628381496,47.826666831970215,0.5673666572570795,0.014000717411346548,46.50308256149292,48.149751377105716,0.8253194342644711,0.0344168463993779,1.0049441904641343,0.9954825767521984,0.9948228040524475,-0.004894041902444579,58.579414188444694,48.87881267439836,47.54741678237915,46.21602089035994,48.02404798780169,0.22180847495896902,47.965595381600515,0.18761516698925104,47.995817235320274,47.7457546363597,-0.0731474744369508,1.2011623216461695,22674000,0.2446374957949428,1.0623158288291263,126844800.0,-55.23620187664372,19.18618833600314,16.367993510430818,32.00484167817168,21.896592388573627,14.713647145280529,0.17347345261073993,0.8072916051592437,48.493560440063476,48.25655382537842,48.06500053405762,47.87344724273682,47.636440628051766,0.08,0.0,47.118779432278046,-0.0018030686130453555,-0.004633122993532251,46.15447507585798,46.099596568516326,0.5968145010065395
2022-01-20,0,47.42500019073486,46.3658332824707,48.34416675567627,47.51270842552185,48.022499799728394,-1.0517470069494113,0.5933488466750114,-0.2834004142130464,2.995654319953527,47.826666831970215,0.47625007629394533,0.012458659411191246,46.52433290481567,48.149751377105716,0.7967740634798773,0.030554114619863796,0.9957918149888416,0.9879573690621629,0.988346845593662,-0.008674748338824534,57.18539945008871,48.81211444902629,47.62541675567627,46.43871906232625,47.90904794420515,0.2941260372599806,47.94470255715506,0.2290739600802813,47.94178375851041,47.76033474965922,-0.5756772554531036,0.37988967616577846,22387200,0.24549388132819597,1.054394783413459,104457600.0,-97.3021982545694,19.18618833600314,16.367993510430818,-46.31542488290742,19.58741888604239,15.806205423251185,0.08339549196705137,0.8323596361007399,48.4392805480957,48.16869400024414,47.95000076293945,47.73130752563477,47.460720977783204,0.02,1.0,47.125263454643,-0.015476944088604894,-0.02066574955518275,45.99944414411272,46.05500847952707,0.5566839916433574
2022-01-21,0,46.97749996185303,46.51833248138428,48.34416675567627,47.55749988555908,48.022499799728394,-1.153242632366893,0.5214777858913812,0.2589335109492361,2.9956722046997553,47.826666831970215,0.4021083927154535,0.010937406838754979,46.712500190734865,48.149751377105716,0.745792845990703,0.019490546220963887,0.9852999365487932,0.9797167489986159,0.9807172309033869,-0.0241652404061512,48.33613780351658,48.72133067287224,47.67837510108948,46.635419529306716,47.760476521083284,0.4510296169050365,47.8725596836635,0.3445128482151973,47.811978378880994,47.73464190574755,-1.6690862469388448,-0.6129817024638043,27508200,0.26277778027213095,1.2643794655199636,76949400.0,-98.02140760675499,19.18618833600314,16.367993510430818,-137.19679744005649,18.24286074242076,17.87259697653819,-0.0033088748569436834,0.8247147154591365,48.35982734680176,48.04008754730225,47.781667709350586,47.52324787139892,47.203508071899414,0.04,0.0,47.12058222761511,-0.036296200060060846,-0.022657648002950836,45.81605911254883,45.95211138044085,0.5446248032124645
2022-01-24,0,46.4258337020874,46.52499961853027,48.34416675567627,47.55749988555908,48.022499799728394,-1.0832437396306227,0.4782137056837013,0.30175592504442994,2.995681836875736,47.826666831970215,0.3699666690826405,0.010025164305589033,46.95308332443237,48.149751377105716,0.62140998899174,0.009725961247349032,0.9732607103386118,0.9699733302546688,0.9739310775111094,-0.03968075534911619,40.46470916523642,48.65776088648032,47.70133347511292,46.74490606374552,47.55845274244036,0.6720389979163505,47.75744070325579,0.513152846107054,47.60348039332196,47.65941415119969,-2.1658769479990845,-2.1047152380670178,28699200,0.2851308115234413,1.286289674682895,48250200.0,-68.99142184249907,19.18618833600314,16.367993510430818,-223.00967043285772,16.461721863978706,24.46599675689716,0.04880847222505788,0.8437975406853022,48.14349371337891,47.68992039489746,47.323333740234375,46.95674708557129,46.50317376708984,0.06,0.0,47.102810683384355,-0.03350341450695782,-0.03622747246103948,45.66788700648716,45.85035760062082,0.5206528013954035
2022-01-25,0,46.19333362579346,46.4258337020874,48.34416675567627,47.55749988555908,48.022499799728394,-1.1613774296738533,0.49073483679942165,0.5610063363098647,2.9956791304481745,47.826666831970215,0.3769082832336437,0.01028872393247387,46.95308332443237,48.149751377105716,0.5475756020892382,-0.006579883392704661,0.9684873001806243,0.9684204639863873,0.9769164905655512,-0.03388175988972697,32.184379644512894,48.677844852889606,47.69637517929077,46.71490550569193,47.28023828778948,0.7844718861361224,47.646607398986816,0.6620211385313989,47.31120121939105,47.51790178000557,-2.9560335409488694,-3.355015862410747,29479500,0.3087687478606867,1.2826344749539398,18770700.0,-96.53763904508294,19.18618833600314,16.367993510430818,-256.8297310527751,14.747374487783159,23.38074235302235,-0.03349011683477598,0.8699752511678203,48.10416007995605,47.62625324249267,47.239999771118164,46.853746299743655,46.375839462280275,0.08,0.0,47.07460249432063,-0.037678682333488145,-0.054529098207234956,45.28739765712193,45.73945781162807,0.6578418223642638
2022-01-26,0,45.586666107177734,46.19333362579346,48.34416675567627,47.55749988555908,48.022499799728394,-1.3985003630398727,0.5537832792408008,1.1648253588220534,2.9956644223627493,47.826666831970215,0.4147082805633545,0.011617170922333078,46.922333335876466,48.149751377105716,0.6767038269841625,-0.02227711160697128,0.9563092852359883,0.9598001058808189,0.9707380099871242,-0.045954777326004836,26.767145156457968,48.77694173967972,47.66937518119812,46.56180862271652,46.88630962371826,0.8507213841157956,47.477440629686626,0.8523787479166435,47.03366035347628,47.359139074881966,-4.045424617809858,-3.249903159461397,26185500,0.2855739840653049,1.1141021320916555,-7414800.0,-94.85614568616651,19.18618833600314,16.367993510430818,-247.32441909917526,13.233972987185751,25.645991899014977,-0.09853838103357952,0.8958084951490863,47.97436026000977,47.41615353393555,46.96500015258789,46.51384677124023,45.955640045166014,0.1,0.0,47.03895657716068,-0.05689863366982861,-0.04750188377107391,44.861633845738005,45.55264336722238,0.838999469556298
2022-01-27,0,45.60083293914795,45.586666107177734,48.34416675567627,47.55749988555908,48.022499799728394,-1.5438110569875696,0.7125365498045829,1.3625614397504675,2.9956192877927945,47.826666831970215,0.5323750257492079,0.01497352812385629,46.40258369445801,48.149751377105716,0.7120165061237371,-0.04233045801911349,0.9582741470214646,0.9650374182757112,0.9802063459167859,-0.0384642539641632,19.82968916531873,49.01148986863687,47.58641676902771,46.16134366941854,46.57023811340332,0.8598575328943879,47.31690488542829,0.9793418018798767,46.6734065170224,47.14556921623241,-5.703895285721863,-4.938660675366067,27759000,0.29339513658931743,1.1452030312669017,20344200.0,-94.0715220740244,19.18618833600314,16.367993510430818,-181.88208651263366,12.684196831872121,23.043224606720045,-0.1287372219417356,0.9215880016099022,47.97436026000977,47.41615353393555,46.96500015258789,46.51384677124023,45.955640045166014,0.1,0.0,47.00447154684999,-0.0380967449050541,-0.05627359320777223,44.55614471435547,45.37703241620745,0.9707838610220962
2022-01-28,0,45.420000076293945,45.586666107177734,48.34416675567627,47.313125133514404,48.022499799728394,-1.2783348153918233,0.8335559534859003,0.2388489977288959,2.9955770308924423,47.826666831970215,0.6709084033966064,0.017553581460899914,46.1340835571289,48.149751377105716,0.8040954580379172,-0.04435829215001172,0.9564848861784204,0.9657870653377463,0.9840363140458037,-0.033154167140095,19.452646733965665,49.15348700043189,47.48637509346008,45.81926318648828,46.232738086155486,0.7629169893033211,47.128393036978586,1.0748243887281332,46.405524737764004,46.954693010727304,-4.627371508575669,-4.697134177621281,25131900,0.29020943169633395,1.0154912325042533,-4787700.0,-71.84545056611267,19.18618833600314,16.367993510430818,-155.523182014196,11.461863916363592,24.602743757310357,-0.08067735196337024,0.9430584265964598,47.8791739654541,47.26208080291748,46.76333427429199,46.2645877456665,45.647494583129884,0.12000000000000001,0.0,46.971708860017586,-0.01904556444442629,-0.026200240318083937,44.262545994349885,45.20851053510393,1.0267795680918748
2022-01-31,0,46.1366662979126,45.420000076293945,48.34416675567627,46.83958339691162,48.022499799728394,-1.0355715898729625,0.9446923422679306,-0.4850282539959201,2.9955320250395943,47.826666831970215,0.8024834251403803,0.019942208713293847,45.59941625595093,48.149751377105716,0.832380962003283,-0.053503518712913395,0.9739329805931852,0.9867345740609951,1.006354692765979,-0.006228588290527637,16.4179443221637,49.260884795162085,47.37150011062622,45.48211542609036,46.048690387180876,0.5542081392102131,46.97886916569301,1.0552140345806285,46.15896539207482,46.771757722316366,-4.944279134687832,-5.491493299716425,20193600,0.276144776081235,0.8122665376282063,15405900.0,-53.78553152315669,19.18618833600314,16.367993510430818,-76.54291966733923,16.922578990675742,22.45282880399948,-0.06947087896784572,0.9558330491106822,47.8791739654541,47.26208080291748,46.76333427429199,46.2645877456665,45.647494583129884,0.12000000000000001,0.0,46.96025339554292,-0.002781724626770954,-0.0027106069059827666,44.19806398664202,45.09875406537737,1.0182073292909375
2022-02-01,0,46.68833351135254,45.420000076293945,48.34416675567627,46.367708683013916,48.022499799728394,-0.7851057934970265,0.9701276094457733,-0.9697202000846934,2.9955205932424263,47.797916889190674,0.8611876201629635,0.02051922550640987,45.59941625595093,48.149751377105716,0.8887756935272938,-0.03956977678948364,0.9875076582813872,1.0032698620086202,1.0196742278097726,0.010715829465113291,33.69131688900562,49.21921363487665,47.27895841598511,45.338703197093565,46.00738089425223,0.4791295493316251,46.883928707667756,1.0135490580915982,46.15327183192287,46.71115542762597,-2.716571191651697,-4.34031552244238,20323200,0.3337787682576889,0.8181104021534814,35729100.0,-45.110402122753264,19.18618833600314,16.367993510430818,-33.45582803533002,18.899844769228114,21.164754659576086,-0.07283035150397267,0.9382033345379837,47.8791739654541,47.26208080291748,46.76333427429199,46.2645877456665,45.647494583129884,0.02,1.0,46.95733914324949,0.027415212226722607,0.005064272135079895,44.23099136352539,45.02352523803711,0.9966114474288433
2022-02-02,0,46.97000026702881,45.420000076293945,48.34416675567627,46.367708683013916,47.97062563896179,-0.6307612795684097,0.9619093629352218,-1.118143237618458,2.9955237974187328,47.763750076293945,0.8662834739685052,0.02037447148442572,45.59941625595093,48.149751377105716,0.9166721332737503,-0.022131456209849975,0.9948847240075089,1.01176842843971,1.0236126199578537,0.03034514865813498,44.387689011071174,49.1353188460334,47.21150012016297,45.287681394292534,46.08511897495815,0.5897204974071901,46.82178585869925,0.9764115401701604,46.28722603867073,46.74107107162364,-0.6155424420952564,-2.768087498235849,18149700,0.360331644518818,0.7545830766045445,53878800.0,-45.58359920396753,19.18618833600314,16.367993510430818,-17.36732095281469,19.471538355410786,20.29963502273111,-0.016981701550009762,0.9053059485382792,47.8791739654541,47.26208080291748,46.76333427429199,46.2645877456665,45.647494583129884,0.04,0.0,46.957377723648655,0.03756897318601138,0.026977657331438188,44.2607171194894,44.96430206298828,0.9975709876367469
2022-02-03,0,46.917500495910645,45.420000076293945,48.34416675567627,46.367708683013916,47.97062563896179,-0.5318504690143026,0.9552240943621262,-1.1657440966982593,2.995526490585381,47.603750228881836,0.8555584764480593,0.02024948919752737,45.59941625595093,48.149751377105716,0.9119416650533413,-0.020540102019186324,0.9945890446799815,1.0124094483913757,1.016340600804098,0.028873761111331442,47.930344906882695,49.0831983279607,47.17275013923645,45.262301950512196,46.188571384974885,0.6699320075168038,46.73440483638218,0.9011235893403559,46.45816777150596,46.81300167309964,1.1721201786774578,-1.818561627893347,20741100,0.36345387451190186,0.8894592447502067,33137700.0,-44.47953284987765,19.18618833600314,16.367993510430818,-12.695640169238471,18.27306773370476,20.103752036415116,0.007000951744108504,0.8930275046289224,47.8791739654541,47.26208080291748,46.76333427429199,46.2645877456665,45.647494583129884,0.06,0.0,46.95761965451661,0.037912528794084244,0.038600405357232366,44.43632779802595,44.86186272757394,0.9819595666019592
2022-02-04,0,46.63083362579346,45.420000076293945,48.34416675567627,46.367708683013916,47.890625,-0.4232675962965165,0.9393741858283268,-1.1743532258341973,2.9955329799589783,47.201250076293945,0.8292084217071534,0.019935414684740645,45.59941625595093,48.149751377105716,0.9115256475039545,-0.019453819966406376,0.9896003312094724,1.007326738299292,1.004401225496708,0.02665859857916386,47.55625220614977,48.99962349181963,47.120875120162964,45.2421267485063,46.33773817334856,0.6285438434867691,46.612023898533415,0.7729077288955614,46.572354697155475,46.87163740714894,1.5676869653607914,-2.5411572468759687,22036500,0.36322501655922096,0.9445905777556024,11101200.0,-51.26817941514891,19.18618833600314,16.367993510430818,-44.26740766040589,16.933257649834356,22.55863634000215,-0.005299871022367424,0.8923093376680352,47.461521759033204,46.92424171447754,46.4900016784668,46.055761642456055,45.51848159790039,0.06,0.0,46.95017121884699,0.01316151814372768,0.025691968149065086,44.60004643031529,44.73084013802664,0.9790615420853389
2022-02-07,0,46.30833339691162,45.420000076293945,48.34416675567627,46.367708683013916,47.88437509536743,-0.2712327930157165,0.9296587308608957,-1.2085055572636176,2.9955367769680525,46.97375011444092,0.8112500858306888,0.01975475410589357,45.59941625595093,48.149751377105716,0.8908737294288538,-0.02972028957277348,0.9840274812054776,1.0011097419199213,0.9922789000181544,0.0037208388202680798,42.71805461029768,48.9193175952362,47.06000013351441,45.20068267179261,46.4388096673148,0.5410994005337302,46.50452389035906,0.6935592846016674,46.588371583389375,46.877531798417785,2.290510817704469,-3.5440328065673894,20010300,0.36147872760170885,0.8572109703367041,-8909100.0,-63.67755444754274,19.18618833600314,16.367993510430818,-66.07454162265114,15.776810618406175,23.072418961630582,-0.06166040590458138,0.8869676861379128,47.461521759033204,46.92424171447754,46.4900016784668,46.055761642456055,45.51848159790039,0.06,0.0,46.93848291483678,-0.01323223640725224,0.003199525287635637,44.69699914114816,44.62657192775181,0.9635243158057143
2022-02-08,0,46.08833312988281,45.420000076293945,48.34416675567627,46.27958345413208,47.82000017166138,-0.09056239323552676,0.9137479666181546,-1.2188796721210478,2.9955429345122035,46.94375038146973,0.7818709516525267,0.019452845256303235,45.59941625595093,48.149751377105716,0.8596495534789096,-0.03984381254903696,0.981177792181312,0.9966068535831687,0.9868388085111749,-0.012851184361160173,37.98474494799421,48.7999544388668,46.97245850563049,45.144962572394185,46.534285817827495,0.36004220143036036,46.38351195199149,0.5940923870745066,46.51909243432262,46.82893208315416,1.55150775142155,-3.147657784796743,19458900,0.36059233448935646,0.8394744403115463,-28368000.0,-61.560448486841665,19.18618833600314,16.367993510430818,-67.29815003916394,15.000921176877837,22.22200542384424,-0.09090210187125755,0.8641011101978624,47.32654582214356,46.81505960845947,46.40166664123535,45.98827367401123,45.476787460327145,0.06,0.0,46.925994454996655,-0.020722377928829472,-0.013017536128925856,44.71849387032645,44.49051993233817,0.9403627560379171
2022-02-09,0,46.03750038146973,45.420000076293945,48.34416675567627,46.17916679382324,47.79020857810974,0.07186780648315287,0.8851450671320499,-1.184441158731746,2.9955539761368617,46.80291700363159,0.75745849609375,0.018886972835239636,45.59941625595093,48.02983341217041,0.8532417275344447,-0.0401763273158422,0.9823350447226025,0.9957337369978948,0.9882897237298687,-0.01985309517261513,36.07408994195954,48.635665271593204,46.8653751373291,45.095085003065,46.52011925833566,0.37970865326148384,46.28440482275827,0.5178216257721295,46.412228455983445,46.72285732828966,1.4714510181995577,-3.5455807621582673,21473700,0.36071810121244946,0.9267845513033818,-49841700.0,-54.99395431722345,19.18618833600314,16.367993510430818,-68.10320618017391,14.418275842982366,21.476579314620825,-0.1413159495939769,0.8329187850798118,46.76627896118164,46.361859451293945,46.03499984741211,45.70814024353027,45.30372073364258,0.06,0.0,46.91123864127263,-0.02243528081009072,-0.02285160541113676,44.62154170445034,44.409802845546174,0.9180397359299804
2022-02-10,0,45.42499923706055,45.420000076293945,48.34416675567627,46.12458300590515,47.51437520980835,0.2602881924938484,0.8611504217036157,-1.0507417235088532,2.9955629903427834,46.659583568573,0.7313459968566896,0.018413880031398495,45.59941625595093,47.87008361816406,0.8542598864159766,-0.037677670680790296,0.9713175135220271,0.981529013566305,0.9790608997527878,-0.031811184378421564,35.988080821553666,48.48867600362452,46.76637516021729,45.044074316810054,46.3396429334368,0.5489477612224039,46.173511913844514,0.5241730363852646,46.320549544670925,46.60766049123425,-0.2149394925990952,-2.925671699915363,27810600,0.36042292912158014,1.17775152138837,-77652300.0,-73.50749986477754,19.18618833600314,16.367993510430818,-109.99285613998494,13.466653977541792,26.00807705469407,-0.14709667166597748,0.8263459328273245,46.6975217590332,46.30624171447754,45.9900016784668,45.67376164245606,45.28248159790039,0.02,1.0,46.88074788053917,-0.03482529078759866,-0.03386582469748078,44.400656018938335,44.31582369123186,0.9286800657494836
2022-02-11,0,45.29166603088379,45.420000076293945,48.34416675567627,46.07562494277954,47.089375019073486,0.3936939683990998,0.8713956692538762,-0.8726451837631739,2.995558186552717,46.52833366394043,0.7248543739318848,0.01868118750935343,45.570499420166016,47.846083641052246,0.7810760319565065,-0.05641438463003189,0.9709735032977839,0.9790199566558582,0.9825082666462633,-0.028718499987718804,28.17902191293806,48.388416452948675,46.64562511444092,44.90283377593316,46.0998808997018,0.5925321732239197,46.092499937329976,0.5679890673841642,46.09978930097636,46.41877604405842,-2.705888557758878,-3.3047751073453293,23733300,0.3653151106603451,1.0061882785825529,-101385600.0,-82.83585701149818,19.18618833600314,16.367993510430818,-120.40892998123802,12.287774165197472,27.483055439413334,-0.20179967898856996,0.8393066502699446,46.6975217590332,46.30624171447754,45.9900016784668,45.67376164245606,45.28248159790039,0.04,0.0,46.85217615767412,-0.028708595156902605,-0.040144747229044785,44.148216247558594,44.204466683524,0.8784406686632332
2022-02-14,0,44.82916736602783,45.29166603088379,48.34416675567627,45.92833352088928,46.97187519073486,0.4583529095693934,0.8478877662448093,-0.6472711489927048,2.995566495779998,46.36708354949951,0.7020668506622314,0.01823290383986436,45.424499320983884,47.78558359146118,0.730242486922857,-0.06314103499227391,0.9640024663004444,0.9692915203119841,0.9781585111494568,-0.031941681386064236,25.934032303854035,48.19894220805725,46.50316667556763,44.80739114307801,45.80154759543283,0.6363644154279833,45.99505949020386,0.6590708688029588,45.89925674301801,46.22605884544687,-3.5732046553194245,-2.442966729432408,29363400,0.3561394554402712,1.238327970045717,-130749000.0,-86.63791668259549,19.18618833600314,16.367993510430818,-151.77821740354577,11.152542616777374,29.094268642899515,-0.1982461817829998,0.8571443418593212,46.599974960327145,46.148348167419435,45.783334732055664,45.41832129669189,44.96669450378418,0.06,0.0,46.80891241260191,-0.029066319461059642,-0.03861310367665991,43.826263427734375,44.13129561288016,0.8460370503994786
2022-02-15,0,44.88083362579346,44.82916736602783,47.81333351135254,45.597291231155396,46.930625438690186,0.16007953119393592,0.8115880925959451,-0.7610256032919085,2.9955789500874523,46.25083351135254,0.6684085178375241,0.017518526831420352,45.40716667175293,47.46075019836426,0.7234942220482946,-0.062412844413288246,0.9687747950750353,0.9731598243005685,0.985648200886483,-0.026199678358652445,23.36977176096946,47.9505928912771,46.3274167060852,44.70424052089331,45.55154759543283,0.5989236051834785,45.944642884390696,0.7171522622899352,45.63243439185095,45.99379919743958,-4.451074988670449,-2.9531669457254783,21824400,0.3527115430777142,0.919032002142572,-108924600.0,-82.1120756099095,19.18618833600314,16.367993510430818,-127.38022580195087,10.545610338049928,27.510930083064807,-0.18457439812217594,0.8403247792376889,46.599974960327145,46.148348167419435,45.783334732055664,45.41832129669189,44.96669450378418,0.06,0.0,46.77989710775494,-0.026233980330581108,-0.026022108963111044,43.59943389892578,44.099740164620535,0.8518501549325964
2022-02-16,0,44.61999988555908,44.82916736602783,47.78250026702881,45.54624938964844,46.745625257492065,0.10178856507350725,0.794612506758507,-0.7560149890713492,2.995584310807196,46.16499996185303,0.6511251926422119,0.01720655877268871,45.25058279037476,47.02224998474121,0.7192992144298506,-0.0607265552246034,0.9662025753913371,0.9713109134415778,0.985144814460782,-0.030790127269403,24.675120681864332,47.77001672532426,46.18079171180725,44.591566698290244,45.310357093811035,0.5831099508982023,45.87458338056292,0.796808677636169,45.44466005826354,45.81700898653942,-3.7528816534645912,-1.548330996008375,28490700,0.35474072704950976,1.1852361230626764,-137415300.0,-91.06572896610238,19.18618833600314,16.367993510430818,-142.95840716924488,9.874539710947948,28.942040271157886,-0.21137876251278478,0.8320432076620929,46.59918812561035,46.14707456207275,45.781667709350586,45.41626085662841,44.96414729309082,0.08,0.0,46.73750977884611,-0.030212656690201345,-0.03232124961301496,43.396841866629465,44.04692050388881,0.8084447108647278
2022-02-17,0,45.510833740234375,44.61999988555908,47.42500019073486,45.4237494468689,46.64520859718323,-0.12040186440559675,0.7745550695016502,-0.9544202542786149,2.9955905420808326,46.112499713897705,0.6527168273925781,0.016829860700443504,44.87566699981689,46.97075023651123,0.7204549531253507,-0.05914602622866783,0.9888786767634176,0.9957971396337326,1.0111421448662028,0.001889587333306908,23.301771728559302,47.57177683173706,46.022666692733765,44.47355655373047,45.22785718100412,0.4877505873541973,45.8810714994158,0.7931840107849386,45.237308565016804,45.6296435600696,-3.64585245787562,-2.1509103899434034,53831400,0.35245309063558466,2.1019511557990262,-83583900.0,-33.47696954690528,19.18618833600314,16.367993510430818,-13.418183187797696,20.479501682913053,24.38807157303271,-0.07526066194200702,0.9155673616966403,46.59918812561035,46.14707456207275,45.781667709350586,45.41626085662841,44.96414729309082,0.08,0.0,46.70448207313769,0.020575992946874955,0.008642523531711308,43.43754141671317,44.07801764351981,0.7721036059876898
2022-02-18,0,46.06999969482422,44.61999988555908,46.97749996185303,45.4237494468689,46.477083683013916,-0.15164227110227624,0.711018395874934,-1.053112183256108,2.9956123319315164,46.06291675567627,0.6177626323699954,0.015481504134098014,44.87566699981689,46.92275047302246,0.7703244460001216,-0.03122061035196901,1.0031145394707495,1.011144086439869,1.0231752315218525,0.01718492014424222,42.592877159384415,47.348995161958605,45.92695837020874,44.50492157845887,45.23249994005476,0.4968123099367299,45.87630959919521,0.7917302899751216,45.301887989754235,45.59135511126233,-1.2530272857145222,0.19998604973107098,31103400,0.41386873752778264,1.2060272280322986,-52480500.0,-43.0571107932884,19.18618833600314,16.367993510430818,24.319955369668964,19.47198942490246,22.807068100970817,-0.046815369229554205,0.9078964377568649,46.59918812561035,46.14707456207275,45.781667709350586,45.41626085662841,44.96414729309082,0.02,1.0,46.69216865645123,0.019655742729764114,0.014036019940770353,43.45126233782087,44.0364020211356,0.7498206834585839
2022-02-22,0,45.69999980926514,44.61999988555908,46.97000026702881,45.4237494468689,46.337708473205566,-0.16957283638238996,0.6703203910627983,-0.9104352617847926,2.995625454446967,46.05375003814697,0.5769251203536989,0.014609792034620674,44.87566699981689,46.71125020980835,0.7937083880495776,-0.0076645690316851445,0.9960423434784313,1.0042594921672054,1.0114610029296154,0.01942557701612002,52.45985404229265,47.222224138982895,45.8815833568573,44.5409425747317,45.271785736083984,0.5246636001293998,45.805714334760395,0.7570595803143365,45.489135472847195,45.65673994477787,0.07059313187119362,-0.14449809324735532,25380900,0.4211102129423163,0.990510867719974,-77861400.0,-59.63403562325931,19.18618833600314,16.367993510430818,-24.579536858115357,18.265049150127222,24.681232445211652,-0.11920247402312703,0.8976472868984328,46.59918812561035,46.14707456207275,45.781667709350586,45.41626085662841,44.96414729309082,0.02,0.0,46.675219195646235,0.018663495383010487,0.008275921459799742,43.468182700020925,43.934419359479634,0.7275669990595011
2022-02-23,0,45.32833290100098,44.61999988555908,46.97000026702881,45.4237494468689,46.222083568573,-0.04199478511946789,0.6594319880763388,-0.8193086625829422,2.995628797304699,45.86875009536743,0.5587917804718018,0.014383854135665054,44.87566699981689,46.71125020980835,0.7929694983259266,-0.010679762160591336,0.9887238418063928,0.9974254696658896,0.9993826562231671,0.009970832514802908,48.22070261538938,47.16415563836886,45.845291662216184,44.526427686063506,45.27702386038644,0.525078033870494,45.68845238004412,0.6867221968150335,45.53798110041228,45.678003495675235,0.6053947756155981,-2.1168750901059323,21030900,0.425876233710048,0.834505877003145,-98892300.0,-74.70401208219499,19.18618833600314,16.367993510430818,-65.02806740222321,17.09886999155059,26.093993006233426,-0.10815311916853458,0.8893606711171771,46.59918812561035,46.14707456207275,45.781667709350586,45.41626085662841,44.96414729309082,0.02,0.0,46.65645117716578,0.005060695533693149,0.008211905942545204,43.45537730625698,43.801796776907786,0.747015971933265
2022-02-24,1,44.62166690826416,44.61999988555908,46.97000026702881,45.3970832824707,46.17958307266235,0.12373926608598555,0.6635402315480999,-0.851426040043874,2.995627389883093,45.65041637420654,0.5629126167297365,0.014487132188705187,44.87566699981689,46.71125020980835,0.8012808494157277,-0.005666858935667651,0.9742287750543644,0.9835204464093792,0.9818648654944105,3.7360437233457944e-05,45.40345106848151,47.12912208907277,45.802041625976564,44.474961162880355,45.247380937848774,0.559316252979122,45.5244642666408,0.6434055089156827,45.48308301988827,45.66146884785799,0.08095721206675163,-3.495140210123059,31717500,0.41201868463456237,1.2448868092040968,-130609800.0,-71.96884252976882,19.18618833600314,16.367993510430818,-121.53546730532189,15.702195849080471,31.56655136190165,-0.029969452523868383,0.8983378109364321,46.2927868347168,45.85527360534668,45.50166702270508,45.14806044006348,44.71054721069336,0.02,1.0,46.617239630169124,0.007488826150573669,0.001190746673633438,43.48190089634487,43.65408216203962,0.7656605798515485
2022-02-25,0,45.17166709899902,44.61999988555908,46.97000026702881,45.31916618347168,46.17958307266235,0.07704651962659054,0.7108463077585653,-0.9957897842899643,2.9956116231132928,45.65041637420654,0.6063375806808473,0.015536336593636258,44.808417320251465,46.71125020980835,0.750979849270128,-0.021472547051726833,0.9872770202023705,0.9987599909128428,0.9939598973424963,-0.007452437438769777,37.812504790110324,47.175484281548016,45.753791666030885,44.332099050513754,45.28892857687814,0.5379436516859997,45.420238086155486,0.5636384387028485,45.26864605155128,45.56441858663609,-0.4628693102181474,-4.893341638791245,24997800,0.43995548269707524,0.9864894302166995,-105612000.0,-45.781656214104196,19.18618833600314,16.367993510430818,-50.18190005747238,19.320043214203196,29.28691538092185,0.045417665314803846,0.8982169765314717,46.05594578552246,45.663692756652836,45.34666633605957,45.02963991546631,44.63738688659669,0.02,0.0,46.596834150415,-0.018000892180753847,0.021343560575096728,43.57382311139788,43.58662850516183,0.761250163283125
2022-02-28,1,45.0,44.61999988555908,46.97000026702881,45.2616662979126,46.17958307266235,0.1371372430436243,0.721537003159732,-1.079869049486159,2.9956078903624053,45.605416774749756,0.6256500434875492,0.015777393146739684,44.808417320251465,46.71125020980835,0.7882403479787352,-0.00546748077670159,0.9839865294422214,0.9955219937154831,0.9916626888846786,-0.023225519902584923,45.8676824072873,47.175407380342904,45.73233337402344,44.28925936770398,45.343214307512554,0.4746377177997637,45.326785700661794,0.5110748594640155,45.24697713983937,45.557206632449734,0.648012636374966,-3.129188164432273,26286600,0.45852572776757006,1.0349912856951333,-131898600.0,-58.44327017437927,19.18618833600314,16.367993510430818,-71.50205624285763,17.96446483755116,28.092270712131704,0.008004709761754812,0.8961774997197061,45.93370590209961,45.56481285095215,45.266666412353516,44.96851997375489,44.59962692260743,0.02,0.0,46.57216059661839,-0.02050880382870157,-0.02678550054403463,43.64836611066546,43.52260398864746,0.775833325462639
2022-03-01,1,45.39750099182129,44.61999988555908,46.97000026702881,45.12875032424927,46.17958307266235,0.1692667623940038,0.7362829964493329,-1.1673857905463574,2.995602659760714,45.605416774749756,0.6445500469207766,0.016107230792991648,44.808417320251465,46.71125020980835,0.806281999490237,-0.024636940401652402,0.993134473329715,1.004964240746751,1.0051626500615436,-0.00661923016862942,41.66535956914878,47.183899363107415,45.71133337020874,44.23876737731007,45.32702391488211,0.46987616225298656,45.277440547943115,0.462977371417881,45.189582697902665,45.50621376265232,0.851636296314519,-2.825265564402445,24024900,0.42585983284552364,0.9388592021871505,-107873700.0,-47.49331924209269,19.18618833600314,16.367993510430818,-24.054403401424448,21.451166446705923,25.937181800668156,-0.04128921969984768,0.9005455744344405,45.93370590209961,45.56481285095215,45.266666412353516,44.96851997375489,44.59962692260743,0.02,0.0,46.556301943850265,-0.00337106970527834,-0.014493901288482073,43.51620210920061,43.47687176295689,0.7533594124650883
2022-03-02,1,45.319167137145996,44.61999988555908,46.97000026702881,45.12875032424927,46.143333196640015,0.3096344420737416,0.7325475210543307,-1.0865093818283256,2.9956038595606578,45.46791648864746,0.6341458368301389,0.016038479330517982,44.808417320251465,46.71125020980835,0.7916510654033351,-0.027647860235092275,0.9922230360690795,1.0019695668180144,1.0047741741674108,-0.00020220827170058797,45.401496094550076,47.13947014701283,45.67437510490417,44.209280062795514,45.21976212092808,0.3396603007422156,45.22613103049142,0.40891201135126476,45.24417627838122,45.479026345040474,-0.24902366996826256,-1.4989306211501947,23863800,0.41547366233505884,0.9261564147852501,-131737500.0,-45.25069827130684,19.18618833600314,16.367993510430818,-27.24017586624618,20.47850123450581,24.76110615449303,-0.06297927764335098,0.8752509402220847,45.93370590209961,45.56481285095215,45.266666412353516,44.96851997375489,44.59962692260743,0.02,0.0,46.539874273586015,0.008219226672683266,-0.002125203525244117,43.43251201084682,43.44188717433384,0.6937587190639254
2022-03-03,1,46.13333320617676,44.61999988555908,46.97000026702881,45.12875032424927,46.07458305358887,0.49356961722428117,0.6977409130327532,-0.7589334621505044,2.995615522937949,45.41125011444092,0.5875166511535639,0.015299350658903504,44.808417320251465,46.65950031280518,0.7310630943257151,-0.03514654291031878,1.0115646490006003,1.018982594171046,1.0228666748516908,0.03387740536498485,43.48369026431836,47.00139861225935,45.605916786193845,44.21043496012834,45.28166689191546,0.4599589121519214,45.276726313999724,0.47404529930844075,45.265140633242,45.437758412952036,-1.6297646248141298,-1.5603219948337212,29885100,0.40722501422462887,1.1340190928940102,-101852400.0,-13.947995660443244,19.18618833600314,16.367993510430818,84.89361783077133,27.715734392444492,21.96003218571554,-0.03693242607019317,0.9157320415555261,46.15781381225586,45.74609385681153,45.413333892822266,45.08057392883301,44.66885397338868,0.02,1.0,46.535116727475916,0.03538247112704718,0.03139576939682347,43.562391008649556,43.51528685433524,0.6515284763700352
2022-03-04,0,46.76333427429199,44.61999988555908,46.917500495910645,45.12875032424927,46.07458305358887,0.38315975604433133,0.6371534894843087,-0.7292246749115763,2.9956346693610554,45.41125011444092,0.5373166275024417,0.013983678403607092,44.808417320251465,46.340583419799806,0.6237270491252238,-0.016713748205794448,1.0263200914136725,1.0294568355955422,1.02993107655399,0.03523596266227336,54.20281810944338,46.838390412119864,45.56408343315125,44.28977645418263,45.486667088099885,0.7266771586879555,45.381845474243164,0.6187099356361366,45.482716952528435,45.507783867418475,0.9482131263023941,1.5593483346463282,35576400,0.4543353898331805,1.3130233317740065,-66276000.0,-1.0979207980918857,19.18618833600314,16.367993510430818,178.24720516546813,30.139618286910764,19.075409849956763,0.022991843857017046,0.978248245492266,46.78684078979492,46.25491410827637,45.82500076293945,45.39508741760255,44.86316073608399,0.04,0.0,46.54499363663866,0.047220763043744896,0.061621881129841814,43.91772733415876,43.686552320207866,0.7261012320117174
2022-03-07,0,47.25416564941406,44.61999988555908,46.76333427429199,45.12875032424927,46.07458305358887,0.292978526446746,0.6214727611188895,-0.9089359602583031,2.9956393416230926,45.41125011444092,0.5280666542053225,0.01364183957686769,44.808417320251465,46.340583419799806,0.5546487870582031,0.0028414814446989325,1.0372679020838345,1.0374016847163758,1.0334953891347631,0.050092569986979196,61.31014523546928,46.7993206443081,45.556375122070314,44.31342959983253,45.86273833683559,0.8712229835127498,45.55505963734218,0.772434288805479,45.803330869122135,45.66597394398921,3.1657934043705516,3.2493135545172747,45870000,0.4739617925369035,1.621610156009715,-20406000.0,-16.867529208535633,19.18618833600314,16.367993510430818,190.75837060500956,29.484868729613957,17.595873848778155,0.013297632681822052,0.9841353867545997,46.96256044006348,46.39705382537842,45.94000053405762,45.48294724273682,44.917440628051764,0.06,0.0,46.56374553542102,0.048165051269945636,0.03878854634018815,44.24425343104771,43.86307716369629,0.7877140627657018
2022-03-08,0,46.77333354949951,44.61999988555908,47.25416564941406,45.12875032424927,46.07458305358887,0.6448013016469708,0.6867740645287346,-0.15933421723041974,2.9956191525883535,45.41125011444092,0.5654665756225583,0.015064950610803703,44.808417320251465,46.353833484649655,0.5916980741048989,0.0204246662127884,1.0260113132102355,1.024183116861635,1.012990856107048,0.030306350076980904,66.40346253645488,46.96108985230881,45.58754172325134,44.21399359419387,46.09154782976423,0.8697992698688926,45.69023820332119,0.8100473244192304,46.16556865940606,45.85349987510697,5.899597490523937,5.409420754095754,28305600,0.4789739449469156,0.9862074984674127,-48711600.0,-42.08264762338127,19.18618833600314,16.367993510430818,109.35878606732389,26.75782705651753,20.426045559638332,-0.007198219640739299,1.0063882554683863,46.96256044006348,46.39705382537842,45.94000053405762,45.48294724273682,44.917440628051764,0.06,0.0,46.5649216155786,0.020222015871445453,0.026487040017491865,44.352179936000276,43.96300152369908,0.7955104011193627
2022-03-09,0,46.486666679382324,44.61999988555908,47.25416564941406,45.12875032424927,46.07458305358887,0.6419030405726752,0.7179457735605806,-0.38962732190239224,2.9956087928002364,45.41125011444092,0.5933665847778314,0.015740699652764333,44.808417320251465,46.764334201812744,0.7008253068198602,0.014862772704022089,1.0192032393050652,1.0155193250879415,1.000818105636278,0.025761716641949928,60.46012933015261,47.04668327800189,45.610791730880734,44.174900183759576,46.3039287839617,0.72894983502598,45.82357154573713,0.7731203518241614,46.31731261172597,45.960287264543254,3.5457324322129793,4.216721862800731,22122900,0.4901177198128598,0.7672327734690172,-70834500.0,-35.88639029477902,19.18618833600314,16.367993510430818,81.703045773346,25.389114326346547,20.452973374720365,0.017717926800308273,0.9843496865275996,46.96256044006348,46.39705382537842,45.94000053405762,45.48294724273682,44.917440628051764,0.06,0.0,46.563320984093004,0.02423603443029365,0.025516411707011535,44.54882594517299,44.09859602791922,0.8131132983236767
2022-03-10,0,47.01083278656006,44.61999988555908,47.25416564941406,45.12875032424927,46.08583307266235,0.5846762713435222,0.7362098998345841,-0.6155255167579354,2.9956025150949466,45.41125011444092,0.6172665977478033,0.016134088764218533,44.808417320251465,46.764334201812744,0.7432437747017728,0.009756530962601715,1.0302455172480212,1.0243778262072991,1.0070405068624633,0.01902094471391491,56.93574255754027,47.103128208024884,45.630708408355716,44.15828860868655,46.53440475463867,0.644783540812336,45.930714334760395,0.8284074739139987,46.356500462275406,46.00556560076541,3.3037037319607205,4.183475568379314,27512700,0.4951216636794224,0.9442654886300279,-43321800.0,-8.605918427845602,19.18618833600314,16.367993510430818,138.6239664470186,29.53754269641604,18.515097821840396,0.08055758284702844,1.0092001066616307,46.96256044006348,46.39705382537842,45.94000053405762,45.48294724273682,44.917440628051764,0.06,0.0,46.57210540613279,0.023978789625833663,0.047517606917284835,44.85248565673828,44.18434388296945,0.9078791985630806
2022-03-11,0,47.52499961853027,44.61999988555908,47.25416564941406,45.12875032424927,46.22166657447815,0.5439019886501633,0.7915805430805182,-0.913817151581529,2.9955825816473647,45.41125011444092,0.675666542053223,0.017329058083319436,44.808417320251465,46.79708347320557,0.7444356859164831,0.03491103084500857,1.0404038931960886,1.0302182800514041,1.0142417042779934,0.01628766117853586,63.493917862906066,47.26253611477127,45.67937502861023,44.09621394244919,46.84952368055071,0.46616360542523716,46.0346429007394,0.9320158200960971,46.51519209208869,46.115501107169166,3.5537898771772123,3.2959164292338423,19162200,0.4831700798446454,0.6675748962825817,-24159600.0,-16.445182882144064,19.18618833600314,16.367993510430818,145.13045596163104,30.52855540726965,17.54165153147377,0.06392597542581134,0.9886576203883526,47.06951997375489,46.48357344818116,46.01000022888184,45.536427009582525,44.95048048400879,0.08,0.0,46.58173225439021,-0.005251381116821441,0.019958256469738166,45.12276022774832,44.277636119297576,0.9665587411840744
2022-03-14,0,47.74250030517578,44.61999988555908,47.52499961853027,45.12875032424927,46.55583357810974,0.4870700360980526,0.8846784197423183,-1.0319994863491657,2.9955461529560496,45.45416736602783,0.7741665077209475,0.019322714765046798,44.808417320251465,47.035166072845456,0.7416776496339864,0.049310033906096624,1.0427684172919847,1.0296803049820553,1.0155818050169778,0.010334213905812017,67.75984061666101,47.55373188716836,45.78437504768372,44.01501820819907,47.07940469469343,0.45063150763458204,46.18053579330444,1.0302837535069562,46.7658006672722,46.27361687492286,4.8673279336951,3.1582373200439116,22646400,0.48947070117077396,0.7904544002848183,-1513200.0,-6.230525430133822,19.18618833600314,16.367993510430818,145.10768049848141,30.351029478095406,16.323534693512286,0.09095398158112895,0.9861201163485203,47.27325311279297,46.64837329101563,46.143333435058594,45.638293579101564,45.01341375732422,0.1,0.0,46.596541687960574,0.0167996175871874,0.008612351805072044,45.34044429234096,44.45141765049526,1.0571734364526981
2022-03-15,0,48.35916709899902,44.61999988555908,47.74250030517578,45.12875032424927,46.76583409309387,0.39979911655775185,0.9732492240928196,-1.1371217963079052,2.9955081470297813,45.605416774749756,0.859691491127014,0.02120049205550642,44.808417320251465,47.281249046325684,0.7577401676983713,0.06498744255856319,1.0534178836349717,1.036847388115425,1.026566811770141,0.03390465098711104,70.92266926849035,47.85341520958396,45.906916761398314,43.96041831321267,47.30738081250872,0.6314654995590848,46.3970239503043,1.149024497711337,47.00976416876851,46.43001863462766,3.488078981432829,4.469366530492964,22872600,0.47023258533615936,0.8074968994161053,21359400.0,-2.6166827995454778,19.18618833600314,16.367993510430818,159.81998839024882,31.835667323703436,15.397522465638424,0.13166100812268539,0.9703631256805124,47.60432055664063,46.91617391967774,46.36000061035156,45.80382730102539,45.1156806640625,0.12000000000000001,0.0,46.61736334490816,0.05074242182449962,0.029011105734400574,45.47581154959543,44.696769441877095,1.1502911524494632
2022-03-16,0,48.448333740234375,44.61999988555908,48.35916709899902,45.28229212760925,46.83270835876465,0.44057424933832384,1.0764112619544637,-0.9094192591904071,2.9954603627508103,45.88499975204468,0.9297582435607907,0.02335788745525438,44.854916954040526,47.546749687194826,0.7486146014629977,0.07750153444579813,1.0513181781879863,1.0322046948017063,1.021581529577119,0.042198488318847094,74.49726701336077,48.2362392719558,46.08341674804687,43.93059422413794,47.477976254054475,0.7624209423244697,46.67035729544504,1.1493599701924468,47.35030303862355,46.654851629186915,3.4125727976252023,6.686401206542316,24615900,0.4806133898511572,0.8647812910538721,45975300.0,-12.072866810565062,19.18618833600314,16.367993510430818,140.49942977019208,31.24508479066549,14.17740805050124,0.14649785385623001,0.9782320876451513,47.9439596862793,47.303019775390624,46.78499984741211,46.266979919433595,45.62604000854492,0.14,0.0,46.63953043516715,0.04223463509575365,0.04764326441946047,45.64410618373326,44.94417980739048,1.2024226017281046
2022-03-17,0,48.11750030517578,44.61999988555908,48.448333740234375,45.32604146003723,47.07166600227356,0.3751609449436871,1.1550648782196093,-0.9787962633416742,2.995421481370163,46.10166645050049,1.0007207918167111,0.02496800998040693,44.962166690826415,47.80416698455811,0.7668608211697585,0.08579860745168455,1.040113201003627,1.0183669785445886,1.0062808739191504,0.023540691645269174,76.02899145028664,48.57192151020814,46.26179175376892,43.951661997329694,47.670000076293945,0.7236564323509503,46.880773953029085,1.1232393622121384,47.626247460670854,46.88243194286936,2.5271170793280526,8.57580430564663,19023000,0.4698328470591177,0.6795991640319383,26952300.0,-14.654522198239157,19.18618833600314,16.367993510430818,105.84066692544147,29.170645531286027,15.818077523298028,0.18765762933042943,0.97261908809894,47.9439596862793,47.303019775390624,46.78499984741211,46.266979919433595,45.62604000854492,0.14,0.0,46.65316663053181,0.020618775474057216,0.04381812523722019,45.95649446759905,45.15433720179966,1.2105192800734486
2022-03-18,0,48.358333587646484,44.62166690826416,48.448333740234375,45.38020896911621,47.321874141693115,0.2640638528478444,1.1580165302773804,-1.1684727581134868,2.9954219569179754,46.30999994277954,1.0114166259765625,0.024937546355223317,45.15450038909912,48.14166698455811,0.8515340906422245,0.05727573746109935,1.0413825312272769,1.0191841297199,1.0066578551079066,0.017534644414626932,69.08267087125539,48.75269983530452,46.43666677474975,44.12063371419499,47.93738106318882,0.5346570149843333,47.120654923575266,1.046677458721022,47.752066390352994,47.058609594895636,2.8737886604848426,6.521417949265892,31233300,0.4544366340510236,1.1627492708456069,58185600.0,-12.583898577648487,19.18618833600314,16.367993510430818,107.01098859650402,28.77319055194976,15.229271758980955,0.16391398649415453,0.9377635242241122,48.04229331970215,47.46218692779541,46.99333381652832,46.52448070526123,45.944374313354494,0.14,0.0,46.67862142371007,0.027680171148342314,0.023645104949877958,46.25569643293108,45.402261189052034,1.2892681336086924
2022-03-21,0,48.38083362579346,44.62166690826416,48.448333740234375,45.38020896911621,47.57937479019165,0.10007449589081889,1.2093442324427601,-1.2890514059303562,2.9953954551447746,46.62500047683716,1.056208324432373,0.025963269886252215,45.15450038909912,48.35841693878174,0.8726217871087515,0.04967080329890584,1.038682458683488,1.016242166470377,1.0036441450004734,0.013370337048486558,69.8550992693836,48.997730232005885,46.57904176712036,44.16035330223483,48.1330954687936,0.3617499846717303,47.333750111716135,0.969734110814882,47.902926124471136,47.21022748182683,4.026244602937466,7.462963528103298,21350700,0.44432604759024585,0.8095371343552504,79536300.0,-25.26838331185007,19.18618833600314,16.367993510430818,95.12623177703685,30.42948500278483,13.835152229458412,0.15860827279096917,0.9582404670101977,48.144014862060544,47.55466149902344,47.07833480834961,46.60200811767578,46.012654754638675,0.16,0.0,46.695608755981645,0.005122079763913545,0.019130386790657396,46.35437829153879,45.60343197413853,1.3218955807118227
2022-03-22,1,48.03000068664551,44.62166690826416,48.448333740234375,45.38020896911621,47.83625030517578,-0.03936834887659139,1.2643298985754972,-1.3987015611432747,2.995365500660189,46.76833391189575,1.1092916440963747,0.027076585864808527,45.15450038909912,48.361333751678465,0.8792182031424718,0.05866157172247543,1.028598974954252,1.0064909667510946,0.9937344251946385,-0.006806701440487117,71.69777773246379,49.223243260819814,46.69458346366882,44.16592366651783,48.20523847852434,0.2548182301457185,47.52738107953753,0.7906333474686078,48.01990141692946,47.320270610388384,2.9142237182938575,6.571578982970094,20235000,0.429935179181771,0.7747926467640489,59301300.0,-32.495343514378696,19.18618833600314,16.367993510430818,66.46606172938998,28.885401919190766,14.765047680528527,0.18039946160005516,0.9371000147686905,48.2517878112793,47.72910754394532,47.30666732788086,46.88422711181641,46.361546844482426,0.16,0.0,46.70779650531651,-0.009766849212678341,0.0021255828601336696,46.45893096923828,45.790845598493306,1.315699420217754
2022-03-23,1,47.52833271026611,44.62166690826416,48.448333740234375,45.38020896911621,48.051875591278076,-0.23212890977013242,1.2746234573007167,-1.3734244418037693,2.9953607055165015,46.892083168029785,1.1115832328796387,0.02722909537215621,45.15450038909912,48.361333751678465,0.8836751987639757,0.05960218725769354,1.0153222089510654,0.9933623566209933,0.9846962174388646,-0.018989322417176102,66.77791379942894,49.36033042213928,46.811083507537845,44.26183659293641,48.174643107822966,0.3232945631969907,47.6270239012582,0.6818495162861408,48.018470934978914,47.380229229702465,1.0626008883087534,5.981649091864198,19625400,0.42865065657449775,0.7534786970478442,39675900.0,-55.05162228836985,19.18618833600314,16.367993510430818,32.24779157469446,27.183447570519263,17.668080472492022,0.1910293036482895,0.9244079664331628,48.33360151672363,47.861534812927246,47.48000144958496,47.098468086242676,46.62640138244629,0.02,1.0,46.7147586577318,-0.019614766741996026,-0.022506406112724697,46.38800157819475,45.864222935267854,1.2465779624180393
2022-03-24,1,47.584166526794434,44.62166690826416,48.448333740234375,45.94937515258789,48.051875591278076,-0.4260185228264538,1.2362685035544505,-1.1557181607243876,2.9953837957521245,47.13249921798706,1.0623081636428835,0.026347825143618376,45.15450038909912,48.361333751678465,0.8481442852108895,0.06514023350982488,1.0141318780249733,0.9923687949340797,0.9896255713160281,-0.011083987634411208,61.068962198437184,49.393620505109986,46.921083498001096,44.448546490892205,48.063928740365164,0.37769609451006847,47.68565477643694,0.6355914741799481,47.8920065317877,47.36862034255524,-0.4485889795060649,3.0238428640195893,13440900,0.4092914206511121,0.5348002750217248,53116800.0,-48.74315231257974,19.18618833600314,16.367993510430818,36.94440793657323,26.203988799853057,16.723284751954544,0.15335458403899,0.9066576000129292,48.37686752319336,47.93156707763672,47.5716667175293,47.21176635742187,46.76646591186523,0.02,0.0,46.72043877648683,-0.015033549641181976,-0.013537068319895674,46.278355189732146,45.87708336966379,1.1497454511860716
2022-03-25,1,47.7574987411499,45.0,48.448333740234375,46.39833331108093,48.051875591278076,-0.5259393702561164,1.1242939675201031,-0.9998125788544354,2.9954457539676085,47.38958263397217,0.9567040586471556,0.02388597564846321,45.3044171333313,48.361333751678465,0.8577177463146534,0.05340735869916277,1.0146229410789949,0.9947941777348586,0.9954386950680524,-0.012424639186700004,60.19164070656321,49.317796413967834,47.069208478927614,44.820620543887394,47.96523802621024,0.3497330362625954,47.721607140132356,0.6234258614120598,47.81348322199203,47.39728583517415,-1.6025928871314896,1.755290261570787,14085300,0.3988029425045926,0.5728774245346157,67202100.0,-41.967256172299074,19.18618833600314,16.367993510430818,40.156911185180924,25.072870459384387,15.966850388208794,0.1332187736778774,0.881586418709841,48.37686752319336,47.93156707763672,47.5716667175293,47.21176635742187,46.76646591186523,0.02,0.0,46.727052353714626,-0.013682573884087113,-0.01075795445624647,46.21683611188616,45.93047114780971,1.0908020355859447
2022-03-28,1,48.2383337020874,45.0,48.448333740234375,46.694167375564575,48.051875591278076,-0.7150703558114369,1.0444973058963147,-0.5882174589440514,2.9954860669248595,47.52666616439819,0.8703831863403323,0.022129883461245885,45.38966760635376,48.361333751678465,0.8058017997115963,0.061277749803331165,1.0220310738626774,1.0043236328667817,1.0079857471302447,-0.002945379668490955,62.98546709515434,49.28749467282779,47.198500061035155,45.10950544924252,47.98249994005476,0.36129185128293817,47.82625000817435,0.5729182503299827,47.79951467659463,47.45271474977483,-1.4259210704511025,1.0651613139678429,20105700,0.3925979810662858,0.8281485746907989,87307800.0,-14.098356555019137,19.18618833600314,16.367993510430818,86.61575755781861,28.954802389701328,14.777199541736064,0.16322351710314392,0.8843377118673942,48.37686752319336,47.93156707763672,47.5716667175293,47.21176635742187,46.76646591186523,0.02,0.0,46.74218856408294,0.012272057296705441,0.003850460729822156,46.26228550502232,46.10938998631069,1.0080698708421418
2022-03-29,1,49.01500129699707,45.319167137145996,48.448333740234375,46.77083373069763,48.14770865440369,-0.8005168938702385,0.9365629627761773,-0.33791000606614974,2.995535677390646,47.55624961853027,0.7744999694824216,0.019775226383592137,46.05974998474121,48.361333751678465,0.7712563339173981,0.06257685220994678,1.0349360217779844,1.0194414800902392,1.0248252718804298,0.020508028237972376,67.0225861942704,49.23354267169188,47.36041674613953,45.48729082058718,48.076309612819124,0.5238315806499276,48.00684533800398,0.5135921674462314,47.91191828766188,47.57563150448009,0.2511215174214351,3.1321268795979726,19934400,0.39584495027618666,0.8280686975003286,107242200.0,-9.570979117383043,19.18618833600314,16.367993510430818,142.33049452543457,32.87823529822168,13.92694205686815,0.18324145221639548,0.8711381582348776,48.65158808898926,48.209207710266114,47.851667404174805,47.494127098083496,47.05174671936035,0.02,1.0,46.76316666478449,0.023852366291832183,0.020800030155467733,46.34446225847517,46.300079345703125,0.9455058817067765
2022-03-30,1,49.518333435058594,45.319167137145996,49.01500129699707,46.95145797729492,48.26833367347717,-0.6951193573528828,0.8880681285625053,0.017706216472376024,2.9955570172780828,47.66333341598511,0.7077460241317752,0.01867993265768984,46.451333332061765,48.38758363723755,0.647865079206777,0.08155123744147037,1.0415857794437458,1.0285071384837412,1.031102076193088,0.04186977769499256,73.70778740990464,49.317428018523316,47.54129176139831,45.76515550427331,48.23880958557129,0.7580953425893668,48.185952527182444,0.573286326628912,48.18896599222458,47.7866465913751,1.3579204671319296,5.438838269589478,24991500,0.4154957166702442,1.0357131756441738,132233700.0,-3.579645392039095,19.18618833600314,16.367993510430818,187.51065316632628,35.70731297588202,12.746002028576916,0.21508383331543957,0.8837049215454009,49.378747451782225,48.957293754577634,48.61666679382324,48.27603983306885,47.85458613586426,0.04,0.0,46.79579308194505,0.05579433452583915,0.04221131926448951,46.603388105119976,46.47888319832938,0.928910734589488
2022-03-31,1,49.702500343322754,46.13333320617676,49.518333435058594,47.19333243370056,48.35854196548462,0.00401330198300808,0.8325414726358946,-0.4302703514941477,2.9955802683102863,47.74999952316284,0.6710835456848144,0.017434967070091616,46.73566751480102,48.50500049591064,0.6634909566732217,0.07337428262019924,1.040862810165414,1.0300431451908432,1.026430465091197,0.044517619434092603,75.6872666018833,49.41633302156573,47.75125007629394,46.08616713102216,48.477738107953755,0.9262318731591537,48.341488293239046,0.6677702879883456,48.52291076052396,48.0602514157952,2.351137266594549,5.33387838476115,27163800,0.39645894211794297,1.132122889835388,159397500.0,-17.96011063462661,19.18618833600314,16.367993510430818,173.1484670756875,34.39368942228219,11.927380205885902,0.17041233959939248,0.8767588270364306,49.470426635742186,49.03145309448242,48.676666259765625,48.32187942504883,47.882905883789064,0.06,0.0,46.831171517825425,0.04263803492329821,0.04910165690036195,46.838439396449495,46.64868518284389,0.9450060738274462
2022-04-01,0,50.0649995803833,46.486666679382324,49.702500343322754,47.45729112625122,48.36458373069763,0.31698640598962174,0.8489782381339623,-0.4214575981999764,2.995575671245412,47.893749713897705,0.6871253490447998,0.017712985659365178,46.77233362197876,49.065334510803225,0.7318916408824526,0.0628519354884102,1.0445504722861019,1.0341586565877803,1.0249489775228937,0.048317037115789274,75.8805057917089,49.627664909419174,47.92970843315125,46.23175195688332,48.84011908939907,0.9871019400112095,48.50738109861101,0.7856081267494182,48.817965829811094,48.32138809460318,3.4821978612677302,4.581800614982983,20939700,0.3819497452290207,0.9001734599784625,180337200.0,-2.666649451622596,19.18618833600314,16.367993510430818,179.43976678022105,34.10431496427225,11.134414761535211,0.13811192904186367,0.8719807082192343,49.656332214355466,49.18183221435547,48.79833221435547,48.41483221435547,47.94033221435547,0.08,0.0,46.86141964697923,0.05270128891535775,0.05727091111966963,47.25437273297991,46.82118715558733,1.0678949012746484
2022-04-04,0,50.43583393096924,46.486666679382324,50.0649995803833,47.52749943733215,48.39770865440369,0.4222424339203279,0.9238309069256544,-0.3554097405563619,2.9955482585169904,48.073750495910645,0.7255419731140137,0.019208543675953087,46.987082862854,49.53675012588501,0.7742915798317471,0.059483304642880555,1.0486755873108105,1.0381588626167055,1.0228766947441417,0.0455550608869133,77.43817136028837,49.94245351230712,48.09479169845581,46.2471298846045,49.247500147138325,0.9706866274708329,48.65571444375174,0.9369453507424251,49.12753944294503,48.58113607987963,5.337167801742113,4.864636875659687,25332600,0.3770490799663724,1.1393129204523682,205669800.0,-18.493083575181217,19.18618833600314,16.367993510430818,178.5684844352082,36.44093187581336,10.197033738449473,0.146583832784616,0.8840039756674598,50.14783895874024,49.57941227722168,49.119998931884766,48.66058558654785,48.092158905029294,0.1,0.0,46.90118632452878,0.03452065482133926,0.05291056254223848,47.63128498622349,46.954820087977815,1.1448292596954994
2022-04-05,0,50.54666614532471,46.486666679382324,50.43583393096924,47.57020807266235,48.59000062942505,0.4455312079922705,1.0328830238515092,-0.42735140278970585,2.9955038663348716,48.17791700363159,0.7998460626602174,0.0214051829297172,46.987082862854,49.738750267028806,0.7662212082751944,0.07830317198994931,1.0475151690396696,1.0360577206562858,1.0160678446109324,0.031248899475627923,82.11190339123391,50.31964116023659,48.25387511253357,46.18810906483055,49.645952633449006,0.8174933829059542,48.80559532982962,1.0608580465809248,49.45188946591212,48.83960483009621,5.992891359290791,4.29425682150179,18657900,0.34923287924033347,0.8577321464404591,224327700.0,-15.749330893995392,19.18618833600314,16.367993510430818,162.3198209263779,34.37163450298236,9.519309407872248,0.18730039845638727,0.8791861458655484,50.180946868896484,49.606193283081055,49.141666412353516,48.67713954162598,48.10238595581055,0.12000000000000001,0.0,46.93113399369417,0.028798537784319178,0.03746573939688655,47.999473571777344,47.108154841831755,1.1293191028989809
2022-04-06,0,50.99416732788086,46.486666679382324,50.54666614532471,47.702916860580444,49.14083433151245,0.44891734661803057,1.0883458153420957,-0.5919189754304268,2.9954806942282355,48.29833364486694,0.8633876276016231,0.02246673638908577,47.473582935333255,50.10208301544189,0.7634818831915536,0.08733685927502877,1.0526732391361424,1.0398661074513778,1.0187898450427246,0.029803787616515143,84.31555661086723,50.619233373009024,48.44254174232483,46.26585011164063,50.039643151419504,0.6783704525485214,49.01107154573713,1.1882677537035122,49.72634726097587,49.0823604693858,5.840271114893081,4.331072388043249,28018500,0.3313331847156216,1.2708315615804602,252346200.0,-3.0935261867889126,19.18618833600314,16.367993510430818,168.00409609189492,35.39058463919808,8.323005659584695,0.22432937372085346,0.9336162014199032,50.71320024108887,50.03673331451416,49.489999771118164,48.94326622772217,48.26679930114746,0.14,0.0,46.98213682537162,0.03416292965235912,0.05270676391658695,48.4121938432966,47.337239674159456,1.2143323017527077
2022-04-07,0,51.96833324432373,47.01083278656006,50.99416732788086,47.75374913215637,49.564375162124634,0.6406587423884461,1.1260417407375736,-0.7902012824047144,2.9954658780148313,48.358750343322754,0.9602084636688233,0.023137249657700466,47.52799940109253,50.44691715240479,0.7824024673884188,0.08473226924964404,1.0678150347969346,1.0522940956842972,1.0321655869118562,0.0455879057461821,85.71396998045198,50.9200002562249,48.667916774749756,46.41583329327461,50.46154771532331,0.835169557902057,49.26892866407122,1.4072397726845325,50.04556628816077,49.34663093512105,5.7129536082507855,5.978421581462842,27088200,0.3279773682714075,1.2298200093979201,279434400.0,-6.242173262973363,19.18618833600314,16.367993510430818,182.8874572104263,37.98323648743955,7.6690354183865885,0.19549380759233775,0.9407493134435625,51.25309233093262,50.473452308654785,49.843332290649414,49.21321227264404,48.43357225036621,0.16,0.0,47.039932130126545,0.05116852982332665,0.04450517516219954,48.839605058942524,47.59203365870884,1.3798366565389515
2022-04-08,0,52.41166687011719,47.52499961853027,51.96833324432373,47.961875200271606,49.79312515258789,0.8410878112480903,1.2703814589907672,-0.38924781857737223,2.9953973919197234,48.37000036239624,1.0919500923156733,0.025970783918744862,47.5785831451416,50.59141626358032,0.7704915923623628,0.09349465884184827,1.0714672081143346,1.0519326315493698,1.0316851073361362,0.04687241205237869,88.61796203498038,51.456554715619475,48.91579179763794,46.3750288796564,50.87488106318882,0.9918374771833475,49.556845324380056,1.6093896525961855,50.528273861105276,49.686688774624336,6.025363397282207,7.465103507204907,23294400,0.3645062965420602,1.0477511564016344,302728800.0,-5.9206394054764955,19.18618833600314,16.367993510430818,169.9861843216966,38.07174181514209,7.234587609428803,0.23398756003898447,0.92591363367011,51.47465303039551,50.65267287445069,49.988332748413086,49.323992622375485,48.50201246643066,0.18,0.0,47.09237246389323,0.04238144550806533,0.05701072060700819,49.18575777326311,47.89457293919155,1.5071892846751018
2022-04-11,0,51.927499771118164,47.52833271026611,52.41166687011719,48.09562540054321,50.157708168029785,0.8283381145031573,1.438232332109078,-0.44604992432758594,2.995307620121188,48.414583683013916,1.2361499595642087,0.029256075476247242,47.72666692733765,51.09158391952515,0.803059295140067,0.0977989534501866,1.0562930749643489,1.0325696907117368,1.0127979169363202,0.02957551653038082,89.6589489241148,52.03658982443544,49.160125160217284,46.28366049599913,51.19273812430246,0.90634313771911,49.8352381161281,1.661219848544722,51.00144834637708,50.03024238690667,5.842953981585609,8.331467116711186,24712800,0.36744920527937386,1.106407212008553,278016000.0,-24.393121079010292,19.18618833600314,16.367993510430818,117.84504498538364,33.75639448912313,12.75810841304216,0.17109106342247632,0.9695942849827882,51.47465303039551,50.65267287445069,49.988332748413086,49.323992622375485,48.50201246643066,0.18,0.0,47.140263960675405,0.021517340805370155,0.021720415163768773,49.4322885785784,48.13536398751395,1.5413702059538732
2022-04-12,0,51.28499984741211,47.52833271026611,52.41166687011719,48.2081253528595,50.463541984558105,0.630330977669555,1.5189344258954827,-0.8956670066383428,2.9952618836355787,48.73166751861572,1.3245624446868896,0.030766733866646693,47.74016551971435,51.93158311843872,0.8793815798119116,0.07378813338149906,1.0388018829227046,1.0123671180642249,0.9944799560921587,0.014606971307754568,79.18685640590537,52.40724398530537,49.3693751335144,46.331506281723435,51.36702387673514,0.7585992175655287,50.10357148306711,1.5602619452689344,51.23625469752584,50.256128549075754,4.476634801923654,8.114717944520738,26761200,0.3904631988089373,1.1877760423532358,251254800.0,-31.33692971682634,19.18618833600314,16.367993510430818,81.07230808921842,31.387738734020715,14.521925330941395,0.10413803510329668,0.9681930969100007,51.50297277832031,50.698512466430664,50.04833221435547,49.398151962280274,48.593691650390625,0.18,0.0,47.18500218212355,0.011619488779483378,0.01449937806815323,49.53420639038086,48.39428956168039,1.5624005806522172
2022-04-13,0,51.817501068115234,47.52833271026611,52.41166687011719,48.2081253528595,50.658541440963745,0.41153112703026706,1.555061232095391,-1.1863096716210473,2.995241102706298,49.26666736602783,1.369833278656006,0.031405438591572965,47.74016551971435,51.93158311843872,0.9147974871240446,0.05855033368922651,1.0464869898213978,1.018315650187497,1.001936829479326,0.016145645342937387,68.04771432778438,52.62578923512583,49.515666770935056,46.40554430674428,51.564404896327424,0.6475513819944254,50.40595252173288,1.4400186586743864,51.24931774154711,50.34720975647513,2.4368326720346856,7.9040583225309655,29284500,0.432147193967261,1.2864425051199397,280539300.0,-7.36843373306151,19.18618833600314,16.367993510430818,106.28015521817575,33.655567588414804,12.955516657171938,0.14987565283160986,1.0076510746128966,51.532866195678714,50.746899269104006,50.11166572570801,49.47643218231201,48.69046525573731,0.18,0.0,47.24226283349405,0.014388034086701973,0.03796137484692741,49.81792231968471,48.7246036529541,1.6474064539923763
2022-04-14,0,52.40916633605957,47.52833271026611,52.41166687011719,48.2081253528595,51.06687545776367,0.21507017082205904,1.6117689912082307,-1.3855970609511596,2.9952071624181364,49.610416889190674,1.431291675567627,0.03244032146592559,47.74016551971435,51.93158311843872,0.8926832508381867,0.07689511590321454,1.0548473217793075,1.025310358475575,1.0101608683977938,0.008482725233139643,72.80852492907226,52.907663119745585,49.684125137329104,46.46058715491262,51.8304763521467,0.5320100784588244,50.73821449279785,1.3129674112628131,51.39083893643543,50.49992156820683,2.7394553226522693,8.89651926326592,22360500,0.4245965337420064,0.9751288822486248,302899800.0,-8.802104319216694,19.18618833600314,16.367993510430818,109.93330911097675,33.3491127878784,12.36942917700056,0.10170519774963974,0.9799334792605072,51.61467990112305,50.87932653808594,50.28499984741211,49.690673156738285,48.95531979370118,0.18,0.0,47.2884949363272,0.00344958118349048,0.013484674907875745,50.07547051565988,49.03747204371861,1.7040475190716746
2022-04-18,0,52.15166664123535,47.52833271026611,52.41166687011719,48.328333616256714,51.41812515258789,0.062301763760094546,1.6734186852732766,-1.4283682322203455,2.995170157807458,49.88374996185303,1.487374973297119,0.033536312614648955,47.74016551971435,52.01241655349732,0.8829324675092892,0.08376700452407448,1.0451506316064667,1.0148986491716865,1.003492385611234,-0.004960731921122674,75.74962733115852,53.245545809419845,49.89870843887329,46.55187106832674,51.99583339691162,0.3895634508551913,51.01773827416556,1.145729793851744,51.64420888066763,50.71790352592139,3.6847142111807396,9.74018262581577,14671800,0.43372992573898694,0.6638000537489922,288228000.0,-20.80594264590041,19.18618833600314,16.367993510430818,87.51510767737555,31.093187642750294,14.512030069893553,0.03030925605430095,0.9758867145426549,51.84674662780762,51.254959968566894,50.77666664123535,50.29837331390381,49.706586654663084,0.18,0.0,47.31661820656194,-0.0097200062952979,-0.004216222184239833,50.11632864815848,49.26426124572754,1.7205839707112602
2022-04-19,0,52.35916614532471,47.52833271026611,52.41166687011719,48.34520864486694,51.84500074386597,-0.12358306483435069,1.7027947486552926,-1.4338367206970888,2.9951534314548622,50.25041675567627,1.5063750267028808,0.03399580732141706,47.74016551971435,52.17741661071777,0.8993224222409542,0.0779406374972327,1.0453356901600694,1.0148157714751411,1.0084941252800075,0.008312866517918405,71.67992372621198,53.493964588863314,50.088375091552734,46.682785594242155,52.051666668483186,0.4123087519544838,51.25660719190325,1.039774908426093,51.767169630138895,50.851253230021,2.2698660925514007,8.112496097639063,15855000,0.4445800919911645,0.7263621351610813,304083000.0,-6.6842739898100305,19.18618833600314,16.367993510430818,90.88439213351892,29.487869481971753,13.76278474681404,0.08824871861771902,0.9554485074702409,51.90889306640625,51.35555293273926,50.90833282470703,50.461112716674805,49.90777258300781,0.18,0.0,47.34842900026753,0.02177721532582577,0.001524581185098122,50.16728755405971,49.50344630650112,1.7283037111611734
2022-04-20,0,53.051666259765625,47.52833271026611,52.41166687011719,48.82083439826965,51.937708139419556,-0.30392408235438384,1.723943688056056,-1.346680408268386,2.9951424155361157,50.49125003814697,1.5146458435058592,0.03428189566739221,47.74016551971435,52.36416616439819,0.8838169682101129,0.09013461163415934,1.0549716329478271,1.0244188866899413,1.0201360699936084,0.034448014382565395,74.29320791071504,53.73517909364141,50.2872917175293,46.839404341417186,52.14309515271868,0.5525510391072347,51.508988107953755,1.0138885468589036,51.91046467852463,50.996747897170636,0.7520597190668329,6.822737447387396,19821600,0.4253372721933416,0.9089439606993718,323904600.0,-5.91622775713704,19.18618833600314,16.367993510430818,113.20446141761981,33.50447249836443,12.832163312741143,0.11017030715184775,0.9514847849439456,52.49262727355957,51.90035384368896,51.42166709899902,50.942980354309086,50.35070692443848,0.19999999999999998,0.0,47.39335656589189,0.041767265334289094,0.03461018286792178,50.26920427594866,49.727481024605886,1.7395314640808375
2022-04-21,0,53.30250072479248,47.52833271026611,53.051666259765625,49.39250040054321,52.014166593551636,-0.4212596802818216,1.7424865042089885,-1.1222361641270149,2.9951347876431678,50.77041673660278,1.5000374698638914,0.03447848302088291,47.74016551971435,52.409416389465335,0.8350881814257795,0.11621138875562687,1.0546936012251247,1.024307765507132,1.0180425234455033,0.02865826460301868,79.85078726075466,54.02334800460329,50.538374996185304,47.053401987767316,52.33952386038644,0.6903533100916561,51.76613099234445,0.9763032627830597,52.19274803987939,51.25476387668727,1.2211010026344666,7.135403353872688,18168300,0.4003926239850542,0.8359225431722848,342072900.0,-7.543989739644437,19.18618833600314,16.367993510430818,111.35405123852802,33.118743703485436,12.2696073616335,0.1356602581843634,0.9239769287664766,52.65150709533692,52.070913932800295,51.601667404174805,51.132420875549315,50.5518277130127,0.2,0.0,47.435058367947455,0.016855215269763857,0.04333343610756078,50.52537482125418,49.97883169991629,1.657967843983862
2022-04-22,0,52.844167709350586,47.584166526794434,53.30250072479248,49.656458616256714,52.20354151725769,-0.4761156427351006,1.6976184791427196,-0.9089615763924099,2.9951713194812895,51.139583587646484,1.458041687011719,0.0333998798610166,48.19025020599365,52.475666809082036,0.8147441624943682,0.12017304526660309,1.039685226411428,1.0110152756669444,1.0035957665485105,0.008300100988092085,80.8600912248593,54.222320355197056,50.82708339691162,47.43184643862618,52.562262126377654,0.5251800216636063,51.9646430015564,0.8817727609417271,52.46936814429243,51.559590391382095,2.6479244325933937,7.243097141195163,21046200,0.396723152342083,0.9516839368573702,321026700.0,-36.576255799662995,19.18618833600314,16.367993510430818,76.55083533946359,30.03272251317432,17.195642184452055,0.09283351386182251,0.9460893403060925,52.749053894042966,52.228807479858396,51.80833435058594,51.38786122131348,50.86761480712891,0.02,1.0,47.47738190919041,-0.00140060118391383,-0.0022898998571804358,50.69202314104353,50.11311476571219,1.4992141687762692
2022-04-25,0,52.09416675567627,47.7574987411499,53.30250072479248,49.974374771118164,52.37166619300842,-0.5590032759080332,1.578082835112101,-0.7526706349526968,2.99525231160702,51.55125045776367,1.353741660118103,0.030888241481734233,48.9373345375061,52.86491756439209,0.8085168083000858,0.1065103722406172,1.0196531935693705,0.9949989804231406,0.9877200564052168,-0.0011025512560248751,72.99065608568071,54.246249126263635,51.09008345603943,47.933917785815225,52.601785796029226,0.4669749689680624,52.083095346178325,0.7641429307765978,52.56326884020446,51.76216451595053,3.0402025281806715,5.551119848718089,18057600,0.43101100100610823,0.80927482296441,302969100.0,-37.29315382335309,19.18618833600314,16.367993510430818,42.14112325370455,27.689676698519055,21.630314410390902,0.10530452831592155,0.9528016810607228,52.78209375,52.2822872467041,51.878334045410156,51.47438084411621,50.97457434082031,0.04,0.0,47.509220488009554,0.006800135579311695,-0.0008912641827495115,50.67916815621512,50.24854523794992,1.310020525134472
2022-04-26,0,52.083333015441895,48.2383337020874,53.30250072479248,50.343125343322754,52.37166619300842,-0.5805447412407744,1.392275773810498,-0.7030189240588882,2.995362046838739,51.8725004196167,1.196141610145569,0.027136219814130214,49.46800022125244,52.86491756439209,0.8032081506290734,0.07993296529274631,1.0151327775325827,0.9953956891907003,0.9877300130615116,-0.005268096308432946,61.63651130876746,54.091468404386745,51.306916856765746,48.522365309144746,52.55523817879813,0.5041358934696768,52.19285726547241,0.623982575249645,52.44774330258279,51.8340460920849,0.5339232534532148,3.288005165091086,19601100,0.483422073344706,0.8794431821852757,283368000.0,-53.26195724120388,19.18618833600314,16.367993510430818,35.24863262658761,27.31200517372411,20.04846880094572,0.021309980308568566,0.9545072706800023,52.78209375,52.2822872467041,51.878334045410156,51.47438084411621,50.97457434082031,0.04,0.0,47.543178580961914,-0.014906510910247972,-0.0037208159705788934,50.597450256347656,50.336460386003765,1.1567819592579722
2022-04-27,0,51.665833473205566,49.01500129699707,53.30250072479248,50.51895809173584,52.37166619300842,-0.53710052440632,1.2086367339917587,-0.8350902863449639,2.995455662569799,51.94791650772095,1.0430832672119137,0.023469054133614962,49.68408365249634,52.86491756439209,0.8094887949467239,0.06259984978584111,1.0032362980035532,0.9871226189943535,0.9808385339936373,-0.026122323468114605,59.89081148915173,53.916440290416986,51.49916682243347,49.08189335444996,52.48583344050816,0.5943301011820681,52.24083341870989,0.5456314519764365,52.35798626726224,51.90587275757941,-0.6217105582797443,3.0400953956076506,17496900,0.46589669234184816,0.7893502744380466,265871100.0,-79.44032578051582,19.18618833600314,16.367993510430818,-4.3256089410523,25.800193804154496,21.934915477540244,-0.012748034028948092,0.9382237151039663,52.943359756469725,52.54331951141357,52.21999931335449,51.89667911529541,51.49663887023926,0.06,0.0,47.570007733556416,-0.03376560275062468,-0.02163022287331559,50.52216012137277,50.319244384765625,1.0142085967340884
2022-04-28,0,51.87666702270508,49.518333435058594,53.30250072479248,50.88229203224182,52.37166619300842,-0.5249171366995186,1.0658660551044177,-0.7277785451580066,2.995518389282555,51.94791650772095,0.8874458408355721,0.02064363329220054,50.02874965667725,52.86491756439209,0.8017701220181068,0.043367776925758966,1.0047443441037283,0.9904301312329353,0.9900505112857685,-0.026749846305507474,53.27582692428138,53.76344054145273,51.631708431243894,49.49997632103506,52.416904994419646,0.6378545838950045,52.234285831451416,0.5496879173586261,52.183516266926624,51.8992977156157,-0.9315774534531288,1.3171430783564853,14955900,0.475609405870394,0.6903437317168584,280827000.0,-55.47443527896697,19.18618833600314,16.367993510430818,13.220003543184125,25.893885490624896,20.33359193978784,-0.043273332436671426,0.9397799100140158,52.943359756469725,52.54331951141357,52.21999931335449,51.89667911529541,51.49663887023926,0.06,0.0,47.59442599859221,-0.022893502681853084,-0.021424541533431457,50.45605141775949,50.3116694859096,0.9404996919351013
2022-04-29,0,51.47749996185303,49.702500343322754,53.30250072479248,51.2122917175293,52.37166619300842,-0.5646597946989772,0.9496571202274906,-0.4326710801540887,2.995563287902007,51.94791650772095,0.7552375125885014,0.018350995165615006,50.39875049591065,52.86491756439209,0.7572209403274041,0.04374360775341579,0.9947415049250798,0.9826982221893269,0.987808499565442,-0.025862224853542948,55.04879694849026,53.648939351081204,51.74962511062622,49.850310870171235,52.192024094717844,0.6540528570699509,52.16755962371826,0.5822348117871212,52.10504125143717,51.90180590197576,-0.9215179655085332,-0.17638861186425414,21088800,0.4758565504892745,0.987272171876591,259738200.0,-94.64717552469483,19.18618833600314,16.367993510430818,-55.02830318009051,23.629748576804232,22.018349244061472,-0.06166726661344909,0.956232309231094,52.943359756469725,52.54331951141357,52.21999931335449,51.89667911529541,51.49663887023926,0.08,0.0,47.623710806270495,-0.024671578749019485,-0.0430348369897487,50.15121732439314,50.2102108001709,0.8296270822611858
2022-05-02,0,51.020833015441895,50.0649995803833,53.30250072479248,51.4293749332428,52.37166619300842,-0.4196948418693513,0.8295412594131121,-0.3334107955634451,2.995603932941737,51.94791650772095,0.6419499397277832,0.016002454898480973,50.53558292388916,52.86491756439209,0.7146592908658945,0.02821333053647281,0.9842290180842481,0.9757158622387468,0.9842076596106915,-0.020603722203070274,49.10482598680575,53.497457610378966,51.838375091552734,50.1792925727265,51.86607156481062,0.5717700113115592,52.10279771259853,0.6566582999838896,51.94945550802336,51.852862661081794,-2.967232528012876,-1.782364431528471,20016000,0.4852595374245643,0.9390794712892497,239722200.0,-84.11483515580939,19.18618833600314,16.367993510430818,-119.73150274209586,20.998899725064458,25.26483395214143,-0.11398372180705577,0.9991398145809709,52.76793342590332,52.25936672210693,51.84833335876465,51.437299995422364,50.928733291625974,0.1,0.0,47.64727854164581,-0.031604417032023435,-0.031110485528805607,49.788997650146484,50.15718623570034,0.8036620003283437
2022-05-03,0,50.916666984558105,50.43583393096924,53.30250072479248,51.4293749332428,52.37166619300842,-0.16314098872777721,0.7496868508314395,-0.4800885063576934,2.9956278001221395,51.94791650772095,0.5855499076843259,0.014448684449004707,50.949417209625246,52.86491756439209,0.6662830612890506,0.01159887799760257,0.9813148698540359,0.9758341352467526,0.986282448427731,-0.022399987929687448,42.98878724501691,53.38554046496855,51.88616676330567,50.386793061642784,51.59071431841169,0.4787956021868786,52.07648822239467,0.6980204815179819,51.72089246598445,51.765135916613715,-4.280601619670948,-1.7460242832268105,17950500,0.49375482055545067,0.8570145643061705,221771700.0,-79.04307687253254,19.18618833600314,16.367993510430818,-111.83842914124965,19.732349105707456,23.740983107144917,-0.11055961069499905,0.9872914575260191,52.76793342590332,52.25936672210693,51.84833335876465,51.437299995422364,50.928733291625974,0.1,0.0,47.66905687579852,-0.01796515705648949,-0.028227314000844862,49.589294978550505,50.14065905979702,0.7649214004357539
2022-05-04,0,51.08166694641113,50.54666614532471,53.30250072479248,51.4293749332428,52.37166619300842,0.00538211710600215,0.7094191977018456,-0.5640234512594233,2.995638885227489,51.94791650772095,0.5591040897369381,0.013666275273196334,50.986417293548584,52.86491756439209,0.6276874276139401,0.007319985024721982,0.9840389492769048,0.9817104444017769,0.9939711208159007,-0.011306631240109333,41.54863210284281,53.3290468113888,51.91020841598511,50.49137002058142,51.44607148851667,0.45363079788040916,52.02392864227295,0.745135175998469,51.52184980223004,51.69488309580006,-3.647518370227669,-0.7182077877545131,20022600,0.4942541380040572,0.952839158602849,241794300.0,-58.85164844190618,19.18618833600314,16.367993510430818,-89.62193993464648,19.46166971556463,21.860939809477532,-0.0453034421560603,0.9955833190321307,52.76793342590332,52.25936672210693,51.84833335876465,51.437299995422364,50.928733291625974,0.1,0.0,47.69494257561976,0.002463743990424927,-0.004378527877840265,49.482786996024,50.08097757611956,0.7031500637089205
2022-05-05,0,50.96750068664551,50.916666984558105,53.30250072479248,51.4293749332428,52.37166619300842,0.21839978823739284,0.6662744971641392,-0.6713240613344533,2.995650059662919,51.94791650772095,0.5306249141693116,0.012828523598047977,51.01816644668579,52.86491756439209,0.6566957933186691,0.0017158750326811076,0.9813339518097793,0.983238921146369,0.9940093984261436,-0.017525534854844316,42.372600704871424,53.269507450367705,51.93695845603943,50.60440946171115,51.28666687011719,0.38291520750870606,51.92095252445766,0.7862823142233889,51.41310791295989,51.6596194324924,-1.943595362632061,-1.4200494167729771,23234400,0.48532278589137606,1.1184141647309924,218559900.0,-76.84208797165807,19.18618833600314,16.367993510430818,-124.41542614705025,17.970768565614378,20.447940113189954,-0.09571968341376837,1.0011389202700536,52.76793342590332,52.25936672210693,51.84833335876465,51.437299995422364,50.928733291625974,0.1,0.0,47.721731021474156,-0.018659460570148112,-0.006125458772557864,49.39074979509626,49.994100025721956,0.723643026690905
2022-05-06,0,50.29083251953125,50.916666984558105,53.30250072479248,51.4293749332428,52.37166619300842,0.21026105371241705,0.6681837999847992,-0.6727814856650931,2.995649580858406,51.94791650772095,0.5319582462310791,0.012865615815536064,51.01549978256226,52.86491756439209,0.7492551326741592,-0.019258507925834608,0.9683301664219877,0.9745750194871537,0.9843030627934791,-0.023052157606743617,37.11772885368483,53.27199272394725,51.93562512397766,50.59925752400807,51.09023816244943,0.4928781826147511,51.78803580147879,0.8941624642820776,51.30372688672654,51.617444000866904,-2.142398084365223,-2.7507891275540852,34258200,0.4283962952346832,1.621082562438736,184301700.0,-89.67999582519658,19.18618833600314,16.367993510430818,-168.76103456115416,15.687763883888103,24.850860676187708,-0.16107492831127418,1.0648884073189833,52.60666651916504,51.9983330001831,51.50666618347168,51.01499936676026,50.40666584777832,0.12000000000000001,0.0,47.75200863370761,-0.01886628343643426,-0.03909063179589529,49.20085525512695,49.86150768824986,0.8233509892231358
2022-05-09,0,50.08916759490967,50.29083251953125,53.30250072479248,51.234166622161865,52.37166619300842,-0.03346137651674639,0.758055547689732,-0.5754253743551625,2.99562537949097,51.90208339691162,0.6142416286468503,0.014619671397918695,50.96241731643677,52.86491756439209,0.7150008912970629,-0.0404649284641459,0.9660072709243966,0.975493793421248,0.984931178827304,-0.01826049018545517,28.822030748619817,53.367861183117505,51.85175008773804,50.335638992358575,50.834881101335796,0.480415574565898,51.62589304787772,0.9839380906454075,51.049671792693815,51.458363448041965,-2.6613350859565754,-3.568120141788095,28207200,0.4331199597030925,1.3194156480641466,156094500.0,-75.19870239625493,19.18618833600314,16.367993510430818,-136.8557250732413,14.028659227340166,22.394988240428702,-0.1463071495264521,1.1057422966220647,52.60037364196777,51.98814707183838,51.49333381652832,50.998520561218264,50.38629399108887,0.14,0.0,47.77729623944627,-0.0007894089391365933,-0.007385980626203414,49.00115312848772,49.728602273123606,0.8447510173383619
2022-05-10,0,50.121665954589844,50.08916759490967,53.30250072479248,51.06645846366882,52.20354151725769,-0.08765831406876315,0.8371515503280116,-0.56178702077941,2.9956012798704736,51.847084045410156,0.6825625085830687,0.016181336329113397,50.85408353805542,52.86491756439209,0.7733061529158112,-0.03540190042484903,0.9688037176409838,0.9799531905090554,0.9891945925931576,-0.015613768085200208,28.166249662893083,53.40992822463369,51.73562512397766,50.06132202332164,50.64119052886963,0.45053659236002735,51.41660731179373,0.9688377964879544,50.805778520309524,51.29028726705042,-3.4456713015372937,-4.335436786969789,24861300,0.42484567231859716,1.1625045941312953,180955800.0,-92.1304117235551,19.18618833600314,16.367993510430818,-139.13458461126115,12.911532583117957,20.611636199795427,-0.14382445065761762,1.1155729592277557,52.60037364196777,51.98814707183838,51.49333381652832,50.998520561218264,50.38629399108887,0.14,0.0,47.79668298439556,-0.01827901978370161,-0.014855446859195907,48.85113525390625,49.50117628914969,0.9278802519641662
2022-05-11,0,49.55666732788086,50.08916759490967,53.30250072479248,51.0074999332428,52.20354151725769,-0.0522109745778575,0.9061305340821962,-0.8010071329657302,2.9955782911913644,51.7416672706604,0.7557167387008669,0.017545254795480695,50.27391586303711,52.86491756439209,0.8280632279429083,-0.022683706664395526,0.9595575056558805,0.9726370307484146,0.981122623937536,-0.02985414747976267,30.232673464955493,53.45759450131564,51.645333433151244,49.83307236498685,50.432024002075195,0.5691670859957967,51.1490477834429,0.9241609978101382,50.632530911478455,51.171818530526565,-2.6338381006612854,-5.5229185278161435,27878700,0.4055062409381975,1.3002000060162706,153077100.0,-94.72116833534847,19.18618833600314,16.367993510430818,-157.58551665236791,11.864095296190627,22.425336855515603,-0.15179439753616525,1.1273208044862641,52.39526808166504,51.74070137786865,51.21166801452637,50.68263465118408,50.0280679473877,0.16,0.0,47.81292046081086,-0.04180174627726885,-0.02854490060981955,48.67560849870954,49.23230307442801,1.041030084686015
2022-05-12,0,49.334166526794434,49.55666732788086,53.30250072479248,50.95479226112366,52.20354151725769,-0.21737885709174995,1.0125408642941776,-0.8030803228923213,2.9955391360121966,51.7416672706604,0.8507750272750855,0.01963852088050999,50.11841611862182,52.86491756439209,0.8218211967400962,-0.04363069800032348,0.9568503293290548,0.9722949826630785,0.9826511822359473,-0.032046581406708796,22.69762277464505,53.58399853576304,51.55891680717468,49.53383507858633,50.20595250810896,0.6527328452433186,50.898333413260325,0.9048293857473312,50.3658594280824,51.01233314290748,-2.869740850992952,-7.027500297315937,25244400,0.394844813442235,1.188539467086632,127832700.0,-91.73127175339108,19.18618833600314,16.367993510430818,-143.01133249748284,10.959024981114268,21.534200765421506,-0.2324697909001565,1.1332278637811535,51.796679336547854,51.231659492492675,50.77499961853027,50.31833974456787,49.75331990051269,0.18,0.0,47.826264964348546,-0.034437694086137394,-0.042710721889391796,48.46929768153599,49.029296330043245,1.122325566326504
2022-05-13,0,49.1899995803833,49.334166526794434,53.30250072479248,50.76020836830139,52.20354151725769,-0.21940504078013304,1.1198008864336548,-0.9237943696746402,2.9954948625341866,51.5716667175293,0.9533583164215088,0.021771290512534548,50.035917568206784,52.86491756439209,0.8346721152959022,-0.05867293880516118,0.9563573168678922,0.9743359401818636,0.9861964492803806,-0.021889336167191575,17.780920159165706,53.67435185297595,51.43475008010864,49.19514830724133,49.935714312962126,0.6205434181218963,50.6908929007394,0.9417355499895679,50.11165534334213,50.822513096672246,-3.1080205195748754,-6.642173270400605,19962300,0.35784000719368714,0.9451873442822281,107870400.0,-84.07008863207285,19.18618833600314,16.367993510430818,-136.45405417476331,10.430252890922723,21.31370580631588,-0.18451716051377373,1.1056099261602057,51.76678591918945,51.18327268981933,50.711666107177734,50.240059524536136,49.65654629516602,0.19999999999999998,0.0,47.83545734044717,-0.010096336303924813,-0.030705788820499104,48.1923828125,48.837584904261995,1.1666605099803098
2022-05-16,0,49.48166561126709,49.1899995803833,53.30250072479248,50.2485408782959,52.10854172706604,-0.13064722631061554,1.1968781588212136,-0.9915704841431672,2.9954595016090884,51.27958345413208,1.0168750286102295,0.023342883725785194,49.53441724777222,52.86491756439209,0.8604216449431918,-0.05678949977238725,0.9650479110251096,0.9845742406589787,0.9964423335710352,-0.012128410449055216,17.322400126516868,53.66754805996727,51.27379174232483,48.8800354246824,49.72345215933664,0.4352461664021261,50.50505951472691,0.9016702664013535,49.883214813467774,50.620896782679246,-3.703221682276631,-5.5748414000239785,21449100,0.3571396573603383,0.9995477380963199,129319500.0,-80.90410403562447,19.18618833600314,16.367993510430818,-109.02712120137404,12.605669549438447,19.810955187803664,-0.16043979708328834,1.1044947033832313,51.47392080688476,50.946373947143556,50.52000045776367,50.09362696838379,49.56608010864258,0.19999999999999998,0.0,47.84667450637613,-0.020487772238612534,-0.009026442563376515,47.983660561697825,48.68720517839704,1.2067846809702207
2022-05-17,0,44.654998779296875,49.1899995803833,53.30250072479248,50.1135413646698,52.08604145050049,0.03791447804137848,1.2396562627951833,-1.1023437455138465,2.995438512875202,51.051249980926514,1.0492375850677491,0.024240304890899827,49.466915702819826,52.86491756439209,0.8834585689899903,-0.05495695875047004,0.8731862354102904,0.8912639722790291,0.9014504172911461,-0.10906794638960648,23.617430602712414,53.61960421641678,51.140291690826416,48.66097916523605,48.91833305358887,1.9133921502411835,50.004285608019146,1.7526703109968393,49.786461101828365,50.504777846724515,-2.9152598329541712,-4.995201446503915,132940200,0.36210680575791565,4.8672750568272,-3620700.0,-97.30446966816922,19.18618833600314,16.367993510430818,-314.0338637141722,8.953031225117847,40.160592002708555,-0.3385014559651277,1.4440030985495578,50.254587173461914,48.97270679473877,47.93666648864746,46.90062618255615,45.61874580383301,0.2,0.0,47.697195002904955,-0.11952016054480707,-0.1319148077997721,47.14462171282087,48.17273848397391,1.9226270031503492
2022-05-18,0,41.68833351135254,44.654998779296875,53.30250072479248,49.956042528152466,51.92833352088928,-1.527851281425334,1.848521199094898,3.413528974147188,2.9950557414413144,50.9941668510437,1.3321502685546875,0.03642041502224325,49.31974983215332,52.86491756439209,0.500812373085436,-0.15827339784870775,0.8213627243293545,0.8425828990030609,0.8605557791156121,-0.1587744745720936,6.90542741722272,54.45212572071481,50.755083322525024,47.05804092433524,47.71821389879499,3.234873904840096,49.2765475000654,2.747990880161861,48.50557600175809,49.75208554513575,-11.206483285090993,-13.569576299479582,104253000,1.0768744625387892,3.3059840394537625,-107873700.0,-97.40556646594699,19.18618833600314,16.367993510430818,-329.4792883852546,7.623444765064883,47.973424261836435,-0.4237984923563844,1.5746937721241387,49.3443865814209,47.65613961029052,46.29166603088379,44.927192451477055,43.23894548034668,0.2,0.0,47.48981543578137,-0.17064099105555675,-0.17931361894012646,45.81395557948521,47.40755435398647,2.766392919059302
2022-05-19,1,40.02750015258789,41.68833351135254,53.30250072479248,49.53791689872742,51.718541860580444,-1.9419030207073467,2.63453985416124,3.5830509697087116,2.9943030168928337,50.94208383560181,1.737866859436035,0.05249455491939355,48.73649950027466,52.169166851043705,0.5806851790365924,-0.21789160087263726,0.7975684261246552,0.8246716520191919,0.8540141442756453,-0.1886454566765995,4.27457091955647,55.45599639342685,50.18691668510437,44.91783697678189,46.27619021279471,4.115031896311892,48.45869037083217,3.6109355439147626,46.801502247594506,48.67322258316308,-16.771758220256125,-19.63952986203483,71008500,1.200504758809778,2.077690773918856,-178882200.0,-98.70844362566659,19.18618833600314,16.367993510430818,-274.0950293790911,7.17584292536528,49.64839417639396,-0.4627464573861834,1.5534026036459045,48.80065364074707,47.029673484802245,45.59833335876465,44.16699323272705,42.396013076782225,0.2,0.0,47.32523475017938,-0.192636292749635,-0.19340218218551372,44.42661666870117,46.63887596130371,3.4408383829872395
2022-05-20,1,39.74583339691162,40.02750015258789,52.844167709350586,49.444790840148926,51.52458333969116,-1.790831046823383,3.3429897040410315,2.1060308967509362,2.993352225744241,50.60374975204468,2.2762335777282714,0.06750355297812229,44.35833225250244,52.08441638946533,0.6907823503873757,-0.24253703128140727,0.8025705155851461,0.8377508742280954,0.8830739485791669,-0.1919936219564019,3.6613437489517957,56.20914606457622,49.52316665649414,42.837187248412064,44.874642508370535,4.46718784232495,47.65333325522287,4.204155655423515,45.10721405745398,47.51216779699104,-20.139326197072645,-22.24272705113897,49356000,1.222273658293106,1.3867108562046082,-228238200.0,-94.86018550096024,19.18618833600314,16.367993510430818,-203.39605476808953,6.776453943189453,48.95860353941383,-0.4123412050333345,1.5274410411250494,48.65273329162598,46.82529999542236,45.34833335876465,43.871366722106934,42.04393342590332,0.2,0.0,47.21143770584777,-0.19486653536793375,-0.19175468872914211,43.11714553833008,45.89637701851981,3.9367155682980246
2022-05-23,1,40.51250076293945,39.74583339691162,52.09416675567627,49.29812479019165,51.180625200271606,-1.4800294753789234,3.8697576333300963,0.6796069324874701,2.9924610041123247,50.20624923706055,2.935633392333986,0.07918756325451154,41.522250175476074,51.89733362197876,0.7826838352975102,-0.23703869603441066,0.8290147654552247,0.8733212808969618,0.9395365096336271,-0.18126238754350532,3.6258241191178398,56.60776520753238,48.86824994087219,41.128734674212,43.61440454210554,4.237887274863845,46.91017852510725,4.492594405400894,43.76596597133466,46.472957096020345,-19.79720279827939,-22.0988152332162,43680900,1.2252225596613497,1.184621392715054,-184557300.0,-85.8055772195824,19.18618833600314,16.367993510430818,-143.25384133266522,10.862364666587235,45.46977621511576,-0.3903979037971908,1.5271476735911729,48.65273329162598,46.82529999542236,45.34833335876465,43.871366722106934,42.04393342590332,0.2,0.0,47.1264436507033,-0.1727953944764361,-0.17190134684123703,41.97078377859933,45.22004073006766,4.186893794392274
2022-05-24,0,40.91416645050049,39.74583339691162,52.083333015441895,48.056249380111694,51.036041498184204,-1.161386217270634,4.196461238260477,-0.3264614796428966,2.9918151653615124,50.105416774749756,3.4816666603088366,0.08690274714074299,40.4640007019043,51.68691682815552,0.8409914298586766,-0.2221599806040038,0.8472742293208853,0.900571557212474,0.9900385101269863,-0.08377186050961727,10.896548385891318,56.68208911775632,48.289166641235354,39.89624416471439,42.43214266640799,3.5161047350751957,46.18392848968506,4.587197535140263,42.9521867445413,45.68684758584019,-17.881452925861726,-20.4337142193027,34584900,1.258417895636863,0.9192613248086451,-149972400.0,-81.29770647024925,19.18618833600314,16.367993510430818,-112.96779786489387,11.50195770452739,42.96612438018505,-0.323515572318223,1.5006810474941676,48.43117259216309,46.64607942962647,45.20333290100098,43.760586372375485,41.97549320983887,0.2,0.0,47.06471186252353,-0.05496762065917027,-0.16247230876288002,40.8686534336635,44.530518123081755,4.341663111379436
2022-05-25,0,41.22000026702881,39.74583339691162,51.87666702270508,43.91333246231079,50.980833768844604,-0.8977662221663335,4.39296684334666,-0.9580664392300164,2.991366947313996,49.822917461395264,3.884091682434081,0.09203648968584999,40.4640007019043,51.496333312988284,0.8716552181550598,-0.20810013697506696,0.8635949836891943,0.9260718978352098,1.015829727580641,-0.011234156054623634,14.686433424314691,56.51664199968161,47.730708312988284,38.94477462629496,41.25190476008824,1.6432051954330282,45.487678459712434,4.544838821886051,42.44173703664893,45.040064477284986,-16.82421874462298,-19.904402310475085,27121800,1.2781182135176206,0.7117884900259778,-122850600.0,-83.36968632015942,19.18618833600314,16.367993510430818,-95.38484326779074,11.30705723813979,41.498194424460415,-0.3102165891722845,1.4427677739189715,48.43117259216309,46.64607942962647,45.20333290100098,43.760586372375485,41.97549320983887,0.2,0.0,47.01795391346777,0.007678024916532689,-0.06075347272685033,39.724134172712056,43.85389736720494,4.466892619202106
2022-05-26,0,41.84166622161865,39.74583339691162,51.87666702270508,41.571250200271606,50.929375410079956,-0.6623291011369132,4.51337729089562,-1.3668962635503032,2.9910533968361612,49.519166469573975,4.169558324813842,0.09560535198842451,40.4640007019043,51.121250247955324,0.8836249855396339,-0.20542311924187653,0.8863179320216369,0.9579812306090001,1.0335358662364595,0.045322991995878414,17.019917298919268,56.235171234470684,47.208416652679446,38.18166207088821,40.85000010899135,0.7996684858644242,44.88416658129011,4.417153826185551,42.137550810471396,44.64904884720211,-16.696417232885306,-19.124933120706736,28197600,1.2813287242934377,0.7273830400079245,-94653000.0,-75.6349427140609,19.18618833600314,16.367993510430818,-74.19410673477675,13.64703164557728,39.37747077864091,-0.29207188312476856,1.4118520087648971,48.21470631408691,46.47097974395752,45.06166648864746,43.6523532333374,41.90862666320801,0.02,1.0,46.97573281334796,0.05820115753281385,0.02915955004946228,39.47763007027762,43.311125891549246,4.449714878255045
2022-05-27,0,42.32500076293945,39.74583339691162,51.47749996185303,41.571250200271606,50.447291135787964,-0.46185662974371666,4.524300376951126,-1.6191172533140332,2.990960056844868,49.40791606903076,4.3048333358764665,0.09686626567626166,40.4640007019043,51.02691640853882,0.8976179169224945,-0.1871853479165641,0.9061875709087475,0.9859609021416802,1.0361880522768536,0.06489151555262751,22.835584063676233,55.75526736652737,46.70666661262512,37.65806585872287,40.940952573503765,0.9355689626937262,44.32958323614938,4.195213752091071,42.063458752581894,44.43620449301747,-6.300151460271791,-16.80060932503201,25299900,1.3081057711555633,0.649108594629439,-69353100.0,-67.98970881286654,19.18618833600314,16.367993510430818,-57.45589182362751,16.676702284976958,37.14432148936888,-0.23804695542626111,1.3898124786496917,48.00842596435547,46.30411946105957,44.926666259765625,43.54921305847168,41.84490655517578,0.04,0.0,46.94298580244532,0.07785227361013547,0.0790292386995725,39.75638798304966,42.78517178126744,4.40683631721588
2022-05-31,0,42.78416633605957,39.74583339691162,51.08166694641113,41.571250200271606,50.163957595825195,-0.27493781761483765,4.481269969051701,-1.75882504770345,2.990986861312178,49.26208305358887,4.33113745689392,0.09689433140485579,40.4640007019043,50.972833919525144,0.9058952523450714,-0.17043689290354339,0.9250822245649898,1.0128547525608038,1.0343667260800968,0.056073200378640164,27.326140260784847,55.21158159078284,46.249041652679445,37.28650171457605,41.33476202828543,1.059022831529533,43.80547612054007,3.860969337749234,42.128478707239125,44.33071603327779,1.5272072495139133,-15.500690478152908,36912300,1.326722862639297,0.9269512036179732,-32440800.0,-66.06929281459375,19.18618833600314,16.367993510430818,-45.96050286419656,18.20540024392053,35.5189975998269,-0.22685261196041834,1.349583749672148,47.616240036010744,45.98688005828858,44.670000076293945,43.353120094299314,41.72376011657715,0.06,0.0,46.90020210342265,0.04918445717399278,0.07911082331912836,40.19687271118164,42.311744689941406,4.344405120668056
2022-06-01,0,42.29583263397217,39.74583339691162,51.08166694641113,41.571250200271606,50.09729218482971,-0.09672532711898774,4.401584061227944,-1.8051434019897714,2.9910988327418684,46.92249917984009,4.265791654586792,0.09602644276726727,40.4640007019043,50.92175035476684,0.9061297217001165,-0.1597217793333751,0.9227401533680968,1.0174258186989766,1.011450669016319,0.03376987247542407,31.253733779972627,54.64037644116621,45.837208318710324,37.03404019625444,41.6990476335798,0.8365814011148683,43.28684507097517,3.4997716825161027,42.29387271604834,44.27551673863889,6.8869306675736865,-14.639376961607855,28534800,1.340514507851451,0.7071750580942124,-60975600.0,-75.12166309676871,19.18618833600314,16.367993510430818,-52.45130345688313,16.848042833674295,37.68889969462681,-0.23714035068595696,1.3541374906476145,47.463439453125,45.86327958679199,44.56999969482422,43.27671980285645,41.67655993652344,0.06,0.0,46.86154597683963,0.010634112532399653,0.023246303638507413,40.484845297677175,41.80099541800363,4.273841955786286
2022-06-02,0,42.07833290100098,39.74583339691162,51.08166694641113,41.571250200271606,49.68979239463806,0.08796358804240786,4.304087284886915,-1.7922564033299557,2.9912440042386574,43.71958255767822,4.145783333778381,0.09479080942223747,40.4640007019043,50.35849933624268,0.8924162826986342,-0.17199584190656947,0.9267096531312667,1.0179708204937334,0.999643640876913,0.020823207870251714,29.13219604930523,54.01434117095486,45.40616660118103,36.7979920314072,41.92273793901716,0.656367911664601,42.76857124056135,3.0427608917347913,42.295512377833795,44.1001046576649,6.415764922062723,-14.651579868898297,23214300,1.33322116892057,0.5730512399534041,-84189900.0,-68.45347514699975,19.18618833600314,16.367993510430818,-47.10788874355794,15.885407626054834,36.1604345901619,-0.22963834896493898,1.3336019795483816,47.356479919433596,45.77675996398926,44.5,43.22324003601074,41.643520080566404,0.06,0.0,46.830787642768065,0.03355751474617863,0.027229677717005463,40.71107700892857,41.34093039376395,4.0823946379376235
2022-06-03,0,42.04166603088379,39.74583339691162,50.96750068664551,41.571250200271606,49.50041604042053,0.27095226561747787,4.1551986648606185,-1.7162255597098215,2.991488810087791,42.55458354949951,3.9383666610717767,0.09242812247984984,40.4640007019043,50.13858261108398,0.880850082715543,-0.1744085479155871,0.9351736392343626,1.0161250538982323,0.9947158703077295,0.004779919810215416,28.449049233929404,53.26639722863175,44.95599989891052,36.645602569189286,42.08380930764334,0.4830860095652836,42.25797598702567,2.4179276577401634,42.2408314539592,43.86156152329928,3.8650592004281688,-14.70752246691481,18302700,1.331999681609794,0.4545740729081408,-102492600.0,-75.20023635611082,19.18618833600314,16.367993510430818,-45.76426032565328,15.179076298365622,34.55259119230059,-0.2522545024846866,1.2959607125628934,47.356479919433596,45.77675996398926,44.5,43.22324003601074,41.643520080566404,0.06,0.0,46.80594224706447,-0.0053966878124238615,0.015806112605717775,40.76590837751116,40.81728090558733,3.8904460659311133
2022-06-06,0,41.79833221435547,39.74583339691162,50.29083251953125,41.571250200271606,49.3710412979126,0.45765248497930283,3.96033579919354,-1.5651389275477163,2.991820338789556,42.31041669845581,3.664149856567383,0.08897689880177333,40.4640007019043,50.09241743087769,0.8773848072370146,-0.1640292290934688,0.9390834929393972,1.005349626810063,0.9880234600682235,-0.01244343860816055,28.945931760317954,52.43037976450951,44.50970816612244,36.58903656773536,42.16642815726144,0.3385711515042403,41.70916645867484,1.2346210283540784,42.188694068886434,43.60433468977328,2.755768180557687,-14.532087030857035,19855500,1.33438329861877,0.5021208412961295,-122348100.0,-62.320274658280006,19.18618833600314,16.367993510430818,-45.8439720767869,14.682290959059713,34.37871927991347,-0.2500909856615611,1.2441024170319464,44.226625381469724,43.245018989562986,42.4516658782959,41.65831276702881,40.67670637512207,0.06,0.0,46.77800404096677,-0.02809778950946995,-0.008968290375822426,40.83502088274275,40.2795775277274,3.727741127172441
2022-06-07,0,40.74833297729492,39.74583339691162,50.121665954589844,41.571250200271606,49.226041316986084,0.6715450468426426,3.768349940876324,-1.2868355773551057,2.9921416127477056,42.18708276748657,3.3832749319076543,0.08547902536512512,40.4640007019043,49.60991735458374,0.861431768075364,-0.16552152448619967,0.924311128956023,0.9752799270965785,0.9656079494761948,-0.04758380338122414,28.14881393101331,51.6217830326163,44.085083150863646,36.54838326911099,42.01023769378662,0.6354182279181538,41.43011890138899,0.9186480641950716,42.10207932437066,43.31379556648042,1.4030372236296618,-15.527636958045544,47707800,1.3340335689458007,1.1774383426747914,-170055900.0,-51.7022976986769,19.18618833600314,16.367993510430818,-60.2584036543854,13.566569538296141,38.832069440183346,-0.20004322179637446,1.2502385220443257,42.306439453125,41.691779586791995,41.19499969482422,40.69821980285644,40.083559936523436,0.02,1.0,46.700442550957895,-0.0408924886399028,-0.039772590756984125,40.71384266444615,40.09573636736189,3.471683103957979
2022-06-08,0,40.87583351135254,39.74583339691162,50.121665954589844,41.14354181289673,45.78874897956848,0.9064780533178467,3.5688341070995855,-0.8612732258187128,2.992460277380977,42.05999946594238,3.0630915260314935,0.08182013659752685,40.4640007019043,49.48916578292847,0.8251789819428332,-0.187011600647655,0.9371313378740094,0.9777796500318011,0.978066259391687,-0.03357302680167784,24.176163151205724,50.755709634182075,43.61804141998291,36.48037320578374,41.80321380070278,0.7427788768640067,41.37208318710327,0.9267100179997262,41.778072441982,42.88132147119301,-2.6130251088299863,-8.748552029550558,22522800,1.3359072895126725,0.5574760759998886,-147533100.0,-60.174189444612416,19.18618833600314,16.367993510430818,-56.99960187429927,13.870407523306929,37.33134220983378,-0.19800167520124698,1.2075995332663592,42.306439453125,41.691779586791995,41.19499969482422,40.69821980285644,40.083559936523436,0.02,0.0,46.6648149448964,-0.025109508622805254,-0.04921095148418485,40.42909567696707,40.09274183000837,3.2166139534113203
2022-06-09,0,40.69666767120361,39.74583339691162,49.55666732788086,40.9045832157135,43.2518744468689,1.1711141703623833,3.2838988940628075,-0.22138778371844614,2.9929159105096974,41.94166612625122,2.6438748836517334,0.0760941220914348,40.4640007019043,49.3489164352417,0.8043412594311311,-0.17516984665440638,0.9430184358251703,0.9735831457794047,0.9804417922828964,-0.03283555061575394,26.026311180173565,49.72354758594666,43.155749797821045,36.58795200969543,41.50499970572336,0.7011868146777968,41.419880867004395,0.8673827508682949,41.563931751135016,42.47914785725049,-3.423903663235918,-1.948986518683316,19880100,1.3428833167656857,0.4969845464332601,-167413200.0,-70.30878214177629,19.18618833600314,16.367993510430818,-61.23602475688487,12.946691355336169,36.74796541688622,-0.20242596103216717,1.201341967078419,42.306439453125,41.691779586791995,41.19499969482422,40.69821980285644,40.083559936523436,0.02,0.0,46.63265009491126,-0.05089802113391395,-0.035312871610667936,40.078459058489116,40.13766588483538,2.9466200484585694
2022-06-10,0,40.294166564941406,39.74583339691162,49.48166561126709,40.843958377838135,42.43979215621948,1.5007354240792563,2.9734676634490644,0.8440091138792578,2.993386581872546,41.81999921798706,2.1881247758865365,0.06961545853003649,40.4640007019043,49.204416275024414,0.7564899304373564,-0.17508147930095488,0.9433756135926155,0.9651624928986259,0.9772507729733656,-0.04156589476398653,25.538400381965054,48.65968514188531,42.712749814987184,36.765814488089056,41.21904741014753,0.7323816015195018,41.45904752186367,0.7953667879739059,41.352604645056026,42.1070079002323,-4.879138343982551,1.6717694486660544,25238100,1.343316196534217,0.6309346760954003,-192651300.0,-77.65151227801337,19.18618833600314,16.367993510430818,-71.60641193646146,12.070686122559255,37.545140345607045,-0.17531548611044512,1.1964840604795612,42.46927912902832,41.95535906219482,41.53999900817871,41.1246389541626,40.6107188873291,0.04,0.0,46.590361908646514,-0.028886127393645822,-0.04556505684930281,39.90567561558315,40.19526045663016,2.573705202513632
2022-06-13,0,39.95666694641113,39.74583339691162,49.48166561126709,40.735416650772095,42.30312466621399,1.9132720565210988,2.5956743306126766,2.6899252729216094,2.993913767350672,41.743332862854004,1.716716480255127,0.06142045140843684,40.267499923706055,45.10849885940552,0.6651764056203424,-0.1808463730702999,0.9454793660674166,0.960639208036543,0.97734982282946,-0.044060735689158026,24.105628742510397,47.45209847811988,42.26074981689453,37.06940115566918,40.915952273777556,0.7561374555440391,41.41934510639736,0.8576818909088254,41.08396345721983,41.713957131616866,-4.7325373314037,1.3795991206273017,24897900,1.3414112786236723,0.6186134882531789,-217549200.0,-97.03978013787963,19.18618833600314,16.367993510430818,-93.91735419387572,11.431264612210585,36.06365627830262,-0.21345618702593694,1.173162471802301,42.449612762451174,41.92352621459961,41.49833297729492,41.07313973999023,40.54705319213867,0.06,0.0,46.54620990093008,-0.04372540885006737,-0.047159373667208286,39.53246252877371,40.121769768851145,2.0445057713823527
2022-06-14,0,39.72999954223633,39.74583339691162,49.48166561126709,40.65062594413757,42.132707834243774,2.4350160613685183,2.095018837920061,6.349922594045408,2.994522859217408,41.454166889190674,1.3110663795471198,0.050121167218855615,40.020416831970216,42.9712495803833,0.4258580256126985,-0.192495514190757,0.9504993055997838,0.9606596163837952,0.980640580170435,-0.024990799884402892,21.969799244855167,45.98912086103605,41.799083185195926,37.6090455093558,40.585714203970774,0.6838999986990676,41.33476175580706,0.9632301064617415,40.79008958931169,41.30435602958702,-5.042181589231575,-1.3720056922202963,21544200,1.3299614159130504,0.5352241895039744,-239093400.0,-89.00254931057393,19.18618833600314,16.367993510430818,-113.95631574793781,10.99160883626576,36.610170097623936,-0.2043371858656115,1.1329346667087496,42.37723927307129,41.806379295349124,41.34499931335449,40.88361933135987,40.312759353637695,0.08,0.0,46.50713230441757,-0.03169333087140269,-0.04332494132222481,39.26245880126953,40.01418358939035,1.1144166832054878
2022-06-15,0,39.804999351501465,39.72999954223633,44.654998779296875,40.45791721343994,42.050832748413086,0.868209104589473,1.1892510974745738,0.8141276605867,2.995321157668107,41.06708335876465,0.9704830455780027,0.028787410306545316,39.93558359146118,42.370917320251465,0.4906207156037794,-0.11028998704942064,0.9635331436874641,0.9696337228981787,0.9874557397513681,-0.026197243404312953,26.21511164239831,43.69000207669353,41.31149988174438,38.93299768679523,40.3009523664202,0.47919435204727484,41.23369026184082,1.0468100133170222,40.50422715075068,40.88785231188955,-5.49851303930085,-2.8942711314840306,25914000,0.8540995721350232,0.7424926625341624,-213179400.0,-87.66670227050781,19.18618833600314,16.367993510430818,-109.860564030145,11.278822864431898,34.642148268048246,-0.07833136501519233,1.1117716703304996,42.355999237060544,41.77199923706055,41.29999923706055,40.827999237060546,40.24399923706055,0.1,0.0,46.46076442463684,-0.02387593480697503,-0.032341984411990675,39.00950295584543,39.92226191929409,0.9977040649070261
2022-06-16,0,39.913333892822266,39.72999954223633,42.78416633605957,40.22749996185303,41.89166617393494,0.1115309579639193,0.9539601067155862,-1.3001057225454047,2.9954626901466734,40.894999980926514,0.8452331686019896,0.023228228318144823,39.79908275604248,42.2987494468689,0.7713660476133857,-0.045176527848929386,0.9718603808211806,0.9782080538377874,0.9954318675603402,-0.01924810612775607,32.457980031633745,42.97692012378579,41.06899991035461,39.16107969692344,40.181666782924104,0.45244864888768627,41.095952238355366,1.0867611421700163,40.316369266344864,40.67951218699434,-4.768929182704093,-3.4328018106763074,30706800,0.5691493032701059,0.9834344012763241,-182472600.0,-77.33325958251953,19.18618833600314,16.367993510430818,-75.0467374213744,13.308931958027108,32.03403961229316,0.05221447353949419,1.1164071926751236,42.355999237060544,41.77199923706055,41.29999923706055,40.827999237060546,40.24399923706055,0.1,0.0,46.40925143918775,-0.003305074028458921,-0.01373664578733643,38.88279506138393,39.79831886291504,1.0136155781878424
2022-06-17,0,39.763333320617676,39.72999954223633,42.78416633605957,40.0097918510437,41.89166617393494,0.2823542270535882,0.9745577549986747,-1.2955847254818118,2.9954500897251517,40.81208324432373,0.8542997932434077,0.02378115693967109,39.79908275604248,42.2987494468689,0.8515213509873881,-0.002852195598786197,0.9703048026572295,0.9797302874806192,0.9955808543862036,-0.013173947734300362,38.56963359949145,42.929365439425446,40.9802499294281,39.03113441943075,40.0227381842477,0.3522749924347114,40.91297599247524,1.0795382116028758,40.20901070968607,40.584079615815554,-2.049161336091761,-4.608641344689234,36838800,0.4349260094322779,1.2481145538150047,-219311400.0,-96.74997329711914,19.18618833600314,16.367993510430818,-103.21899891433104,12.475121020909992,30.586853342912796,0.09140040238911175,1.1059489432422505,42.355999237060544,41.77199923706055,41.29999923706055,40.827999237060546,40.24399923706055,0.1,0.0,46.344845023646904,-0.02801973635617938,-0.022558219947213236,38.69803128923689,39.56356348310198,1.0319659181556553
2022-06-21,0,40.12249946594238,39.72999954223633,42.78416633605957,39.945833683013916,41.89166617393494,0.2617426634453252,0.9890632195753483,-1.3089512638331897,2.9954414001458933,40.81208324432373,0.8648664665222171,0.024142900762186774,39.76158332824707,42.2987494468689,0.8344443846798314,0.00044029580487836713,0.9793848398821626,0.9941606085412329,1.0072509733549584,0.004150309127477048,37.59102597463829,42.945168026980284,40.96704158782959,38.9889151486789,39.94071415492466,0.20545145087556324,40.722856930324006,0.9514241140364337,40.09599976860933,40.53306240307659,-2.7216575055916254,-6.052374237792856,23916600,0.431514220576374,0.8467974503241267,-195394800.0,-61.25228726133039,19.18618833600314,16.367993510430818,-55.180761207384286,15.266336067298175,27.662233301126804,0.1194308448446692,1.1355251215996929,42.10642504882812,41.570118545532225,41.13666534423828,40.70321214294434,40.16690563964844,0.1,0.0,46.30782594389391,0.023113459935012237,0.0038617483216128066,38.75101743425642,39.41473824637277,0.9926967187022386
2022-06-22,0,40.552499771118164,39.72999954223633,42.78416633605957,40.08104133605957,41.89166617393494,0.2869938707817676,0.9690131353607578,-1.2864438878078848,2.995453374914296,40.81208324432373,0.8497998237609863,0.02364261194694894,39.800832748413086,42.2987494468689,0.8922076117510068,-0.009626690272199654,0.9894262322980165,1.0090050060673237,1.0171989245928497,0.020702246120276158,41.00250482514263,42.92390116200265,40.98587489128113,39.047848620559606,39.977618898664204,0.2866708639021709,40.598333154405864,0.8369075212522094,40.105571020215734,40.558520932175654,-1.4108482048212114,-6.221149313066941,20235000,0.40204203762436114,0.747470706517734,-175159800.0,-71.02801961301608,19.18618833600314,16.367993510430818,-41.72245647250249,15.40248476509474,26.094799138358372,0.057644258471669235,1.1177488259473196,41.752438537597655,41.28377867126465,40.904998779296875,40.5262188873291,40.057559020996095,0.1,0.0,46.27764639550057,0.010296081780154065,0.010719172363134894,38.70447976248605,39.3050776890346,1.008491236366
2022-06-23,0,40.87750053405762,39.72999954223633,42.78416633605957,40.08104133605957,41.89166617393494,0.2829916256988153,0.9680748954340773,-1.283005852350031,2.995453932465427,40.81208324432373,0.8481998634338381,0.02361856766600199,39.800832748413086,42.2987494468689,0.9120309991455607,-0.008839644327592065,0.9973071473439705,1.017587327429634,1.0211376266252923,0.026943881422665905,47.029986289166274,42.924024632558215,40.987874841690065,39.051725050821915,40.10916655404227,0.4437145439787015,40.51255941390991,0.7280067561388459,40.22036478252682,40.62577916103363,0.6411181275096153,-4.121760358616874,18040800,0.40365462682628583,0.6874233398833794,-157119000.0,-39.91585223652734,19.18618833600314,16.367993510430818,-3.37104979071141,15.84281408302001,24.2738717454861,0.03542389081374165,1.1157667160098492,41.724425048828124,41.26111854553223,40.88666534423828,40.512212142944335,40.04890563964844,0.02,1.0,46.253181715153126,0.035517072202224664,0.0348233954605084,38.898458753313335,39.21546064104353,1.0063314893083037
2022-06-24,0,41.35666751861572,39.72999954223633,42.78416633605957,40.08104133605957,41.89166617393494,0.2884686050922151,0.968247447834905,-1.2820594558911327,2.9954538204571644,40.81208324432373,0.8496665000915528,0.023623834147323764,39.800832748413086,42.2987494468689,0.9151656833729537,-0.008309066733440834,1.009042736472441,1.029511236783445,1.0276012204977558,0.03616169046838302,51.088437209403644,42.92253644153773,40.98604154586792,39.04954665019811,40.341547693525044,0.6076977942870472,40.463630948747905,0.6343231038675857,40.38776898392031,40.718948231255354,2.304580581962662,-2.85380214508164,31845900,0.4044883463069485,1.2026263302580278,-125273100.0,-30.71417964231754,19.18618833600314,16.367993510430818,26.102736875214497,18.053289695946027,23.13097185986487,0.019413428624531204,1.0872587800625366,41.4391986541748,41.030398765563966,40.69999885559082,40.369598945617675,39.96079905700684,0.04,0.0,46.21360394677247,0.025700487374008762,0.03635474133609366,39.09474127633231,39.17860003880092,1.0071942125356548
2022-06-27,0,41.28583335876465,39.72999954223633,42.78416633605957,40.08104133605957,41.89166617393494,0.26755204627858487,0.970354456793015,-1.3038710817098982,2.9954526558894585,40.81208324432373,0.857866535186767,0.02367129553514329,39.800832748413086,42.2987494468689,0.8988223950604157,-0.01159128559637383,1.0071465700069018,1.0260621399114893,1.0185356482609058,0.0382890444790136,55.85103214747686,42.9335838220333,40.99287490844726,39.05216599486123,40.55309540884836,0.6463105417582727,40.42702388763428,0.5620418584875876,40.6336519540865,40.84758028581082,4.09430655706429,-1.6293324621456886,19889100,0.39373594345815677,0.7630615460579699,-145162200.0,-16.059404227979787,19.18618833600314,16.367993510430818,24.615362597584944,17.259546417507725,22.948215009065347,0.001159310239658415,1.056025278824357,41.187080169677735,40.82645999145508,40.53499984741211,40.24353970336914,39.882919525146484,0.04,0.0,46.18890753681036,0.04928555980621363,0.029016521139543658,39.31314032418387,39.16132164001465,0.9864756712375604
2022-06-28,0,41.2408332824707,39.72999954223633,42.78416633605957,40.08104133605957,41.85916566848755,0.33567353520899706,0.9534591204683889,-1.1773339774777083,2.99546207382684,40.81208324432373,0.824516563415527,0.023274922067006328,39.800832748413086,42.2987494468689,0.8712557922790499,-0.024552094162859854,1.0067313427725824,1.0224239497417977,1.0098394463991485,0.027872984769495845,52.86395128167741,42.87200150624134,40.965083265304564,39.05816502436779,40.74273817879813,0.6215896050174194,40.462202480861116,0.5979647784278798,40.80140916257646,40.92224778273672,3.7202211566103838,-1.2261227384924336,15399000,0.375042598395634,0.60223329647348,-160561200.0,-41.72094029527838,19.18618833600314,16.367993510430818,18.95224255994284,17.853018305890323,21.255375701001874,-0.07274829744521563,1.0586902681935817,41.25329307556152,40.880019645690915,40.57833290100098,40.27664615631104,39.90337272644043,0.06,0.0,46.169345252768906,0.0016371753724524485,0.034491422988169464,39.393771580287385,39.13828332083566,0.8950451249489567
2022-06-29,0,40.760833740234375,39.72999954223633,42.78416633605957,40.08104133605957,41.46708369255066,0.40501379094958545,0.9041453811029332,-0.9258716476235462,2.995488748354419,40.81208324432373,0.7594665145874018,0.022100367775210388,39.800832748413086,42.100082874298096,0.812270296796566,-0.03607252836169224,0.9963324873534121,1.0073170781085208,0.9926494508124017,0.0051373890707617775,50.108907936260735,42.71916565348698,40.910874891281125,39.10258412907527,40.885238238743376,0.45040565529303833,40.453988211495535,0.5926115443017697,40.9130844561803,40.96248261931634,3.325954662702746,1.208639149606939,19111500,0.35504983393940215,0.7743787071078617,-179672700.0,-47.58801280186209,19.18618833600314,16.367993510430818,-13.377749574861681,16.879986018384802,23.11971315109846,-0.08137193407780856,1.039735878016854,41.25329307556152,40.880019645690915,40.57833290100098,40.27664615631104,39.90337272644043,0.06,0.0,46.14315618129889,0.01019164282936047,-0.0020461061733059323,39.561026436941965,39.129528863089426,0.774374150543882
2022-06-30,0,40.36750030517578,39.72999954223633,42.29583263397217,40.08104133605957,41.30354189872742,0.32495270925063297,0.7955556289052408,-1.0088162556656524,2.995542637660182,40.75458335876465,0.6563457632064817,0.019494273857771433,39.800832748413086,42.045332717895505,0.8134251852912358,-0.03629196538159356,0.9891641480629898,0.9950617742794687,0.9820740706499048,-0.012476306579873309,43.97796665343279,42.40081951930035,40.80970826148987,39.218597003679385,40.92023835863386,0.3861991281481073,40.430476256779265,0.5887599237306863,40.87450915334216,40.8996948378123,2.5085935617462067,-0.2813392688034726,19166100,0.35455140986303774,0.7916163287053386,-198838800.0,-52.02076945457801,19.18618833600314,16.367993510430818,-39.252322631955714,16.02252518136606,24.47345716111256,-0.02335041222248727,1.017135347521814,41.25329307556152,40.880019645690915,40.57833290100098,40.27664615631104,39.90337272644043,0.06,0.0,46.11570537771778,-0.01650214433157371,0.00737457937840171,39.53384344918387,39.142430441720144,0.7394886297081513
2022-07-01,1,40.72083282470703,39.72999954223633,42.07833290100098,40.08104133605957,41.25208330154419,0.389616706325485,0.7231609129814668,-0.8675168519855521,2.9955748706226197,40.72250032424927,0.5931249618530273,0.0177622806646583,39.800832748413086,41.8226655960083,0.7799669989724941,-0.04065827892588628,1.000185226478928,1.0023815750989162,0.9931345172006656,-0.015374418009441504,39.115751834028806,42.15961347101298,40.71329164505005,39.266969819087116,40.944285937717986,0.3640928213354634,40.46095241819109,0.5921941389011892,40.74815501776984,40.78559351330012,0.6106320455966736,-0.8088312504779014,17460900,0.36024802562715535,0.7298584498705885,-181377900.0,-38.33113254701849,19.18618833600314,16.367993510430818,10.68738385677929,17.417719372928318,23.433729344158085,-0.0470752358834767,0.9863869296629119,41.25329307556152,40.880019645690915,40.57833290100098,40.27664615631104,39.90337272644043,0.06,0.0,46.092453841983975,-0.00881034527261304,-0.008008534272230847,39.62323107038225,39.16385541643415,0.6208589720834777
2022-07-05,0,41.0483341217041,39.72999954223633,42.04166603088379,40.08104133605957,40.96833372116089,0.386156625856339,0.6520664474334422,-0.6386455031589073,2.9956038406031547,40.70875024795532,0.5303750610351564,0.016042803871074398,39.800832748413086,41.400833988189696,0.7237390208780252,-0.031417242247404616,1.0099129868448682,1.0084388187038003,1.0042364945125466,-0.00575256008512004,45.945811926900916,41.94954953610224,40.64541664123535,39.34128374636846,40.968690735953196,0.36459522544380824,40.53892864499773,0.5925570415418917,40.74162143481887,40.72483883351113,0.4150990803007301,1.058878483261279,18218100,0.3735690171999247,0.7616437668926334,-163159800.0,-17.20985057033937,19.18618833600314,16.367993510430818,74.66729494096052,20.040242094950607,21.790978395386087,0.014875762434462559,0.9849783496196259,41.25329307556152,40.880019645690915,40.57833290100098,40.27664615631104,39.90337272644043,0.06,0.0,46.07023653865235,0.0010473356452029847,0.004283667115022996,39.65225764683315,39.27535820007324,0.5930239526924934
2022-07-06,0,41.68249988555908,39.72999954223633,41.79833221435547,40.08104133605957,40.92020893096924,0.12483025631704077,0.5773780287321871,-0.8582003611555815,2.9956311846453305,40.70875024795532,0.48567512512207,0.014222622517902172,39.800832748413086,41.292916774749756,0.6668501287597755,-0.01794325402279528,1.026770039685368,1.0207959115912149,1.020937591994654,0.010709449056552023,52.253039373884,41.750506103240745,40.59575004577637,39.440993988311995,41.0152382169451,0.43615916681252953,40.678392955235076,0.6167966123183637,40.817497801566,40.69954554480871,0.41791593276147637,2.7321277241594877,21300000,0.38125720796052814,0.887807958385565,-141859800.0,-13.723206091858586,19.18618833600314,16.367993510430818,158.38848012731344,23.41083508657893,20.69721242369284,0.03548503087651064,0.9629556777030174,41.4341071472168,41.026280242919924,40.6966667175293,40.36705319213867,39.959226287841794,0.08,0.0,46.04761630297871,0.02255456474385431,0.008137314841425512,39.717223576136995,39.40598242623465,0.6004642359979634
2022-07-07,0,41.68000030517578,39.72999954223633,41.68249988555908,40.08104133605957,40.92020893096924,0.03757138072097772,0.5657498672963586,-1.0157241667536059,2.995635147949004,40.70875024795532,0.4804626703262329,0.013938173114448442,39.800832748413086,41.292916774749756,0.7414818430463723,0.022925279146626204,1.0268549640851912,1.0168499146334766,1.0186724050841516,0.02255023954610902,65.15847591882472,41.72145816392926,40.58995842933655,39.45845869474383,41.07154778071812,0.49797932472709455,40.812321594783235,0.6161280687369389,41.03162007262554,40.76863903885629,0.7878593380298199,4.914423271631509,17487300,0.3280827206139089,0.7778823121217581,-159347100.0,-11.552333644109462,19.18618833600314,16.367993510430818,131.1127965301983,22.563672791738195,20.410215368711672,-0.031172429356988565,0.927744081204573,41.43961408996582,41.03519402313233,40.70833396911621,40.381473915100095,39.9770538482666,0.08,0.0,46.028869647941306,0.027887202093936025,0.024107392342779404,39.77251543317522,39.542827878679546,0.6418649663423668
2022-07-08,0,41.91499996185303,39.72999954223633,41.68249988555908,40.08104133605957,41.09645891189575,0.08112520313251198,0.6132359594832567,-1.1229378868878068,2.9956184465361986,40.70875024795532,0.5223877000808713,0.015090751633488783,39.800832748413086,41.38900079727173,0.7858794279586446,0.019673404179021796,1.031460801279521,1.0197779845509065,1.0198338144999413,0.03833528568720501,64.75742295537351,41.86301371469711,40.636541795730594,39.41006987676408,41.16785730634417,0.5924139564537799,40.95529774257115,0.6236684000165978,41.19318342026632,40.85908036864401,0.954726874436348,4.710465982217358,14751000,0.32773311463210064,0.6677059540848612,-144596100.0,-14.004702142455047,19.18618833600314,16.367993510430818,143.09813769056146,24.557675945920227,19.61856203407237,-0.020903116508554313,0.8962381521439478,41.523654556274415,41.10317440032959,40.76333427429199,40.42349414825439,40.00301399230957,0.1,0.0,46.01405505587423,0.03141944229750582,0.028543182100612324,39.91212463378906,39.65294810703823,0.6875079807515128
2022-07-11,1,41.78499984741211,39.72999954223633,41.91499996185303,40.08104133605957,41.25208330154419,0.17057550870851962,0.6724718675095103,-1.1381605074771248,2.995595814215944,40.70875024795532,0.5691501903533933,0.016527320140950437,39.800832748413086,41.68025026321411,0.8008539777653644,0.02993690541182783,1.0269486396886016,1.0140554447602288,1.009072023058277,0.026133233258908373,68.36284296920394,42.03344385327464,40.68850011825562,39.343556383236596,41.314166750226704,0.601536551099194,41.09970249448504,0.5569282302643981,41.372346461612125,40.97951605145282,1.6347067353483298,5.015031002936909,11532900,0.3260455673024326,0.5320904095558416,-156129000.0,-13.826060862330008,19.18618833600314,16.367993510430818,114.4781745883599,23.412274043632323,20.149131771616183,0.022957659997908993,0.8729350834370776,41.543320922851564,41.135007247924804,40.80500030517578,40.47499336242676,40.0666796875,0.1,0.0,46.002309791606706,0.022996025373567708,0.031830746549319784,40.07477133614676,39.81789888654436,0.721395754922972
2022-07-12,1,41.83583354949951,39.72999954223633,41.91499996185303,40.08104133605957,41.30354189872742,0.0948286839738542,0.7137012628777232,-1.317780506080475,2.995578919431567,40.7408332824707,0.6203335285186767,0.017517186304033122,39.800832748413086,41.69274988174438,0.8409730941644338,0.03699873727548014,1.0268247074639953,1.014234806413578,1.005133483945236,0.01918468665404438,67.61817584180832,42.17031925282149,40.74291672706604,39.315514201310584,41.52392864227295,0.45442928779667124,41.2220835004534,0.5121208781669829,41.47296862776467,41.081837233515245,2.5126230579694844,5.084248119978865,13732200,0.31084317734693284,0.6508335187651026,-142396800.0,-28.45310373497766,19.18618833600314,16.367993510430818,106.21566238045543,24.059016461590613,18.81705827864546,-0.02272557482203356,0.8679634624831274,41.80712022399902,41.454773475646974,41.170000076293945,40.88522667694092,40.53287992858887,0.12000000000000001,0.0,45.98860240737176,0.006599659465148955,0.019897244188278457,40.235574449811665,39.88470894949777,0.7450312838173663
2022-07-13,1,41.68166637420654,39.72999954223633,41.91499996185303,40.08104133605957,41.43750071525574,-0.05857528236801843,0.7436949465625171,-1.3868918661157563,2.995566235775299,40.819167137145996,0.6507501602172852,0.018218886456945773,39.800832748413086,41.79008321762085,0.8364273782355979,0.0470301140385075,1.0211089244562008,1.0091517199627578,0.9976543533395364,-1.999667377983183e-05,70.33878220001733,42.30738996941897,40.820000076293944,39.33261018316892,41.66119057791574,0.2849176175356674,41.30273825781686,0.486848792587474,41.56092802583733,41.17887918006206,3.637414338820147,4.270257602000785,12689100,0.2951936157078104,0.6193138599241104,-155085900.0,-24.30936344625151,19.18618833600314,16.367993510430818,84.63277377865906,22.37357272926095,19.724107759002436,0.023763378841592825,0.8666802337513643,41.80712022399902,41.454773475646974,41.170000076293945,40.88522667694092,40.53287992858887,0.12000000000000001,0.0,45.97561540821025,0.0019180231317823537,0.009014169025569051,40.361821855817524,39.992526463099885,0.7322642118470452
2022-07-14,0,42.03666687011719,39.72999954223633,41.91499996185303,40.30625009536743,41.68041682243347,-0.2524753709794166,0.738579279270781,-1.3065267013359558,2.995569011798388,40.96291732788086,0.6449167728424072,0.01805541398710055,39.800832748413086,41.79008321762085,0.8259059596874123,0.04912325332134548,1.0276343302335404,1.0166615299995536,1.0061553360485604,0.008557259172983223,67.63259100456183,42.383408606225274,40.90625004768371,39.42909148914215,41.802380970546174,0.13718273335246867,41.385535853249685,0.5071132941147729,41.58889314391014,41.24577283152687,2.3595626190546226,2.784456222086168,20905500,0.29140475108254255,1.0219225371424885,-134180400.0,-5.931240454776853,19.18618833600314,16.367993510430818,125.82957019617731,24.808511483056215,17.553320483241937,0.041091756322239825,0.9042987354315728,42.11017417907715,41.69991397857666,41.36833381652832,41.03675365447998,40.62649345397949,0.14,0.0,45.95692473265472,0.019948830229293835,0.02149770082033959,40.52631269182478,40.08928516932896,0.7690328105709451
2022-07-15,0,43.01583385467529,39.763333320617676,42.03666687011719,40.50624990463257,41.68187475204468,-0.34504159063646883,0.7258866395024305,-1.168427124569974,2.9955753791272146,41.1445837020874,0.6310917520523069,0.017695236972576762,39.90250043869018,41.843750190734866,0.7891124017184189,0.05606500577751028,1.0486146626878656,1.0371425694185163,1.027836973403435,0.026263483092547668,71.63975731841813,42.47335669308262,41.02158341407776,39.5698101350729,41.99285725184849,0.4685158384502818,41.5040477343968,0.668151173530279,41.698948013100875,41.345711560215044,2.4077292527457526,2.8357074696722124,21184200,0.29666292602197425,1.047657480957482,-112996200.0,-11.560630549779608,19.18618833600314,16.367993510430818,186.7805094610338,28.367055872306175,16.4131108236515,0.025837253755606002,0.8980391650307371,42.60677243041992,42.10161256408691,41.69333267211914,41.28505278015137,40.77989291381836,0.16,0.0,45.94217474309094,0.029266385166250464,0.029923245343940648,40.707850864955354,40.212537220546174,0.8182812048100404
2022-07-18,0,42.99833297729492,39.763333320617676,43.01583385467529,40.678749561309814,41.70812487602234,0.09892087684739338,0.7911925617804073,-0.2926695882331307,2.9955478087335603,41.263333320617676,0.651245827674866,0.01921203821088376,40.10158290863037,41.927166652679446,0.6863489467597702,0.07773091494145919,1.044101848360615,1.0301428172305485,1.0220420925560745,0.02903752864218223,79.40860722748528,42.764510262797266,41.18212513923645,39.59974001567563,42.181190490722656,0.5747258257348278,41.62636913572039,0.7735698168120597,42.02758685745545,41.56855597960546,3.1987859959861598,4.011847268188947,14243700,0.35353240946871417,0.7343103206952896,-127239900.0,-14.697462732509564,19.18618833600314,16.367993510430818,164.0164693580894,26.88665954290279,15.509713673044239,-0.019452917713507614,0.88246481229882,42.6144140625,42.10779388427734,41.698333740234375,41.28887359619141,40.78225341796875,0.18,0.0,45.93231830152567,0.026464784189689894,0.026874112647891232,40.86681147984096,40.31966345650809,0.858764620509548
2022-07-19,0,43.125834465026855,39.763333320617676,43.01583385467529,40.75083351135254,41.79770827293396,0.22718339093438775,0.8286323706210367,-0.248963969365402,2.995531619082642,41.321250438690186,0.662375020980835,0.02004608214308894,40.34300022125244,42.13283348083496,0.7052387999881391,0.08135634984604943,1.043290186125921,1.0275905448557736,1.019193981583857,0.03083483239316931,79.88336426239533,42.99363983470216,41.336375093460084,39.67911035221801,42.35416684831892,0.6575089032499819,41.76101207733154,0.8604689988947288,42.270694088210405,41.75747771626743,3.1629862343245505,4.147910988374718,16995300,0.3485555619957986,0.9233961470692266,-110244600.0,-7.108526450024185,19.18618833600314,16.367993510430818,154.93945078568024,25.864581047913653,14.920122214746403,0.07657677610551335,0.8518121253665549,42.6144140625,42.10779388427734,41.698333740234375,41.28887359619141,40.78225341796875,0.18,0.0,45.92099880270955,0.03589989947581773,0.03276203086370227,41.05848639351981,40.48530551365444,0.8224482946790885
2022-07-20,0,43.49666690826416,40.12249946594238,43.125834465026855,40.84833383560181,41.85562515258789,0.44072993278735045,0.8335171215666207,-0.48633031532333826,2.995531179929838,41.51833391189575,0.6711666584014893,0.02008257221603845,40.533999824523924,43.00008306503296,0.7378543119190567,0.07485413518751059,1.0479988133901417,1.0313213802916725,1.0217280662745305,0.04354433716164419,80.14738763059314,43.17153439381378,41.50450015068054,39.837465907547305,42.59869071415493,0.725341254448316,41.956428732190815,0.9241546363676402,42.487757118703584,41.95423872134226,2.8887856478010554,4.570715556703765,18564900,0.3457751148514053,1.0235573841668906,-91679700.0,-5.866949929601812,19.18618833600314,16.367993510430818,169.31132483605742,28.381979071723002,14.149208865952422,0.04270404553043909,0.8340634362157767,42.87162696838379,42.31585353851318,41.86666679382324,41.4174800491333,40.8617066192627,0.19999999999999998,0.0,45.9103599379982,0.04203554078397653,0.04453504965213697,41.2976188659668,40.68619510105678,0.9026491027074163
2022-07-21,0,43.85750102996826,40.36750030517578,43.49666690826416,41.00562572479248,41.94541668891907,0.575681561057575,0.877056669772751,-0.5931344252954696,2.995511660925156,41.68083333969116,0.6848041248321536,0.02104605574809465,40.703999519348145,43.02683391571045,0.763399559424173,0.07260137238796946,1.0524147908116255,1.0354230601881165,1.021493913404954,0.04331537905888205,81.865024627906,43.42732186234214,41.67320852279663,39.919095183251116,42.88750035422189,0.7719558399060903,42.20571449824742,0.9332399364142336,42.74389108237761,42.17016342694197,4.096367277976813,6.71191660471186,18764700,0.3435714676249902,1.0387835326512074,-72915000.0,-0.08773796664752627,19.18618833600314,16.367993510430818,179.93331969985547,30.30556383605087,13.306510093385421,0.14611035815831483,0.8235351387058197,43.28986767578125,42.73506723022461,42.28666687011719,41.83826651000977,41.28346606445312,0.2,0.0,45.90174027819526,0.037005182065351416,0.05727053986651805,41.64226531982422,40.93891988481794,0.9850994264640925
2022-07-22,0,44.114166259765625,40.36750030517578,43.85750102996826,41.19270849227905,42.27708339691162,0.591965150036571,0.9579551666076225,-0.6388537823001785,2.9954712792019276,41.68208312988281,0.7576625967025749,0.02289652150173015,40.75683364868164,43.16291770935059,0.7895898603010046,0.0729007511950937,1.054392722651646,1.0361559293685274,1.0188303550067863,0.025533211998189698,83.49380379287295,43.75436891895437,41.83845858573913,39.922548252523896,43.23500033787319,0.6807930300503691,42.44809545789446,0.958244117490769,43.024049206439614,42.40335284892954,4.8323824552861945,8.64557056644155,13616400,0.3445965376318021,0.763127497843679,-59298600.0,-10.016981557329272,19.18618833600314,16.367993510430818,156.23304255294767,30.817247165243998,12.468000797023622,0.10628956721743613,0.8161398064391854,43.53663989257812,42.963346618652345,42.5,42.036653381347655,41.46336010742188,0.2,0.0,45.895965576922414,0.024327927096766677,0.0343451668401486,41.957423073904856,41.15962246486119,1.075580494268074
2022-07-25,0,44.04750061035156,40.36750030517578,44.114166259765625,41.27458333969116,43.002708196640015,0.5288575332217479,1.0508369715169337,-0.7732103646612591,2.9954205883197043,41.733749866485596,0.8642959260940544,0.02501975402263509,40.75683364868164,43.53275032043457,0.8315029343080834,0.06667603814810949,1.0487427264687803,1.0292734597228639,1.012155756248486,0.024400193226343125,84.2489698957455,44.1019658150584,42.00029187202453,39.89861792899067,43.52226230076381,0.4877486449934918,42.662321635655,0.9564870952226091,43.296540285961704,42.62507977632464,5.835898842720842,8.333163149354148,20535300,0.3371439180433682,1.1885670032921696,-79833900.0,-14.45142598460842,19.18618833600314,16.367993510430818,127.29955249481651,29.661688361056733,12.00048635569924,0.14816901060590645,0.7873677661290482,43.717573165893555,43.25621318817139,42.88333320617676,42.51045322418213,42.04909324645996,0.2,0.0,45.88698002489471,0.025238893058335377,0.02285598143898793,42.15094157627651,41.33862713405064,1.1377900242422394
2022-07-26,1,40.4883337020874,40.36750030517578,44.114166259765625,41.27458333969116,43.043334007263184,0.37436126303850814,1.1291578496326413,-1.0585020723197835,2.9953743071892336,41.81041669845581,0.9712001419067391,0.026798678317299932,40.75683364868164,43.87650098800659,0.8639531031273524,0.06689140140611051,0.960923072747302,0.9411295281197081,0.9259061604460953,-0.06115825457425872,82.80552760514269,44.39314922587661,42.13483352661133,39.87651782734605,43.161190850394114,1.2558554368180201,42.577024051121306,1.0939551286540525,43.48114666974804,42.77284318533374,4.783523266598062,7.306426808345595,95391600,0.3370046352645998,4.5311325480103655,-175225500.0,-85.59641069271537,19.18618833600314,16.367993510430818,-105.90142099170332,21.347237287338146,35.355082726073185,0.20863337347149147,1.0158905815985837,43.414706619262695,42.7659800491333,42.24166679382324,41.71735353851318,41.06862696838379,0.02,1.0,45.770285051737396,-0.058505708680034574,-0.052729746478567936,41.82426507132394,41.26605796813965,1.1728687861701173
2022-07-27,1,41.30250072479248,40.36750030517578,44.114166259765625,41.19270849227905,43.043334007263184,0.3174522475864253,1.1717147496249636,-1.1081324638552486,2.9953459261791213,41.81041669845581,0.9991126298904419,0.027835037499951833,40.69758291244507,43.87650098800659,0.6624755996534395,-0.01824646886325521,0.9811745195529566,0.9630709243845419,0.9560579550296225,-0.05044446711512962,35.58616300301004,44.4383880430274,42.094958543777466,39.75152904452753,42.91892910003662,1.4422441006689841,42.55005979537964,1.1220575475077674,42.73033295689636,42.43564828472521,-5.8757437113198785,-2.8649101823314562,42159600,0.8942836694921515,1.8829222999113686,-133065900.0,-51.01275505604859,19.18618833600314,16.367993510430818,-36.89848117504128,27.64067204620319,30.881085684434197,0.31711682450522555,1.0799940389865315,43.414706619262695,42.7659800491333,42.24166679382324,41.71735353851318,41.06862696838379,0.02,0.0,45.73054010626415,-0.031001106422528846,-0.02292363583781046,41.72382027762277,41.29531587873186,1.1311319892567822
2022-07-28,0,42.733333587646484,40.36750030517578,44.114166259765625,41.238959074020386,43.043334007263184,0.31523657566091934,1.1695421834839859,-1.1010855723594337,2.995347403835792,41.81041669845581,0.9969542694091793,0.02778139149133302,40.69758291244507,43.87650098800659,0.6695784666883967,0.01328890836753014,1.0150907653382588,0.9973161114435611,0.9993296179450308,-0.02563227306438698,44.331577786899345,44.43712628286152,42.09804191589355,39.758957548925586,42.86285754612514,1.44048811203808,42.608512197222026,1.1076525956268568,42.370653420659686,42.25689691736385,-3.9439488349418523,-0.9057091593553162,33262200,0.9073370924361968,1.4400436400475365,-99803700.0,-27.306826191434872,19.18618833600314,16.367993510430818,47.6601419980425,33.18005713829477,28.056728868280597,0.3619367589373135,1.103804153997023,43.414706619262695,42.7659800491333,42.24166679382324,41.71735353851318,41.06862696838379,0.02,0.0,45.70977765396581,-0.021124120739191676,-0.006812542545572142,41.73257500784738,41.395530700683594,1.0915057320559785
2022-07-29,0,43.3866662979126,40.36750030517578,44.114166259765625,41.585625410079956,43.043334007263184,0.17383583837118283,1.1352865365121845,-1.0583926650612887,2.9953708232687832,41.87541675567627,0.9815834426879888,0.02690464957766226,40.69758291244507,43.87650098800659,0.5891025470477118,0.058607376344464016,1.0282012650960206,1.010920030789561,1.0199707545508294,-0.016491300267790443,55.75417295361132,44.467239981288536,42.19666690826416,39.92609383523979,42.84714317321777,1.4330020188309311,42.72291694368635,1.0987313843256483,42.461133969921804,42.30516501622332,-0.910129351117071,1.9523646106124897,30141900,0.952983608507481,1.2746692581334336,-69661800.0,-10.052515768896116,19.18618833600314,16.367993510430818,81.93413884488488,33.89856847582179,25.535673976463034,0.3883747998743925,1.1261516764910442,43.414706619262695,42.7659800491333,42.24166679382324,41.71735353851318,41.06862696838379,0.02,0.0,45.69554917221782,-0.0012102071057263908,-0.0037721962855533403,41.79754202706473,41.54758044651577,1.064667874748405
2022-08-01,0,44.069167137145996,40.4883337020874,44.114166259765625,41.68124985694885,43.19104242324829,0.08815364149818566,1.0814802430151342,-1.144570147711454,2.9954063538345927,41.97583341598511,0.9647209119796756,0.025538155627516917,41.015583992004395,43.87650098800659,0.5387732198779341,0.06546608426898612,1.040652620325066,1.025936010036644,1.039571459956952,0.0004918900390307179,59.148914355995245,44.51058569393127,42.347625207901004,40.18466472187074,42.87738118852888,1.4598566095436039,42.882440771375386,1.1219125574889526,42.69440207659983,42.44758943401114,-0.25289434379778397,3.8331134530318423,24996300,0.959109503220853,1.0404889190259083,-44665500.0,-11.926573644011878,19.18618833600314,16.367993510430818,111.53534008582922,35.75452201604939,23.786351420995352,0.3555024899936943,1.1226168243219474,43.628625686645506,42.93901929473877,42.38166618347168,41.82431307220459,41.13470668029785,0.02,1.0,45.687247674664725,0.003938653968321049,0.002496007425847977,41.797080993652344,41.71967315673828,1.05214667073667
2022-08-02,0,44.244998931884766,40.4883337020874,44.114166259765625,41.68229150772095,43.41416645050049,-0.0033243350377041587,1.0758409813578245,-1.1827442546874036,2.995412032007897,42.385000228881836,0.9694583892822266,0.025304949323419985,41.277084064483645,44.049667263031004,0.5080268992185669,0.07359209770816605,1.0406904693043395,1.0274680059088246,1.0436125726324121,0.09278389319350255,62.44609842151802,44.6667238862386,42.51504192352295,40.3633599608073,42.89607157026018,1.479041558436398,43.06553595406668,1.120038219519455,43.04041745554528,42.658681167983666,0.4826223615273949,5.338326975137327,19695000,0.9660072273719781,0.8173062259064288,-24970500.0,-10.938601655800024,19.18618833600314,16.367993510430818,101.82256071691744,33.96260046132789,22.59424274729166,0.32781282125804145,1.097429834745084,43.628625686645506,42.93901929473877,42.38166618347168,41.82431307220459,41.13470668029785,0.02,0.0,45.68078092709697,0.08771933907174145,0.004999109045725709,41.81873648507254,41.8880797794887,1.0598932766954443
2022-08-03,1,43.78833293914795,40.4883337020874,44.244998931884766,41.75937485694885,43.586875438690186,-0.12147143759968515,1.0834957896275108,-1.1358761561162372,2.9954095624969788,42.8658332824707,0.9666375255584718,0.025389547959140196,41.64225034713745,44.07366704940796,0.546634756378027,0.061476616166523695,1.026091646919554,1.0142272717820624,1.0148560653396974,0.06018599771764688,62.557947068488744,44.84186674328701,42.67487516403198,40.507883584776955,42.8590476172311,1.4483398366089262,43.190654958997456,1.0937940372006256,43.34268704971309,42.87060215758445,0.2965774562047356,6.1497842592600005,32003100,0.9595411660083906,1.299216769964693,-56973600.0,-26.323198402833807,19.18618833600314,16.367993510430818,61.50217318276822,31.682618411263682,24.434049880898556,0.28971461206231597,1.0923751648837356,43.628625686645506,42.93901929473877,42.38166618347168,41.82431307220459,41.13470668029785,0.02,0.0,45.66689434828075,0.0308870731301234,0.06984758437952965,41.74870082310268,41.949821199689595,1.0369611802783305
2022-08-04,1,42.697500228881836,40.4883337020874,44.244998931884766,41.82312512397766,43.80562496185303,-0.3209730004096302,1.0842627772817235,-1.052617035588297,2.995410150435185,43.00708341598511,0.9563166427612302,0.025344987127496953,41.64225034713745,44.07366704940796,0.5688558130861764,0.050583796030115605,0.9980676422281435,0.9882937072613869,0.9783019726502431,-0.0008385341314679495,58.429502418408745,44.94869237127487,42.78016681671143,40.611641262147984,43.174642835344585,1.0242672497289727,43.16791684286935,1.1009929437338193,43.451416637240456,43.07965229711694,-0.5883822410180216,4.166995624184413,53106000,0.9682825957815012,2.010559355058172,-110079600.0,-61.115028109511194,19.18618833600314,16.367993510430818,-35.03807651646489,28.077568466566852,31.077053611289763,0.1552313504658976,1.1445864091281832,43.628625686645506,42.93901929473877,42.38166618347168,41.82431307220459,41.13470668029785,0.02,0.0,45.629453772437685,-0.03221582421785585,-0.008057582644855886,41.91411263602121,41.869188853672576,1.032558933240764
2022-08-05,1,42.00166702270508,40.4883337020874,44.244998931884766,41.89520835876465,43.80562496185303,-0.43660841556191343,1.0549222130298355,-0.8156390625335277,2.9954278033007906,43.00708341598511,0.9003541469573975,0.02462985181724417,41.64374980926514,44.07366704940796,0.5498210733296329,0.018668740731026232,0.9806361284926317,0.9748050056989164,0.9625168183335344,-0.031922233104924036,49.55380523453854,44.9408862389564,42.83104181289673,40.721197386837055,43.27452373504639,0.8262226505067385,43.096726417541504,1.144177161185634,43.261439979561814,43.08928354992705,5.4563038900278045,-0.740038253980884,32007000,1.0039466300863524,1.1734343439342771,-142086600.0,-53.98730246415543,19.18618833600314,16.367993510430818,-62.87053423720954,27.053344981238382,30.396694583389653,0.21080254999035372,1.1030680685312335,43.628625686645506,42.93901929473877,42.38166618347168,41.82431307220459,41.13470668029785,0.02,0.0,45.60486166062576,-0.04142386323208702,-0.0244317796996808,41.91365051269531,41.81873539515904,1.0147678162952627
2022-08-08,1,42.4233341217041,40.4883337020874,44.244998931884766,41.96020865440369,43.80562496185303,-0.4449466469707593,1.0513223059948207,-0.7877865718819832,2.9954299217827627,43.00708341598511,0.8955874586105346,0.02454331967263316,41.64374980926514,44.07366704940796,0.5148703656280683,0.005185286013741309,0.990380823264906,0.9894424387698707,0.9783904075458919,-0.037346587702008494,45.21396661655572,44.93801977792898,42.83537516593933,40.732730553949686,43.23023809705462,0.8673495707570819,43.046547821589876,1.1581217325116733,42.94499564626877,42.958682343517026,1.6927941060307568,-2.31791766233386,18175200,1.0168917450310635,0.6583199497545318,-123911400.0,-46.71840335068927,19.18618833600314,16.367993510430818,-33.9042483905066,29.20125341372194,29.28701262110372,0.2171064378913827,1.0630870068814884,43.628625686645506,42.93901929473877,42.38166618347168,41.82431307220459,41.13470668029785,0.02,0.0,45.59274291954572,-0.03719644020566204,-0.033623759978303094,41.81504767281668,41.77381134033203,0.9868514854306444
2022-08-09,1,42.7450008392334,40.4883337020874,44.244998931884766,42.02791690826416,43.80562496185303,-0.518459222309326,1.028389221105556,-0.5783014494485852,2.9954432506313324,43.00708341598511,0.8604790735244748,0.02399006739200289,41.64374980926514,44.07366704940796,0.5015527265381885,0.014042999083775114,0.9971472179590011,1.000735535801276,0.993349801273889,-0.03390209354419049,48.223468103266185,44.924070321865045,42.86729187965393,40.81051343744282,43.13857160295759,0.8818482351222019,42.99285738808768,1.1530615911360165,42.813603814275794,42.89181591483422,-0.7254277630987316,-1.628954783222689,19325100,1.021011657654753,0.6929513496883348,-104586300.0,-37.82633240536815,19.18618833600314,16.367993510430818,-15.300969862866008,29.77056315514029,28.094391088667667,0.2631090468994792,1.029057115990436,43.628625686645506,42.93901929473877,42.38166618347168,41.82431307220459,41.13470668029785,0.02,0.0,45.581160690230654,-0.02871575032603879,-0.027689787922759935,41.668526785714285,41.73303440638951,0.9421678422458486
2022-08-10,1,43.13999843597412,40.4883337020874,44.244998931884766,42.32666730880737,43.80562496185303,-0.6430272779887645,1.0015340072960064,-0.2597818858560501,2.9954584909797113,43.00708341598511,0.8104748725891113,0.023338844553146706,41.64374980926514,44.07366704940796,0.4654311537823475,0.025510843436069252,1.005295586755466,1.0046751690356166,1.0095675225848482,-0.014806101526514182,50.78863685084594,44.915818258732635,42.912750244140625,40.909682229548615,43.005833217075896,0.7827936608417885,42.94160720280239,1.1273329024408527,42.795837925129874,42.863775601956704,-1.4789462141968506,-1.7281003866711193,25251000,1.02199984359643,0.8854966650535485,-79335300.0,-35.92097516299963,19.18618833600314,16.367993510430818,4.240359231436496,31.336518667730996,26.914099571006666,0.24754489592065687,0.9974576727647277,43.628625686645506,42.93901929473877,42.38166618347168,41.82431307220459,41.13470668029785,0.02,0.0,45.5677357063956,-0.010421552279100577,-0.026680804671781664,41.51186915806362,41.65447507585798,0.8978407259482064
2022-08-11,1,43.20750141143799,40.4883337020874,44.244998931884766,42.6289587020874,43.80562496185303,-0.8489887130520236,0.9615390002794658,0.3141661003550542,2.995480436599559,43.070834159851074,0.7456997680664059,0.02236882828168687,41.93175039291382,44.07366704940796,0.435970125816257,0.02624688511260783,1.0051606635532113,1.0019595449598604,1.0142248812810186,0.01194452086942488,52.956472692541794,44.908744847787936,42.985666847229005,41.062588846670074,42.857619285583496,0.5813722700308535,42.87684542792184,1.079833352931912,42.88284814525382,42.90120736470419,-2.1084326333652825,-1.6359860392042493,23854500,1.0226546107192707,0.8322212977063284,-55480800.0,-31.12204640148991,19.18618833600314,16.367993510430818,11.926311335784062,30.513706439413653,25.74279156694015,0.23427972339563835,0.9683534910969747,43.628625686645506,42.93901929473877,42.38166618347168,41.82431307220459,41.13470668029785,0.02,0.0,45.55580581381769,0.038348492419358005,-0.000878039434375117,41.40614482334682,41.612440654209685,0.8933487208366409
2022-08-12,1,43.739999771118164,40.4883337020874,44.244998931884766,42.72437524795532,43.80562496185303,-1.0515844569137534,0.9373156331335448,0.857184398417544,2.995493299997197,43.13291645050049,0.6992040109634402,0.021775650294875836,41.93175039291382,44.07366704940796,0.459116548531638,0.004455744305927558,1.0161645717244905,1.0131938275692496,1.024272001030795,0.04138723226088592,51.67677152153559,44.91883984056213,43.04420857429504,41.169577308027954,42.85071454729353,0.5686234821347216,42.85488108226231,1.0570775650406634,42.966010324222594,42.95422779950733,-2.3448921810214216,-2.055269146397903,26625000,0.9994354282398534,0.9201439468006465,-28855800.0,-14.184864556656354,19.18618833600314,16.367993510430818,70.6386276264269,34.3103278835482,23.836655932836646,0.2621619766205779,0.971089982122484,43.628625686645506,42.93901929473877,42.38166618347168,41.82431307220459,41.13470668029785,0.02,0.0,45.54641379923711,0.04910627104349574,0.05754440231537712,41.511927468436106,41.63031414576939,0.9244668745569066
2022-08-15,1,44.09666728973389,40.4883337020874,44.244998931884766,42.72437524795532,43.80562496185303,-1.1066305350468626,0.949429075114801,0.8385772987513285,2.9954873731517755,43.173749923706055,0.7253331756591791,0.022038530360029413,41.93175039291382,44.07366704940796,0.45348399499031566,0.01724873367102106,1.0235896143410261,1.020620338822495,1.0242850646971513,0.03944369773552747,55.73182936675155,44.97927502034679,43.08041687011719,41.18155871988759,43.050595555986675,0.7290693465170824,43.11261919566563,0.8565516784312397,43.168949076853345,43.077225480811826,-0.11037910051737548,-0.6981118905101574,26516100,1.0061595305057358,0.8973509026099087,-2339700.0,-12.348441565309818,19.18618833600314,16.367993510430818,87.65273599105535,34.23984295133539,22.522387143637307,0.27425041123227534,0.9543454923628031,43.70493244934082,43.0625327835083,42.54333305358887,42.02413332366943,41.38173365783691,0.02,0.0,45.53879401417249,0.04362923942222863,0.0521214347877517,41.86244855608259,41.8882805960519,0.9558830867899273
2022-08-16,0,46.4491662979126,40.4883337020874,44.244998931884766,42.72437524795532,43.90500092506409,-1.1358207731488736,0.9745260799558715,0.7542584512999904,2.9954748007014986,43.29708385467529,0.7565163993835455,0.022592292650729776,41.93175039291382,44.09841718673706,0.4656491848139079,0.0225116299023578,1.076824089133022,1.0750006640196197,1.0706067510473918,0.08665727888533192,58.030342198068176,45.08438574565088,43.13533358573913,41.18628142582739,43.685952595302034,1.3424812053479385,43.480238165174214,1.0919937976797827,43.40616250171918,43.248877461750226,3.2769296875736376,8.912032819617998,91773300,1.0085185334408757,2.7569310575726362,89433600.0,-9.86711526183896,19.18618833600314,16.367993510430818,233.47151686510807,44.13638879867065,18.40353147274834,0.21381909303742566,1.0845114141744374,45.7329462890625,44.963526779174806,44.34166717529297,43.71980757141113,42.95038806152344,0.04,0.0,45.55684380633556,0.0861875298106427,0.09691246643441238,42.47972433907645,42.196687425885884,1.2016270401273046
2022-08-17,0,46.60083293914795,40.4883337020874,46.4491662979126,42.72437524795532,44.05291724205017,0.01701874412401353,1.2129136798982478,1.228167877030196,2.995339815158392,43.44166660308838,0.8974331521987914,0.02801089280809163,41.93175039291382,44.127249526977536,0.4100348425670298,0.06787875024712473,1.076194421630865,1.0730369609575299,1.0560696396586762,0.08022333399733883,69.77491544787466,45.72732753717992,43.301500177383424,40.87567281758693,44.282738140651155,1.592837395937397,43.756488118852886,1.3477532495841447,44.16668365445446,43.69236623465942,10.588863705822224,12.460905472560768,41792100,1.1311992064826486,1.2131385094211626,131225700.0,-18.181806359405712,19.18618833600314,16.367993510430818,205.8045985672006,43.8860652394777,16.698030854173076,0.17040932123362382,1.109903677810677,46.18880082702637,45.33226775360107,44.64000129699707,43.94773484039307,43.09120176696777,0.06,0.0,45.56686822809402,0.085083414348889,0.08735678157303275,43.056484767368865,42.43576622009277,1.3924917792772624
2022-08-18,0,46.46000003814697,40.4883337020874,46.60083293914795,42.72437524795532,44.07604217529297,0.3191949910766109,1.410476979257932,0.5957536710778752,2.9952070332856504,43.56333303451538,1.0441248416900635,0.0324570596491881,41.93175039291382,44.46541566848755,0.5638183836882007,0.06255103106091571,1.069109964015698,1.0629106087078763,1.0366177869119164,0.07527624881007289,70.02809911885959,46.277662437443475,43.45670847892761,40.635754520411744,44.81345231192453,1.6138471871257778,43.97601195744106,1.5219229532086342,44.771736579419,44.07444784108994,9.847172326105806,9.050310441073327,19197600,1.1301636376288677,0.5569168362646921,112028100.0,-20.738651326377145,19.18618833600314,16.367993510430818,161.281329415717,42.02213423036888,15.98883130916234,0.1320362225494071,1.0763390276123785,46.18880082702637,45.33226775360107,44.64000129699707,43.94773484039307,43.09120176696777,0.06,0.0,45.570272555063816,0.0712522740188779,0.08158345075437198,43.55436379568918,42.61144529070173,1.5281919756922453
2022-08-19,0,45.993332862854004,40.4883337020874,46.60083293914795,42.72437524795532,44.10104203224182,0.3467624723094163,1.5541779442306731,-0.022042987184883067,2.9950987835225407,43.56333303451538,1.174249792098999,0.03565705103928514,41.93175039291382,46.450249671936035,0.6568849823826561,0.05317642782973478,1.0552116142462815,1.043254049293018,1.011524241900858,0.051516531859328696,68.37542146878532,46.6951893177979,43.58683342933655,40.478477540875204,45.22107151576451,1.4751052387607804,44.1134523664202,1.6150182376957378,45.18726283012726,44.36249053518846,8.691072934788133,7.083590426449146,22918800,1.1315698033426669,0.6560161505206542,89109300.0,-32.38639947305143,19.18618833600314,16.367993510430818,115.22957618358184,39.96563629784368,18.808787641788946,0.10262276785040315,1.0508862861464456,46.18880082702637,45.33226775360107,44.64000129699707,43.94773484039307,43.09120176696777,0.06,0.0,45.57174316996274,0.03630306422860796,0.05546116036986625,43.94493593488421,42.72840254647391,1.595787242412516
2022-08-22,0,45.16083335876465,40.4883337020874,46.60083293914795,42.72437524795532,44.133750200271606,0.28098513154295574,1.637772540678726,-0.43675530793228035,2.995031417716154,43.56333303451538,1.268208122253418,0.037494112966092716,41.93175039291382,46.450249671936035,0.7174640181809782,0.04417576991973872,1.0338831220693727,1.0151790739025646,0.9834676278596165,0.024132573603323326,64.00684019201044,46.956336840848415,43.680791759490965,40.405246678133516,45.50011893681118,1.1874134790016413,44.178869111197336,1.639124586771046,45.381101656691165,44.537470075473045,6.614127330381423,4.366240277970046,18667200,1.138610402595052,0.5357528772695064,70442100.0,-46.30684090301715,19.18618833600314,16.367993510430818,66.39441106803855,37.59876849440803,23.364639559875066,0.08201663587915631,1.0372515746375788,46.18880082702637,45.33226775360107,44.64000129699707,43.94773484039307,43.09120176696777,0.06,0.0,45.569905590617026,0.014856589497705963,0.017773318602021682,44.164746965680806,42.78544589451381,1.6174588867954045
2022-08-23,0,44.731666564941406,40.4883337020874,46.60083293914795,42.72437524795532,44.473957538604736,0.20025823203011597,1.6679336042521542,-0.6197264280442512,2.99500652850968,43.56333303451538,1.3238747596740723,0.038136000613390605,41.93175039291382,46.450249671936035,0.7714230965752209,0.11540360467924993,1.02275465834472,0.9993818773105839,0.969627563704881,-0.036975900104548765,64.38201522173757,47.072325605415934,43.73645839691162,40.40059118840731,45.641785621643066,0.9841847763455718,44.24625008446829,1.6412234209648726,45.31985557215398,44.56250918716123,4.52081671820433,2.069916259439425,16955100,0.7849853076423609,0.5483342202680014,53487000.0,-49.54545484101486,19.18618833600314,16.367993510430818,38.89214998455257,36.03967297681533,25.310286231145707,0.018789479410549363,1.0048289797657266,46.18880082702637,45.33226775360107,44.64000129699707,43.94773484039307,43.09120176696777,0.06,0.0,45.56690739379695,-0.038530473823957245,0.010558031071609592,44.24711881365095,42.87952314104353,1.4523830005630176
2022-08-24,0,44.850833892822266,41.30250072479248,46.60083293914795,42.74208402633667,44.83895826339722,0.36655800305776687,1.5029950389008122,-0.7978990256146501,2.9951496860612874,43.76416635513306,1.2269040060043337,0.03419890923848011,42.3811674118042,46.450249671936035,0.7787361760526702,0.08302562266140255,1.0205287162441528,0.9976163084561941,0.9795039762466614,-0.037552956373351876,58.84598997577721,46.95461511785595,43.948625040054324,40.9426349622527,45.74952370779855,0.8132936693066858,44.40005963189261,1.5848484110390189,45.18126548025951,44.62411936517592,2.2671851829273373,2.1543035837979834,15766500,0.7867091602138371,0.5326259355538326,69253500.0,-44.03408259645714,19.18618833600314,16.367993510430818,42.869813142533076,35.35698553797201,24.263898273912357,-0.030572442576468007,0.9732936847596546,46.18880082702637,45.33226775360107,44.64000129699707,43.94773484039307,43.09120176696777,0.06,0.0,45.56472769618265,-0.03261194339754503,-0.03157057608384121,44.356793539864675,43.10962104797363,1.4035912481393975
2022-08-25,0,45.18083381652832,42.00166702270508,46.60083293914795,43.04124903678894,44.92833375930786,0.4446344059892112,1.384961285520916,-0.9295099510590599,2.995241844226978,43.92875003814697,1.1483331298828119,0.03138648363216732,42.670083618164064,46.450249671936035,0.8330381884600732,0.04955148890579218,1.0239040729118793,1.0011467189203178,0.994311106524751,-0.027532634967033287,57.14759281720454,46.89596426949763,44.12604169845581,41.35611912741398,45.56833335331508,0.771662532224258,44.62714297430856,1.4354860799795752,45.107997154321694,44.62161138121406,1.71025759868242,5.043231225241266,19414500,0.7294246895454566,0.6715713565969705,88668000.0,-42.52017279090269,19.18618833600314,16.367993510430818,55.88511440888285,36.2276197943152,23.628952149416737,-0.04302619569856838,0.9280583783244707,46.30601399230957,45.52199414825439,44.88833427429199,44.25467440032959,43.47065455627441,0.06,0.0,45.56336024401645,-0.02300984066260725,-0.02616114676927575,44.19482748849051,43.33727591378348,1.4093633116284798
2022-08-26,0,44.670833587646484,42.00166702270508,46.60083293914795,43.19062566757202,45.165833473205566,0.27145015397907857,1.364474127819028,-0.9844516249542505,2.995257999252282,44.08291721343994,1.144016609191894,0.03083667686382433,42.670083618164064,46.450249671936035,0.8437094004127788,0.04135297020278424,1.00954648570854,0.9855364014293773,0.9886536786568042,-0.028754151806111516,58.507107450659134,46.97736496553796,44.2484167098999,41.51946845426184,45.29261916024344,0.6806982447745157,44.7876786504473,1.288182837001444,45.130209698372774,44.636921297124445,-2.730581800434329,7.569144320163916,21331800,0.7202985624462713,0.749310818671545,67336200.0,-71.69562121620176,19.18618833600314,16.367993510430818,8.191607101627197,31.585090420777448,29.07993890929043,-0.12759709995678184,0.9884353114823744,46.35321327209473,45.59839298248291,44.988332748413086,44.37827251434326,43.623452224731444,0.06,0.0,45.558612796240524,-0.039555964957936895,-0.053713676711459254,43.82831954956055,43.4424021584647,1.4089113881746729
2022-08-29,0,44.0141658782959,42.00166702270508,46.60083293914795,43.19062566757202,45.165833473205566,0.15061113474727597,1.3525745982087956,-0.9624693032609479,2.995266999884545,44.170833110809326,1.1284707689285276,0.030523459080527487,42.670083618164064,46.450249671936035,0.8632235466523852,0.013652775615841906,0.9932646915954612,0.9690587922687959,0.9798563111171924,-0.02539075112630107,51.601515064203525,47.01777427080419,44.312625074386595,41.607475877969,44.94321428026472,0.6051417040098432,44.878333296094624,1.172870539824858,45.01606990300069,44.58171734731673,-4.141555482541881,5.297790738216742,17381700,0.7182740072550088,0.6188338508172401,49954500.0,-68.66715914309101,19.18618833600314,16.367993510430818,-8.921858473962528,29.10835574415517,28.999083957147587,-0.11499690675077939,0.9959280968226427,46.44603996276855,45.748646354675294,45.18499946594238,44.62135257720947,43.923958969116214,0.02,1.0,45.553784517429726,-0.012558390666594366,-0.030214462981380596,43.541869572230745,43.54811668395996,1.4086167606897448
2022-08-30,0,44.267499923706055,42.00166702270508,46.60083293914795,43.19062566757202,45.165833473205566,0.15628004713805313,1.353122606085561,-0.9644564077691475,2.995266592259477,44.170833110809326,1.1309458255767821,0.030537721122799028,42.670083618164064,46.450249671936035,0.8591784789709404,-0.005217155817863957,0.9990436649228396,0.9748135098258345,0.9905533682602529,-0.01037669009182729,45.12971055109715,47.01612022361521,44.30987501144409,41.60362979927297,44.6966667175293,0.43311273376884324,44.9588691166469,1.0793029804491243,44.762431921533604,44.45030519470562,-5.264386908830973,2.969154320141222,14468100,0.7333763824831667,0.5199399061721234,64422600.0,-72.5212834245403,19.18618833600314,16.367993510430818,-5.435924161232159,27.744054573922632,27.639904327554376,-0.12575960702518194,0.9702664470485973,46.462560791015626,45.7753876953125,45.220001220703125,44.66461474609375,43.977441650390624,0.02,0.0,45.54995813777196,-0.01134323783115787,-0.015530823446226331,43.3317756652832,43.63835580008371,1.4082565797328617
2022-08-31,0,44.25416660308838,42.00166702270508,46.60083293914795,43.19062566757202,45.165833473205566,0.15380521047650053,1.353077550800873,-0.9647011777925201,2.995266635152076,44.18208360671997,1.1299332809448246,0.030535928977840892,42.670083618164064,46.450249671936035,0.8586358051078045,0.01094280033962465,0.9987173961799892,0.9792243278191654,0.9923163419813728,-0.01330337115157576,48.70223096693493,47.017155162636904,44.31100006103516,41.604844959433414,44.56714289528983,0.40588187478382287,45.033630916050505,0.9803727794744823,44.63397999344072,44.39447427179666,-3.7523545951630712,2.6135872244068477,22460700,0.727842229562174,0.821251242944763,41961900.0,-78.83720909601418,19.18618833600314,16.367993510430818,-4.531806817725615,26.796872609521113,26.34494263520818,-0.10744795391997193,0.9452475890398655,46.558533920288085,45.93073403167725,45.4233341217041,44.915934211730956,44.28813432312012,0.02,0.0,45.5442561493669,-0.017929977974590727,-0.010820957105135823,43.238297598702566,43.70152228219168,1.394133525839804
2022-09-01,0,44.54666614532471,42.00166702270508,46.60083293914795,43.19062566757202,45.165833473205566,0.10665728254274115,1.3478793759298917,-0.9434164094975732,2.995270466936407,44.26083326339722,1.1089707660675046,0.030402636940856258,42.670083618164064,46.450249671936035,0.8407458247466754,0.03645802133291092,1.0047902964666209,0.9908415256138653,1.0015550825368107,-0.014036209995124449,51.3460381695766,47.03005049609196,44.334291744232175,41.63853299237239,44.540714263916016,0.39935417221384795,45.09124994277954,0.9203625558592508,44.533621871622294,44.37308619634349,-2.007639558981493,2.4224154543991174,21741900,0.6790140131617595,0.84332512578953,63703800.0,-67.93070525012831,19.18618833600314,16.367993510430818,15.10161769263267,28.351630640392408,24.52229724181533,0.0018252596805779639,0.9429680374266296,46.619106689453126,46.02877978515625,45.551666259765625,45.074552734375,44.484225830078124,0.02,0.0,45.540548814223634,-0.010230430842795402,-0.0036303884338506564,43.2605105808803,43.753814697265625,1.2702433920216158
2022-09-02,0,44.66333293914795,42.00166702270508,46.60083293914795,43.60687518119812,45.165833473205566,0.006955281172664077,1.2948092896896621,-0.7451930540163807,2.995307456386945,44.40708303451538,1.0377499103546142,0.029144812270136492,42.712834167480466,46.450249671936035,0.7855026723984143,0.06059281221490243,1.0053252353341249,0.9976824417253447,1.0070498717769207,-0.00016790930224797052,56.4981117889918,47.01636861943365,44.42675004005432,41.837131460674996,44.51392841339111,0.38095085246260896,45.13172606059483,0.8850404565994621,44.534231458879574,44.427248203519255,-0.41357819599257656,1.8442304033553987,17234400,0.6548665699415456,0.6882052252707693,80938200.0,-80.13191362497358,19.18618833600314,16.367993510430818,0.21377085745332028,27.38737691398008,22.542409573271893,-0.06711017677804096,0.9525177542903871,46.619106689453126,46.02877978515625,45.551666259765625,45.074552734375,44.484225830078124,0.02,0.0,45.53729400708087,0.010637988484975436,-0.02112329673025078,43.16934585571289,43.76306969778879,1.149062723373967
2022-09-06,0,44.14416694641113,42.4233341217041,46.60083293914795,43.945624351501465,45.165833473205566,0.11286460356499316,1.169430256319356,-0.6651027717627027,2.9953881464811194,44.60499954223633,0.9163332939147949,0.026244044664723028,43.10049867630005,46.450249671936035,0.7641761250687453,0.052801102596456394,0.9906717247721243,0.9890237171078295,0.9953776052942147,0.0029536188070609093,56.6396963607008,46.89869384851518,44.55983333587646,42.220972823237744,44.365833146231516,0.2611438239093535,44.967083249773296,0.8340346137698809,44.561415988275414,44.510839334966725,-0.418054554174796,1.2850532347282115,21899700,0.6513457384284753,0.8680452126948001,59038500.0,-85.57290251486882,19.18618833600314,16.367993510430818,-45.71062597416909,25.40417908302352,25.20488109303667,-0.07053128000727937,0.9535284279391494,46.619106689453126,46.02877978515625,45.551666259765625,45.074552734375,44.484225830078124,0.02,0.0,45.531105539236016,-0.004063868024964168,0.0056228383378497575,43.00598961966379,43.60040855407715,1.0444476228985455
2022-09-07,0,44.79249954223633,42.7450008392334,46.60083293914795,44.07604193687439,45.165833473205566,0.3033242613668052,1.067975394439068,-0.5796522973838183,2.9954467920280883,44.60499954223633,0.8302916526794434,0.02392103178595059,43.2007511138916,46.450249671936035,0.7291718234414905,0.03273285950888351,1.003284168250699,1.0058403053803975,1.0094046527260285,0.01185970789936408,49.00324573714411,46.78182576598995,44.645874977111816,42.50992418823368,44.38321399688721,0.2875415526568292,44.83791657856533,0.6889648644973383,44.45396932409491,44.52750858623246,-2.2944837059159098,-4.962412751862567,17058900,0.6644303808559435,0.6792195001920133,76097400.0,-47.60937367208468,19.18618833600314,16.367993510430818,16.285023682419276,28.902249008717213,22.963355496169463,-0.07582587739532964,0.9718477726672374,46.03337355041504,45.55497994232178,45.16833305358887,44.781686164855955,44.3032925567627,0.02,0.0,45.52915893536873,0.02460731969737595,0.021523009339647146,43.197571345738005,43.51294544764927,0.9659717646429872
2022-09-08,0,45.29833221435547,43.13999843597412,46.60083293914795,44.13229203224182,45.165833473205566,0.4533042375182969,0.9749357053326299,-0.4940953403289976,2.9954956688664405,44.66708326339722,0.750233345031738,0.021787124798046616,43.68674993515015,46.450249671936035,0.7016394201372879,0.03830554395394226,1.0122928226952352,1.0170601229963114,1.0183939459917473,0.023594741273338604,55.19746153200349,46.69812132292722,44.74824991226196,42.7983785015967,44.566666330610005,0.4003628341671125,44.75494030543736,0.53025251893317,44.538278748881524,44.644959629989756,0.2723610571339101,-3.8804744097020096,16956000,0.6732290522368704,0.6864584174655814,93053400.0,-31.13210093469043,19.18618833600314,16.367993510430818,44.93655815039843,29.716552997466888,21.817835831623565,-0.050403314885638054,0.9498110534276292,45.689572967529294,45.27687947082519,44.94333267211914,44.60978587341309,44.19709237670899,0.02,0.0,45.528586354761266,0.029272179240457774,0.029815915996851163,43.3618529183524,43.451861245291575,0.8802483676563883
2022-09-09,0,45.56416702270508,43.20750141143799,46.60083293914795,44.22666668891907,45.21020841598511,0.4915786460285917,0.9081076501108782,-0.47468517318181824,2.995527990770494,44.701250076293945,0.715016531944275,0.020244878662613323,43.986749267578126,46.450249671936035,0.6386341483486122,0.048390458476360566,1.0157837924006954,1.022001923778967,1.0195835098989854,0.02284123516810377,59.85487414261194,46.67238190140279,44.85616660118103,43.039951300959274,44.75190448760986,0.5207458212255687,44.72428560256958,0.4610403238011597,44.730968348854915,44.800715564238224,2.9176205215621582,-2.5003612200552987,16140600,0.679646239708396,0.6638124614435533,109194000.0,-9.551262410877683,19.18618833600314,16.367993510430818,59.7837375833221,30.296784245433706,21.039697255354536,-0.06855917806937369,0.9145863180240196,45.28974540710449,44.95345874786377,44.68166542053223,44.40987209320068,44.07358543395996,0.02,0.0,45.52883108265871,0.01754906149452795,0.032365249333077585,43.56361770629883,43.447696685791016,0.8175897401780726
2022-09-12,0,45.864166259765625,43.739999771118164,46.60083293914795,44.264166593551636,45.36479091644287,0.6162750498443443,0.8366201089096338,-0.6894806729166905,2.9955598890761426,44.76208305358887,0.6915499496459958,0.018602306023690597,44.08841714859009,46.450249671936035,0.6190811104070651,0.041704784205129894,1.0197929110232993,1.02784713346539,1.0216442954296172,0.026886334753695174,61.062635040061785,46.64724009956365,44.97399988174438,43.30075966392511,44.98190443856375,0.6118470217277862,44.77452366692679,0.5432577110419154,44.94625519402277,44.97400556545117,2.9291627068025012,-0.9331044597890767,14284500,0.6735030790890679,0.6027730217455289,123478500.0,-2.349773882072068,19.18618833600314,16.367993510430818,79.83124433802416,31.16740941828437,20.239623391690696,-0.08179206284168403,0.8828299503459061,45.48074540710449,45.10795874786377,44.80666542053223,44.505372093200684,44.13258543395996,0.02,0.0,45.52990102320126,0.038120350415529636,0.026695362110682602,43.81906345912388,43.52868052891323,0.8223670836134963
2022-09-13,0,45.40333366394043,44.0141658782959,46.60083293914795,44.476874589920044,45.639166831970215,0.5337989637206958,0.8075487563174942,-0.9220701344457072,2.9955723188278993,44.8216667175293,0.6849790954589843,0.017913598637879544,44.139416980743405,46.450249671936035,0.603671457888163,0.04008237081542959,1.007167789826654,1.014805626940936,1.0059971477081426,0.028523966010228774,62.94651669658704,46.69530571881174,45.080208206176756,43.465110693541774,45.104285512651714,0.5957447715560836,44.822499888283865,0.568264392664756,45.18366265476355,45.144623570727155,3.638074740209634,1.5573957535583791,17687400,0.6724668518128795,0.7605344561142802,105791100.0,-39.556070821897954,19.18618833600314,16.367993510430818,18.441678060950313,28.471607777284024,24.21990192143604,-0.11840558745682866,0.8973896829945934,45.48074540710449,45.10795874786377,44.80666542053223,44.505372093200684,44.13258543395996,0.02,0.0,45.52923192307887,0.021762105717444635,0.016691753689120438,43.85330745152065,43.55690901620047,0.7987041536411601
2022-09-14,0,45.09833240509033,44.0141658782959,46.60083293914795,44.63416624069214,45.639166831970215,0.4499065315041584,0.7776370732244647,-0.9034913190585376,2.995584289274469,45.00583362579346,0.6519583225250244,0.017225113421128903,44.24316663742066,46.450249671936035,0.78500545987243,-0.022515638435025413,0.998954290541166,1.004868540362181,0.993694601964418,0.006827769514528237,50.26413642725697,46.70081567133602,45.145541524887086,43.590267378438156,45.16642829350063,0.5639200871203672,44.84017835344587,0.5730433482936117,45.245837681477155,45.22044758650689,1.9230788580699034,1.5015472272286068,19934700,0.42158809793901325,1.0137348261674144,85856400.0,-43.47260962648336,19.18618833600314,16.367993510430818,-1.5247587321515388,26.62311257604045,24.54441964789136,-0.12415211473873622,0.8911473855437654,45.48074540710449,45.10795874786377,44.80666542053223,44.505372093200684,44.13258543395996,0.02,0.0,45.5274627976075,-0.006041021479447739,0.019495060275538965,43.94215720040457,43.555751528058735,0.7360858508480779
2022-09-15,0,44.72000026702881,44.0141658782959,46.60083293914795,44.63416624069214,45.44354200363159,0.5555880962279472,0.7178419705934074,-0.5006449558076671,2.9956058403230084,44.9745831489563,0.5844166278839111,0.015924441485794524,44.24316663742066,46.0399995803833,0.7174436972005518,-0.03224192443125651,0.992058219872991,0.9945974121172201,0.9840322278225182,-0.012767179696372644,45.91911609671914,46.51368377143278,45.07799983024597,43.64231588905916,45.24869019644601,0.4112877671168909,44.807261671338765,0.5651514666801886,45.20803440426428,45.19019516956005,0.9739520929507268,0.5518258876958696,20189400,0.42213538507576515,1.0863583717054155,65667000.0,-62.40197447937599,19.18618833600314,16.367993510430818,-44.755249013457515,25.05173804330749,26.15518978984916,-0.10663261110983335,0.8793986742245742,45.48074540710449,45.10795874786377,44.80666542053223,44.505372093200684,44.13258543395996,0.02,0.0,45.52400697865439,-0.021696135504258862,-0.016722923044796976,43.99445016043527,43.50021989004953,0.6611011198186287
2022-09-16,0,44.25166606903076,44.0141658782959,46.46000003814697,44.63416624069214,45.32458257675171,0.5576927220272682,0.6300082669131654,-0.29015181350669605,2.9956344478103176,44.8216667175293,0.516770787239075,0.01400517633773327,44.24316663742066,45.877082920074464,0.629875032822621,-0.037451566286902715,0.9837210384108895,0.9831628061645344,0.9762114745976128,-0.028805551367158455,41.98571125088507,46.24397473046635,44.98395819664002,43.72394166281369,45.17142827170236,0.5414651615192195,44.77732113429478,0.5837329535936586,45.084806189799366,45.08263182415974,1.3044380729094047,-1.0199757520431747,41874300,0.42726409683257927,2.123625199116963,23792700.0,-66.05736089676265,19.18618833600314,16.367993510430818,-75.95644996083563,22.87109517605167,28.377197882510966,-0.06286508013804365,0.8944416428883543,45.48074540710449,45.10795874786377,44.80666542053223,44.505372093200684,44.13258543395996,0.02,0.0,45.51468218277037,-0.026673513421222372,-0.023748565961539674,43.87644631522043,43.537008830479216,0.5827243254177337
2022-09-19,0,44.53166675567627,44.0141658782959,45.993332862854004,44.476874589920044,45.21020841598511,0.36411693350678237,0.5500874305008346,-0.7236745061863608,2.995657244279248,44.76208305358887,0.45749996185302705,0.012258614143996052,44.2409161567688,45.594166946411136,0.5645925467085952,-0.03786781008057539,0.9923813737205973,0.9900326149409403,0.9881104347818321,-0.029053171849725556,38.342738747641626,45.97371635918587,44.8735414981842,43.773366637182534,45.06190463474819,0.587129929430674,44.8142854826791,0.5469133766807438,44.87581339366286,44.91066130977044,-1.2074197214549205,-0.9383472054384083,16853100,0.4273412758175042,0.8680442080296059,40645800.0,-52.05834211018251,19.18618833600314,16.367993510430818,-29.04101744822155,22.027077794673186,26.629065144969495,0.016267684861701225,0.8850766911822922,45.49097245788574,45.12451270294189,44.82833290100098,44.53215309906006,44.165693344116214,0.02,0.0,45.51185881883437,-0.027087687444262265,-0.01834260691642691,43.77926526750837,43.57055909293039,0.5496566642345355
2022-09-20,0,44.454166412353516,44.0141658782959,45.864166259765625,44.465625047683716,45.165833473205566,0.3520989427453156,0.4903083658593039,-0.6658877035628206,2.9956724591691293,44.72583341598511,0.4017167091369629,0.010944271233766657,44.2409161567688,45.419416999816896,0.6654662104147889,-0.013931687178803413,0.992270351812445,0.988599003604197,0.9922583553693173,-0.020905232611603264,44.826864269657655,45.78107492454393,44.80045819282532,43.819841461106705,44.903333118983674,0.5787044561662278,44.82761880329677,0.534696718773241,44.78793271971769,44.80141707763643,-1.6924805422223375,1.1757598197164953,13963500,0.3969591171291219,0.7280300565593874,26682300.0,-62.41699988297506,19.18618833600314,16.367993510430818,-52.43492067418134,20.94113001908299,25.316236710358922,0.07805351413518598,0.8644760807753241,45.49097245788574,45.12451270294189,44.82833290100098,44.53215309906006,44.165693344116214,0.02,0.0,45.50907339730862,-0.01235023235718724,-0.03273702909927816,43.62701579502651,43.59531675066267,0.5523353646398801
2022-09-21,0,45.1899995803833,44.0141658782959,45.864166259765625,44.40749979019165,45.11895775794983,0.5354481598584682,0.48852454907463183,-0.5102969200331477,2.995672839167053,44.69541692733765,0.3931500053405756,0.010913061244900978,44.2409161567688,45.419416999816896,0.6926096143040648,-0.006203662279942467,1.0094911995966702,1.0042705727385495,1.01297507430299,0.0020326067595932695,45.17261810423343,45.742173943654024,44.76512484550476,43.78807574735549,44.807023593357634,0.4288437454563482,44.89446401596069,0.5156492547609722,44.70404215924677,44.71200182880442,-2.4361261993408947,0.42167840733986794,24903600,0.38611136360158255,1.2720673699824772,51585900.0,-46.21516426766122,19.18618833600314,16.367993510430818,62.83459250978476,28.26088271788938,22.69136797567928,0.023814269853810445,0.8955848874607684,45.49097245788574,45.12451270294189,44.82833290100098,44.53215309906006,44.165693344116214,0.02,0.0,45.50766659270087,-0.001111716269269758,-0.003328010177541775,43.47430310930525,43.64668328421457,0.5528681865008364
2022-09-22,0,44.62666606903076,44.0141658782959,45.864166259765625,44.40749979019165,45.183125257492065,0.4010689986008497,0.4970925631670171,-0.7375944064358753,2.995670770655486,44.69541692733765,0.41501249313354477,0.011098778748973416,44.2409161567688,45.419416999816896,0.6429220001240842,0.0075620820868464115,0.9963969081510405,0.9908761312655511,0.9999365050499021,-0.0020870795492115013,54.82224795940658,45.78222662261089,44.788041496276854,43.793856369942816,44.696071079799104,0.3401498842545598,44.90017829622541,0.5119284235378888,44.82502526044651,44.760536921642554,-1.4699202762434984,2.1146776656949013,16744500,0.4203886606154063,0.8531722830211608,34841400.0,-64.541833274821,19.18618833600314,16.367993510430818,-34.43270911831974,26.781046362711397,26.332548746925486,-0.0188996530272823,0.8775669212999889,45.49097245788574,45.12451270294189,44.82833290100098,44.53215309906006,44.165693344116214,0.02,0.0,45.50470217273408,-0.0005995271014924697,-0.011339907445714694,43.38961737496512,43.62146241324289,0.5546882127299669
2022-09-23,0,43.739999771118164,44.0141658782959,45.864166259765625,44.40749979019165,45.183125257492065,0.4644171190976365,0.498076646205826,-0.7161179796463708,2.995670510684433,44.66708326339722,0.4176999664306635,0.011123534463388334,44.2409161567688,45.419416999816896,0.6212848218097942,-0.012265549364315398,0.9768444246261062,0.9726394199454066,0.9804793332009745,-0.011562644830466207,46.622343187083175,45.77298639749893,44.77683310508728,43.78067981267562,44.50202356066023,0.44401365561217004,44.834225927080425,0.5971690726797192,44.774070833009446,44.73459413396095,-1.7105959678165692,0.17958678084925755,27195300,0.43262611297558906,1.3587320239787701,7646100.0,-86.3923947487551,19.18618833600314,16.367993510430818,-166.664704790213,23.595869872313447,33.67822432570603,-0.08309806900848354,0.924883648036283,45.33757209777832,44.87621212005615,44.50333213806152,44.130452156066895,43.66909217834473,0.04,0.0,45.494957532671194,-0.023500473689352597,-0.02554911873927612,43.16471426827567,43.55343573434012,0.6174208774987352
2022-09-26,0,43.3725004196167,43.739999771118164,45.864166259765625,44.264166593551636,45.121249198913574,0.3941977033116792,0.5371039731828869,-0.5294573276507921,2.9956602095909783,44.644999504089355,0.42924997329711945,0.012014461008066463,44.13116683959961,45.419416999816896,0.5640645738083836,-0.020837619130208894,0.9701980270706256,0.9683955676876503,0.97447680094138,-0.02603015832349942,39.019434603749914,45.77899934918255,44.704791402816774,43.630583456451,44.309523582458496,0.5988605497944108,44.77910688945225,0.6935897847590848,44.514230859373576,44.59482312314025,-3.011935389918875,-2.067318104736587,23011200,0.46184863955704425,1.1448828123542385,-15365100.0,-69.53908252251838,19.18618833600314,16.367993510430818,-153.27486082009764,21.309570508545608,31.66684962427935,0.001209744363151112,0.9509631869619389,45.298239364624024,44.81254642486572,44.420000076293945,44.02745372772217,43.54176078796387,0.06,0.0,45.486652159325,-0.022482061611326598,-0.014115279587238194,43.06475612095424,43.52960314069475,0.62388161868811
2022-09-27,0,43.90916728973389,43.3725004196167,45.864166259765625,44.253541469573975,45.121249198913574,0.069136743890903,0.6107035385570331,-0.4279099323269415,2.995638715136233,44.586666107177734,0.48352911949157684,0.013680673210971224,43.986749267578126,45.419416999816896,0.6112188372236935,-0.014578612268910789,0.983631059476196,0.9858625427030158,0.991699936101164,-0.01225979849817127,37.243584324785495,45.86128182152935,44.63987474441528,43.41846766730121,44.260595185416086,0.6180592611290824,44.716011728559224,0.7314237863028054,44.22667706433786,44.450550734296996,-3.013192842947264,-1.7480600046914445,17171700,0.44606790370686733,0.8547950524362607,1806600.0,-73.14626776673757,19.18618833600314,16.367993510430818,-103.93377495387182,22.858677259374353,29.202327653884712,-0.04092453472479071,0.9575608998854555,45.298239364624024,44.81254642486572,44.420000076293945,44.02745372772217,43.54176078796387,0.06,0.0,45.48153108687079,-0.01946833205108134,-0.02516191648240053,42.9610971723284,43.418771743774414,0.6569651268808817
2022-09-28,0,43.9908332824707,43.3725004196167,45.864166259765625,44.253541469573975,45.121249198913574,0.06177709373587446,0.6164838523484695,-0.4757330090518064,2.9956369103188676,44.586666107177734,0.48825405597686783,0.013811785243044536,43.892250537872314,45.419416999816896,0.6916788056880918,-0.008094711347822792,0.9855764099018413,0.9910207600633708,0.9959963168305146,-0.026536098894613613,43.58823005622063,45.86759251968412,44.634624814987184,43.401657110290245,44.183333260672434,0.6123029417121764,44.62261894771031,0.7348168524559031,44.14622276993882,44.4079095837992,-0.7739793994707252,-1.972053941016438,16838400,0.45993708585997334,0.8332875575475858,18645000.0,-51.50304163107108,19.18618833600314,16.367993510430818,-75.36727586027003,20.682184441583892,27.82703204995753,-0.002410358091937484,0.9827349524153302,45.298239364624024,44.81254642486572,44.420000076293945,44.02745372772217,43.54176078796387,0.06,0.0,45.47715352023786,-0.012317198666972229,-0.003294674723176869,42.90463965279715,43.34195246015276,0.6512456916133362
2022-09-29,0,44.291666984558105,43.3725004196167,45.864166259765625,44.224791288375854,45.121249198913574,0.0807307723285442,0.6275709694588855,-0.5957231731904602,2.9956333974886573,44.586666107177734,0.5012915134429932,0.014064541407765743,43.892250537872314,45.419416999816896,0.7103043509204391,-0.005950475194335678,0.9926239654782177,1.0002936039839165,1.008282530466035,-0.00750670202328052,44.658240248744754,45.875933421843186,44.62079148292541,43.36564954400764,44.16011905670166,0.6033383046842741,44.53172608784267,0.6865062464408911,44.10585167804878,44.37829630287246,-1.2144918719814783,-2.8864173755836577,15241500,0.4604860247193827,0.7679796112410266,33886500.0,-60.12028919862625,19.18618833600314,16.367993510430818,-52.84812836940277,20.57198758010955,26.12945409621288,-0.00286894626930025,0.9718254415418014,45.298239364624024,44.81254642486572,44.420000076293945,44.02745372772217,43.54176078796387,0.06,0.0,45.47368145519467,-0.00854628945105107,-0.01869835376020058,42.84448078700474,43.235748291015625,0.6549961787180898
2022-09-30,0,43.666666984558105,43.3725004196167,45.864166259765625,44.224791288375854,45.121249198913574,0.07492705578914208,0.626527942438755,-0.5826786203879424,2.995633731404992,44.586666107177734,0.49941649436950686,0.014040576046944421,43.892250537872314,45.419416999816896,0.7355135440974284,-0.005724315259299476,0.9785759213336575,0.987133365942265,0.9955731218668639,-0.0016765612012755726,47.574816160884104,45.87572238687641,44.6226665019989,43.36961061712139,43.94250011444092,0.4154190024591627,44.37476185389927,0.6047747446731402,44.151163600090484,44.374596923549625,-0.3655437519355951,-2.792764844165533,19602300,0.4607815155131928,0.9930620464303355,14284200.0,-85.22730362676188,19.18618833600314,16.367993510430818,-125.02800156147205,19.222879774355974,29.174133380202164,-0.08107928433608509,0.9657425763071054,45.221840530395504,44.750747367858885,44.3700008392334,43.989254310607905,43.518161148071286,0.06,0.0,45.46678575974333,-0.002767747269398435,-0.0276632102478137,42.60986055646624,43.04208183288574,0.7188489439125504
2022-10-03,0,43.797499656677246,43.3725004196167,45.864166259765625,44.105833530426025,45.121249198913574,0.11254362756172581,0.6603099404868797,-0.8176654710733828,2.995622624536554,44.579166412353516,0.5434164524078369,0.01481224073483053,43.73266649246216,45.419416999816896,0.6987781401890913,-0.02231508239539047,0.9824766654580619,0.9914020682230665,0.9988900435579939,0.009798817982564989,40.83877867740928,45.89928642493433,44.57866654396057,43.258046662986814,43.82404776981899,0.28582134843634444,44.26005942480905,0.5439075860354254,44.030443884352266,44.29775839039538,-3.3709506748622866,-4.791320663633817,17574900,0.4791564676322906,0.8895857139060881,31859100.0,-53.59479405604867,19.18618833600314,16.367993510430818,-69.64490856544556,18.82049920286898,26.96212777413939,-0.016356625720572057,0.9703323058919302,45.09450622558594,44.64774658203125,44.28666687011719,43.92558715820312,43.47882751464844,0.06,0.0,45.46190171271804,0.009291055681852622,0.0189914110920496,42.570062909807476,42.9798401423863,0.7219305896304684
2022-10-04,0,44.72333335876465,43.3725004196167,45.864166259765625,43.9704167842865,45.121249198913574,0.21784509707182576,0.6813866117622919,-0.9579234347385297,2.9956153508923493,44.49291658401489,0.5739123106002808,0.015299896174687487,43.73266649246216,45.419416999816896,0.7383305707156432,-0.007853071282435207,1.0042204310491323,1.014044483139665,1.0180319935971056,0.018542052133635245,43.838709899403874,45.89814810336162,44.535374879837036,43.17260165631245,43.96452399662563,0.4384971629795565,44.233273778642925,0.5074625840360444,43.97371952727197,44.26866024275945,-1.8580066256146481,-3.5368196070116884,16134300,0.46768001836565315,0.8287598035854213,47993400.0,-34.85838236760746,19.18618833600314,16.367993510430818,21.885097134524745,23.528852439300163,25.185194000730256,-0.024778329262605918,0.9645942395174334,45.09450622558594,44.64774658203125,44.28666687011719,43.92558715820312,43.47882751464844,0.06,0.0,45.459859238078586,0.025200585614670645,0.02239000928119066,42.76396288190569,42.96433857509068,0.7166328262357096
2022-10-05,0,44.48416614532471,43.3725004196167,45.864166259765625,43.9704167842865,45.121249198913574,0.10490036442170826,0.6764343038959297,-0.9317202491378898,2.9956171271738077,44.579166412353516,0.5637498378753663,0.01517882699721462,43.73266649246216,45.419416999816896,0.7445017066388119,-0.0015441465463757076,0.9982010938036612,1.0080064838774698,1.0088485075394924,0.011214446875471795,52.87502101725054,45.91720180824657,44.56433320045471,43.21146459266286,44.12333338601248,0.38658152730371986,44.21642848423549,0.4937929474608002,44.16572878001453,44.38851451233336,2.2481334997532088,-0.831514218657355,14553900,0.491970990940926,0.7524212554002778,33439500.0,-49.346389747681265,19.18618833600314,16.367993510430818,-11.475939217453764,22.27924218652357,26.01230243552511,-0.0857553892080874,0.9459328487727898,45.09450622558594,44.64774658203125,44.28666687011719,43.92558715820312,43.47882751464844,0.06,0.0,45.45722373677145,-0.0014272745955826727,0.015043966064565097,42.838468824114116,42.95161247253418,0.7013328770379555
2022-10-06,0,44.23500061035156,43.3725004196167,45.864166259765625,43.9704167842865,45.121249198913574,0.17232816763931322,0.6745695202411341,-0.8967799682185937,2.995617720666752,44.50791645050049,0.5548082065582278,0.015142220569554006,43.73266649246216,45.419416999816896,0.7271650773047863,-0.017973422623554003,0.9929534555561664,1.0039661739137065,1.0009579413872733,-0.0012793913181524674,48.80811492098632,45.8980555710914,44.548916530609134,43.19977749012687,44.16988100324358,0.3759670533043163,44.215238094329834,0.49372154816554725,44.249424230754244,44.423683223362616,2.563065801955054,-0.5273571562967487,14200500,0.4793291369584947,0.7394175885629665,19239000.0,-62.85404408098135,19.18618833600314,16.367993510430818,-37.17212850605169,20.65552767674769,26.453693312400407,-0.1454151849299301,0.9474138723023046,45.09450622558594,44.64774658203125,44.28666687011719,43.92558715820312,43.47882751464844,0.06,0.0,45.45401354372725,-0.004310112620881323,-0.010742999360986525,42.87225014822824,42.91667366027832,0.678102621358733
2022-10-07,0,43.29916572570801,43.3725004196167,45.864166259765625,43.9704167842865,44.81708312034607,0.35186824376168047,0.6550292507098278,-0.642721434638684,2.9956240951394473,44.46916627883911,0.5259915828704834,0.014721164413227465,43.73266649246216,45.419416999816896,0.673639062156972,-0.02917130936885511,0.9731078984839105,0.9836006370578284,0.9800330239375952,-0.008416059301710743,45.289918357352555,45.8058084518286,44.495749950408936,43.185691448989274,44.071071352277485,0.5009742058186214,44.127202306474956,0.5406157358636751,44.247016089505436,44.39992294211183,0.7420621722741181,-0.03766063554127385,17080500,0.4756542141882797,0.8872076760955694,2158500.0,-94.77610210373616,19.18618833600314,16.367993510430818,-153.46321662866336,18.817063010515827,32.7532017179813,-0.178807444672566,0.9656939415312292,45.07877223205566,44.62227884674072,44.25333213806152,43.88438542938233,43.427892044067384,0.08,0.0,45.44697240324556,-0.008789433395016588,-0.027901665961285387,42.66169357299805,42.7831666128976,0.7057600949976187
2022-10-10,1,43.08833312988281,43.29916572570801,45.864166259765625,43.88125038146973,44.72083353996277,0.35388859752671387,0.656317514941088,-0.39514625604309517,2.9956231151442316,44.37291669845581,0.5270832061767579,0.014787754557165824,43.63725032806396,45.21133298873902,0.5039839009556994,-0.05592602554966242,0.9708406070182324,0.9797924616283847,0.9768861923643877,-0.016191940917940406,35.91801924777758,45.69513491544126,44.382499885559085,43.06986485567691,43.899166515895296,0.6077422700381393,44.02964278629848,0.5973366181569816,44.00989582254114,44.233338119837654,-1.5722992840835963,-2.7676957090566567,11411700,0.504254910328161,0.5972105889916626,-9253200.0,-86.67373483627509,19.18618833600314,16.367993510430818,-150.30777311560314,18.027271787975025,31.378481804862357,-0.19923538424145293,0.9360017315466437,45.07877223205566,44.62227884674072,44.25333213806152,43.88438542938233,43.427892044067384,0.08,0.0,45.4421227513333,-0.024220931217211472,-0.0029298716618334844,42.52610342843192,42.68529210771833,0.6334276402930297
2022-10-11,1,43.786664962768555,43.08833312988281,45.40333366394043,43.783124685287476,44.64999961853027,-0.03257375565513973,0.620859222254306,-0.7564319382825189,2.995633792794811,44.271666526794434,0.5094207191467284,0.014032712155136354,43.36516695022583,45.10749912261963,0.5013071565040503,-0.050987457246915835,0.9896698698054395,0.9963157321166136,0.9959210564509386,-0.020943617696880135,35.16754805511025,45.485426673573556,44.24370822906494,43.00198978455633,43.91630908421108,0.6017540326123496,43.929404599326,0.4969511719899927,43.775514495846664,44.06303291736914,-2.7168402920911165,-3.0724528040889036,21276000,0.4988134088260444,1.1030827055389776,12022800.0,-35.483902033452694,19.18618833600314,16.367993510430818,-22.75232812172625,25.49937284707011,27.948478327618158,-0.1370711203116481,0.9758110343962685,44.50577223205566,44.158778846740724,43.87833213806152,43.59788542938232,43.250892044067385,0.08,0.0,45.43665387422487,-0.011769211491513887,0.0010564141506004606,42.66354424612863,42.636702401297434,0.5983329549837112
2022-10-12,1,44.15999889373779,43.08833312988281,45.1899995803833,43.77499866485596,44.55541658401489,-0.06503628571134704,0.56757378334247,-0.7970572741388171,2.995649660757415,44.24333333969116,0.4815041923522948,0.012851830547487352,43.36516695022583,44.76083326339722,0.5017071387529325,-0.029084610724402906,0.9999348796861172,1.0050906799437083,1.0087104704819154,-0.007287250266260981,44.77863484379923,45.298022360691284,44.16287479400635,43.027727227321414,43.96809468950544,0.6054122968932917,43.89607122966221,0.46092971744118855,43.77673738474982,44.01019391170299,0.2748045282523721,-3.10540967170959,16947600,0.5288337005509031,0.8855281081343748,28970400.0,-56.521767044551694,19.18618833600314,16.367993510430818,-0.83016506991442,25.501822273059965,25.411145336911908,-0.16082491198918586,0.9965864206911985,44.50577223205566,44.158778846740724,43.87833213806152,43.59788542938232,43.250892044067385,0.02,1.0,45.43265320172078,-0.013165942957828136,-0.022942466905534472,42.60060828072684,42.58533559526716,0.5702518725405674
2022-10-13,1,43.572500228881836,43.08833312988281,45.1899995803833,43.77499866485596,44.4960412979126,-0.09538653766008927,0.5255332449281749,-0.5868669408209826,2.9956612882872413,44.19749975204468,0.4392791843414308,0.011912542928734962,43.36516695022583,44.72033357620239,0.47795560679218885,-0.012522391993452063,0.9876811495718204,0.9913374000915854,0.9967668715600242,-0.014976836720438369,49.823007433727106,45.167024608295065,44.11595811843872,43.06489162858237,43.80368995666504,0.5157601852035304,43.884106976645334,0.46742062616479846,43.87362113347769,43.992642268367256,0.8276710768928135,-1.0457137321687993,20545500,0.5323199165533733,1.072523982425547,8424900.0,-40.9536313718944,19.18618833600314,16.367993510430818,-51.70470350363138,22.81877544080808,28.723326248340747,-0.09401478384782176,1.034211014871485,44.50577223205566,44.158778846740724,43.87833213806152,43.59788542938232,43.250892044067385,0.02,0.0,45.426500469356164,0.004556548337947719,-0.004814999750160092,42.50944301060268,42.63670294625418,0.561591135999885
2022-10-14,1,43.84499931335449,43.08833312988281,45.1899995803833,43.72166657447815,44.46166634559631,0.09776966885463459,0.5190542155722112,-0.5259540542675061,2.9956629002442345,44.07541608810425,0.4362499713897705,0.011781001086652173,43.36516695022583,44.63633279800415,0.46181940241011427,-0.015347802703958203,0.9951522770804506,0.9991720019914584,1.0060499922673338,0.012606099413190464,45.13925128343469,45.09669154767579,44.05858311653137,43.02047468538696,43.71238040924072,0.423546140207605,43.917856897626606,0.4441160522917573,43.80047622939219,43.91530957776195,-2.5732275379631964,-0.3829436285158128,16641000,0.5381239982074142,0.9299479450447203,25065900.0,-66.90041715554172,19.18618833600314,16.367993510430818,-45.01465346947699,21.7996720943483,26.63035721882304,-0.15567298920289507,1.0358150373727686,44.50577223205566,44.158778846740724,43.87833213806152,43.59788542938232,43.250892044067385,0.02,0.0,45.42158526518374,0.014545678716510357,-0.009492637629875848,42.39421463012695,42.616341727120535,0.5675443799819399
2022-10-17,1,43.8125,43.08833312988281,45.1899995803833,43.72166657447815,44.46166634559631,0.20929136727852135,0.5190574966220349,-0.5019555463123919,2.995662865699558,43.950000286102295,0.4352416801452634,0.011786515114243418,43.36516695022583,44.63633279800415,0.4615381973862099,-0.01541975614991439,0.9948737795011894,0.9980257893248974,1.0027923849856053,0.01680656496816213,47.43480594035561,45.07636477199163,44.038249778747556,43.000134785503484,43.6520231791905,0.3623394100880849,43.91095209121704,0.4450120984018487,43.812822438073134,43.90438111280264,-1.4368412119542255,1.0893974042688328,17812500,0.5378948937690683,0.9927535262605253,7253400.0,-53.71660067187884,19.18618833600314,16.367993510430818,-21.451724024621857,20.577164280936422,25.136948527487686,-0.19965261742153748,1.0189713227155903,44.50577223205566,44.158778846740724,43.87833213806152,43.59788542938232,43.250892044067385,0.02,0.0,45.4167334113914,0.015852353462051383,0.021857585627097876,42.3798702784947,42.62606021336147,0.5391079572134393
2022-10-18,1,44.66666603088379,43.08833312988281,45.1899995803833,43.72166657447815,44.33229184150696,0.3851387816508905,0.5084317212935422,-0.24997863578929724,2.9956656133809356,43.87708330154419,0.41466665267944336,0.011554664646855638,43.36516695022583,44.63633279800415,0.44320088674969127,-0.014434336849362241,1.0150986361883314,1.01744847765802,1.0189649148372797,0.020097467319410978,47.293348216881306,45.019154883550826,44.002291440963745,42.985427998376665,43.847380365644185,0.4874388526674074,43.959225858960835,0.4888418448956065,43.812508497797744,43.90658331627492,-0.9551273980375891,-0.22015286488133393,16842300,0.5378066296072689,0.9312104192860294,24095700.0,-14.866723699859877,19.18618833600314,16.367993510430818,114.98773074018324,24.0335016041096,22.980036119983513,-0.22159845232242617,1.0349970801275548,44.50577223205566,44.158778846740724,43.87833213806152,43.59788542938232,43.250892044067385,0.04,0.0,45.41471468981794,0.011080065876099221,0.03727187592541817,42.63809149605887,42.64989253452846,0.5511626744232204
2022-10-19,1,44.64916706085205,43.08833312988281,45.1899995803833,43.72166657447815,44.339791774749756,0.37050668973534945,0.5198558024067552,-0.41181915120568036,2.995662616109632,43.87708330154419,0.42741662979126005,0.011811437293171505,43.36516695022583,44.672332763671875,0.30451298032320473,-0.01158073809159068,1.0144559981634242,1.0171811724634474,1.0144924983077832,0.011077177974830654,54.55895873878916,45.05262802670377,44.01291642189026,42.97320481707675,44.07035664149693,0.43670357449906044,43.984761578696116,0.5161197892780441,44.02485294687645,44.025283053849314,3.1582601702735706,1.5363035841432655,11339400,0.547284601991028,0.6513808108224549,12756300.0,-20.19633114991437,19.18618833600314,16.367993510430818,108.26624963990267,23.029370051809625,22.87451308243883,-0.16961696051639646,1.002973436909214,44.50577223205566,44.158778846740724,43.87833213806152,43.59788542938232,43.250892044067385,0.04,0.0,45.41311860789,0.0197453526787561,0.00821578345744425,42.843558175223215,42.684830801827566,0.5258126143185587
2022-10-20,1,44.75999927520752,43.08833312988281,44.72333335876465,43.72166657447815,44.339791774749756,0.012495258202853497,0.46955650505459057,-0.9345013354240392,2.9956752942666633,43.87708330154419,0.3954625272750853,0.010675165771585667,43.36516695022583,44.65091695785522,0.29259560276998375,0.0005042050819230682,1.0175993880509508,1.0193229492815963,1.0147550452583984,0.027253406164160277,56.04362190469215,44.92498780602288,43.985874795913695,43.04676178580451,44.20940440041678,0.48374340834589985,44.06285674231393,0.5461304881156693,44.178692212493274,44.079719714875516,3.6224049936310063,0.8071497431302022,12754800,0.532533064434188,0.7411804391541171,25511100.0,-17.871679377990805,19.18618833600314,16.367993510430818,134.1606508445297,23.682679734672025,21.894961564286714,-0.16982177346385524,0.9729990509772569,44.55670478820801,44.19997821807861,43.911664962768555,43.6233517074585,43.2666251373291,0.06,0.0,45.411744630491576,0.013683133800058478,0.022261283510768524,42.90927069527762,42.786407470703125,0.5398164049162787
2022-10-21,0,45.25166702270508,43.08833312988281,44.75999927520752,43.72166657447815,44.339791774749756,0.06111373905063521,0.47944929843139356,-0.9240552453188555,2.9956728964912642,43.87708330154419,0.40296667098998995,0.010898422381632552,43.36516695022583,44.672332763671875,0.42716507202752046,0.023319604696542966,1.028621341818488,1.029289136027914,1.0204074119075244,0.032082739910595404,60.301424723037684,44.95144005308532,43.99254145622253,43.033642859359745,44.365356990269255,0.6215126853714598,44.16672583988735,0.6244488695259491,44.32206607808655,44.14326988513793,2.222901226358717,2.5038143878397,18134700,0.4898771753192625,1.0822980907730995,43645800.0,-6.531093853765643,19.18618833600314,16.367993510430818,189.88404423510278,26.590116870697116,20.089661116818494,-0.10598389900303183,0.9846895012177768,45.06858630371094,44.61403944396972,44.246665954589844,43.879292465209964,43.42474560546875,0.08,0.0,45.41157157460036,0.048838353008541224,0.03416986560881982,43.16980634416853,42.88520731244768,0.6309979214765417
2022-10-24,0,46.205833435058594,43.08833312988281,45.25166702270508,43.75666546821594,44.52541637420654,0.2360913749746804,0.5479414015570334,-0.6360130023305386,2.9956550427971522,43.950000286102295,0.4608542013168332,0.012433962275682118,43.36516695022583,44.72699995040894,0.44996312643680875,0.04332622248908807,1.0485091803893742,1.0463455303735498,1.0353552379995683,0.054626726049839425,66.36171132445105,45.16400762191595,44.06812481880188,42.972242015687804,44.741547448294504,0.8252035085609472,44.27261870247977,0.8208970120086347,44.55246250375863,44.30426816612493,2.4720746293363054,3.3202063529353407,18806700,0.4885637580985125,1.1366648716177379,62452500.0,-8.622071314815617,19.18618833600314,16.367993510430818,257.34331344696255,31.560034086864256,18.332887720847502,-0.1265137158215764,1.0019737743735209,45.850413864135746,45.24646016693115,44.75833320617676,44.270206245422365,43.66625254821777,0.1,0.0,45.41457254542671,0.061200972748502114,0.06884912786752864,43.499756404331755,43.004599707467214,0.8160516216943986
2022-10-25,0,46.493332862854004,43.08833312988281,46.205833435058594,43.79479098320007,44.653541803359985,0.9945707050624403,0.696035617452962,1.2468208055978298,2.9956089635470042,44.07541608810425,0.537937669754028,0.015743924463701375,43.54516677856445,44.80916604995728,0.5139988501984455,0.052304935098636575,1.0516523900559813,1.045475326790111,1.0307419369133868,0.04089552667099006,72.32198431461909,45.6018627044799,44.20979146957397,42.817720234668045,45.11988081250872,0.9441720908025936,44.416130610874724,1.0137066207286147,44.96649179424544,44.57432142226204,6.043566911111666,3.314824645116513,15051300,0.5163566827341296,0.9155575994145804,77503800.0,-3.30384552606365,19.18618833600314,16.367993510430818,216.43164854420516,29.93595547047228,17.389477747265254,-0.0669956284139759,0.9808802921567987,45.850413864135746,45.24646016693115,44.75833320617676,44.270206245422365,43.66625254821777,0.1,0.0,45.41748165443254,0.04420768081261173,0.06622508304568277,43.94586072649275,43.170037678309846,0.9691170860874145
2022-10-26,0,46.9466667175293,43.08833312988281,46.493332862854004,43.79479098320007,44.680832862854004,1.0540790176295394,0.8508702141665417,0.7156353974047023,2.995549343867599,44.19749975204468,0.6522167205810547,0.019190108459776624,43.54516677856445,45.34708366394043,0.6484077363092436,0.05688684195442342,1.0588120387042204,1.0492829275703277,1.0324302161422558,0.051456719305558396,73.93869677929258,46.040740176563055,44.33899974822998,42.637259319896906,45.56761891501291,0.9637930204086695,44.609821047101704,1.2154263445268663,45.34864467849686,44.833216387191676,6.040218020240387,4.516588466479461,20754300,0.5175781584085252,1.2476071194452034,98258100.0,-6.442437975027812,19.18618833600314,16.367993510430818,205.78133313006762,32.2471242973545,16.43567013705704,-0.09110802747318887,0.9636746760425846,46.247694213867184,45.5678204498291,45.018333435058594,44.46884642028809,43.78897265625,0.12000000000000001,0.0,45.423118863697006,0.055173557697513864,0.05218436310062133,44.397979736328125,43.38892500741141,1.1335754214983405
2022-10-27,0,47.010833740234375,43.08833312988281,46.9466667175293,43.79479098320007,44.732499837875366,1.019763246999582,1.0178767606449513,0.24816474568729108,2.9954724800137495,44.263333797454834,0.7802334403991693,0.022880426485146193,43.54516677856445,46.234583377838135,0.7195291522731427,0.05994354951455842,1.0567368928998035,1.0442133676996996,1.023498772754875,0.050286740426146226,76.07501141617317,46.52254494127282,44.48679141998291,42.451037898692995,45.902500016348704,1.0049475430112527,44.87494019099644,1.308769413823042,45.750974194472676,45.09276779018803,7.1535902254591655,6.130136927234877,16602900,0.5213076048725047,0.993985938753023,114861000.0,-9.913208806478245,19.18618833600314,16.367993510430818,168.4953236993686,30.917775854245388,15.680498669328493,-0.09336895281592256,0.937936221874254,46.27949449157715,45.6069206161499,45.06333351135254,44.51974640655518,43.84717253112793,0.14,0.0,45.42763753991426,0.04951899081910538,0.05210837961195247,44.702941349574495,43.67051642281668,1.2458081922694382
2022-10-28,0,47.125,43.08833312988281,47.010833740234375,43.79479098320007,44.88291621208191,0.8650104125058596,1.1550862455696327,-0.3919650772724106,2.9953996468721633,44.359583377838135,0.9102751684188846,0.02588559091136212,43.54516677856445,46.53866624832153,0.7795534761407884,0.07658397094650872,1.056075662208552,1.0388155142749442,1.016026445281481,0.041398098690043295,79.20015750502365,46.93292224890599,44.62274975776673,42.312577266627464,46.25619043622698,0.9226322584616115,45.16327353886196,1.3293811342603894,46.0676918851817,45.320348815499464,5.248136737426882,8.5721467199601,13648200,0.48986366027827905,0.8319207102431174,128509200.0,-2.684046784546776,19.18618833600314,16.367993510430818,154.56432814397147,30.70413618365679,14.54341245790851,-0.005068870035994282,0.939035848476708,46.49030532836914,45.783179092407224,45.211666107177734,44.640153121948245,43.93302688598633,0.16,0.0,45.43193619020015,0.041739887365661144,0.06279365157987284,45.10786002022879,43.975709097726,1.351167368673984
2022-10-31,0,47.459166526794434,43.08833312988281,47.125,43.80874991416931,45.49020862579346,0.6799162185645473,1.2536674865634914,-0.8335133868102886,2.9953430307922027,44.56666660308838,1.0259335327148449,0.027986356428543295,43.54516677856445,46.9530834197998,0.8160249374450275,0.07597466452209795,1.0594588792130997,1.0386718346531627,1.0150318283168394,0.02712499696596482,79.62801854015272,47.3030013816658,44.79566640853882,42.28833143541184,46.64178575788225,0.7388368026511856,45.42559507914952,1.3974427681947297,46.33309435668272,45.5502607989343,5.545082029802825,9.368352351782343,22572000,0.48995868271558213,1.3552275959209883,151081200.0,-5.034001424673318,19.18618833600314,16.367993510430818,137.28457614836861,30.099877799076605,14.044859622212394,-0.05726675991669304,0.9029140390048493,46.53359916687012,45.8181995010376,45.239999771118164,44.66180004119873,43.94640037536621,0.18,0.0,45.43973543293091,0.020945417943274425,0.04042402381535695,45.48917661394392,44.19922365461077,1.4550657194120677
2022-11-01,0,47.47583293914795,43.08833312988281,47.459166526794434,43.83687448501587,46.277708292007446,0.5258531252712915,1.3575925224338954,-1.0914628903001857,2.995279047560265,44.65791654586792,1.1641252040863037,0.03018297595904566,43.54516677856445,47.02225036621094,0.855998991678382,0.06117238950154485,1.0555169541365421,1.0308097533259246,1.0099736841315101,0.02113206379917143,80.20283968702066,47.69393479691246,44.97874975204468,42.2635647071769,46.959523745945525,0.4711301173752575,45.66244036810739,1.4465716414590952,46.614395332722104,45.781628160053835,6.030311204857364,8.387260292942102,14814300,0.45908630215218554,0.8929922863882919,165895500.0,-12.252949229822804,19.18618833600314,16.367993510430818,114.29519336013855,29.73210526023524,13.272207081921621,-0.0920076919006231,0.8872295024914656,46.65583905029297,45.91707940673828,45.31999969482422,44.722919982910156,43.98416033935547,0.19999999999999998,0.0,45.44470162055199,0.011565622375863338,0.016354740921890997,45.71546881539481,44.44263757978167,1.5321634767900103
2022-11-02,0,47.18166732788086,43.08833312988281,47.47583293914795,43.83687448501587,46.60666632652283,0.38915738661299665,1.4603513849708514,-1.3472349058218325,2.995210462538898,44.65791654586792,1.3037335395812988,0.03236854454011261,43.54516677856445,47.15841665267944,0.8791608665518045,0.06725239682024851,1.045777006887812,1.018212307904608,0.9995374780076178,0.005005693200020422,81.63688555622369,48.03707750100555,45.11637473106384,42.19567196112214,47.09892858777727,0.33591770861710996,45.92023801803589,1.3647532787395042,46.82819848819594,45.937184190690196,4.915102719479689,7.5086823561500715,15522000,0.45133724491094773,0.9329296768644619,150373500.0,-20.857951101916715,19.18618833600314,16.367993510430818,91.93776872794064,27.454908328233827,14.390610591804874,-0.11002169648504964,0.8921891838443916,46.79309289550781,46.13511935424805,45.60333251953125,45.07154568481445,44.41357214355469,0.2,0.0,45.449376361506644,-0.0027632300338524818,0.0048546423742020185,45.777479444231304,44.638617924281526,1.5680325872465906
2022-11-03,1,46.75166702270508,43.08833312988281,47.47583293914795,43.83687448501587,46.962708473205566,0.207910300392461,1.5191188817010994,-1.5404035327446948,2.995169933048064,44.713332653045654,1.3888752460479736,0.03357076077996796,43.54516677856445,47.209417247772215,0.9011451476788023,0.06661391831968776,1.0331574760801114,1.0034484565262924,0.989442797790948,-0.005512914724324247,76.17407456927913,48.289487553593844,45.25124979019165,42.21301202678946,47.135833467756,0.26500152928576276,46.127857140132356,1.2401720837215422,46.91415108376832,46.03845767271833,2.111927910993709,8.283130598520723,10976400,0.4535773191916746,0.6661768842738885,139397100.0,-21.956868657479657,19.18618833600314,16.367993510430818,65.91626839979736,25.525564070683306,17.70795726666334,-0.06274523658901933,0.8910804580135872,46.835572967529295,46.20387947082519,45.69333267211914,45.18278587341309,44.551092376708986,0.02,1.0,45.45194425850225,-7.104345089425923e-05,-0.002975741263281222,45.80755887712751,44.87670980181013,1.5753070707220092
2022-11-04,1,47.0,43.08833312988281,47.47583293914795,43.83687448501587,46.962708473205566,0.01664222224105927,1.5338880747851225,-1.6055547382882673,2.995160902475658,45.0058331489563,1.4256252574920651,0.03380314400199367,43.54516677856445,47.209417247772215,0.8949954413488682,0.07973597733656142,1.0357651214651142,1.004484558509646,0.9957908395103202,-0.0026525198938992522,71.71803829740342,48.44485926037956,45.37708311080932,42.30930696123909,47.14345250810896,0.25936306158316214,46.35553571156093,1.0622319534964957,46.87150150396504,46.072652885638014,0.5556369998535233,6.629416706286185,14669400,0.40050391952434594,0.8968736530295943,154066500.0,-24.5282550348613,19.18618833600314,16.367993510430818,61.30686660520778,24.54846008132502,16.121428728537058,-0.012961066150578687,0.9088603822250465,47.02280001831055,46.50693342590332,46.09000015258789,45.67306687927246,45.15720028686523,0.04,0.0,45.45548761958269,-0.010806269525333256,0.0017053775373662193,45.79969188145229,45.09883580889021,1.4975887696713295
2022-11-07,1,47.32833290100098,43.08833312988281,47.47583293914795,44.08124899864197,47.002708435058594,-0.15698386137412682,1.4947836360655258,-1.5854918805893647,2.995193042793035,45.728750228881836,1.4028752326965332,0.032807592749953464,43.765248489379886,47.209417247772215,0.8670841607031678,0.09078250621406264,1.038764831167979,1.007736247063512,1.0032786541370922,-0.002756761978101596,74.88224648918165,48.55169209665498,45.56212482452393,42.57255755239287,47.18880953107561,0.2600664631843503,46.54565477371216,0.9709787830900355,46.90224099570226,46.17298603471898,0.11360398128284824,7.275320970042796,11364000,0.38979861954307515,0.6948858565596363,165430500.0,-10.566029180279221,19.18618833600314,16.367993510430818,79.1595562508912,25.266929524446336,15.26037213562091,-0.008442105877536861,0.891560648988725,47.02280001831055,46.50693342590332,46.09000015258789,45.67306687927246,45.15720028686523,0.04,0.0,45.45922066766313,0.0008431860867263996,-0.000421019195335223,45.87928717476981,45.29111426217215,1.4352443570315683
2022-11-08,1,47.57916736602783,43.572500228881836,47.47583293914795,44.526875019073486,47.03937530517578,-0.27416403024584546,1.4280848730199613,-1.6052669436093014,2.9952441007825015,46.3495831489563,1.346296052932739,0.031198518351832908,43.809916496276855,47.34141626358032,0.8813645112447203,0.08088462414855924,1.0394336879256336,1.0106615692754455,1.009155677979354,0.0021765690138040306,76.07964258600573,48.63029455911977,45.77412481307984,42.917955067039905,47.253690583365305,0.29570484103473843,46.75494050979614,0.8373342649602051,47.00929921373108,46.322085128060365,0.6753744520273608,5.958955764186286,15068400,0.3736163897133457,0.9392282239689442,180498900.0,-12.284050547273297,19.18618833600314,16.367993510430818,81.86313401499248,26.480858886828145,14.213873981891847,-0.040383994698039445,0.8888303407222842,47.203627380371096,46.69652043151856,46.28666687011719,45.87681330871582,45.36970635986328,0.02,1.0,45.46462328514144,0.007763327552615218,0.0032319237483762605,45.892244066510884,45.50005204336984,1.4353610387094606
2022-11-09,1,47.05000019073486,43.572500228881836,47.57916736602783,44.662291288375854,47.139166831970215,-0.44840031145795445,1.4031670664676055,-1.435367993779228,2.995264062252385,46.62249994277954,1.299250164031983,0.030527689070311902,43.841749382019046,47.46083316802979,0.884464573959144,0.0774268242288136,1.023632759708895,0.9971213126174987,0.9974947779297916,-0.002790641887049028,77.26182289487384,48.77008406617801,45.963749933242795,43.15741580030758,47.19523824964251,0.28867536656442794,46.91851200376238,0.6106341937508437,47.15097364059325,46.4711367702815,0.9637503788389009,6.562273157710878,15932100,0.37138528104911633,0.9962163774393298,164566800.0,-45.68022456331754,19.18618833600314,16.367993510430818,40.55548372865804,23.772034205932027,18.71621102733493,-0.036357060623210646,0.9193902788272988,47.231161193847655,46.74108787536621,46.345001220703125,45.94891456604004,45.458841247558595,0.02,0.0,45.46837208199233,-0.00909402683086391,-0.01566794553902051,45.759894779750276,45.6245356968471,1.3406610346914662
2022-11-10,1,47.33833312988281,43.572500228881836,47.57916736602783,44.73666596412659,47.139166831970215,-0.6722577297718955,1.3580569347958147,-1.13396226169955,2.995295531695681,46.84916687011719,1.2200251054763789,0.029453664688032902,43.841749382019046,47.46083316802979,0.8578377738300416,0.07980951158611693,1.0266781569858114,1.003012243113477,1.0041682645585972,0.0125485601805988,68.45730719717896,48.82436386768428,46.10824999809265,43.39213612850102,47.17559541974749,0.2705065258531915,47.067559582846506,0.38572893999444097,47.12324495790662,46.532843210287396,-0.8621439565917445,5.116177284649267,20310600,0.365218277778077,1.270932455783839,184877400.0,-24.63973404878081,19.18618833600314,16.367993510430818,60.10666595795118,21.813151614903237,17.173942509888548,-0.037702296307736104,0.9303859681185842,47.47738734436035,47.13964037322998,46.86666679382324,46.593693214416504,46.25594624328613,0.02,0.0,45.47451818150314,0.0116543806043794,0.01143879698105734,45.79090009416853,45.75318445478167,1.2843769018602333
2022-11-11,1,47.36333465576172,43.8125,47.57916736602783,45.12875008583069,47.21833372116089,-0.8520932941750737,1.250207492980445,-0.8244651255468378,2.995364760853159,46.97333335876465,1.088495936393737,0.027004338739103673,44.56875028610229,47.46083316802979,0.8356538160703595,0.07967462358847173,1.0230426069584622,1.002846093550759,1.0022041848273593,0.007730524590674914,70.53676015189694,48.7969566291036,46.2965416431427,43.79612665718181,47.20154789515904,0.27974307229607936,47.15023824146816,0.3017180151471061,47.175023085728576,46.66364745066715,-0.2896206359167554,4.611246931810816,19270800,0.3654394853336874,1.196026279212443,204148200.0,-25.91298913508597,19.18618833600314,16.367993510430818,58.32713386071923,20.080938685926327,17.104043505548756,0.04103215927440425,0.9384537534838489,47.571000869750975,47.291167350769044,47.06500053405762,46.83883371734619,46.55900019836426,0.02,0.0,45.48036109765017,0.011420861724262155,0.01321769862448768,45.87558582850865,45.826532636369976,1.1347131911137316
2022-11-14,1,46.80166721343994,43.8125,47.57916736602783,45.967291831970215,47.330832958221436,-1.0619156521994975,1.1351085601834912,-0.3338213608075731,2.9954313130175563,47.00541687011719,0.9488917636871349,0.024425403755545926,44.66491613388062,47.46083316802979,0.7856323144253236,0.08104615476774252,1.007083954979756,0.9904538256379309,0.9887989457755465,-0.01112791546371783,70.95002174666674,48.74267553063004,46.47245841026306,44.20224128989608,47.208690779549734,0.2666744999733317,47.172262123652864,0.25819272085813816,47.22068473670817,46.79794221115351,0.3850379568369079,2.5050975919089753,37525800,0.36386991695936083,2.194745356479873,166622400.0,-97.93098821653788,19.18618833600314,16.367993510430818,3.135397251552947,17.646135918418548,19.159872307550774,-0.05004247823673235,0.9916595114234832,47.56706759643555,47.28480078125,47.05666732788086,46.82853387451172,46.54626705932617,0.02,1.0,45.487699962264976,-0.028501323234977782,-0.018301848003138967,45.76776123046875,45.78766005379813,0.956675136909136
2022-11-15,0,48.98916721343994,44.64916706085205,47.57916736602783,46.42145800590515,47.330832958221436,-1.165959399775651,0.9580102433769044,-0.13509154320900096,2.995519423627198,47.00541687011719,0.7704834938049316,0.020548495422954064,44.750665950775144,47.46083316802979,0.8196630279763855,0.04779853461818602,1.0507754851465196,1.0381920217070801,1.0373236780873405,0.029634815518416735,56.89801098278167,48.53793725768886,46.62191677093506,44.70589628418126,47.49285752432687,0.7056889130399259,47.318155016217915,0.5419970030409528,47.115717529440744,46.845641910762765,0.10694846605273037,0.6631797111544184,76548600,0.3645610398431435,3.811548231406786,243171000.0,-23.583316802978516,19.18618833600314,16.367993510430818,223.76033535534123,27.246894717529248,14.657439265021093,-0.0370513123907745,1.2036837703555803,49.14600015258789,48.56200015258789,48.09000015258789,47.61800015258789,47.03400015258789,0.02,1.0,45.53329984454488,0.03256537825427408,0.035029828071628376,46.067169189453125,45.93343053545271,1.0016841228384459
2022-11-16,0,49.47499942779541,44.64916706085205,48.98916721343994,46.68708348274231,47.34458351135254,-0.6598181020124028,0.9798556247149391,0.816297556367247,2.9955123802699446,47.03041696548462,0.6952958917617806,0.020920080909232665,45.20250024795532,47.486166381835936,0.5581668813704624,0.09720226463962774,1.0562994842376185,1.0451360569460388,1.0413925703242186,0.05154089749691604,75.01512242509966,48.79775307949274,46.83804183006286,44.87833058063298,47.79952417101179,1.0191081231815216,47.4941668510437,0.7816500737871267,47.58346410027024,47.15704536373241,4.232270666893492,4.350682676152598,32593200,0.5875282625357983,1.5413393297321838,275764200.0,-14.750003814697266,19.18618833600314,16.367993510430818,243.6415661017904,25.569283022716355,13.75496976227848,-0.04045405461404632,1.1910395532592644,49.14600015258789,48.56200015258789,48.09000015258789,47.61800015258789,47.03400015258789,0.02,0.0,45.554463426227876,0.06474496679089303,0.03998882672533818,46.347140720912385,46.113213947841096,1.0209220970881983
2022-11-17,0,49.204166412353516,44.75999927520752,49.47499942779541,46.789167165756226,47.3872926235199,0.07414431659744804,1.0049945427953788,1.2729165628659072,2.9955044763484264,47.08750009536743,0.6521667003631592,0.02134683032198536,46.11041679382324,47.720167350769046,0.5323772186277923,0.10533959403345032,1.0451330298945691,1.0344036108245431,1.025225625887129,0.0394148496389044,77.17607996284104,49.08932253400079,47.07933344841003,45.06934436281927,48.03166689191546,1.1386189884377653,47.64267873764038,0.8953612206766979,48.05748983511882,47.49639747347211,4.535690135726358,5.241697480153539,24791400,0.5895418281561664,1.1399469051085729,250972800.0,-18.916702270507812,19.18618833600314,16.367993510430818,197.38987502400283,24.503684250140935,14.027621868498628,-0.00895532407560522,1.1540607295430882,49.14600015258789,48.56200015258789,48.09000015258789,47.61800015258789,47.03400015258789,0.02,0.0,45.569352456851114,0.0396176674884432,0.06115985915576203,46.58823994227818,46.24024200439453,0.9776983347367869
2022-11-18,0,49.90916728973389,45.25166702270508,49.47499942779541,46.91041684150696,47.46333312988281,0.6329753966939515,0.9578192329845251,0.7577011503403899,2.9955280818826617,47.15333366394043,0.6498624324798584,0.0202492180260785,46.46458292007446,49.010667133331296,0.5796005195399958,0.0873448350016645,1.0551277058832822,1.0438427641890338,1.0318918048594965,0.05375112737469534,72.51698561280739,49.21718027123638,47.301541805267334,45.38590333929829,48.44011933462961,1.236407676218606,47.81767879213606,1.0776140189398558,48.34617481414043,47.77674289250576,3.415358309708368,4.412024217195789,18987000,0.5974985538097037,0.8713442160724391,269959800.0,-0.3333091735839844,19.18618833600314,16.367993510430818,204.4969760061585,26.5378648668152,13.362583077869528,0.007312523505428363,1.124961374830939,49.14600015258789,48.56200015258789,48.09000015258789,47.61800015258789,47.03400015258789,0.02,0.0,45.58264628598373,0.05365413094165361,0.05528235152908255,47.086172921316965,46.42303385053362,1.066537581752664
2022-11-21,0,50.34083271026611,46.205833435058594,49.90916728973389,46.986666679382324,47.50166654586792,1.1792574893863574,0.9965305381092788,0.22299708248878636,2.9955142807394433,47.25500011444092,0.7484583616256707,0.020964400213677334,46.72583360671997,49.231249713897704,0.6325427660219961,0.08014862149127247,1.0590396617750888,1.04650355208235,1.0299738969888523,0.07562050045537339,75.01690387505349,49.52747789483733,47.53441681861877,45.541355742400214,48.869047846112935,1.3091437704649966,48.02232163293021,1.2636765979577187,48.739517848537574,48.100505422140024,6.076869473769,5.162334154259188,21157200,0.5835498002796229,0.9657296343184303,291117000.0,-7.137747436217954,19.18618833600314,16.367993510430818,185.07500612661926,29.554885368885422,12.793942543064759,-0.008972958840932323,1.0910356708925086,49.62222654724121,48.94721993255615,48.40166664123535,47.85611334991455,47.18110673522949,0.04,0.0,45.59896435749514,0.09220305955083186,0.0601063965978197,47.49294008527483,46.64192008972168,1.2014715950145904
2022-11-22,0,50.60499954223633,46.493332862854004,50.34083271026611,47.00812530517578,47.93166732788086,1.1380255931027135,1.120655782727407,-0.16221964239711717,2.9954591524772267,47.333333015441895,0.9212499141693129,0.02347357340124815,46.79666719436646,49.518416213989255,0.6892404951378027,0.08275379738341111,1.0599866520420735,1.0454480360213192,1.0205981727720352,0.03298346186936385,76.76114421912705,49.98247834783397,47.74116678237915,45.49985521692434,49.33214282989502,1.2601786779481603,48.26684536252703,1.4111059666052086,49.14183906067101,48.41753963737065,6.342639002825264,6.034648775494622,16898400,0.5856378795921582,0.7680968711861402,308015400.0,-5.359677886667953,19.18618833600314,16.367993510430818,157.83365589484322,29.36554832527944,12.406162973737853,-0.03668868537287411,1.044771170420605,49.70117259216308,49.01107942962646,48.45333290100098,47.89558637237549,47.20549320983887,0.06,0.0,45.61245341948831,0.028825191615904133,0.09610521008617884,47.914516993931365,46.89505141122,1.3223061503487143
2022-11-23,0,50.8125,46.75166702270508,50.60499954223633,47.04020857810974,49.042917013168335,0.9943651654495075,1.2433130359809652,-0.592699962251209,2.9953988633704958,47.350833892822266,1.0842831897735608,0.02593112219209694,46.932166767120364,49.95233383178711,0.7537514252883729,0.07792529439243566,1.0597694291416553,1.0432135916303398,1.0181471527583228,0.027033867360757746,77.47939512497915,50.43337618831021,47.94675011634827,45.460124044386326,49.90511894226074,0.7092649869579137,48.55690486090524,1.490806947009802,49.51056843621073,48.73822803155057,6.844249692373092,7.255640608386329,16920600,0.5828904650082796,0.7758659230172961,324936000.0,-6.291371153913198,19.18618833600314,16.367993510430818,142.46486541103326,30.371202322209374,11.914898985535284,-0.05668756022219712,1.0101447559510623,49.935466430664064,49.200599838256835,48.606666564941406,48.01273329162598,47.27786669921875,0.08,0.0,45.62661077573019,0.02639727504018352,0.03377637901032002,48.56377410888672,47.165767669677734,1.4440688434228375
2022-11-25,0,50.84500026702881,46.75166702270508,50.8125,47.106250047683716,49.27187466621399,0.8010096216288599,1.3671442563143767,-0.9757177116809661,2.9953319637104987,47.411250591278076,1.235554013252259,0.028399315948848307,46.98016672134399,50.36724939346313,0.7911284130850209,0.0808678757065301,1.0561893672401066,1.035879033781413,1.0133667362067154,0.03334745763040381,78.37992178010553,50.874330293100556,48.140041780471805,45.40575326784305,50.17023794991629,0.6545652052982187,48.83154773712158,1.5354276653430126,49.83703909260027,48.97396433519334,8.569850232617943,8.685964022037474,8777400,0.5821071703148244,0.4098258471270309,333713400.0,-1.98672485217415,19.18618833600314,16.367993510430818,122.73302641786044,29.45167069783934,11.603398868253663,-0.017982524204263908,0.9672772620369747,49.935466430664064,49.200599838256835,48.606666564941406,48.01273329162598,47.27786669921875,0.08,0.0,45.6339791045778,0.03425696230702946,0.030774510970884697,48.824310302734375,47.44573974609375,1.54586577846898
2022-11-28,0,51.1324987411499,46.75166702270508,50.84500026702881,47.167500495910645,49.58354139328003,0.600903125851631,1.4609640022869863,-1.2970129631768195,2.995278062730837,47.46749973297119,1.3526832008361822,0.030227831581896073,46.98016672134399,50.625749588012695,0.8247824128789435,0.07893899770883414,1.0579484216513744,1.0343467093004766,1.0124746058070937,0.024511157325352695,78.40209630387213,51.25367811138549,48.331750106811526,45.40982210223756,50.40702356610979,0.6609148809761582,49.10327386856079,1.5847597467468313,50.089008881900675,49.17615878846215,3.788251891491081,8.18085163197619,17674800,0.583026515274994,0.8175692177890272,351388200.0,-6.902879689492406,19.18618833600314,16.367993510430818,119.07464370318212,31.935104238227925,11.041432094085664,-0.0480110751949449,0.9439002709257177,50.25889224243164,49.462219146728515,48.81833267211914,48.174446197509766,47.37777310180664,0.1,0.0,45.6496440675533,0.021833169777981,0.03722988171101963,49.05615506853376,47.701647894723074,1.6507531996530964
2022-11-29,0,51.021666526794434,46.75166702270508,51.1324987411499,47.29166650772095,50.01708364486694,0.4269995143890987,1.5535968123038062,-1.4787469840696608,2.9952221020442322,47.52750015258789,1.4524206209182737,0.03201172029659702,46.98016672134399,50.81575002670288,0.8438992261490128,0.07739984671415549,1.0512967746760538,1.0242949248250517,1.0054091744412752,0.013524484595771824,79.42463616231943,51.63931866847663,48.532125043869016,45.4249314192614,50.66666643960135,0.42423864429238684,49.3491666657584,1.5971096230842534,50.349104284465376,49.403320831309344,3.3501755078814557,8.037819223648313,13841700,0.5825364745442387,0.6534588821135476,337546500.0,-10.201533522739984,19.18618833600314,16.367993510430818,98.35665590706456,30.959521048614082,11.151830324046935,-0.050635780046337474,0.9040980482828262,50.25889224243164,49.462219146728515,48.81833267211914,48.174446197509766,47.37777310180664,0.1,0.0,45.66145027610235,0.012041040040451145,0.018238479459634752,49.28614807128906,47.93719400678362,1.715635471690681
2022-11-30,0,50.75,46.75166702270508,51.1324987411499,47.29166650772095,50.40687441825867,0.23882475701554004,1.6230413982297944,-1.6328936926498494,2.9951784849769605,48.28416728973389,1.5232497692108153,0.03332032573776699,46.98016672134399,50.86266689300537,0.8667915920496656,0.07468712749476875,1.0418751690720938,1.0102819868980277,0.9973796328278765,0.0028653385846324486,77.2792577381216,51.956332840328606,48.71025004386902,45.46416724740943,50.786785398210796,0.26204647634313866,49.6134523664202,1.489919446308278,50.517065959131834,49.56519957376985,3.693793121520304,7.235307701547952,31338000,0.5852608968411334,1.423911517380417,306208500.0,-13.561357687747478,19.18618833600314,16.367993510430818,77.01326475096549,29.479676953404937,14.264465685755441,0.018135208455699926,0.8816624841172978,50.25889224243164,49.462219146728515,48.81833267211914,48.174446197509766,47.37777310180664,0.1,0.0,45.686427997479356,0.004812467107885743,0.008402394339971033,49.38749258858817,48.236832754952566,1.74064229899345
2022-12-01,0,50.81333351135254,46.75166702270508,51.1324987411499,47.29166650772095,50.641249656677246,0.04185220576006127,1.6550838861723067,-1.7112111733751996,2.9951590070347556,49.09666681289673,1.547145576477051,0.033864330626366713,46.98016672134399,50.86266689300537,0.8764242073758688,0.07562964333840999,1.0396811549146687,1.0080093981115048,0.998055488923793,1.6403667454589765e-05,73.46488220541463,52.184126169256245,48.87395839691162,45.56379062456699,50.854285512651714,0.17413944549444518,49.861666679382324,1.3660493803331177,50.57398292374062,49.66733180511617,1.684725985077834,7.863974057950683,22732200,0.584308903397979,1.0162412993039442,328940700.0,-7.75807588197132,19.18618833600314,16.367993510430818,76.51880577033342,29.45550006979502,13.162038319708428,0.09367275688445333,0.8872582280930108,50.25889224243164,49.462219146728515,48.81833267211914,48.174446197509766,47.37777310180664,0.1,0.0,45.70491689826357,0.00623273358341736,0.011075195516665583,49.49022674560547,48.491583415440154,1.746657976143072
2022-12-02,0,50.78499984741211,46.75166702270508,51.1324987411499,47.33583307266235,50.765625,-0.15513059713165883,1.6586731174967442,-1.6871806121352013,2.995159499564452,49.33958292007446,1.5298205661773678,0.03381214557642914,46.98016672134399,50.86266689300537,0.8602984175380312,0.0868774687044828,1.0352551023019763,1.0047797193788852,0.9974957041526014,-0.0011800652827532732,75.99718527148508,52.3728879410787,49.05554170608521,45.738195471091714,50.879999841962544,0.14140703665959875,50.10607133592878,1.1778008241099795,50.63332208780474,49.777827383703475,0.9386034669030567,7.340774699301984,20733000,0.5669827536349417,0.907085134225237,308207700.0,-8.674372497259569,19.18618833600314,16.367993510430818,72.14912125226923,27.929978000202848,12.48036664922394,0.13006250687565132,0.8688827165337405,50.25889224243164,49.462219146728515,48.81833267211914,48.174446197509766,47.37777310180664,0.1,0.0,45.72174793351972,0.0009797423743000966,0.005248581157073822,49.56102916172573,48.73777307782854,1.724082072750712
2022-12-05,0,50.65916633605957,46.80166721343994,51.1324987411499,47.35708427429199,50.79187488555908,-0.3387528630486978,1.6108030363186312,-1.5914688056631303,2.995195456737939,49.69208335876465,1.4660706043243408,0.03270187431168649,47.04500017166138,50.86266689300537,0.8617900465710504,0.08053191164706616,1.0284619862915003,0.9991650442754468,0.995258722594386,-0.009256977787972076,74.9404343808599,52.478814419957814,49.25720834732056,46.0356022746833,50.858095032828196,0.16372139145666376,50.381606987544465,0.6993261095046872,50.673786240829735,49.89120013376991,0.35569668373487096,7.224291145290268,23608200,0.5694554836159512,1.0130678987472788,284599500.0,-29.633301084183888,19.18618833600314,16.367993510430818,53.41556220555491,25.861731919794174,14.206716473256431,0.11464506166892297,0.871343634747,50.75291911315918,50.26187281036377,49.864999771118164,49.46812673187256,48.97708042907715,0.1,0.0,45.73964107832251,-0.012116592631392087,-0.009276971669020176,49.525396074567524,49.04458509172712,1.6611117508674327
2022-12-06,0,50.18416690826416,46.80166721343994,51.1324987411499,47.525209188461304,50.79187488555908,-0.5441163981569783,1.5507216094691914,-1.378138937898996,2.9952374406283857,50.125,1.3867164230346674,0.03136562261215998,47.30049962997437,50.86266689300537,0.8672499934156671,0.07037715530834064,1.01504849789838,0.9883345082291446,0.9877638787445923,-0.016414587675031234,71.38552718074348,52.541609883061916,49.44016666412354,46.33872344518516,50.763690267290386,0.3034386236721662,50.46696410860334,0.5788472246587009,50.666307476838554,49.980698071171595,-0.30176366827144835,8.242225869919178,20625600,0.5730544327653005,0.8678342642557354,263973900.0,-59.899066866397085,19.18618833600314,16.367993510430818,27.137344641154595,23.958189382581118,16.704948245860507,0.08150877860282453,0.8733903545050362,50.92283850097656,50.536911819458005,50.224998474121094,49.91308512878418,49.52715844726563,0.1,0.0,45.75368497198205,-0.020134536121362734,-0.023581588928477674,49.37823649815151,49.10127340044294,1.6006442933155547
2022-12-07,0,49.97000026702881,46.80166721343994,51.1324987411499,48.636667251586914,50.79187488555908,-0.7651630998807123,1.4795380246526155,-1.0076887059660384,2.9952835479970767,50.26249980926514,1.2862831306457523,0.029839648005196884,47.30949983596802,50.86266689300537,0.8702315978406353,0.05475084341421941,1.0078059461417561,0.9844204113359775,0.9868018354917548,-0.015369452866427435,60.90409687056521,52.54203441379193,49.58295836448669,46.623882315181454,50.59761905670166,0.3771199162150201,50.50232131140573,0.5263306002766167,50.54128532805529,49.992967368463,-1.2997017509963031,2.439314164328918,17550300,0.5906687650965882,0.7346035688566059,246423600.0,-69.73506856352842,19.18618833600314,16.367993510430818,11.621169567366996,22.387366868017796,16.679588145065924,0.05326884396843434,0.8679099856981157,50.92283850097656,50.536911819458005,50.224998474121094,49.91308512878418,49.52715844726563,0.1,0.0,45.764997766849326,-0.021716407261094806,-0.025233682991758162,49.17461940220424,49.115387235369,1.5346498142860059
2022-12-08,0,49.6133337020874,46.80166721343994,51.1324987411499,49.15041661262512,50.79187488555908,-0.998600213986514,1.4076482923417426,-0.4775674880956178,2.9953273004480896,50.26249980926514,1.1695831823349003,0.028321478639337015,47.30949983596802,50.86266689300537,0.8251399662909404,0.06206163792681461,0.99820599954867,0.9786182138362364,0.9827860636809788,-0.023615845022193604,59.31361765993408,52.51779659422022,49.70250000953674,46.88720342485326,50.39642865317209,0.4759157734209924,50.53154754638672,0.4552636698805206,50.39563652456443,49.98571294840025,-2.273502181080679,1.000507013559061,13512600,0.5759729904476903,0.5684759739956508,232911000.0,-90.15384398691498,19.18618833600314,16.367993510430818,-16.949833284832923,21.65794355415804,18.079621944410253,0.08613199501718052,0.833059076063003,51.03533245849609,50.71899949645996,50.46333312988281,50.20766676330567,49.89133380126953,0.02,1.0,45.77298190603729,-0.026270544330113443,-0.020201548050597085,49.00667790004185,49.14641298566546,1.3488704898330082
2022-12-09,0,48.8100004196167,46.80166721343994,51.1324987411499,49.40729117393494,50.79187488555908,-1.2073171450501774,1.2702979120224414,0.2789467188590269,2.995403892551649,50.26249980926514,1.0029665040969853,0.025492292127052056,47.36083450317383,50.86266689300537,0.7977428317358675,0.04805831599441072,0.9795173066429639,0.9650552299911944,0.9714915113356031,-0.03888942470669421,52.03039007621166,52.371262509149254,49.83066668510437,47.29007086105948,50.11928585597447,0.7317854732319333,50.45303562709263,0.6315131245174616,50.19861346330431,49.9689065799021,-2.760264257474683,0.8315704127672379,27929400,0.5859578055987081,1.156458106374072,204981600.0,-99.0445031902538,19.18618833600314,16.367993510430818,-88.16976681244941,19.519139965563596,24.39422375932458,0.0017366690767305405,0.8583168847551823,50.80562533569336,50.347185424804685,49.97666549682617,49.60614556884766,49.14770565795899,0.04,0.0,45.785572140267874,-0.04804992679299536,-0.04898098771263783,48.703002384730745,49.045247486659456,1.2669869227552992
2022-12-12,0,48.96500015258789,46.80166721343994,51.1324987411499,49.40729117393494,50.79187488555908,-1.3087221693715294,1.1617848025819815,0.9648268239959847,2.9954584354950384,50.26249980926514,0.9073081302642827,0.023280277760461036,48.6653338432312,50.86266689300537,0.7204221820933809,0.030544001480668433,0.981178959786595,0.9720308332613921,0.9822992864091236,-0.03344244104281202,41.12667846845893,52.227819654755024,49.90425004959106,47.5806804444271,49.855238233293804,0.7719763792590373,50.35476187297276,0.746837774169724,49.85036143290267,49.85177353416454,-3.822659271691233,-2.2023346206845686,19432200,0.6211430726797907,0.8043502016649778,224413800.0,-70.27597031824786,19.18618833600314,16.367993510430818,-74.97187239038267,19.06529735256854,22.517452515574128,0.013298277948220085,0.863437129094569,50.80562533569336,50.347185424804685,49.97666549682617,49.60614556884766,49.14770565795899,0.04,0.0,45.79540743321817,-0.02025706393906379,-0.03029617133129162,48.48124694824219,48.98573684692383,1.148747186932787
2022-12-13,0,49.53583335876465,46.80166721343994,51.1324987411499,49.40729117393494,50.79187488555908,-1.3925497643326161,1.0318079099920785,1.9644949671591556,2.9955170951734993,50.26249980926514,0.8121497821807864,0.020642626226400628,48.94950017929077,50.86266689300537,0.5698574761401919,0.046223416129216634,0.9910271892043323,0.9876122706204566,1.000552088402751,-0.012919085628833038,45.22868109289902,52.04794914441653,49.98433332443237,47.92071750444821,49.67678587777274,0.6570554635710407,50.278392859867644,0.7734707217389455,49.62971261692728,49.78493556959849,-3.6374967573259096,-2.7330349610956004,23408100,0.6027543579748933,0.9980857455519008,247821900.0,-75.90228541716274,19.18618833600314,16.367993510430818,-74.61613678002469,22.944035933168145,20.419370201226094,0.06162905852822958,0.8841438882902488,50.80562533569336,50.347185424804685,49.97666549682617,49.60614556884766,49.14770565795899,0.04,0.0,45.80827365196219,-0.01230229451341247,-0.023765135625611035,48.241814204624724,48.90142168317522,0.752479877463399
2022-12-14,0,49.02083206176758,48.8100004196167,51.1324987411499,49.52062487602234,50.79187488555908,-0.3687725882904936,0.7413014461768136,-1.2816223441250256,2.9956226924317257,50.26249980926514,0.6617706441879271,0.014790224265969446,48.986750507354735,50.86266689300537,0.8037605084495181,0.011158918928810282,0.9780489484233861,0.9802483629729061,0.9927498992524929,-0.018994760860297832,45.8075423918526,51.603644524052235,50.12104163169861,48.638438739344984,49.44273812430246,0.5279025921556261,50.15041657856533,0.8248187758881808,49.61106283813133,49.83723086715568,-2.4597154522018094,-2.1127678947597346,20334600,0.3751649085756874,0.9850939539426212,227487300.0,-84.60720759246391,19.18618833600314,16.367993510430818,-109.26184985533816,21.352575711821853,21.108216512182572,0.046035702618896834,0.8821812223289502,50.80562533569336,50.347185424804685,49.97666549682617,49.60614556884766,49.14770565795899,0.04,0.0,45.81824679722057,-0.012655544655959416,-0.017793611640728093,48.03694534301758,48.78117070879255,0.7575396700234464
2022-12-15,0,48.41583442687988,48.8100004196167,51.1324987411499,49.52062487602234,50.79187488555908,-0.3641243170815463,0.7389123069757719,-1.2857337236223823,2.995623407695697,50.26249980926514,0.6600290775299072,0.014742091197968587,49.01524887084961,50.86266689300537,0.8007059440375375,-0.009179734639323261,0.9659477042249527,0.9715097173395746,0.9842817395546906,-0.024136642024463195,37.31270027685248,51.60044948806654,50.12262487411499,48.64480026016344,49.19011919839041,0.5369958396515261,49.9769047328404,0.91773457960851,49.46422139410693,49.77570344801424,-3.234033231861168,-3.5260377628190342,17514000,0.3775468792045192,0.8806167032081871,209973300.0,-84.28697347796621,19.18618833600314,16.367993510430818,-152.56002466010628,19.61905571680102,25.616968327998382,0.06686800756598489,0.8915491612645939,50.680545623779295,50.14472589111328,49.711666107177734,49.27860632324219,48.74278659057617,0.06,0.0,45.82508169995412,-0.02298700026794631,-0.021474108553922476,47.85267203194754,48.61545426504953,0.8165347555141335
2022-12-16,0,47.87666702270508,48.41583442687988,51.1324987411499,49.452916622161865,50.79187488555908,-0.5050666395947647,0.8172347072628313,-1.0789009483502388,2.9955986929740015,50.26249980926514,0.7182831525802612,0.016321952239042366,48.94950017929077,50.86266689300537,0.7568371955765236,-0.016021651070501807,0.9562010344940078,0.9653348533897299,0.9780828596946056,-0.01912176580388869,32.05240955451171,51.704136038594875,50.069666624069214,48.43519720954355,48.89107159205845,0.6084300879367186,49.744345324380056,1.0102362439040347,49.20203485978187,49.63744893268066,-3.5236860355114796,-4.777590377404628,40343100,0.3959738357894011,1.9521560133785478,169630200.0,-98.38426673570105,19.18618833600314,16.367993510430818,-179.82598759368153,18.16174543605916,26.536244324900732,-0.03354108673754109,0.894295671553388,50.3603210144043,49.81817437744141,49.380001068115234,48.94182775878906,48.39968112182617,0.08,0.0,45.83704159290245,-0.01761741403712469,-0.04052967572190565,47.58325849260603,48.37893894740513,0.9524813386877713
2022-12-19,0,47.591665267944336,47.87666702270508,51.1324987411499,49.40708303451538,50.79187488555908,-0.7411245600099267,0.9308462611711668,-0.5975985656058547,2.995558180081326,50.26249980926514,0.7912956190109256,0.01861569969435763,48.77058382034302,50.86266689300537,0.7883121818386203,-0.04072398674234915,0.951770647354548,0.9652486502973245,0.975982360850926,-0.028047276225137918,24.645520986149243,51.864984176929134,50.00329165458679,48.141599132244444,48.6022618157523,0.6836226618506108,49.49934523446219,1.0894471373085501,48.873210746035156,49.465290838991606,-4.189179974259382,-6.367441057255879,15067500,0.36907211408977325,0.7360791638668301,154562700.0,-90.9932751560316,19.18618833600314,16.367993510430818,-161.74442886554738,17.25631745505328,27.501697453799444,-0.07337433514656633,0.8739888814028463,50.26877412414551,49.6906137008667,49.22333335876465,48.7560530166626,48.17789259338379,0.1,0.0,45.840977633833745,-0.035265575085411505,-0.01727339298733153,47.30548204694475,48.156079973493306,1.0724275513524446
2022-12-20,0,47.8216667175293,47.591665267944336,51.1324987411499,49.006874084472656,50.79187488555908,-0.7360949191978986,1.0692996981755878,-0.7164109738292184,2.9955013107748947,50.26249980926514,0.9270166015624994,0.02143425681361777,48.361917686462405,50.86266689300537,0.8212254612555377,-0.05461108397122588,0.9585917656458961,0.9759855782722276,0.9862543841273516,-0.034604578645532236,20.718633558672966,52.02601594984849,49.88741655349732,47.74881715714614,48.46107128688267,0.7337880807280265,49.29017857142857,1.1117413232450417,48.555183129976726,49.2794725027755,-4.074849003863669,-6.722636660738639,17009400,0.34812278301770905,0.8394499114252867,171572100.0,-80.47136522713309,19.18618833600314,16.367993510430818,-119.88147218381053,19.08651985299906,25.699698200035368,-0.052072337638794236,0.8684657606899026,50.26877412414551,49.6906137008667,49.22333335876465,48.7560530166626,48.17789259338379,0.1,0.0,45.8462114077894,-0.023323596375952382,-0.02682068802353041,47.24695478166853,47.974978583199636,1.1305225662733918
2022-12-21,0,48.30833339691162,47.591665267944336,51.1324987411499,48.92625021934509,50.79187488555908,-0.547650001509891,1.1535264019302478,-1.1116443618622858,2.995462408172082,50.077083587646484,1.020229115486145,0.023181121341852108,47.8711669921875,50.86266689300537,0.8655168646812877,-0.05500114316538991,0.9707981858261535,0.9906946153301412,1.0033855887383722,-0.01453460977484411,24.254809397736725,52.06851105772097,49.761458253860475,47.45440544999998,48.36726175035749,0.6998157664523199,49.11124999182565,1.0474656914103735,48.37324996727162,49.12752917735618,-2.0248590321466007,-5.770114842306804,13726500,0.3460885268848027,0.6827759307121583,185298600.0,-70.02604995227489,19.18618833600314,16.367993510430818,-79.04225038651794,21.71309370173377,24.34141285138255,-0.043227679062258266,0.8514325683163483,50.17454772949219,49.614393920898436,49.16166687011719,48.70893981933594,48.148786010742185,0.1,0.0,45.85143417817793,-0.010158941988645753,-0.01566217554379527,47.11503383091518,47.798140389578684,1.1483528500785
2022-12-22,0,47.9300012588501,47.591665267944336,51.1324987411499,48.711458921432495,50.79187488555908,-0.33320202094518114,1.1778951433497098,-1.3475206886475355,2.995450036096284,49.791666984558105,1.050708293914795,0.023725583453392707,47.8711669921875,50.86266689300537,0.89139004267739,-0.049282491573695034,0.9654231543515649,0.9862968858353117,0.9984827539868734,-0.010034592479522653,32.76695739705018,52.00241523329366,49.64662494659424,47.29083465989481,48.137857164655415,0.4823042828826088,48.90732152121408,0.9717189909235969,48.35804323625254,49.032211256262094,-1.3410941562951542,-4.92980865717314,13082400,0.36614960486482867,0.6570091979479762,172216200.0,-84.47198787962485,19.18618833600314,16.367993510430818,-101.97033921408247,19.777397778297686,28.562679194727167,-0.031414451578405035,0.8679968178908324,50.113426330566405,49.56495278930664,49.121665954589844,48.67837911987305,48.12990557861328,0.1,0.0,45.85530285114886,-0.01293343663058344,-0.021749518509103574,46.92876597813198,47.58529009137835,1.1781052858433445
2022-12-23,0,47.74166679382324,47.591665267944336,51.1324987411499,48.38895916938782,50.75874996185303,-0.14289326978509684,1.2025146915957106,-1.4701881489570947,2.995436836909139,49.574583530426025,1.0782499361038205,0.024291999219515054,47.8711669921875,50.86266689300537,0.8738897246944849,-0.05733108452885553,0.9644294083051508,0.9858362411200943,0.9965766066908198,-0.0028197499382698332,29.511534028942474,51.907529392728165,49.502500009536746,47.09747062634533,47.95511926923479,0.2997984600171712,48.698928696768625,0.8751657462114062,48.251823943544004,48.90207226949268,-3.2417585231367103,-5.621735940021857,9547500,0.36793497434566946,0.4785581153005518,162668700.0,-79.96069887650049,19.18618833600314,16.367993510430818,-95.57623695680988,18.92752129308094,27.33528064237436,-0.029653399133378194,0.8421876230389475,49.83583865356445,49.3404119720459,48.939998626708984,48.53958528137207,48.04415859985352,0.1,0.0,45.85803073635299,0.007145332673990312,-0.010938381371693104,46.794058663504465,47.41550200326102,1.1717906601814878
2022-12-27,0,47.95750045776367,47.591665267944336,51.1324987411499,48.21375036239624,50.68187475204468,0.029478152827869607,1.2193753402863354,-1.4915241209729238,2.995427007409436,49.27833271026611,1.0991665840148925,0.02471005539421572,47.81366672515869,50.834166812896726,0.8530953052484551,-0.06631461459554724,0.971835704501942,0.9924825341562669,1.0016465322910368,0.007686959213544231,26.74907482767379,51.786084016449124,49.34733333587646,46.9085826553038,47.889642987932476,0.222490415319627,48.53988109316145,0.7818387306248423,48.12604452927049,48.771829946887436,-2.6094319784954956,-5.759075313009307,10044600,0.3529603410767272,0.5132902499840948,172713300.0,-78.05897087671646,19.18618833600314,16.367993510430818,-77.67310661424659,20.134117779945722,26.32539089272071,-0.02264153302214795,0.812031505872879,49.65757179260254,49.19621181488037,48.82333183288574,48.45045185089111,47.989091873168945,0.1,0.0,45.861159545495006,0.007072998484052295,0.007425665881772192,46.72206061226981,47.287366322108674,1.13489441175582
2022-12-28,0,47.445000648498535,47.591665267944336,51.021666526794434,47.95062565803528,50.30291676521301,0.1843354822681236,1.1827576592415552,-1.4694565050956545,2.9954435683669187,48.992916107177734,1.0635249662399289,0.02404536941227705,47.81366672515869,50.78783321380615,0.8591365662938943,-0.06005617373202795,0.9645531004977231,0.9839278426675819,0.989430371330866,-0.007876473048411992,31.190041953743027,51.55409874019025,49.18858342170715,46.82306810322405,47.82797636304583,0.27926419254412066,48.35952397755214,0.7149316318951414,48.084677089519204,48.683369194891085,-0.9466613031495116,-4.436989966518321,15246300,0.363630801460778,0.7763168446900407,157467000.0,-95.90956574013393,19.18618833600314,16.367993510430818,-107.69285035113121,18.445073159306304,30.712408534969317,-0.04096702068225655,0.8230769108540157,49.33585284423828,48.88373983764649,48.518333435058594,48.1529270324707,47.700814025878906,0.12000000000000001,0.0,45.86447891253903,-0.019160038806131596,-0.010574170525547153,46.65424237932478,47.1187504359654,1.1449277866781251
2022-12-29,0,47.42166614532471,47.445000648498535,50.81333351135254,47.91666769981384,50.02354192733765,0.2945416446709334,1.1622945815608963,-1.3762491300413884,2.9954516715557453,48.887500286102295,1.024391484260559,0.02371557860487406,47.726666641235354,50.75349998474121,0.8395132242298705,-0.06512313993106335,0.9675965705124645,0.9877267359352325,0.990499841028719,-0.01835433328452596,27.625957867512287,51.334339290914144,49.00975012779236,46.68516096467057,47.80369077410017,0.30904354223080216,48.20297629492624,0.656862713014194,47.92582422748916,48.536061140582085,-0.901621606202932,-5.053031028691665,9171900,0.3713730738912073,0.4949498056496773,148295100.0,-86.65240978994102,19.18618833600314,16.367993510430818,-91.80514047791087,17.50183238079645,29.141843003120453,-0.09943202025060695,0.8054759865415821,49.33585284423828,48.88373983764649,48.518333435058594,48.1529270324707,47.700814025878906,0.12000000000000001,0.0,45.86662810636784,-0.02087057807611914,-0.013189914836308622,46.624049595424104,46.96476582118443,1.1215454784761183
2022-12-30,0,47.17916774749756,47.42166614532471,50.81333351135254,47.86291694641113,49.702500343322754,0.4404677076794565,1.139259072637982,-1.1954385686095863,2.9954611389353882,48.61291742324829,0.9956665229797366,0.02332476087351255,47.57699880599976,50.671749687194826,0.8248356980513839,-0.06674758634503043,0.9659284989265999,0.9859599075646026,0.9890983565249452,-0.015665209506204647,27.139812875689174,51.121851580334564,48.8433334350586,46.56481528978263,47.71190520695278,0.38811106868740647,48.086488246917725,0.6849382480844461,47.80262285094189,48.39362964432448,-0.35720356004044446,-4.41749705819604,11505900,0.3689549916546632,0.6402960991738572,136789200.0,-89.56344224933274,19.18618833600314,16.367993510430818,-101.92689350382689,16.785810567973165,30.819515715506643,-0.13408556856238135,0.7798464805171943,49.327986297607424,48.8710066986084,48.50166702270508,48.13232734680176,47.67534774780273,0.14,0.0,45.868872399105065,-0.011778605295257871,-0.023350216314799388,46.51907076154436,46.883012771606445,1.0480654767541104
2023-01-03,0,47.66250038146973,47.17916774749756,50.78499984741211,47.80166673660278,49.55520844459534,0.5292371022757817,1.0996911790784187,-0.9888398485206307,2.995477897074225,48.36208391189575,0.9588706731796265,0.022598735158545085,47.442667198181155,50.2316668510437,0.7941763244304256,-0.07100191219353319,0.9794679120892354,0.9986415925760229,1.0023870117569715,-0.0016582247263255967,25.368122709886485,50.861007505022684,48.661625146865845,46.462242788709005,47.61964334760393,0.2860389559704381,47.99345254898071,0.6436451969555302,47.64734169354735,48.211354524724364,-1.3435311107553403,-3.341185531856112,17249700,0.36746328114465726,0.9693298695343595,154038900.0,-70.28750411329538,19.18618833600314,16.367993510430818,-59.55134832355008,21.10851129108326,28.989448483640597,-0.15044193577503684,0.7698574025816629,49.327986297607424,48.8710066986084,48.50166702270508,48.13232734680176,47.67534774780273,0.14,0.0,45.87359181377821,-0.001182412652223408,0.0008363937325335658,46.445679255894255,46.780356543404714,0.912897385618586
2023-01-04,0,47.77499961853027,47.17916774749756,50.65916633605957,47.72187519073486,49.149582386016846,0.6427554957965069,1.0047000502394992,-0.8080047607934744,2.9955186758775283,48.13291692733765,0.8714331817626956,0.020713115969206584,47.442667198181155,49.991416931152344,0.781642999839213,-0.05915347944557064,0.9849398407928074,1.0014480957810852,1.0050876589399609,-0.0038054702078171854,35.057682966921774,50.514900274047726,48.50550017356873,46.49610007308973,47.59750025612967,0.26308776366412395,47.867678710392546,0.46681779645553106,47.64878887228639,48.11849970724974,-1.3368977359156484,-2.660062834798796,13338300,0.3970295980223896,0.7718032553533316,167377200.0,-61.787652520149486,19.18618833600314,16.367993510430818,-50.51469010340839,20.86496863247093,27.195975516557894,-0.12186574164511185,0.7620104343433516,48.90269245910645,48.526986289978026,48.22333335876465,47.91968042755127,47.54397425842285,0.14,0.0,45.877329984261046,-0.00034777242907824135,-6.952488472700671e-05,46.45868573869978,46.693725858415874,0.8016938371296555
2023-01-05,0,47.79249954223633,47.17916774749756,50.18416690826416,47.72187519073486,48.97895812988281,0.684791941203269,0.885095363725099,-0.8038923645337346,2.9955654762886326,47.943750858306885,0.762466659545899,0.018301731200556254,47.442667198181155,49.649000358581546,0.7791247148905233,-0.048006521541700695,0.9882386868951952,1.0014300743367086,1.0062284925075593,0.007324246790768818,38.28315582986008,50.13148256514246,48.361291837692264,46.591101110242064,47.60476207733154,0.2683786569383268,47.77994067328317,0.3282896103577125,47.67867714157296,48.05025258094166,-0.3233916883972619,-3.5546666339122384,13274400,0.3939812197459216,0.7847971274240021,180651600.0,-56.14972389327817,19.18618833600314,16.367993510430818,-43.39861651905916,20.131577101415775,25.905847683454276,-0.10061726054817391,0.7428191110903163,48.36534757995606,48.09232773590088,47.87166786193848,47.65100798797607,47.3779881439209,0.02,1.0,45.881072691992905,0.014013781700834782,-0.003755012230364196,46.43546077183315,46.614759717668804,0.7334975861576382
2023-01-06,0,48.597500801086426,47.17916774749756,49.97000026702881,47.72187519073486,48.8487503528595,0.7935461390440928,0.7868457145694033,-0.5672585276263766,2.995599817315356,47.90333414077759,0.6705500030517584,0.016310486082155507,47.442667198181155,49.543583393096924,0.7416560060614051,-0.04357615995910327,1.0073752017286308,1.018360073701137,1.0216820943520832,0.02479530457994339,39.2351973770945,49.81539989852968,48.24170846939087,46.66801704025207,47.69619069780622,0.4536434137659644,47.79291684286935,0.35763639146756043,47.70723031278514,47.990379615311106,0.10647459928999088,-2.5057357614483524,21231900,0.3946728734644682,1.2417394142122868,201883500.0,-11.424399354783937,19.18618833600314,16.367993510430818,63.88998545424729,27.825961047994532,22.571195564185526,-0.02746722783075616,0.7916653360596481,48.65312118530274,48.325107955932616,48.060001373291016,47.794894790649415,47.466881561279294,0.04,0.0,45.88999250891733,0.03257131585636808,0.03885631545593801,46.57341929844448,46.647739955357146,0.6904015199220782
2023-01-09,0,48.66083335876465,47.17916774749756,49.6133337020874,47.72187519073486,48.650625705718994,0.7047223971301508,0.6865832606841966,-0.5857853524269481,2.995631039581628,47.90333414077759,0.5882000350952155,0.014252425023610335,47.442667198181155,49.07233219146729,0.6826246193025493,-0.020474997852406703,1.0101249458675496,1.0190697014734431,1.0179806644615033,0.03140508156474797,53.27704228295456,49.54625001746214,48.17308349609375,46.79991697472536,47.86988108498709,0.5613992413894577,47.84892872401646,0.42653267571209885,47.930494389451084,48.05676342860396,1.3345156382501717,0.3752209919688671,17756700,0.4398339749541617,1.0257632264862466,219640200.0,-41.27667449085933,19.18618833600314,16.367993510430818,63.38727622669352,26.23032810745769,20.53589300547725,-0.07818388791111851,0.8079749876297633,48.73206723022461,48.38896745300293,48.11166763305664,47.834367813110354,47.49126803588867,0.06,0.0,45.89713099103225,0.022286503166723648,0.01969756992931964,46.743429456438335,46.69883591788156,0.6099185306953153
2023-01-10,0,48.24833297729492,47.17916774749756,49.53583335876465,47.72187519073486,48.61333394050598,0.5977073757009054,0.6142535268317185,-0.5736806810642467,2.995651020787195,47.90333414077759,0.5310500144958497,0.01276358805185571,47.442667198181155,48.97058334350586,0.7453120050065288,-0.003056075795322072,1.0025532120056813,1.0088868632998056,1.0031325061502585,0.012291268631239305,57.31215868231855,49.35396553259106,48.12545847892761,46.89695142526416,47.987976346697124,0.5378535141625901,47.89583356039865,0.4321351271120396,48.11393538644995,48.12395788542372,2.562615014538081,1.6378883176802732,11970600,0.4031084178018213,0.7249294183050946,207669600.0,-42.55321911959977,19.18618833600314,16.367993510430818,18.160065855047637,24.8726752690642,22.69285948288793,0.007897346631090232,0.7912148985111717,48.73206723022461,48.38896745300293,48.11166763305664,47.834367813110354,47.49126803588867,0.06,0.0,45.90122521159684,0.008774427364448778,0.021651793194264194,46.8693117414202,46.74668066842215,0.6066986472099554
2023-01-11,0,48.5649995803833,47.17916774749756,49.53583335876465,47.72187519073486,48.46125102043152,0.724113354697764,0.594847663797317,-0.20546174106193993,2.99565601807157,47.90333414077759,0.4973499679565435,0.012367570215137893,47.442667198181155,48.97058334350586,0.7166619550967662,-0.014636315185533428,1.0097224530971451,1.0144337095315614,1.0072626263978874,0.016535844440836334,50.021763067247505,49.28707043440616,48.097375106811526,46.90767977921689,48.18595232282366,0.4359169394112543,47.948928764888215,0.4666117655262375,48.14881668444991,48.149024659230555,1.7432260381507405,1.3797956126424695,14834700,0.410884929102037,0.9110597893926176,222504300.0,-24.53907064174613,19.18618833600314,16.367993510430818,69.21150553090608,26.015886901016085,21.674372011582562,-0.005491231334671556,0.769223376283498,48.73206723022461,48.38896745300293,48.11166763305664,47.834367813110354,47.49126803588867,0.06,0.0,45.907003526164516,0.016485806430079242,0.017618380219467045,47.07090813773019,46.79498944963728,0.5554650673450089
2023-01-12,0,48.50250053405762,47.17916774749756,49.53583335876465,47.72187519073486,48.45312571525574,0.7735966836375893,0.5716106309297946,0.1353385946830996,2.9956618062982585,47.90333414077759,0.4733499336242673,0.011889389343740772,47.442667198181155,48.69683322906494,0.5888121413488484,-0.01959861604326018,1.0088425263476808,1.011844235194721,1.0026805806769497,0.014855908324983735,52.628336520538085,49.22059634006089,48.07737507820129,46.9341538163417,48.30595234462193,0.37981185405873624,47.962797846112935,0.48078638393964523,48.25154090910102,48.189019317997904,2.937380837878914,1.5543851017253045,12472800,0.39467209856107194,0.7926213162821378,210031500.0,-43.26242861641652,19.18618833600314,16.367993510430818,61.63732710166106,24.367035945010556,21.362171361805483,0.01321842953706242,0.7626121536686431,48.73206723022461,48.38896745300293,48.11166763305664,47.834367813110354,47.49126803588867,0.06,0.0,45.91155467354826,0.010748946915845936,0.0073038847771780616,47.12711388724191,46.78639657156808,0.49829030365427274
2023-01-13,0,48.375,47.17916774749756,49.02083206176758,47.72187519073486,48.437500953674316,0.26389596040506175,0.47618360579620633,-0.8143294613563268,2.995683159262359,47.90333414077759,0.4113499641418457,0.009915181291311932,47.442667198181155,48.60383405685425,0.5627972944498307,-0.01057369909708691,1.0072730121928863,1.0069628736348986,0.9971177176056766,-0.004578441224727614,53.71007510693711,48.97807564855835,48.02570843696594,47.07334122537353,48.39166668483189,0.29915726395071895,47.994583470480784,0.4930058938222811,48.31142781826604,48.189862471345386,1.7623921235035893,0.40193300719086555,13699800,0.37931384457054707,0.8893433045103997,196331700.0,-36.4539200503865,19.18618833600314,16.367993510430818,61.693440269785256,22.86052303757625,21.71325864395586,0.06345575840196815,0.7548064110132416,48.73206723022461,48.38896745300293,48.11166763305664,47.834367813110354,47.49126803588867,0.06,0.0,45.916390042474355,-0.010151248032658211,0.014099261651686986,47.19818387712751,46.828434807913645,0.4672494757508042
2023-01-17,0,48.300832748413086,47.17916774749756,48.66083335876465,47.72187519073486,48.38520860671997,-0.01225362537552486,0.42695990112360765,-1.1094399064968223,2.9956926997799247,47.90333414077759,0.3726000404357904,0.008896218050101936,47.442667198181155,48.56824970245361,0.6266873105209482,-0.0008434105776190451,1.0064053767123855,1.003427785133049,0.9965030044115328,-0.00739815957727985,54.09665428200661,48.84733663612477,47.99341683387756,47.13949703163035,48.464285714285715,0.15774731197625402,48.034523895808626,0.4935897546244554,48.32533261108224,48.1816158889625,1.2558877786720215,0.9284346535829372,15122400,0.35526030093222655,0.9893737708393033,181209300.0,-48.93626691859917,19.18618833600314,16.367993510430818,51.060201009626034,21.74510201787851,20.653815469458404,0.014484494693420048,0.736844099169374,48.73206723022461,48.38896745300293,48.11166763305664,47.834367813110354,47.49126803588867,0.06,0.0,45.92154607305794,-0.0037253991967421962,-0.016146610097488075,47.25113786969866,46.8432993207659,0.45678313560860206
2023-01-18,0,47.48083305358887,47.17916774749756,48.66083335876465,47.72187519073486,48.325000047683716,-0.002635120353023199,0.421977593935919,-1.0559412867056133,2.995693609822262,47.90333414077759,0.3656999397277829,0.008793459288918679,47.442667198181155,48.56824970245361,0.6878573049158503,0.008859550008083292,0.9894382508946251,0.9840995087596869,0.9810427332020809,-0.015907283761850022,55.30407386042308,48.831621937826064,47.98766674995422,47.14371156208238,48.30476175035749,0.3917062882703337,48.00047622408186,0.5152753199662771,48.31763796548199,48.15681770797697,1.0636254873581605,1.1712325776237622,22674300,0.3327244399768282,1.5744532815605172,158535000.0,-95.12199282340427,19.18618833600314,16.367993510430818,-112.41628908934067,19.129057675947717,29.556708126896133,0.06829954423890636,0.7777836320173073,48.70610708618164,48.34694721984863,48.05666732788086,47.76638743591309,47.40722756958008,0.02,1.0,45.92603498667499,-0.027751009008695315,-0.028354652046517145,46.9752197265625,46.77431951250349,0.5033580663707673
2023-01-19,0,46.71166706085205,47.17916774749756,48.66083335876465,47.64479160308838,48.325000047683716,0.05611484536109718,0.4357767218109302,-1.201635599624696,2.9956910130961543,47.8758339881897,0.38153329849243106,0.009084761860788692,47.442667198181155,48.56824970245361,0.594158758403607,-0.0023288156388618845,0.9738114730056795,0.9685222597886,0.9682211333053672,-0.03816189715936624,42.13888419425803,48.83942849512027,47.96787505149841,47.09632160787655,48.02630942208426,0.6817889095600322,47.948095253535676,0.6054671266476801,48.10961257858306,48.04138400626931,-2.2977884234585884,-0.9939371310533734,17342100,0.37720591776587903,1.1947618722834343,141192900.0,-99.55889162688995,19.18618833600314,16.367993510430818,-202.50961933753055,17.54429797955189,32.217902958702645,0.000978652495192054,0.7874657935103826,48.57315992736817,48.131753089904784,47.77499961853027,47.41824614715576,46.97683930969238,0.04,0.0,45.927657388360934,-0.04995541823762595,-0.04162635153713116,46.69094140189035,46.71718542916434,0.6189677800932009
2023-01-20,0,46.574167251586914,46.71166706085205,48.66083335876465,47.61708354949951,48.325000047683716,-0.43374798941534176,0.5096975523652876,-0.4035993689967525,2.9956756261565594,47.8758339881897,0.42070837020874025,0.010635566319796622,47.397416305541995,48.56824970245361,0.5455338971144679,-0.02321122898609407,0.9718364200394528,0.9678050699723392,0.9728454922985579,-0.03975739933483757,32.33898293440946,48.94327024587437,47.923875141143796,46.90448003641322,47.78714288984026,0.861010522239546,47.887559618268696,0.6975188116299524,47.7619624447808,47.86139798000874,-4.00561635174199,-1.5456498632584417,29543100,0.40897282289983966,1.9510962868008714,111649800.0,-75.54176385485252,19.18618833600314,16.367993510430818,-165.331116845379,16.170079381810964,31.55498756311577,0.05211628935848689,0.7933610176839428,48.524386978149415,48.05280704498291,47.67166709899902,47.290527153015134,46.81894721984863,0.06,0.0,45.93056344168951,-0.02948687837800945,-0.03825352852646732,46.490274156842915,46.67979294913156,0.6578153699287552
2023-01-23,0,47.1924991607666,46.574167251586914,48.66083335876465,47.471874952316284,48.325000047683716,-0.5651147776379716,0.5886120954050007,-0.46491686529863374,2.995656470157713,47.86125040054321,0.48308334350585935,0.012298237484006611,47.13241767883301,48.56824970245361,0.6477477554273599,-0.03589786737365635,0.986022147138432,0.9831429275096573,0.9937668938378994,-0.024444461792938466,28.659936618352145,49.03872435865668,47.86150016784668,46.68427597703668,47.59107140132359,0.8090598092522056,47.88851186207363,0.696485667518462,47.46654231213765,47.67445832859034,-3.4698934085367257,-1.7871554557796736,13149900,0.38842089578999295,0.8701072225072976,124799700.0,-53.87002863975907,19.18618833600314,16.367993510430818,-63.725517639386304,21.431000973284945,28.9278320781137,0.07993911660797112,0.8035969865199653,48.524386978149415,48.05280704498291,47.67166709899902,47.290527153015134,46.81894721984863,0.06,0.0,45.933186088635246,-0.01823941812154184,-0.014985190694867876,46.32816096714565,46.69953455243792,0.6470598593771049
2023-01-24,0,48.093332290649414,46.574167251586914,48.66083335876465,47.43916702270508,48.319374561309814,-0.3532817591278494,0.5964449718075927,-0.7168550860398915,2.9956543238020252,47.7837495803833,0.4886125612258908,0.01247643829723942,47.13241767883301,48.56824970245361,0.7431107468575556,-0.01538706611127658,1.006016516518618,1.004850816114701,1.0178052238675386,-0.004296001662010496,41.36380884386549,48.99859839965461,47.805708456039426,46.61281851242424,47.53261879512242,0.7444363232709895,47.91928556987217,0.6952482472567243,47.39613306581423,47.58479715784117,-2.8261102264501794,0.028256991179650647,13669200,0.4126549490275093,0.9027159339347609,138468900.0,-49.94844843367091,19.18618833600314,16.367993510430818,8.052810346875743,27.802818909640067,24.57575492251848,0.06679585167925088,0.8783399499633536,48.524386978149415,48.05280704498291,47.67166709899902,47.290527153015134,46.81894721984863,0.02,1.0,45.93693127113285,-0.009625516221337005,-0.015624062563109817,46.245013100760325,46.68606349400112,0.6474099155158268
2023-01-25,0,47.31750011444092,46.574167251586914,48.66083335876465,47.43916702270508,48.319374561309814,-0.3842323577435723,0.5992026788157322,-0.7362024333699484,2.9956536175248147,47.7837495803833,0.4975957679748532,0.012531983210315432,47.13241767883301,48.56824970245361,0.712892610978962,0.007366007943226438,0.9896186014392419,0.9898144065482503,1.002266452409701,-0.0034399762734492745,54.17166833712121,49.01228036526086,47.81387500762939,46.61546964999793,47.38154738289969,0.6457585446255806,47.88660703386579,0.7130750588215037,47.56898410276638,47.642781514441,-0.8436023687498179,0.9039221730532349,12491700,0.46075146983510856,0.8170108731375717,125977200.0,-56.96595706988692,19.18618833600314,16.367993510430818,-61.65022329453319,25.82041604141034,24.477238081914518,0.06033985751420632,0.8782204551591268,48.524386978149415,48.05280704498291,47.67166709899902,47.290527153015134,46.81894721984863,0.02,0.0,45.93934619211968,0.010650354160760989,-0.014334286715630752,46.10798263549805,46.653083256312776,0.6503072795299571
2023-01-26,0,47.5625,46.574167251586914,48.66083335876465,47.39562463760376,48.319374561309814,-0.28878941180098233,0.6088125797752079,-0.9012258235961013,2.9956510332148127,47.7837495803833,0.5166832685470581,0.012738619167922252,47.13241767883301,48.56824970245361,0.6729863711981516,-0.013345156382501718,0.9951840587755458,0.9968805487175549,1.0081535500562007,0.018214570206615655,44.69606485753876,49.010291833210694,47.79266667366028,46.57504151410986,47.27607127598354,0.5182995257279153,47.870178495134624,0.7180421621810609,47.50512746430772,47.5990323296559,-2.186046275057534,-0.957612784390075,15819000,0.49064022483290837,1.0154552168458109,141796200.0,-58.30759691753521,19.18618833600314,16.367993510430818,-27.663695455974327,26.91359093707174,23.133172430171264,0.03192251789017215,0.8628714149845392,48.524386978149415,48.05280704498291,47.67166709899902,47.290527153015134,46.81894721984863,0.02,0.0,45.942932453732865,0.024346152581819824,0.009727311249553202,46.00579016549246,46.62846401759556,0.6531147224350289
2023-01-27,0,47.676666259765625,46.574167251586914,48.66083335876465,47.39562463760376,48.319374561309814,-0.19418438439360156,0.6095514908131714,-0.9421019560612578,2.9956508012160117,47.71875,0.5181664943695068,0.012759352653075243,47.13241767883301,48.56824970245361,0.6942186303854933,0.0024765380945396464,0.9979852519428513,1.0013774741907269,1.0069415075170778,0.023671899536564345,48.975721677550005,48.992019632398446,47.772916650772096,46.55381366914575,47.304047448294504,0.5361710986494529,47.804404599326,0.6878327994522473,47.51574650311591,47.61101729460803,-1.5286128755975614,-0.481246104387295,18412800,0.48079040979329096,1.1700651222376428,160209000.0,-47.058844370958475,19.18618833600314,16.367993510430818,-4.537478046389212,26.88044623835097,21.403209844946666,0.07487767080594357,0.8659995854872343,48.524386978149415,48.05280704498291,47.67166709899902,47.290527153015134,46.81894721984863,0.02,0.0,45.947611668927145,0.019638310754503063,0.03219740038752585,46.12005833217076,46.54763902936663,0.6369759934293613
2023-01-30,0,47.332499504089355,46.574167251586914,48.66083335876465,47.39562463760376,48.319374561309814,-0.24787177759824996,0.6053970674070378,-0.872528175563394,2.995651929126776,47.72583293914795,0.5075332450866696,0.012669318885349244,47.13241767883301,48.56824970245361,0.6897372536811905,0.0053772913347132235,0.9905408568072157,0.9958761523976881,0.9950387322872765,0.002966580406047692,50.40738912451261,48.995294066149526,47.784499931335446,46.57370579652137,47.3927377973284,0.46899001981776395,47.70952360970633,0.6512515789598361,47.554373533069125,47.67039210341381,0.4124468624123174,-1.8948187173036992,15897600,0.4813261639464333,0.9890968275995943,144311400.0,-52.50602590627582,19.18618833600314,16.367993510430818,-57.81639696783625,25.356390278877363,21.530331579322016,0.1081782003120486,0.8524757765012941,48.1907723236084,47.782945976257324,47.45333290100098,47.12371982574463,46.71589347839355,0.02,0.0,45.950714352030715,-0.0034352701165879518,0.011455688229910808,46.274274008614675,46.48260770525251,0.6369759934293613
2023-01-31,0,47.64416694641113,46.574167251586914,48.66083335876465,47.328749656677246,48.319374561309814,-0.23216499816934358,0.6083736795738756,-0.9120787474905985,2.9956511269887383,47.72583293914795,0.5115457439422606,0.012732799286284499,47.13241767883301,48.56824970245361,0.6604983842230937,0.0032499885842079057,0.9971562466604338,1.0046372310195955,1.0010014877772277,-0.009339451496597762,47.02447978694106,48.996788958421426,47.78004159927368,46.563294240125934,47.54559489658901,0.30257551708194824,47.66636889321463,0.6325501131457416,47.49946290075499,47.67731505437887,1.3290736175793858,-2.729780324315053,14103600,0.4846948523878175,0.870445906338006,158415000.0,-31.980799038586284,19.18618833600314,16.367993510430818,-9.385143150823085,27.8011904614659,20.18266174223711,0.12697198280310332,0.844441639874383,48.1907723236084,47.782945976257324,47.45333290100098,47.12371982574463,46.71589347839355,0.02,0.0,45.954243132637224,0.005943312741639506,0.008623089749403021,46.428954533168245,46.45961434500558,0.6278618245387679
2023-02-01,0,48.05333232879639,46.574167251586914,48.66083335876465,47.44374966621399,48.319374561309814,-0.31614805976591653,0.5936738162812077,-0.7094883742076856,2.995655051041648,47.72583293914795,0.4916999816894531,0.01241909912303333,47.14441595077515,48.56824970245361,0.6897732565749609,-0.0003846511389847571,1.005230618257056,1.0146699735963862,1.0115071379110065,0.015550952873161217,49.50287586779027,48.99063919178178,47.80329155921936,46.61594392665694,47.66857106345041,0.3099920427262685,47.629821232386995,0.5899842723273585,47.53691515637629,47.7125699960144,2.297410255441037,-1.2522008401162839,12849300,0.4772949418850165,0.8039500184887294,171264300.0,-22.434397853206875,19.18618833600314,16.367993510430818,42.26302683148345,30.370679198833997,18.54409224091211,0.0963118208062307,0.8534101813654815,48.1907723236084,47.782945976257324,47.45333290100098,47.12371982574463,46.71589347839355,0.02,0.0,45.95816843518256,0.016369295742956202,0.011536931996224,46.52324948992048,46.42570522853306,0.6347302652531337
2023-02-02,0,47.985833168029785,46.574167251586914,48.66083335876465,47.44374966621399,48.319374561309814,-0.4079739762063568,0.5951484164863353,-0.6835906464804982,2.9956547005732626,47.7837495803833,0.4991166210174562,0.012444859018236089,47.14441595077515,48.56824970245361,0.679660246815705,0.005825907116452548,1.003408413945497,1.012021302571889,1.006966914081452,0.008900565950691997,54.06865729745456,49.013129989558365,47.822833156585695,46.632536323613024,47.65321404593332,0.2872724247942502,47.592916420527864,0.5456940931959343,47.666990241824166,47.75947298781163,1.8240889618862084,-1.053572029255386,17806800,0.48553277143246587,1.0987690772661094,153457500.0,-34.964185973465526,19.18618833600314,16.367993510430818,17.285109618944286,28.71423922630676,17.532683327697608,0.04986296357391117,0.838166553380435,48.1907723236084,47.782945976257324,47.45333290100098,47.12371982574463,46.71589347839355,0.02,0.0,45.96314810484196,0.009914917411299573,0.008992546186076242,46.551120213099885,46.398066656930105,0.6344110601754577
2023-02-03,0,47.49083423614502,46.574167251586914,48.66083335876465,47.44374966621399,48.319374561309814,-0.45808861767403,0.5960742894141634,-0.6671429868205694,2.995654476932249,47.88916635513306,0.5048749446868896,0.01246147259067569,47.14441595077515,48.56824970245361,0.6825018983020812,0.004045271279912858,0.9928388787305106,0.9988975203286138,0.9948120404467308,-0.0038977562442831237,53.1029246325855,49.025523412888994,47.83337483406067,46.64122625523235,47.67797606331961,0.2596548775382899,47.52976172310965,0.4972302816866745,47.74832721574141,47.80980782594824,-0.22352188442664747,-1.0652386172647679,17155500,0.4858773574652096,1.0460549542413837,136302000.0,-57.75651924534486,19.18618833600314,16.367993510430818,-51.3517960437702,26.227012530599445,21.825920977786883,0.032214616307398795,0.8521070013367995,48.1907723236084,47.782945976257324,47.45333290100098,47.12371982574463,46.71589347839355,0.02,0.0,45.9666069329039,-0.011095463096365,-0.003515862630401149,46.52185658046177,46.31491960797991,0.6465749708862185
2023-02-06,0,47.05250072479248,46.574167251586914,48.66083335876465,47.44374966621399,48.319374561309814,-0.38146303345492094,0.6007164199481201,-0.7752318265510536,2.9956532348787697,47.831249713897705,0.519958209991455,0.012562481850368342,47.14441595077515,48.56824970245361,0.6675430956058143,-0.022772088002448596,0.9839853993348441,0.9877733452659985,0.9863980214414061,-0.005915571377604567,44.214479469920335,49.019724408652344,47.8182915687561,46.61685872885986,47.60511902400425,0.3524323985385364,47.4405951499939,0.45876183155029826,47.686218691750106,47.778628542542116,0.36632138486792415,-1.8277328451782542,17454000,0.45997511540234964,1.0766567384036871,118848000.0,-70.04772927463793,19.18618833600314,16.367993510430818,-95.83687580364146,24.68914411940493,22.897264104516033,-0.022452244915781627,0.8405281041954596,48.1907723236084,47.782945976257324,47.45333290100098,47.12371982574463,46.71589347839355,0.02,0.0,45.96909349380379,-0.010341088035178414,-0.018283125147058318,46.450787680489675,46.22828892299107,0.617905220810448
2023-02-07,0,46.72833251953125,46.574167251586914,48.66083335876465,47.328749656677246,48.26145792007446,-0.22012124853683224,0.594858036470384,-0.9119813726703869,2.995654571352545,47.66041660308838,0.5115622901916502,0.012460097580007922,47.01841735839844,48.508750438690186,0.6048779119910968,-0.03305189251721847,0.9787874538926307,0.9812564708470797,0.980753603882895,-0.019222383044497082,39.316924792546764,48.930757637882174,47.741041564941405,46.551325492000636,47.46964277539934,0.4796544664593076,47.386845111846924,0.49623687493533297,47.52984038320981,47.66487314203604,-1.0722718006991212,-2.584493791489794,16341300,0.4665892402681386,1.0124391864576896,102506700.0,-66.46782883012065,19.18618833600314,16.367993510430818,-110.68334934189316,22.868361197992165,24.99494666192313,0.06527207733786128,0.8426331633167056,48.1907723236084,47.782945976257324,47.45333290100098,47.12371982574463,46.71589347839355,0.02,1.0,45.970941382933205,-0.02008769539976296,-0.008230828653771874,46.34302193777902,46.231540134974885,0.6171631549507638
2023-02-08,0,46.80333423614502,46.574167251586914,48.5649995803833,47.28624987602234,48.13208246231079,-0.16082127191520346,0.5945568249989692,-1.0369876354586514,2.995654354201514,47.603333473205566,0.5001081180572513,0.012479045151328572,46.72666597366333,48.38775005340576,0.6172959266745842,-0.03150368860368638,0.9823466767311748,0.9856567187067605,0.986118788783296,-0.026012724447463498,37.15575188260456,48.833530172977675,47.64441652297974,46.455302872981804,47.39404773712158,0.5424584418948997,47.393392767224995,0.48716470165773273,47.33231004459702,47.52645778874246,-1.989094067666964,-1.5848511613271683,11691300,0.46373070329214705,0.7249717236658035,114198000.0,-75.53693726912073,19.18618833600314,16.367993510430818,-95.93541696903111,22.121178459883186,24.178281553127167,0.03244995998644023,0.8088735753486244,48.1907723236084,47.782945976257324,47.45333290100098,47.12371982574463,46.71589347839355,0.02,0.0,45.97232016774548,-0.030759726514252073,-0.02537019711690222,46.25337164742606,46.263822828020366,0.625020115988015
2023-02-09,0,47.07499980926514,46.574167251586914,48.5649995803833,47.15749955177307,48.063332319259644,0.022712836819610685,0.6044939877449299,-1.100390458397199,2.9956515447472345,47.52666711807251,0.5047164583206175,0.01270688369118371,46.72666597366333,48.38775005340576,0.6107387010767527,-0.03627438195119155,0.9895492088686113,0.9924525081027333,0.9970946648619071,-0.018981297158584765,37.114716655494064,48.7811545614121,47.57216658592224,46.36317861043238,47.31273814610073,0.5413748210756607,47.42916652134487,0.43831932287465375,47.20300888126729,47.415447059710345,-1.1179744857940959,0.1962404278433318,13064400,0.4559249984326013,0.8145880623230575,127262400.0,-63.99492150019584,19.18618833600314,16.367993510430818,-50.21426652777117,23.50250928435415,22.928166628828887,0.005326735475754741,0.79204902892951,48.231678726196286,47.84915888214111,47.53999900817871,47.23083913421631,46.848319290161136,0.02,0.0,45.97440802215842,-0.014621928326174372,-0.02177374537143999,46.14421190534319,46.28658321925572,0.567939776177174
2023-02-10,0,47.743332862854004,46.574167251586914,48.50250053405762,47.06937503814697,48.002707958221436,0.12276661893321152,0.5682742343015317,-1.0433867856474326,2.9956607335518552,47.48583364486694,0.471516489982605,0.011964255825843907,46.72666597366333,48.30824947357178,0.584200445138788,-0.029431487223841462,1.0051721754580107,1.0075781064332399,1.0151676069115338,0.005316786507759685,41.81386139682707,48.63421506596939,47.49766659736633,46.36111812876327,47.26845250810896,0.47988257659122824,47.46851178577968,0.44015959757401685,47.16988026816472,47.33270334263626,-1.1946208185068696,1.075344095736157,15002700,0.46313976215759567,0.9281241532391271,142265100.0,-36.00507849980417,19.18618833600314,16.367993510430818,50.582128555009874,27.79925595058202,21.262410045100744,0.06277155046494529,0.7930931931405515,48.231678726196286,47.84915888214111,47.53999900817871,47.23083913421631,46.848319290161136,0.02,0.0,45.978146270716884,0.014184019625439692,0.0006964651249949048,46.100084577287944,46.311667033604216,0.5471645833248364
2023-02-13,0,48.4375,46.574167251586914,48.375,47.06937503814697,47.80395793914795,0.026504576602349693,0.5234766472079705,-0.9829253203461557,2.995671447459473,47.48583364486694,0.43498735427856444,0.011029917100410866,46.72666597366333,48.11408233642578,0.4953673075619037,-0.013057718597333253,1.0206025663240257,1.0220840498715293,1.0288229727509863,0.029435189498392633,51.55711355168562,48.506661508222095,47.45970821380615,46.41275491939021,47.33297634124756,0.606165196909096,47.493095193590435,0.48506167793485766,47.30887165670056,47.35170062245745,-0.6451154392816435,1.167206043085205,16015800,0.49162101852450424,0.9837509536041631,158280900.0,-2.8265182273536604,19.18618833600314,16.367993510430818,161.25201422254824,32.33809192729205,19.731387144374775,0.07936052970665991,0.7935867544704572,48.12217489624023,47.76058117675781,47.46833419799805,47.17608721923828,46.81449349975586,0.02,1.0,45.98378329699284,0.03717644456920244,0.029637927460316304,46.20645686558315,46.37878853934152,0.5673257048369796
2023-02-14,0,48.575833320617676,46.574167251586914,48.4375,47.06937503814697,47.80395793914795,0.06468247304466625,0.5290878194693294,-0.9334557854946244,2.995670153419494,47.48583364486694,0.4377998542785647,0.011147413326253488,46.72666597366333,48.11408233642578,0.39791869016751047,0.0028295009383953996,1.0234499297966009,1.0226186230315255,1.025726303922351,0.039537058171596806,59.226717026361996,48.52100885274481,47.46283321380615,46.40465757486749,47.48797621045794,0.7698719715710363,47.582976136888774,0.5607063438580714,47.5887173569227,47.475479575493665,0.941250369434316,0.7156245844447361,13831200,0.5175101144428873,0.8529469442728009,172112100.0,-19.43123913556401,19.18618833600314,16.367993510430818,163.1409162464929,32.87181030237123,18.21857010161122,0.10155360414378532,0.7980921827408649,48.37938488769531,47.968638473510744,47.63666534423828,47.30469221496582,46.89394580078125,0.04,0.0,45.98876797870002,0.0319904873106307,0.034191010724344856,46.38204084123884,46.45194871085031,0.5938653542979708
2023-02-15,0,48.5575008392334,46.574167251586914,48.575833320617676,47.06937503814697,47.80395793914795,0.21470414426220902,0.553688683568735,-0.7479753435070529,2.9956643216151955,47.48583364486694,0.450174880027771,0.011662353222463158,46.72666597366333,48.127749061584474,0.5396985371770286,0.023061943032737973,1.0227673838974012,1.0202316619126404,1.0174010684237533,0.037479522169035606,63.476857874807024,48.583960609553856,47.47658324241638,46.36920587527891,47.70297622680664,0.8353528295872229,47.65404762540545,0.6180399405274509,47.83191578935204,47.61137424826737,2.284649452729279,2.6593399971118186,14674200,0.4797549100249985,0.9278204830303921,157437900.0,-6.635001044070628,19.18618833600314,16.367993510430818,146.08170788382517,30.849880015392394,17.097954037723873,0.20714094615284237,0.78965704862758,48.37938488769531,47.968638473510744,47.63666534423828,47.30469221496582,46.89394580078125,0.04,0.0,45.99415999908475,0.04528601923140818,0.03965110152951831,46.65563528878349,46.55321148463658,0.6526340308885195
2023-02-16,0,48.326666831970215,46.574167251586914,48.575833320617676,47.06937503814697,48.002707958221436,0.1879771759330316,0.601740279540227,-0.9803973881270527,2.995652193629622,47.52666711807251,0.5025831699371338,0.012660109508464084,46.72666597366333,48.44950008392334,0.6154140606492712,0.03951547642212704,1.0167524346870669,1.0143072023896074,1.005175638088344,0.026588784445597202,66.4236904376302,48.73389719077906,47.53041663169861,46.32693607261815,47.93130970001221,0.7372236758419342,47.70047623770578,0.643749841224232,48.01159742893568,47.75499083490438,3.1985549997514093,2.0919859957601017,16312200,0.43923593286837603,1.034757058362323,141125700.0,-33.88619358967753,19.18618833600314,16.367993510430818,88.69277186720757,28.628169106318172,17.01165637803022,0.21462283506232596,0.7901576302721488,48.37938488769531,47.968638473510744,47.63666534423828,47.30469221496582,46.89394580078125,0.04,0.0,45.99930256569984,0.019431857559012,0.02888317288195267,46.808458600725444,46.57574026925223,0.5900042149775085
2023-02-17,0,48.5674991607666,46.574167251586914,48.575833320617676,47.163124322891235,48.063332319259644,0.03525686999802747,0.594772208036765,-1.0330966019232766,2.9956542524394987,47.603333473205566,0.49824986457824705,0.012492283853925559,46.79583406448364,48.44950008392334,0.6136691197945597,0.03762814632662247,1.020086307654248,1.0186332361443584,1.0049522339832573,0.017262437464935054,62.77905705298879,48.800711036328046,47.611166620254515,46.421622204180984,48.183333260672434,0.5699107746429912,47.788690498897004,0.6733816751370914,48.09230283398182,47.86695746904223,3.4204822347788717,1.3633515578943192,24770700,0.4423436517344517,1.5954684052078945,165896400.0,-8.175344204323267,19.18618833600314,16.367993510430818,125.97018194731824,28.649827760468778,15.772997787131724,0.20123417824858905,0.7913368943872366,48.37938488769531,47.968638473510744,47.63666534423828,47.30469221496582,46.89394580078125,0.04,0.0,46.0083055317118,0.018925426181874982,0.034765336795210405,47.09738213675363,46.675376892089844,0.6102994017726501
2023-02-21,0,48.391666412353516,46.72833251953125,48.575833320617676,47.28624987602234,48.151665925979614,0.028365994136712824,0.5794659274485504,-1.1566837871809041,2.9956585236213558,47.66041660308838,0.49433318614959704,0.012145374297460479,47.027584075927734,48.55850067138672,0.6606753327091168,0.029135986109061665,1.0142699917555786,1.0126586633627443,0.9979103454498527,-0.0009462418094757785,63.7520020079815,48.8697650706106,47.7108332157135,46.5519013608164,48.37142848968506,0.29329470465299157,47.84208331789289,0.6904591135133124,48.213240064973036,47.993511575774,3.769314629852081,2.609200168206935,54393900,0.42645999926464373,3.0926957571870597,111502500.0,-10.466302195130629,19.18618833600314,16.367993510430818,112.38615446519877,23.863529627407125,19.66926999669393,0.25427301379925554,0.8821939318511098,48.68753326416016,48.217899856567385,47.83833312988281,47.45876640319824,46.989132995605466,0.06,0.0,46.02796010287872,0.009732079559617635,0.02511814973374219,47.367261614118306,46.755736759730745,0.6753098510946953
2023-02-22,0,48.44499969482422,46.72833251953125,48.575833320617676,47.328749656677246,48.34291672706604,-0.1673399755055631,0.5847469010495744,-1.1559177600401993,2.9956573018339245,47.709999561309814,0.5052040147781369,0.012240678492656268,47.027584075927734,48.55850067138672,0.7613586040714415,0.006203232495954651,1.0141133963716384,1.0109416903553359,0.9991990398549271,-0.0026933892194892506,57.633375784553486,48.94028538039199,47.770791578292844,46.6012977761937,48.471666608537944,0.09721586388730864,47.870059558323454,0.7074039140623843,48.257752616025016,48.04552103775793,2.7969550895871427,1.5689212632957774,29844000,0.3818055108000059,1.6222562864877206,141346500.0,-42.48698457123205,19.18618833600314,16.367993510430818,59.97634397061963,20.936540528566315,17.256729196511593,0.22200574030839787,0.9337038309778992,48.68753326416016,48.217899856567385,47.83833312988281,47.45876640319824,46.989132995605466,0.06,0.0,46.03715000492057,-0.008591578211617046,-0.011445272269153373,47.39141573224749,46.74575015476772,0.6762993909171151
2023-02-23,0,47.62833309173584,46.72833251953125,48.575833320617676,47.328749656677246,48.40312480926514,-0.18009950500057412,0.5992878832770173,-1.2366157403704208,2.9956535792228878,47.709999561309814,0.5245457220077512,0.012540453278079256,47.027584075927734,48.55850067138672,0.803128379913816,0.023828384374837187,0.9966510295246864,0.9903518878568318,0.9828854017435903,-0.019135411243134115,62.385836754432006,48.98695071505562,47.788374948501584,46.58979918194755,48.35607133592878,0.33496610256954895,47.84452383858817,0.7093530640602186,48.30231522510978,48.05445395291567,1.4696645372157007,0.8150680650988316,22021200,0.33312227835933317,1.1668050913801804,119325300.0,-64.76678960663165,19.18618833600314,16.367993510430818,-43.26565084699934,19.024404263567376,20.79615649421785,0.18246901843934013,0.9541536445322003,48.68753326416016,48.217899856567385,47.83833312988281,47.45876640319824,46.989132995605466,0.02,1.0,46.04142092553195,-0.03056549646329587,-0.02336924433365944,47.21397454398019,46.71021570478167,0.6790514931814876
2023-02-24,0,47.131667137145996,46.72833251953125,48.575833320617676,47.4512505531311,48.40312480926514,-0.2425457761662995,0.5908459515994683,-1.1321876299268356,2.995655811480288,47.709999561309814,0.5105582380294799,0.012359781240853806,47.027584075927734,48.55850067138672,0.7943722116357864,0.0013841385910294843,0.9859373560145201,0.9783462443796294,0.9763803064971919,-0.024727542227962473,46.434656427243524,48.98560850056527,47.80391659736633,46.62222469416739,48.149761881147114,0.5516851326285176,47.81886904580252,0.7293420105085999,48.13537239455404,47.974550032217756,-1.6705381331905242,-0.7450117101064052,20623500,0.38265265684046856,1.079013043273532,98701800.0,-60.82895532654199,19.18618833600314,16.367993510430818,-72.97997145674556,17.51362958725522,22.063885598278166,0.24771743932642146,0.9624286348895168,48.68753326416016,48.217899856567385,47.83833312988281,47.45876640319824,46.989132995605466,0.04,0.0,46.0446425207604,-0.012476556699020591,-0.027972980652783603,47.0736928667341,46.72786685398647,0.6764557039980533
2023-02-27,0,47.32499980926514,46.72833251953125,48.575833320617676,47.282291412353516,48.40312480926514,-0.18209143184933704,0.6068910646041211,-1.2814095585959813,2.9956515480363985,47.709999561309814,0.5299457168579103,0.01270114901541695,47.027584075927734,48.55850067138672,0.7657923405640232,-0.011431149981213223,0.9904279528718137,0.9822438512046058,0.985263553190048,-0.02558293865180461,39.54752567328934,48.996157083431875,47.782374954223634,46.56859282501539,47.97369030543736,0.5948545945920121,47.838333266122,0.7107146687524457,47.88643009197199,47.83722138018964,-2.9730137081533368,-0.7562871968369494,16647300,0.3973780154556571,0.8750211891968604,115349100.0,-71.50255564911116,19.18618833600314,16.367993510430818,-61.518036349172995,17.3244946216446,20.72231904336167,0.2264425243909295,0.9515409733456194,48.68753326416016,48.217899856567385,47.83833312988281,47.45876640319824,46.989132995605466,0.04,0.0,46.04734250057498,-0.03414353316902452,-0.01961589214085164,46.83540071759905,46.745518003191265,0.6937682722022742
2023-02-28,0,47.22749996185303,46.72833251953125,48.575833320617676,47.27666664123535,48.40312480926514,-0.10970969369141623,0.6147426094085182,-1.3697257662755784,2.995649409759903,47.69374990463257,0.545770707130432,0.012870203939098745,47.027584075927734,48.55850067138672,0.780692309795447,-0.0001584470480704448,0.9887513029683351,0.9810720418381023,0.9883469491026984,-0.024057168037579624,43.938077303118895,48.99427685051564,47.76479163169861,46.535306412881575,47.81666646684919,0.630175125345312,47.873988083430696,0.6615667516264464,47.74806148840755,47.750596189815205,-2.5382299514319895,0.5791383673027043,18054000,0.3930202289353574,0.9436129336750494,97295100.0,-70.48802982476651,19.18618833600314,16.367993510430818,-54.32485423607089,16.5656305153117,19.81462017736767,0.22306367290538096,0.9240498787763901,48.753612976074216,48.32485939025879,47.97833251953125,47.63180564880371,47.203052062988284,0.04,0.0,46.05040312395201,-0.03529488771784728,-0.029431698993798203,46.735996791294646,46.77222769601004,0.693981336443776
2023-03-01,0,46.82166767120361,46.72833251953125,48.575833320617676,47.20354175567627,48.40312480926514,-0.0977699378873861,0.6188466743122607,-1.3997886172989433,2.9956482852762765,47.69374990463257,0.5504956865310667,0.012957550530697505,47.027584075927734,48.55850067138672,0.794789704360058,-0.00874539342931027,0.980362584084952,0.9750925224232796,0.984651750865945,-0.03350876321285312,41.26135790864717,48.997235003211316,47.75954165458679,46.521848305962266,47.56726196834019,0.6289645953958776,47.875297614506316,0.6592986920979927,47.62008259245724,47.6692439479962,-2.2744520617135553,1.0682329443558425,14180100,0.3864867568902823,0.7409909874602008,83115000.0,-91.3043977494546,19.18618833600314,16.367993510430818,-104.26384767590025,15.387190384495751,22.477420777579958,0.17971177007973319,0.9237604709312869,48.74102722167969,48.304487533569336,47.95166778564453,47.598848037719726,47.162308349609376,0.06,0.0,46.05175017052788,-0.02835562538166947,-0.048734154686901655,46.443822043282644,46.77060209001814,0.7335816263007648
2023-03-02,0,46.71500015258789,46.72833251953125,48.575833320617676,47.11750030517578,48.40312480926514,-0.04297142218548207,0.651609359919019,-1.51837978444185,2.995639017390981,47.68583297729492,0.589999771118164,0.01365530135127654,46.819834327697755,48.55850067138672,0.7785643575968559,-0.025631201789822335,0.9789721326099358,0.9764381920371812,0.9891622337694578,-0.01917625245017074,34.3523372422715,49.02163541066445,47.718416690826416,46.41519797098838,47.3277382169451,0.5800409319569308,47.84958335331508,0.6987531999699694,47.42044209518687,47.54479077064833,-3.5946497549400105,0.03917121580717492,14785500,0.3814547803528472,0.7687376387424428,68329500.0,-87.40255929370639,19.18618833600314,16.367993510430818,-94.22721372170966,14.875200796955351,21.72951260816646,0.1905418701076244,0.8873014296347093,48.74102722167969,48.304487533569336,47.95166778564453,47.598848037719726,47.162308349609376,0.06,0.0,46.05313600214177,-0.011190194500110717,-0.025929126349731445,46.1265629359654,46.74691227504185,0.7521128506860232
2023-03-03,0,46.8891658782959,46.71500015258789,48.575833320617676,47.06937503814697,48.40312480926514,0.09256427397777693,0.6817996323202836,-1.5537782696157236,2.9956299536731064,47.55958366394043,0.6167331552505495,0.014308041323920452,46.79583406448364,48.55850067138672,0.7934755468518528,-0.02648350422492149,0.9840018844651691,0.9838676798397376,0.9967052011295726,-0.005145187377829319,33.36313194025018,49.01509934665656,47.65150008201599,46.28790081737542,47.105476243155344,0.32066459314936996,47.78857142584665,0.7445353033722407,47.240472065850476,47.41194203249697,-3.4647830588813995,-0.7647363954027935,16888800,0.38156948613380937,0.8801943757368047,85218300.0,-85.5073295824243,19.18618833600314,16.367993510430818,-76.41753862395929,15.537984359187906,20.872996320546402,0.21630903096454138,0.8577321454739146,48.74102722167969,48.304487533569336,47.95166778564453,47.598848037719726,47.162308349609376,0.06,0.0,46.054936282562245,-0.012634270206778875,-0.009993801711064771,45.96073259626116,46.676074164254324,0.7705533463673694
2023-03-06,0,46.845831871032715,46.71500015258789,48.575833320617676,47.011667013168335,48.40312480926514,0.2523453957257255,0.696643942095993,-1.561875988570786,2.9956252878147627,47.40791702270508,0.6303331756591796,0.014636401877264804,46.79583406448364,48.55850067138672,0.8378170285791627,-0.012669146952807044,0.9842250540158087,0.9859322618494579,0.9968117310776339,-0.010125048920520241,38.64828224289347,48.98995460172128,47.596666717529295,46.20337883333731,46.99369035448347,0.23220608997260228,47.674880845206125,0.759200922715023,47.14723508622254,47.34507534799948,-3.211546756794681,-1.7890811833596927,16720800,0.371169412731104,0.8724269657820983,68497500.0,-85.73034281267144,19.18618833600314,16.367993510430818,-71.06751451380558,15.104512180079146,20.29069021246706,0.2503979589689831,0.8193226847104279,48.74102722167969,48.304487533569336,47.95166778564453,47.598848037719726,47.162308349609376,0.06,0.0,46.05671560844901,-0.005585516658009881,-0.01277467111601677,45.89384242466518,46.55390848432268,0.7836091307693168
2023-03-07,0,46.74166679382324,46.71500015258789,48.575833320617676,46.8783323764801,48.40312480926514,0.31063607343490496,0.7154721060680309,-1.60295389730941,2.9956193103741224,47.27624988555908,0.6593582820892336,0.015042171379832634,46.79583406448364,48.55850067138672,0.8425091743267388,-0.004392303290500127,0.9827024094002447,0.9873174914573255,0.9966275719401697,-0.010287082069180165,39.56794830703288,48.995360811409746,47.564416599273684,46.13347238713762,46.937976019723074,0.24023172223625336,47.54386895043509,0.7499689226594508,47.06818493489178,47.307914929112016,-1.6429322000330504,-3.2860245243195565,17387400,0.35866084104605417,0.907365238853042,51110100.0,-95.18317731026781,19.18618833600314,16.367993510430818,-88.73802749330122,13.851712500593734,22.13779846992744,0.23645670832977914,0.8296091450805788,48.69539981079102,48.23063299560547,47.85499954223633,47.47936608886719,47.01459927368164,0.08,0.0,46.05805955115856,-0.020263122444451498,-0.015483574073726929,45.744271414620535,46.40898214067732,0.8122572002285994
2023-03-08,0,46.0716667175293,46.71500015258789,48.575833320617676,46.83979082107544,48.40312480926514,0.30236068640022234,0.7296586593887332,-1.6167227738640164,2.995614707949437,47.27624988555908,0.6733458089828488,0.015345445310356092,46.74033336639404,48.55850067138672,0.8273389227255858,0.00028535737470235646,0.9689328467136611,0.9765687826901783,0.9843812369905247,-0.016018245205212667,39.17719179420128,49.00819222150269,47.54887490272522,46.089557583947744,46.75892843518938,0.3470268512464286,47.366309370313374,0.7849762441332753,46.98531096703202,47.26856699006376,-0.827469866889945,-3.7758827824698056,19090800,0.3518461356193268,0.9891611342803804,32019300.0,-92.58586686367879,19.18618833600314,16.367993510430818,-137.5035021527548,13.05671810477289,25.2664011896363,0.2028184148579349,0.8172563216239925,48.576612976074216,48.03835939025879,47.60333251953125,47.16830564880371,46.630052062988284,0.1,0.0,46.05799667690118,-0.014627184143371275,-0.028354372035035446,45.58912549700056,46.212263107299805,0.872929801652453
2023-03-09,0,45.99166679382324,46.0716667175293,48.575833320617676,46.83979082107544,48.40312480926514,0.09247892715168848,0.7789521456878952,-1.3449603369431642,2.995597958778311,47.27624988555908,0.7028957700729371,0.01639345617293436,46.739000129699704,48.55850067138672,0.7779387255710171,-0.015632807588538734,0.9679187329780254,0.9798021268440246,0.9858314745651239,-0.015483963532098577,30.024663583210636,49.07394590400092,47.51604161262512,45.958137321249325,46.58238083975656,0.38155680867034747,47.199523653302876,0.8127991167021843,46.75862018767033,47.15860142302127,-2.648353083543946,-5.11936174378975,15415800,0.38163270522358433,0.7911131022622916,16603500.0,-97.8108919275074,19.18618833600314,16.367993510430818,-138.85865605029707,12.264070662366152,24.79343277690833,0.1884918957796931,0.8079286126500278,48.54829322814941,47.992519798278806,47.54333305358887,47.09414630889893,46.53837287902832,0.12000000000000001,0.0,46.05766609904168,-0.02370097624574996,-0.021262853103265558,45.358729771205354,46.04736328125,0.9454819326307001
2023-03-10,0,45.6966667175293,45.99166679382324,48.575833320617676,46.83979082107544,48.40312480926514,-0.052549451177741936,0.8342108692440232,-1.235389146648928,2.9955778346821345,47.27624988555908,0.7394208049774171,0.017571412686907407,46.65066680908203,48.55850067138672,0.8171451531824189,-0.023012915981545617,0.9625323990772571,0.9769237506548727,0.9825549819351633,-0.025432296318979475,27.496852599576048,49.143879978997084,47.475458240509035,45.807036502020985,46.42166641780308,0.4864738824949243,46.994464193071636,0.8032090389188137,46.56909069923177,47.06302154979248,-2.616766013504848,-4.831700986674023,20065200,0.3746037483455825,1.011541745153004,-3461700.0,-92.81637785506824,19.18618833600314,16.367993510430818,-138.11940723483409,11.467069952040436,25.645139169579966,0.16249514394594286,0.8023622504773196,48.483000350952146,47.88683386993408,47.40500068664551,46.923167503356936,46.32700102233887,0.14,0.0,46.05672653838893,-0.026302695630359252,-0.025124587942529142,45.21101597377232,45.827419008527485,1.026293937136333
2023-03-13,0,45.76083469390869,45.6966667175293,48.575833320617676,46.80166745185852,48.40312480926514,-0.17419998321688196,0.9172485407123556,-1.1736360855240973,2.995544858281228,47.27624988555908,0.8014457941055297,0.019348564776653948,46.06366672515869,48.55850067138672,0.8393804709388933,-0.04286810372463724,0.9652852362362105,0.9813060207631885,0.9890064710603915,-0.023161018468217942,20.16238678828834,49.241038667346956,47.40654158592224,45.572044504497526,46.2853570665632,0.522897893600721,46.80654764175415,0.7576366471633214,46.354215975400294,46.93550165239756,-2.402735762370586,-5.911015582116686,28142100,0.3362244673576667,1.3732392046639803,24680400.0,-88.85017699476741,19.18618833600314,16.367993510430818,-114.41845939758618,11.4665691939497,24.162589683196,0.11762215788082654,0.7907649032746741,48.28690592956543,47.728212989807126,47.27666664123535,46.82512029266358,46.266427352905275,0.14,0.0,46.05587557756828,-0.023320281836264778,-0.023459163221679267,45.0656247820173,45.59609385899135,1.0791342964971125
2023-03-14,0,45.92166709899902,45.6966667175293,48.575833320617676,46.735000133514404,48.40312480926514,-0.07678990829446404,0.9804413692181932,-1.2971734911633717,2.995517372631948,47.17958354949951,0.8488249063491822,0.020724897660392056,45.96858358383179,48.55850067138672,0.8554090601095239,-0.055260186964465725,0.9707075618200948,0.9880691617826669,0.9971590414559824,-0.01754322751135995,16.680154944430956,49.26829941591136,47.307416677474976,45.34653393903859,46.147142955235076,0.46088620616185083,46.62630959919521,0.6267044865843098,46.2078150758455,46.80728936066412,-2.04252478981602,-5.436538795806421,25542600,0.2822396287782938,1.218079631122534,50223000.0,-75.7246892609296,19.18618833600314,16.367993510430818,-97.44992730785998,11.013047473337808,23.20691941581173,0.1313233861878588,0.7645197112077926,47.471973373413086,47.069013618469235,46.74333381652832,46.417654014587406,46.014694259643555,0.14,0.0,46.055452363367074,-0.008258594502201122,-0.018130045026705646,44.94624655587332,45.45348957606724,1.069435594371727
2023-03-15,0,46.08749961853027,45.6966667175293,48.575833320617676,46.55416679382324,48.34291672706604,0.09655329655312646,0.9887377910396173,-1.2942578672134821,2.9955128174410723,47.01041650772095,0.8410373830795287,0.02095599272725602,45.90558385848999,48.55850067138672,0.861174454765184,-0.05463964362896704,0.9768103490894446,0.9944313179122362,1.0043365813312448,0.00034365809029757166,21.1334863561469,49.159100614504155,47.181625032424925,45.204149450345696,46.03880977630615,0.34344702481809886,46.51625006539481,0.56992188246754,46.13854067847675,46.694294827114774,-2.0633738331112257,-5.208654374488073,33133500,0.2834531872497551,1.5105531514478443,83356500.0,-49.28580653915762,19.18618833600314,16.367993510430818,-66.77020405830727,14.654386236210247,21.021330924885472,0.20149928919941784,0.7837206478871411,47.14600035095215,46.80533386993408,46.53000068664551,46.254667503356934,45.914001022338866,0.14,0.0,46.05625374332623,0.011151352084237454,0.002800663087021241,44.899331774030415,45.3965870993478,1.03411371399336
2023-03-16,0,46.269999504089355,45.6966667175293,48.5674991607666,46.08354139328003,47.802916526794434,0.26923287507242083,0.961658770781394,-1.1923621182818434,2.995523816367683,46.86749887466431,0.8085957813262936,0.020435950294449435,45.90558385848999,48.45624980926514,0.861705709958649,-0.05086755244840398,0.983271237906402,0.9999531655923147,1.0082440352332058,0.006051807417936317,26.697463205136,48.98052588888334,47.057208347320554,45.133890805757765,45.9714287349156,0.19807171391767783,46.454702377319336,0.544299825007095,46.128151188757286,46.61059908450129,-1.6187827651137492,-3.2351194618501604,28905600,0.2904987397760977,1.2763967544295414,112262100.0,-68.71428828336896,19.18618833600314,16.367993510430818,-64.80393326681158,13.852215661364879,19.870638371801043,0.1287479907671015,0.769883469650924,47.14600035095215,46.80533386993408,46.53000068664551,46.254667503356934,45.914001022338866,0.14,0.0,46.05680043736285,0.012223874058568729,0.005407385483414418,44.88060052054269,45.312435967581614,0.9642654980781635
2023-03-17,1,46.22249984741211,45.6966667175293,48.5674991607666,46.08354139328003,47.40083312988281,0.4396506236802609,0.9111240012224654,-0.9704745063007469,2.995544426558665,46.833749771118164,0.7500665855407718,0.019409224743145524,45.90558385848999,48.396999740600585,0.8713413439478968,-0.04255760768752798,0.9846550925282667,0.9998882331355334,1.005988733179509,0.011507034706343289,33.10096989687905,48.76508128300829,46.942833280563356,45.12058527811842,45.992976324898855,0.21799594149849455,46.37595238004412,0.48525080108424967,46.16432881125354,46.57312441326036,-1.0090938601192887,-1.82821377938811,43081200,0.29752467706370533,1.7961950743599044,69180900.0,-49.542672023530194,19.18618833600314,16.367993510430818,-53.779583360240956,13.02782239958539,19.59641316186444,0.2334888823339096,0.7601297431632166,47.033946395874025,46.714693367004394,46.45666694641113,46.19864052581787,45.87938749694824,0.02,1.0,46.05802402007947,0.021912568825546597,0.02042244474402153,44.96752657209124,45.2783260345459,0.9305136639233663
2023-03-20,0,46.89416694641113,45.6966667175293,48.5674991607666,46.08354139328003,47.251874923706055,0.6460337046497006,0.8656052198907889,-0.5861054565426804,2.995562156741884,46.78166723251343,0.6913038635253905,0.018480980219637035,45.90558385848999,48.396999740600585,0.8258436193096313,-0.04828330372935509,1.0012071921912902,1.015882822757061,1.0182762453945933,0.024766424390709307,30.53309502766053,48.568835371117025,46.83762493133545,45.10641449155387,46.1219049181257,0.40433445921019695,46.35214287894113,0.44691807709960374,46.17957297375278,46.5333663749916,0.32738804699119706,-2.329635427990395,33928500,0.2864810853482778,1.388089396418301,103109400.0,-17.495725640074358,19.18618833600314,16.367993510430818,22.87770745429027,19.561940187692446,18.0611146279006,0.1926973910591465,0.765834772408034,46.848040817260745,46.56431424713135,46.33500099182129,46.10568773651123,45.82196116638183,0.04,0.0,46.06197497484143,0.02990097261237512,0.0329086391430433,45.16761234828404,45.2631710597447,0.8232421760838917
2023-03-21,1,46.89416694641113,45.6966667175293,48.44499969482422,46.08354139328003,47.155625343322754,0.6782255442679558,0.7699408434705367,-0.1939950611561958,2.9955971650948294,46.78166723251343,0.6060415267944336,0.01646792851614034,45.90558385848999,47.70466642379761,0.7903732214392641,-0.030945399837689787,1.0029988610767877,1.0157764610407887,1.0132889243360255,0.021177363733672294,48.82636264032688,48.29384000755875,46.75395832061768,45.214076633676605,46.29297637939453,0.4456495499996554,46.357321398598806,0.45315357386151833,46.35820591067045,46.57949057544342,1.9623123393934006,-0.7058027964875061,19013400,0.33646553024539844,0.8385712612904058,103109400.0,-25.728996747364224,19.18618833600314,16.367993510430818,19.878714940888784,18.41513391165219,17.88481484757239,0.12512217354006058,0.7554181991344128,46.848040817260745,46.56431424713135,46.33500099182129,46.10568773651123,45.82196116638183,0.04,0.0,46.063822545706856,0.02096691378732074,0.026392500045264,45.3546017238072,45.28280884878976,0.6350548461845456
2023-03-22,1,46.73666763305664,45.6966667175293,48.44499969482422,46.08354139328003,46.95354199409485,0.6290916944817222,0.6738554548776535,0.2435103563510177,2.995628379540178,46.78166723251343,0.5410165786743164,0.014435918757524912,45.90558385848999,47.355333137512204,0.7009964329903512,-0.032012235693723703,1.0012336207484542,1.0120305567263503,1.005659141614642,0.014085555083256374,48.55071295996392,48.02679425707586,46.67908334732056,45.33137243756525,46.43238108498709,0.4019271451487463,46.35886907577515,0.4545041287636983,46.49156759284746,46.611517787864955,2.620541748228812,0.15484129210568087,18548400,0.3355726335180887,0.8389606213095835,84561000.0,-41.166355536449345,19.18618833600314,16.367993510430818,15.904255987097551,17.37704144335513,17.100797806978925,0.11518944099635084,0.743364478280004,46.848040817260745,46.56431424713135,46.33500099182129,46.10568773651123,45.82196116638183,0.04,0.0,46.06531399103727,0.0032356866674385643,0.014423121032938736,45.48103332519531,45.273329053606304,0.5510594268716451
2023-03-23,1,46.829166412353516,45.6966667175293,47.62833309173584,46.08354139328003,46.89416694641113,-0.04869877708305467,0.5394700623430041,-1.0266937101290856,2.9956652308277105,46.73916721343994,0.4726832962036127,0.01157818433359905,45.90558385848999,47.23724994659424,0.7667750172750203,-0.018721324069053243,1.0050543278642152,1.0125754209694042,1.0048422594017132,0.012084869553861566,49.48076763977648,47.672606868918194,46.59366674423218,45.51472661954617,46.56202384403774,0.3531363489631637,46.354583399636404,0.44937304937603184,46.550167086217336,46.601824141008734,2.132463154737525,0.04638227635229854,22044300,0.2885690809942037,0.9970311995419255,106605300.0,-21.78402262907978,19.18618833600314,16.367993510430818,48.197905646127204,17.44649800837447,15.935501102445528,0.13213158112656037,0.7407433622427718,46.848040817260745,46.56431424713135,46.33500099182129,46.10568773651123,45.82196116638183,0.04,0.0,46.06756430312371,0.017139136929909426,0.011361155998694064,45.626260484967915,45.28625352042062,0.5353517526952094
2023-03-24,1,47.156667709350586,45.6966667175293,47.32499980926514,46.08354139328003,46.89041614532471,-0.28900747660109366,0.48854637636790627,-1.2040505151846206,2.995677151395143,46.73916721343994,0.44071662902832004,0.010494252618126617,45.90558385848999,47.141250419616696,0.8119001883680468,-0.0064182054904242895,1.012951906940986,1.0178137365015536,1.0094473081666422,0.020210241008649765,54.769836399848856,47.53080116299888,46.55370841026306,45.57661565752725,46.71476214272635,0.3448083662246245,46.376785959516255,0.4820056347818654,46.61880330085554,46.61594137410026,1.9761898264670652,-0.12796019041608805,22752300,0.26960776916480517,1.0241227418688372,129357600.0,-10.501656523041211,19.18618833600314,16.367993510430818,101.7515760065064,19.1817672188643,14.966699136454533,0.10740421566344754,0.732356906174852,46.9881082611084,46.67761487579346,46.42666816711426,46.175721458435056,45.865228073120115,0.06,0.0,46.0708824113756,0.01721658984321106,0.02545559934296356,45.75359072004046,45.32646124703543,0.5329770050772418
2023-03-27,0,47.89333438873291,45.6966667175293,47.32499980926514,46.08354139328003,46.89041614532471,-0.28289100966060193,0.490053242627252,-1.2053355186486014,2.9956768148208797,46.73916721343994,0.4417166519165036,0.010526338311969334,45.90558385848999,47.16375093460083,0.7490349550660581,-0.0035569382058739125,1.0287483008199203,1.0304664798246934,1.0211326537743828,0.021306859837463055,60.64814364197585,47.5350649241278,46.55495843887329,45.57485195361878,46.94666712624686,0.504664268130991,46.45904793058123,0.6258732535761021,46.753442630386154,46.6758704628908,2.3198656895468357,0.6635293384769148,26775600,0.27666082228860156,1.1783585602035314,156133200.0,-9.11137715300842,19.18618833600314,16.367993510430818,203.36660838493555,25.167596452262295,13.467288901442535,0.13365813351452022,0.7557600823979949,47.62732116699219,47.194674530029296,46.845001220703125,46.495327911376954,46.06268127441406,0.08,0.0,46.07743989867346,0.023208095862435885,0.034218106419861574,46.0283077784947,45.454454149518696,0.633156422021994
2023-03-28,0,47.89333248138428,45.6966667175293,47.89333438873291,46.08354139328003,46.89041614532471,0.2334056478065925,0.5470456961500763,-0.3138742832180168,2.9956633789872704,46.73916721343994,0.46445003509521426,0.011743367546447439,45.90558385848999,47.16375093460083,0.6558302400617365,0.014098447460011558,1.028120704195813,1.0257599879427988,1.0168003875211455,0.02130681916399002,71.85894154345962,47.67746656014683,46.58337516784668,45.48928377554653,47.185357502528596,0.5001768883680268,46.589166913713726,0.7212382491079475,47.03930717393866,46.81794798511619,3.508396157428279,2.4638992870957206,21282900,0.32164155297080704,0.9300243311554153,134850300.0,-15.410648541489664,19.18618833600314,16.367993510430818,176.13594472242283,24.057554021161792,12.873300431353792,0.10919428535528397,0.7341580046299683,47.62732116699219,47.194674530029296,46.845001220703125,46.495327911376954,46.06268127441406,0.08,0.0,46.08236182173777,0.02271745421661775,0.019233453106371843,46.22466605050223,45.59609631129673,0.6870395369623494
2023-03-29,0,48.084166526794434,45.6966667175293,47.89333438873291,46.08354139328003,46.89041614532471,0.4610957892854358,0.6026651076410549,-0.2458253377807309,2.9956488653199047,46.73916721343994,0.49108333587646485,0.012928103811165423,45.90558385848999,47.230334186553954,0.7593546009560547,0.022888223839147067,1.0314801514973533,1.0255166087992078,1.0165391643454569,0.028831728105165766,74.80469435493855,47.82199700910535,46.61666679382324,45.41133657854113,47.355357442583355,0.5804922311774952,46.738631180354524,0.800368351135885,47.25317622230983,46.92196392733021,3.6147604294182587,3.953982769982739,24216900,0.30468279717037394,1.0355262617762362,159067200.0,-8.436446023531834,19.18618833600314,16.367993510430818,170.81473068845145,24.677063191620856,12.228399456500522,0.11412155709905643,0.71767057897107,47.62732116699219,47.194674530029296,46.845001220703125,46.495327911376954,46.06268127441406,0.08,0.0,46.088465349826464,0.03375873569968957,0.027132954949011974,46.379981994628906,45.77379717145647,0.7672133006495153
2023-03-30,0,48.565834045410156,45.6966667175293,48.084166526794434,46.08354139328003,46.89416694641113,0.5372496991484674,0.6817602063000404,-0.4957345424343176,2.995625889516645,46.73916721343994,0.5415832901000982,0.014605039588586154,45.90558385848999,47.89333267211914,0.7943836711199496,0.029308923680495688,1.0404038286942159,1.03139728838485,1.020905458570111,0.03708517076226481,77.60568769192784,48.04331214920286,46.67979173660278,45.3162713240027,47.594167028154644,0.6922396246786074,46.94357170377459,0.876734991177757,47.46236619953869,47.048494125361415,2.537628148386103,4.549736678063204,21879000,0.3035423949945798,0.9215797896907659,180946200.0,-9.281477818221688,19.18618833600314,16.367993510430818,190.86929523110152,28.15265377475683,11.273783295835914,0.08516546058061819,0.7228370315823315,48.078428665161134,47.590788642883304,47.19666862487793,46.802548606872556,46.314908584594725,0.1,0.0,46.09537614525405,0.03569131936970882,0.044079655394856435,46.624847412109375,45.989724567958284,0.8794572890588472
2023-03-31,0,49.07833385467529,45.6966667175293,48.565834045410156,46.08354139328003,46.959792137145996,0.6514274802673397,0.7962592615159888,-0.46440711572208215,2.99558788087855,46.78541660308838,0.6222498893737793,0.017024150883695018,45.90558385848999,47.912417602539065,0.791758283256277,0.03575811460298029,1.049302659377071,1.0372241171251284,1.0242007321198376,0.04075067723548376,81.27439539162683,48.36485195427587,46.772333431243894,45.17981490821192,47.92869077410017,0.7702031320796899,47.18053592954363,0.9752652171081201,47.73891971219504,47.2300287443911,3.564765530240341,6.2787234474155715,20868000,0.31647706404289744,0.8716895752518357,201814200.0,-8.439847295028308,19.18618833600314,16.367993510430818,197.5392913435102,31.57688831500715,10.265136801373027,0.07479714671804248,0.7371581160663818,48.55723957824707,47.986379600524906,47.52499961853027,47.06361963653565,46.492759658813476,0.12000000000000001,0.0,46.10341385976762,0.039844923784379205,0.04834703614057101,46.994712829589844,46.23787307739258,1.03126880448685
2023-04-03,0,49.40583324432373,45.6966667175293,49.07833385467529,46.08354139328003,47.34083390235901,0.776872164923357,0.9419379369613777,-0.3514571919816776,2.9955314489056772,46.78541660308838,0.7405668258666992,0.0200917648449896,45.90558385848999,48.132333278656006,0.7988772225693109,0.04765636331933842,1.0538384160616132,1.0378813377324236,1.0228315628222227,0.031580571177492356,84.7715260277988,48.76566770398561,46.881791830062866,44.99791595614012,48.2967860358102,0.7728534133760978,47.42940493992397,1.0693256535771147,48.0726497283263,47.44808138480109,5.01034057456506,7.249647395982049,19766700,0.3284264441995991,0.8204670345064609,221580900.0,-2.1242618377108835,19.18618833600314,16.367993510430818,176.410033430069,31.697065597152395,9.756107728165825,0.08979110116274382,0.7202182506327889,48.68712109375,48.09144082641602,47.61000061035156,47.128560394287106,46.532880126953124,0.14,0.0,46.11175618826401,0.03135171959502947,0.04858948737441112,47.36970738002232,46.49798393249512,1.1931706475672719
2023-04-04,0,49.29750061035156,45.6966667175293,49.40583324432373,46.08354139328003,47.893332958221436,0.7667089460948917,1.0905675846188778,-0.5341901749450257,2.995464720082643,46.78541660308838,0.900895895957946,0.02319873244638635,45.90558385848999,48.61708402633667,0.8271927968746724,0.05699767751655251,1.0486645147579579,1.030170055143425,1.014237083856755,0.02931865577558357,87.09287153978309,49.19092706796517,47.009791898727414,44.82865672948966,48.602619307381765,0.6621475569151132,47.65869072505406,1.1030729642783326,48.403726148016176,47.67320530181029,5.502269268005786,7.587194379972004,18113700,0.32723497424557113,0.7507234754173777,203467200.0,-15.140855002558803,19.18618833600314,16.367993510430818,133.25632091484013,29.818076443880447,10.785349869905026,0.08558745201969041,0.7109169579151534,48.75634814453125,48.20349478149414,47.75666809082031,47.30984140014648,46.75698803710937,0.14,0.0,46.118834345640664,0.02520735062997015,0.02122494178652715,47.622969491141184,46.68828010559082,1.266100156750049
2023-04-05,0,49.488332748413086,45.6966667175293,49.40583324432373,46.08354139328003,47.94104242324829,0.6094318957839303,1.1962829699720865,-0.9573463754799625,2.9954118293543557,46.861666679382324,1.0274334144592288,0.025378538288865424,45.90558385848999,49.10025053024292,0.8642227333624465,0.07001773807316816,1.04986995471232,1.028990032677159,1.0123142614116722,0.02920225768780238,88.81897011410929,49.53014952949801,47.137583589553834,44.74501764960966,48.8304762159075,0.6517422971329129,47.88857167107718,1.1265093353574556,48.62419586555959,47.838951200260176,4.5398307492717,6.965014414734386,26540700,0.2736969875707806,1.083257621581645,230007900.0,-1.7086997493286251,19.18618833600314,16.367993510430818,134.94212147555962,30.714087903745725,9.815347027344972,0.13014681735497977,0.7253753104087246,48.99318627929688,48.395073272705076,47.91166687011719,47.4282604675293,46.830147460937496,0.16,0.0,46.13049336562683,0.03771746138653098,0.04219772344901859,47.879495348249165,46.95390156337193,1.3694244979431553
2023-04-06,0,49.93000030517578,45.6966667175293,49.488332748413086,46.18874979019165,48.204583406448364,0.4443755466860285,1.2733424789974195,-1.1992692179594862,2.995371410710637,46.89416694641113,1.1239332771301265,0.026915770230244655,45.90558385848999,49.30833387374878,0.8691431709874675,0.07602825029727889,1.0554147356085184,1.0322674032876886,1.0155150978310927,0.02808901126849994,90.2144821086858,49.85510184909287,47.30841689109802,44.76173193310317,49.12142876216343,0.6173531250087074,48.15339313234602,1.1404153269092803,48.83925080738043,48.0329694121372,3.3303138736053532,6.955550635005504,17891700,0.2672947356729718,0.7265778571563454,247899600.0,-2.0725859690315946,19.18618833600314,16.367993510430818,136.5652126473763,31.966982619696925,9.012524243363847,0.1826057425868492,0.7335627991359162,49.435708099365236,48.87214801025391,48.41666793823242,47.961187866210935,47.39762777709961,0.18,0.0,46.13921960074101,0.03521675570120775,0.04555223208821177,48.21484647478376,47.219756262642996,1.4509411009796227
2023-04-10,0,50.14666557312012,45.6966667175293,49.93000030517578,46.258124589920044,48.69395899772644,0.335915410408022,1.3563068718462685,-1.2695805600583614,2.995325912722449,47.02541732788086,1.2088666105270385,0.028550623056733677,45.90558385848999,49.41408319473267,0.8469841851540701,0.09263987707931819,1.0556007464456134,1.0301428116081754,1.0142933943841268,0.021767888893869936,93.8915749847823,50.217947310358184,47.50533356666565,44.79271982297311,49.41607148306711,0.525078808131942,48.38571446282523,1.1941837302110967,49.10964871657657,48.26477473079887,4.252508059620071,8.020986467635298,14519100,0.24770747086994427,0.5963328186974249,262418700.0,-5.231600622653028,19.18618833600314,16.367993510430818,126.66248270745362,30.79350765378223,8.606404277017468,0.19564756304618425,0.7133083679787771,49.45607995605469,48.888626815795895,48.43000030517578,47.97137379455567,47.403920654296876,0.19999999999999998,0.0,46.1464812777193,0.02075271757627073,0.033225890852063844,48.50775255475725,47.44386727469308,1.4775273445375956
2023-04-11,0,50.14083290100098,45.76083469390869,50.14666557312012,46.62000060081482,49.13312554359436,0.2614242432989575,1.4054643559828577,-1.3292297372576742,2.9952997054170947,47.52500009536743,1.2504998683929442,0.029447478601866993,46.07091636657715,49.53249950408936,0.8497504697379439,0.09584245804404506,1.0505574884533206,1.0237349751000073,1.0098112876470189,0.014876778882414454,94.30964154570268,50.53876222141091,47.72783350944519,44.91690479747947,49.64107131958008,0.42861160662688974,48.61761917386736,1.1974903811325788,49.3683804123595,48.49929998718301,4.2893517665037955,6.935827712699995,18370500,0.2448918379197308,0.7699697343488107,244048200.0,-9.005109602244064,19.18618833600314,16.367993510430818,110.76389432984584,29.338152277476375,8.713358430567345,0.1967074603963478,0.6952148477281334,49.45607995605469,48.888626815795895,48.43000030517578,47.97137379455567,47.403920654296876,0.19999999999999998,0.0,46.15545161838436,0.0092811371815269,0.017768674969549668,48.712974548339844,47.66891098022461,1.466780252262378
2023-04-12,0,49.93916606903076,45.92166709899902,50.14666557312012,46.8060417175293,49.324583768844604,0.16234795799571164,1.4230401193814988,-1.4220193507551562,2.9952924418302658,47.893333435058594,1.2615999031066891,0.029679543316698986,46.20899982452393,49.9510835647583,0.8636947221960706,0.09187745281342193,1.041552955787237,1.0149600958244624,1.0027810800809216,0.01301618643409408,94.02226120612882,50.7929136585628,47.9468334197998,45.1007531810368,49.76404735020229,0.357904259195392,48.846369062151226,1.113474054326065,49.56217018635205,48.697970439018405,3.2430182381263353,6.923389764658811,11209800,0.25017014189536,0.48439013070988834,232838400.0,-15.305265954568014,19.18618833600314,16.367993510430818,92.77529377299926,27.511701522767073,9.727295464169472,0.14274229612003073,0.6884139506630774,49.45843955993652,48.89244617462158,48.43499946594238,47.977552757263176,47.411559371948236,0.19999999999999998,0.0,46.160718302312056,0.014331205136368874,0.004371550691152296,48.80112566266741,47.89791924612863,1.4283174045410334
2023-04-13,0,49.77833366394043,46.08749961853027,50.14666557312012,46.87791681289673,49.42645812034607,0.028177703249816905,1.4064483546679163,-1.4987404437381366,2.9953056548449286,47.98875045776367,1.2663124036788944,0.02921111725420909,46.26524953842163,49.95933275222778,0.878759982665619,0.08357290984282123,1.0338671424019958,1.0075022178076742,0.9969823978678096,0.005859985564711678,86.80788591127663,50.96060507763723,48.147708368301394,45.334811658965556,49.817261695861816,0.3216201536811428,49.05702386583601,0.9725427950151286,49.65714248083134,48.843192001603306,1.7539964109304502,6.852218179348773,13272600,0.26738426873040083,0.599240283271807,219565800.0,-15.494244771014662,19.18618833600314,16.367993510430818,74.21410838938951,25.783109800223677,12.501991892863265,0.09553270608492581,0.682098559481445,49.545760208129884,49.03378722381592,48.6200008392334,48.206214454650876,47.69424147033691,0.19999999999999998,0.0,46.16660826031993,-0.00120251729243126,0.015350174796150516,48.83843994140625,48.104073660714285,1.4054398201161975
2023-04-14,0,49.62916564941406,46.22249984741211,50.14666557312012,46.89416694641113,49.56083297729492,-0.12026998329226857,1.365564085855517,-1.5129956487751541,2.995332606754164,48.325000286102295,1.24483323097229,0.02825368328314119,46.69000082015991,49.95933275222778,0.8863691343740585,0.07582308617792413,1.0268333375116714,1.0010505327139374,0.9928414576756046,-0.006025128258021151,81.18542784592167,51.06337824228292,48.3322500705719,45.60112189886088,49.864642415727886,0.24837845716319085,49.23363086155483,0.8121787228320478,49.687537142869985,48.959489947641835,0.7539604033689605,6.297714602942249,10464900,0.2794684379861327,0.49299924954103286,209100900.0,-31.654728580053792,19.18618833600314,16.367993510430818,61.20528401690689,24.20019429642937,11.910906030080625,0.12169511726465418,0.6748059360223243,49.71725326538086,49.311373443603514,48.983333587646484,48.655293731689454,48.24941390991211,0.02,1.0,46.17107031504911,-0.015384562936422208,-0.00795071271632372,48.896741594587056,48.259855542864116,1.3227990106021674
2023-04-17,0,49.69416618347168,46.22249984741211,50.14666557312012,47.09104251861572,49.666457653045654,-0.27955615360948766,1.3069089144171335,-1.444696088276443,2.9953682370047146,48.822083950042725,1.1897706508636474,0.026946459780868022,46.819916534423825,49.95933275222778,0.873913919065998,0.0737014616960983,1.0246175809458813,1.0002163643785513,0.9953398488364892,-0.009023519001251201,76.7900555614973,51.114026206672406,48.500208377838135,45.88639054900386,49.89404719216483,0.204756701886722,49.362261704036165,0.7210729851261766,49.67145378442342,49.04281727866267,0.6727826663748881,5.243156610010446,16166700,0.28478490119625055,0.8131617247074321,225267600.0,-19.826509181513032,19.18618833600314,16.367993510430818,62.7362660349825,23.15326675125186,11.395626877435465,0.06208336728782286,0.6549389034826149,49.7384933013916,49.34575350189209,49.02833366394043,48.71091382598877,48.31817402648926,0.02,0.0,46.17820032962833,-0.006577554121788953,-0.008488042738745233,48.88974598475865,48.384620666503906,1.261369656562463
2023-04-18,0,49.950833320617676,46.73666763305664,50.14666557312012,47.709166288375854,49.71520805358887,-0.40098075904134656,1.2205567161396216,-1.4098418775307406,2.9954167572573125,49.18791723251343,1.1116622161865237,0.025076261241303757,46.887666893005374,49.95933275222778,0.900771310550509,0.059708902394199244,1.0262367401740178,1.0041377751946168,1.0022975291438694,-0.0037893183936221764,75.7701598279585,51.11490512692034,48.67379169464111,46.23267826236188,49.89702333722796,0.205516373142789,49.5092260496957,0.5977898698588997,49.67717996977869,49.12654115521035,0.4159231552717728,3.760088575420679,13482300,0.26078953292345436,0.71490099541465,238749900.0,-16.557970203591385,19.18618833600314,16.367993510430818,70.0048213709509,24.899024797407705,11.007761906378363,0.059287343668655054,0.6295863426449293,49.76995948791504,49.39668605804443,49.09499931335449,48.793312568664554,48.420039138793946,0.02,0.0,46.18448291271643,-0.0014661286216243186,-0.004385217216874206,48.84543555123465,48.53014101300921,1.2225672584364524
2023-04-19,0,50.169166564941406,46.73666763305664,50.14666557312012,47.89333391189575,49.81625032424927,-0.6006328432363184,1.1788083930409285,-1.1528274536735512,2.9954393757566966,49.35166692733765,1.0559663963317873,0.024142737547774157,46.887666893005374,49.969833278656004,0.8782201213284653,0.06518222997115153,1.0274960956491024,1.0074231039407324,1.0074467068569457,0.004605613469650605,78.41082481120145,51.1842417994333,48.82662501335144,46.469008227269576,49.900237764631,0.21019444982481839,49.65815462384905,0.45907903020297197,49.744293730124554,49.22227295519358,0.04172444485191595,4.296006839852147,12433500,0.2594502227303707,0.6709937085738894,251183400.0,-21.909246069341158,19.18618833600314,16.367993510430818,76.73609242848599,27.42501209819477,10.318562342879707,0.0388163648292468,0.6236636757665094,49.96732096862793,49.656340812683105,49.40500068664551,49.15366056060791,48.842680404663085,0.02,1.0,46.19052351428666,0.0044864664703054835,-0.0003997966370369629,48.82211521693638,48.66493388584682,1.1507849744942071
2023-04-20,0,50.18083381652832,46.73666763305664,50.169166564941406,48.03645849227905,49.932291746139526,-0.7920310763413103,1.125245019146252,-0.7752821875935898,2.9954668408013885,49.44708299636841,0.977345576286315,0.022968695774990083,47.12391757965088,50.14141616821289,0.8368645175061598,0.07344338194657622,1.0242998511930028,1.005896716306097,1.0067510330519414,0.00808585026781361,81.6789538433745,51.240865032570454,48.99037499427796,46.73988495598546,49.90595218113491,0.21821617081331932,49.77351175035749,0.35447944359496547,49.84899599814297,49.347630860173446,0.044870364886933106,4.336146779179643,13641600,0.24851954668971946,0.7460688315438532,264825000.0,-8.906927610363615,19.18618833600314,16.367993510430818,80.67144725557759,25.545074157880425,10.262226023390562,0.1063980332563996,0.6217351581196697,50.0813876953125,49.84097424316406,49.64666748046875,49.45236071777344,49.211947265625,0.02,0.0,46.19727321082753,0.009900119513308603,0.010914637824470745,48.86409160069057,48.78853307451521,1.0281896758711349
2023-04-21,0,50.59749984741211,46.829166412353516,50.18083381652832,48.445417165756226,49.94208288192749,-0.9443995460175444,1.026362712805543,-0.39368329881417274,2.9955128765189505,49.558749198913574,0.8637247705459586,0.020876907677336912,47.81966600418091,50.148915672302245,0.8038097224309161,0.0715722200703243,1.029187167303713,1.0128429921591293,1.0134735901665586,0.019511393861393334,81.58712729627499,51.21530872906262,49.16258330345154,47.10985787784046,49.99999986376081,0.34179185414512553,49.88202360698155,0.3578096122627165,49.93108788590592,49.480990099297614,0.07977712617243979,3.3253825510504003,25335000,0.25067480029585487,1.373232136396343,290160000.0,-10.795386812839428,19.18618833600314,16.367993510430818,107.81656752693229,27.77456138659718,9.728606632313776,0.09858774715029046,0.6089921234052664,50.35130680847168,50.094347053527834,49.886667251586914,49.678987449646,49.42202769470215,0.04,0.0,46.210869341201075,0.0218883489293471,0.01498414422382433,48.97556413922991,48.88834490094866,0.9198563238346895
2023-04-24,0,50.76083278656006,47.156667709350586,50.59749984741211,48.95020890235901,49.9983332157135,-0.9267190712018916,0.9212096021354814,-0.24249611928869497,2.9955570217274072,49.66166591644287,0.748783020973206,0.01866648300132372,47.893334197998044,50.170333290100096,0.7578331377762214,0.07296597289844653,1.0285674618966978,1.0147566389667324,1.0128162822241344,0.021464624220682627,84.20513632174169,51.193419179475434,49.350999975204466,47.5085807709335,50.1403568812779,0.42676305195198394,49.978809288569856,0.3998811458550809,50.09766259668436,49.666467278871885,1.3182714694741495,3.0953903146654964,13579500,0.25426843938779425,0.7548135728036993,303739500.0,-3.2041546130521,19.18618833600314,16.367993510430818,130.88704381389158,28.99740254696122,9.245887412265791,0.10935416458638761,0.5950165355063983,50.516840530395505,50.228247367858884,49.9950008392334,49.761754310607905,49.473161148071284,0.06,0.0,46.21852988668516,0.021669134180169802,0.028825188771625296,49.1280790056501,48.98325947352818,0.8388482841368062
2023-04-25,0,50.82833385467529,47.89333248138428,50.76083278656006,49.242708921432495,50.14229106903076,-0.769845136006433,0.8214492312112417,-0.36627835080740656,2.9955941489987676,49.736249923706055,0.6542997932434076,0.016584477960083655,48.06508331298828,50.2225004196167,0.7951133928956284,0.0598725988579684,1.0261880473339473,1.0148600259525649,1.0098645440714917,0.01756728518271622,84.08296759771707,51.174106691487424,49.531208229064944,47.888309766642465,50.31166662488665,0.42804338909192746,50.08815452030727,0.40845725302034414,50.264777345842994,49.8548941623689,1.9737485172818352,2.742590202933183,17246700,0.21797549046602938,0.9847328636543492,320986200.0,-32.9802576563693,19.18618833600314,16.367993510430818,119.02152503746814,29.380852458389622,8.372736151216603,0.05270616923391381,0.6101344492475134,50.73001298522949,50.40832610321045,50.148332595825195,49.88833908843994,49.5666522064209,0.08,0.0,46.22804255684244,0.011478262442555565,0.013710445873152042,49.27219935825892,49.08447047642299,0.786353675194035
2023-04-26,0,50.293334007263184,47.89333248138428,50.82833385467529,49.37875008583069,50.15229082107544,-0.782550311412087,0.7766842945388991,0.07157074435169442,2.995609542623542,49.854166984558105,0.5981166458129877,0.015634384395894308,48.517667293548584,50.61383314132691,0.7576278630672981,0.06128204535426356,1.0123873006695323,1.002801453531287,0.9957630040537773,0.002474975185426942,84.59637483851995,51.23132679143986,49.67795820236206,48.124589613284265,50.39726202828543,0.33343418536299474,50.14565461022513,0.37261137489815294,50.40581919776952,50.01317338198773,2.416257032673666,3.1052958575394465,12910200,0.21602805812069834,0.755183175879203,308076000.0,-50.71423316494188,19.18618833600314,16.367993510430818,62.486087373539725,27.803448190123355,12.33755985401674,0.07101055510051252,0.59869632879688,50.80946618652344,50.536932556152344,50.31666564941406,50.09639874267578,49.82386511230469,0.08,0.0,46.23441896205343,0.005999659628028953,0.007073964310417474,49.33703068324497,49.11338833400181,0.6738863641791615
2023-04-27,0,50.40666580200195,48.084166526794434,50.82833385467529,49.46770787239075,50.172083377838135,-0.7789879755504157,0.6697226261199082,0.43521374807553226,2.9956415131774143,49.93458318710327,0.5159957981109621,0.013448796883846526,49.02708387374878,50.61383314132691,0.7339989211518422,0.045943761534011675,1.0122235437834577,1.004351931630458,0.9975164124501654,0.004500363351858994,65.6880030901574,51.13740353089582,49.797958278656004,48.45851302641619,50.46238095419748,0.2702396017607275,50.17970214571272,0.3731674046563007,50.37807971558033,50.07955016749958,1.2057105890042836,1.6266485738012888,12861000,0.2648751390458363,0.7781500829518516,320937000.0,-42.32143149083657,19.18618833600314,16.367993510430818,82.42179426206967,28.649975223618963,11.753628819030581,0.07236520012447466,0.5835515309495709,50.80946618652344,50.536932556152344,50.31666564941406,50.09639874267578,49.82386511230469,0.08,0.0,46.241022308021435,0.002715799489159343,0.009132639530115472,49.408392224993015,49.12691388811384,0.5549872326841796
2023-04-28,0,50.3841667175293,48.565834045410156,50.82833385467529,49.59395742416382,50.208958864212036,-0.46780359388281156,0.5538190342883292,-0.0391220042998528,2.99567060881899,49.94499969482422,0.4375165939331055,0.01109544638130708,49.27558393478394,50.61383314132691,0.7203323662035849,0.03790384315999963,1.0094178525293127,1.00264837145411,0.9961807685458264,-0.004216278087379122,65.61958367221287,51.02172131099304,49.91408324241638,48.80644517383973,50.49309526171003,0.2421142506158824,50.19666651317051,0.3769295122828285,50.38613693669751,50.148987598971,0.9125623159446435,0.9546675223568152,14088600,0.25051232728186235,0.8730002342277363,306848400.0,-49.642781238249384,19.18618833600314,16.367993510430818,63.677856155384795,26.34627313883357,13.23288929910602,0.07713156266930742,0.5892499986049836,50.80946618652344,50.536932556152344,50.31666564941406,50.09639874267578,49.82386511230469,0.08,0.0,46.24808401762631,-0.0050089695877993945,0.0,49.45316696166992,49.13764108930315,0.4602385834483381
2023-05-01,0,50.508334159851074,49.07833385467529,50.82833385467529,49.677916049957275,50.31604218482971,-0.11843993093057766,0.46755728771042904,-0.713733395336126,2.995688542738317,50.045833110809326,0.3858333110809326,0.009350210756317295,49.394999980926514,50.61383314132691,0.7585824033683102,0.026607114795719738,1.0100656791336198,1.003611428749361,0.9994789225791118,-0.004974280618497584,62.71120304383966,50.94011445144319,50.00499987602234,49.069885300601484,50.53988102504185,0.19963237981498186,50.22291660308838,0.3854426558803013,50.386685175336524,50.199696149664554,0.4285503772712349,0.4736130342761739,11409600,0.2315651003728076,0.7283395956137226,318258000.0,-38.5714519266925,19.18618833600314,16.367993510430818,91.96823845505718,26.126008278513268,12.366508266941448,0.07323794503548765,0.5854940608558401,50.80946618652344,50.536932556152344,50.31666564941406,50.09639874267578,49.82386511230469,0.08,0.0,46.25405271592194,-0.007659020317559828,-0.000922755585508941,49.482084546770366,49.17308807373047,0.4259845338982348
2023-05-02,0,50.30000019073486,49.29750061035156,50.82833385467529,49.75729179382324,50.38979148864746,-0.07154676937864667,0.4280529633316851,-0.8685307878967299,2.995695731168705,50.14374923706055,0.3575167226791379,0.00854798087448228,49.48008279800415,50.61383314132691,0.7744617272501946,0.022315197277924886,1.004463177337453,0.9978574849862086,0.9963519905584667,-0.010394471427117913,63.579666240675294,50.9326058179445,50.07649989128113,49.22039396461776,50.49738107408796,0.21629366132738564,50.24869046892439,0.37698050921881526,50.41824851657627,50.24027445235615,0.6526402979276192,0.7329380817739889,11329500,0.22393143251645206,0.743241647510785,306928500.0,-45.892801674105314,19.18618833600314,16.367993510430818,23.228372082575785,23.896888996250745,17.1998118658271,0.05949267198285565,0.5943872768285031,50.80946618652344,50.536932556152344,50.31666564941406,50.09639874267578,49.82386511230469,0.02,1.0,46.25951655361232,-0.0025729991574425792,-0.01034284395663923,49.4564323425293,49.21599824087961,0.41251470645934746
2023-05-03,0,50.379167556762695,49.29750061035156,50.82833385467529,49.89208364486694,50.38979148864746,-0.1804897928435354,0.40154505939264523,-0.6259212038990016,2.9957001653628517,50.15791606903076,0.32621673583984434,0.00801148004016768,49.615082359313966,50.61383314132691,0.7272885854680419,0.020335708057637195,1.005146709890412,0.9987362107097865,1.0000132473432972,0.0017066585700427073,57.61513549210923,50.924298357386974,50.12120823860168,49.31811811981639,50.442857469831196,0.18459665693446978,50.291607175554546,0.3527353432429899,50.38986581144347,50.239598041403106,-0.5879730373524813,0.7225473513220497,12334500,0.22889972797934224,0.8248074145402022,319263000.0,-55.892679058969705,19.18618833600314,16.367993510430818,36.07803047715436,24.587345953355445,15.941343420756462,0.0813693975917932,0.5955025149372969,50.80946618652344,50.536932556152344,50.31666564941406,50.09639874267578,49.82386511230469,0.02,0.0,46.26559056169825,-0.001921736300089738,-0.006267686574815319,49.356621333530974,49.242350169590544,0.3328406671882758
2023-05-04,0,50.125000953674316,49.488332748413086,50.82833385467529,49.93687462806702,50.38979148864746,-0.0824565659021139,0.35737356353636407,-0.7016743353895643,2.995706903085093,50.17500019073486,0.28862528800964354,0.00712250098087388,49.68766613006592,50.61383314132691,0.7001684009105975,0.018000905645344765,0.9989977012458053,0.9932839949561536,0.9946291824589347,-0.005587849222839281,58.36659909544086,50.89003871299496,50.17529158592224,49.46054445884952,50.34238134111677,0.11988057182677275,50.32702398300171,0.3024078810739319,50.389434045903556,50.25654420317414,-0.7518892201831975,1.20701889476367,14011200,0.22670227329464726,0.9778945660310199,305251800.0,-62.47623988560268,19.18618833600314,16.367993510430818,-26.182961908788464,23.095672810398398,18.128941421274284,0.02149923858198165,0.588680906727468,50.837,50.5815,50.375,50.1685,49.913,0.02,0.0,46.27208495007274,-0.002235386628803515,0.0008719469083280453,49.33197620936802,49.30208778381348,0.32702178750872485
2023-05-05,0,50.32583236694336,49.62916564941406,50.82833385467529,49.94791650772095,50.38979148864746,0.07682790663352465,0.32129944455087617,-0.6165383950999543,2.9957117999109406,50.17500019073486,0.25942099571228,0.006399479049543033,49.76991691589355,50.61383314132691,0.764774354458104,0.0039054806190001413,1.0023643530826964,0.9973740468366247,0.9997317892845047,-0.0011577913139455553,47.90258161981983,50.84972388528705,50.2071249961853,49.56452610708355,50.34702396392822,0.11828317643910591,50.37214299610683,0.24176420739031101,50.325036862098074,50.25177820910192,-1.383741798446306,0.9990804757083558,14556000,0.21591681081706432,1.0278833483744954,319807800.0,-45.939609255099384,19.18618833600314,16.367993510430818,46.50499110999928,25.150302528043664,16.556813125820973,0.010691912102922812,0.598536948877405,50.910946258544925,50.70119267272949,50.53166580200195,50.362138931274416,50.15238534545898,0.02,0.0,46.27932702071514,0.009117984697381898,0.006384845248757578,49.39897700718471,49.368003845214844,0.3499633996101586
2023-05-08,0,50.66666603088379,49.62916564941406,50.82833385467529,50.081459045410156,50.38979148864746,-0.07088568783513903,0.3157630326544765,-0.4794093698436699,2.995712508807092,50.23708391189575,0.25150012969970703,0.006286729388023845,49.76991691589355,50.61383314132691,0.7749899747626872,0.0035728555782436736,1.008755254381203,1.0046697152979467,1.0067358374665654,0.0031347672352768363,52.035619361638105,50.858442664582626,50.22691659927368,49.59539053396473,50.384166853768484,0.16975580561018752,50.42327390398298,0.22057441002736258,50.324969172611866,50.26133260554622,0.06461762840276702,1.2711073189950661,14926200,0.21514775209092832,1.0525124466778715,334734000.0,-24.009379351554955,19.18618833600314,16.367993510430818,119.43650547305533,26.99180278478969,15.316671285831493,0.04556449110072694,0.6007843859658273,50.912519927978515,50.70373988342285,50.53499984741211,50.36625981140137,50.157479766845704,0.02,0.0,46.28734932158004,0.011281380834971433,0.015434495800150097,49.48853465488979,49.448463439941406,0.3968475162616775
2023-05-09,0,50.93499946594238,49.62916564941406,50.82833385467529,50.081459045410156,50.43208289146423,-0.18007944567814857,0.32920701446217937,-0.6881673243631439,2.995710806939668,50.29666709899902,0.2668750476837161,0.006551003137537234,49.76991691589355,50.67608270645142,0.7275588578436473,0.01048712395585904,1.0135730001287073,1.0101791250847243,1.0114311689025701,0.012624240015897348,59.97004411399655,50.91133065108622,50.25291662216186,49.59450259323751,50.462857246398926,0.2686303292067004,50.477976254054475,0.24618466587049814,50.408853408552446,50.311013436042,0.515805250645064,1.4330746109307582,15209700,0.22742875941147103,1.0845900671410862,349943700.0,-17.94881370943217,19.18618833600314,16.367993510430818,144.49601601138448,27.00527634210206,14.78655980560581,0.09726488359494305,0.5778714008249332,50.912519927978515,50.70373988342285,50.53499984741211,50.36625981140137,50.157479766845704,0.02,0.0,46.29585354565645,0.015750250868844073,0.013003115972172604,49.609388623918804,49.53127779279436,0.4377684263194428
2023-05-10,0,50.984999656677246,49.62916564941406,50.93499946594238,50.081459045410156,50.53062558174133,-0.1281934389779422,0.35976967534861354,-0.7503142938291125,2.9957066787634847,50.31291627883911,0.2874333381652832,0.007153527494406279,49.76991691589355,50.76758289337158,0.6974878132770482,0.019940929640977254,1.0137669232208704,1.0109568996966765,1.0098772548824504,0.012025448797500449,66.3691439323983,51.01216430110617,50.292624950408936,49.5730855997117,50.530952317374094,0.33443472176559075,50.535416671207976,0.2646444708743046,50.538859133179685,50.38772578439076,1.0932655719032547,1.5265011429074573,15827700,0.2266976942281588,1.1103768323353924,365771400.0,-36.8099322482126,19.18618833600314,16.367993510430818,120.9475980288239,28.281469842596746,12.98844896254181,0.11904115834180347,0.6108806518751848,51.06532051086426,50.827340354919436,50.635000228881836,50.442660102844236,50.20467994689941,0.02,1.0,46.304592424156084,0.016661180971093037,0.01289524595039258,49.68119376046317,49.58163915361677,0.4430325972407857
2023-05-11,0,50.91166687011719,49.62916564941406,50.984999656677246,50.158125162124634,50.61479139328003,-0.1815660376254783,0.3800293110018936,-0.6935771910309301,2.9957037698808,50.35249996185303,0.3002499580383301,0.007548514059451513,49.76991691589355,50.839000415802005,0.6994933056523575,0.024240787184303215,1.0112573478767182,1.0081202123438668,1.0060103181766966,0.01569408282246032,68.51696099127433,51.10497525179505,50.34491662979126,49.58485800778747,50.618333271571565,0.34381103494763554,50.55785717282976,0.2829972646464071,50.6485212595583,50.47392879670746,0.9437363254103753,1.602535826903804,11926800,0.2210784659085317,0.840681578847203,353844600.0,-25.15334838928609,19.18618833600314,16.367993510430818,115.39134584454571,26.850176220057687,12.331118057527815,0.1314403619832945,0.5974843349094608,51.06532051086426,50.827340354919436,50.635000228881836,50.442660102844236,50.20467994689941,0.02,0.0,46.31119687697091,0.017611489461047514,0.020459847384665223,49.798806871686665,49.62761960710798,0.4572113674875421
2023-05-12,0,51.12083339691162,49.62916564941406,50.984999656677246,50.17791700363159,50.690207719802856,-0.3007055196972747,0.37579335507147466,-0.5430785643749987,2.9957044563033053,50.381667137145996,0.2985748863220216,0.007455983136650553,49.925166606903076,50.91400012969971,0.6733457830956835,0.025841684096864655,1.0142703871557304,1.0112507727037565,1.0070127389102923,0.015797076622034334,67.18321700164317,51.153170000243044,50.4015832901001,49.649996579957154,50.72428553444998,0.371025859223222,50.58357150214059,0.3171535454671676,50.71312333376482,50.54310794305699,1.216037131337808,0.6209141235288659,16119300,0.21786398369535823,1.1139975866944765,369963900.0,-26.17582700476252,19.18618833600314,16.367993510430818,135.88069829548138,28.613364649092908,11.651106397707744,0.12510593226139644,0.5871879401551644,51.06532051086426,50.827340354919436,50.635000228881836,50.442660102844236,50.20467994689941,0.02,0.0,46.320405323258456,0.008565695603553358,0.017279243912789684,49.940198625837056,49.64840997968401,0.4246698749774268
2023-05-15,0,50.8841667175293,49.69416618347168,51.12083339691162,50.26520895957947,50.77770805358887,-0.08773707751324457,0.3628946806841273,-0.6124928298663939,2.9957064236619693,50.395416259765625,0.30286659717559844,0.0071894263089132176,50.107584190368655,50.93999948501587,0.6098784561238608,0.028708947609114972,1.0080830234724696,1.0051044508446476,0.9992210647907899,0.004292776763975992,70.43440378154497,51.20195603884323,50.47616667747498,49.75037731610673,50.83273778642927,0.26142171438303075,50.58755956377302,0.3207981677519632,50.815034587710464,50.644559287427995,1.4721677155806192,0.7092094250409536,16113900,0.22014335585660205,1.1138276120919546,353850000.0,-50.51123930773821,19.18618833600314,16.367993510430818,61.53129684317057,25.827628588838618,15.759115673434994,0.05043723210071282,0.6040554973037119,51.06532051086426,50.827340354919436,50.635000228881836,50.442660102844236,50.20467994689941,0.02,0.0,46.328990536983156,-0.005500176937029866,0.0007248326944871223,50.006212506975444,49.66909435817173,0.39347217798752143
2023-05-16,0,50.144165992736816,49.950833320617676,51.12083339691162,50.29833364486694,50.842292070388794,0.11606517219783134,0.3254216635295468,-1.1381683373833402,2.995711545224491,50.457499980926514,0.28689982891082766,0.006439445341336394,50.164750003814696,50.93999948501587,0.6502479030351777,0.01868504156719201,0.992252982161435,0.9897526022499278,0.9838491210610854,-0.015526327309267063,61.103051501053365,51.18651003123695,50.535666704177856,49.884823377118764,50.80678544725691,0.3221053709349353,50.57690470559256,0.33354608196470664,50.8344600159717,50.69569357871947,1.5145451359823492,0.1098459434331198,15512100,0.22620545064347777,1.0647603789786686,338337900.0,-93.45604324880938,19.18618833600314,16.367993510430818,-106.81808964263094,23.521247145177732,21.348850110279155,0.0123686734269222,0.6159087087651588,51.06532051086426,50.827340354919436,50.635000228881836,50.442660102844236,50.20467994689941,0.02,1.0,46.335946418480546,-0.02091780115766584,-0.01925088603799539,49.91304397583008,49.656010491507395,0.38082196141606844
2023-05-17,0,50.044166564941406,50.125000953674316,51.12083339691162,50.29833364486694,50.842292070388794,0.2742866750949174,0.3104318787039845,-1.2950090899952713,2.995713423994195,50.457499980926514,0.2781998586654666,0.006141652615671433,50.16666650772095,50.93999948501587,0.52774094147389,-0.0004983254440200414,0.9900848062571234,0.9880827216004966,0.9849436624501683,-0.018453135198023385,42.410682495445144,51.166197095191784,50.545333337783816,49.92446958037585,50.71785695212228,0.43380244889461084,50.55101190294538,0.3607397714660417,50.663377705694714,50.6271827709667,-0.3609803666672604,-0.29659599521643343,26985900,0.28265246863204835,1.7642167197842609,311352000.0,-85.4609389425584,19.18618833600314,16.367993510430818,-139.5338048711261,21.352283475799453,22.63034749396164,0.011605889603892274,0.6300103441393784,51.006320510864256,50.731840354919434,50.510000228881836,50.28816010284424,50.013679946899416,0.04,0.0,46.347456480653726,-0.019796833239177136,-0.022551924719381108,49.76369421822684,49.62611443655832,0.3784679985127408
2023-05-18,0,50.62583351135254,50.044166564941406,51.12083339691162,50.29833364486694,50.842292070388794,0.19953805811642553,0.3190802774792191,-1.251429267943056,2.99571235132935,50.457499980926514,0.2838248586654665,0.0063135351178929995,50.142249488830565,50.93999948501587,0.5331754218443198,-0.002723495031720642,1.0017164967751575,1.000228862617982,1.0000954861206617,-0.005614299753607499,40.61000900566727,51.177243892742254,50.539083337783815,49.900922782825376,50.673690387180876,0.4236291680494597,50.5682738167899,0.3579128279279415,50.509769147486715,50.543714865826516,-1.2286173824086615,-0.7191494047323992,46768500,0.28348113741613584,2.7587811777488933,358120500.0,-51.0637520772841,19.18618833600314,16.367993510430818,21.136767334539112,28.592684417453565,18.95769353473168,-0.05219948389718027,0.6983428986422234,51.006320510864256,50.731840354919434,50.510000228881836,50.28816010284424,50.013679946899416,0.02,1.0,46.371104312608026,-0.010775795062096138,-0.007079644532181118,49.69299915858677,49.65119389125279,0.372280138811926
2023-05-19,0,50.156667709350586,50.044166564941406,51.12083339691162,50.319374322891235,50.842292070388794,0.08307450453433662,0.3086686011112112,-1.148871083120972,2.9957136419844015,50.55291700363159,0.2702498912811279,0.0061048350751007514,50.142249488830565,50.93999948501587,0.5544414896571639,0.0005599815015737158,0.9919965399133539,0.9899798276732906,0.9919474948539252,-0.018860523655298667,50.964964607775805,51.178670524747446,50.56133332252502,49.9439961203026,50.55535725184849,0.43763567492966954,50.543154784611296,0.37440352618542316,50.539806231553314,50.55035754484026,-0.6069813641532815,0.4796482894678165,27594000,0.29846415656272646,1.6169422072368624,330526500.0,-78.72333517980809,19.18618833600314,16.367993510430818,-105.76849620751152,26.312640466732656,20.284234159991776,-0.07633124736948994,0.704651753747587,51.006320510864256,50.731840354919434,50.510000228881836,50.28816010284424,50.013679946899416,0.02,0.0,46.383049692944105,-0.020644143008988647,-0.020963898266290016,49.56939860752651,49.62529618399484,0.38676485746345085
2023-05-22,0,49.72166728973389,50.044166564941406,51.12083339691162,50.29833364486694,50.842292070388794,0.1800202505372866,0.32080022588092744,-1.2656834501242586,2.995712135354767,50.457499980926514,0.28647068500518813,0.006347540992185422,50.142249488830565,50.93999948501587,0.4943536574911244,-0.011902190016264615,0.9838220046594889,0.9817216876158866,0.9871089950930162,-0.022845995184489043,42.29590244375138,51.1808921673838,50.53929171562195,49.8976912638601,50.38535731179373,0.5024825793591093,50.50184529168265,0.43093288021841974,50.44443664652544,50.4861165160436,-1.6246581404422502,-0.6962543040669651,16117800,0.3134532632443434,0.9374923658394436,314408700.0,-95.04958161089719,19.18618833600314,16.367993510430818,-168.37040306765135,24.7035710785837,21.845192629949533,-0.13432015505210135,0.6969386458661923,50.97328065490723,50.67836058807373,50.44000053405762,50.201640480041505,49.90672041320801,0.02,1.0,46.38925155781808,-0.021661865793931256,-0.029267731452916293,49.3573112487793,49.57805906023298,0.4270171029267624
2023-05-23,0,49.355000495910645,49.72166728973389,51.12083339691162,50.259167432785034,50.842292070388794,-0.028228292346307235,0.3621941266580506,-0.7813243545632194,2.9957065384729855,50.395416259765625,0.30798326969146717,0.007173960317846614,50.116917514801024,50.93999948501587,0.471505692654252,-0.021772631149104896,0.9775719399758324,0.9763037169880393,0.9843732916945226,-0.015737932443436797,36.22868805671095,51.21172169409674,50.48733344078064,49.76294518746454,50.1330954687936,0.5148123103901984,50.428690501621794,0.5291082008664565,50.263151083101405,50.36327810577176,-2.3373809060684594,-1.1497671944492438,16302300,0.3249475956693617,0.9508353338885895,298106400.0,-83.08115391759621,19.18618833600314,16.367993510430818,-195.97681168852836,23.185227521704142,24.680606334739423,-0.07620814240713623,0.6895380556829395,50.87809436035156,50.52428785705566,50.23833465576172,49.952381454467776,49.59857495117188,0.04,0.0,46.39492569103938,-0.009814417357416394,-0.023505474497027425,49.134454999651226,49.53732681274414,0.4736354413974679
2023-05-24,0,49.24833297729492,49.355000495910645,51.12083339691162,50.153542280197144,50.721041202545166,-0.44124337638554023,0.4290135641311912,0.052842609259558415,2.9956960179778584,50.381667137145996,0.3328165626525873,0.00850986630399792,50.011916637420654,50.93999948501587,0.5851512483806062,-0.01865721431824401,0.976884565830168,0.9772480258809716,0.9853476518172768,-0.015902624467004522,33.55705121646591,51.27169390110478,50.413666772842404,49.555639644580026,49.8994049344744,0.48761461463748956,50.36607136045183,0.6130341749065882,50.035614248679884,50.21354730226778,-3.454233398917273,-2.032917792256317,20515200,0.3139364260717241,1.1705920918616255,277591200.0,-83.47829177447352,19.18618833600314,16.367993510430818,-190.8745637605061,21.402483729792905,25.46037255096202,-0.0694610617337567,0.6936186198905797,50.816733856201175,50.42496704101563,50.108333587646484,49.79170013427735,49.3999333190918,0.06,0.0,46.40156137511414,-0.012706410474070284,-0.014354239143493899,48.93547766549246,49.47084508623396,0.5319951311966997
2023-05-25,0,48.79750061035156,49.24833297729492,51.12083339691162,50.13937473297119,50.721041202545166,-0.6037131433031424,0.4984964537041553,-0.15139156978916102,2.995683184708234,50.381667137145996,0.38319159507751477,0.009898380271198454,49.685000610351565,50.93999948501587,0.6822475721932669,-0.022979754885137173,0.9689461454262541,0.9716504559741039,0.9794466289007187,-0.03611462319116154,31.778388277431898,51.358409628752305,50.36141672134399,49.36442381393568,49.707024165562224,0.6220692239877675,50.256904806409565,0.7430443617057537,49.83900251643668,50.10538893423713,-3.2148187653642757,-1.748963510623399,21299100,0.31177102454116684,1.1867516149279602,256292100.0,-88.44492560721052,19.18618833600314,16.367993510430818,-204.42228935786537,19.565372935442756,27.363996092758416,-0.07436607758662088,0.7045504633777598,50.72154756164551,50.27089430999756,49.906667709350586,49.54244110870361,49.091787857055664,0.08,0.0,46.40737446008383,-0.03505644581663436,-0.02253723583417603,48.76599611554827,49.33952004568918,0.6327348853498888
2023-05-26,0,48.700833320617676,48.79750061035156,51.12083339691162,50.10479235649109,50.721041202545166,-0.808041840187439,0.6035018549819346,0.04300701198768353,2.995660004245744,50.35249996185303,0.4655165100097662,0.01200259250111344,49.344333744049074,50.93999948501587,0.7026832554968676,-0.03149136346886755,0.9685740847134909,0.9738251437030457,0.9847338435600631,-0.02902573985116441,27.458093222758247,51.48796217172534,50.28095846176147,49.0739547517976,49.51511941637312,0.7027071113745369,50.1164881842477,0.8391805812776889,49.577610998111744,49.95013157965866,-2.6855873574212263,-3.036873280998498,15720900,0.32344225988396486,0.8719779954639773,240571200.0,-85.63716784629815,19.18618833600314,16.367993510430818,-167.293739068916,18.649125880401265,26.082539259971014,-0.04821672059846406,0.6863680694394866,50.72154756164551,50.27089430999756,49.906667709350586,49.54244110870361,49.091787857055664,0.08,0.0,46.41165069173777,-0.02328070740478605,-0.033340021466062915,48.62039075578962,49.19204248700823,0.7031711233609912
2023-05-30,1,48.77083396911621,48.700833320617676,51.12083339691162,49.963541746139526,50.721041202545166,-0.7566829414447739,0.6938570721225984,-0.3693275846707498,2.9956363983385637,50.31291627883911,0.5477790212631227,0.013822737417141923,49.20324974060058,50.93999948501587,0.7689700298717176,-0.03578618992883308,0.9715926502093839,0.9799669891299275,0.991989512099087,-0.019123118198693168,25.895125871278186,51.584505936161094,50.19679179191589,48.80907764767069,49.250119481767925,0.546425349443253,49.9619049344744,0.8753545847171462,49.35701447822234,49.786645813817856,-2.684295366534901,-3.8799330294751244,15742500,0.31971698241101587,0.8628081589836046,256313700.0,-89.52482293169012,19.18618833600314,16.367993510430818,-140.27447454588994,19.193210117033672,24.533621717606525,-0.06166745057636292,0.6775800229581703,50.72154756164551,50.27089430999756,49.906667709350586,49.54244110870361,49.091787857055664,0.08,0.0,46.41596590258003,-0.017026680383663395,-0.025682121916199577,48.3671030317034,49.03005109514509,0.7693708797047675
2023-05-31,1,48.71749973297119,48.700833320617676,51.12083339691162,49.630000591278076,50.721041202545166,-0.5795323101227638,0.7554503441800678,-0.8407659518797885,2.9956182923510872,50.228333950042725,0.613108224868774,0.015075865071995438,48.794833946228025,50.93999948501587,0.828944878479604,-0.030400918803581256,0.9722127447256589,0.9830698191551848,0.9947523601007523,-0.012916639783891237,28.135066485325737,51.62081747073929,50.10991678237915,48.599016094019014,49.04452405657087,0.39946875783684915,49.799940654209685,0.88124740866372,49.20898593475129,49.66381587242139,-3.6641362987541837,-4.248877038416851,30130800,0.3205699321996299,1.5704805449052732,226182900.0,-79.95681336393312,19.18618833600314,16.367993510430818,-116.9664118576656,17.656450652052737,24.623183022605467,-0.0306733820371531,0.6839433364864147,50.69997343444824,50.24834664154053,49.88333320617676,49.51831977081299,49.06669297790528,0.1,0.0,46.42427425355103,-0.009709365727970765,-0.011575498068217487,48.224774496895925,48.89708655221121,0.8048470549794766
2023-06-01,1,48.954999923706055,48.700833320617676,51.12083339691162,49.328333616256714,50.721041202545166,-0.4258605013999264,0.8121447716646457,-1.1745728618634448,2.9956002058048936,50.1504168510437,0.6903873920440674,0.016232898643075738,48.76550054550171,50.93999948501587,0.8514853602241453,-0.03298323303812606,0.9784974053387666,0.9907144687861388,1.0022109812550586,-0.00595620269470043,27.076196123815244,51.655081302820264,50.03079175949097,48.40650221616167,48.935000147138325,0.26551049442888913,49.66017872946603,0.8458169950731755,49.08592913266902,49.56654972259304,-2.869345277718866,-4.447386366529262,20239200,0.31845527472578367,1.033616593266263,246422100.0,-74.13796292756558,19.18618833600314,16.367993510430818,-83.7771300104055,18.508362306944953,22.937715258242537,0.015234267732026434,0.6817567950653688,50.69997343444824,50.24834664154053,49.88333320617676,49.51831977081299,49.06669297790528,0.1,0.0,46.43035741897698,-0.001490397097829499,-0.006068383011101666,48.169528416224885,48.763419832502095,0.8262751590087005
2023-06-02,1,49.34583282470703,48.700833320617676,51.12083339691162,49.174999713897705,50.721041202545166,-0.23794458676360417,0.8404204991642232,-1.399116255222955,2.995590584067331,50.134583473205566,0.7409998703002927,0.016822007757915577,48.76550054550171,50.93999948501587,0.8902551266284695,-0.023341665989185325,0.9877150586206978,1.0008298537588989,1.0114268980559618,0.01123689138781736,34.08390782834378,51.640424376166585,49.959583377838136,48.27874237950969,48.93369047982352,0.2631052151077307,49.53339297430856,0.7359211685085169,49.05272945927409,49.51880735973993,-1.5419180566902009,-3.8432584645143617,19178100,0.3237886588849992,0.9666722112171297,265600200.0,-58.94396219504525,19.18618833600314,16.367993510430818,-42.273712194163174,21.16284418076254,21.400408797532368,0.04292508137502767,0.6785359771491459,50.69997343444824,50.24834664154053,49.88333320617676,49.51831977081299,49.06669297790528,0.1,0.0,46.43699877590036,0.018199148739346915,0.008060585986325057,48.19340624128069,48.66393062046596,0.8279526208130031
2023-06-05,1,49.98250102996826,48.700833320617676,51.12083339691162,49.174999713897705,50.721041202545166,-0.11168833447118685,0.8498559856446897,-1.4885997781997302,2.9955872603382288,50.09416627883911,0.7673123598098754,0.01702414555370159,48.76550054550171,50.93999948501587,0.9075469975537594,-0.01947309157433913,1.0012394888608456,1.01638134709563,1.0221788432402121,0.026317161780638143,41.960172318538675,51.62033694267916,49.92062497138977,48.22091300010038,49.038571630205425,0.47246682498055115,49.468988282339915,0.6420865266867207,49.12763224454647,49.53589969081329,-0.018574959196632726,-3.4721667356695,15553200,0.33449569982668126,0.7819938096933203,281153400.0,-48.38358414549778,19.18618833600314,16.367993510430818,13.833983174235032,27.135767946198058,19.600552482160662,-0.006932040962164938,0.6879263625878573,50.69997343444824,50.24834664154053,49.88333320617676,49.51831977081299,49.06669297790528,0.02,1.0,46.443454239831986,0.023084220813941014,0.0249040647433371,48.295000893729075,48.61523927961077,0.8132726002105319
2023-06-06,1,49.84833335876465,48.700833320617676,51.12083339691162,49.174999713897705,50.721041202545166,-0.05818126874246709,0.8449510553750605,-1.4630464490659911,2.9955888744838837,50.013333797454834,0.7518624496459964,0.01693171340001104,48.76550054550171,50.93999948501587,0.8930473825865696,-0.013503256766460529,0.9988953662223268,1.0140122079817762,1.0141187930607594,0.022093109794488086,51.96815129633206,51.59336051529113,49.90345840454101,48.213556293790894,49.188690594264436,0.544548482854997,49.44785737991333,0.6227336099595219,49.34482252980285,49.63781173398805,1.490747012719832,-1.7719965673534683,15015600,0.35842861343604876,0.7547943738774673,266137800.0,-48.599147366071485,19.18618833600314,16.367993510430818,-1.6749933468665632,25.536704555417366,21.462106781400593,-0.015995508909627164,0.6787885908739862,50.69997343444824,50.24834664154053,49.88333320617676,49.51831977081299,49.06669297790528,0.02,0.0,46.44929316865416,0.025468919569593185,0.022947646607005566,48.46448244367327,48.61523927961077,0.7784084580048745
2023-06-07,1,49.88749980926514,48.700833320617676,51.12083339691162,49.174999713897705,50.69041681289673,0.04711042395425163,0.8266170573863015,-1.3637998065396584,2.9955948853775043,49.915417194366455,0.7164583206176758,0.01657791656878867,48.76550054550171,50.93999948501587,0.8696775262578496,-0.02133436965881058,1.0005005368247117,1.014547518059957,1.0104854807047836,0.024016012371466333,48.64630892482193,51.51577588570767,49.86254177093506,48.20930765616245,49.358214378356934,0.5520204867857006,49.43666689736502,0.612517540194316,49.47311697383874,49.694297965633005,2.1534560894911277,-0.5899642124170899,24256500,0.3516453594165046,1.1922016989113815,290394300.0,-46.22844521944163,19.18618833600314,16.367993510430818,13.94274656897225,24.93553533375653,20.442780101304663,-0.008122407843476596,0.6617321648621903,50.69997343444824,50.24834664154053,49.88333320617676,49.51831977081299,49.06669297790528,0.02,0.0,46.458966918636776,0.021311387582499952,0.02697517770116368,48.63209206717355,48.62624141148159,0.732529491245656
2023-06-08,0,50.39833354949951,48.700833320617676,51.12083339691162,49.174999713897705,50.273959159851074,0.12805163963674282,0.7893513099627972,-1.1950633425586412,2.9956067822721963,49.86791658401489,0.6678999948501584,0.015847192668934404,48.76550054550171,50.91900014877319,0.847657664462194,-0.02152593615381883,1.0118081668728485,1.023827462947543,1.0160169105073429,0.02948286442738879,49.13041513123883,51.3888694080268,49.8101667881012,48.2314641681756,49.59071431841169,0.6037105124598359,49.42041690008981,0.5807355562519787,49.57620996224581,49.730583091540716,2.4366451408236607,-0.3130569783252678,18873000,0.35147982680738904,0.9207134175210695,309267300.0,-3.504172000555238,19.18618833600314,16.367993510430818,75.38382624294498,29.898029515337026,18.54563990854661,0.03484537773101011,0.6773228008088449,50.22629425048828,49.86518730163574,49.573333740234375,49.28148017883301,48.92037322998047,0.04,0.0,46.46765180611392,0.032290943340386846,0.03608634779379329,48.91815185546875,48.64262744358608,0.7236440832258876
2023-06-09,0,50.88083362579346,48.700833320617676,51.12083339691162,49.174999713897705,50.21708416938782,0.09817584202942026,0.7553147961234865,-1.1151380894708212,2.9956172154270564,49.86791658401489,0.6415000200271607,0.015172803331734774,48.76550054550171,50.88691673278809,0.810417226051676,-0.010082822900441685,1.0220968607010665,1.0312201824062033,1.0198092600909063,0.031106999582705575,57.670277353816395,51.29146307498929,49.78083348274231,48.27020389049533,49.8997620173863,0.6351022293680929,49.472143036978586,0.6758238661693166,49.782000348586195,49.82129302705346,3.337034551047258,-0.44937524199381695,15603900,0.3736253935904226,0.7544643698968528,324871200.0,-7.233159723134654,19.18618833600314,16.367993510430818,122.74002475318248,32.19747590809226,17.167821180852524,0.027815559859039062,0.6794189474481974,50.55481448364258,50.13092749023438,49.788333892822266,49.445740295410154,49.02185330200195,0.06,0.0,46.47559878357065,0.0286923452169896,0.03853203344773897,49.2093620300293,48.717068263462615,0.7227605755838268
2023-06-12,0,51.250000953674316,48.700833320617676,51.12083339691162,49.174999713897705,50.21708416938782,0.09173649558777208,0.7530331153118137,-1.118082264393944,2.995617898612494,49.86791658401489,0.6401125240325924,0.015127437289120011,48.76550054550171,50.88116693496704,0.7412801437076263,-0.004694754665964879,1.0295445973488468,1.0343348890800288,1.0209265166638806,0.025358873557489447,63.11609475599998,51.28535805114976,49.779291820526126,48.273225589902495,50.227619307381765,0.658061041201221,49.58130972726004,0.8259850048275247,50.05762148256386,49.95108006722505,4.440568388525402,1.4438078714465048,14713500,0.38744886791098343,0.7138386749337758,339584700.0,-2.15281858352027,19.18618833600314,16.367993510430818,156.82455883247408,32.88468138233888,16.41808574451864,0.06936883107195617,0.6596987062939642,50.702520645141604,50.250407081604,49.885000228881836,49.51959337615967,49.06747981262207,0.08,0.0,46.48365446620544,0.028705112130704036,0.03547921067346107,49.52257810320173,48.84605325971331,0.7560065310788135
2023-06-13,0,51.61666679382324,48.700833320617676,51.250000953674316,49.174999713897705,50.21708416938782,0.14781752208171742,0.764970417578122,-1.028068988407866,2.9956143083751017,49.86791658401489,0.6459250640869143,0.015365248379912043,48.76550054550171,50.88116693496704,0.7314470431704583,0.007189549514996612,1.0367759165657635,1.0364029403804151,1.0230643674001734,0.03547427398087066,68.15925699888557,51.315691033520494,49.785750198364255,48.255809363208016,50.55202416011265,0.708696216409076,49.74285731996809,0.9843139641737659,50.355842913862574,50.08830436274785,4.687980867214599,3.073777987038635,15738900,0.39259440170214505,0.7642821243089295,355323600.0,-1.9999912806917615,19.18618833600314,16.367993510430818,179.82664357776045,35.59540569847904,15.54787796463232,0.11978492714369428,0.6468630517184132,51.010666107177734,50.49966610717773,50.086666107177734,49.67366610717774,49.162666107177735,0.1,0.0,46.4928994390318,0.03685409265501316,0.036715680271622544,49.82596097673689,49.00968360900879,0.85479603012924
2023-06-14,0,52.143333435058594,48.700833320617676,51.61666679382324,49.174999713897705,50.21708416938782,0.4017081898441515,0.8313393924041154,-0.6447845402570112,2.995593357155832,49.86791658401489,0.6788875675201418,0.016686065026617944,48.76550054550171,50.91775035858154,0.7885551210603908,0.029365346335597876,1.0465846564613028,1.0410292487413257,1.0263088796999285,0.04521841412013394,75.29421193716112,51.48505398698719,49.822375202178954,48.15969641737072,50.86071450369699,0.8712426449349437,49.949643066951204,1.1607175553319713,50.67075192015635,50.239419581449354,4.601875860891791,4.5824461051317185,21103200,0.35601927380888965,1.0110477345784104,376426800.0,-3.733727931573247,19.18618833600314,16.367993510430818,193.29665749098095,39.62147940539945,14.389958471889265,0.17089000358068923,0.6489918522932143,51.47415936279297,50.87458604431152,50.38999938964844,49.905412734985354,49.30583941650391,0.12000000000000001,0.0,46.506553944437066,0.04580001857713856,0.04733614000599631,50.15696716308594,49.2259840284075,1.0090915590904406
2023-06-15,0,52.49499988555908,48.700833320617676,52.143333435058594,49.174999713897705,50.45520853996277,0.6199691892021197,0.9722645727891874,-0.43645932682820776,2.9955433582023616,49.86791658401489,0.779733500480652,0.01947554337263203,48.76550054550171,51.28666753768921,0.7953708282498325,0.04194628493599023,1.0515333744852966,1.040930641249221,1.024136139305385,0.04160189808657644,79.38908428394599,51.866862719873424,49.922333574295045,47.97780442871667,51.238809721810476,0.9309192273546278,50.213750158037456,1.2916692086119652,51.04087141615058,50.46288734591583,4.323177833367623,5.878372490492949,18160500,0.36690887644060277,0.8888552803818253,394587300.0,-3.782091291321447,19.18618833600314,16.367993510430818,178.3036246402661,40.975582251812874,13.656184678900456,0.2051220435341177,0.6350160766760039,51.70335877990723,51.05998557281494,50.53999900817871,50.020012443542484,49.376639236450195,0.14,0.0,46.518966669652364,0.0365381608654507,0.05153340156331976,50.529173714774,49.49682807922363,1.1591888642518082
2023-06-16,0,52.25333309173584,48.700833320617676,52.49499988555908,49.174999713897705,50.68958353996277,0.6754563979113963,1.1227067173409404,-0.5461024919178779,2.995481851602504,49.86791658401489,0.9207667541503909,0.022433999724236868,48.76550054550171,51.66933345794678,0.8231672513236417,0.0369211970364378,1.044129550544475,1.0289161047334145,1.0111493370686642,0.02697478339361581,80.59532814737241,52.290288675007815,50.04487524032593,47.79946180564404,51.57678590502058,0.7749502707283816,50.46750014168875,1.3202230553332326,51.40582048709887,50.70425372628575,5.3094383472082125,7.577230860105072,34675800,0.3547564788373218,1.7489446050023454,359911500.0,-20.423552672698044,19.18618833600314,16.367993510430818,128.05849503661165,36.72019980526178,18.38947582485928,0.174493741268335,0.6579912750391378,51.70335877990723,51.05998557281494,50.53999900817871,50.020012443542484,49.376639236450195,0.14,0.0,46.54079868895825,0.01593838328350028,0.02208060804532252,50.78807939801897,49.71008573259626,1.21853240272911
2023-06-20,0,51.51583194732666,48.700833320617676,52.49499988555908,49.174999713897705,50.97312545776367,0.622952445280173,1.2168965298623764,-0.8757880184331248,2.9954390211724653,49.86791658401489,1.0184167289733892,0.024276631994961047,48.76550054550171,52.154333400726316,0.8828573531809895,0.04180232615402354,1.027721637303827,1.008619547020014,0.9916107622484338,0.0051869461210865,77.62996041863354,52.56004327906986,50.126250219345096,47.69245715962033,51.7364285332816,0.5830741207929517,50.66357142584665,1.2508755118776116,51.61582351131575,50.84957713797823,4.7423368409240645,7.2945359019435925,19994400,0.33888298754243773,1.0281631041121588,339917100.0,-30.78669057056859,19.18618833600314,16.367993510430818,77.84714305061094,34.50178297674832,22.40451238636738,0.16747480629348768,0.6502778305190406,51.70335877990723,51.05998557281494,50.53999900817871,50.020012443542484,49.376639236450195,0.14,0.0,46.55194367909353,0.0003892273825127912,0.006989361156149791,50.88124792916434,49.89969989231655,1.2458536201456123
2023-06-21,0,51.44749927520752,48.700833320617676,52.49499988555908,49.174999713897705,51.3164587020874,0.4744586144430467,1.2540811192178563,-1.1618412482127238,2.9954213334139315,49.86791658401489,1.0999665832519525,0.024984578070111386,48.76550054550171,52.154333400726316,0.9246841666688819,0.03608416119954243,1.0249688337187424,1.004266782209586,0.9892830392289859,-0.003277381689357095,64.85084532033831,52.70237066967961,50.194208431243894,47.68604619280818,51.81738076891218,0.47353584892581574,50.85857139314924,1.1312335716959712,51.589104632519515,50.87781612065486,2.217332040809603,5.6283597281701185,19251000,0.3698236234574404,0.9820245284231597,320666100.0,-30.675304213737387,19.18618833600314,16.367993510430818,67.48905489331297,32.003193790681884,22.68390180722713,0.19892263252712933,0.6509722602971172,51.77651910400391,51.17840609741211,50.69499969482422,50.21159329223633,49.61348028564453,0.14,0.0,46.56254786889511,-0.0054088020805656,0.0023361196363968165,50.945389883858816,50.07737595694406,1.2627388839555989
2023-06-22,0,51.77416706085205,48.700833320617676,52.49499988555908,49.174999713897705,51.464582443237305,0.2953796449581124,1.277750114040564,-1.3561370596788322,2.995410128881808,49.9350004196167,1.147633228302002,0.02541243848539768,48.76550054550171,52.154333400726316,0.9256313590797719,0.04239689511238585,1.029706686079651,1.0074983960500306,0.9962126480553195,-0.007079838397104354,65.24233300841706,52.836000258598716,50.28050003051758,47.72499980243644,51.89226164136614,0.4054040691532527,51.05994047437395,1.0108260182691584,51.55163301687395,50.89958393190817,1.1137114096471836,5.603734914968778,13307400,0.35598772578824894,0.6840572468847081,333973500.0,-22.282053233033846,19.18618833600314,16.367993510430818,78.76211756903916,32.82353346174997,21.323264556789756,0.2045408778652725,0.6430457356707027,51.86777212524414,51.32611225891113,50.88833236694336,50.45055247497559,49.908892608642574,0.14,0.0,46.57037307681709,-0.00713963313708077,0.002897660877665736,51.02263968331473,50.27260889325823,1.2894515358797827
2023-06-23,0,51.88749980926514,48.700833320617676,52.49499988555908,49.174999713897705,51.541040658950806,0.09522704057261626,1.2987451740837679,-1.4728968386372934,2.9954004940837606,50.19041728973389,1.1763540840148927,0.025768007838962072,48.76550054550171,52.154333400726316,0.9118472222096465,0.0512877072351184,1.029484096272029,1.006010369786077,0.9998137385223669,-0.011572532195796126,68.88296415888728,52.99894870693219,50.40145835876465,47.80396801059711,51.930952072143555,0.3872351276964867,51.2414881161281,0.9016333845039434,51.60479534865924,50.96965282867327,1.0227631169246931,5.75869092337765,18975000,0.35524794619771277,0.9792727061601285,352948500.0,-28.497926640026623,19.18618833600314,16.367993510430818,73.84020653124706,32.03844074583672,20.29548618047609,0.18039185213692888,0.6273521851979866,51.97869241333008,51.50565272521973,51.12333297729492,50.741013229370125,50.26797354125977,0.14,0.0,46.58159916864631,-0.014391803117547508,-0.008988409383882479,51.030130113874165,50.42804554530552,1.2875192717113568
2023-06-26,0,51.73333263397217,48.700833320617676,52.49499988555908,49.24812459945679,51.656041860580444,-0.10308854931808986,1.3089144646038722,-1.4863658199065295,2.995396462293242,50.639583587646484,1.1929998874664307,0.025901958546857284,48.76550054550171,52.154333400726316,0.8921623871974803,0.06332289892441915,1.0237449990908765,1.000133704335208,0.9991823648833104,-0.009951527050930165,72.22001248526792,53.15124562957089,50.53341670036316,47.91558777115544,51.872380529131206,0.38070975037996363,51.366547516414094,0.832335013768911,51.67173393570468,51.04403067105123,0.524700706699457,5.150722642754779,14106300,0.3277246172629905,0.7417737354265148,338842200.0,-32.71599560132156,19.18618833600314,16.367993510430818,57.74013362176159,30.234271777341558,21.852512268393856,0.18880788089416406,0.6173032886164596,51.97869241333008,51.50565272521973,51.12333297729492,50.741013229370125,50.26797354125977,0.14,0.0,46.58963063521406,-0.003086237504678402,-0.01699111232988963,50.944920676095144,50.550943919590544,1.2310813807456549
2023-06-27,0,51.54583263397217,48.700833320617676,52.49499988555908,49.722708225250244,51.74354124069214,-0.2912896873154764,1.270050778622781,-1.3727441877822308,2.9954174513759884,51.06541728973389,1.151520719528198,0.025060093894367114,48.76550054550171,52.154333400726316,0.8824476247907882,0.06226791425498406,1.0170801257815982,0.9948692278652427,0.997564748328443,0.0005823585781588037,69.29776480373691,53.220309858789754,50.68020830154419,48.14010674429863,51.73678520747593,0.27686203250497665,51.48779746464321,0.7086014233114288,51.68589059534054,51.10404010983995,-0.7862957238762982,3.5028891470519876,12093600,0.3303599791390447,0.6420600967740908,326748600.0,-40.69640886936317,19.18618833600314,16.367993510430818,47.853757530090704,28.14187514268764,21.345404096407467,0.15694456678915283,0.6158293568158695,52.020385650634765,51.573139236450196,51.211666107177734,50.85019297790527,50.402946563720704,0.02,1.0,46.59638374032847,0.002140634984322487,-0.00668684792680323,50.79322869437082,50.66120120457241,1.155056843209789
2023-06-28,0,51.698333740234375,48.71749973297119,52.49499988555908,49.877708196640015,51.74354124069214,-0.46077828409656535,1.197648920191782,-1.1674416558892973,2.9954535580170285,51.34875011444092,1.0673831939697265,0.02356534809660013,48.93658332824707,52.154333400726316,0.8724118552533154,0.05689873309554652,1.0172340241476971,0.9972432007833656,1.0003999301645612,0.004875542418205203,65.02719796532192,53.21775610759548,50.822458267211914,48.42716042682835,51.657499585832866,0.15841340445230853,51.617142745426726,0.5389917807868073,51.65075307753972,51.15523584897755,-1.8081098269475788,3.4053280437490385,18889800,0.3389286400938009,0.9945672046810967,345638400.0,-34.36009317991371,19.18618833600314,16.367993510430818,52.11239585224958,26.813337885237697,20.337718415420767,0.19078426266243817,0.6001749370767868,52.07938565063476,51.6686392364502,51.336666107177734,51.00469297790527,50.593946563720706,0.02,0.0,46.607187302023,0.005632414105345873,0.007589510307190294,50.78386470249721,50.78597205025809,1.0514261430936247
2023-06-29,0,51.38999938964844,48.71749973297119,52.49499988555908,49.95875072479248,51.74354124069214,-0.6324645802874084,1.1139286682490404,-0.8789429162341063,2.9954923095863197,51.48166561126709,0.9734832191467291,0.021855094517451684,49.306749534606936,52.154333400726316,0.834608401027511,0.061186104040676065,1.0082632092394024,0.9911393995535642,0.9934690133865938,-0.0074200647352199445,67.03493643036046,53.1966905922659,50.96883325576782,48.74097591926974,51.63952350616455,0.18247990726748756,51.687976019723074,0.418101305938429,51.661994209233676,51.251503517237126,-1.0621319610887006,3.6298350045454253,21530400,0.33565618550855714,1.1598578136628497,324108000.0,-59.577655876189716,19.18618833600314,16.367993510430818,18.503098206185854,24.519246234150543,24.45776691641929,0.16923066131584108,0.609448395637989,52.221772125244144,51.89911225891113,51.63833236694336,51.37755247497559,51.054892608642575,0.04,0.0,46.618522199127455,-0.009438223508576038,-0.001165412808583969,50.78948320661272,50.83536556788853,0.9368718751437467
2023-06-30,0,52.03833293914795,48.954999923706055,52.49499988555908,50.2943754196167,51.74354124069214,-0.7176254617866735,0.9891538585997294,-0.6508148869217778,2.9955440453083892,51.48166561126709,0.841887354850769,0.01935628720601437,49.79808330535889,52.154333400726316,0.8124228802494031,0.049739545904140724,1.0183136923898375,1.005103904836755,1.0074990474612013,0.0029069261467071783,59.77141604079842,53.08076595580114,51.102458238601685,49.12415052140223,51.7239283152989,0.2129553768848527,51.77065454210554,0.35605573465832796,51.59367520586601,51.308309197661266,-0.2442599739180812,1.967656012226963,19073100,0.3505549691929293,1.0307187486827643,343181100.0,-20.628593141189512,19.18618833600314,16.367993510430818,83.86599313996679,31.859126000414793,21.515793920765013,0.18083851756295755,0.6432972289329658,52.34291856384277,52.0952052230835,51.89499855041504,51.69479187774658,51.447078536987306,0.04,0.0,46.6302357926218,0.011064035736753075,0.009181362970620147,50.91682870047433,50.931109292166575,0.8485080226010308
2023-07-03,0,52.481666564941406,49.34583282470703,52.49499988555908,50.76020860671997,51.80250024795532,-0.768627502621122,0.8762831801523167,-0.569985489880529,2.9955854793212935,51.530832290649414,0.7203039073944083,0.0170959984595861,49.88358316421509,52.154333400726316,0.7663435727712145,0.054563880277501496,1.0239001627245572,1.0145616349268005,1.0154892072946777,0.014465217933356644,66.23536515303618,53.00919124967842,51.25662488937378,49.50405852906914,51.82499967302595,0.3587560320543032,51.858630657196045,0.36942623936222097,51.70460913566095,51.439244909827735,1.1484205690540756,2.27492206960955,8647500,0.36512302823840287,0.4810010829824904,351828600.0,-4.528190256974281,19.18618833600314,16.367993510430818,119.93470870005815,32.733342529699975,19.846656562926025,0.16198788764905683,0.6475853549843507,52.39639833068848,52.13846503448487,51.92999839782715,51.72153176116943,51.46359846496582,0.02,1.0,46.63590014758906,0.02031595574484535,0.01762511300261173,51.03153283255441,51.02708625793457,0.8041015580698769
2023-07-05,0,52.727500915527344,49.84833335876465,52.49499988555908,51.1577091217041,51.92520809173584,-0.7483141933173083,0.797351000705513,-0.470552393241078,2.9956115373912002,51.581249713897705,0.6256414318084709,0.015508617279322014,49.97300090789795,52.2761664390564,0.768217053221888,0.05000080995296148,1.0255591716451968,1.0188643042173189,1.0172998929230288,0.022924613323180187,69.02427690477995,53.00811857779652,51.4134165763855,49.81871457497448,51.944999831063406,0.49699720042734374,51.937975951603484,0.4280936504740925,51.89833047274888,51.608408372508094,1.3665106446962356,2.403249928483732,17585400,0.35370280454731573,0.9726577926452482,369414000.0,-16.889583783856196,19.18618833600314,16.367993510430818,133.3065416030689,33.09343350253562,18.53997952417332,0.17785714955199206,0.6437102723424712,52.56957368469238,52.278546669006346,52.04333305358887,51.80811943817139,51.51709242248535,0.04,0.0,46.647730847758915,0.02343196696460481,0.01973557922755046,51.1556020464216,51.09286608014788,0.7627729119364635
2023-07-06,0,52.50749969482422,49.84833335876465,52.727500915527344,51.35499978065491,52.06458306312561,-0.7930393573487833,0.7751748027811216,0.036516260705389936,2.9956187531801115,51.65750026702881,0.5791834592819214,0.015037144121474066,50.34725017547608,52.482999897003175,0.7074765470415088,0.05775855204708588,1.0185610233157545,1.0122431774234568,1.0084570183620265,0.01565168344990786,71.89135052417049,53.10101617622569,51.55066657066345,50.00031696510121,52.055595125470845,0.5272603979987456,51.963987827301025,0.4519315134542754,52.10350543279104,51.7828255824945,1.618889153167898,2.1520841826947077,14427000,0.34882314435654016,0.7992660513863751,354987000.0,-33.61209933765963,19.18618833600314,16.367993510430818,98.29744528644233,31.452218569176026,19.399822272981737,0.1315344376060159,0.6289212944107804,52.56957368469238,52.278546669006346,52.04333305358887,51.80811943817139,51.51709242248535,0.04,0.0,46.65697666206177,0.01145951529286715,0.01695905956895088,51.252047947474885,51.098484311785015,0.6708462621013102
2023-07-07,0,51.58666801452637,49.88749980926514,52.727500915527344,51.43312430381775,52.170833349227905,-0.8146126739555056,0.6957712440289174,0.46781712071385684,2.995641318324763,51.71583318710327,0.5220126008987428,0.013462121620607262,50.832583618164065,52.4962498664856,0.6540020872599892,0.0525181637800276,0.9981240310997695,0.9924632462894678,0.9877016238581768,0.003826982432647119,67.17473383320102,53.075167375524266,51.68362488746643,50.29208239940859,52.0614287512643,0.5208675108408546,51.89910697937012,0.43470682429846175,52.20377996889558,51.9206991244289,1.4964569677532662,0.698394666729875,19774800,0.35789968641562464,1.1093094583962673,335212200.0,-94.1470621444059,19.18618833600314,16.367993510430818,-46.84284139312451,27.368381798812266,29.013748819763507,0.04835904801771379,0.6711410166675773,52.56957368469238,52.278546669006346,52.04333305358887,51.80811943817139,51.51709242248535,0.02,1.0,46.667444140434874,-0.005120520855126265,-0.011845660582711592,51.20523016793387,50.999229431152344,0.5563594981302799
2023-07-10,0,51.60499954223633,50.39833354949951,52.727500915527344,51.498748779296875,52.170833349227905,-0.37072849104702926,0.5621800952332413,0.01304925158181458,2.9956732267112747,51.71583318710327,0.43910837173461914,0.010859483868817748,51.21308422088623,52.4962498664856,0.5813358320016108,0.02357884440483958,0.9968400959602783,0.9931741846253448,0.9873090638720919,-0.008327195981053914,50.5297373433747,52.892943488195975,51.76858329772949,50.64422310726301,52.04809529440744,0.5327699552674494,51.85279744012015,0.4285583452002006,52.05150579483166,51.91907668772465,0.07922149758288308,-1.730320741047547,12967800,0.4172398327516128,0.7397082818886468,348180000.0,-70.90295306971127,19.18618833600314,16.367993510430818,-34.68737051999172,25.416588845906055,26.94461550745847,0.004068403547899381,0.6710593846874154,52.56957368469238,52.278546669006346,52.04333305358887,51.80811943817139,51.51709242248535,0.02,0.0,46.67451636773223,-0.01463285202170439,0.0038890910422875557,51.18416268484933,50.98401369367327,0.5002262130632077
2023-07-11,0,51.56583309173584,50.88083362579346,52.727500915527344,51.53833246231079,52.170833349227905,0.2185836957046525,0.46889776717130305,-0.6318997680151259,2.995691374832577,51.71583318710327,0.3902833557128901,0.009047030074233308,51.37599954605103,52.4962498664856,0.5339704700815062,0.014232587495888894,0.994924001447411,0.9929602629958174,0.9881982717166216,-0.017450540982198115,49.152035659148126,52.76671213170894,51.82891659736633,50.89112106302372,52.07321439470564,0.4996886996388613,51.85636895043509,0.42573317143999245,51.944033928567436,51.9200492156024,-0.180536182204668,-1.2407506108008435,11460900,0.4053552335632094,0.661569059701919,336719100.0,-74.7491584392421,19.18618833600314,16.367993510430818,-56.29276546486458,23.909208071118798,27.000003728065334,-0.015555375301545887,0.6624122312854953,52.56957368469238,52.278546669006346,52.04333305358887,51.80811943817139,51.51709242248535,0.02,0.0,46.680655052363555,-0.022439894388205373,-0.016096233494099672,51.20148522513254,50.99548421587263,0.4693474172616332
2023-07-12,0,51.75500011444092,51.250000953674316,52.727500915527344,51.56083297729492,52.170833349227905,0.6164399066240024,0.420962748808964,-0.8738247011588838,2.9956993865402994,51.71583318710327,0.3628833770751953,0.008116796112620759,51.441749286651614,52.4962498664856,0.5091725616715425,0.006162578188964506,0.9979143877365229,0.9969244425798449,0.9953171699924016,-0.018443900890437237,47.16094906812606,52.705092068281374,51.86316657066345,51.02124107304553,52.03273827689035,0.5142483477058892,51.878333296094624,0.4106824252484374,51.853122965160914,51.88806035694899,0.3421554858450159,0.0970597630264504,16509900,0.39799132473863635,0.9481018753407889,353229000.0,-68.2273735458079,19.18618833600314,16.367993510430818,-26.900511150294598,24.21771898170269,25.7633947075285,-0.0706790320555265,0.6446209213952626,52.56957368469238,52.278546669006346,52.04333305358887,51.80811943817139,51.51709242248535,0.02,0.0,46.689818464065304,-0.019416862479436525,-0.019974638159673645,51.10129383632115,51.00906126839774,0.457189318032195
2023-07-13,0,51.570834159851074,51.38999938964844,52.727500915527344,51.581459283828735,52.170833349227905,0.7210243851126859,0.3979427985572363,-0.8262272039058658,2.9957029188003754,51.74416637420654,0.3427750825881958,0.0076692029778383485,51.50899868011474,52.4962498664856,0.5251622855734611,0.002680012662774838,0.9938795131920235,0.9929768914298912,0.9954990747569765,-0.017838700003182106,48.835526287737444,52.68430212581625,51.88841652870178,51.09253093158731,51.90261936187744,0.4966572359159079,51.86380951745169,0.4181766887778926,51.830627877005604,51.86742667179157,-0.5444694491623167,0.5976983207453636,11859600,0.39169859211138425,0.6887239999372811,341369400.0,-83.44474404879234,19.18618833600314,16.367993510430818,-73.19077396746991,22.50771372137388,28.121668401703076,-0.12241658125047297,0.6440529383624257,52.56957368469238,52.278546669006346,52.04333305358887,51.80811943817139,51.51709242248535,0.02,0.0,46.6960447009313,-0.01896760930538821,-0.025172351801303252,50.910743713378906,50.971138272966655,0.4701590520000288
2023-07-14,0,51.419166564941406,51.38999938964844,52.727500915527344,51.569583892822266,52.170833349227905,0.7197646119394415,0.3996295177756976,-0.8371317066947408,2.995702666947998,51.74416637420654,0.3445167160034174,0.007702049797879189,51.50899868011474,52.4962498664856,0.5557025241582811,-0.010979337865319507,0.9910003236320172,0.990299703534043,0.9961737083939227,-0.0032469910547002767,43.58768146895513,52.685383932554565,51.88612489700317,51.08686586145178,51.71571445465088,0.3625772053005845,51.830357142857146,0.4345476804546583,51.76662690852153,51.812412300991994,-1.735524926525071,-0.39273041469115677,10427400,0.3738437740347988,0.6249235880876526,330942000.0,-74.5818988366463,19.18618833600314,16.367993510430818,-78.1221639533771,21.57160897975773,27.371797458645105,-0.1250728076486455,0.6240016324623733,52.56957368469238,52.278546669006346,52.04333305358887,51.80811943817139,51.51709242248535,0.02,0.0,46.701441176280305,0.0076225628649480015,-0.015594205269335056,50.749220166887554,50.95241110665457,0.46413520985814394
2023-07-17,0,51.504167556762695,51.38999938964844,52.727500915527344,51.56083297729492,52.09208297729492,0.85874127462501,0.40741551262791087,-0.6616227333443558,2.995701471372151,51.71583318710327,0.34414170265197797,0.007857592445834522,51.44466600418091,52.4962498664856,0.5219989150079948,-0.020494015105496328,0.9933317347506647,0.991881049341535,0.9984685093424746,-0.001953918929717413,39.5274369151074,52.664747578753136,51.849916553497316,51.035085528241495,51.57238129207066,0.1022992618126276,51.81398820877075,0.44272292327917534,51.67954404730715,51.73882383827212,-2.481313029953702,-0.9025935842838663,10135200,0.36354189874634474,0.6223788526778189,341077200.0,-71.40454050495559,19.18618833600314,16.367993510430818,-59.009251373919724,21.806028536905,26.126460852304124,-0.11516270442583096,0.6070490404463652,52.56957368469238,52.278546669006346,52.04333305358887,51.80811943817139,51.51709242248535,0.02,0.0,46.706765580631945,-0.00019374632263391423,0.008860482362415257,50.64341081891741,50.94772938319615,0.4322603906633892
2023-07-18,0,51.56333351135254,51.38999938964844,52.727500915527344,51.53833246231079,51.92520809173584,1.1301627807948496,0.38562095552802544,0.03578357148178357,2.995704641199545,51.65166664123535,0.30935833930969353,0.0074443661073224365,51.44466600418091,52.484249877929685,0.5269546345441078,-0.014337181776670803,0.9954239438229359,0.9940430651746253,1.00000646226566,-4.847357704573785e-05,42.35147421317328,52.57161684811355,51.8003749370575,51.029133026001446,51.56904779161726,0.10213618370011059,51.815238271440776,0.44193152238500893,51.634418021954815,51.70136160368543,-1.910835868957638,-0.44297373770771703,13437300,0.3621057668183501,0.882715209992452,354514500.0,-76.08685251492227,19.18618833600314,16.367993510430818,-45.01213693367301,22.934546743987813,24.280428280287513,-0.03846150008616635,0.6065454285659887,52.56957368469238,52.278546669006346,52.04333305358887,51.80811943817139,51.51709242248535,0.02,0.0,46.71387814021391,-0.0005172245873154013,-0.0020015693602440814,50.69397463117327,50.94960239955357,0.4355932451694299
2023-07-19,0,51.53083324432373,51.38999938964844,52.727500915527344,51.53833246231079,51.80250024795532,1.4123102534110634,0.3742514531308541,0.7923062793522733,2.9957062274070894,51.59583377838135,0.2821417236328131,0.007229694338871393,51.44466600418091,52.484249877929685,0.6280333375172381,0.0009220770048797383,0.9954595239836065,0.9951783572818047,0.9993858494659547,-0.004331308465298167,47.07981856688085,52.514377864300045,51.76587495803833,51.01737205177662,51.55845260620117,0.101630718534634,51.8032739503043,0.4475712780807765,51.61499166027282,51.67995124126327,-0.04523359246086087,0.03395207039266418,12372900,0.32284137185518774,0.8336626438564806,342141600.0,-75.2507458744864,19.18618833600314,16.367993510430818,-58.073571211281404,21.60992020161891,23.316225301892324,0.012220565512239242,0.5977445827860229,52.56957368469238,52.278546669006346,52.04333305358887,51.80811943817139,51.51709242248535,0.02,0.0,46.72033113420921,-0.0027089737957105564,-0.00019395922024329125,50.68180138724191,50.93298203604562,0.4301022681226361
2023-07-20,0,52.07166576385498,51.38999938964844,52.727500915527344,51.54208278656006,51.80250024795532,1.4143554672197038,0.3737642874490336,0.7985436317236378,2.995706295937041,51.59583377838135,0.28169168472290096,0.007220178778967662,51.44466600418091,52.484249877929685,0.6180649452681104,0.0016197865841920418,1.0058926140313749,1.0079524890739873,1.0107535684084572,0.009711528079059395,46.739876745520796,52.514153597786255,51.766625022888185,51.019096447990115,51.630714416503906,0.21937551774825792,51.85196440560477,0.43608470361843926,51.595113762011266,51.67779587111233,-0.14371921048443367,-0.32399592751339834,14987700,0.3225265916977051,1.0245583093219035,357129300.0,-28.924295390875404,19.18618833600314,16.367993510430818,86.24287695706207,28.15220457964931,20.712903656475685,0.05360852932636521,0.6248103623603216,52.59396105957031,52.31802114868164,52.095001220703125,51.87198129272461,51.59604138183594,0.02,0.0,46.729275009313994,0.02173479627574393,0.015737769114320302,50.81429672241211,51.00789097377232,0.4525007843339905
2023-07-21,0,52.707499504089355,51.38999938964844,52.727500915527344,51.558958292007446,51.92520809173584,1.2429343771108878,0.3718685434387387,0.4125651558064738,2.9957065787888717,51.65166664123535,0.292716560363769,0.007179229697606165,51.495667457580566,52.484249877929685,0.5953786088729859,0.005746083807650034,1.0175618572821223,1.021121802195647,1.021110265688854,0.025055500219374638,56.59541909611296,52.541570434198036,51.797833347320555,51.054096260443075,51.76678575788225,0.4660409544319683,51.8997620173863,0.49126452252916486,51.71388833455912,51.74534668612301,0.9809454085988722,1.326457252972554,16960500,0.33701006827693936,1.1451205024878293,374089800.0,-13.227517499172473,19.18618833600314,16.367993510430818,156.12685780746227,31.469355211307768,19.6332505797866,0.048773811693171895,0.6120858163009618,52.59396105957031,52.31802114868164,52.095001220703125,51.87198129272461,51.59604138183594,0.02,1.0,46.740313179478235,0.023988126278631228,0.027509239048020093,50.970201764787944,51.035747800554546,0.5000184787591005
2023-07-24,0,52.899166107177734,51.38999938964844,52.727500915527344,51.558958292007446,52.04666614532471,1.024825337613214,0.42125415268934285,-0.3683317672126196,2.9956993536636167,51.65166664123535,0.3510165405273433,0.008125339292254887,51.495667457580566,52.52749967575073,0.5350012118392138,0.015803415039045646,1.020342874139323,1.0226144960135735,1.019733133998846,0.02708515866949246,65.63145577437794,52.68700827486111,51.84449996948242,51.001991664103734,51.95654746464321,0.6184640539914236,51.929583413260325,0.539599282754968,51.96019185895853,51.8848530520974,1.8404007101579867,1.2859108413866935,12529800,0.36408854514159744,0.864789429385158,386619600.0,-2.9851454425716772,19.18618833600314,16.367993510430818,153.04526716367548,31.84075778486902,18.171682555443834,0.10509901474804602,0.6140796429686387,52.68564024353027,52.392180488586426,52.15500068664551,51.91782088470459,51.62436112976074,0.04,0.0,46.748705521809896,0.028737440975034945,0.030001301256544197,51.21225248064314,51.06149809701102,0.5685394309563063
2023-07-25,0,53.201666831970215,51.38999938964844,52.899166107177734,51.558958292007446,52.17416596412659,0.9056095418603582,0.48002080496700994,-0.7224310608211337,2.9956896119315046,51.65166664123535,0.416774849891663,0.009249832057047885,51.495667457580566,52.70949964523315,0.6092621161023068,0.02253544115269289,1.0251774053513367,1.0258956660371688,1.020078175676434,0.03177322351079126,68.79309704620916,52.85512489431207,51.89508328437805,50.93504167444404,52.211190359933035,0.7191000967823802,51.96345240729196,0.6045112697609774,52.192426056376355,52.03104174765192,2.5757426052278074,0.7955150237458818,15553800,0.3624094645616589,1.06816599158587,402173400.0,-18.980178696475594,19.18618833600314,16.367993510430818,148.26063434046813,33.06292069339177,16.623769834478995,0.09379899111770144,0.6233122201763764,52.947947570800785,52.60436102294922,52.32666778564453,52.04897454833985,51.705388000488284,0.06,0.0,46.75939429807706,0.029759945949471067,0.027897961443324494,51.42340360369001,51.08631188528879,0.61639977352517
2023-07-26,0,53.21749973297119,51.38999938964844,53.201666831970215,51.558958292007446,52.48812484741211,0.8347336724091711,0.5559494802634853,-0.7550301582903582,2.995675219815806,51.65166664123535,0.4886998367309573,0.010697816568203792,51.495667457580566,52.74466743469238,0.6503568687651884,0.032123531881930276,1.0240337846739997,1.0229741020914664,1.0140111107194165,0.03273120930628948,73.10915956447546,53.08039895480493,51.968499994277956,50.856601033750984,52.45595209939139,0.7298457418634832,52.01416669573103,0.6788723951541351,52.44402282743984,52.198618543401814,3.466606687950777,0.8992762945517059,15094200,0.3612152577927447,1.0260310986489931,417267600.0,-13.12152250885209,19.18618833600314,16.367993510430818,142.75458823609458,31.533297406468648,15.507405395361182,0.10980053200301415,0.6204564945757479,52.99378570556641,52.641439514160155,52.356666564941406,52.07189361572266,51.7195474243164,0.08,0.0,46.76998810717643,0.03311338743112713,0.03344753003631332,51.6523448399135,51.14787782941546,0.6622739857064104
2023-07-27,0,53.25083255767822,51.38999938964844,53.21749973297119,51.565208196640015,52.5574996471405,0.6676881229947343,0.6092300713769353,-1.0512382027019747,2.9956639543426085,51.72666692733765,0.5397498321533206,0.011704239910811794,51.495667457580566,52.92941617965698,0.7249386043082348,0.029385202245977245,1.023029802676824,1.0207452300127122,1.0081661691805088,0.02264507533080984,72.89438170934947,53.270543491981776,52.05208334922791,50.83362320647404,52.69702339172363,0.6613506715861026,52.13303559167044,0.7411036679013024,52.64031575110582,52.34916116949332,3.3265893955479124,1.3521878632072037,13400400,0.36120302338185567,0.928212523845345,430668000.0,-21.518926218570986,19.18618833600314,16.367993510430818,119.35042129106893,29.681122720237354,14.596545254343305,0.04593294826508559,0.6120906053496338,53.0040118560791,52.657992012023925,52.37833213806152,52.09867226409912,51.752652420043944,0.08,0.0,46.779293657276,0.01066807850265361,0.02936225474774726,51.86724036080496,51.280607495989116,0.690795974368774
2023-07-28,0,53.285834312438965,51.38999938964844,53.25083255767822,51.565208196640015,52.71249985694885,0.4901156357893732,0.6562992399579582,-1.3166894868356647,2.9956531823406514,51.896666526794434,0.5955665588378907,0.012589735517138802,51.495667457580566,53.203250122070315,0.7498145923452075,0.0362100251047019,1.0221778724696686,1.0181374311814098,1.0043445465867278,0.010972533582336519,75.50275680068447,53.44230677001601,52.1297082901001,50.817109810184185,52.94773783002581,0.4417772814238121,52.253095218113494,0.7838942644543947,52.79533906360021,52.480383096338414,3.272672520201108,3.225958580389881,11020200,0.34974765987784484,0.7921778529206894,441688200.0,-13.994592047915885,19.18618833600314,16.367993510430818,119.1711756069382,28.791047809759547,13.583666797051482,0.0056218478602229885,0.6107508619673775,53.067680465698245,52.7094935836792,52.420000076293945,52.13050656890869,51.772319686889645,0.1,0.0,46.78708569086758,0.009724096716635433,0.015430659744077872,52.11490958077567,51.39835548400879,0.7136720179949524
2023-07-31,0,53.28083324432373,51.419166564941406,53.285834312438965,51.569583892822266,52.77041721343994,0.33216311883550437,0.6791289445600869,-1.4850371557342557,2.9956478393115367,52.054999351501465,0.6258665895462038,0.01300402960466497,51.528166675567626,53.2208330154419,0.823923662913816,0.023972738995113582,1.0202267749303697,1.0144237710600026,1.0020656624111937,0.007214993453256158,74.09800854293232,53.5827579253598,52.224500036239625,50.86624214711945,53.12047604152134,0.2256781854101578,52.375595229012625,0.802026352663139,52.921423944526275,52.593245070651044,3.4057300408751936,3.257116142064783,13033200,0.3248783404852623,0.9576704122739823,428655000.0,-14.673929099540214,19.18618833600314,16.367993510430818,97.10326620887889,26.841549092448297,14.151216083883712,-0.04178513854308117,0.6083160840373694,53.067680465698245,52.7094935836792,52.420000076293945,52.13050656890869,51.772319686889645,0.1,0.0,46.79616361087194,0.0035154714134493226,0.009408424630184088,52.22633852277483,51.520317622593474,0.7493359426063111
2023-08-01,0,53.205833435058594,51.419166564941406,53.285834312438965,51.569583892822266,52.974791288375854,0.18523074426311867,0.7151333363376922,-1.6397577860505168,2.9956388160257257,52.27666616439819,0.6693748950958252,0.013677175293554314,51.528166675567626,53.25383262634277,0.8573932769357844,0.015227540047597885,1.0175801819806658,1.0095808002546292,0.9992206201096289,7.831715313622034e-05,72.42271488084165,53.7168917241738,52.28662505149841,50.856358378823025,53.19166660308838,0.1334437784166782,52.47922618048532,0.8093685791483498,53.01220464282592,52.65683981455083,2.32212175802542,3.325845913391718,11782500,0.3126413301000485,0.8559115648852882,416872500.0,-24.864140364189343,19.18618833600314,16.367993510430818,80.56613462891016,25.255393183693805,13.314973923261588,-0.09975234183680894,0.6003410747911168,53.067680465698245,52.7094935836792,52.420000076293945,52.13050656890869,51.772319686889645,0.1,0.0,46.8042234609771,-0.00037697571289174725,-0.0011926970377813073,52.26098414829799,51.61559295654297,0.7613715469426016
2023-08-02,0,53.05916690826416,51.419166564941406,53.285834312438965,51.569583892822266,53.20270848274231,0.11353673181816264,0.7419230334907387,-1.7447222838132037,2.995631791079804,52.2895827293396,0.7055832386016846,0.0141797182100153,51.528166675567626,53.25383262634277,0.8737670139943362,0.00907178438624595,1.0140728906575267,1.0036697214407364,0.9964505867507284,-0.002975202245530051,68.43331253675883,53.80667946198575,52.322833395004274,50.838987328022796,53.21452386038644,0.07657882815650194,52.58553566251482,0.7780121988799097,53.060263965981264,52.68620916192592,0.9454706363571177,2.8032717948209562,12660000,0.30983100063458613,0.9364075014672973,404212500.0,-23.369567752558982,19.18618833600314,16.367993510430818,73.0095613899294,23.359745408067177,14.01427682961035,-0.10561468228179323,0.6026975193651888,53.067680465698245,52.7094935836792,52.420000076293945,52.13050656890869,51.772319686889645,0.1,0.0,46.81280960841007,-0.0032551978017413274,0.00031415861543804393,52.25723920549665,51.734745843069895,0.7754719399792805
2023-08-03,0,53.02416706085205,51.419166564941406,53.285834312438965,51.569583892822266,53.20270848274231,0.08082260739090175,0.7543847452238297,-1.7943964545520112,2.9956284376666407,52.2895827293396,0.7221665382385254,0.01441331969030272,51.528166675567626,53.25383262634277,0.8965309317086751,0.010506446062872052,1.01308288111436,1.0001163231560597,0.9963858384078285,-0.004256562497509497,64.78813330391453,53.84818618508877,52.339416694641116,50.83064720419346,53.189166750226704,0.10547940417496628,52.700178555079866,0.7080263735467482,53.058420731259005,52.678415757253816,0.3024637491680908,2.88599704204859,13202700,0.30719826889058627,0.980990508628722,391009800.0,-23.365835179667403,19.18618833600314,16.367993510430818,58.781271636172455,22.415631132070008,13.529537796769281,-0.04686814409479585,0.583219255914438,53.081053955078126,52.73114050292969,52.448333740234375,52.16552697753906,51.815613525390624,0.1,0.0,46.8215961350517,0.0006282836156050742,-0.0030048988639270044,52.26145226614816,51.84242793491909,0.7935244010123204
2023-08-04,0,53.02583312988281,51.419166564941406,53.285834312438965,51.569583892822266,53.20270848274231,0.010439369471084484,0.7684143018986569,-1.8568325706563167,2.9956246096417494,52.38958263397217,0.747999906539917,0.014674126466980117,51.528166675567626,53.25383262634277,0.9152052524170746,0.027865708363271225,1.012614912869628,0.9983541425228198,0.997266679094592,-0.004879367770271648,73.41767327488182,53.90207866673981,52.36525006294251,50.828421459145204,53.161785806928364,0.12068038328764448,52.80886895315988,0.6218542774141912,53.04770855374764,52.67515211314335,-0.333635733028387,3.1214051162878342,14262000,0.21195808921480466,1.0818560407801014,405271800.0,-36.16140779789645,19.18618833600314,16.367993510430818,46.56355482933876,23.36100697412204,12.291987777893794,-0.011099592044744028,0.596084750609166,53.081053955078126,52.73114050292969,52.448333740234375,52.16552697753906,51.815613525390624,0.1,0.0,46.83093782752439,-0.009818101299471915,-0.005152057286945413,52.195906502859934,51.92412567138672,0.7480026505404187
2023-08-07,0,53.35916709899902,51.419166564941406,53.285834312438965,51.569583892822266,53.20270848274231,-0.18750956319695955,0.7594679373744968,-1.8114960292757722,2.9956272901077208,52.803332805633545,0.7349041318893434,0.014483378534541628,51.528166675567626,53.25383262634277,0.9132670271609151,0.027532866975099907,1.0175821484371381,1.0040282892323193,1.0045181496243465,0.001470207012643554,73.36107155954089,53.956144193459316,52.437208318710326,50.918272443961335,53.17726216997419,0.13948473955431823,52.93714278084891,0.5224385657467725,53.04221424055988,52.702408527600106,-0.36015709879288227,2.954451348899273,14268900,0.21222781435922952,1.0770643469124102,419540700.0,-9.651538278631596,19.18618833600314,16.367993510430818,82.68031408572854,24.469607481567945,10.941232930053944,0.00836818301787722,0.6218407579770667,53.14981407165527,52.786760597229005,52.49333381652832,52.199907035827636,51.83685356140137,0.12000000000000001,0.0,46.84097634845267,0.003940832251521309,0.003626968198735846,52.258174896240234,52.0627076285226,0.7576389660020064
2023-08-08,0,53.56416606903076,51.419166564941406,53.35916709899902,51.569583892822266,53.20875000953674,-0.3802042386228249,0.7595858184579468,-1.6803260641958826,2.995627510475127,52.96166658401489,0.7218499565124518,0.014461437851416166,51.528166675567626,53.28133335113525,0.883554909175504,0.03477756296640907,1.0197858357108178,1.0070140071177365,1.0080800581073508,0.006734837344659628,79.5324338850266,54.044088333464344,52.52491669654846,51.005745059632574,53.217023849487305,0.2014843808227233,53.08238083975656,0.3582415486749264,53.12142771082476,52.7757183825921,0.2034419672283228,3.4827724767854686,11017500,0.21792503662488785,0.8330318389418851,430558200.0,-14.434531158730458,19.18618833600314,16.367993510430818,86.92201991483263,24.06632017876086,10.065493975791973,0.013576304414333776,0.6276617615751057,53.34469258117676,53.017652336120605,52.75333213806152,52.48901194000244,52.16197169494629,0.14,0.0,46.84883310877146,0.009678797986695242,0.004941713210252363,52.29281997680664,52.20386477879116,0.7533063587720841
2023-08-09,0,53.71916580200195,51.419166564941406,53.56416606903076,51.70895862579346,53.22583293914795,-0.5498676083913631,0.7582856808230602,-1.4374608031634382,2.9956281801156246,53.02500009536743,0.6958832502365112,0.014409274721041043,51.528166675567626,53.29316759109497,0.8818778122252955,0.034956351088579016,1.0207949818939261,1.009240223322333,1.0096353969549134,0.012438923039988392,81.56217635209649,54.14140470705932,52.62483334541321,51.10826198376709,53.27964278629848,0.27814945537948566,53.20005941390991,0.2569728751985491,53.230780908161066,52.87468688153572,0.5223372406253636,3.9458566778192137,13209600,0.21831576659060156,1.0113951933921201,443767800.0,-25.536533913560266,19.18618833600314,16.367993510430818,102.1994352954962,24.571695160257484,9.502607586259987,0.014943819194160487,0.6173526062944896,53.66674617004394,53.43995951080322,53.25666618347168,53.07337285614014,52.846586196899416,0.16,0.0,46.85853188416043,0.010614144379997414,0.011312877913445924,52.34197834559849,52.284158434186665,0.7502938687936124
2023-08-10,0,53.569167137145996,51.419166564941406,53.71916580200195,51.946457862854004,53.2583327293396,-0.7004204025496191,0.7664202439998601,-1.1176620717353591,2.995626249725329,53.042500019073486,0.6693791103363033,0.01453672285035226,51.528166675567626,53.3796669960022,0.8558139920141982,0.04165788041147099,1.0160484957088787,1.0054744906480562,1.0043245930372722,0.010278333569454956,85.65462493147065,54.25588211779099,52.72304162979126,51.19020114179153,53.331547600882395,0.29544330480701403,53.26160710198538,0.2318897877353833,53.349714447499586,52.9842892083346,0.8226833759678869,3.163908843666315,15169500,0.20838185137112333,1.1469224304820749,428598300.0,-40.528747627366016,19.18618833600314,16.367993510430818,80.60829663443008,22.933374791425976,11.50499729273065,-0.0030758810097304187,0.6142084015759098,53.6761863861084,53.45523986053467,53.27666664123535,53.098093421936035,52.877146896362305,0.16,0.0,46.869335151350114,0.009856346335776145,0.010109937796976179,52.422492436000276,52.34173829214914,0.7046015838663541
2023-08-11,0,53.640000343322754,51.419166564941406,53.71916580200195,52.54854106903076,53.28208351135254,-0.9235661153926246,0.7394822308297619,-0.6477392530523396,2.9956338540052436,53.13041687011719,0.614108352661134,0.013999258181050456,51.528166675567626,53.564666175842284,0.8356491849767942,0.04181321316223943,1.0154675559887545,1.006202796064228,1.0036016744742078,0.01158241515858105,79.59203463699787,54.30192274031553,52.822958278656,51.34399381699647,53.41452380589077,0.2876563275149802,53.3145238331386,0.2273023743144704,53.402360274147455,53.07455500461763,0.682883207779982,1.634810304347273,14195100,0.2082705610020607,1.0581789312430812,442793400.0,-21.739058323359437,19.18618833600314,16.367993510430818,94.4103705030033,21.70011730460856,10.73006116084917,-0.02681102650179758,0.6115266565310067,53.70765257263184,53.506172416687015,53.343332290649414,53.18049216461181,52.97901200866699,0.16,0.0,46.87959540470936,0.021681630055854884,0.01577967004503319,52.54202216012137,52.39963068280901,0.6762816054217862
2023-08-14,0,53.66333293914795,51.504167556762695,53.71916580200195,52.85124945640564,53.30416750907898,-1.136996904497245,0.6850912647465437,-0.008417094254409285,2.9956481032089353,53.203750133514404,0.5327334117889393,0.012942367196248139,51.56008348464966,53.57625045776367,0.8078142846049495,0.04146912546846154,1.0137781571772326,1.0059721512636777,1.0017360289424415,0.005700348350351714,80.25898868659431,54.30418249706816,52.933999967575076,51.56381743808199,53.505833217075896,0.24070823035181949,53.347499983651296,0.2426409060069496,53.46042475254911,53.1737451242368,1.0946900769528043,1.4004648667694175,20813700,0.2083953617805401,1.4921739317457159,463607100.0,-57.67632687367337,19.18618833600314,16.367993510430818,76.59798698084354,22.315044806892406,9.322819531941535,-0.0945931961847006,0.6535602487960919,53.88082501220703,53.64625169372559,53.4566650390625,53.26707838439941,53.03250506591797,0.02,1.0,46.89429735335523,0.0004909332910938424,0.014075982813892468,52.603297642299104,52.43237495422363,0.6102337284913221
2023-08-15,0,53.202500343322754,51.53083324432373,53.71916580200195,52.99291682243347,53.41041684150696,-1.3763416452177777,0.61811839171916,0.9573780645863876,2.9956640036600692,53.21166658401489,0.44712093353271526,0.011653385588836478,52.020832538604736,53.642333602905275,0.7621695115765178,0.040726603281633446,1.0030267002193247,0.9966187803406769,0.9920071454134456,-0.0067520088941908085,80.3812360177415,54.27819502013265,53.041958236694335,51.80572145325602,53.53107139042446,0.18474969724414037,53.34642859867641,0.24329132282104288,53.51098987909987,53.26668175366284,1.2054237034263515,0.8677662461889402,14559300,0.2090298827625546,1.0396028469064795,449047800.0,-74.68861146593602,19.18618833600314,16.367993510430818,15.883146008326671,20.78978515759638,9.635961500564013,-0.12161191794638608,0.6514014304529557,53.88082501220703,53.64625169372559,53.4566650390625,53.26707838439941,53.03250506591797,0.04,0.0,46.90401798261597,-0.005627828894409825,-0.004636487432862026,52.66911915370396,52.43251282828195,0.4972649382572481
2023-08-16,0,53.206665992736816,51.53083324432373,53.71916580200195,53.02541661262512,53.41041684150696,-1.6602742696577308,0.5170351157361868,2.6411345922576226,2.995684652175924,53.21166658401489,0.3549084329605094,0.009732624193364807,52.64391613006592,53.642333602905275,0.6429741537812967,0.03244013329016298,1.0015576678033897,0.996703036745903,0.9934246640849426,-0.00954035308653356,59.94551473661007,54.15798680976521,53.12391657829285,52.08984634682049,53.50928551810129,0.21492638693244948,53.34327384403774,0.24490725547078865,53.434873643267125,53.28138857410484,0.3331719711168107,-0.028185070181236917,26980800,0.24349586414933785,1.8310601849872448,476028600.0,-73.0289806210201,19.18618833600314,16.367993510430818,-9.176777633548225,18.859629647087637,10.705273627251694,-0.1528554324111139,0.6667773915973598,53.88082501220703,53.64625169372559,53.4566650390625,53.26707838439941,53.03250506591797,0.06,0.0,46.92186139578708,-0.00673562494850477,-0.005128110380045323,52.63803972516741,52.448107310703826,0.33163871809977924
2023-08-17,0,52.72916603088379,52.07166576385498,53.71916580200195,53.05083346366882,53.41041684150696,-1.2573466836818947,0.365719729073687,2.3670858123021414,2.9957085824401575,53.212082862854004,0.2472917079925537,0.006873435096865933,52.879999446868894,53.642333602905275,0.575385543200077,0.021796887275107778,0.9910061492802956,0.9874853391153559,0.9863969847038522,-0.01568068258578048,56.58224884344478,53.93914767386087,53.2077082157135,52.47626875756613,53.389999798366,0.36127807151273683,53.303511823926655,0.2950135824968433,53.380280885613395,53.29754354622837,-0.285801136999134,-0.08294060922628314,53614200,0.21924608762915523,3.2169044355422995,422414400.0,-91.36590279303739,19.18618833600314,16.367993510430818,-223.40925532267934,15.266682572132611,19.09406746950912,-0.30335779159588094,0.7648647861637887,53.64954512023926,53.27189186859131,52.966665267944336,52.66143866729736,52.28378541564941,0.08,0.0,46.95280401643588,-0.028516176565312357,-0.0290008605980842,52.43173326764788,52.36227662222726,0.3860451292470958
2023-08-18,0,52.35166645050049,52.707499504089355,53.71916580200195,53.05083346366882,53.41041684150696,-0.06946192086238391,0.2821181707063857,-0.6254594097529473,2.995718232341059,53.212082862854004,0.216725044250488,0.005298930883093193,52.88216609954834,53.642333602905275,0.5757803510706272,0.00041107104298796377,0.9833037745897725,0.9809576594888588,0.9824226688213472,-0.02401815593915524,37.16180084669039,53.804819570477704,53.24058322906494,52.67634688765217,53.19464274815151,0.4976220643547431,53.237142767224995,0.38979842457988867,53.21962760030233,53.235647914029975,-1.558878069847792,-1.0446834299171852,27954900,0.2058111546352806,1.6237635494419036,394459500.0,-62.49994469670938,19.18618833600314,16.367993510430818,-181.15497382117644,13.319821657353257,16.659125006737106,-0.29639988468350936,0.8140409438415434,53.64954512023926,53.27189186859131,52.966665267944336,52.66143866729736,52.28378541564941,0.08,0.0,46.969144329251414,-0.02028535236977591,-0.014538825131846443,52.31850051879883,52.33023943219866,0.38391215339645035
2023-08-21,0,52.58500003814697,52.35166645050049,53.71916580200195,53.05083346366882,53.41041684150696,-0.695443795943716,0.32337881564293813,0.6897849924386303,2.9957137885725955,53.212082862854004,0.23273753166198716,0.006075946151355552,52.88216609954834,53.642333602905275,0.5758516023726094,-0.010349873107034809,0.988016571108955,0.9865761149525983,0.9915960642429245,-0.020094407893444854,28.435986596164316,53.869549207671376,53.2227915763855,52.57603394509962,53.054047448294504,0.5129640600004385,53.19279752458845,0.4271583574714533,53.00382164128507,53.12300999962801,-2.54564517353414,-1.743904397220047,15679200,0.2170161678256263,0.9024734964027287,410138700.0,-67.91229340534039,19.18618833600314,16.367993510430818,-151.32131250584408,12.60514687998039,15.765279971744164,-0.3445710663698348,0.7987521960043682,53.64954512023926,53.27189186859131,52.966665267944336,52.66143866729736,52.28378541564941,0.08,0.0,46.97835472907488,-0.015562393723487,-0.022890787368630226,52.189292907714844,52.30589267185756,0.40012764535094747
2023-08-22,0,52.29416751861572,52.35166645050049,53.71916580200195,53.05083346366882,53.41041684150696,-0.7065891809908187,0.34558549984879244,0.2296742917543848,2.995711147620775,53.212082862854004,0.24791665077209474,0.0064951032567611006,52.71474943161011,53.642333602905275,0.7361293846464835,-0.011591117920626346,0.9828422138902956,0.9825467533700041,0.9901385542978406,-0.017073122857862666,34.236739692051366,53.89825427263154,53.20708327293396,52.515912273236374,52.8617856161935,0.5089396147660853,53.138154711042134,0.4898910740510791,52.90044622395497,53.052319591636476,-1.837189472218957,-1.1668521228398598,16670700,0.2119488761960053,0.9564684559391787,393468000.0,-74.35564292656164,19.18618833600314,16.367993510430818,-186.05711871054785,12.11138264842114,17.61523698564977,-0.3134573697944955,0.7719364830294471,53.64954512023926,53.27189186859131,52.966665267944336,52.66143866729736,52.28378541564941,0.08,0.0,46.98756854537909,-0.013632446173503898,-0.018687485923130562,51.992426191057476,52.267224175589426,0.42555532234973065
2023-08-23,0,52.46833324432373,52.29416751861572,53.71916580200195,53.02541661262512,53.41041684150696,-0.7167913275219695,0.3987978711438649,-0.209782144138714,2.9957040853800216,53.212082862854004,0.3062791013717643,0.007501600001995355,52.56166667938233,53.642333602905275,0.7306315736890648,-0.01735016148801544,0.986957246389922,0.9881770937379737,0.9968651052137115,-0.013876696361953544,29.402223711822163,53.95930404955397,53.16170830726624,52.364112564978505,52.691071374075754,0.37913066780708465,53.098452295575825,0.5213526862824365,52.7494047212454,52.94549854025057,-2.5090097242599367,-1.4417855277883869,14210400,0.219209230334965,0.817383021459583,407678400.0,-60.30919701096775,19.18618833600314,16.367993510430818,-108.9543447810226,14.802655802999084,16.5746898071483,-0.28263819095179155,0.7617982391070032,53.64954512023926,53.27189186859131,52.966665267944336,52.66143866729736,52.28378541564941,0.08,0.0,46.995799681896564,-0.007283595585548697,-0.006784709171372745,51.90315628051758,52.253226961408345,0.4292671890894259
2023-08-24,0,52.58916664123535,52.29416751861572,53.71916580200195,52.950416803359985,53.41041684150696,-0.5390444422280812,0.4260509719458627,-0.7433556646901742,2.995700067061858,53.206249713897705,0.34564994812011773,0.008019896225989701,52.45666656494141,53.642333602905275,0.8025907981973952,-0.014694593037713245,0.989927700781255,0.9927916527429755,1.001971966659366,-0.002655065501442566,34.911285352979164,53.97635192672559,53.12424998283386,52.27214803894213,52.603452273777556,0.30482935566799674,53.067261832101,0.5388014198019018,52.67945644570136,52.889615031841664,-2.226845835645915,-1.048265059761202,14033100,0.2241789384824897,0.8057185918828722,421711500.0,-75.90207040772535,19.18618833600314,16.367993510430818,-95.56788248744527,16.276067169048154,15.3310772050857,-0.2831300861904762,0.764765027918696,53.64954512023926,53.27189186859131,52.966665267944336,52.66143866729736,52.28378541564941,0.08,0.0,47.00389294304203,0.007707627900240821,-0.01488137092488504,51.79556056431362,52.23233985900879,0.4531312795944957
2023-08-25,0,52.46500015258789,52.29416751861572,53.71916580200195,52.69416618347168,53.41041684150696,-0.3531823859146147,0.44038560142636235,-1.0545248665586233,2.9956978365548714,53.204166889190674,0.36938331604003877,0.008294894026770347,52.45666656494141,53.642333602905275,0.833663386652093,-0.013074162771267415,0.9882058245561777,0.9922833998072934,1.0001397960388592,0.002164853762478769,38.411544268782436,53.97193788986444,53.09116668701172,52.210395484159,52.49750001089914,0.14958088197783204,53.00339276450021,0.5543111765874915,52.65607936076079,52.8561150494069,-1.1528287169390141,-0.8234976479820298,12267000,0.2265212189160296,0.7018049723628893,409444500.0,-63.91747864186917,19.18618833600314,16.367993510430818,-93.33780184502469,15.496707260366303,15.490806176966833,-0.24948992246332463,0.7458532402102176,53.64954512023926,53.27189186859131,52.966665267944336,52.66143866729736,52.28378541564941,0.08,0.0,47.01087200425993,-0.0006964434747587234,0.01368116803181597,51.72790309361049,52.18297140938895,0.4562688664910163
2023-08-28,0,52.772499084472656,52.29416751861572,53.71916580200195,52.58812499046326,53.41041684150696,-0.1755330341873159,0.45821884331709456,-1.2785193212488024,2.995694950960901,53.13083362579346,0.3918624544143675,0.008637469628927658,52.45366678237915,53.642333602905275,0.8319406942590031,-0.015311943189678899,0.9947667249670701,1.0003222251583892,1.0055671438403693,0.0035656374667616397,36.12082243131936,53.966562665653356,53.05012497901917,52.13368729238498,52.50369044712612,0.16121090568238156,52.94684512274606,0.5326616574942438,52.606956242915686,52.82181444897388,-1.393934061288805,-1.6757513188917574,11871000,0.2272063166907972,0.6814148700670825,421315500.0,-52.319567484024724,19.18618833600314,16.367993510430818,-33.31108911413348,17.6014146701355,14.970986074345783,-0.2276546269913959,0.7166255878507543,53.64954512023926,53.27189186859131,52.966665267944336,52.66143866729736,52.28378541564941,0.08,0.0,47.018020179818244,0.007682042115555454,0.005002231145498594,51.87026759556362,52.151000431605745,0.45402235498961807
2023-08-29,0,53.1783332824707,52.29416751861572,53.71916580200195,52.58812499046326,53.41041684150696,-0.025924943220207254,0.4588147676435695,-1.3081058233721838,2.9956948340704854,53.042500019073486,0.39432082176208494,0.008652848504105243,52.45366678237915,53.642333602905275,0.8573460904709,-0.008144489478110556,1.0028972344488698,1.0097199841250861,1.0125766794318298,0.01690754066484068,45.33613661739563,53.94233780631375,53.02470827102661,52.10707873573947,52.62178570883615,0.2858729206392496,52.908214228493826,0.4902655819008035,52.64684722818417,52.84089461112152,0.08218042660391549,-1.4779787358919123,12702300,0.24005588696668792,0.7272130826562746,434017800.0,-35.18041408154507,19.18618833600314,16.367993510430818,35.40331216733667,21.45165699813076,14.20359134463046,-0.1733124620902619,0.7013904776764257,53.64954512023926,53.27189186859131,52.966665267944336,52.66143866729736,52.28378541564941,0.02,1.0,47.026194141384615,0.019361818860496705,0.016125859924729778,51.969874790736604,52.14418765476772,0.46484979566345214
2023-08-30,0,53.56750011444092,52.29416751861572,53.71916580200195,52.58812499046326,53.41041684150696,-0.0182131411922588,0.458310829368695,-1.3015132510782046,2.9956949151626406,53.042500019073486,0.3931666946411127,0.008643568805680379,52.45366678237915,53.642333602905275,0.8484528215458604,0.002245914912546099,1.0102627808844176,1.01715593713973,1.0165639843974963,0.020949147841209603,55.191624041831645,53.93995492213462,53.02333326339722,52.10671160465982,52.76214286259243,0.4556061160065319,52.90809515544346,0.4900928768972685,52.779232281529,52.90394132000531,1.5790649811536455,-1.0067775838601998,10967700,0.2562108260888219,0.6309629005757521,444985500.0,-20.36075442536959,19.18618833600314,16.367993510430818,87.00181432210516,24.118781832984077,13.52615438548564,-0.1367863852341415,0.6839100892040023,53.64954512023926,53.27189186859131,52.966665267944336,52.66143866729736,52.28378541564941,0.04,0.0,47.03364643707088,0.019607758267159436,0.02668626135341774,52.14324842180525,52.16627066476004,0.498227949050434
2023-08-31,0,53.973334312438965,52.29416751861572,53.71916580200195,52.58812499046326,53.5649995803833,-0.10183122037431411,0.47343899847697857,-1.4165898991038668,2.9956924363880626,53.10208320617676,0.4182499885559082,0.00892460235458652,52.45366678237915,53.642333602905275,0.8139687586731644,0.010246894646460407,1.0174289571396617,1.024160323438043,1.0200102894348075,0.026320395617721815,62.01713286570462,53.99562792066001,53.048749923706055,52.101871926752096,53.0020238331386,0.5902888054525345,52.93190472466605,0.5344728591476254,52.976438529056765,53.02003371015701,1.8684036808618538,-0.003111907080448477,19582800,0.2697632085332669,1.1062800663334178,464568300.0,-4.767887655615065,19.18618833600314,16.367993510430818,137.06360673344537,28.335816931802743,12.569505029372973,-0.11892699210505873,0.6833929452939229,53.70302780151367,53.31515403747559,53.00166702270508,52.68818000793457,52.300306243896486,0.06,0.0,47.04784186143899,0.0364586756358205,0.02852611792752716,52.406363351004465,52.199394771030974,0.5681570653155212
2023-09-01,0,53.96249961853027,52.29416751861572,53.973334312438965,52.58812499046326,53.56791687011719,-0.06660791397581593,0.5143974998357762,-1.368496766813144,2.9956853333278772,53.19041681289673,0.45850422859191864,0.009688027006791812,52.45366678237915,53.66891622543335,0.7791791331741966,0.017868671299050013,1.0163155027487836,1.0215430251644402,1.0144979676219854,0.028542827820205785,67.43551212957377,54.12500328595696,53.0962082862854,52.06741328661385,53.215476172310964,0.6336928836987592,52.95327377319336,0.5707176169714242,53.226353980623955,53.168161609309266,3.211002055297067,0.6214279772235408,12553500,0.28243836489932744,0.7126167826403861,452014800.0,-17.816866016685093,19.18618833600314,16.367993510430818,96.50947954921114,25.63325428868883,14.11995140960479,-0.09207754639693204,0.7014840489155066,53.70302780151367,53.31515403747559,53.00166702270508,52.68818000793457,52.300306243896486,0.06,0.0,47.056641575763464,0.0237611360344403,0.02982983896168876,52.56939969744001,52.23627798897879,0.5869239765332779
2023-09-05,0,53.75833320617676,52.29416751861572,53.973334312438965,52.58812499046326,53.586875438690186,-0.11429720652557716,0.5474365972823747,-1.4194438557504399,2.995679193983049,53.204583168029785,0.4889333724975586,0.01030119053577033,52.45366678237915,53.743499183654784,0.8189664241079228,0.011307007817642042,1.0115780274671913,1.0145841520627636,1.0050008554230865,0.018680830713097007,66.11716723743014,54.237914805282514,53.14304161071777,52.04816841615303,53.38249996730259,0.5939348335396111,52.99297612054007,0.6075347863525288,53.41279156983988,53.28963112647934,2.8477488835957807,0.55748807052586,15209400,0.2746054628238835,0.8610840065594431,436805400.0,-34.12805307066037,19.18618833600314,16.367993510430818,71.41372086363513,23.392965584573393,12.885899451576384,-0.14462322630913002,0.7137589723711798,53.70302780151367,53.31515403747559,53.00166702270508,52.68818000793457,52.300306243896486,0.06,0.0,47.06702405038362,0.009765546786144386,0.015523882435313236,52.72820826939174,52.26188441685268,0.5896892410917297
2023-09-06,0,53.66250038146973,52.29416751861572,53.973334312438965,52.58812499046326,53.64583349227905,-0.14943804794429605,0.5620339581637297,-1.4929746274099893,2.9956763600113745,53.204583168029785,0.5049000167846686,0.010571900740194476,52.45366678237915,53.77874984741211,0.8443304962509834,0.003624944648550365,1.0093956410695706,1.0105377199319772,0.9995250386438113,0.009104593339306799,60.13110721004952,54.28706783240411,53.16299991607666,52.0389319997492,53.55357142857143,0.437471470852312,53.02553571973528,0.631605908389739,53.5005861523739,53.35908805027067,2.2232080095839715,1.0447495122731847,14594700,0.2762139294305234,0.8179993829148111,422210700.0,-19.07155062246026,19.18618833600314,16.367993510430818,73.39321164506559,21.636350266645564,12.815389348565184,-0.13009732702385807,0.7165857633025353,53.70302780151367,53.31515403747559,53.00166702270508,52.68818000793457,52.300306243896486,0.06,0.0,47.07700637500429,0.008872315188000579,0.017326106826762902,52.89970234462193,52.31380271911621,0.6089052398891144
2023-09-07,0,54.20333385467529,52.29416751861572,53.973334312438965,52.58812499046326,53.66270852088928,-0.15586183753464594,0.5659384398229871,-1.511453709601718,2.9956755894306717,53.204583168029785,0.5088333892822263,0.010644359901165953,52.45366678237915,53.77874984741211,0.8450432897880289,-0.0010548455041369017,1.0194744742425994,1.0180989552128166,1.007781010010134,0.01186976690859165,57.11959998529314,54.29979351134458,53.16791663169861,52.03603975205264,53.757976395743235,0.33365031502235337,53.13083342143467,0.6978089487322505,53.54286418346638,53.38862638589617,2.282474459923866,0.8567242096979646,19120800,0.2749701259146414,1.054213355144492,441331500.0,-0.12228517799987393,19.18618833600314,16.367993510430818,135.24958125061568,24.557567301611233,11.955523527723038,-0.04985979436802254,0.7132580779913051,53.85062568664551,53.453019294738766,53.13166618347168,52.81031307220459,52.41270668029785,0.08,0.0,47.091103939717634,0.014081839770532234,0.02136834391566293,53.12287957327707,52.49657358442034,0.6774163989267168
2023-09-08,0,54.51499938964844,52.29416751861572,54.20333385467529,52.58812499046326,53.66270852088928,-0.03334800936195238,0.5984237042472784,-1.4016009121904005,2.9956689796558473,53.204583168029785,0.529579286575317,0.011250231192324659,52.45366678237915,53.963583087921144,0.7995427628627718,0.011838278461670394,1.0248697406704907,1.0206268917068504,1.0111848774283687,0.010035790527112898,66.32466842146255,54.388972442826834,53.19212503433228,51.99527762583772,53.948928696768625,0.3290879826520239,53.28535720280239,0.749600567941271,53.70950744211987,53.467804932796504,2.7113265337544603,2.79573514007044,12667200,0.29784898777463,0.7032492634236767,453998700.0,-1.1810556510899684,19.18618833600314,16.367993510430818,147.6365071722994,25.20774590950765,11.62536627918201,0.007792275796581914,0.681120527202166,54.02055961608887,53.64972003936768,53.35000038146973,53.050280723571774,52.679441146850586,0.1,0.0,47.10073851525051,0.007133685943636614,0.015942936721192697,53.29766355242048,52.63376917157854,0.7453064994007849
2023-09-11,0,54.70666694641113,52.29416751861572,54.51499938964844,52.58812499046326,53.68708300590515,0.1524304990398587,0.6605045221747521,-1.1982179756344575,2.995655360302381,53.204583168029785,0.5791084337234494,0.012406306525759041,52.45366678237915,53.9963342666626,0.7944815816847806,0.016312435509419337,1.0275594736355473,1.0205357055032458,1.0127050985158734,0.01379045324329864,69.8084166859888,54.560425691306904,53.239416646957395,51.918407602607886,54.11166681562151,0.3858080321905106,53.436904839106965,0.8092161816879083,53.91116113004818,53.57013050598419,2.513553969579454,4.132309601249126,11912100,0.30422941268065884,0.6655458860759493,465910800.0,-1.6991147492715502,19.18618833600314,16.367993510430818,149.6634429245379,26.71704559769973,11.277245326520083,0.01898244842105818,0.6519929540572845,54.17845462036133,53.777441390991214,53.45333480834961,53.129228225708005,52.72821499633789,0.12000000000000001,0.0,47.11001684551043,0.01714431748964751,0.01063900887179658,53.445195879255024,52.79422215053013,0.814210428206434
2023-09-12,0,54.832499504089355,52.29416751861572,54.70666694641113,52.58812499046326,53.80937480926514,0.29089666772374967,0.7300956011924771,-1.0990523834785522,2.995638551543534,53.204583168029785,0.6377750968933107,0.013699717156762199,52.45366678237915,54.23450040817261,0.8137316529618931,0.01944221408026002,1.0288922888692895,1.0186234346026501,1.0122455778469874,0.0199813914206175,71.79376730553257,54.75294117949677,53.29274997711182,51.83255877472686,54.234404700142996,0.4633391111388634,53.6182142666408,0.8178025499555285,54.10998313606095,53.67157166207145,2.1266006991860986,4.03473786578878,11757300,0.3058853668547492,0.6739476607613918,477668100.0,-4.869310405286571,19.18618833600314,16.367993510430818,139.26223013986007,27.52339433783567,10.895878774267038,0.054604021406130965,0.6266123995996491,54.31429200744629,53.904518577575686,53.57333183288574,53.2421450881958,52.832371658325194,0.14,0.0,47.11928719016457,0.026517737062015545,0.018258303658502006,53.53493663242885,52.970649991716655,0.8840345983604125
2023-09-13,0,54.97583293914795,52.29416751861572,54.832499504089355,52.58812499046326,53.965208292007446,0.35150988417710344,0.8008102487124938,-1.1402502203083156,2.9956198113988464,53.204583168029785,0.7020792579650881,0.015010161421818371,52.45366678237915,54.534166145324704,0.8497245550934475,0.030637642032761654,1.0304515058869974,1.017392717393057,1.0108824824162088,0.02447393521252561,76.20540741119565,54.95282880278388,53.35120830535889,51.7495878079339,54.37916660308838,0.5191644235118534,53.797321387699675,0.82117196654622,54.288893362715676,53.77718824131477,1.5918327125704055,4.853948548985,14364300,0.280851490577019,0.8238455992800965,492032400.0,-13.85608221064018,19.18618833600314,16.367993510430818,130.85467568430295,29.501399240161913,10.27368843841348,0.054159483873649134,0.6170923645696518,54.550946350097654,54.09785980224609,53.731666564941406,53.36547332763672,52.91238677978516,0.16,0.0,47.13079284172166,0.019136684218850952,0.02676741009889065,53.67542157854353,53.12241063799177,0.9400029165356598
2023-09-14,0,55.03333282470703,52.29416751861572,54.97583293914795,52.58812499046326,54.03083419799805,0.2859787834812151,0.8742424379664322,-1.2722772519208172,2.995598657573531,53.38708305358887,0.7758750915527344,0.016359365343338372,52.45366678237915,54.719250202178955,0.8667868734096776,0.03325085143753679,1.0298177698112236,1.01508017130818,1.0070757526943204,0.015312692246145732,77.51142873112018,55.18835981108301,53.439874935150144,51.69139005921728,54.561309405735564,0.4877597644222127,53.971904686519075,0.8041995527409346,54.459151911135635,53.908345358105144,1.8778472601919751,4.779072518175507,14923800,0.2804416775220462,0.8865894128256584,506956200.0,-6.444709410954863,19.18618833600314,16.367993510430818,119.9729175880964,27.95643644566283,9.735664249444973,0.09304080544229978,0.6046809579660433,54.550946350097654,54.09785980224609,53.731666564941406,53.36547332763672,52.91238677978516,0.16,0.0,47.14281566472065,0.010888842659497966,0.023409848368721436,53.909405844552175,53.318807056971956,1.0020677453544546
2023-09-15,0,54.94000053405762,52.29416751861572,55.03333282470703,52.58812499046326,54.28125023841858,0.1841679956566528,0.93818662471942,-1.410080318074617,2.9955788464491553,53.61500024795532,0.834754204750061,0.017525975125932708,52.45366678237915,54.846832847595216,0.8769025153442155,0.04369814596486654,1.0263172138769165,1.0106262406575592,1.0023230800799143,0.007796040524030268,81.91746952081355,55.407581526187506,53.53120827674866,51.65483502730981,54.74380942753383,0.29717083459656807,54.14869042805263,0.7144919381618878,54.60100231454521,54.03431253879543,2.3717246099136453,4.647660990990491,63925200,0.24654525672229993,3.6847957473814543,443031000.0,-15.143867529294146,19.18618833600314,16.367993510430818,99.07134493774308,25.882135578676337,11.525806320971762,0.19634261567729613,0.6064895372624141,54.65478602600098,54.265939277648926,53.9516658782959,53.63739247894287,53.24854573059082,0.16,0.0,47.192948546369614,0.005312314578202582,0.007157317229611987,54.05834742954799,53.47902488708496,0.9660153464766185
2023-09-18,0,54.71249961853027,52.29416751861572,55.03333282470703,52.58812499046326,54.56291627883911,0.0069076272821416915,0.9669776950925207,-1.4712844234210252,2.995569787926292,53.71041679382324,0.8504083490371706,0.018026587407348527,52.45366678237915,54.94358377456665,0.8756661929675827,0.04944129306761321,1.0199611238743116,1.004654872454724,0.99662705279131,0.00010661720855442702,81.88035020764266,55.57570539209239,53.64175000190735,51.707794611722306,54.81654739379883,0.18334566931412422,54.28726189477103,0.6071137870640314,54.68426563085224,54.13314510083584,2.3806198807482812,4.717431381438097,12997800,0.22336406459464817,0.78297570888614,430033200.0,-34.764037033701975,19.18618833600314,16.367993510430818,72.34019358788957,23.91088928203533,12.678965052511614,0.15587027879721801,0.6095972639709303,54.73345329284668,54.3932735824585,54.11833381652832,53.84339405059814,53.50321434020996,0.16,0.0,47.20274184224054,-0.005598216046351356,-0.002137206428914108,54.055998120989116,53.58943884713309,0.9481435625562844
2023-09-19,0,54.40750026702881,52.29416751861572,55.03333282470703,52.72666597366333,54.70812511444092,-0.16963286539416725,0.9461614493746033,-1.4320312998321092,2.995577230405553,53.860416412353516,0.8257082939147949,0.01759979754670738,52.46799993515015,54.94358377456665,0.8998671719624673,0.04045829759132717,1.012048197857846,0.9976803525681525,0.9910502138301391,-0.007750863829011689,72.92750682136668,55.65211455905804,53.759791660308835,51.86746876155963,54.80119037628174,0.21464361701047646,54.37505953652518,0.5165305555174055,54.690122831094186,54.19766636154973,0.9393624481108601,3.6761581651690753,14019600,0.2361567995301808,0.848770715485089,416013600.0,-41.582521746669364,19.18618833600314,16.367993510430818,45.516308380909095,22.554275465548727,15.530419951747124,0.19802615490837744,0.6001021377463047,54.81605293273926,54.526972999572756,54.29333305358887,54.05969310760498,53.77061317443847,0.02,1.0,47.21290542545551,-0.00692918521743735,-0.00584156457861675,54.03767395019531,53.66766875130789,0.9099694941779766
2023-09-20,0,54.59833240509033,52.29416751861572,55.03333282470703,53.07687473297119,54.70812511444092,-0.3632691987474479,0.9159078964381927,-1.2521206199762096,2.995587323717259,53.96791696548462,0.7902416419982913,0.017008213658108905,52.46799993515015,54.94358377456665,0.8796158625723154,0.040412398718476204,1.0138793502419514,0.9999892997714546,0.9960684955078138,-0.006866663293223163,65.42496881184061,55.68273246462931,53.85091667175293,52.01910087887654,54.78571401323591,0.2261899448581286,54.44869041442871,0.46328650873522315,54.61718479533154,54.20955842048634,-0.1971918257785789,2.3114056208363314,10120800,0.23744625500728175,0.6251250768991305,426134400.0,-32.65998131183231,19.18618833600314,16.367993510430818,59.212967879872416,24.68234317065989,14.449947750134704,0.18209694784627292,0.5989042751763958,54.81605293273926,54.526972999572756,54.29333305358887,54.05969310760498,53.77061317443847,0.02,0.0,47.22045926030953,-0.003950043226834787,-0.003707780664184332,54.017469678606304,53.731332778930664,0.8489767682846019
2023-09-21,0,54.37249946594238,52.46500015258789,55.03333282470703,53.470208406448364,54.70812511444092,-0.5173592967170954,0.8557876213348862,-1.0556124511375213,2.9956061833792846,54.08833408355713,0.7270958518981935,0.015857866813037462,52.57708330154419,54.94358377456665,0.8649783656776598,0.04059589907016981,1.0075301784313342,0.9941490997229855,0.9933166824230402,-0.012007874588834122,67.69363545504399,55.67770015874643,53.96612491607666,52.254549673406885,54.71999972207205,0.27242740636358154,54.477202211107524,0.44364814371850053,54.61097696455881,54.25937370985668,-0.19802804185991035,1.924361391603411,18782400,0.2377077813588106,1.1439680753095263,407352000.0,-66.16170081592155,19.18618833600314,16.367993510430818,18.96931845820276,22.116326331790702,17.43608901952553,0.09831329718165657,0.6206490952774959,54.81605293273926,54.526972999572756,54.29333305358887,54.05969310760498,53.77061317443847,0.04,0.0,47.23372975036136,-0.020151206164478075,-0.01604277321044203,53.89530999319894,53.715123312813894,0.7938124022915674
2023-09-22,0,54.14416694641113,52.46500015258789,55.03333282470703,53.638750314712524,54.70812511444092,-0.6783410485733165,0.787017057929144,-0.693743831948733,2.995625950434487,54.28791666030884,0.6622832250595095,0.014557855142458598,52.75416584014893,54.94358377456665,0.8541773603279368,0.033910650017958524,1.0015322174705807,0.9896681507433692,0.9915394260083612,-0.014485503820720669,60.613090176680004,55.635367343015886,54.06133322715759,52.48729911129929,54.60119029453823,0.3195369411344608,54.4901784488133,0.4298787083691807,54.55072406427757,54.273648326248924,-0.8389186017549068,0.7395599300809258,13215000,0.24935661216225538,0.8068881319669662,394137000.0,-58.92244410407576,19.18618833600314,16.367993510430818,3.0003587642733724,20.980831956524774,16.540886954259918,0.12505423695092477,0.6075076167573957,54.81605293273926,54.526972999572756,54.29333305358887,54.05969310760498,53.77061317443847,0.04,0.0,47.24293194129474,-0.013909065426084721,-0.017549053566484073,53.79147393362863,53.73344775608608,0.6796596936870849
2023-09-25,0,54.201666831970215,52.46500015258789,55.03333282470703,53.734375,54.70812511444092,-0.8057826883393635,0.710865763007106,-0.17416227503807358,2.9956457592400763,54.28791666030884,0.5772665786743161,0.013130362031142847,53.1377498626709,54.94358377456665,0.7928049006654536,0.03200546629066226,1.0011559780071193,0.9913911427207271,0.995494096831796,-0.009336674253995314,55.45903043155571,55.56081476843059,54.13908324241638,52.71735171640218,54.482380867004395,0.28480555084787174,54.521845136369976,0.38590021999428714,54.44982861373647,54.26052919613936,-1.5127847060678041,0.33665476796867344,10459500,0.2551673330803763,0.6421851055051279,404596500.0,-46.801337070966866,19.18618833600314,16.367993510430818,-0.063520681001391,19.937385572663576,15.918743957763587,0.12917434187542695,0.5936377925693674,54.81605293273926,54.526972999572756,54.29333305358887,54.05969310760498,53.77061317443847,0.04,0.0,47.25026218789099,-0.00214171288910725,-0.00953599839040136,53.689047132219585,53.799226488385884,0.5775106153974118
2023-09-26,0,54.27750015258789,52.772499084472656,55.03333282470703,53.911458015441895,54.70812511444092,-0.6947737863545982,0.5982125298161763,-0.1552885927537253,2.9956712636087603,54.28791666030884,0.483499813079834,0.011031856491969158,53.528583431243895,54.94358377456665,0.7619687173103047,0.02708167648475198,1.0009512716328128,0.9936960559293792,0.9987610040043073,-0.002389378556318267,55.09090242199129,55.422341636017855,54.2259165763855,53.02949151675315,54.387737955365864,0.20677870343456586,54.56577369144985,0.3076163631359093,54.39018934722509,54.272896556088654,-1.5112041194849146,0.8246788904208783,14435700,0.24992068383562638,0.8793893855202933,419032200.0,-76.83486358935593,19.18618833600314,16.367993510430818,-5.869032382617823,20.729219774740965,15.140530699647913,0.06732350421420842,0.5795682120838044,54.94034671020508,54.72816038513184,54.55666732788086,54.38517427062988,54.17298794555664,0.04,0.0,47.26040844751073,-0.005386119146748469,-0.005629519583053015,53.588500431605745,53.82342393057687,0.48830518029125886
2023-09-27,0,53.853333473205566,53.1783332824707,55.03333282470703,53.97062563896179,54.70812511444092,-0.4189351857151176,0.4966966712876989,-0.5647127390588147,2.9956903842260307,54.32499980926514,0.4082497596740723,0.009147071823963283,53.653000354766846,54.94358377456665,0.7571404388132221,0.020669449421791268,0.9917527894080272,0.9869333399635368,0.9914302340438679,-0.013645085830777282,54.555823564644456,55.29455997236666,54.30116662979126,53.30777328721586,54.26499993460519,0.23495043933929521,54.54077366420201,0.3505622033593183,54.363014006961,54.300374984904636,-1.2058616218233176,1.1460512774215241,15711000,0.23749894284236264,0.9483865476520325,403321200.0,-74.28062736703441,19.18618833600314,16.367993510430818,-94.5737255948613,18.88295634250405,22.094094051183625,0.060935594895586774,0.5907895992961498,54.845946350097655,54.57535980224609,54.356666564941406,54.13797332763672,53.86738677978516,0.06,0.0,47.27069307774835,-0.013360904048095978,-0.010160363231867425,53.50862666538784,53.78231239318848,0.4461784407760484
2023-09-28,0,54.08000087738037,53.56750011444092,55.03333282470703,53.97062563896179,54.70812511444092,-0.054211091114196426,0.4388148933646978,-1.1105116151748096,2.995699656328596,54.32499980926514,0.3744997501373291,0.008076112387868843,53.74874992370606,54.94358377456665,0.7423362385628444,0.005335947321678214,0.9953084355748671,0.9931303154468342,0.9983416508590158,-0.005379531774977964,41.81539630393405,55.21254642605739,54.334916639328,53.45728685259861,54.218214307512554,0.23445194809399275,54.509702341897146,0.3716648022886731,54.23563417896897,54.27118043212024,-1.5703288120905388,-0.6457174431523226,11617200,0.24703116147336454,0.6998943579557315,414938400.0,-59.53235633130248,19.18618833600314,16.367993510430818,-47.53722243688015,20.389716303991552,20.965765570926735,0.05074476030242677,0.5781141916908724,54.845946350097655,54.57535980224609,54.356666564941406,54.13797332763672,53.86738677978516,0.06,0.0,47.27862789046976,0.0038290636641020726,-0.008358110015331975,53.46915980747768,53.7534168788365,0.4258738291138321
2023-09-29,0,53.77333354949951,53.66250038146973,55.03333282470703,54.05333423614502,54.70812511444092,0.06572456424089387,0.40706825497650384,-1.112698071817452,2.995704240311771,54.32499980926514,0.34887471199035647,0.007488303876581459,53.843833446502686,54.94358377456665,0.8070250895983099,0.0019762826643975437,0.9891978977792493,0.9892305009385846,0.9937536171450082,-0.0068489999537466595,45.29650116425779,55.174678187427986,54.36054167747498,53.54640516752197,54.10035732814244,0.21832832440719088,54.44303567068918,0.4148190653461123,54.19609161911388,54.26427611415601,-0.6019379461307536,-0.7979427994833033,18842400,0.235063420774394,1.1377240627878478,396096000.0,-88.88875524091003,19.18618833600314,16.367993510430818,-135.1433394355271,17.356634094793925,26.908261080186907,-0.021646754236192663,0.6306299936201796,54.75941253662109,54.435292358398435,54.17333221435547,53.9113720703125,53.587251892089846,0.08,0.0,47.29047517792368,-0.014906119033769594,-0.012290037228340989,53.28216116768973,53.64981542314802,0.48380657115984566
2023-10-02,0,53.18083381652832,53.66250038146973,55.03333282470703,54.05062556266785,54.70812511444092,0.033688510462450444,0.41874664840185993,-1.1580058405339622,2.9957025955098073,54.32499980926514,0.3588747501373291,0.00770455336362012,53.77183351516724,54.94358377456665,0.7678749563429031,-0.0035055097589623825,0.9784784514097045,0.9804349413495592,0.9841528857209335,-0.018833978272412955,39.259845872267036,55.18803493613172,54.350541639328,53.51304834252428,53.930119378226145,0.37740318218352903,54.3250595501491,0.5176565146847867,54.08903676491469,54.215203875438625,-1.5110330650206887,-1.7060688376900828,12992700,0.245215732583087,0.7834741213300372,383103300.0,-76.259875086324,19.18618833600314,16.367993510430818,-185.77408536175366,16.075539085398603,28.23606590053281,0.01035636698433277,0.6322515481181523,54.6901863861084,54.32323986053467,54.02666664123535,53.73009342193603,53.3631468963623,0.1,0.0,47.298105213485385,-0.018213047835834106,-0.01385906788729283,53.196648188999724,53.54597909109933,0.5181891915467307
2023-10-03,0,53.184165954589844,53.18083381652832,55.03333282470703,54.02333402633667,54.70812511444092,-0.41376376114781765,0.48446180553624857,-0.46585564999708895,2.9956924394729567,54.32499980926514,0.39795804023742676,0.008920066230243948,53.74874992370606,54.94358377456665,0.676399975687446,-0.010742509211243246,0.9792439306750067,0.9832728980748757,0.9879472737030317,-0.020143414765315337,31.254556439588374,55.2803819603004,54.311458349227905,53.34253473815541,53.79297637939453,0.45342616183574297,54.19708333696638,0.5638077215978485,53.861021597960004,54.10160320023729,-2.191669798370209,-3.012202074497544,11253300,0.2749341355398597,0.6867781789420493,394356600.0,-89.50208165509676,19.18618833600314,16.367993510430818,-173.98991336913963,16.626413122893837,26.04925941429647,0.03296758945453624,0.636376339446069,54.66217289733886,54.30057973480224,54.00833320617676,53.71608667755127,53.354493515014646,0.1,0.0,47.30467793090431,-0.0209846456962961,-0.024406590826503483,53.04347773960659,53.417475836617605,0.5574965012337727
2023-10-04,0,53.39250087738037,53.18083381652832,55.03333282470703,54.02333402633667,54.70812511444092,-0.5731887875624412,0.5311507383955405,-0.4319027710994501,2.9956843100427637,54.32499980926514,0.4266664028167725,0.009784890016187146,53.61466693878174,54.94358377456665,0.7309521275549854,-0.008913755853334355,0.9835997787605242,0.9893622602297151,0.9958624374819716,-0.008557178657370934,31.64700481920532,55.345051463439646,54.28274998664856,53.220448509857476,53.677381243024556,0.4346241284609627,54.079881055014475,0.5468904678786124,53.692249601859274,54.008998094270126,-1.7730460102404833,-3.259008347433824,15755700,0.274583377095765,0.9581608507579503,410112300.0,-63.40133872477046,19.18618833600314,16.367993510430818,-122.93408876599574,16.480567846194734,24.070736392819708,0.061523723858403614,0.6394923369981907,54.64180104064941,54.284100929260255,53.9950008392334,53.70590074920654,53.348200637817385,0.1,0.0,47.31429737026183,-0.004452170136199363,-0.009230897268081807,52.946219308035715,53.317633220127654,0.564890725147585
2023-10-05,0,53.290833473205566,53.18083381652832,55.03333282470703,54.02333402633667,54.70812511444092,-0.5834630065965877,0.5498459354755857,-0.5620390563699553,2.9956808434318094,54.32499980926514,0.44099139213562,0.010131813786990539,53.37166738510132,54.94358377456665,0.837222581769606,-0.014959097893661824,0.9819710694724507,0.9896897314686673,0.9956777994096361,-0.014592592296071571,33.857083177201154,55.36894188239527,54.26925001144409,53.16955814049292,53.53642886025565,0.36138443323823904,53.96208340781076,0.5245277699364911,53.619398955661495,53.95921889477714,-1.492880204400959,-2.9815238567379914,14269500,0.24718061281348333,0.8807721685994028,395842800.0,-88.8243139769158,19.18618833600314,16.367993510430818,-131.93292657742234,15.257073124732516,22.320885155261955,-0.03641668731571928,0.6414334513720644,54.52465266418457,54.18933954620361,53.91833305358887,53.64732656097412,53.31201344299316,0.1,0.0,47.32266580047351,-0.021287036830230144,-0.016324432579067134,52.785531180245535,53.18701580592564,0.6233334952977815
2023-10-06,0,52.1416654586792,53.18083381652832,55.03333282470703,53.83333349227905,54.70812511444092,-0.4683077596570817,0.5898276100034149,-0.9611034628014892,2.995673008666464,54.32499980926514,0.49117891311645534,0.0108776868032413,53.280166721343996,54.94358377456665,0.8517038291033653,-0.022455579751420148,0.9616041986498627,0.9702971253248103,0.9770882911003281,-0.030343443173712292,30.016215456872306,55.40328021237743,54.2236249923706,53.04396977236377,53.29190485818045,0.6069026213835663,53.77845239639282,0.6711295932345692,53.53917159896592,53.89976014387036,-1.8178189426715539,-3.0017601835109606,42616200,0.23280866301190745,2.407888770706116,353226600.0,-63.55283911671924,19.18618833600314,16.367993510430818,-234.43437111359358,11.763253240886296,39.86256700512842,-0.02521058493309917,0.7725217270971626,53.875945281982425,53.24035873413086,52.72666549682617,52.212972259521486,51.57738571166992,0.12000000000000001,0.0,47.34191007521948,-0.022009739962820407,-0.03771393128780964,52.536041259765625,53.02233396257673,0.7613545254269262
2023-10-09,0,51.669166564941406,52.1416654586792,55.03333282470703,53.67812538146973,54.70812511444092,-0.8727505792617164,0.739119508387914,0.2576031617811494,2.9956385837535935,54.23958349227905,0.5942998886108398,0.01366084609744514,53.18383274078369,54.94358377456665,0.6975507257478644,-0.04688645152234417,0.9549802493597186,0.9651008364352438,0.9741914598344359,-0.028425038554342752,18.037832001212916,55.58319731259797,54.104958295822144,52.62671927904632,52.94749995640346,0.751871645666413,53.58285713195801,0.8491250923761742,53.191859683321184,53.678214793195956,-3.178388233623455,-4.698805899521309,21022500,0.32817242069532077,1.1580031943206202,332204100.0,-67.91728005608132,19.18618833600314,16.367993510430818,-203.9628728517835,10.64978979463743,36.0893326519324,0.011270002609841978,0.7923415492374044,53.875945281982425,53.24035873413086,52.72666549682617,52.212972259521486,51.57738571166992,0.12000000000000001,0.0,47.35086019079612,-0.0266083429354258,-0.025573730021679255,52.22124263218471,52.845201219831196,0.872927797820703
2023-10-10,0,52.297499656677246,51.669166564941406,55.03333282470703,53.36708402633667,54.62687420845032,-0.9987850827271637,0.8954233797833779,0.3889544148802262,2.995593771589738,54.172916889190674,0.7138833045959473,0.016596333803396646,53.076916980743405,54.94358377456665,0.732172217229424,-0.057690839698307586,0.9693143835435835,0.9814798515851215,0.9916912625089032,-0.016671621750534937,14.760213865272451,55.74393003631542,53.95308327674866,52.162236517181896,52.73666654314314,0.68571252461361,53.41851193564279,0.8600535534187799,52.81202356527826,53.42369661852865,-4.457903611919737,-5.033007744608412,16014300,0.33033278833144036,0.8719087469364121,348218400.0,-53.69648661887162,19.18618833600314,16.367993510430818,-121.3647897708582,16.5687343651691,33.46830052279374,0.03492328920254975,0.7933648191405084,53.82246551513672,53.197098922729495,52.69166564941406,52.18623237609863,51.560865783691405,0.12000000000000001,0.0,47.35877224343264,-0.009365838707520835,-0.015615193776322743,52.11176790509905,52.69696453639439,0.8964630155502217
2023-10-11,0,52.75166702270508,51.669166564941406,55.03333282470703,53.264166593551636,54.45520830154419,-0.7695910002123626,0.9402641541628978,-0.29472617250892563,2.9955789946242772,54.11208391189575,0.768066692352295,0.017468478657003177,52.28191623687744,54.94358377456665,0.8124390052245807,-0.048718375680370615,0.9800345630828086,0.9936958097073724,1.0036784617154793,-0.012002319504512693,28.344867540081445,55.706861592703845,53.82633328437805,51.94580497605226,52.675357001168386,0.6580068928909949,53.302738189697266,0.8303353158707195,52.6842856081371,53.294859187136105,-2.7445460331443443,-4.214108100119508,12026100,0.3696833197842475,0.6589631197967566,360244500.0,-44.65939147073431,19.18618833600314,16.367993510430818,-79.09984355456638,19.575722515397413,31.012648344647438,0.0634553986630091,0.795029164160048,53.57798574829101,52.999339111328126,52.53166580200195,52.06399249267578,51.48534585571289,0.02,1.0,47.36514671463411,-0.017204942781185006,-0.005405816436268663,52.02390670776367,52.610277448381694,0.8909081421689105
2023-10-12,0,52.88000011444092,51.669166564941406,55.03333282470703,53.18333292007446,54.38124966621399,-0.6086699576120644,0.929197126785865,-0.5687021483860426,2.9955821090379913,53.96666717529297,0.7812667083740237,0.017298612392391007,52.28191623687744,54.73524971008301,0.8308131834608642,-0.04145970605250364,0.984452705373153,0.9981847193433854,1.0085796729208332,-0.007709268780177969,36.43753468119334,55.57351924212763,53.71512498855591,51.85673073498418,52.63190473828997,0.6281738062611315,53.21244055884225,0.7999755494283579,52.70172842766175,53.23266420012172,-0.806995233101929,-2.980978360673956,13514100,0.3908938617321217,0.7433682351873396,373758600.0,-38.60383997905624,19.18618833600314,16.367993510430818,-60.168336899478135,18.64945104320397,29.545211757506433,0.07269120257306222,0.774907964358856,53.57798574829101,52.999339111328126,52.53166580200195,52.06399249267578,51.48534585571289,0.02,0.0,47.37247914821603,-0.0008173249559347839,-0.012732934222154279,52.01732798985073,52.53040286472866,0.8429789570674886
2023-10-13,0,53.20416736602783,51.669166564941406,54.94000053405762,53.10562539100647,54.301249980926514,-0.5206220551604922,0.8943172137603744,-0.702507859175526,2.9955926994074518,53.81333351135254,0.7678792238235473,0.016682701273965837,52.28191623687744,54.60974912643432,0.8284020297691567,-0.037495456854604384,0.9924769612400047,1.006583918948851,1.0163553069153983,0.020377214613342964,38.85137859509449,55.39609278056335,53.6074583530426,51.818823925521855,52.60499995095389,0.5932291491588767,53.141190596989226,0.7478131946527371,52.745846658514196,53.18143673643843,-0.5719105201511128,-2.3348162937319112,13809000,0.3948066253329994,0.8810277572551286,387567600.0,-31.202621072529947,19.18618833600314,16.367993510430818,-23.646399693918305,21.3525205249587,28.094975029820368,0.10896839221831228,0.7567002853163429,53.57798574829101,52.999339111328126,52.53166580200195,52.06399249267578,51.48534585571289,0.04,0.0,47.38042683791965,0.021865706527832707,0.004714528661967595,51.96235602242606,52.454287665230886,0.7902899842152804
2023-10-16,0,53.67916679382324,51.669166564941406,54.71249961853027,53.10562539100647,54.220625162124634,-0.5131315153215539,0.8435752691142584,-0.6813171701197254,2.9956077114346726,53.58291721343994,0.7214166641235351,0.015761673409773188,52.28191623687744,54.426583480834964,0.8328148794937493,-0.027568330144280097,1.002961474678304,1.016665326927884,1.0212834095143604,0.038901347989724666,44.75090995759682,55.20781723286963,53.520666694641115,51.8335161564126,52.66047613961356,0.6798833814202964,53.0984524999346,0.6929628037700354,52.85939523005952,53.17913188742686,-0.35273401368679136,-1.8403483218232313,14348100,0.40513207924970407,0.9114965738119356,401915700.0,-16.72471783543241,19.18618833600314,16.367993510430818,28.55841394670973,24.940442415845688,26.104701594203696,0.1431066345561338,0.7562216935080327,53.47357342529297,52.91487992858887,52.46333312988281,52.01178633117676,51.453092834472656,0.06,0.0,47.38935186799071,0.034458511078599985,0.03068873953747466,52.062433515276226,52.423982347760884,0.7606512501175025
2023-10-17,0,53.68833351135254,51.669166564941406,54.59833240509033,53.10562539100647,54.1585419178009,-0.5738973591972363,0.7994889749042063,-0.5462839875252263,2.995620156573256,53.53583383560181,0.6697500228881836,0.014952383139869137,52.28191623687744,54.37599954605103,0.831980689977199,-0.013386637313439297,1.0041020676976884,1.015880127530176,1.0137046649611274,0.026594652972051103,52.413283063937676,55.06797800321418,53.469000053405765,51.87002210359735,52.881428718566895,0.7324655205710839,53.08666678837368,0.6804261389962648,53.06459619852997,53.270843345541074,0.7287056615711,-1.1023598306528135,10893000,0.4194563369409659,0.698944653246647,412808700.0,-14.895458052630845,19.18618833600314,16.367993510430818,32.34859521645778,23.87200818954599,24.98639117350053,0.1443189333834185,0.733634331593815,53.47357342529297,52.91487992858887,52.46333312988281,52.01178633117676,51.453092834472656,0.06,0.0,47.39610032383783,0.024238600422494372,0.03580599739701815,52.29782812935965,52.41693469456264,0.7304782997309515
2023-10-18,0,53.875,51.669166564941406,54.59833240509033,53.10562539100647,54.09604239463806,-0.5857945128473635,0.7721760451331181,-0.41117183003020674,2.995627549578592,53.53583383560181,0.6337916851043701,0.014451283706489067,52.28191623687744,54.28700008392334,0.8005222226851808,-0.01666715545423786,1.0082712544558143,1.0184406263675283,1.011914445752281,0.021294738928561596,51.91004556395239,54.977393805888184,53.43304171562195,51.88868962535571,53.19654778071812,0.5833150423529679,53.07202386856079,0.6592823211611356,53.220517796101916,53.36280009516964,2.9662804957755533,-0.30638764810189917,10559100,0.4161813387532016,0.6765687352468533,423367800.0,-13.850138266120911,19.18618833600314,16.367993510430818,52.0917269544037,24.726510095404038,23.631838397397424,0.14133733332002507,0.7202793930264275,53.47357342529297,52.91487992858887,52.46333312988281,52.01178633117676,51.453092834472656,0.08,0.0,47.40275428890981,0.02091885693710882,0.02499994112396702,52.56564113071987,52.39344188145229,0.6837426766626629
2023-10-19,0,53.68666648864746,51.669166564941406,54.37249946594238,53.10562539100647,53.92625021934509,-0.7277029784929134,0.7326793684588255,-0.2777806570566286,2.99563781380229,53.53583383560181,0.5976250648498536,0.013721390383805265,52.28191623687744,54.209250164031985,0.7904878062515985,-0.009149836237600304,1.0054271227063842,1.0139555787076013,1.0041397465758266,0.015254659085869537,55.36782241881599,54.86223383228509,53.396875095367434,51.93151635844978,53.3950001852853,0.4468004685507594,53.065833364214214,0.6525632946592358,53.38398067510734,53.43407485578202,4.2691484723024296,-0.3790696635622934,11745900,0.41709096427836756,0.7699697443758658,411621900.0,-14.845905451063949,19.18618833600314,16.367993510430818,34.6469464850269,23.394034981851078,24.04238432989425,0.18822180125571517,0.7069260667178991,53.27747900390625,52.756259048461914,52.334999084472656,51.9137391204834,51.39251916503906,0.08,0.0,47.40990951650977,0.011450158034743252,0.016052555788517518,52.71458271571568,52.41317531040737,0.6725700290856789
2023-10-20,0,53.28333282470703,51.669166564941406,54.27750015258789,53.10562539100647,53.858750104904175,-0.8129138894719455,0.7016052641915758,-0.1212792574490611,2.9956455248733205,53.53583383560181,0.5663251590728763,0.01314788788093351,52.28191623687744,54.14991693496704,0.7959575426013891,-0.008449672117339624,0.9985148653480186,1.0055862318134479,0.9935977000334748,0.0014879559740981207,53.153968197458575,54.76579397488584,53.36258344650268,51.95937291811953,53.47095244271414,0.35496356049281297,53.073154721941265,0.6545248173793652,53.46106908127937,53.456371278249655,2.656277720904098,-0.16117107705861658,15056700,0.41616525219123585,0.981077858357605,396565200.0,-33.61346962239837,19.18618833600314,16.367993510430818,-15.225688719430254,21.527824130468144,27.164492486162953,0.15487976601868628,0.7133362766914533,53.27747900390625,52.756259048461914,52.334999084472656,51.9137391204834,51.39251916503906,0.08,0.0,47.418366472902335,-0.006694635909643032,-0.0011953213105555095,52.73948451450893,52.3816956111363,0.6576428318659501
2023-10-23,0,53.25916576385498,51.669166564941406,54.27750015258789,53.10562539100647,53.793333530426025,-0.7853413301992966,0.678356656166134,-0.017481356388820757,2.995651066706497,53.34166717529297,0.5312085151672363,0.012722477238620444,52.28191623687744,54.09216747283936,0.7696209420916265,-0.01694291081693294,0.9988676576243578,1.0029691389023054,0.992853909486018,-0.007824283703609769,46.77815614315543,54.67625505274974,53.31954174041748,51.96282842808522,53.52511896405901,0.26804403695253426,53.07851185117449,0.6558089781460379,53.41780732781244,53.41892047031751,1.0078654040887778,0.192736745219769,17097000,0.4240580023219961,1.09044117998785,379468200.0,-12.605064465183672,19.18618833600314,16.367993510430818,16.073855848459857,19.22646215988717,26.475636411944407,0.16378637602295484,0.7416694433814611,53.27747900390625,52.756259048461914,52.334999084472656,51.9137391204834,51.39251916503906,0.08,0.0,47.42827384384079,-0.0012407262101090666,0.0073828003306499685,52.836273193359375,52.42680059160505,0.6188336928644363
2023-10-24,0,54.12666606903076,51.669166564941406,54.27750015258789,53.10562539100647,53.70958352088928,-0.8109129245434632,0.6474735603685687,0.15342221588078608,2.9956581651018372,53.2870831489563,0.4883418464660643,0.01215401141218413,52.28191623687744,53.895500087738036,0.733657443642987,-0.018761630249552994,1.0160354914446244,1.0162628235850506,1.01060833209132,0.008164391200288224,46.121262588290726,54.56736380774886,53.27241668701172,51.97746956627458,53.65690449305943,0.30777769198959315,53.13095222200666,0.7099647156210978,53.37777926320766,53.36789491189932,0.7170303490799667,0.1410190569297894,17535000,0.4231037524374514,1.107431252107814,397003200.0,-1.944141601070308,19.18618833600314,16.367993510430818,131.70831697671318,24.49831318721844,24.39267332400898,0.239461194722038,0.7475026074423835,53.56270539855957,52.986978828430175,52.52166557312012,52.05635231781006,51.48062574768066,0.1,0.0,47.43986526070581,0.01133688811338307,0.012654256190932403,52.996961321149556,52.47965867178781,0.6390628271711472
2023-10-25,0,54.393333435058594,51.669166564941406,54.12666606903076,53.10562539100647,53.70958352088928,-0.893996665473258,0.6365081270256568,0.18454904760869661,2.9956606141631186,53.2870831489563,0.4815543127059939,0.011949866159092458,52.28191623687744,53.895500087738036,0.6842158254858716,0.005075500033088768,1.0211857899335803,1.0177742535959111,1.0139276906129258,0.009621038237746626,59.83436291952428,54.53789123688517,53.26487498283386,51.991858728782546,53.758928298950195,0.4157989546079472,53.20970221928188,0.7861234542967044,53.56394815104781,53.42055815764443,1.7338842964244334,1.3750342830661793,16621800,0.46024052024107825,1.0467471227017509,413625000.0,-12.381723399723295,19.18618833600314,16.367993510430818,140.83302808918415,25.769858133683496,22.929701536903643,0.17929804999777726,0.738395474523787,53.779174591064454,53.162080871582035,52.663333892822266,52.1645869140625,51.54749319458008,0.12000000000000001,0.0,47.45107446935538,0.007552287664292834,0.00830122503605784,53.0697866167341,52.56611006600516,0.6600281683144255
2023-10-26,0,54.16166687011719,51.669166564941406,54.393333435058594,53.10562539100647,53.70958352088928,-0.6787218313964393,0.6713943327494292,0.04147853557792214,2.9956526805910766,53.2870831489563,0.506812677383423,0.012598437059865604,52.28191623687744,54.08466739654541,0.6737460626187479,0.005793871164844561,1.0163212851771866,1.0103359189123746,1.0076620508662613,0.008847641556775976,62.12714509894946,54.63466364642537,53.291874980926515,51.94908631542766,53.82654735020229,0.44017818436448003,53.35398803438459,0.7599568679270458,53.77376919136795,53.51193880421067,1.3304354070516782,2.06883602675751,16220100,0.46129700910623755,1.0068577015293652,397404900.0,-23.12563061349389,19.18618833600314,16.367993510430818,107.55199586761975,23.910016102704,24.045686752989674,0.1143942648383084,0.73898649557831,53.90582797241211,53.367087615966796,52.93166732788086,52.49624703979492,51.95750668334961,0.12000000000000001,0.0,47.461571527729724,0.0062201049102526,0.001423866679380061,53.08623123168945,52.692029680524556,0.6451945805425822
2023-10-27,0,53.764166831970215,51.669166564941406,54.393333435058594,53.10562539100647,53.70958352088928,-0.6546383234743266,0.6764047987737529,0.01249986773319689,2.995651507045023,53.2870831489563,0.5113043069839478,0.012691483943547606,52.28191623687744,54.130166149139406,0.7275968070839427,0.007221670946998415,1.0087850667576346,1.0005288270798238,0.9985018774114379,0.009024097813945753,59.418160603363376,54.64876787811086,53.295958280563354,51.94314868301585,53.810714040483745,0.4401382013732408,53.50363091060093,0.589919755356814,53.8721994483908,53.54782311645629,0.881631683845357,3.874063848303393,13829700,0.4588290856548074,0.8720416621739467,383575200.0,-36.44761000901535,19.18618833600314,16.367993510430818,56.02431472866901,22.787270614350746,26.421797956318386,0.14776551206277633,0.7200114077593788,54.094627792358395,53.67268732452393,53.33166694641113,52.99064656829834,52.56870610046387,0.12000000000000001,0.0,47.46996975093803,0.015180140334327685,0.0024880275353160743,53.068847111293245,52.81724412100656,0.6516344770457626
2023-10-30,0,54.044166564941406,51.669166564941406,54.393333435058594,53.10562539100647,53.70729184150696,-0.6545308862221593,0.6760842009271608,0.015512913260614436,2.9956515823412637,53.2870831489563,0.5108001375198363,0.012685577612159368,52.28191623687744,54.130166149139406,0.7786188643996704,0.010968858018555508,1.0140474640641617,1.004692479920202,1.0019125854420392,0.014739262056169489,55.236255890749916,54.64766834654121,53.29549994468689,51.94333154283257,53.861785479954314,0.4440690750323226,53.6283928326198,0.4917455409991475,53.844043026406105,53.539318165977555,-0.20572281768869635,4.054643042085199,12653700,0.4470332887845112,0.798741828703879,396228900.0,-17.969890582565423,19.18618833600314,16.367993510430818,91.58929575363224,25.1674207645113,24.28560671985878,0.14620586572976135,0.7273913018863595,54.2031884765625,53.848408432006835,53.561668395996094,53.27492835998535,52.920148315429685,0.12000000000000001,0.0,47.47809302044261,0.012483690061132036,0.026832927573027358,53.17456272670201,52.94457272120884,0.6887791153634649
2023-10-31,0,54.33166694641113,51.669166564941406,54.393333435058594,53.10812449455261,53.79187512397766,-0.72718142224677,0.6946899722350492,-0.06982463206696599,2.995647184645717,53.34166717529297,0.5425001621246338,0.013024134586598065,52.28191623687744,54.130166149139406,0.7712966915509744,0.016170237793817346,1.018616895170692,1.0093522845713392,1.0043193277456695,0.0037874284944674486,58.696804252554244,54.72804652657764,53.33866658210754,51.94928663763744,54.01154749734061,0.3899496859844385,53.741249970027376,0.4549902676108513,53.892528271476074,53.59744493141041,0.6659010508122012,3.33986695297229,14168400,0.4503979630826752,0.8862010052042824,410397300.0,-14.02440939112595,19.18618833600314,16.367993510430818,103.90660622502651,24.966716127428207,22.9354283915068,0.1992913917389541,0.7151967323145385,54.2606148071289,53.94136122131348,53.68333435058594,53.4253074798584,53.10605389404297,0.12000000000000001,0.0,47.48745507812303,0.0009801065023014033,0.014905985669224759,53.3930424281529,53.06626347133091,0.7238274446248527
2023-11-01,0,54.786667823791504,51.669166564941406,54.393333435058594,53.1231255531311,53.91729164123535,-0.7456949983124803,0.7262308346445648,-0.17382197545607436,2.9956394613271953,53.53583383560181,0.5790417194366455,0.013600836549903303,52.28191623687744,54.17866687774658,0.7720993308912691,0.01758984976537478,1.0260436195193043,1.0165901241241329,1.011963052375186,0.00723129773251574,61.418215671416725,54.84850330098774,53.39604163169861,51.94357996240948,54.22976207733154,0.31983708684956413,53.87744052069528,0.46265844828568997,54.00006519321058,53.6871016056829,1.967471001021914,2.995165864665471,14899500,0.4522496279524649,0.9344317351192241,425296800.0,-6.929269024624997,19.18618833600314,16.367993510430818,135.20842856421658,28.798658625451505,21.118322961337196,0.17970697086606408,0.7212540540821105,54.547680007934574,54.189493125915526,53.89999961853027,53.61050611114502,53.25231922912597,0.14,0.0,47.497950099924864,0.012964027799819533,0.00992348064486816,53.57440458025251,53.20533888680594,0.7959312585279934
2023-11-02,0,54.97666549682617,51.669166564941406,54.786667823791504,53.1231255531311,54.064791440963745,-0.5766388837903292,0.7869202024106765,-0.30509046294443154,2.995623643607855,53.68291664123535,0.6414251565933228,0.014718211242140565,52.28191623687744,54.33783359527588,0.7616205192966092,0.028069261692783197,1.0282595029228976,1.0183928596230305,1.013999099025704,0.015047517438179892,66.48832764112304,55.03959038384051,53.465749979019165,51.89190957419782,54.3511905670166,0.41988021250539126,54.004047530038015,0.5048438476750605,54.192677818136005,53.79671108593795,2.8680547996363517,3.6056499720579556,15492300,0.459485575267547,0.9678982264601832,440789100.0,-8.200799545038143,19.18618833600314,16.367993510430818,139.47701931801714,29.035725054226205,19.356674066867022,0.2430196705751943,0.7306885026639965,54.75396035766602,54.356353408813476,54.03499984741211,53.71364628601074,53.3160393371582,0.16,0.0,47.50917997836513,0.023181096346351016,0.016957613377788377,53.68106024605887,53.339010783604216,0.8662522659337557
2023-11-03,0,55.11166572570801,51.669166564941406,54.97666549682617,53.1231255531311,54.13541626930237,-0.4734782080611012,0.8513235735192567,-0.40802428480728326,2.9956055738005585,53.6875,0.6913667869567874,0.015897720121174068,52.28191623687744,54.432666873931886,0.7632476404080943,0.05437110635435361,1.02916195953217,1.018459898370942,1.0134422587444882,0.025063140994059152,73.85015226522317,55.252688727238706,53.550041580200194,51.84739443316168,54.453809465680806,0.5100046297567704,54.1063688823155,0.5743203597918649,54.383612883947876,53.91608386460952,1.570389402353654,3.3315024340182107,17240100,0.3570107806251622,1.1698259927856625,458029200.0,-19.80683272565437,19.18618833600314,16.367993510430818,135.20001768717185,27.673721020859684,18.206649015055437,0.1729071149464802,0.7213537731035939,54.78197384643555,54.3790135345459,54.0533332824707,53.72765303039551,53.32469271850586,0.18,0.0,47.521659584431845,0.02165415869175913,0.0178648363038872,53.770331791469026,53.42005920410156,0.8365584834137946
2023-11-06,0,54.92333221435547,51.669166564941406,55.11166572570801,53.24541616439819,54.204166889190674,-0.4669201620296171,0.8517375807561524,-0.07952037960585123,2.995606154382973,53.72625017166138,0.6586249828338623,0.015861465795533502,52.706250286102296,54.80566759109497,0.6982955946661649,0.06662579231735485,1.0228086384556654,1.0115616966451615,1.0049984422785274,0.016267540148993342,77.64447758604456,55.40201675506394,53.69854159355164,51.99506643203934,54.56261880057199,0.5184683130954499,54.194583075387136,0.5994678078365528,54.56477055340325,54.082849939038475,1.3206256084802137,2.6686310862217044,14529000,0.3257325850454797,1.0080731191256012,443500200.0,-17.149815208467516,19.18618833600314,16.367993510430818,116.36992885271681,26.21979801790535,18.698271016905565,0.10637339639128515,0.7069713934364567,54.78197384643555,54.3790135345459,54.0533332824707,53.72765303039551,53.32469271850586,0.18,0.0,47.532008519571775,0.011409751714137828,0.023019260391080154,53.9164548601423,53.501343045915874,0.7628370340329242
2023-11-07,0,55.28000068664551,52.297499656677246,55.11166572570801,53.27729105949402,54.347083568573,-0.1409644747840076,0.7537044342385751,-0.6764173602725623,2.995634293470423,53.81958341598511,0.6118332386016846,0.01399344493440924,52.86716680526733,54.92866554260254,0.7423884474507454,0.050209523876213864,1.0263408445568725,1.015019663102,1.0082807618319116,0.017454530544217306,71.59957762422916,55.3686587444995,53.86124987602234,52.353841007545185,54.779166494097026,0.4400222057672461,54.294940267290386,0.6567224919976437,54.655996201584514,54.23515057303399,1.4062812100388247,2.3003111145958477,15023400,0.3176750608307843,1.0459719698393801,458523600.0,-11.175769977857891,19.18618833600314,16.367993510430818,137.87965564365592,28.016269209163994,17.594312392866264,0.04695786039281657,0.6976639928798906,54.86091989135742,54.44287303161621,54.10499954223633,53.76712605285645,53.34907919311524,0.19999999999999998,0.0,47.54316023295605,0.013707842742559428,0.016133067049349102,54.12694713047573,53.59789712088449,0.7441182510649128
2023-11-08,0,55.0,52.75166702270508,55.28000068664551,53.58020830154419,54.49166703224182,0.09430021206534538,0.724022823475607,-0.956144957402036,2.9956424554937295,53.9595832824707,0.6032082557678222,0.013405254535766688,53.17175064086914,54.99016551971435,0.7425852542975457,0.047928981331570024,1.0183228698894846,1.0077443641008839,0.9997152376678594,0.003893870254979337,73.90919304159863,55.45842057447197,54.01037492752075,52.56232928056953,54.91571412767683,0.2999286018445752,54.38874980381557,0.6569513878716167,54.81380103913396,54.39679166793557,2.8194128989532126,2.6078899056065112,15591900,0.31328686658684735,1.0722427498334066,442931700.0,-26.891738142247483,19.18618833600314,16.367993510430818,88.74892443106441,25.487130301435354,21.857095156028247,0.022544656009771315,0.7121164013300155,54.86091989135742,54.44287303161621,54.10499954223633,53.76712605285645,53.34907919311524,0.02,1.0,47.554132202600385,-0.003457272393302846,0.00544645546716696,54.18708855765207,53.680825642177034,0.695098919539628
2023-11-09,0,54.67166709899902,52.88000011444092,55.28000068664551,53.684791564941406,54.820833921432495,0.060537971657981596,0.6937738505401562,-1.1078997121713796,2.9956501333754675,54.085416316986084,0.5863749504089355,0.012818515644393683,53.253665924072266,55.0111665725708,0.7622576382963839,0.04009076930731954,1.0101413010420737,1.0006161862252292,0.9929771624771302,-0.005547779136309328,66.86152523896426,55.51033927746581,54.122791576385495,52.73524387530518,54.96428557804653,0.20069734218121932,54.48791653769357,0.5771965110670589,54.86281842492484,54.485307723137744,1.7686153674144092,2.446293646543049,15080100,0.32659761675790516,1.0314924598264394,427851600.0,-31.315497078360682,19.18618833600314,16.367993510430818,50.6019452539292,24.37260746515463,22.037580275402743,0.0006561133632022344,0.6914889594032622,54.86091989135742,54.44287303161621,54.10499954223633,53.76712605285645,53.34907919311524,0.04,0.0,47.56431801691595,-0.009666649498641045,-0.00576228480512462,54.21104976109096,53.80204609462193,0.6476099323933816
2023-11-10,0,55.089999198913574,53.20416736602783,55.28000068664551,53.68791675567627,54.820833921432495,0.05025670841557173,0.6411970565329526,-1.2311177506991993,2.99566233960841,54.144166469573975,0.556362509727478,0.011827503543476196,53.280916118621825,55.0111665725708,0.7875781302741174,0.027582420806912693,1.016188633582358,1.007332356788317,1.0016849190401182,-0.0003931386669070447,58.89008748299066,55.494769038679316,54.2123749256134,52.92998081254749,55.007618631635395,0.18832069812920085,54.61869035448347,0.47590202220200617,54.81757530980321,54.508800268138,0.6257863446804282,2.605569510562285,14319900,0.3365908391807271,0.9777856074006324,442171500.0,-6.930661283286556,19.18618833600314,16.367993510430818,105.20332740079645,28.781342443833992,20.14062292523932,0.03085398910389212,0.7025731939750437,55.05994676208496,54.765026695251464,54.52666664123535,54.288306587219246,53.99338652038575,0.04,0.0,47.574697135749275,0.009291964740489655,0.004047870061170726,54.27306965419224,53.92373711722238,0.656770845117452
2023-11-13,0,55.66499996185303,53.25916576385498,55.28000068664551,53.745208501815796,54.936665534973145,-0.05278038138797412,0.6244436364842846,-1.283647592882185,2.995666150256775,54.24666690826416,0.549833345413208,0.011498471118381894,53.63958339691162,55.092165851593016,0.7933818908789996,0.02628268077463292,1.0250122780812496,1.0153847579244724,1.0122197393127876,0.013503691738931067,62.81394795578327,55.555553790226256,54.30666651725769,53.05777924428912,55.10595212663923,0.30991770282602943,54.72857134682791,0.528271331351728,54.885239367339,54.57783691250407,0.5536591057110184,3.437593151902339,15408900,0.333287954866874,1.0483475101670094,457580400.0,-2.595711283988301,19.18618833600314,16.367993510430818,150.5000095364691,31.882550366227314,18.88614998537133,0.07166068401174047,0.6957229929510171,55.380828277587895,55.02458792114258,54.73666763305664,54.448747344970705,54.09250698852539,0.02,1.0,47.58665997653167,0.016981983655065758,0.01834084254313032,54.374556405203684,54.02780832563128,0.7249762848859909
2023-11-14,0,56.01833248138428,53.25916576385498,55.66499996185303,53.847291707992554,54.98249912261963,-0.03610336408929189,0.6727828133264073,-1.0431479573322178,2.995655799670717,54.36250019073486,0.5851374626159668,0.01236597674016162,53.64633312225342,55.12849922180176,0.7433918932410405,0.03681742980684094,1.0296359876710426,1.0188176968108351,1.0159045681015852,0.013356218986392498,68.87826173151893,55.751523802312,54.40595817565918,53.06039254900636,55.235475948878694,0.4639080760178649,54.84464270727975,0.6195780990412484,55.078229438258774,54.70357010465762,1.252048407822394,2.8420998456848285,19792500,0.35095328710983625,1.3070179783071665,477372900.0,-17.441871296470072,19.18618833600314,16.367993510430818,156.50164090954044,34.20479194480946,17.650200062815124,0.01155655138727464,0.6912664433708106,55.70679838562012,55.288265312194824,54.94999885559082,54.611732398986824,54.19319932556153,0.04,0.0,47.60248643068785,0.012073584208513122,0.016799999662341258,54.515040806361604,54.142686298915315,0.774724973772304
