date,buy?,todays_price,Minimum,Maximum,25th Percentile,75th Percentile,Skewness,Standard Deviation,Kurtosis,Shannon Entropy,Median,Mean Absolute Deviation (MAD),Coefficient of Variation (CV),10th Percentile,90th Percentile,Autocorrelation,Cumulative Return,curr_to_avg_one_month,curr_to_avg_one_two_week,curr_to_avg_one_one_week,momentum,rsi,upper_band_current,middle_band_current,lower_band_current,rolling_mean_7,rolling_std_7,rolling_mean_14,rolling_std_14,ema_7,ema_14,roc_7,roc_14,Volume,Volatility,Relative Volume (RVOL),On-Balance Volume (OBV),Williams %R,Stochastic Oscillator %K,Stochastic Oscillator %D,Commodity Channel Index (CCI),ADX1,ADX2,Chaikin Money Flow (CMF),Average True Range (ATR),Fib_23.6,Fib_38.2,Fib_50,Fib_61.8,Fib_76.4,Parabolic SAR 2,Parabolic SAR 3,VWAP,Adj Close Momentum,Adj Close Return,Adj Close 7d MA,Adj Close 14d MA,Adj Close Volatility
2021-12-30,0,614.2324981689453,588.3324890136719,634.7100067138672,600.364990234375,614.7893829345703,0.09334228731113148,11.655321586012223,-0.39798357617182534,2.9955496021651777,610.536247253418,9.056589965820308,0.019118120550067008,594.4532592773437,622.1260177612305,0.6926228244163024,-0.038966635417935054,1.0075201150910909,1.0180701185845635,1.0039735056195203,0.008985443827641326,46.0661957102172,632.9585191485869,609.6478759765625,586.3372328045382,610.6107134137835,4.700250116698568,604.6078567504883,9.148201303251684,608.7610478538292,610.1364094422157,3.6790428332027645,-2.9370609776342262,1625100,7.290336667052357,0.600814099222502,-7505400.0,-21.91911388310518,91.40936679472856,92.55270083870475,52.25902925752344,21.101940581476335,21.244596410430358,0.011897727051794735,12.943205463121936,611.4366665039063,605.7616472167969,601.1749877929688,596.5883283691406,590.9133090820312,0.04,0.0,608.3721110355187,-0.0035002009199790463,0.011852879964088419,611.3871459960938,605.0349949428013,10.429086198480855
2021-12-31,0,607.1450042724609,588.3324890136719,628.4350128173828,600.364990234375,613.8593864440918,-0.2928583433223883,10.219766071711275,-0.5820605807256625,2.995591047593216,610.536247253418,8.21130142211914,0.016791592284378168,594.4532592773437,619.9760040283203,0.7851012528343861,-0.006019857606278847,0.9975699343510598,1.0036814989925564,0.9906174912028415,-0.010737551917821109,54.04124204380233,629.0635326927389,608.6240005493164,588.1844684058939,611.4835728236607,2.814769158312053,604.1885713849749,8.863323301228933,610.0990399139205,610.1412106274739,3.785731281902775,-0.9006726604667294,1995900,6.401430466364114,0.75657583005758,-9501300.0,-46.745524035638134,91.40936679472856,92.55270083870475,-12.402974057275955,19.315116772705203,25.914263020392386,0.0036353506245152146,12.860543343886125,611.4366665039063,605.7616472167969,601.1749877929688,596.5883283691406,590.9133090820312,0.04,0.0,608.2994932988339,-0.018971199505906422,-0.019210712393483594,611.0328630719866,604.3764256068638,10.323497280205428
2022-01-03,0,600.8824920654297,588.3324890136719,628.4350128173828,600.364990234375,613.5137557983398,-0.19147869998875283,9.995496771600124,-0.45450023283189855,2.9955970172958,609.6124954223633,7.926901855468759,0.016437700893551514,594.4532592773437,619.9760040283203,0.8017031583505522,-0.006463801766258609,0.9881576576370802,0.9912968127064506,0.9825124251057432,-0.019915439738992124,48.63883544300051,628.0746200995967,608.0836265563964,588.0926330131962,610.3578578404018,4.892946832695705,603.7387488228934,8.859628410167728,609.3839786217936,609.3689760133357,1.0165823932101175,-0.9575614174256732,3067500,6.41422175847618,1.202950611377344,-12568800.0,-59.78902277787722,91.40936679472856,92.55270083870475,-64.111779767293,16.835542679422193,30.17901054024609,0.031588790466358034,13.444078635178233,611.4366665039063,605.7616472167969,601.1749877929688,596.5883283691406,590.9133090820312,0.04,0.0,607.861925278877,-0.025688283085580466,-0.027227329881741345,608.6228637695312,603.8628540039062,10.509924487892386
2022-01-04,0,593.2674865722656,588.3324890136719,628.4350128173828,600.250617980957,613.5137557983398,-0.053747621204375526,10.089034412785017,-0.5612719378162994,2.9955943463030654,609.004997253418,8.18745239257812,0.016605468634290372,594.4532592773437,619.9760040283203,0.7873297536419591,-0.01373006130789986,0.9764546572996174,0.9767118708122803,0.9739499478761484,-0.0328842523944588,43.59767697029868,627.7510699242029,607.5730010986329,587.3949322730629,607.4339250837054,7.793966540615417,603.4878550938198,9.117823061823616,607.3226604172527,607.9047379732019,-1.2944300810768357,-1.0371744436320842,4393100,6.5479878014947435,1.6794158686469025,-16961900.0,-75.51897862753074,91.40936679472856,92.55270083870475,-113.89572685181953,14.848274310640361,32.23944094721609,0.006500863037686711,13.912559438658953,611.403623046875,605.7081616210937,601.10498046875,596.5017993164063,590.806337890625,0.02,1.0,606.7669318910492,-0.03202828978540906,-0.03583306836849418,605.345720563616,603.374285016741,11.028281375895741
2022-01-05,0,579.8100128173828,588.3324890136719,628.4350128173828,597.9612464904785,613.5137557983398,0.055696290148334174,10.547151458002128,-0.8065669572586844,2.9955812328225684,607.9712524414062,8.896704406738285,0.01738233913854866,593.1234878540039,619.9760040283203,0.7471503568106572,-0.04531122968758556,0.9555617285718853,0.9543302357322774,0.9582037010846922,-0.04945671078162028,34.77822689994458,627.8683034653207,606.7740005493164,585.6796976333121,602.6792842320034,12.498601867447102,602.16321345738,11.060948558264121,603.8630356899023,605.7038270749988,-3.334913076108248,-0.5885774010885139,4148700,6.010066449354544,1.5555534725021325,-21110600.0,-98.80883141431674,91.40936679472856,92.55270083870475,-191.83838448190227,12.632091150233553,35.89067519628063,-0.10397985021010807,14.947943934134816,607.9297099609375,600.0851328125,593.7449951171875,587.404857421875,579.5602802734375,0.04,0.0,604.9691471239937,-0.07046214833480902,-0.07072096557691668,598.8314383370536,600.6942879813058,13.129105968848357
2022-01-06,0,553.25,579.8100128173828,628.4350128173828,596.2712516784668,613.1793746948242,-0.15454558730583778,11.512302020922878,-0.3899203995300522,2.9955508396317936,607.1625061035156,9.720427932739256,0.019038251238448364,591.4779983520508,614.7907485961914,0.6146554616683427,-0.07737474680477416,0.9149267000230412,0.9138065304974384,0.9235186370940538,-0.09928243515401236,25.77227978702866,627.7178543165039,604.6932502746582,581.6686462328125,594.0807124546596,21.397832128826995,599.1992841448102,17.108171721101094,597.8625664121375,601.6398528560278,-5.428623907188792,-3.0993278308986842,5711800,6.221980598976148,2.0100647522522523,-26822400.0,-85.64889088370548,91.40936679472856,92.55270083870475,-277.6754798977882,10.909011612831147,44.293280168701486,-0.09400549879989463,15.842684423528011,602.0603911132813,590.5847946777344,581.3099975585938,572.0352004394531,560.5596040039062,0.06,0.0,601.1205233458206,-0.09606437982693894,-0.09376945336974477,590.6285749162946,597.9964294433594,16.055336000318302
2022-01-07,0,545.5424957275391,553.25,619.8150024414062,594.3756294250488,613.0343742370605,-1.551037135605269,14.91770652444168,2.7273822754322667,2.995420008946248,604.0899963378906,11.11560119628906,0.024824201215994723,587.480241394043,613.784764099121,0.5370031405426865,-0.10739495200860183,0.9078243135851761,0.9094144491265513,0.9295782148408362,-0.10146259643318634,18.291611993955897,630.7694126826724,600.9339996337891,571.0985865849058,584.875712803432,26.637473701135335,596.1428560529437,22.248842985658015,586.6921053471651,594.4228320966129,-9.81188090145057,-6.976941319733796,3382900,8.136706573014493,1.1697724357090247,-30205300.0,-96.55294774787055,91.40936679472856,92.55270083870475,-253.36644974799523,10.03048316793497,42.732946205141076,-0.09025497953623586,15.789792536054371,601.1659418945312,589.1369997558594,579.4149780273438,569.6929562988281,557.6640141601563,0.08,0.0,598.7353707378023,-0.10188567265465143,-0.11604506883045022,580.702863420759,594.7342878069196,20.46679755124895
2022-01-10,0,537.0874938964844,545.5424957275391,614.2324981689453,592.9074897766113,610.7368698120117,-1.5800684492831631,18.556219354011997,1.8018239377973169,2.9952412801432216,600.958740234375,13.420800170898428,0.03107097505811125,577.1540115356445,613.4695037841797,0.6787735663477195,-0.11006664393088052,0.8993120747558476,0.9056147318562872,0.9347959775386359,-0.10616884168094332,16.979629982091073,634.3328130061196,597.2203742980957,560.1079355900719,573.854997907366,28.369672635377665,592.2328556605747,27.301765564137472,576.3737166785643,587.2152160974803,-10.563504107579933,-7.273097115182168,4486100,8.158551860271585,1.5060116590769086,-34691400.0,-85.65068255950266,91.40936679472856,92.55270083870475,-221.5216754503127,9.126558944349966,45.055801111046854,-0.044448930284916706,15.920311859119446,598.3575505371093,584.5912137451172,573.4649963378906,562.338778930664,548.5724421386719,0.1,0.0,595.4634341699985,-0.09628876575892664,-0.10389420789094479,570.3828560965402,590.8850010463169,23.655981180807597
2022-01-11,0,537.9524993896484,537.0874938964844,614.2324981689453,590.9537467956543,609.0662460327148,-1.387893635229738,22.321412761488965,0.7957462648510081,2.9950118675970296,599.6187438964844,16.48505157470702,0.03761461079804993,552.4792495727539,613.4695037841797,0.75389870338179,-0.11543943002424925,0.9065229924555205,0.9188489142302457,0.9575661103695509,-0.09323785380893157,15.580313785067938,638.0668245464154,593.4239990234375,548.7811735004597,563.9703543526786,26.85098254327343,587.7269635881696,30.72791250121732,566.4970696168416,580.2104966899813,-12.55957711492532,-9.249317672736975,3077800,8.217912925981052,1.023616547879965,-31613600.0,-84.60067566561608,91.40936679472856,92.55270083870475,-169.14726362904568,8.585566636997408,41.82185023634153,-0.0058580930978003876,15.750380196427782,598.3575505371093,584.5912137451172,573.4649963378906,562.338778930664,548.5724421386719,0.1,0.0,593.4687231345769,-0.0851052955778191,-0.09463141557792693,561.5828595842634,586.307861328125,26.119585721159183
2022-01-12,0,539.4450073242188,537.0874938964844,614.2324981689453,586.2018699645996,609.0662460327148,-1.1055887998916907,25.11289155679477,-0.1689025689719652,2.9948112784662904,597.567497253418,19.780075073242188,0.042566919585034016,544.78349609375,613.4695037841797,0.8340682747128776,-0.09857485088303741,0.9143714970212246,0.9334335376387901,0.9795116958092978,-0.06961764129774939,17.033903594822362,640.1884067097809,589.9626235961914,539.7368404826019,555.1935708182199,22.455937645016046,582.7757143293109,32.60498469993214,559.2958045532732,574.5722781957636,-11.396372266247264,-10.495643386960497,3787400,8.118114589325549,1.2430196246391867,-27826200.0,-88.43995554252298,91.40936679472856,92.55270083870475,-138.97055924449646,8.223990314799616,39.14372657748954,-0.034397971292397876,15.467356621723647,598.3575505371093,584.5912137451172,573.4649963378906,562.338778930664,548.5724421386719,0.1,0.0,591.1792581268752,-0.05339027309230726,-0.09122904759141644,552.9899989536831,580.8064313616071,28.493271471867583
2022-01-13,0,528.8274993896484,537.0874938964844,614.2324981689453,573.1700096130371,609.0662460327148,-0.8567871679481631,27.344409240303623,-0.829059397673928,2.9946323098374465,596.5500030517578,22.94877349853514,0.04657571352513372,539.2957565307618,613.4695037841797,0.8718955830533623,-0.09845324067477992,0.9007515174064007,0.9263674293927758,0.9745179033537976,-0.04414369744302138,18.290986292903295,641.7846925040449,587.0958740234375,532.4070555428302,545.9878583635602,16.72296565727458,576.7108917236328,34.258169011966054,554.2919648223808,570.3739553619123,-10.224542327740355,-11.386622857274485,4475100,8.115636983413532,1.430942194424726,-32301300.0,-99.08158019967775,91.40936679472856,92.55270083870475,-140.98390314936546,7.298314092737385,41.61218359878325,-0.14210160589305432,16.033072029767123,596.4553911132813,581.5122946777344,569.4349975585938,557.3577004394531,542.4146040039062,0.12000000000000001,0.0,588.1606719392864,-0.06161319954114142,-0.08514238381252039,542.71142578125,574.0285731724331,31.802859672160267
2022-01-14,0,523.3849945068359,528.8274993896484,614.2324981689453,551.3231239318848,609.0662460327148,-0.6700355455649387,29.98421781336733,-1.177906430265146,2.9943962674524167,594.0062484741211,26.34214859008789,0.051376312570317176,537.865998840332,613.4695037841797,0.8704276133242999,-0.11083323077339889,0.8967914800968807,0.9307584018775071,0.9732488277323794,-0.04061553663414197,15.996226869910503,643.5879348332777,583.619499206543,523.6510635798082,537.9271414620536,9.916910692600055,570.3032128470285,35.30341122600965,547.8953840294456,565.6109141866459,-10.8618774231053,-13.83455632871956,7861100,8.287811877703305,2.3373348893563564,-40162400.0,-87.29881353877106,91.40936679472856,92.55270083870475,-120.82639038888692,6.387897143919963,39.42573062666933,-0.09970491494628635,16.863470728927787,594.9497099609375,579.0751328125,566.2449951171875,553.414857421875,537.5402802734375,0.14,0.0,583.4268944629446,-0.02840719178379658,-0.04988338246129139,536.7357090541294,567.7835736955915,34.104946277295255
2022-01-18,0,515.3274993896484,523.3849945068359,614.2324981689453,544.018123626709,609.0662460327148,-0.5103208232564121,32.581338463900416,-1.405265763185174,2.9941383107928985,592.547492980957,29.511198425292967,0.0561697341581514,536.2614944458007,613.4695037841797,0.8869116880885959,-0.11039250036271014,0.8884168057482646,0.9302864022476126,0.9662278913359654,-0.04051480392695539,15.180034406725591,645.2141753408866,580.0514984130859,514.8888214852852,532.5096413748605,10.492690978118768,563.2951769147601,35.816059441962494,541.761193965563,561.4884329645602,-9.731639168556153,-14.631968985279357,4839100,8.2724979816699,1.4291979792580078,-45001500.0,-98.10596332001181,91.40936679472856,92.55270083870475,-124.79414640047618,5.880616716007351,37.7887793842039,-0.1387054687688802,16.87501544190823,594.1945070800781,577.8527281494141,564.6449890136719,551.4372498779297,535.0954709472657,0.16,0.0,580.339096531085,-0.05381122368568936,-0.055927272210413354,530.6657104492188,560.6471426827567,37.25531120249676
2022-01-19,0,516.1450042724609,515.3274993896484,614.2324981689453,539.0718803405762,609.0662460327148,-0.3928896432382255,35.415397174635416,-1.5258618148374348,2.993827698618524,592.547492980957,33.039250183105466,0.061442263076741825,528.2832489013672,613.4695037841797,0.8895168787956728,-0.12926063773463456,0.895461287130999,0.9463786987321604,0.9757224967933287,-0.04053795668191873,12.672640648410157,647.2320432811556,576.4012489318848,505.570454582614,528.3099997384207,10.28807164930369,556.5928562709263,35.18224658455706,535.1926168150299,557.0701003513137,-6.8544962693812135,-15.993822160485726,4353500,8.165893525918628,1.2671583751498994,-40648000.0,-93.58528263592501,91.40936679472856,92.55270083870475,-103.77274498135263,6.217663387134802,35.52071121510367,-0.1475670349048826,16.548499390560472,594.1945070800781,577.8527281494141,564.6449890136719,551.4372498779297,535.0954709472657,0.16,0.0,577.8927346392951,-0.04618748661992389,-0.04443825380993481,527.0657087053571,553.8842860630581,39.21154560214785
2022-01-20,0,514.8925018310547,515.3274993896484,614.2324981689453,537.7362480163574,609.0662460327148,-0.2365468855732437,37.54428115882366,-1.6589414256643926,2.993569586726411,586.5387496948242,35.65916236877441,0.06556611664879647,522.6609954833984,613.4695037841797,0.9026738365011081,-0.141239671181829,0.8991915890953588,0.9576237439618634,0.9814467847049337,-0.04551438081696335,10.900797721357238,647.7056864936727,572.6171241760254,497.5285618583781,525.1392865862165,10.54891307759274,549.4971422467913,32.584776068543036,530.4662329128682,553.2931971863887,-5.388671219072208,-15.382942821081471,12659000,7.64880004431444,3.202685813460439,-53307000.0,-98.76807557306962,91.40936679472856,92.55270083870475,-96.58657018020978,5.65080898931993,33.938276211722915,-0.2841015409701748,16.794088974560175,588.792611328125,573.1487077636718,560.5050048828125,547.8613020019532,532.2173984375,0.18,0.0,571.4786330749187,-0.05392571438699212,-0.06025816366616286,522.5514264787946,546.4671412876675,40.75113032842503
2022-01-21,1,396.76749420166016,514.8925018310547,614.2324981689453,535.0224952697754,609.0662460327148,-0.06088562572925043,38.95188799829984,-1.71598119943842,2.9933777624387448,566.5300064086914,37.1245002746582,0.06853986030293008,516.0632537841797,613.4695037841797,0.9024131195004004,-0.1541980585002569,0.6981532866009571,0.7469471484458639,0.7634320975511651,-0.2497222730293085,8.10081618069236,646.2137758440117,568.3099998474121,490.4062238508125,504.97000013078963,48.53729708094208,534.4701772417341,48.55188590400054,526.614120835636,549.3305804271856,-4.132472328560203,-16.173028394627053,58904300,7.141227079009096,8.686604581886286,-112211300.0,-92.38695227581522,91.40936679472856,92.55270083870475,-253.68583052619908,3.4479270382107314,59.29023022848048,-0.09390054188935185,25.399050059754313,555.709990234375,522.129990234375,494.989990234375,467.849990234375,434.269990234375,0.19999999999999998,0.0,515.4987362795042,-0.2343990935009903,-0.2600796290581985,502.07427978515625,531.8285696847098,53.99040011983085
2022-01-24,1,377.4449996948242,396.76749420166016,614.2324981689453,527.4668731689453,607.8531265258789,-1.1457862128802252,52.862238050756,1.7441911532998828,2.9910395962620804,549.3962478637695,42.619025688171384,0.09478441193834185,515.2839996337891,613.4695037841797,0.6027537989233306,-0.3535198677889056,0.6767761573165154,0.7321391430631773,0.765137487534813,-0.2788387063895956,2.0729425759331477,663.4347258115948,557.710249710083,451.9857736085711,481.82714189801897,65.14109257664333,518.5103563581195,60.33560091389725,494.18868343768827,529.6186783833622,-26.244883209609462,-34.650290884447806,32346000,26.040330457769265,3.8890047785968878,-144557300.0,-85.66378587409301,91.40936679472856,92.55270083870475,-240.25400163284655,2.9963770189914185,59.64089736255306,0.11279400085916243,26.9833528042007,541.6577774658203,505.31108013916014,475.9349822998047,446.55888446044924,410.21218713378903,0.2,0.0,494.64427843640624,-0.2635393633158615,-0.25433361942582516,480.6357116699219,516.8128553118024,63.943292822155314
2022-01-25,1,374.6000061035156,377.4449996948242,614.2324981689453,521.5749969482422,602.4481201171875,-1.2208393824342758,64.20804528538446,1.154243003139932,2.9884045560502943,542.4937515258789,47.203574829101555,0.11761961036444271,503.0800010681152,613.1272491455078,0.7051336163955753,-0.3843588032045093,0.686211619814608,0.7511115921258759,0.8071266876500394,-0.27308360887553995,1.856783569999897,674.3118394721361,545.8957489013671,417.4796583305982,459.79464285714283,72.28506023713953,502.89125061035156,67.38589870796551,465.0348029750962,509.8069632587971,-30.030866062317422,-37.18488977812912,15145800,25.96742075172248,1.6882107917173363,-159703100.0,-93.80229522800376,91.40936679472856,92.55270083870475,-203.3616020690745,2.9314523528293006,55.78240205295429,0.02582699344473747,26.647161948131558,535.8743385009766,500.6328533325195,472.15000915527344,443.66716497802736,408.4256798095703,0.2,0.0,486.72952150148006,-0.2826546159271889,-0.3029732128706865,458.80999755859375,500.7607116699219,73.06842087205892
2022-01-26,1,369.3125,374.6000061035156,614.2324981689453,515.9406280517578,595.1712379455566,-1.0630938865550104,72.26214653633497,0.2649519399778817,2.9860279574129693,538.6987533569336,52.43789947509765,0.13532968966337533,394.8352447509766,610.3237442016601,0.7727952184677886,-0.38934532372740693,0.6916338416362265,0.7654482182537728,0.847105303039053,-0.28447917359857167,1.7782176880103002,678.4954173402481,533.9711242675781,389.4468311949082,437.78428649902344,73.1469690018325,487.8557139805385,72.21389971229844,442.4772136434069,492.0770301924021,-29.164045641373797,-36.85816017529459,12684000,25.894602955288452,1.3335337909514413,-172387100.0,-96.11136338400345,91.40936679472856,92.55270083870475,-174.37884010241663,2.713433004571559,54.064257929625775,-0.018961155105754284,26.60103358752011,513.3515867919922,482.41418768310547,457.4099884033203,432.40578912353516,401.46839001464843,0.2,0.0,480.50367925509624,-0.3027177481853085,-0.2958104526172766,435.0971418108259,485.9164254324777,80.01836818139805
2022-01-27,1,385.41500091552734,369.3125,614.2324981689453,515.21875,583.1743812561035,-0.8867675364871067,78.18363144413469,-0.3877067261495091,2.983880374739255,537.5199966430664,58.786323852539056,0.1498446025190006,377.16050033569337,607.4282531738281,0.8086699830652161,-0.394547333196833,0.7386758142375851,0.8277551352481499,0.9478890382606151,-0.2514651125333559,1.7305003131874441,678.1320120337772,521.7647491455078,365.3974862572385,419.22535814557756,66.35941267152296,475.867499760219,74.42014831509707,424.27533283159346,475.8448996458424,-29.43769808532858,-36.304566696691595,24324700,25.864006583099737,2.281129597423722,-148062400.0,-82.55185396892453,91.40936679472856,92.55270083870475,-125.97845631619069,5.819189945936032,48.79622153039745,-0.015068415001868282,27.24381679557282,505.76507238769534,476.27745220947264,452.4449920654297,428.61253192138673,399.12491174316403,0.2,0.0,472.0259205757453,-0.23915393564774956,-0.25037796458763456,417.3685738699777,474.0171421595982,82.194423348064
2022-01-28,1,382.5499954223633,369.3125,614.2324981689453,485.36124992370605,559.8900032043457,-0.6894896751897275,80.790455649297,-0.873873148264841,2.9826299427726037,532.9574966430664,64.91431217193602,0.15824615075196805,377.16050033569337,601.5087432861328,0.8375701034587866,-0.37252587242702595,0.7493096029629677,0.84971126452482,1.004838341296668,-0.035833325529612825,10.503019154567383,672.1175358255715,510.53662452697756,348.9557132283836,400.1403568812779,51.35405438938533,464.22517830984935,75.42423638652784,414.62984805301454,463.61145504149846,-25.209696480003274,-30.336195044640334,11966600,26.4016768882204,1.0703079999856895,-160029000.0,-82.93657533025883,91.40936679472856,92.55270083870475,-109.70807401938247,5.570707365310006,48.43550434599331,0.02615429408235522,26.315656119698467,498.7668529052734,470.6165888061523,447.86500549316406,425.1134221801758,396.96315808105464,0.2,0.0,468.1638638115426,-0.03305664062500002,-0.24375802193494836,398.5828595842634,462.8242841448103,82.78821758165677
2022-01-31,1,413.7525100708008,369.3125,607.1450042724609,393.92937088012695,547.4693717956543,-0.533062670770825,81.69634581658646,-1.2186047394820336,2.9818196444105487,526.1062469482422,70.7625,0.16373571816259624,377.16050033569337,594.0289871215821,0.8456289129040009,-0.369919882844509,0.8292422837382919,0.9498799552294327,1.094975869929503,0.09619285036318481,10.427723087195053,662.3451910228214,498.95249938964844,335.55980775647555,385.69178662981307,15.162129803491421,455.4155366080148,73.4358101903642,406.6318921952794,452.15251736589175,-25.883231987958165,-29.87714093432958,20047500,26.460161396272937,1.659135486754227,-139981500.0,-60.74891749745449,91.40936679472856,92.55270083870475,-65.18065334598782,15.980289968541543,42.727949278657775,0.11173140806349265,27.592874382974486,498.7668529052734,470.6165888061523,447.86500549316406,425.1134221801758,396.96315808105464,0.02,1.0,464.8085924352018,0.10329335240192616,0.07456607458726415,386.9957188197545,454.77357264927457,80.23533006193044
2022-02-01,0,443.52750396728516,369.3125,600.8824920654297,393.92937088012695,540.9693794250488,-0.39357371075603476,79.7399666485079,-1.4208839241743083,2.9820681324152516,519.7649993896484,72.51376163482664,0.16297314043686922,377.16050033569337,581.1557601928711,0.8621866420191824,-0.3114252528000973,0.9064848310044659,1.04452621009243,1.1516425821299188,0.18400292776482852,26.38044413709913,648.7628079765813,489.28287467956545,329.80294138254965,392.37178802490234,26.737249460635972,448.67089407784596,69.50304315026075,408.390450861555,449.2940799191577,-19.64293350565041,-22.963667042572133,22568100,28.143334068329036,1.7282796234989237,-117413400.0,-45.19475232585507,91.40936679472856,92.55270083870475,-31.940479965328812,22.794363555445035,38.9693298393409,0.18623161736482804,27.9925948841369,498.7668529052734,470.6165888061523,447.86500549316406,425.1134221801758,396.96315808105464,0.04,0.0,463.5724085028021,0.24755741534562237,0.18075684383205565,395.5142909458705,448.7942853655134,76.18646219773196
2022-02-02,0,439.0475082397461,369.3125,593.2674865722656,393.92937088012695,538.325626373291,-0.31178995286522787,76.01654272475223,-1.5071841214224753,2.9829789174924817,515.7362518310547,70.79509918212894,0.1579022733890695,377.16050033569337,555.9060012817383,0.8629971681091895,-0.2523987678309095,0.9119935897096286,1.051760055783962,1.1006138102204561,0.18882385036993354,38.08207647073387,633.4482107241627,481.4151252746582,329.3820398251537,401.17214638846264,30.830106359302683,441.4996441432408,64.40941370130172,417.11186556045243,450.6341653890078,11.785242099963678,-17.552664134750977,14346000,29.505025771302098,1.0582943431858378,-131759400.0,-58.791514781272944,91.40936679472856,92.55270083870475,-36.37801896389872,20.94787066934379,35.81255864239791,0.1386807819564423,28.1905882705059,496.10810119628906,468.4659231567383,446.12498474121094,423.78404632568356,396.1418682861328,0.04,0.0,462.4031900775605,0.1939949858526384,0.1720975799566431,401.56143624441967,441.09857395717074,72.34651122109682
2022-02-03,0,415.14500427246094,369.3125,579.8100128173828,393.92937088012695,537.3037452697754,-0.2421601575388872,71.99485034223069,-1.6026324472989106,2.983975715808626,515.1100006103516,68.09196186065674,0.15198273845690755,377.16050033569337,546.3132461547851,0.8552117353439929,-0.24277349729379602,0.8763803842373299,1.0132135527962634,1.005538218369482,0.07713763939211482,37.829370022377816,617.6938270424937,473.7041263580322,329.71442567357076,406.9642889840262,28.743963006596744,433.37946592058455,59.53456273015748,422.53367011902805,450.60162641649526,16.32092320595832,-18.611257444474127,9905200,29.48381645352224,0.7155075269438586,-141664600.0,-71.03418030727222,91.40936679472856,92.55270083870475,-52.58204281076965,19.545924232430153,39.31160278931107,0.11804833483879905,27.96845474403281,494.2592342529297,466.9703737182617,444.9149932861328,422.8596128540039,395.57075231933595,0.04,0.0,461.00018555038446,0.04887507964795623,0.12760631731662517,407.1585780552455,432.98428780691967,70.21237983202549
2022-02-04,0,406.7225036621094,369.3125,553.25,393.92937088012695,530.8924980163574,-0.13211581876557318,68.73141672559834,-1.7249835062114967,2.9847070952551578,479.2100028991699,65.71462364196779,0.14765997247015397,377.16050033569337,540.0547561645508,0.8536029937288114,-0.24962493579311174,0.873787222130279,1.0174262474530555,0.971151215887974,0.063187840880923,34.24410749805529,602.9337093819827,465.4708759307861,328.0080424795895,412.30857522147045,23.592950693931584,425.0464308602469,53.86177459118244,420.6292486288345,447.0499752719306,10.823544449633898,-21.49708463504551,7789800,29.39881265282923,0.558508693314214,-149454400.0,-66.4858921111949,91.40936679472856,92.55270083870475,-53.580284791264674,18.683981190678814,39.66675028469437,0.1349314003774993,27.091616354890302,485.2975291748047,459.7212457885742,439.0500030517578,418.3787603149414,392.8024769287109,0.04,0.0,459.80904994024246,0.06715066359617072,0.06069304494393889,414.3685782296317,424.73286002022877,67.96131992387761
2022-02-07,0,404.5425033569336,369.3125,545.5424957275391,393.92937088012695,524.7456207275391,0.038694456745284864,66.76557277701781,-1.7428796355558693,2.985085831896188,441.2875061035156,63.53044857025147,0.14573038116727358,377.16050033569337,538.1017501831054,0.8445393265855643,-0.2544622887357261,0.8830019838137643,1.0094590980363067,0.9549226997203559,-0.022259699916481912,32.97987728087644,591.6756466679271,458.1445011138916,324.61335555985596,415.04107557024275,20.914690056039976,417.13321685791016,47.318279305670806,417.1580838231208,442.38087821230187,10.129633755182772,-22.289995332146045,8232900,29.39980786348143,0.5801902748414376,-157687300.0,-71.09258594369388,91.40936679472856,92.55270083870475,-52.696237012424284,17.704031437908753,38.44834417150139,0.13747090628008185,26.479100158725544,485.2975291748047,459.7212457885742,439.0500030517578,418.3787603149414,392.8024769287109,0.04,0.0,458.5183112693412,-0.05862248369666645,0.046154702435340304,416.5685773577009,416.9685756138393,66.04589279899642
2022-02-08,0,401.03749084472656,369.3125,539.4450073242188,393.92937088012695,517.9550018310547,0.21903807334670686,64.57303964252011,-1.6833027993013348,2.985548623202554,427.0962562561035,60.43064880371094,0.1431474767004761,377.16050033569337,537.1739944458008,0.8385244606004149,-0.24678472696870662,0.8890320975212563,0.9939919602373156,0.9507831643570823,-0.09580017640956195,32.9574791568747,580.2405807804016,451.0945014953613,321.94842221032104,417.68214634486606,16.912268096336174,408.911251613072,37.84236800190189,414.00161146248627,437.6747690687684,4.962832893366931,-21.49797869586391,6818500,29.420287101036276,0.4765975471495014,-164505800.0,-70.27628700177465,91.40936679472856,92.55270083870475,-48.90958800536649,17.148627597634214,37.242157994079435,0.13781689874943368,25.32220422252813,485.2975291748047,459.7212457885742,439.0500030517578,418.3787603149414,392.8024769287109,0.04,0.0,457.4802271304723,-0.11725330984837945,-0.055274652478000966,419.3071507045201,408.94500514439176,63.3239618792453
2022-02-09,0,408.32750701904297,369.3125,539.4450073242188,393.92937088012695,515.5318756103516,0.41552028369474425,62.28120839392428,-1.5295676326145335,2.9860527498840526,414.44875717163086,56.593099670410155,0.1401808004773735,377.16050033569337,529.7399993896485,0.8193780559548256,-0.25451133455140235,0.9190521228943221,1.0054721157446054,0.9879711902734093,-0.06996965167589142,32.1264515590704,568.854418130622,444.29200134277346,319.72958455492494,416.90714590890065,17.243412891660316,401.29946626935686,22.487172586591456,410.7649445986256,431.9084129427507,4.832700468850281,-22.301390592743545,7738200,29.375135737294144,0.5322140025475184,-156767600.0,-42.59950291317063,91.40936679472856,92.55270083870475,-37.1946983716283,18.329848396252594,35.65644987924958,0.15599266791358904,24.50370409877729,433.2232863769531,417.5983635253906,404.9700012207031,392.34163891601565,376.7167160644531,0.04,0.0,456.4745564252677,-0.038628098895198026,-0.09677769947679575,417.2714364188058,402.1335776192801,59.33571634415442
2022-02-10,0,403.1824951171875,369.3125,539.4450073242188,393.92937088012695,515.0012512207031,0.6113357607777806,58.847260941086915,-1.2725918515753036,2.9869026972347803,411.0400085449219,51.811150512695306,0.13441255316212997,377.16050033569337,523.9292449951172,0.793305012976121,-0.24305999411423077,0.92090587891988,0.983355743256204,0.9902432570004003,-0.02881525498840498,35.221706394643014,555.5052736064171,437.8107517242432,320.1162298420693,411.14357321602955,13.109811299236137,401.757680620466,22.453054757985885,410.43885878139037,426.57790938574453,-1.3111710309212368,-20.69655208282244,8452900,29.49377761928798,0.5721890364900901,-165220500.0,-48.78528540859671,91.40936679472856,92.55270083870475,-38.66038991263605,17.40040366393461,34.59385245439117,0.1755706473216685,23.91866284568142,433.2232863769531,417.5983635253906,404.9700012207031,392.34163891601565,376.7167160644531,0.04,0.0,455.3198848775068,0.0016518316076781225,-0.05404214719877873,410.00571986607144,402.76000540597096,54.78519716439897
2022-02-11,0,398.97499084472656,369.3125,528.8274993896484,393.92937088012695,461.36875343322754,0.8123942401627293,54.40644402917812,-0.9237956162827139,2.987996984139213,407.5250053405762,46.416912879943844,0.12623374406893173,377.16050033569337,516.8690032958984,0.7661305726769888,-0.2375916615861985,0.9257011330714313,0.9688950351721397,0.985701468996576,-0.019048645569459732,34.59659397101315,539.8105141722478,430.9976261138916,322.1847380555354,405.41892787388394,5.342389772305763,403.29553713117326,21.37097700347019,408.8323681482363,420.96340859266854,-9.096393907754935,1.6168161478134773,7558900,29.48279553999249,0.5063875413216428,-172779400.0,-65.94345470555155,91.40936679472856,92.55270083870475,-44.40751553421137,16.124143889064847,34.72282347847354,0.16991204393023657,23.921689311249477,434.4410472412109,419.5694849243164,407.5500030517578,395.53052117919924,380.6589588623047,0.04,0.0,454.20124131444254,-0.04598097191827866,-0.03523177596125291,404.55286080496654,403.0571485246931,51.27494389254722
2022-02-14,0,395.10250091552734,369.3125,523.3849945068359,393.92937088012695,440.16750717163086,1.0552174100595066,49.90636452581109,-0.3499752987652367,2.9890694399557596,405.6325035095215,40.52950080871583,0.11756366696525725,377.16050033569337,515.4092498779297,0.7213225791036637,-0.23770265668265056,0.9307369766585575,0.9556788863136862,0.9798853296581221,-0.023335007726189905,33.86587723885469,524.3177297382678,424.50500068664553,324.6922716350233,402.5557131086077,4.576987408163133,404.760001046317,19.905564998311593,406.48144776940967,416.0797183890667,-9.127148347949978,5.704139985245532,7202200,29.486665354251606,0.48355865654726415,-179981600.0,-60.77949540244044,91.40936679472856,92.55270083870475,-39.45511319658098,15.012100454141112,32.56133600195035,0.165815767125117,23.815572048103157,434.4410472412109,419.5694849243164,407.5500030517578,395.53052117919924,380.6589588623047,0.04,0.0,453.18792763403303,-0.013752794566915028,-0.03315699748468276,403.2628609793527,405.2107195172991,45.67342255147069
2022-02-15,0,405.3550033569336,369.3125,516.1450042724609,392.68062591552734,421.1206302642822,1.341949578986061,44.76457210254121,0.5583901393624915,2.9902402588640915,403.86249923706055,33.84856376647948,0.10706900023760182,377.16050033569337,514.936001586914,0.6598086438728884,-0.2332982396951745,0.9695380277805182,0.9849208320161139,1.0100417527922168,0.010765857583820537,33.36416261871811,507.62002021216244,418.09087600708006,328.56173180199767,402.36035592215404,4.39506567589214,407.33446557181225,17.101615496664127,403.6512072480019,411.2577375391213,-4.827831998618882,5.473169908690854,5392300,29.490196708440028,0.36137012777261757,-174589300.0,-59.05093184550763,91.40936679472856,92.55270083870475,-15.756435953572037,14.412327353179519,31.260424545555527,0.18699371594908182,22.996375828149482,438.0896052246094,425.47520166015624,415.2799987792969,405.0847958984375,392.47039233398436,0.04,0.0,452.5620934069722,0.009739034737614949,0.013329980776430625,402.87571498325894,408.6221466064453,40.12441736109235
2022-02-16,0,397.8874969482422,369.3125,516.1450042724609,392.68062591552734,414.1006336212158,1.6950856458858152,38.845773477693974,2.151778734662024,2.991506245175619,403.86249923706055,26.69565254211425,0.09415051631289917,377.16050033569337,450.6640037536622,0.5333895370949657,-0.2146489842940413,0.9643600813775823,0.9758273332301108,0.9893060032588804,-0.02556773641584209,38.54744406527872,490.28379816083225,412.5922512054443,334.9007042500564,401.40964072091236,4.561017759022592,408.22535814557756,16.171482294956988,403.94728465046086,408.27593939106913,-0.336224401861927,9.759351052816678,5277700,29.685123851734765,0.3525981709015816,-179867000.0,-69.90741591067395,91.40936679472856,92.55270083870475,-32.26392361130844,13.61747111031586,32.96879648000565,0.19536120992685233,22.565289162352208,438.0896052246094,425.47520166015624,415.2799987792969,405.0847958984375,392.47039233398436,0.04,0.0,451.8477561785305,-0.035869184409272115,-0.013505841507491073,402.30142647879467,409.4350019182478,32.02490150162849
2022-02-17,0,391.4300003051758,369.3125,514.8925018310547,392.68062591552734,409.6837577819824,2.0779476076544925,30.80072853820633,5.021955450113078,2.992995503313657,402.10999298095703,19.465940818786617,0.07573712946383179,377.16050033569337,439.4955078125,0.2297094472732333,-0.22724161736036294,0.9625027074397647,0.9697797058312262,0.978329201820792,-0.029149318123535606,36.37669017289543,468.28083291564604,406.6793758392334,345.07791876282073,400.0371420724051,5.93135394190197,408.8596442086356,15.233935411772853,402.1967568798786,404.3161475935234,-1.6450697648498012,3.23612106510833,4669200,29.66710643517106,0.3204988282971389,-184536200.0,-98.66721456860068,91.40936679472856,92.55270083870475,-45.290851273360715,13.0107596581606,33.054809907916784,0.2246386887385505,21.899159745061272,441.3039312744141,430.67805145263674,422.0900115966797,413.5019717407227,402.87609191894535,0.02,1.0,451.16173255998467,-0.04824371997922283,-0.0635035973030944,399.89285714285717,409.60000392368863,21.621538847076913
2022-02-18,0,393.93499755859375,369.3125,443.52750396728516,389.9262504577637,407.1237545013428,0.591139805002455,18.349401792416966,0.3337100984041328,2.9946910337513533,400.00624084472656,13.557752227783203,0.04581551912726081,377.16050033569337,417.5352546691895,0.7306448782804164,-0.013452447527799625,0.9835926325948026,0.9817541740661054,0.9904085457444055,-0.012632353911361527,44.91077392188882,437.2050543477734,400.50625076293943,363.80744717810546,397.981069292341,4.999995454752083,407.44410760062084,15.659105909571982,399.0809623587609,399.40546121392595,-2.395658949320178,2.321266498254254,6801700,13.630122654298164,0.5685419123811689,-177734500.0,-92.31932339702001,91.40936679472856,92.55270083870475,-26.494167745951135,13.569554597385288,31.24379979581831,0.20487016118474619,21.485045480386564,441.3039312744141,430.67805145263674,422.0900115966797,413.5019717407227,402.87609191894535,0.02,0.0,450.25206738244844,-5.108229740258263e-05,-0.036871983837934656,396.80714198521207,407.03928920200894,21.71598066972347
2022-02-22,0,382.9425048828125,369.3125,443.52750396728516,389.9262504577637,407.1237545013428,0.6086117220059172,18.388600869805952,0.3244985141983556,2.9946861446012623,400.00624084472656,13.699377059936523,0.045929634335339406,377.16050033569337,417.5352546691895,0.7241614004078913,0.04368847879055809,0.9564843647026261,0.9574101198132775,0.965217962957159,-0.030776813623142885,48.95600872374856,437.1418276703981,400.36462593078613,363.5874241911742,395.0896421160017,6.959176895305146,403.1166076660156,13.07915027628339,397.60966511388824,398.7638438369454,-3.5247464873283696,-4.789702063394343,6697500,12.875780359207843,0.6270489098149655,-184432000.0,-94.47819825753025,91.40936679472856,92.55270083870475,-92.83734795223728,12.674037974962772,34.63492673565437,0.06172018510241268,21.333730116581766,433.34544580078125,421.81728259277344,412.5,403.18271740722656,391.65455419921875,0.04,0.0,449.17521735599763,-0.04838994903040483,-0.03559835619506606,392.6800013950893,401.34286063058033,22.137906295939423
2022-02-23,0,375.70999908447266,369.3125,443.52750396728516,389.9262504577637,407.1237545013428,0.6515373974300587,18.08248150258976,0.42843299419499337,2.9947225710681282,400.00624084472656,13.42450180053711,0.04513404556682971,381.7549964904785,417.5352546691895,0.6736596604162562,0.02227041816168988,0.937775725978955,0.9444280360651276,0.9528289886204053,-0.07313343619039325,43.39845334533007,436.8044641953651,400.63950119018557,364.47453818500605,391.76607186453685,9.778655779567641,398.59249986921037,10.367779579238638,393.8747256411217,397.4632259502038,-5.02005679301432,-13.659806560483663,4614300,13.1255438974247,0.4544134026496862,-189046300.0,-98.72206435308347,91.40936679472856,92.55270083870475,-129.26310245391127,11.835480657201908,34.51915507755892,0.1101359181380367,21.18920504532296,414.4864083251953,405.34680743408205,397.9600067138672,390.5732059936523,381.43360510253905,0.06,0.0,448.3724391291103,-0.098169147496313,-0.07340448175986608,389.2728576660156,396.91285923549106,22.055918861183752
2022-02-24,0,372.6425018310547,369.3125,443.52750396728516,389.9262504577637,407.1237545013428,0.6693783109051792,18.00400776560481,0.4453008552952995,2.994731823720296,400.00624084472656,13.369002151489259,0.044931950056517844,381.8659957885742,417.5352546691895,0.6212763635101493,0.01732272556296539,0.9299903943163147,0.9427191466532878,0.9594766532484903,-0.0634475707601121,40.53973932111045,436.70301637044304,400.6950008392334,364.68698530802374,388.55750056675504,11.946040604416396,395.5566068376814,11.326500713690564,389.38816024437324,395.6462759375864,-5.831190499182991,-14.426117439820974,7068700,13.177290031398755,0.7159159560628319,-196115000.0,-39.39239334040137,91.40936679472856,92.55270083870475,-112.5643851717993,10.449196724325862,34.359659716898776,0.1967087702068357,22.262421276829294,399.2306486816406,390.72468725585935,383.8500061035156,376.9753249511719,368.46936352539063,0.08,0.0,447.2568422110342,-0.020222035933744165,-0.04277718804621062,388.3385707310268,395.8007158551897,20.089551230298394
2022-02-25,0,386.0699920654297,372.6425018310547,443.52750396728516,389.9262504577637,407.1237545013428,0.7524380508464681,17.726269783218363,0.45997171819095506,2.99476433388476,400.00624084472656,13.202502059936524,0.044220434594139366,381.8659957885742,417.5352546691895,0.6748814897348532,-0.03313960031169634,0.963100699790299,0.9855858493686704,1.0071426109163242,-0.013693401720785814,36.21182403024036,436.31404049722283,400.8615009307861,365.4089613643494,385.802498953683,9.37326586695817,394.08142743791853,11.103074722126307,385.3301472996068,393.6364247031861,-5.684600586538577,-10.237989619046873,4841600,12.655070636884668,0.5440311748201302,-191273400.0,-38.07075090201281,91.40936679472856,92.55270083870475,-75.15385034943532,10.09009398460784,32.56745213611087,0.23965354816703222,21.788410123766084,399.2306486816406,390.72468725585935,383.8500061035156,376.9753249511719,368.46936352539063,0.08,0.0,446.59306852521706,0.010680875738522166,-0.018287778900875122,385.9585702078683,394.41714259556363,19.950144726505744
2022-02-28,0,390.4324951171875,372.6425018310547,443.52750396728516,390.08999824523926,407.1237545013428,0.754513493281314,17.69828484581347,0.47168585198819857,2.9947675570014183,400.00624084472656,13.169752502441407,0.044147015888248105,381.8659957885742,417.5352546691895,0.6983191451249423,0.00920140291514073,0.9739039525801342,1.0010961304066066,1.0213794172874175,-0.00889106696057207,46.047912772934275,436.2908201799082,400.8942504882813,365.4976807966543,384.73749869210377,8.109652552375683,393.07356970650807,10.714035383227781,385.62615037819495,393.53884245004537,-4.757560935919316,-5.077789256981232,5035000,13.02404395915003,0.5886885282319118,-186238400.0,-31.6855799491269,91.40936679472856,92.55270083870475,-51.860719516655685,11.744009536898867,30.84475261878839,0.2214263406654943,21.342584074201998,399.2306486816406,390.72468725585935,383.8500061035156,376.9753249511719,368.46936352539063,0.08,0.0,445.97987362851694,0.00825469702321624,0.02030148528030245,385.4499991280692,393.8757128034319,19.609510086369408
2022-03-01,0,389.1374969482422,372.6425018310547,443.52750396728516,391.1806240081787,407.1237545013428,0.7779793349983283,17.370111788817336,0.6122625187475363,2.9948049394655887,400.00624084472656,12.800715980529787,0.04328585837639117,382.2192543029785,417.5352546691895,0.7893598762802844,-0.0563622319768472,0.9697203326399442,0.9999659456950094,1.0198605941666536,0.016177342516014104,43.842033039815526,436.02859905065714,401.2883754730225,366.54815189538783,384.40999821254184,7.836010868481676,392.2235701424735,10.503592219764647,386.97365289350705,394.34238722921845,-1.8736456632173204,-3.487892649761114,3290400,10.85878996172426,0.4264908027227285,-189528800.0,-45.89772789178362,91.40936679472856,92.55270083870475,-62.073250380955805,11.27958317864742,29.624971922519187,0.10871417603406583,20.616642806554164,399.2306486816406,390.72468725585935,383.8500061035156,376.9753249511719,368.46936352539063,0.08,0.0,445.5637318070115,0.02347762265336173,-0.012906075290105727,385.38856724330356,392.64071219308033,19.00538865593485
2022-03-02,0,383.34749603271484,372.6425018310547,443.52750396728516,390.1087455749512,405.69687843322754,0.9630548793223006,17.315325473726254,0.9003698486693037,2.994807527593207,398.4312438964844,12.6368896484375,0.04328207837971202,382.2192543029785,417.5352546691895,0.7170822438290831,-0.12263051678313687,0.9582306954108727,0.9865996761248951,1.0014341723588955,0.020328170575319326,37.02033965871748,434.68827576434705,400.05762481689453,365.426973869442,382.89749799455916,6.6182588087784815,390.43928364345004,9.644078518318185,387.5517621762838,393.89181235289146,-0.5856739021399123,-2.9673021022096426,5356800,8.040697549169684,0.7815023437192263,-194885600.0,-55.5106264393127,91.40936679472856,92.55270083870475,-96.18923093634149,10.713400404494543,31.183333910524375,-0.04095432989188702,20.13992304563045,398.18394909667967,389.8780114135742,383.1649932861328,376.4519751586914,368.14603747558596,0.08,0.0,444.8196355367671,0.034207825658634894,0.0070220834760635386,383.77999441964283,390.2935682024275,14.028223417604574
2022-03-03,0,376.20999908447266,372.6425018310547,439.0475082397461,388.37062072753906,404.7456283569336,0.8477583623919819,14.499872875486743,1.4245194726056996,2.995071703308932,396.49499893188477,10.973625946044923,0.03651913640718887,382.2192543029785,409.0092567443848,0.6017548474394486,-0.12686556958345319,0.9475161880585149,0.9737455489767869,0.9788825179912398,0.009573511437606763,34.46852559046056,426.0483701711395,397.048624420166,368.0488786691925,381.9357114519392,7.083472318683228,388.51267678397045,9.596573749959484,386.4452839603433,392.0364630188481,-2.6876265352138775,-6.117641000649791,6076800,8.059864260888219,0.9434515908169967,-200962400.0,-76.5336441774924,91.40936679472856,92.55270083870475,-139.44066803497643,9.893794983705162,32.56050423003148,0.009433497954921252,20.23582855913516,398.18394909667967,389.8780114135742,383.1649932861328,376.4519751586914,368.14603747558596,0.08,0.0,443.8851386806273,-0.056303339547747244,0.0016600878553472192,382.4499947684152,387.5649980817522,13.094866477961164
2022-03-04,0,365.4300079345703,372.6425018310547,415.14500427246094,385.389368057251,403.522497177124,-0.18014808770548202,11.571172594111596,-0.8856356154045293,2.9952999230614332,394.51874923706055,9.723825531005861,0.0293754108671442,376.15999908447264,406.88300399780275,0.6935201458646799,-0.0937865198600225,0.9277068973739516,0.9511805410797329,0.9490714897395923,-0.05346176743869124,33.779174637498535,417.0490941506255,393.90674896240233,370.7644037741792,380.4671412876674,9.306228616419988,386.11660657610213,10.884704907946686,383.8227338866027,389.5576481159954,-1.758098333952277,-6.6898975921251544,5325500,6.478238790835043,0.857286127193219,-206287900.0,-87.17054941151436,91.40936679472856,92.55270083870475,-170.90673548905104,9.266204242524774,33.18335071964617,0.060365436736085895,20.049502578043068,396.4649490966797,388.4875114135742,382.0399932861328,375.5924751586914,367.61503747558595,0.08,0.0,442.9915969059484,-0.07438581810304656,-0.07255849006881811,381.6314261300223,385.45214189801897,14.526277751861793
2022-03-07,1,355.7175064086914,365.4300079345703,408.32750701904297,383.24624824523926,401.5737419128418,-0.46098986950058995,12.070880150099955,-0.7810147459842405,2.9952543393701245,392.68249893188477,10.086649932861325,0.030838611562617507,375.4032493591309,405.4917533874512,0.685650296957928,-0.1015249841249094,0.908784932809535,0.932208572491511,0.9338586714254171,-0.08891418911757454,29.487817025214454,415.5627594457078,391.42099914550784,367.2792388453079,378.0492847987584,13.10236988980987,383.3033926827567,13.22223940157407,379.2178027692187,386.5203458208401,-2.736150534974462,-8.407790884118677,5708400,6.620141386366893,0.9345814283784724,-211996300.0,-99.89824021830216,91.40936679472856,92.55270083870475,-196.85453785973812,8.86149573345003,34.31387667687162,-0.028070132363456457,19.45544507598642,395.24544567871095,386.63728692626955,379.6800079345703,372.7227289428711,364.1145701904297,0.1,0.0,441.93156754182826,-0.11218691189437568,-0.10373587332049833,375.9499991280692,382.144284929548,16.44386905620792
2022-03-08,1,347.77249908447266,355.7175064086914,408.32750701904297,381.25937843322754,399.49061584472656,-0.6753257116009481,13.82868543618085,-0.26840516581268536,2.9950945378160605,390.93124771118164,11.289598693847655,0.03556113557443954,371.92125244140624,404.6237533569336,0.691898490844831,-0.12069188414835906,0.8943138555055672,0.9206078375405335,0.9299513137938582,-0.10629918264924065,25.775515133056665,416.5281201551986,388.8707492828369,361.21337841047523,372.5782143729074,16.697586189203008,379.1903566632952,14.707640465226119,373.32146165745735,382.3241864454216,-4.541885410064304,-9.968297951942457,6428700,6.830861098080256,1.0682869802991641,-218425000.0,-98.24759379619648,91.40936679472856,92.55270083870475,-194.04324172451857,8.262418507384286,35.536005713608404,-0.06931829915430934,19.364369892619116,388.1907994384766,379.1096021118164,371.77000427246094,364.4304064331055,355.3492091064453,0.12000000000000001,0.0,440.67409724382304,-0.11516150992485019,-0.13373208130708558,368.9442879813058,377.45142909458707,19.07206278940339
2022-03-09,1,357.78250885009766,347.77249908447266,408.32750701904297,376.08499908447266,398.1593704223633,-0.7969706477659118,15.979629911563077,-0.08304906581901594,2.9948653524360727,389.78499603271484,12.848547821044917,0.04139454656985924,364.4587577819824,403.3997459411621,0.7305816374183581,-0.13281798578995452,0.9268202584441302,0.956006352656862,0.9783617987590568,-0.06668880701502089,23.33293705712842,417.9915088923401,386.0322490692139,354.0729892460877,367.913930620466,15.38779314821922,376.3257146562849,14.691487342277913,366.93820034505893,377.4963783108677,-9.919831576670822,-14.205450480589459,6520200,6.934026860790471,1.0861840625702792,-211904800.0,-70.86816647687213,91.40936679472856,92.55270083870475,-121.74117743986007,9.522733690079225,32.614545724282614,-0.08215624073602676,19.58128566513665,388.1907994384766,379.1096021118164,371.77000427246094,364.4304064331055,355.3492091064453,0.12000000000000001,0.0,439.5745482392827,-0.055890298930611926,-0.07106975554964196,363.84000505719865,374.64500209263394,19.419417016337693
2022-03-10,1,358.32249450683594,347.77249908447266,408.32750701904297,374.94312477111816,395.79874992370605,-0.5838985913231513,16.71273812178693,-0.5894821809791502,2.9947757368346757,387.60374450683594,13.727047653198241,0.043537551493712294,357.57600860595704,403.3997459411621,0.7862060820103585,-0.12378543522072362,0.9334487229001588,0.9620577404711573,0.9937323365974592,-0.04754659530891503,31.452700465552944,417.29497621305626,383.86949996948243,350.4440237259086,363.5117874145508,12.427180514561183,373.9608928135463,14.737708156509386,364.6759428966021,374.73006227459615,-8.362517637598279,-10.079479351762956,4807800,7.165160540674279,0.820957835367884,-207097000.0,-74.1157872580733,91.40936679472856,92.55270083870475,-104.08820782743857,10.11314651890593,30.935483113359595,-0.16972525763951524,19.159892703237002,388.1907994384766,379.1096021118164,371.77000427246094,364.4304064331055,355.3492091064453,0.12000000000000001,0.0,438.79407398789573,-0.03070073107204596,-0.06120572018087786,359.6300048828125,372.509286063058,18.90262642230299
2022-03-11,1,351.2174987792969,347.77249908447266,405.3550033569336,370.8393783569336,394.22687339782715,-0.4818100025807922,16.60683989506047,-0.9093000622674503,2.994776902345298,384.70874404907227,14.136647796630859,0.04354530398985173,357.57600860595704,399.39574127197267,0.8104783747213815,-0.11126475269545798,0.9209381705094213,0.9466211235440691,0.9837887297846906,-0.03889256176744571,32.52537767601899,414.58292913399305,381.36924934387207,348.1555695537511,358.92178780691967,9.458914799672579,370.9096429007394,14.706241191017883,363.07497669985696,372.2877916857276,-7.918795459977183,-8.458091043744169,4819900,7.173847204574942,0.8493694798649439,-211916900.0,-99.44587476325758,91.40936679472856,92.55270083870475,-135.6609302945286,9.240838184284973,33.17806123153648,-0.2688031978904934,19.461714869996722,384.121,375.6895,368.875,362.0605,353.629,0.14,0.0,437.91952748847064,-0.059187800325803175,-0.07539326608472077,353.95714896065846,368.86857169015065,19.822398816754454
2022-03-14,1,335.2175064086914,347.77249908447266,405.3550033569336,363.6531295776367,392.0562496185303,-0.36573004737329085,17.049977939465037,-1.1260726141785993,2.9947129317737873,383.1450004577637,14.813398017883298,0.04501394763790693,355.26750564575195,397.9962463378906,0.8035865820378697,-0.11970046534574892,0.8850136542325646,0.912064652424614,0.9465076199892293,-0.05763000029705345,29.795309830413423,412.87095540590764,378.77099952697756,344.6710436480475,353.0657174246652,9.65903894719393,367.50071443830217,17.04745328105822,360.13123360718214,369.4659741374607,-8.381428752224325,-10.843793784263378,5907800,7.2419513824252135,1.0564499184120526,-217824700.0,-98.24819289016277,91.40936679472856,92.55270083870475,-165.74453555213745,8.836741015793447,35.59820942051755,-0.26772469197650345,18.88982659440271,381.7185217285156,371.80074279785157,363.7850036621094,355.7692645263672,345.85148559570314,0.16,0.0,436.7089295614268,-0.054959171653312766,-0.08492522126361313,348.6628635951451,365.5564291817801,21.965556056278132
2022-03-15,1,339.14249420166016,335.2175064086914,405.3550033569336,358.18749809265137,390.68187141418457,-0.4379038883827028,18.840766453731714,-0.8505216195646694,2.9944636726163814,379.5762519836426,16.056247863769535,0.05016403875552946,350.8729988098145,395.3810005187988,0.7628065352777103,-0.1515682496771624,0.9029758563462983,0.9368176028002878,0.9688055496472207,-0.024815087177771034,24.34358013346392,413.2646582126392,375.58312530517577,337.90159239771236,349.3103583199637,9.147345802361762,364.8887498038156,18.437601410142832,353.9389446956318,365.1883497073527,-10.896173088312032,-12.46270598473414,5460600,7.84309228207815,0.9919264965136525,-212364100.0,-79.49360492019066,91.40936679472856,92.55270083870475,-122.41845083384426,9.90885471722772,33.622416732529224,-0.22559402663746775,18.563860850046165,381.7185217285156,371.80074279785157,363.7850036621094,355.7692645263672,345.85148559570314,0.16,0.0,435.6834348465951,0.005822770884573947,-0.018586220476557246,346.0942905970982,363.8628583635603,22.2524331031488
2022-03-16,1,352.1949996948242,335.2175064086914,405.3550033569336,357.2662582397461,389.4612464904785,-0.3046200715542898,19.861806394075746,-1.0307935754723367,2.9943038883851782,375.95999908447266,17.182110671997073,0.05327950356308264,346.9094985961914,394.3302474975586,0.780702977274477,-0.1633444970629123,0.9447667734158015,0.9864963995476994,1.0110769303229006,-0.015617055102082888,25.721417547734386,412.50873775763387,372.7851249694824,333.06151218133095,348.80714307512557,8.827425460084807,363.428213936942,18.585422753294008,350.27718612226,362.2410221915579,-7.193583767651861,-9.73290702188388,6982500,7.387990514235752,1.2503234366928073,-205381600.0,-59.20801642459557,91.40936679472856,92.55270083870475,-63.89955562064277,14.948546853142494,31.407597775373898,-0.20617135974421286,18.44659118854385,381.7185217285156,371.80074279785157,363.7850036621094,355.7692645263672,345.85148559570314,0.16,0.0,434.5788271609169,-0.0035118306965542523,0.04614345904451123,347.1328604561942,361.5414297921317,20.708233391850314
2022-03-17,1,364.82250213623047,335.2175064086914,397.8874969482422,354.8368797302246,386.8368682861328,-0.25301885137124436,18.856940427731047,-1.2124646697855028,2.9944278624865395,374.1762504577637,16.834660720825195,0.050947199394301465,346.9094985961914,391.6805000305176,0.8260179170188693,-0.11483773077534457,0.985668106185927,1.0308610552385682,1.0506985605135406,0.018140104874913243,37.89860440196218,407.84100564183905,370.12712478637695,332.41324393091486,351.24285779680525,10.65702378520842,361.9105360848563,17.42562278729802,350.7059623137624,361.1661507357296,-0.9902539656904332,-5.4871631753644605,5818300,8.183833221135082,1.0368371859287528,-199563300.0,-38.78994397847192,91.40936679472856,92.55270083870475,-6.901507835570911,19.058147448844345,29.15600234957359,-0.18183168368855995,18.4454002544319,381.7185217285156,371.80074279785157,363.7850036621094,355.7692645263672,345.85148559570314,0.02,1.0,433.8248954909389,0.041006826059721835,0.03514586541220164,351.3671439034598,360.1557159423828,19.537109501883645
2022-03-18,0,375.7174987792969,335.2175064086914,393.93499755859375,354.8368797302246,384.02812004089355,-0.21447866046677247,17.768680466904705,-1.161977350848308,2.9945647219568707,369.0362548828125,15.711873245239257,0.048222361665931565,346.9094985961914,390.5322456359863,0.8384293212274917,-0.06797511214827927,1.019658445887434,1.065073610143928,1.0780402173657777,0.0697573443383459,47.42927241345013,404.0112359795858,368.47387504577637,332.9365141119669,353.8049992152623,14.093272452585332,360.8594649178641,15.954608322116972,354.182296766671,361.64931557825105,4.902631201904332,-5.503533132820713,8324800,8.774680656761427,1.4367061791930609,-191238500.0,-22.092659580544787,91.40936679472856,92.55270083870475,42.28078813612758,21.418628895024394,27.61403646929203,-0.0827319567358656,18.07848988407526,379.6175217285156,370.10124279785157,362.4100036621094,354.7187645263672,345.20248559570314,0.04,0.0,432.937477498083,0.11835918521511601,0.06679378261530443,354.4828578404018,359.1614314488002,19.265471548456688
2022-03-21,0,375.8424987792969,335.2175064086914,393.93499755859375,354.8368797302246,383.0437526702881,-0.2215297506256343,17.069947822645453,-1.0574623101356002,2.994650170076094,369.0362548828125,14.926248168945312,0.04642505661810579,346.9094985961914,389.2669967651367,0.7970066920269034,-0.0462449360737166,1.0221770720453842,1.0623299163110527,1.0634473486701794,0.12118994859736287,53.27185503121933,401.82814561477335,367.6882499694824,333.54835432419145,356.30785696847096,16.39672485250563,359.9098221915109,14.468433962175567,359.532183774406,363.5401621199324,5.012819096954108,-3.7688964217678524,4866500,9.162638973099186,0.8541308146142107,-186372000.0,-24.62964038061692,91.40936679472856,92.55270083870475,41.01584608477846,20.309503616087866,26.1736404303599,-0.049036206289062335,17.705732134162822,375.2016026611328,366.5292035522461,359.52000427246094,352.5108049926758,343.83840588378905,0.06,0.0,432.4147903525082,0.13165760939713844,0.10069930734640374,357.028573172433,358.3292890276228,18.503533558631954
2022-03-22,0,376.87001037597656,335.2175064086914,390.4324951171875,354.8368797302246,377.8931255340576,-0.30485479869351,16.107289440496594,-0.9864168365817405,2.9947630704057837,369.0362548828125,14.021623229980468,0.0439149633224668,346.9094985961914,386.3767425537109,0.8231853324925601,-0.018540658226718285,1.0274995519350674,1.0592090157880192,1.0423904468392458,0.11124384829193046,55.06064596975537,398.99820391151076,366.78362503051756,334.56904614952435,359.9725014822824,17.869893609569953,359.447144644601,13.746856978188157,363.5801401948242,365.17250823465685,4.889451413474322,-3.416529703050856,4242800,8.852950438000663,0.7610581053907983,-182129200.0,-6.579856571668798,91.40936679472856,92.55270083870475,59.39514134710669,20.62990819857635,24.083421353072943,0.006702524344624133,17.86302834269754,373.24576452636717,364.94712506103514,358.24000549316406,351.532885925293,343.23424645996096,0.08,0.0,431.9953882035268,0.1139491299715909,0.1568230631420022,363.1142883300781,358.5357186453683,18.720658333213482
2022-03-23,0,377.802490234375,335.2175064086914,390.4324951171875,354.8368797302246,376.37500190734863,-0.30223475929268745,15.855089836040145,-0.9263170376938272,2.9947917250324805,369.0362548828125,13.717998504638672,0.04326317895338701,346.9094985961914,386.3767425537109,0.8375328473993783,0.003087517751272559,1.030895246452114,1.0532166074732965,1.0236067084952107,0.07270827400087909,56.93394601827962,398.19017997725604,366.4800003051758,334.76982063309555,366.05607060023715,15.066677420828324,359.5608940124512,13.901945840587013,366.91947749259714,367.3042512145917,7.303881977930599,-1.6897164384205325,3729000,8.707071770993608,0.6742481157124763,-178400200.0,-21.41100318759453,91.40936679472856,92.55270083870475,50.02226659678326,19.904730424131138,23.23684648081768,0.011308693371090887,17.186994511615577,373.24576452636717,364.94712506103514,358.24000549316406,351.532885925293,343.23424645996096,0.08,0.0,431.6210053065054,0.04743655501072386,0.08942542613636363,369.3257141113281,358.9942888532366,18.80683454180202
2022-03-24,0,376.0325012207031,335.2175064086914,390.4324951171875,354.8368797302246,377.1031303405762,-0.30989082992876155,15.922412582502135,-0.946141782914065,2.994784141888594,369.0362548828125,13.82262306213379,0.04343448006982549,346.9094985961914,386.3767425537109,0.8427641025478583,0.013847020610815086,1.0257727021736702,1.042464277496009,1.0048675778086984,0.0307272687918978,58.0954145334882,398.42945002767516,366.5846248626709,334.7397996976667,371.3260716029576,9.511456341363555,360.3182149614607,14.521260624246516,369.7033740579864,369.19943909592695,12.703687310937966,0.42329846462820153,3888500,8.67718829772041,0.723900442978296,-182288700.0,-19.26462510999805,91.40936679472856,92.55270083870475,40.22778906279089,18.979157801375603,24.549840111841405,-0.042396818028428,16.733667859226045,373.24576452636717,364.94712506103514,358.24000549316406,351.532885925293,343.23424645996096,0.08,0.0,431.2193585507275,0.011604732443250887,0.05084885950228683,373.8914271763393,359.99285888671875,18.135726590824675
2022-03-25,0,373.7475051879883,335.2175064086914,390.4324951171875,354.8368797302246,377.1031303405762,-0.32938435713813646,16.003834444388545,-0.9692932414614903,2.994775016166007,370.5737533569336,13.992123031616211,0.04363641295571733,346.9094985961914,386.3767425537109,0.832696796433963,-0.025999147955082316,1.0190683072999807,1.03106742087986,0.9928131939689185,-0.005243284110293178,54.38138146565901,398.7617937209304,366.7541248321533,334.7464559433762,374.40500095912387,4.402908069157092,361.60607201712475,14.877009591943347,371.3752100962434,370.20880949813056,10.877435782820985,2.9013745603593595,3574500,8.109488758604968,0.6733870360044008,-185863200.0,-22.536942969601075,91.40936679472856,92.55270083870475,34.5766000219589,18.046325300256136,24.426179070480895,-0.07475970750603962,16.337987354643356,373.24576452636717,364.94712506103514,358.24000549316406,351.532885925293,343.23424645996096,0.08,0.0,430.8412431745957,-0.01773515473398113,0.006596694257658257,376.2228567940848,361.6778586251395,17.29556023045026
2022-03-28,0,375.18750762939453,335.2175064086914,390.4324951171875,354.8368797302246,376.37500190734863,-0.33728365919208797,15.47686466335079,-0.8607158154618912,2.9948340455020968,369.5887565612793,13.37599868774414,0.042270577330708256,346.9094985961914,383.9264961242676,0.802832055334108,-0.04273463438075577,1.0247161101252666,1.0286465305530341,0.9976825617055144,-0.0017427277437482847,51.561924045037365,397.09172981498284,366.13800048828125,335.18427116157966,375.8857160295759,1.275016990207607,363.5642869131906,14.7195149436252,372.0181296025694,369.9587375825187,6.119480830744115,5.068628463447572,4323400,8.03398299894186,0.8199656340442965,-181539800.0,-14.338484204038265,91.40936679472856,92.55270083870475,54.349557006565774,18.13273412666433,22.957367953752854,-0.07297651576832827,16.13831297446103,373.24576452636717,364.94712506103514,358.24000549316406,351.532885925293,343.23424645996096,0.08,0.0,430.4100048736199,0.010464810769261534,-0.005491319769769493,377.2385733468192,364.3028586251395,16.203986976456964
2022-03-29,0,388.26000213623047,335.2175064086914,389.1374969482422,354.8368797302246,376.0768756866455,-0.4619783068932809,14.612866632186659,-0.7954696395189287,2.9949271024487154,369.5887565612793,12.61917499542236,0.03999407893829185,346.9094985961914,378.356990814209,0.777286536506242,-0.03584848396324833,1.0626321012069724,1.0529484543647154,1.0328041516206217,0.030222600489996365,53.0440737374489,394.60148437826496,365.3757511138916,336.1500178495183,377.6775022234236,4.836927144491602,365.74125071934293,15.996957776410422,372.7875398593235,369.4304140855543,2.841109151017666,7.883029456639949,5880700,8.049711293026977,1.0885800626599471,-175659100.0,-7.018586067543346,91.40936679472856,92.55270083870475,129.69667461739607,23.835304008651182,21.139810256615707,-0.031498832343617056,16.270903393497967,380.7635217285156,371.0282427978516,363.1600036621094,355.29176452636716,345.5564855957031,0.1,0.0,429.9839531818464,0.023242435977204323,0.045996986451250874,378.8414306640625,366.66214425223217,16.641649267153444
2022-03-30,0,385.5875015258789,335.2175064086914,388.26000213623047,354.8368797302246,376.0768756866455,-0.48293825711461663,14.542605172563425,-0.8082365645955263,2.994934444251451,369.5887565612793,12.579687728881833,0.0398065597695176,346.9094985961914,378.356990814209,0.7365056643146773,0.01281475985719336,1.05544445054636,1.0319545610986898,1.0195171420313922,0.02060603487995638,63.54834304804458,394.41708671841786,365.33187637329104,336.2466660281642,379.0696454729353,5.567907996448289,367.6887512207031,16.669806117186187,376.608039120178,370.69206511596997,3.338280329684959,8.518441380515378,4023300,8.514684734247659,0.7540624121450661,-179682400.0,-22.540492546808423,91.40936679472856,92.55270083870475,100.07413968077141,22.345258368784126,20.573587522020176,-0.038716777836228816,16.11333485058338,380.7635217285156,371.0282427978516,363.1600036621094,355.29176452636716,345.5564855957031,0.1,0.0,429.660128093132,0.01863871176359,-0.0037867234831926587,379.8242885044643,368.42643083844865,16.714441699212585
2022-03-31,0,378.94749450683594,335.2175064086914,388.26000213623047,354.8368797302246,376.0768756866455,-0.4526701622858898,14.688812446008074,-0.8130870147770288,2.9949190895664164,369.5887565612793,12.681874847412109,0.04019444129353564,346.9094985961914,378.5809913635254,0.7848731924017959,0.02492624455550599,1.0369512768492641,1.005200425205472,0.9978525843075782,0.0077519716425307195,62.596066534521455,394.82150153996537,365.4438766479492,336.066251755933,379.3664289202009,5.48588431246089,369.6694652012416,16.203047246585896,378.81687855433745,371.52380549052924,2.592842155486124,7.60906932638102,4134700,8.367661793511886,0.7893066483149896,-183817100.0,-32.85843741561669,91.40936679472856,92.55270083870475,62.03328636055473,21.286981095554378,21.887466331658405,-0.03193112571038139,15.70365305623476,380.7635217285156,371.0282427978516,363.1600036621094,355.29176452636716,345.5564855957031,0.1,0.0,429.28245826646395,-0.0029810096687871157,0.0002670461324027274,378.634286063058,370.8742871965681,16.845314807139843
2022-04-01,0,374.90999603271484,335.2175064086914,388.26000213623047,354.8368797302246,376.2418785095215,-0.4514863898604601,14.800824014867027,-0.8417070420660324,2.9949072345201455,369.5887565612793,12.818749618530273,0.04048578585555987,346.9094985961914,379.6114952087402,0.8354890285304571,0.03699063097928704,1.0255189710547787,0.9907782515692691,0.9857077341863806,0.00311036415919852,58.51619068843662,395.1823994488015,365.5807514190674,335.97910338933326,378.9532154628209,5.726957197854605,372.50464303152904,12.833232260026968,378.8511955501665,371.5247484760009,0.5512468685918563,7.895391267211443,4644200,8.121544834439822,0.8923723130547063,-188461300.0,-35.90582089126153,91.40936679472856,92.55270083870475,42.456299852785634,20.068372348551144,22.999314078552203,-0.01617820604845961,15.465062416778393,381.36295654296873,371.9985144042969,364.42999267578125,356.8614709472656,347.49702880859377,0.1,0.0,428.8395847157709,-0.001016463492332531,-0.005962019337574165,378.4885733468192,373.90714372907365,16.926294194441105
2022-04-04,0,383.5499954223633,335.2175064086914,388.26000213623047,354.8368797302246,376.2418785095215,-0.5220646168966705,14.939555554177964,-0.8529482183835451,2.994893023391483,374.32875061035156,13.230274734497073,0.04081235257990676,346.9094985961914,379.6114952087402,0.846533444299741,0.0539543015967642,1.0477940651200608,1.0138276113697093,1.0078078374193313,0.022288822583157897,56.85952188181633,395.93386193233056,366.0547508239746,336.1756397156186,380.0271432059152,5.792449125182699,375.67660740443637,8.810404147924158,377.8593730355934,371.3663797628729,-0.7656101472136294,11.840816444601506,7001800,7.831881768993882,1.3288669576769785,-181459500.0,-9.356286997707755,91.40936679472856,92.55270083870475,97.06186366275666,24.790769397719007,20.6442147358983,0.07784194578749651,15.996390450688164,383.88815942382814,376.0859190673828,369.7799987792969,363.47407849121095,355.6718381347656,0.1,0.0,428.3363706176319,0.03431874956865322,0.047211431345001116,380.7442888532366,377.31785801478793,17.45265369376432
2022-04-05,0,384.1899948120117,335.2175064086914,388.26000213623047,356.3856315612793,377.1031303405762,-0.6785829174063838,15.20575383259365,-0.7243619990139067,2.994867437578921,375.0487518310547,13.30984985351563,0.04138223930288516,346.9094985961914,383.75374603271484,0.8007556998885963,0.10287615159932587,1.0455675185932587,1.0134545915384552,1.0050725750821676,-0.010482685061106833,64.75615763257659,397.8578829398455,367.4463752746582,337.03486760947084,381.51892743791853,5.2222654678659,377.96196419852123,5.929546365464175,379.25294081817134,372.7778349832237,1.9991607579813815,13.094053968447149,4234500,7.708411284342509,0.8207524678783321,-177225000.0,-39.28401735146693,91.40936679472856,92.55270083870475,70.45193896650822,23.204461441694974,19.323235884615155,0.11166338711328548,15.867142167990234,386.6776811523437,380.60116186523436,375.69000244140625,370.77884301757814,364.7023237304687,0.1,0.0,428.0061940056614,-0.02978411824202165,0.004332736489253904,381.644287109375,378.9335719517299,16.53142735818507
2022-04-06,0,370.4250030517578,335.2175064086914,388.26000213623047,358.18749809265137,378.08874130249023,-0.9011527599916827,14.918570111542795,-0.2655497269100402,2.994905636747814,375.4525032043457,12.617074584960937,0.04040046906157247,350.0099983215332,384.3297454833984,0.8369973271979464,0.07380876736201257,1.0031352712446915,0.9752607584167139,0.9711302429748473,-0.03932310672446282,63.59752007839383,399.10439028412077,369.26725006103516,339.43010983794954,380.8385696411133,6.368940441360118,378.36214283534457,5.106497220093785,380.4499499559574,374.3618991533701,2.7939958070813216,9.084454675651573,4354900,7.468702552964572,0.8621814384209145,-181579900.0,-83.35801911302893,91.40936679472856,92.55270083870475,-3.5341958897152357,21.394575877233194,24.344208899446755,0.0923384398813572,15.978235407433477,388.53028259277346,383.59986419677733,379.61500549316406,375.6301467895508,370.69972839355466,0.02,1.0,427.5737525291824,-0.03439325523685621,-0.059899956056308226,380.19285801478793,378.71571568080356,16.33759814815328
2022-04-07,0,362.3450012207031,335.2175064086914,388.26000213623047,363.19750022888184,378.08874130249023,-1.050201851096088,14.684556788993888,0.063970991830967,2.9949326615717715,375.4525032043457,11.847875289916988,0.03969878780703595,350.0099983215332,384.3297454833984,0.835366748243262,0.03377546408739624,0.9795772200072265,0.9558441929385074,0.9575599770041813,-0.043812120483180284,49.99678880294989,399.26848834910595,369.8993747711182,340.5302611931304,377.1364266531808,8.50856223452478,377.40696443830217,6.655094304958253,377.8592200731453,373.3641570749403,-1.269366511621986,1.5356785512740334,4948900,8.201495944183586,0.9784147344446905,-186528800.0,-80.23828092141562,91.40936679472856,92.55270083870475,-48.52106641744914,19.964983666927264,26.785238011939324,0.12251466526208837,15.897528843693868,386.3968405761719,380.1465809326172,375.0950012207031,370.04342150878904,363.79316186523437,0.04,0.0,427.02599246549033,-0.033209649384723594,-0.05064620353473345,375.95428466796875,377.3978576660156,16.14907675875317
2022-04-08,0,358.80249786376953,335.2175064086914,388.26000213623047,364.20312690734863,378.08874130249023,-1.10254623590741,14.551562694185561,0.22093916267728453,2.994947484803819,375.4525032043457,11.56629981994629,0.039317868227646165,350.0099983215332,384.3297454833984,0.7972523567120902,0.03168265385432493,0.9694731505637486,0.9499291733683382,0.9565923891014501,-0.04296364017869447,45.22426239872089,399.2036254951827,370.1005001068115,340.99737471844037,373.30999755859375,9.971585872138833,376.1898215157645,8.314547723084537,373.9092387386172,371.59887451955944,-6.674651206135428,-3.5591894447399675,4025200,8.252666930481627,0.8020971057191165,-190554000.0,-94.88436681546453,91.40936679472856,92.55270083870475,-76.82631519596829,19.253126877576456,25.830203244504883,0.1407045878893412,15.30618343084423,386.3968405761719,380.1465809326172,375.0950012207031,370.04342150878904,363.79316186523437,0.04,0.0,426.5622858003268,-0.047098819933052094,-0.049947920761346735,372.29857090541293,376.06142970493863,14.953787461840285
2022-04-11,0,349.49500274658203,335.2175064086914,388.26000213623047,364.20312690734863,378.08874130249023,-1.186700230815825,14.147720738425587,0.5893422354985653,2.994991446046133,375.4525032043457,11.040824584960944,0.03818756824386435,350.88974914550784,384.3297454833984,0.6956311733852713,0.07035727849584236,0.943357910085515,0.9289632098336653,0.9398500902367931,-0.08878892734252297,45.498173167300315,398.77519153788626,370.47975006103513,342.184308584184,369.10249873570035,12.96177990911997,374.2344638279506,10.945089909054307,370.09749032033176,370.09590085177695,-6.9465435358027765,-4.533814289462144,3777100,7.354961774636015,0.7689833279381735,-194331100.0,-94.54193282799861,91.40936679472856,92.55270083870475,-145.67444529236536,18.271108980857534,29.13091895074125,0.17547527963855208,14.97532145055679,384.39320288085935,376.90340466308595,370.8500061035156,364.7966075439453,357.3068093261719,0.06,0.0,426.08019380270713,-0.11111111111111116,-0.06819825190096475,368.5,373.56714303152904,12.891679958029895
2022-04-12,0,350.4175033569336,339.14249420166016,388.26000213623047,364.20312690734863,378.08874130249023,-0.979086041463334,12.629135934852817,0.1972814992079881,2.9951466915689497,375.4525032043457,10.112787322998054,0.03402304104496951,351.925,384.3297454833984,0.5883228168353517,0.03052554227771318,0.9440288837723749,0.9378197031553704,0.9599125148520743,-0.08790570267610265,38.21048839283625,396.45189674763526,371.19362487792966,345.93535300822407,365.6035712105887,14.362862998851236,372.2783933367048,12.58290885848303,364.9854994470461,368.25443698884425,-7.772182739612388,-7.263779784993882,3824300,7.686876648728144,0.7917813579517163,-190506800.0,-96.58985050043202,91.40936679472856,92.55270083870475,-161.81615743437055,18.977506494701114,26.768418260342646,0.10486812459754215,15.131554242746379,383.697,375.7765,369.375,362.9735,355.053,0.08,0.0,425.5935231498769,-0.09483095717945811,-0.12107278134478767,364.30428641183033,371.3964298793248,12.851435131912371
2022-04-13,0,346.87750244140625,349.49500274658203,388.26000213623047,364.20312690734863,378.08874130249023,-0.6748451837187341,11.375230647057515,-0.6182126339080178,2.995260738159723,375.4525032043457,9.379911727905267,0.030598533887285465,352.01725006103516,384.3297454833984,0.6528339945819644,-0.005046909636510511,0.9330749716214215,0.9378438826082044,0.9681283986357123,-0.06356887471513739,35.80645598195402,394.5078366298084,371.7573753356934,349.00691404157834,360.3646436418806,13.38044578362157,370.19589342389787,14.219924778784998,361.40944805566295,366.5962413866654,-6.5328993451655055,-7.248492952085295,3231000,7.10311628383788,0.6959732208632566,-193737800.0,-83.2490248877649,91.40936679472856,92.55270083870475,-158.74662743835515,17.9852354260527,25.89454562012451,0.08047522184329191,14.82467867686318,383.43976086425783,375.3601213989258,368.8300018310547,362.2998822631836,354.22024279785154,0.1,0.0,425.183275332576,-0.04864941802851064,-0.07817967038767319,358.4371425083705,369.59071568080356,13.36168698603834
2022-04-14,0,345.98500061035156,346.87750244140625,388.26000213623047,364.20312690734863,378.08874130249023,-0.7612377539508351,11.880288698395628,-0.4751236016972631,2.9952165384783016,375.4525032043457,9.725549049377435,0.031979974463126025,350.32525329589845,384.3297454833984,0.7410042467227553,-0.049188302776683644,0.9313402868431894,0.9453245429406988,0.9784989546216443,-0.04515034167778331,29.85735904319357,395.2520778698137,371.4915004730225,347.73092307623125,354.9067873273577,9.172671209403454,368.2128573826381,15.559268142812046,357.83522693046075,364.45449294361435,-9.561333181759908,-7.753318844688124,4343800,6.468248180220879,0.9507747836088861,-198081600.0,-97.75773445834545,91.40936679472856,92.55270083870475,-152.76593625998217,16.918335761458238,24.993698673024173,-0.006296007009347879,14.632721963627093,383.13295654296877,374.8635144042969,368.17999267578125,361.4964709472656,353.22702880859373,0.12000000000000001,0.0,424.6136145244447,-0.05804221832923773,-0.07389711081762171,352.8628583635603,367.2535727364676,15.010030650553164
2022-04-18,0,337.9599914550781,345.98500061035156,388.26000213623047,361.4593753814697,378.08874130249023,-0.7221359268528826,13.05984037878327,-0.7864682115261088,2.9951056241882887,375.4525032043457,10.94998664855957,0.0352445110821547,349.23325271606444,384.3297454833984,0.8059183324164444,-0.07913524992992331,0.9120505548838207,0.9317899769232427,0.9647303362277188,-0.058089078344724654,25.495086522323543,396.6693061542951,370.5496253967285,344.42994463916193,350.26892852783203,8.171475938207736,365.55374908447266,17.35329470026709,354.90320053490734,362.5873118729938,-9.944297019071064,-7.428144453746301,5105000,5.837461590777098,1.1581991081526555,-203186600.0,-90.38225991868252,91.40936679472856,92.55270083870475,-157.54142298471854,16.01331595621517,27.760850282989253,-0.07457634093673116,14.354407168994305,381.18831884765626,371.71583813476565,364.05999755859375,356.40415698242185,346.93167626953124,0.14,0.0,423.8964069733529,-0.05063509970779001,-0.0670716801167884,348.50714111328125,364.3499995640346,16.425046611491744
2022-04-19,0,341.6824951171875,337.9599914550781,388.26000213623047,356.70624923706055,378.08874130249023,-0.6491273545941966,14.790680294651006,-0.9061604153991105,2.994920016608409,375.0487518310547,12.874975051879886,0.040119921020899625,346.78825225830076,384.3297454833984,0.7997253739959916,-0.1007935703047361,0.9268184049169822,0.9517492339174465,0.9871022860134324,-0.0223537033948934,21.625301469672426,398.2431106198196,368.66175003051757,339.0803894412155,347.3171419416155,6.677600775855066,362.2267842973982,17.128653440729952,350.6364714071035,359.8038840867062,-8.764260330489488,-9.92237625648487,20906900,5.994844426854518,4.013052512368695,-182279700.0,-73.61802508602024,91.40936679472856,92.55270083870475,-103.86251723399644,19.119329605892872,25.259694041276607,0.07654710862113247,14.647920277888524,380.82159045410157,371.41919134521487,363.8199920654297,356.22079278564456,346.8183936767578,0.14,0.0,421.3131130863748,0.0017528314700072656,-0.02042828883753652,346.5728541782924,361.2635694231306,16.90091495441598
2022-04-20,0,233.14999771118164,337.9599914550781,388.26000213623047,350.1868782043457,378.08874130249023,-0.46047456584599844,15.800721853996313,-1.2388492370880053,2.9947985836552284,374.32875061035156,14.206500396728519,0.04305916443302901,345.5547500610352,384.3297454833984,0.848983757788472,-0.09336777745643642,0.6353661675568947,0.6570974364109323,0.676611973727824,-0.3346508222972636,26.74750431534132,398.5551935554047,366.9537498474121,335.3523061394195,329.3667847769601,42.650240869647064,351.33839116777693,37.48781776459178,348.38407086390134,357.9230904501299,-5.702439949193659,-11.996473178481082,133387500,6.095687272226053,11.432926829268293,-315667200.0,-92.54536082825683,91.40936679472856,92.55270083870475,-403.6130082769181,11.146014310646498,51.712868604700276,-0.1166430942651669,23.33012973554841,352.7116303100586,325.91917111206055,304.2649917602539,282.61081240844726,255.8183532104492,0.16,0.0,388.27592438490706,-0.3426620214201289,-0.3500287286166487,328.0457109723772,350.1721409388951,35.31396732678984
2022-04-21,0,219.35499954223633,233.14999771118164,388.26000213623047,348.8406276702881,378.08874130249023,-2.724422039814159,32.98908606114462,7.963491771768032,2.99109583662316,372.08625411987305,21.37720024108887,0.09169550670731738,341.31024475097655,384.3297454833984,0.3359497846957393,-0.38287861054980393,0.6097127939382158,0.6457049159821612,0.6830701529046558,-0.3676297886188532,8.22427062394291,425.74592133646155,359.76774921417234,293.78957709188313,310.77535574776783,58.01180537312992,339.9389272417341,50.46511242611374,319.5833288316222,341.96635698280545,-35.019962486519745,-39.53382908197462,53501600,24.546743032296295,3.7795386840110514,-369168800.0,-96.3685650393739,91.40936679472856,92.55270083870475,-303.5602435096123,10.581739114861039,49.40500894976222,-0.11524084894086031,22.817589691853673,352.4779926147461,325.5409948425293,303.7699966430664,281.99899844360357,255.06200067138673,0.18,0.0,377.36592631548615,-0.3772793260233269,-0.36582389610578503,309.5057111467634,339.0028555733817,47.030399442071975
2022-04-22,0,218.00500106811523,219.35499954223633,388.26000213623047,346.6543769836426,376.7612495422363,-2.116560952735905,44.665872880997384,3.4526561163596776,2.9867735502990382,366.38500213623047,28.984050445556637,0.12694744934952104,327.4789920806885,384.3297454833984,0.6130970666353329,-0.4166594673860618,0.6196045671103619,0.6715967357481458,0.7374339017767159,-0.3699004272337443,7.536261675037689,441.1771204415602,351.84537467956545,262.5136289175707,291.8592839922224,64.19025344187712,328.7314276014055,58.830821633825124,294.5428978512446,326.1349527759169,-37.23658483858492,-42.114672158551684,37515100,24.54294633062423,2.3688381326672103,-406683900.0,-97.05866449770912,91.40936679472856,92.55270083870475,-226.75659230295307,10.032723462068807,47.311926391392966,-0.14468197164304797,22.3460026506331,352.13107232666016,324.9794543762207,303.03499603271484,281.090537689209,253.93891973876953,0.19999999999999998,0.0,370.4385407839086,-0.3682173916466305,-0.3849841372685795,291.1371394566127,327.7207129342215,55.4969854932374
2022-04-25,0,211.2224998474121,218.00500106811523,388.26000213623047,344.90937423706055,376.1275043487549,-1.636560192137605,52.90576432787836,1.2118682055581615,2.9826592119082878,360.5737495422363,36.95675134658815,0.15382086728752775,231.7704978942871,384.3297454833984,0.7366735295434437,-0.41670513370126006,0.6141188683299676,0.6809828721330797,0.7822172021704149,-0.3750073819744194,7.496280498857541,449.7555283276927,343.943999671936,238.13247101617932,272.47999790736606,65.27980968285446,316.4223207746233,64.25665343291492,275.40663551160833,312.2703205038803,-37.78706857401002,-41.851376763746785,28152000,24.55578362460849,1.6496155028230446,-434835900.0,-97.08878699910738,91.40936679472856,92.55270083870475,-179.0138312753833,9.629681730431617,47.24302285103486,-0.14681941109774935,21.617242830434048,346.2243587036133,319.1428179016113,297.25499725341797,275.3671766052246,248.28563580322262,0.2,0.0,365.40383764281177,-0.3787071190342767,-0.3846627366179085,271.0628553118025,314.7499989100865,62.393197105965676
2022-04-26,0,203.65749740600586,211.2224998474121,388.26000213623047,340.75186920166016,376.1275043487549,-1.280287725710862,59.74379745585233,-0.00315541971223654,2.9783904748421137,354.61000061035156,46.15384994506837,0.17790541912011074,219.21999969482422,384.3297454833984,0.7909179300897264,-0.43702150111017285,0.6064524515660692,0.6893945731488886,0.8323320317457249,-0.40395688887674197,6.92046758394643,455.30534431661187,335.8177494049072,216.33015449320254,252.1474974496024,60.56456395480959,303.52714238848006,67.63668589293934,259.37131781624845,299.32488513143784,-39.107466364702816,-44.929604388388796,20318100,24.454377178583655,1.1372794425914037,-455154000.0,-99.93265889469473,91.40936679472856,92.55270083870475,-149.6916656891158,9.246761081640866,47.49454504159785,-0.20479439900807378,20.90343706122445,334.41716064453124,308.40142028808594,287.375,266.34857971191406,240.33283935546874,0.2,0.0,361.7757361003667,-0.4308826418256376,-0.4127745145965186,250.67285374232702,301.7678560529436,68.46867364808347
2022-04-27,0,192.62749862670898,203.65749740600586,388.26000213623047,311.757493019104,375.9193706512451,-0.9974749738623597,65.51017242166093,-0.7307939545900974,2.973982701899161,349.9562530517578,55.08162488937377,0.20018922627609662,217.3267509460449,384.3297454833984,0.8155700184157368,-0.4754610408348278,0.5886406413552688,0.6859190329127581,0.8873653682641078,-0.17380441553626158,4.400761073076889,458.26159373705957,327.2412488937378,196.22090405041604,231.38571275983537,50.28234058813139,290.82732064383373,70.73068490563615,245.49258959654196,287.151727038512,-41.136899852093585,-46.990421365434656,22298400,23.918771946953218,1.1932947009899972,-477452400.0,-99.57405045335325,91.40936679472856,92.55270083870475,-131.728427496816,8.842378650339558,49.11819541195634,-0.2546915961464755,20.297136704877346,325.8782875366211,299.4858669128418,278.1550064086914,256.82414590454107,230.43172528076173,0.2,0.0,357.7424954745738,-0.16645302068568013,-0.4591664002509968,229.3414263044085,288.9242837088449,73.09774628044941
2022-04-28,0,194.54000091552734,192.62749862670898,385.5875015258789,229.7012481689453,371.54625129699707,-0.7792322710994397,70.11263206674333,-1.171758585712487,2.96949876797166,348.18625259399414,62.674024810791025,0.2208552736425049,210.46599960327148,383.61399536132814,0.832159867315485,-0.5004311657809772,0.6128023420331943,0.7339684990513049,0.9309314413978429,-0.11312711667613895,4.073096442219106,457.6848878517484,317.4596237182617,177.23435958477504,210.3653564453125,14.543734481024632,278.841249193464,71.88769757585237,232.2982032125867,274.48742070367234,-43.00286912739102,-47.998246057976274,21363200,23.861978348545144,1.0925562344368578,-456089200.0,-92.13114830456645,91.40936679472856,92.55270083870475,-108.68302274905574,8.34016266760528,47.104577842429634,-0.19612093139403644,19.98146160941611,320.7516014404297,294.924202331543,274.0500030517578,253.17580377197265,227.34840466308592,0.2,0.0,354.12931349163875,-0.08569332253522155,-0.11790971254732648,208.04285757882255,277.30785587855746,75.75851145801323
2022-04-29,0,195.9375,192.62749862670898,384.1899948120117,219.01749992370605,364.3650016784668,-0.570487730207722,73.1295056962148,-1.49458478030145,2.9657765328310286,346.4312515258789,68.27932456970215,0.2375049824513132,202.745747756958,379.40774459838866,0.8567829249822169,-0.48663072395107765,0.6363523458283529,0.7843194214530177,0.9604285093676028,-0.10122474695532457,5.538669678512046,454.16626008017386,307.90724868774413,161.64823729531443,205.04928534371513,11.256998980033151,267.20803506033764,71.1263884614086,222.87663814875998,266.50666415471665,-43.06410082588352,-46.31083628582096,16391900,24.00429718889206,0.8128374756462152,-439697300.0,-97.26138048806352,91.40936679472856,92.55270083870475,-94.86920960509987,9.070358568623098,44.57878906920642,-0.22049572232471437,19.604746731344438,318.39084423828126,293.01458459472656,272.5050048828125,251.99542517089841,226.61916552734374,0.2,0.0,351.4556671034611,-0.116740920394109,-0.12766932661765748,202.92428588867188,265.48499843052457,78.22011178799396
2022-05-02,0,195.34750366210938,192.62749862670898,384.1899948120117,216.30937576293945,359.68812370300293,-0.36765143881820356,75.09140005957549,-1.7072475538258327,2.9626783578449434,343.83374786376953,72.15589965820311,0.25134628864576886,195.79775009155273,375.7739959716797,0.8710057848932472,-0.4773745643663702,0.6538680861288033,0.831925324583463,0.9787096213336582,-0.0751576948325623,6.676370460693524,448.9395490815533,298.75674896240236,148.57394884325137,201.61964307512557,9.725003364636148,256.1974994114467,69.31647886564217,216.18333973101323,259.72399828166607,-15.960754053825568,-45.39126645812992,14591600,24.1023221773617,0.7061485778885037,-454288900.0,-92.02577480867912,91.40936679472856,92.55270083870475,-82.8112223341083,8.72115364820354,42.86252478135747,-0.18286572003182044,18.93267784065317,318.39084423828126,293.01458459472656,272.5050048828125,251.99542517089841,226.61916552734374,0.2,0.0,349.1727926772396,-0.04978322502944377,-0.07451743337147806,200.2442866734096,254.8749989100865,78.98900692056698
2022-05-03,0,199.03249740600586,192.62749862670898,384.1899948120117,209.33124923706055,352.5137519836426,-0.1719850078435503,76.17623901160098,-1.8240927418644906,2.960150008741287,339.8212432861328,74.41651203155516,0.26287735744512614,195.26675338745116,371.7375022888184,0.8692042176659364,-0.4906856837607475,0.6868432682247109,0.9024268505539657,1.01329024896556,-0.02270969671585299,4.858785842315994,442.1311023670741,289.7786243438721,137.42614632067006,198.90928540910994,6.509547322507885,245.38428470066614,65.1716873919941,211.00223186089053,253.2805685576431,-10.94458568540826,-44.10578059001451,11839400,23.824849474541274,0.5663288930387763,-442449500.0,-91.42428513395913,91.40936679472856,92.55270083870475,-72.37371333102955,9.60731965862515,41.442445906227746,-0.1849371761010589,18.182172742081587,312.7296014404297,288.43520233154294,268.8000030517578,249.16480377197263,224.8704046630859,0.2,0.0,347.40151081495975,0.007409280574222521,-0.04783006226365075,198.0085710797991,244.57285526820593,77.47264142735588
2022-05-04,0,199.2624969482422,192.62749862670898,384.1899948120117,202.50124740600586,349.7256278991699,0.008505620670442506,75.43071057786199,-1.8774103277550591,2.959113056322283,285.5549945831299,74.26524982452392,0.2688646278733857,195.26675338745116,363.1530014038086,0.8679720424427654,-0.48194252819260797,0.7102496672865005,0.9659455726436221,1.0192611488862777,0.034444709965274045,8.016604126050133,431.4141705987782,280.5527494430542,129.69132828733024,197.20071356637138,3.7040568403438865,234.84035573686873,59.15133057477186,207.99655570169057,247.47077213881218,-8.702783683472221,-43.20132541916084,12218800,23.905351654558093,0.5735250872634652,-430230700.0,-88.93630464026762,91.40936679472856,92.55270083870475,-65.50413634148933,9.092778006800296,40.7290776458808,-0.1488929654461876,17.838313566759073,312.7296014404297,288.43520233154294,268.8000030517578,249.16480377197263,224.8704046630859,0.2,0.0,345.623099897693,0.08205156344322906,0.02827621362366843,197.16571262904577,234.1142839704241,75.36779454529731
2022-05-05,0,193.87000274658203,192.62749862670898,370.4250030517578,199.2049970626831,347.5318775177002,0.1806841143804159,73.46882315490042,-1.8799797406226708,2.959175228487508,226.25249862670898,72.22326269149781,0.2707965239548655,195.26675338745116,359.15674819946287,0.8726874461914861,-0.4620706072575772,0.7145796078998837,0.9555012201108967,0.9849916827063719,-0.0034440123665684386,8.520381803601197,418.24402085966653,271.3063745498657,124.36872824006491,195.80250004359655,2.5178956850710397,223.97499874659948,50.50368821161582,205.76878252388804,241.9498887403467,-5.6622769391565155,-42.555370254402376,13971300,23.985616817786706,0.6413102626947076,-444202000.0,-98.36223420001325,91.40936679472856,92.55270083870475,-67.3597200600262,8.43725772942642,39.7982766330393,-0.16573923429318166,17.850580906645728,312.4851158447266,288.2374378051758,268.63999938964844,249.04256097412107,224.7948829345703,0.2,0.0,343.5310269578858,-0.05613470683845667,-0.0011667867282683442,195.72571454729353,223.19928414481026,73.77823858070572
2022-05-06,0,182.68500137329102,192.62749862670898,362.3450012207031,198.2587480545044,346.20812606811523,0.37099446497017874,71.61238205458709,-1.7828615879018361,2.9592510487933397,218.68000030517578,69.37359985351563,0.27283129123966143,194.4730010986328,351.2560028076172,0.8678077246790307,-0.4649574242960331,0.6959995378564803,0.9118281684126253,0.9287965897176669,-0.06763635662754186,8.204588982359171,405.70338864378107,262.4786245346069,119.25386042543275,194.38214329310827,5.566342850307619,212.8839280264718,39.368292808925574,202.78455711953222,236.42352348227965,-4.805860223211795,-43.96577816825114,17185500,23.99859645041691,0.7672993967822583,-461387500.0,-97.06601250618611,91.40936679472856,92.55270083870475,-72.44243619249205,8.005531472032338,41.92979994055764,-0.166386308476569,17.46898399571977,310.174673828125,284.4976545410156,263.7449951171875,242.9923356933594,217.31531640625,0.2,0.0,340.86425124400967,-0.04932758646533553,-0.09297314882986012,194.644287109375,211.99285670689173,71.84446486638285
2022-05-09,1,176.56500244140625,182.68500137329102,358.80249786376953,195.79000091552734,342.7581214904785,0.5681831293704451,69.7662198338799,-1.5803062429470314,2.959237605763757,214.61375045776367,65.67506217956543,0.27521666285114027,193.74575233459473,349.5872528076172,0.8528306623782079,-0.4908480223494625,0.6965209074525378,0.8970966998092226,0.9099436045374082,-0.09614917451512983,7.321820199800472,393.0280642099961,253.49562454223633,113.96318487447655,191.8142863682338,8.72900720927149,201.08982140677315,15.014844912227803,197.74053935109572,229.61952535713272,-5.161515009176047,-45.944784592180454,14031300,23.970011049867274,0.6127823374322912,-475418800.0,-98.95287550305076,91.40936679472856,92.55270083870475,-74.11027696323227,7.638769868165429,41.48412610154726,-0.18242991698566197,16.999624745601785,230.6695983886719,219.51519927978515,210.5,201.48480072021485,190.3304016113281,0.2,0.0,338.6831443806174,-0.13215682203483514,-0.09067027974099176,190.87000165666853,199.45642961774553,69.55933321453308
2022-05-10,1,176.5275001525879,176.56500244140625,350.4175033569336,195.14562797546387,338.89061737060547,0.7759763956378821,67.27360790434747,-1.2626123419128885,2.9598391648293965,207.43999862670898,60.611499710083,0.2752785648282823,191.63324890136718,347.13925247192384,0.8445129756853172,-0.49479963646452163,0.7223373089164798,0.9129827647083838,0.9277103050862088,-0.11307197340497666,7.018903176480593,378.9309655798131,244.38374977111818,109.8365339624232,189.04142924717493,10.165605302605098,197.04535729544503,13.235260138246709,192.69827849621174,222.30007469870142,-9.239744211744993,-48.32483227422891,13883900,23.98030916649437,0.5932522412696134,-489302700.0,-87.58536481099509,91.40936679472856,92.55270083870475,-71.41957233207805,7.267072415395366,40.21049660944649,-0.16757811702554973,16.592390457963987,214.2020361328125,205.86397827148437,199.125,192.38602172851563,184.0479638671875,0.2,0.0,336.5875566214847,-0.11112218941145213,-0.10929510838245748,189.05571637834822,195.99000113351005,66.39910066112199
2022-05-11,1,172.2324981689453,176.5275001525879,350.4175033569336,194.37250137329102,259.35249614715576,1.0190052122871662,64.2553397282661,-0.7687077185405018,2.9611904659466384,201.45999717712402,54.424561977386475,0.27257402426770316,182.07300148010253,346.07425079345705,0.8234531751549841,-0.49623663640803406,0.7306179585093304,0.9034460213279594,0.9270677325571941,-0.13565020610134093,6.772065802156491,364.2460540979506,235.73537464141845,107.22469518488629,185.73928560529436,11.449029857407274,193.67946434020996,13.116595440943907,188.86729717911606,215.59146633023195,-9.906220017817983,-24.285866658568786,12665500,23.96013809796555,0.5311575674488962,-501968200.0,-98.64955196155348,91.40936679472856,92.55270083870475,-78.36516441706101,6.783563494324491,39.708201219013596,-0.1819055618343799,16.50505313282778,211.940083984375,203.07496380615237,195.91000366210938,188.7450435180664,179.87992333984374,0.2,0.0,334.65550368245454,-0.18450076174276442,-0.16760894990945652,184.32857186453683,192.28642926897322,62.768100431128914
2022-05-12,1,169.6400032043457,172.2324981689453,346.87750244140625,193.55937671661377,222.80374908447266,1.2946107598094883,59.94501795051938,-0.024557053290618747,2.9638442826636595,199.14749717712402,47.15243654251098,0.26427739800182976,176.5612522125244,342.11274566650394,0.7919950079530306,-0.5034774611880791,0.7478856488269365,0.899469792477334,0.940479899132414,-0.12498065300957706,6.493467037088255,346.7161602830578,226.82612438201903,106.93608848098026,181.54035786220007,11.147063608559696,190.224821635655,12.574902217311285,184.81019576798576,208.4579845861458,-11.8327621596567,-21.482301051550767,17662100,23.951422187421326,0.7189463599933975,-519630300.0,-78.49862557757842,91.40936679472856,92.55270083870475,-79.30673861055736,6.343802754544138,38.372149946525845,-0.16109663969981833,16.388234245804963,203.9278043823242,196.05110482788083,189.68500518798828,183.3189055480957,175.44220599365235,0.2,0.0,332.04468205136106,-0.07439469637182439,-0.14558108792678282,180.67714364188058,189.34285736083984,56.38086084564874
2022-05-13,0,182.14500045776367,169.6400032043457,345.98500061035156,190.1418743133545,218.3425006866455,1.6308428512174071,54.38536846724544,1.1686344448448969,2.9678012790428605,197.48499870300293,38.835198898315426,0.24951508612959586,176.09799995422364,338.3322418212891,0.7359874237154712,-0.5096897180366662,0.8356645685809043,0.978695394446378,1.037685861957475,-0.0029559126992803053,6.300209632316572,326.73498635465694,217.96424942016603,109.19351248567513,179.09500122070312,8.062000968682387,188.14785739353724,11.161934794283617,181.03617615370015,201.42013263226605,-14.76768597326219,-22.185269891426934,13136300,23.923410798122525,0.5253202496813799,-506494000.0,-46.31783041250988,91.40936679472856,92.55270083870475,-56.997001282445666,10.46654803013088,36.09138147865172,-0.12571100309904137,16.179026862992252,198.19015692138674,191.40991879272462,185.93000030517578,180.45008181762697,173.66984368896485,0.02,1.0,330.30080768997533,0.036856927247355564,-0.003610917099209674,178.3385729108538,187.75214276994978,48.47538025231836
2022-05-16,0,190.3499984741211,169.6400032043457,341.6824951171875,182.55000114440918,212.9181251525879,2.1095543620394994,46.209790437088266,3.377022318406782,2.9743010562018553,195.6425018310547,30.274148826599117,0.220285526643767,176.09799995422364,243.63099708557144,0.6511299614286548,-0.46104567089866755,0.907412677354573,1.0304185837930864,1.0850976360650266,0.07807320727271216,20.29377324343129,302.1918302867131,209.7722494125366,117.35266853836009,178.59214346749442,7.030639958533911,187.1973217555455,10.270590907309595,181.23909622689212,196.56072991357024,-8.590425570610375,-13.766288823706814,16145000,24.414344365367285,0.6316937727005779,-490349000.0,-43.33336239769352,91.40936679472856,92.55270083870475,-40.497995729740715,13.66584560985842,34.423248698523814,-0.15117731938255977,15.751147725869176,194.79800671386718,188.66600671386718,183.7100067138672,178.7540067138672,172.6220067138672,0.04,0.0,328.2921655725138,0.07746960098488365,0.03061277144700049,178.07999965122767,186.90285709926061,38.027831889824306
2022-05-17,0,189.0749969482422,169.6400032043457,341.6824951171875,182.55000114440918,205.54874801635742,2.870675263307647,35.75093408916051,8.652394544210756,2.9820887045034414,194.94375228881836,21.2721992111206,0.1766422501457613,176.09799995422364,220.73449935913087,0.37010812130748266,-0.4429038619352262,0.934203084706722,1.0262930603823586,1.0611519699352383,0.07107955862292514,27.064842948528767,273.8936179418098,202.39174976348878,130.88988158516779,179.50499997820174,7.998801697306498,186.943571635655,10.169497696389632,183.37708666993598,193.36566049864786,-1.815651840198365,-6.534254373830054,9876700,24.54970407291691,0.3949612024908465,-500225700.0,-33.69049798874628,91.40936679472856,92.55270083870475,-29.275883863549534,13.262253578921383,33.65787293975691,-0.16798717453601925,15.070930105535089,194.79800671386718,188.66600671386718,183.7100067138672,178.7540067138672,172.6220067138672,0.04,0.0,327.08856722319047,0.07261056867373927,0.10086649820588028,179.4499991280692,187.0471431187221,15.829202176226513
2022-05-18,1,181.97000122070312,169.6400032043457,233.14999771118164,182.55000114440918,200.3612470626831,0.5518209248552053,16.08346589581079,-0.13513433962941956,2.992363807469245,194.2050018310547,12.211761989593507,0.08258036742542774,176.09799995422364,218.14000091552734,0.7695242857265786,-0.18904139479142557,0.9343228417654227,0.9930949483234398,1.0070923261519988,0.05653696692134225,39.625466321207206,226.9283066466631,194.7613748550415,162.59444306341993,180.27714266095842,7.928263648790804,186.0457145145961,10.00072107127217,184.52101641084937,189.8478193212302,3.497821674968334,-1.844233924955417,9665600,6.39282105174417,0.5135631498674462,-509891300.0,-65.52381969633556,91.40936679472856,92.55270083870475,-71.06181494489857,12.360532518314146,35.60402400652026,-0.1582854874909871,15.01513859685116,194.79800671386718,188.66600671386718,183.7100067138672,178.7540067138672,172.6220067138672,0.04,0.0,325.8580588922426,0.06503580959173183,-0.0026455094619778226,180.03428431919642,185.4521429879325,14.262012410386408
2022-05-19,1,180.88500213623047,169.6400032043457,219.35499954223633,182.10125064849854,199.08999729156494,0.31849780114656256,13.66111411462877,-0.5483982385320072,2.993220308370934,193.2487506866455,10.863137283325196,0.07107671854970408,176.09799995422364,211.90074996948243,0.7882285136856536,-0.1704314850336238,0.9411174139107794,0.9965786344209373,0.9904126353828406,0.06628742466091109,36.90313769136283,219.52460325977512,192.20237503051757,164.88014680126003,180.89964294433594,7.753937869344072,184.97053609575545,9.658750104678802,183.84265890730987,188.47137091965737,3.0611948600009473,-6.461395926631218,10448500,5.917665585621257,0.6268594751263048,-520339800.0,-50.15601169584226,91.40936679472856,92.55270083870475,-55.141285891204454,11.72433555218794,34.043656670662976,-0.13666682890284412,14.699002773659709,194.54588531494142,188.4620655822754,183.54500579833984,178.6279460144043,172.54412628173827,0.04,0.0,324.5638602014733,0.052607413787971735,0.1028430673349459,180.86571175711495,184.96071406773157,12.860273658021521
2022-05-20,1,185.54500198364258,169.6400032043457,218.00500106811523,181.69875144958496,196.71124935150146,0.3322657037301082,12.347756179547842,-0.3998206566979752,2.9936381367558376,191.48874855041504,10.078487033843993,0.064892942893166,176.09799995422364,204.41399765014648,0.738426475225255,-0.17027131831845774,0.9751213939404008,1.029618642466715,1.003569798181438,0.01866645539177081,36.35887524798451,214.97438751931296,190.2788751602173,165.58336280112164,182.8014292035784,6.854241267340362,184.2703574044364,9.192697557495231,183.0793877448915,187.43548432289978,2.468455045177672,-7.682295560456539,10429400,5.919416876808125,0.681049189534225,-509910400.0,-43.268537488762874,91.40936679472856,92.55270083870475,-22.83931515074993,13.048734972028923,32.28296102526886,-0.09992585186193803,14.393310891835304,194.54588531494142,188.4620655822754,183.54500579833984,178.6279460144043,172.54412628173827,0.04,0.0,323.3270778354501,-0.006874831007934956,0.06907239236736629,183.7199990408761,184.02428545270647,11.326825222875424
2022-05-23,1,184.7849998474121,169.6400032043457,211.2224998474121,181.69875144958496,195.49500274658203,0.08934998846248372,10.607380858992297,-0.6438658415165137,2.9941522918471413,189.71249771118164,8.970786571502686,0.056226082794453555,176.09799995422364,199.70199699401857,0.726059239729182,-0.12156611100767696,0.9794818191887481,1.0237764756973413,0.9957966194889425,-0.02923561161712107,43.42305136120907,209.87063692397825,188.65587520599365,167.44111348800905,184.9650001525879,3.6475535982236003,183.25267900739397,8.163797466335026,183.64676649760298,187.07774402605224,7.729379737405214,-5.017981542995341,9602000,5.9792741705653505,0.6674440306612749,-519512400.0,-40.65275542543901,91.40936679472856,92.55270083870475,-23.768500185876206,12.40111445607097,31.635757152511157,-0.06362753285898888,14.063025849448314,194.54588531494142,188.4620655822754,183.54500579833984,178.6279460144043,172.54412628173827,0.04,0.0,322.19871345638137,0.004986370500033699,-0.001065854556026079,185.59571402413505,183.1364288330078,10.1004106731953
2022-05-24,1,180.87749862670898,169.6400032043457,203.65749740600586,181.69875144958496,194.74187660217285,-0.15945163858244013,9.276622854726881,-0.9347248305011986,2.994501923235255,187.30999946594238,8.03599910736084,0.049519162802941524,176.09799995422364,199.05549736022948,0.7297429397329901,-0.09266782612461387,0.9655348117683653,0.9975843122509449,0.9806209648458271,-0.04335580300856601,44.45649875037408,205.8872459154474,187.33400020599365,168.78075449653988,184.78392846243722,3.8373959325285356,181.93946484157019,6.745952798271482,183.88863600774616,186.34843832299705,8.927727161631198,-7.158377523410319,7706400,5.797399358533499,0.5602356560654393,-527218800.0,-53.605290463096146,91.40936679472856,92.55270083870475,-50.312901413568255,11.74143361830585,30.325821231595558,0.0036691540969653468,13.792058518643776,191.7420067138672,186.1940067138672,181.7100067138672,177.22600671386718,171.67800671386718,0.04,0.0,321.2815032689639,-0.053631409276024056,-0.03308132727825004,184.5528564453125,181.44571467808314,9.831591367417081
2022-05-25,1,184.2874984741211,169.6400032043457,199.2624969482422,180.8831262588501,194.03750228881836,-0.16740300264831098,8.574374806252882,-1.006213628434077,2.9946684641416637,185.16500091552734,7.428749332427978,0.046050510453857885,176.09799995422364,196.2469997406006,0.7889709720027595,-0.06099855983059934,0.989755354385606,1.0139586871332877,1.0080683635146719,0.012735600581807782,43.227859069725426,203.34374987953458,186.1950002670288,169.04625065452302,183.9178570338658,2.954330002457938,181.2550002506801,5.87183021791789,183.1224160787511,185.09176579148206,-0.6958751697105184,-9.226522101802553,8522100,5.349245117507173,0.6521936277557862,-518696700.0,-24.291740017401832,91.40936679472856,92.55270083870475,-1.1582304731957394,13.78880667054059,28.92223788595167,0.10342090438864183,13.428293439708442,188.05952111816407,183.2152421875,179.3000030517578,175.38476391601563,170.54048498535155,0.04,0.0,320.3173268912807,0.06004853119840603,-0.01432617423654006,184.7414289202009,181.41071428571428,9.823595981661212
2022-05-26,1,188.32999801635745,169.6400032043457,199.2624969482422,180.8831262588501,194.03750228881836,-0.04919274313806694,8.453347899434528,-0.9305047908566673,2.9946955189414646,184.5362491607666,7.119099502563477,0.045502416258282614,176.09799995422364,196.2469997406006,0.7768285429882912,-0.05270125626172925,1.013736813580697,1.0293731710083,1.0275758844411902,0.04115872400808507,47.06108472174503,202.68469605826846,185.77800025939942,168.87130446053038,183.8114286150251,2.743477157280176,181.6582142966134,6.164124615888547,183.45785185706416,184.7709134864881,-3.1849225366945424,-4.94274727224652,8049900,5.396775932975023,0.649124759296711,-510646800.0,-13.532267885162556,91.40936679472856,92.55270083870475,35.31213116602223,14.982816320870082,27.466649323175297,0.06996031467200364,13.129808558174592,188.05952111816407,183.2152421875,179.3000030517578,175.38476391601563,170.54048498535155,0.04,0.0,319.44121842840144,0.04316545865145027,0.08019635001572484,184.8614283970424,182.1557137625558,9.396746079064002
2022-05-27,0,193.5,169.6400032043457,199.2624969482422,180.8831262588501,191.22999954223633,0.0012758829254338616,8.237091854625122,-0.7763562869691336,2.994745327281233,184.5362491607666,6.754249515533449,0.044412588995605726,176.09799995422364,196.2469997406006,0.7453508650995598,-0.038826166423694033,1.043309474062047,1.0469362932469877,1.04727627331587,0.042873685258623784,51.49708901022206,201.94168382369116,185.46750011444092,168.99331640519068,185.45857129778182,4.409195107703702,182.86785697937012,6.72398351143303,184.72070477177783,185.14599721156034,-0.39402297707754286,3.0900164767942173,8586000,5.478444452907283,0.7148527603965243,-502060800.0,-2.1096959094663377,91.40936679472856,92.55270083870475,83.56522346221713,16.22398692160429,26.70310934379619,0.1719952518195117,12.540472056291625,188.05952111816407,183.2152421875,179.3000030517578,175.38476391601563,170.54048498535155,0.04,0.0,318.55246334675957,0.0474375961811353,0.06382170801473169,187.432856968471,183.7335706438337,9.584134055865142
2022-05-31,0,196.09249877929688,169.6400032043457,199.2624969482422,180.8831262588501,191.13749885559082,-0.012768004860568638,8.098137844362832,-0.7131985488529309,2.994776897631224,184.5362491607666,6.620187015533448,0.04369209059756694,176.09799995422364,195.71600303649902,0.707908713700076,-0.009457523784409262,1.0579828828342743,1.0544846848111364,1.0522467741258326,0.06119273177596685,57.10577995010171,201.54190080316656,185.3456251144409,169.14934942571526,187.63107081821985,5.412494936553292,184.2653568812779,7.312288644099305,186.94044613415218,186.09583656865016,6.336208551931955,9.591367102443584,11398500,5.617177144829004,0.9618005250096826,-490662300.0,-6.740051463598519,91.40936679472856,92.55270083870475,109.12032385115391,18.091747558773864,25.283872361010072,0.14351008125834835,12.298270311892132,191.16135925292969,185.72432067871094,181.3300018310547,176.93568298339844,171.4986444091797,0.06,0.0,317.4146474850517,0.05335040476819253,0.05951164998476184,189.42714364188058,185.14642769949776,9.44332328829987
2022-06-01,0,196.50250244140625,169.6400032043457,199.2624969482422,180.8831262588501,191.13749885559082,-0.004002127556566775,8.145632876351176,-0.7282829682523992,2.9947661664828584,184.5362491607666,6.661161746978761,0.04393951103655134,176.09799995422364,196.3864986419678,0.6632205442868457,-0.014771450215547911,1.0599819566876691,1.0534364393730098,1.0418042001041254,0.08638445319803867,58.73813653243693,201.67414062300264,185.3828748703003,169.09160911759795,189.1964280264718,6.231222755414609,185.9989286150251,7.114387357127208,189.24984295048438,187.09956466151954,8.407273385558598,11.083258194783971,8416200,5.583657984957807,0.7205619838956169,-482246100.0,-24.556587886129837,91.40936679472856,92.55270083870475,110.8885211760702,18.551228732298917,23.645031817862105,0.10707267769844668,12.211242882470664,193.29292578125003,187.44854595947268,182.72500610351562,178.0014662475586,172.15708642578124,0.08,0.0,316.58600492451694,0.06970171664341795,0.02918267792070169,190.3642861502511,187.0421425955636,9.016073752464884
2022-06-02,0,198.57500076293945,169.6400032043457,199.2624969482422,180.8831262588501,191.13749885559082,-0.07281362558797162,7.949970368978351,-0.745533325835658,2.994809893366109,184.5362491607666,6.522012023925784,0.042913343002311824,176.09799995422364,196.1334991455078,0.6378342328690085,-0.013851048486825081,1.0718929409694706,1.0603249221136908,1.035633733976635,0.07752833158579508,59.08885994497596,201.15631586002704,185.25637512207032,169.3564343841136,191.16642815726144,6.761403288181793,188.06571415492468,6.131440492064889,191.05887151385457,187.89296816108003,5.905575650444991,14.091419755552836,9623100,5.584455388567459,0.8331497156125856,-472623000.0,-1.2768983634226936,91.40936679472856,92.55270083870475,161.2526780725621,18.655125200962498,21.760076430158055,0.09766436019850228,12.321163783698603,198.44664251708986,194.1016833190918,190.59000396728516,187.07832461547852,182.73336541748046,0.1,0.0,315.6908262478968,0.09189157396889458,0.1372407702261878,192.8857138497489,189.24071393694197,9.135522661519454
2022-06-03,0,200.02999877929688,169.6400032043457,198.57500076293945,180.8831262588501,191.13749885559082,-0.10059028038877113,7.890599740052984,-0.769291503430138,2.9948229449017063,184.5362491607666,6.4841997337341315,0.04260076949135223,176.09799995422364,196.1334991455078,0.6702442128801729,0.024268829368654724,1.079947298061158,1.0587070820386304,1.027903385299573,0.0621249980681422,63.219381999883154,201.00319979291112,185.22200031280516,169.4408008326992,193.90249960763114,5.694992697815767,189.34321403503418,6.6446652128331785,192.87621767933058,188.8949595939145,7.462727454563175,17.056706562153916,7191800,5.462738721519984,0.641478366896227,-465431200.0,-21.80781818247084,91.40936679472856,92.55270083870475,139.61080487962224,17.86965178146198,20.843869143524184,0.12337301407367542,11.943906474721722,198.44664251708986,194.1016833190918,190.59000396728516,187.07832461547852,182.73336541748046,0.1,0.0,315.0263966912853,0.03960293663935088,0.05936215614006811,195.54857090541296,190.05071367536272,9.607199003491512
2022-06-06,0,199.61999893188477,169.6400032043457,200.02999877929688,180.8831262588501,191.13749885559082,0.028457539216436397,8.330134693050711,-0.7753397913564002,2.9947239796992653,184.5362491607666,6.822999515533449,0.044899125143709445,176.09799995422364,196.7097522735596,0.7609527014599665,0.09494483551259802,1.0759445847504592,1.0459386131765689,1.013608199335942,0.03162790145676886,69.63503215067402,202.19026950054234,185.53000011444092,168.8697307283395,196.0928568158831,4.108031763028367,190.00535692487443,7.19204214764587,194.58586944459765,189.956922942369,10.58865823444098,9.819099221271479,5372000,4.7535719925648765,0.5058087502465723,-470803200.0,-27.990602717151937,91.40936679472856,92.55270083870475,110.93920887584162,16.943148278472027,21.39371114339601,0.12309442602186434,11.697179440136631,198.44664251708986,194.1016833190918,190.59000396728516,187.07832461547852,182.73336541748046,0.1,0.0,314.5299397024918,0.00999025013500665,0.029989580335454052,196.87857055664062,190.80999973842077,9.835926432231508
2022-06-07,0,196.52000045776367,169.6400032043457,200.02999877929688,180.8831262588501,194.14812469482422,-0.060421972127769175,8.842842364902495,-0.9583222613265048,2.9946047615806304,185.16500091552734,7.468424320220949,0.04744605947503903,176.09799995422364,198.67950057983398,0.782746050268662,0.13057512061672247,1.0544233680746569,1.0221575002790735,0.9917038438782648,0.002180102151423613,72.02345612624737,204.06243472217562,186.3767499923706,168.6910652625656,197.2628571646554,2.294693844242758,190.53714288984025,7.390466705335306,195.8038278101037,191.0164561514365,8.319880938595933,4.869976638861895,4839500,4.471576553798487,0.4762806901862755,-475642700.0,-23.05108157454735,91.40936679472856,92.55270083870475,85.80635378269832,16.238303541532026,22.00386411853451,0.20424152119558606,11.333069961444187,198.44664251708986,194.1016833190918,190.59000396728516,187.07832461547852,182.73336541748046,0.1,0.0,314.0796928141683,0.005925841544154764,0.017521379815402974,197.90857151576452,191.38499995640345,9.610957032925155
2022-06-08,0,201.45000076293945,169.6400032043457,200.02999877929688,181.69875144958496,196.19499969482422,-0.256981307219705,8.805175365994954,-0.8729301435345871,2.994622800838856,186.9375,7.484999465942384,0.04699238888436944,176.09799995422364,198.67950057983398,0.8004715472198619,0.11325431044961576,1.0751196180791656,1.0414431898071714,1.0161438010378196,0.025177787865620083,65.17823659274293,204.98485062517838,187.37449989318847,169.76414916119856,198.39857155936105,2.079177168957881,191.92857142857142,7.486585433429874,195.98657454826184,191.59378622728912,4.348750877539369,3.93759282278846,7244100,4.567920711556998,0.7370102965347056,-468398600.0,-14.366919213211116,91.40936679472856,92.55270083870475,122.63677618607541,20.184824443225015,20.639300253081817,0.19556090891253228,11.219272192819338,199.9058853149414,195.28206558227538,191.54500579833984,187.8079460144043,183.1841262817383,0.12000000000000001,0.0,313.4437897041848,0.05142293287351074,0.027299429310167343,199.0,193.21642848423548,9.81469078539202
2022-06-09,0,196.9124984741211,169.6400032043457,201.45000076293945,182.10125064849854,196.5068769454956,-0.38180106303065925,8.94435026719831,-0.7078343769098536,2.994600171522141,188.7024974822998,7.550874710083006,0.047419789171073694,180.01299858093262,199.66099891662597,0.732345195108819,0.16963989319445552,1.0439605878401101,1.0072727161536137,0.9883230619228341,-0.008372163074057193,72.2254721305191,206.5093254581027,188.62062492370606,170.73192438930943,198.51571437290735,1.946460491758353,193.0733925955636,6.867801058315003,197.36360973600478,192.7529454705403,4.108527526066901,10.705060950463986,6949000,4.462812404209945,0.7281616982126559,-475347600.0,-48.36146098453252,91.40936679472856,92.55270083870475,53.55731492889394,18.85451837413023,22.54553306809222,0.22611863215222552,11.15289218296718,200.25044329833983,195.83978231811523,192.2750015258789,188.7102207336426,184.29955975341798,0.12000000000000001,0.0,312.80274446377774,-0.06007115064321422,-0.0007257238452682628,198.3328574044364,193.8800005231585,8.199462009942698
2022-06-10,0,183.07250213623047,169.6400032043457,201.45000076293945,183.75187397003174,196.61812496185303,-0.4940984537985292,8.275739790917195,-0.4300690664244975,2.994774607368734,189.71249771118164,7.100624847412108,0.04358987722094055,180.8842517852783,199.66099891662597,0.673059178536381,0.16076688725903504,0.9642772842383234,0.9304674884790629,0.9203947714817273,-0.08477476751762847,64.29445374627922,206.4061045207992,189.85462493896483,173.30314535713046,196.59714290073939,6.210282026943294,192.8967854636056,7.104015503506586,197.26842290351172,193.3507551190533,0.4181698432774487,8.860599910776344,13065600,4.577219950848291,1.4028841285955644,-488413200.0,-80.90035422000634,91.40936679472856,92.55270083870475,-76.6598855870817,17.422092833226,28.283346877712415,0.16696021454552404,11.207688560635221,200.25044329833983,195.83978231811523,192.2750015258789,188.7102207336426,184.29955975341798,0.02,1.0,311.49002704865956,-0.08061108468459388,-0.10800133742258088,196.90857151576452,193.6364288330078,7.4876926225967555
2022-06-13,1,173.7025032043457,180.87749862670898,201.45000076293945,183.98374938964844,196.61812496185303,0.04684079866211716,7.064354316564544,-1.5417986479668098,2.995045048934725,189.71249771118164,6.446625041961669,0.03707811559198692,181.86150131225585,199.66099891662597,0.7003367825212177,0.005092106157928111,0.9116985365989271,0.8852097849143133,0.8884356855933364,-0.12983416424314653,41.47892259648153,204.6549585186882,190.52624988555908,176.39754125242996,193.04392896379744,10.514124763525816,192.10517856052942,8.548134732577559,193.75906218507782,192.14557476798694,-6.834518715190603,-1.3325607378150137,10222400,4.9859801442999,1.1150464293622493,-498635600.0,-98.0999589736339,91.40936679472856,92.55270083870475,-167.5763432732609,15.896708258436217,33.253537311472364,0.05183609167215445,11.405720880550763,198.3128853149414,192.7035655822754,188.17000579833984,183.6364460144043,178.02712628173828,0.04,0.0,310.3977281265445,-0.1392411333733805,-0.14720069311007136,191.85142953055245,192.36857169015067,8.875455053779898
2022-06-14,1,168.40749740600586,173.7025032043457,201.45000076293945,183.98374938964844,196.61812496185303,-0.24650286623354206,7.769592526729767,-1.0432305939212212,2.9948938170921826,189.71249771118164,6.851124763488768,0.04087019429901546,180.8842517852783,199.66099891662597,0.6844554017186294,-0.0874572913224304,0.8858697694525561,0.866972703652466,0.8848114816251111,-0.1430516129975269,30.940039350873214,205.6433100763477,190.10412502288818,174.56493996942868,188.526428767613,13.407552905824856,191.21446418762207,10.281910860900592,188.76489763517685,189.55185616937922,-12.52549286820185,-5.997508808733327,11555300,5.017201243174709,1.2927987218910284,-510190900.0,-92.43620871188224,91.40936679472856,92.55270083870475,-176.9920991855927,15.104147755154127,34.59472843921872,0.11865465020219125,11.146728125542653,197.2084034423828,190.91580255126954,185.8300018310547,180.74420111083984,174.45160021972657,0.06,0.0,309.142802241115,-0.1564372752063693,-0.15014713500638208,187.36000061035156,191.45428575788225,10.20803604224195
2022-06-15,1,175.4375,168.40749740600586,201.45000076293945,182.79687690734863,196.61812496185303,-0.46911221258961994,9.093791533688599,-0.6510812155425914,2.994565017157823,188.7024974822998,7.820749664306639,0.048113517145697816,180.15999908447264,199.66099891662597,0.7147371712377893,-0.10930847481591602,0.9282063628771771,0.9162219911161672,0.9498048260950215,-0.12912633737614232,27.830140796091843,207.19458303685963,189.00699996948242,170.81941690210522,185.07178606305803,13.186392691685628,190.58232143947058,10.988333901126827,183.65792054487173,186.43255106925838,-15.808879451217567,-6.894169432560785,12396000,5.113399527222319,1.3675824703199522,-497794900.0,-63.27146266978498,91.40936679472856,92.55270083870475,-85.81030940137536,20.889456028648535,31.094703791682193,0.11220829186382407,11.515550843033358,197.2084034423828,190.91580255126954,185.8300018310547,180.74420111083984,174.45160021972657,0.06,0.0,307.91021947354204,-0.11201499292805572,-0.09314737396479209,184.92714364188058,190.90285709926061,10.404937520839123
2022-06-16,1,173.79500198364258,168.40749740600586,201.45000076293945,181.69875144958496,196.61812496185303,-0.3320682597537713,9.562344191791379,-1.001219543748442,2.994434797412909,186.9375,8.428124618530275,0.050775721962712995,175.26400032043458,199.66099891662597,0.8018639249073709,-0.03589878099072029,0.9228455410343709,0.9177402868132872,0.968182220405779,-0.11739984343104914,38.657203696822805,207.44981350565308,188.32512512207032,169.20043673848755,181.82535770961218,12.68604798117638,189.5441074371338,11.868886158287737,181.5740818610569,184.82381026696018,-12.114266637250322,-4.802278259457665,8201300,5.21114988090541,0.9121722887057048,-505996200.0,-78.95590245988639,91.40936679472856,92.55270083870475,-108.52618508162509,19.76079816938024,29.41465612706274,0.14727879866977106,11.303717111282111,197.2084034423828,190.91580255126954,185.8300018310547,180.74420111083984,174.45160021972657,0.06,0.0,307.0841312425689,-0.10074180494127671,-0.14534336864077013,181.31857299804688,189.61357225690568,10.661994586883205
2022-06-17,1,175.53249740600586,168.40749740600586,201.45000076293945,180.8831262588501,196.61812496185303,-0.3093303881919562,9.990405088973052,-1.1675259309514618,2.994310059900754,186.9375,8.836874580383302,0.05316410068284493,173.7857521057129,199.66099891662597,0.8074843632173507,-0.039196174745588785,0.9340989961962977,0.9392050724023548,1.003713891324185,-0.041185894343727436,37.571634149456585,207.8971853381634,187.91637516021729,167.93556498227116,178.12285723005022,9.346378866583944,188.26071439470564,12.369107685544156,179.6109000082053,183.32634369250118,-11.563707725008468,-7.7178336886364916,12133400,5.216807065230551,1.3369843088857545,-493862800.0,-73.94432914796492,91.40936679472856,92.55270083870475,-85.23040954004432,21.15267664870883,28.203538343348725,0.0981334390684684,10.947008957627014,197.2084034423828,190.91580255126954,185.8300018310547,180.74420111083984,174.45160021972657,0.06,0.0,305.9024865966345,-0.04061445192639079,-0.0895368023192537,177.41571480887276,188.2078574044364,11.005711228329611
2022-06-21,1,174.23250198364258,168.40749740600586,201.45000076293945,179.5412483215332,196.61812496185303,-0.2807273438870943,10.243660559389944,-1.2798650885543863,2.994233346122784,186.9375,9.104499816894533,0.05458954863037881,173.7857521057129,199.66099891662597,0.8445990881269673,-0.05396267466433512,0.9285033982612821,0.9446312012338254,1.004945937901327,0.003051186767719649,38.38028005448704,208.13607104248592,187.64874992370605,167.16142880492617,174.88285773141044,4.334548344607258,186.6992860521589,12.680250550831117,178.57975374665978,182.4906916138933,-12.865476921706525,-9.285531056327722,12177600,5.108090052350995,1.3290536211843569,-506040400.0,-84.61716022292698,91.40936679472856,92.55270083870475,-96.55364926057398,19.918163860617852,28.899941665707725,0.03250519560751111,10.795073682023364,197.2084034423828,190.91580255126954,185.8300018310547,180.74420111083984,174.45160021972657,0.06,0.0,304.7103513597602,0.007189588090932952,-0.06575925778261622,174.29285757882255,186.31285749162947,11.662255752727114
2022-06-22,1,175.66500091552734,168.40749740600586,201.45000076293945,175.5087480545044,196.61812496185303,-0.1900190879849869,10.648527958599393,-1.4583213378192643,2.994105189671471,186.55749893188477,9.670124816894532,0.056918698375077625,173.7857521057129,199.66099891662597,0.8517151224083233,-0.057106896514778537,0.9389676433252058,0.9656897470380811,1.0125892816086,0.043094895543900336,37.4074230612464,208.38018084090487,187.08312492370607,165.78606900650726,173.82464327130998,2.5308958785552313,185.2108930860247,12.663976191159245,177.47743917456194,181.8798159170233,-11.517804439142393,-11.147798580637108,11992400,5.110809024312204,1.2919879381133426,-494048000.0,-66.10209155130529,91.40936679472856,92.55270083870475,-63.13044443286114,21.020699358876115,26.515401354574276,0.007058499871918743,10.925430682911717,197.2084034423828,190.91580255126954,185.8300018310547,180.74420111083984,174.45160021972657,0.06,0.0,303.5938298573971,0.06774505526051655,0.05421649369955626,173.71428571428572,185.3114286150251,11.81643917742296
2022-06-23,0,180.20999908447266,168.40749740600586,201.45000076293945,175.5087480545044,196.61812496185303,-0.10708342655883937,10.92876116418379,-1.5793118954032774,2.9940126809165624,186.30874824523926,10.126124763488772,0.05855933946109981,173.7857521057129,199.66099891662597,0.8655874536355664,-0.028817833897289123,0.9656152561240701,1.002164648163806,1.0301687714569838,0.027203414802836612,40.445023568363645,208.48464730547943,186.6271249771118,164.76960264874418,174.75428553989954,3.4914374098265983,183.8991072518485,12.11232819638852,177.01542911587288,181.8002123518036,-4.046211820053102,-10.60419143114592,9538200,5.065368952097863,1.0175469290740495,-484509800.0,-59.55915205044817,91.40936679472856,92.55270083870475,-44.33076707713242,20.048119012683582,25.288593540590842,0.04530927494742384,10.637176597220883,197.2084034423828,190.91580255126954,185.8300018310547,180.74420111083984,174.45160021972657,0.06,0.0,302.7391255480405,0.008883493965318845,0.08457690101213117,175.43142918178015,183.6414293561663,11.779874912190357
2022-06-24,0,186.84500122070312,168.40749740600586,201.45000076293945,175.5087480545044,196.61812496185303,-0.10022214666952126,10.94727234393624,-1.5880757775712881,2.994006461755524,186.30874824523926,10.159499740600587,0.05866901942822972,173.7857521057129,199.66099891662597,0.8865114537223421,-0.022125751466646706,1.001346514664629,1.05148237628403,1.0623013692253171,0.07508846104958078,45.70056808451877,208.4882946878725,186.59375,164.6992053121275,177.38821465628487,4.663357500180101,182.95732171194894,11.242999928647894,177.82642963298892,182.54966899169537,3.746345481545224,-9.248395622765775,12424000,5.11491705680715,1.2983843871994598,-472085800.0,-38.352659949968235,91.40936679472856,92.55270083870475,6.704855297703371,24.46710406148076,23.666115073719148,0.07069909371538875,10.554518426146346,197.2084034423828,190.91580255126954,185.8300018310547,180.74420111083984,174.45160021972657,0.02,1.0,301.71352698157006,0.1009518280002244,0.05963025626988293,178.76143101283483,183.06071581159318,11.809825402685421
2022-06-27,0,188.77000045776367,168.40749740600586,201.45000076293945,175.5087480545044,196.61812496185303,-0.13518908264566498,10.934515822629212,-1.5760710637502153,2.9940116652929007,187.58749961853027,10.043962211608887,0.058560521924480614,173.7857521057129,199.66099891662597,0.8895475751675891,-0.007885078379947445,1.01097020936342,1.0683683280728589,1.0575527898433468,0.07541340348584868,52.560257891811794,208.59065678258756,186.7216251373291,164.85259349207067,179.29285757882255,6.202520008980269,182.1823218209403,10.344077794987815,180.09915138916543,183.74591203202098,10.948149042466405,-6.591510093014308,8363900,5.259205428213625,0.8726471814171087,-463721900.0,-42.320192366924616,91.40936679472856,92.55270083870475,5.867290015895716,23.302352648241616,22.150202770986148,0.05622193789222457,10.471336257250718,197.2084034423828,190.91580255126954,185.8300018310547,180.74420111083984,174.45160021972657,0.04,0.0,301.03221357198083,0.07765942287851657,0.0910873535055075,180.05143083844865,182.48928724016463,11.778222943887563
2022-06-28,0,185.09249877929688,168.40749740600586,201.45000076293945,175.5087480545044,196.61812496185303,-0.14091812203075768,10.93817174745058,-1.5768262492166323,2.9940107269891634,187.8075008392334,10.063762321472169,0.05857320019495566,173.7857521057129,199.66099891662597,0.8845794615928623,-0.024444442078740712,0.9911583248005975,1.044187969332597,1.0217947441457624,0.06233048754975612,53.3032457844421,208.61996875430057,186.7436252593994,164.86728176449824,180.90678569248743,6.000050013500496,181.3660717010498,9.54572676120619,182.29212272243353,184.92433418979488,7.599572758255032,-5.435326386222144,7185400,5.137277784600152,0.755206403709712,-470907300.0,-64.45474442062988,91.40936679472856,92.55270083870475,-18.063525935286048,21.295224226794378,22.269792172268275,-0.023781863823854055,10.639816578282812,197.2084034423828,190.91580255126954,185.8300018310547,180.74420111083984,174.45160021972657,0.06,0.0,300.4326916379766,0.05084548742147632,0.023303582272748494,180.9442879813058,181.13143048967635,11.729023788757056
2022-06-29,0,178.42000198364258,168.40749740600586,201.45000076293945,175.5087480545044,196.61812496185303,-0.04094616447399836,10.831471134415642,-1.5428525381535645,2.9940398296262605,185.96875,9.808499908447265,0.05813268673063718,173.7857521057129,199.66099891662597,0.8707870929598517,-0.056095975462990846,0.9575831346527731,1.0001191267312446,0.9732893759947155,0.015683266750671887,47.95551287178884,207.98619246719556,186.32325019836426,164.66030792953296,181.31928634643555,5.65852781338122,179.72107178824288,7.605678376803103,182.99432943438703,185.1945759253984,6.500472779256107,-5.814930618689272,5766800,5.145529005249074,0.6245924899002481,-476674100.0,-62.363003334010415,91.40936679472856,92.55270083870475,-51.20853542259975,20.470851090665928,24.375349529074633,-0.0470425662428175,10.277677855911527,192.86124157714843,187.39938104248046,182.98500061035156,178.57062017822267,173.1087596435547,0.06,0.0,299.93274448620815,-0.002962707703645595,0.04359017487923585,181.35143171037947,179.3835732596261,11.549870634671274
2022-06-30,1,175.42250061035156,168.40749740600586,201.45000076293945,175.5087480545044,196.61812496185303,0.14772301412292801,10.718727993729974,-1.4924052414874227,2.994065113308362,184.08250045776367,9.626837406158447,0.057801712945673545,173.7857521057129,199.66099891662597,0.8421466912661152,-0.09202173118968585,0.9459817461944283,0.9778288753474885,0.9540701881474021,-0.02656621995695685,40.84747026672646,206.87708134604148,185.43962535858154,164.0021693711216,181.4892861502511,5.423112451479134,178.18607194083077,5.8306081333537545,181.86235682210918,184.422238999659,1.644997148851551,-11.4321165014032,7894700,5.314162464127116,0.8574834429893041,-484568800.0,-62.07021120198496,91.40936679472856,92.55270083870475,-67.14733745664445,19.158771492792606,26.175377082283962,-0.011829183765143667,10.197127266706067,185.6108773803711,181.53455764770507,178.23999786376953,174.945438079834,170.86911834716796,0.06,0.0,299.2372788343773,-0.03764245965523749,-0.022471934072204804,181.91714477539062,178.10500117710657,11.632235688659257
2022-07-01,1,177.7025032043457,168.40749740600586,201.45000076293945,175.4337501525879,196.61812496185303,0.3523377662242547,10.614988956855921,-1.3712506184813937,2.9940848911063256,181.64125061035156,9.43443712234497,0.05756950381290952,173.7857521057129,199.66099891662597,0.8135968747525004,-0.11659322706098108,0.9637546470718389,0.9905462017019326,0.9715297283438358,-0.048930921119790693,37.4581953024232,205.61560318074064,184.38562526702881,163.155647353317,181.7803579057966,5.103679378385956,177.8025005885533,5.658518062163924,180.29853487776637,183.21500442422882,0.682994626812341,-10.913475797776147,5201600,5.282805587776729,0.5788721030520546,-479367200.0,-43.87536104363129,91.40936679472856,92.55270083870475,-39.87167169058722,18.821356762818382,25.072676629305445,-0.035252832210362135,9.885183496623181,185.6108773803711,181.53455764770507,178.23999786376953,174.945438079834,170.86911834716796,0.06,0.0,298.7950712786468,-0.05711296204707128,-0.009685816414042788,182.06857299804688,177.8914293561663,10.59600801746841
2022-07-05,1,180.18999862670898,168.40749740600586,201.45000076293945,175.4337501525879,190.70750045776367,0.5579165948810786,10.18602595939054,-1.092521929645324,2.9942034320514765,179.31500053405762,8.850399475097657,0.0555575151235023,173.7857521057129,199.66099891662597,0.7899284937660845,-0.1116207354457179,0.9828080758598642,1.0022289878892947,0.9950767893163408,-0.04545214711155554,40.21277591015364,203.7140523078802,183.34200038909913,162.96994847031806,181.77750069754464,5.104710534522167,178.2658931187221,5.5617419655752025,179.70109081776502,182.2066837328819,1.159879474112285,-2.933263526320718,7334300,5.307932770036188,0.8155678801273231,-472032900.0,-22.636076217437758,91.40936679472856,92.55270083870475,-7.690298399635847,21.169268579412908,22.730704806211776,0.030114942283518183,10.124818089653836,185.6108773803711,181.53455764770507,178.23999786376953,174.945438079834,170.86911834716796,0.06,0.0,298.19435605121424,-0.017235880920777658,-0.026041399328053494,182.66428702218192,179.04785810198103,9.953836936581093
2022-07-06,1,184.07500076293945,168.40749740600586,201.45000076293945,175.4337501525879,187.32625102996826,0.7372046169070408,9.452161238160542,-0.6694250265687556,2.9944045890387567,179.30500030517578,7.948249816894531,0.05183526854064687,173.7857521057129,197.18324851989746,0.756421556169009,-0.09733493842871813,1.0094598320694328,1.0211922002815035,1.0262564434366888,-0.005497240693533856,43.76911950164464,201.25432285779084,182.35000038146973,163.4456779051486,181.38178634643555,4.740802216083467,179.38500050136022,4.970318090042773,179.86231787738396,181.372264044646,-0.011098417327163265,3.7348312791620013,5753400,5.368996754566977,0.6384193423284319,-466279500.0,-34.38952268415464,91.40936679472856,92.55270083870475,20.05660137354242,20.553931385201718,21.834883014927502,0.053882981471939664,9.787324827164197,186.6138773803711,183.15805764770508,180.36499786376953,177.57193807983398,174.11611834716797,0.06,0.0,297.7362426678214,0.02483291371664831,-0.026858421526106412,181.6942858014788,180.22785840715682,9.355264336619259
2022-07-07,1,186.81250381469727,168.40749740600586,201.45000076293945,175.4337501525879,185.53062438964844,0.8459466588048339,8.600893760025178,-0.15647583404981003,2.994624211017756,179.30500030517578,7.015549926757814,0.04736885759354663,173.7857521057129,196.55925025939942,0.7287168414721292,-0.06332688614815525,1.0288575974534973,1.030750807194142,1.0427015925966028,0.04703789786878332,49.619894791747186,198.7745379930728,181.57275047302247,164.37096295297212,181.10214396885462,4.26635713777013,180.19750077383858,5.199819941210978,180.9111550240641,181.07580207971736,-1.48251247807894,9.30332888871422,6334500,5.452657032282609,0.6971181491180236,-459945000.0,-13.080328009558418,91.40936679472856,92.55270083870475,68.38158475328963,22.503144580088968,20.741043299233556,0.05988904845021655,9.567512870574479,186.9135983886719,183.64319927978516,181.0,178.35680072021484,175.0864016113281,0.06,0.0,297.2534493378907,0.0611684437361244,0.05384185879911311,181.71285792759485,180.88214438302177,8.685220091144942
2022-07-08,1,186.41500091552734,168.40749740600586,201.45000076293945,175.4337501525879,185.52250003814697,0.9225049534582984,7.9963442517386945,0.40660156845852136,2.994769544135947,179.30500030517578,6.4331001281738285,0.0441573810622612,173.7857521057129,189.58425025939943,0.6075898834253991,-0.0726606944294191,1.0294201915280052,1.022269870921426,1.0308255035152283,0.06266300085182519,51.48046606953919,197.08006414434655,181.08737564086914,165.09468713739173,181.29107284545898,4.495636364700345,181.09892926897322,5.097397126746123,182.3763423503762,181.33038131107386,-1.0369744336067777,6.483792698081804,5835700,5.3555762961484605,0.6472406842071698,-465780700.0,-23.303583227861594,91.40936679472856,92.55270083870475,75.68271744835155,21.278210033898908,20.182214345882116,0.0635928733615985,9.395545370035288,186.9135983886719,183.64319927978516,181.0,178.35680072021484,175.0864016113281,0.06,0.0,296.8079251962222,0.0692514493537677,0.04832919425706253,182.76714215959822,181.85571507045202,7.2290450104753985
2022-07-11,1,180.98749923706055,168.40749740600586,196.9124984741211,175.4337501525879,185.4231243133545,0.5363512553963967,6.638053012860446,-0.0673492475589561,2.9950588284523874,179.30500030517578,5.531000137329102,0.036809437896641775,173.7857521057129,187.0375011444092,0.5191290799087452,-0.0533104685580604,1.0036147798651422,0.9891405535237457,0.9887919939938198,0.01848592998680121,52.450884609243026,193.6117316742194,180.33562564849854,167.05951962277766,181.65785816737585,4.323807478701033,181.48857225690568,4.841222801947098,183.33542099615943,181.4777113376243,0.7145087699136916,7.261427997263436,6038800,5.281584767918465,0.6731644402679147,-471819500.0,-66.33930651509598,91.40936679472856,92.55270083870475,2.528180518860662,19.65454957100241,23.07384870716711,0.07078116769120829,9.44514969550457,186.9135983886719,183.64319927978516,181.0,178.35680072021484,175.0864016113281,0.06,0.0,296.32242681031494,-0.014504032534672695,0.014124785781848262,182.62142726353235,181.98642948695593,6.665399571583042
2022-07-12,1,176.24499893188477,168.40749740600586,188.77000045776367,175.4337501525879,184.3293752670288,0.003784242810761494,5.450811418928815,-0.9529544278502593,2.9952712811807944,179.30500030517578,4.707624816894532,0.030359977570837998,173.7857521057129,186.81575355529785,0.6732731216487967,-0.01138894631821004,0.9816509512625771,0.9663150721791826,0.9594384106770456,-0.021893555274379528,49.56696447231575,190.44099852450316,179.5393756866455,168.63775284878787,181.77535792759485,4.133089735314375,181.63232203892298,4.634667909785337,182.69457308205537,181.00476013728127,1.4390187338151443,3.107687699809394,6845300,4.433668764130824,0.7904731660844713,-478664800.0,-80.68181818181817,91.40936679472856,92.55270083870475,-48.11348752020728,18.686624339304682,24.624431699766347,0.0590991517511985,9.224779078295729,187.00799694824218,183.7959969482422,181.1999969482422,178.60399694824218,175.3919969482422,0.02,1.0,295.75888991596184,-0.061491325771033445,-0.030564046086546632,182.5614275251116,182.2392861502511,6.728137875144158
2022-07-13,1,173.9849967956543,168.40749740600586,188.77000045776367,175.4337501525879,184.3293752670288,0.16768136322532384,5.432614923716656,-0.9091338716849742,2.9952733667940654,178.06125259399414,4.661549816131592,0.030316269756120694,173.7857521057129,186.81575355529785,0.7057810901689241,0.014637070166732371,0.9709092528071757,0.9605200291831014,0.951221091040579,-0.054814634933939455,46.278557355251095,190.06323037386153,179.19800052642822,168.3327706789949,181.2442855834961,4.909546833935859,181.51232174464636,4.819136271476303,181.05239386866515,180.23490769616475,0.4688670601955084,1.1550640238358778,12734400,4.026713176449298,1.4495040038245488,-491399200.0,-69.5111083984375,91.40936679472856,92.55270083870475,-62.23505018090539,17.317626531036925,25.69521985328704,0.14046299693291656,9.24300905599087,186.88999694824219,183.6049969482422,180.9499969482422,178.2949969482422,175.0099969482422,0.04,0.0,294.71808753832073,-0.04074758285059987,-0.05013991327412823,182.07714189801897,182.07285744803292,6.3709647345057885
2022-07-14,1,174.92000198364258,168.40749740600586,188.77000045776367,175.4337501525879,184.3293752670288,0.16879738803796315,5.418657698804976,-0.8993751909637591,2.995275796899145,178.06125259399414,4.648837604522706,0.030235999336409587,173.96599731445312,186.81575355529785,0.6342638961927517,0.0331190681861503,0.9760500400437887,0.9716401371428433,0.9670018743133285,-0.0636600954872436,45.012419416697874,190.0494406036036,179.21212520599366,168.3748098083837,180.4914289202009,5.470213138192248,181.13446480887276,5.126677891676846,179.269705711254,179.4630555914085,-2.0919831412934733,-0.9563681502389406,9039500,3.8651439709737003,1.0438752084401517,-482359700.0,-77.42221408420139,91.40936679472856,92.55270083870475,-79.17910804018594,16.533324650260354,24.53150326534802,0.15532337332499752,8.989933964835027,186.88999694824219,183.6049969482422,180.9499969482422,178.2949969482422,175.0099969482422,0.04,0.0,293.9874310252032,-0.07655732639127122,-0.050418335881715286,180.4914267403739,181.5778568812779,5.821699354073199
2022-07-15,1,182.11750030517578,173.79500198364258,188.77000045776367,175.4337501525879,184.3293752670288,0.5176232364641924,4.933552113853963,-1.2274962062441181,2.995356427850613,178.06125259399414,4.355774898529051,0.02747919087714944,174.20775146484374,186.81575355529785,0.7174667414155316,-0.002949757129219362,1.01436884367801,1.0135911674672298,1.0202060984707053,-0.023053405515894854,43.66233355380881,189.4048546625834,179.53775043487548,169.67064620716755,180.2117859976632,5.30399394342908,180.7967861720494,4.870922336260968,178.17304414762495,179.0033232394506,-2.924688763655527,-2.935462586818179,16319100,3.531243355856187,1.8427761055996044,-466040600.0,-13.733317057291666,91.40936679472856,92.55270083870475,66.20377990715245,23.585983628714217,21.797238857375763,0.2068223931475687,9.394943100775324,186.88999694824219,183.6049969482422,180.9499969482422,178.2949969482422,175.0099969482422,0.04,0.0,292.79491230258793,0.011391619058095825,-0.000845372528649983,181.21285574776786,181.45357077462333,6.158299869665164
2022-07-18,1,193.2224998474121,173.79500198364258,188.77000045776367,175.50499820709229,184.3293752670288,0.36923812093850805,4.870373008112513,-1.284425403403097,2.9953668395405266,179.30500030517578,4.279749870300293,0.02707692006067803,174.20775146484374,186.81575355529785,0.6542927055191308,0.04788686801428564,1.0742237141956266,1.0714048038867832,1.087652196975403,0.06760135734195627,55.261265757273236,189.6124964663593,179.87175045013427,170.13100443390925,181.12749971662248,6.935819927327742,181.11482184273856,5.53205107284303,179.13680726921282,179.34318940724725,-1.063425478555143,-2.5301725412194322,16322800,3.855267878582885,1.7623807061054073,-449717800.0,-29.195861340024052,91.40936679472856,92.55270083870475,174.32441065339057,29.584278494260968,20.06256723207057,0.14025608950521287,9.478162069586785,192.5970778808594,188.2214577026367,184.68499755859375,181.1485374145508,176.7729172363281,0.02,1.0,291.7263893248125,0.07657608047527154,0.02107178592060467,181.44856916155135,181.58071354457311,6.323842539605759
2022-07-19,1,196.25500106811523,173.9849967956543,193.2224998474121,175.63187503814697,185.4231243133545,0.5212561655087181,5.4628514470219,-0.7704600901893901,2.9952782651666054,180.19999885559082,4.674937725067139,0.030207681031009147,174.85125198364258,187.0375011444092,0.5075872052239675,0.10077907340707035,1.0852223477974832,1.0789347869201213,1.0897122762811944,0.11353514855740077,65.98730679102752,191.76882823736656,180.84312534332275,169.91742244927894,182.53321402413505,8.903978395418498,181.912143434797,6.8069515768903885,182.66212702826272,181.2244559007,3.43124571526167,2.358690140833401,28178700,4.529877361714563,2.799935016253389,-421539100.0,-1.0535986764054326,91.40936679472856,92.55270083870475,188.64600812103953,28.330788373009124,18.072222499366287,0.28087684837089016,9.770439317651531,194.35428021240233,189.64285958862305,185.83499908447266,182.02713858032226,177.31571795654298,0.04,0.0,290.00542531992403,0.15580400349696988,0.13696858602974973,183.5414276123047,183.15428488595145,7.599512487851678
2022-07-20,1,210.42000198364258,173.9849967956543,196.25500106811523,176.0999994277954,186.51437664031982,0.6202431874839043,6.263812557105758,-0.47882722456266213,2.9951431729602422,180.5987491607666,5.269175243377686,0.03443940163034477,174.85125198364258,189.21525039672852,0.567362470115174,0.12639719245115466,1.1569214265761845,1.1466811344945214,1.142965790242491,0.20941463838276397,68.80332460921768,194.40687564063975,181.87925052642822,169.3516254122167,186.73785727364677,13.706540543978631,184.1978577205113,10.113622789222974,186.08491521945103,183.39993672679506,5.278545237379699,6.03076967593833,53920300,4.5208672694366685,4.437450159202514,-367618800.0,-1.1212158480925871,91.40936679472856,92.55270083870475,280.9489516101169,35.4341188639117,15.953313710903803,0.4780601557132605,10.277554614180485,205.81428021240234,198.91285958862304,193.33499908447266,187.75713858032228,180.85571795654297,0.06,0.0,287.3478133551041,0.22587225551800194,0.24069937648449563,189.12714276994978,185.87428501674108,10.2271493645067
2022-07-21,0,218.50000381469727,173.9849967956543,210.42000198364258,177.33812713623047,186.82062816619873,1.4692776786487125,8.588748243092542,2.272394964752034,2.994662242486893,181.55249977111816,6.4709879112243645,0.046757104412307966,175.37225074768065,193.52574996948243,0.528447598355334,0.1978481819769437,1.1895129771291177,1.1738602716346114,1.1416658531149317,0.2491424727695235,76.67558812020137,200.8661220126133,183.6886255264282,166.51112904024313,192.77428654262,17.17983338385469,187.27482223510742,13.291964439273574,192.2077485146187,187.3597902998936,16.26217438809452,17.935208857880035,23430100,5.374762528329749,1.8415438091813496,-344188700.0,-0.8055700436112981,91.40936679472856,92.55270083870475,271.1401746103375,37.35135215075796,14.556566989636442,0.5245528608405227,10.459159765184099,211.42968487548828,203.4551633605957,197.01000213623047,190.56484091186525,182.59031939697266,0.08,0.0,286.374070547852,0.2809246277974664,0.2680109196791022,196.1885724748884,189.375,13.291985103798412
2022-07-22,0,222.65250396728516,173.9849967956543,218.50000381469727,178.24062728881836,187.32625102996826,1.5755446813972622,11.249541236042083,1.9445546557224231,2.9939531173735685,183.09625053405762,8.059700775146485,0.06053661138766257,175.37225074768065,197.671501159668,0.6531133890934505,0.21247436282531879,1.1981491355375231,1.1761466687954591,1.1126894769457834,0.2225761038570404,79.48736394786346,208.3294581434709,185.83037567138672,163.33129319930254,199.72678756713867,18.130037802822564,190.48553657531738,15.962508005150594,198.81021830873928,191.89304502032167,23.97515114692317,24.55642979347869,17805500,5.524646042891896,1.3554281068539118,-326383200.0,-14.937137124180392,91.40936679472856,92.55270083870475,222.32094834880894,38.001527543173346,13.47531484310544,0.43988346567085385,10.491363128897813,215.27260394287106,206.56370260620116,199.5250015258789,192.48630044555662,183.7773991088867,0.1,0.0,285.6835373428515,0.16567078277159997,0.26124272789225994,202.45714460100447,192.26714324951172,15.130526143065058
2022-07-25,0,220.3499984741211,173.9849967956543,222.65250396728516,178.24062728881836,189.88312530517578,1.3704670406901038,13.720888726049633,0.8343695120926506,2.993148195007608,184.58374977111816,10.210500564575193,0.0730018949426818,175.37225074768065,211.22800216674807,0.7562431474065233,0.1916428189817391,1.1723706649328085,1.1421211139135443,1.0583064992715745,0.14039513332107578,80.4105350977084,215.3942783676266,187.95250091552734,160.51072346342806,206.21678706577845,15.744253909879667,193.35410799298967,17.50408251005887,204.78016749024417,196.2066567958975,27.97224362327686,25.295085861142898,10935200,5.442590329125669,0.8371765426427806,-337318400.0,-18.172690583269368,91.40936679472856,92.55270083870475,160.18904863575835,35.6785376999496,14.090314363972906,0.3767960996465134,10.376264263986352,215.27260394287106,206.56370260620116,199.5250015258789,192.48630044555662,183.7773991088867,0.1,0.0,285.2488635777431,0.14451077206420337,0.15546504046108622,208.70428684779577,194.59785679408483,16.489889134124734
2022-07-26,1,215.4000015258789,173.9849967956543,222.65250396728516,178.24062728881836,193.9806251525879,1.1012300568925883,15.423193247654964,-0.17418654051794435,2.992513905754511,184.58374977111816,12.3633504486084,0.08133405150016781,175.37225074768065,218.68500328063965,0.8343157234331441,0.16729352089726401,1.1359097001462917,1.0941410915820031,1.008259393447864,0.09755165653648201,76.81247273393814,220.47413727350815,189.62775077819825,158.78136428288835,210.9714300973075,11.779916383561009,195.59160804748535,18.214401864181998,208.6495785669896,199.2271348890392,25.971870555276375,22.28758541177952,9508500,5.522221356545281,0.724775768090048,-346826900.0,-25.884325350587584,91.40936679472856,92.55270083870475,112.24044338145806,33.740037942982845,16.62676518904886,0.3461902377699323,10.188672813126342,215.27260394287106,206.56370260620116,199.5250015258789,192.48630044555662,183.7773991088867,0.1,0.0,284.8466465389901,0.06090362784266157,0.1204169584834175,212.2471444266183,196.73000008719305,17.284825041034214
2022-07-27,0,221.39749908447266,173.9849967956543,222.65250396728516,178.24062728881836,199.79625129699707,0.8640843712865882,16.409620843022125,-0.8105887641396747,2.992122180111293,184.58374977111816,14.008525485992433,0.08593257866042231,175.37225074768065,218.68500328063965,0.8816602597513861,0.16374246901664288,1.1593965629856309,1.1026746537985401,1.0180856971874674,0.05216945631282455,71.07354903000333,223.77849251764826,190.959250831604,158.14000914555976,214.99642998831612,9.245472772058713,198.06196485246932,19.24812023025108,210.29828602174183,200.81622817956088,18.275289944640885,17.017520376534605,10508400,5.593826085495866,0.7909747406547648,-336318500.0,-4.358768993224439,91.40936679472856,92.55270083870475,126.52312608703849,36.27571917368966,15.050698304751622,0.4013103410359731,10.451625898294383,215.27260394287106,206.56370260620116,199.5250015258789,192.48630044555662,183.7773991088867,0.1,0.0,284.4581008668477,0.047634436528824375,0.12458460798920903,217.36571611676897,199.40714263916013,18.685221854168493
2022-07-28,1,224.59750366210938,173.9849967956543,222.65250396728516,178.24062728881836,211.66500186920166,0.6469163240488266,17.62339162723367,-1.2402411746562574,2.991626203573812,185.2450008392334,15.600150299072265,0.09141972382142714,175.37225074768065,220.45474853515626,0.8664091546495472,0.24087824584135037,1.1650789013870995,1.0928069167019414,1.0224779307017646,0.027906177304157787,76.36541185474624,228.02128410133014,192.7745008468628,157.52771759239545,219.0453589303153,4.8141333479389745,200.78928647722518,20.154630708060935,213.0460229843336,203.0428391375831,14.581634778201481,18.513212212005293,8972700,5.316831154044911,0.6673298291086167,-327345800.0,-5.582567175113734,91.40936679472856,92.55270083870475,114.20255620358687,34.37826138416862,14.17143858486355,0.4097694419125752,10.30722385434537,215.27260394287106,206.56370260620116,199.5250015258789,192.48630044555662,183.7773991088867,0.1,0.0,284.13851152096447,0.009558689221793815,0.04426169711233567,220.8500017438616,202.19571467808314,19.57605568875141
2022-07-29,1,225.3349952697754,173.9849967956543,224.59750366210938,179.56812477111816,216.1750020980835,0.4504885950897864,18.589933346355437,-1.4836628944863002,2.9912469510704556,186.6137523651123,16.89055061340332,0.09529224752062411,175.37225074768065,221.52299957275392,0.8630434986900788,0.2803232360766839,1.1550702062369593,1.0705195289573346,1.0201716044264681,0.012047882932789244,78.83656791265835,232.26324262349698,195.08337593078613,157.9035092380753,221.17607225690568,3.47463300735491,203.95696476527624,20.28758856775731,215.9444099890992,205.2746676167432,14.44167151906471,20.48252692061202,9064900,5.172302105459945,0.6712659816197719,-318280900.0,-9.582319100878664,91.40936679472856,92.55270083870475,104.67933751808094,34.223288746533605,13.340126726052699,0.3945604684823371,10.167421902453563,216.34219927978515,207.4288988342285,200.2249984741211,193.02109811401368,184.10779766845704,0.12000000000000001,0.0,283.8267027432813,0.020232223760130008,0.004555962977604031,222.0585719517299,205.59285736083984,19.849452363734965
2022-08-01,1,224.6750030517578,173.9849967956543,225.3349952697754,180.78812408447266,218.96250247955322,0.2721909315773378,19.125585003533672,-1.63391479566184,2.9910785747806212,190.0175018310547,17.80205024719238,0.09679968488190634,176.11249923706055,222.84700393676758,0.8772246482944956,0.2680462638765172,1.1371400923021817,1.045909708174444,1.0147189157708827,0.019627885670916667,78.91320605664046,235.83017067082466,197.5790006637573,159.32783065668997,222.0582150050572,3.465842630053283,207.41625077383858,19.303989370618464,218.32699646358134,207.3151662697915,7.088201285775227,24.503071327941676,5525000,5.188581848719782,0.40864311624953636,-323805900.0,-7.436516067466589,91.40936679472856,92.55270083870475,89.80556029529029,32.411168477251955,13.636874569513278,0.38421981785158926,9.969033678833007,216.34219927978515,207.4288988342285,200.2249984741211,193.02109811401368,184.10779766845704,0.12000000000000001,0.0,283.63563124677506,0.035238718596875884,0.026174941973132238,222.3914293561663,209.29000091552734,20.19414007172574
2022-08-02,1,223.31499862670898,173.9849967956543,225.3349952697754,181.83500003814697,220.61187362670898,0.08471648482203581,19.422354957121723,-1.7098824477141994,2.9910168937997246,194.73875045776367,18.397887992858887,0.09714692951202171,176.11249923706055,224.60525360107422,0.8921623824720408,0.2468783215721439,1.1169791963158056,1.0245769426359055,1.004651761083929,0.03674557588096916,77.5065045207978,238.77233557037138,199.92762565612793,161.08291574188448,222.15285709926061,3.49370902806811,210.93982233319963,17.10977166221901,219.9476507012859,208.99150817158917,2.8260865580109384,27.47879622876011,6361300,5.236582540078379,0.4721970975463017,-330167200.0,-15.832348533260696,91.40936679472856,92.55270083870475,75.19072268995389,30.67836852271114,12.99544652309504,0.33842419007257657,9.779815622516724,216.84252172851564,208.23874279785156,201.28500366210938,194.3312645263672,185.72748559570311,0.12000000000000001,0.0,283.4108193422353,0.03510819680363664,0.013317485402336442,222.53142874581474,212.4942866734096,20.31967662307367
2022-08-03,1,225.5099983215332,173.9849967956543,225.3349952697754,183.58562564849854,221.71125030517578,-0.11134966118599021,19.50508197120847,-1.7049462346401634,2.9910479727057746,203.3375015258789,18.580375289916994,0.09651973423351654,176.11249923706055,224.60525360107422,0.9088572349616122,0.21317396550933426,1.115922770133664,1.0219598206538363,1.007352671188834,0.018575183794155903,74.57566521228999,241.09403959854487,202.08387565612793,163.073711713711,222.88999993460519,3.592873911948729,214.55339350019182,13.971751006789443,220.80916378692572,210.4295188457096,0.29754646708180293,28.35302051302324,6400700,5.285944838328764,0.47398302882020016,-323766500.0,-7.154305210527339,91.40936679472856,92.55270083870475,75.66156537222737,29.146936561471527,12.346727470733608,0.3456193924679071,9.558399920338916,217.4891594238281,209.2854190673828,202.65499877929688,196.02457849121095,187.8208381347656,0.12000000000000001,0.0,283.19473700383173,-8.822170875844026e-05,0.059931708877346626,223.7057146344866,216.2050007411412,20.446300146151138
2022-08-04,1,228.6775016784668,173.9849967956543,225.5099983215332,185.34062576293945,222.8181276321411,-0.30271521263177803,19.681952584986707,-1.624720466387727,2.991029598318473,212.91000175476074,18.644062690734863,0.09640661399116493,176.11249923706055,224.74100227355956,0.9118408417910164,0.20714616910879097,1.1201136440901964,1.0292755814737276,1.0177625353364992,0.018165820856564263,75.50578718569383,243.51953070403104,204.1556255340576,164.79172036408417,224.78678567068917,2.2234726988492306,217.87910788399833,10.8496215415751,221.9680711180348,212.14279515513968,2.341729014360816,28.92179039800233,7142700,5.283701248681386,0.5273513638028186,-316623800.0,-4.946194178950283,91.40936679472856,92.55270083870475,80.08992500956828,30.612433086888558,11.686497984097736,0.337897256283541,9.377085285980513,221.76388415527344,215.38806219482422,210.23500061035156,205.0819390258789,198.7061170654297,0.14,0.0,282.96908565007385,0.01721086326924892,0.013936069072147063,225.9914289202009,219.11928667340956,20.784695335223716
2022-08-05,1,225.89249801635742,173.9849967956543,228.6775016784668,185.34062576293945,223.63562488555908,-0.4808802584267578,19.95055110456328,-1.476086828996815,2.990969518765629,216.9500026702881,18.584350433349606,0.0967304721697782,176.11249923706055,225.35249557495118,0.9048080567204018,0.22671190920998044,1.095242325798962,1.0121039721391718,1.0017294647632047,0.0024741063673423547,77.53819081343086,246.14997763637268,206.2488754272461,166.34777321811953,225.42892837524414,1.658909808274238,220.21267918178015,8.36804393216454,223.58990886973112,213.9362008471391,6.164113304796187,25.565912828404763,5539700,5.257159876530996,0.4094479692054801,-322163500.0,-12.11359495841659,91.40936679472856,92.55270083870475,64.72625710429165,28.941043348695988,12.739127004081393,0.3417213403198752,9.210150669215087,221.76388415527344,215.38806219482422,210.23500061035156,205.0819390258789,198.7061170654297,0.14,0.0,282.7859651235779,0.008359292724915646,0.003362509921554361,225.99571446010046,221.68071528843467,20.63707855217413
2022-08-08,1,232.33750534057617,173.9849967956543,228.6775016784668,190.44624996185303,224.61687850952148,-0.6896959844920825,19.84320472973728,-1.2297716522186046,2.991078783107287,219.42500114440918,17.982675380706787,0.09529796673435466,176.11249923706055,225.54824829101562,0.8951499141289689,0.2481110516946783,1.1158122972902635,1.0394716487864006,1.0298009228302776,0.034104827794541936,74.73141342281852,247.90915974176215,208.2227502822876,168.53634082281303,226.53464290073939,3.0273978612277244,222.79000091552734,5.4797453377934335,224.10910507143998,215.18681614558443,2.0302844207692385,16.907967858166014,10982100,5.085025411768797,0.7971418710161869,-311181400.0,-20.23411633350178,91.40936679472856,92.55270083870475,90.06527516703663,35.475325364642735,11.274821982228438,0.3515092022063582,9.662998688240437,232.08104656982422,225.96948648071287,221.0300064086914,216.0905263366699,209.97896624755856,0.16,0.0,282.4762726895784,0.03218247894977244,0.038194805823931886,227.06285749162947,223.95642961774553,19.860156096187435
2022-08-09,1,229.60249710083008,173.9849967956543,232.33750534057617,195.49687576293945,224.8400011062622,-0.8959974463765182,19.47174470175762,-0.79657019213884,2.9913333453316815,220.87374877929688,16.836675319671627,0.09237497772069961,176.11249923706055,226.17099838256837,0.850050510430476,0.31826438621597464,1.0892462837391093,1.0217554405687572,1.010812390680957,0.028155289670584116,80.58005284595586,249.73373999097862,210.7902505874634,171.84676118394816,227.1442860194615,3.1717962495011442,224.1601791381836,4.4503129553399186,226.10046751246202,217.4290455406582,3.446165497062277,18.385520917216066,6181200,4.871344941732988,0.44974984792966055,-317362600.0,-39.461594297642506,91.40936679472856,92.55270083870475,67.35839420652046,33.14299194524857,11.842516567544294,0.37822057287326727,9.604213724787298,234.77144512939452,230.32428414916993,226.7300033569336,223.13572256469726,218.68856158447267,0.16,0.0,282.28581885496016,0.0384789284749254,0.01648908366930527,227.7828587123326,224.92071533203125,18.116893686560694
2022-08-10,0,240.56000137329102,173.9849967956543,232.33750534057617,206.87875175476074,225.37874603271484,-1.1475981532260116,18.1674873207586,-0.14429131219583047,2.9919786330005773,222.0250015258789,14.982875099182127,0.08511031041124104,181.39775047302246,228.77000122070314,0.8153648234900962,0.3196683698566184,1.1269657728625542,1.063794039627207,1.0532214903279526,0.0667376309865404,76.37366818107343,249.79310013742784,213.45812549591065,177.12315085439346,229.41357149396623,5.747437295828679,225.73589324951172,5.946072041580555,226.93073852813438,219.34747763502608,1.8938477913497422,9.116288820622048,9254800,4.899170046546685,0.6820215097504285,-308107800.0,-1.3069688618610904,91.40936679472856,92.55270083870475,127.23774559465873,38.52189877364893,10.602680273709765,0.39249100528326303,9.961055912637118,236.7755947265625,231.9721956176758,228.08999633789062,224.20779705810548,219.40439794921875,0.18,0.0,282.0710916941204,0.07665507524508608,0.10247494638715329,230.34000069754464,226.36571502685547,16.84152736767249
2022-08-11,0,245.12749481201172,174.92000198364258,240.56000137329102,214.15500164031982,225.60562324523926,-1.2141983789829316,16.66721952810186,0.5369077703495342,2.99267343244043,222.98375129699707,12.83862476348877,0.07688297306918447,192.11199989318848,229.8759979248047,0.724975514157575,0.3752572527170831,1.1307303266974391,1.0748836914214694,1.059259569725742,0.07193533693871879,81.48978036872529,250.12131478099622,216.78687572479248,183.45243666858875,232.52964237758093,7.527324929693184,227.34124973842077,7.795815419480465,230.32577046691216,222.77065222925268,7.070211686109921,10.096108546204931,8780100,5.187357179710113,0.6476580935316807,-299327700.0,-22.311153382142635,91.40936679472856,92.55270083870475,155.3981699599027,40.803675684624906,9.834839938323217,0.3668201850918276,9.971694846332216,242.18471612548828,236.34763674926756,231.62999725341797,226.91235775756837,221.07527838134766,0.19999999999999998,0.0,281.88710541251095,0.055630434006385565,0.0704362083607776,233.3800005231585,227.9557146344866,14.254513187209351
2022-08-12,0,246.81999969482422,182.11750030517578,245.12749481201172,217.72500324249268,226.58874893188477,-0.9797511715346024,14.764526925855083,0.7792071573730124,2.9934303569926013,223.95625114440918,10.586849365234377,0.0670209314973804,195.9517509460449,233.15975494384767,0.6810277892134676,0.3459853907573384,1.120395280851319,1.0726489103576407,1.0516224708606141,0.09264363297691891,82.55414093589386,249.8263042179211,220.29725036621093,190.76819651450077,235.57392828805106,8.465901175019278,229.23196411132812,9.074768437709357,234.05789841814897,226.45960505592086,9.767591213953468,10.094200803611383,6098500,5.120293631332253,0.4674734739369262,-293229200.0,-5.80288222450116,91.40936679472856,92.55270083870475,174.0300359903266,38.79553797410775,9.35082195156893,0.342045496992437,9.73871657933961,242.18471612548828,236.34763674926756,231.62999725341797,226.91235775756837,221.07527838134766,0.19999999999999998,0.0,281.7680516682669,0.09930330890590344,0.08433734539948626,236.60428728376115,230.1550009591239,13.338400748974728
2022-08-15,0,249.18000030517578,193.2224998474121,246.81999969482422,219.88749980926514,228.90875053405762,-0.5060055722432412,13.031245820618924,0.5303896430295487,2.9940127554431206,224.6362533569336,9.027886962890625,0.058296905766106764,209.00350189208984,241.0167507171631,0.6985459185499076,0.2773874672449538,1.114737853659747,1.0728875046926376,1.0430764041756946,0.07249150299651674,82.15090700913962,249.59486697693123,223.53237533569336,197.4698836944555,238.5028566632952,9.197309769653543,231.6448211669922,9.59031217589861,237.3068390345137,229.78558770809656,9.449692488980961,12.012707694124119,6527400,4.787269272706006,0.51986756812938,-286701800.0,-7.698488641768115,91.40936679472856,92.55270083870475,171.6603937683887,39.43784648588499,9.03123989235741,0.39820980097259767,9.363093937973513,243.16124462890627,237.6993840942383,233.28500366210938,228.87062322998048,223.4087626953125,0.2,0.0,281.6490887999944,0.06689791746844076,0.09846548174994184,239.3471439906529,232.66928645542689,11.845184703179498
2022-08-16,0,246.54249954223633,196.25500106811523,249.18000030517578,221.13562393188477,230.2862491607666,-0.08580503990639772,12.20413326364072,0.42277365142113377,2.994273771761575,225.0049991607666,8.799324779510496,0.05392179456482446,214.90200157165526,245.29674530029297,0.66267812202851,0.2696746526153063,1.0893042319868067,1.0504479613600715,1.0176856942134322,0.07377969601945145,82.82643349746482,250.73851688586296,226.33025035858154,201.9219838313001,241.4528568812779,7.662030251045424,233.44089262826103,9.873952262232567,240.30882861886292,232.90760719861947,8.9656824463373,15.682450575673942,5136800,4.788060112462659,0.4504465399456935,-291838600.0,-19.492579282421683,91.40936679472856,92.55270083870475,128.2328499067111,37.804180286146476,11.397718186249827,0.31277461724439576,9.07001481793295,244.36248376464846,239.64376269531252,235.8300018310547,232.0162409667969,227.29751989746094,0.2,0.0,281.5468177293679,0.0684961286978043,0.05225061741925112,242.04857308523995,234.0221437726702,10.8113239925126
2022-08-17,0,241.03249740600586,210.42000198364258,249.18000030517578,222.33875274658203,234.39312934875488,0.5571051490197352,10.854469462791032,-0.7170158475315369,2.9946163601767575,225.4224967956543,8.825762119293216,0.047431611948070336,218.19000358581542,246.57024955749512,0.7788991973288806,0.17166855440578221,1.0532582843432923,1.0169074899015937,0.9812189013639536,0.0019641504407112986,75.676305229901,250.55356420786967,228.8446252822876,207.13568635670555,242.69499860491072,6.564131084339626,234.61482075282507,9.717421175437213,241.90641401304043,235.13268292100693,9.141517185038872,11.357400405037897,5627200,4.108031230082627,0.6259998175576307,-297465800.0,-34.84413816781722,91.40936679472856,92.55270083870475,75.72960666319025,35.3656824541037,15.795820308527379,0.11806038877716866,9.002871125786543,244.6480453491211,240.1059852600098,236.43500518798828,232.7640251159668,228.2219650268555,0.02,1.0,281.41853017116716,-0.012125708518562206,0.04875181062909967,243.14285714285714,235.10285731724335,10.612853068149832
2022-08-18,0,243.2224998474121,215.4000015258789,249.18000030517578,223.14937496185303,240.67812538146973,0.5739042005578494,10.292257735261943,-1.0655469479682516,2.99474220133326,225.7012481689453,8.897324810028072,0.04467605670694219,220.1649990081787,246.57024955749512,0.8562761200746851,0.1031235386632655,1.0557666233288,1.0194706340593858,0.9897534247650488,-0.007771445492316342,63.94195424664236,250.95976552392966,230.37525005340575,209.79073458288184,244.64071328299386,3.185669056396458,235.89249965122767,9.578381335737587,241.70119864255486,236.11503312325857,3.742397101442565,7.317531796177814,5280400,4.152804705727639,0.6533810215853064,-292185400.0,-21.922234620430956,91.40936679472856,92.55270083870475,83.49089650779626,35.11910730429611,14.880394439818497,0.017090345618989193,8.874094175575078,244.6480453491211,240.1059852600098,236.43500518798828,232.7640251159668,228.2219650268555,0.02,0.0,281.3067554611895,0.010177178622832406,0.0043422946865897495,245.31857081821985,236.55071476527624,10.919391505744123
2022-08-19,0,240.2699966430664,215.4000015258789,249.18000030517578,224.27687740325928,241.57999801635742,0.3888173657892876,10.27638469822058,-1.294696136550683,2.9947530835501204,227.2849998474121,9.193149948120118,0.044369084655933914,221.2927490234375,246.57024955749512,0.8681338510277956,0.09238609723045985,1.0373842683393424,1.0009925657745093,0.979256956713076,-0.026537570131498378,65.05689623557343,252.1641442514827,231.6113748550415,211.0586054586003,244.59928403581893,3.2488424502733544,237.00642776489258,9.066627756300518,242.08169998627005,236.8038125536748,5.931992429769089,7.938183128733047,7504700,4.10182778892636,0.9918173450083029,-299690100.0,-34.811962772675585,91.40936679472856,92.55270083870475,51.45672018904651,32.44972457641231,16.632739463030994,0.11460471475336768,8.91808791193583,244.6480453491211,240.1059852600098,236.43500518798828,232.7640251159668,228.2219650268555,0.04,0.0,281.13395454340827,-0.032651421139206716,-0.006345254658001736,244.8971426827567,237.61857169015067,10.735072905910865
2022-08-22,0,229.28999710083008,215.4000015258789,249.18000030517578,224.6556282043457,241.57999801635742,0.1995452480306724,10.225637414342328,-1.3776842138094272,2.9947673609617427,229.13999938964844,9.28169937133789,0.04398270237749835,221.2927490234375,246.57024955749512,0.8677150582307355,0.0904016260807227,0.986226412299588,0.9495609087452695,0.939522507837058,-0.07982182831682327,60.92859968006301,252.9435243175152,232.49224948883057,212.04097466014593,242.33678436279297,6.602938613991304,237.43321337018693,8.495187018967863,241.6235581526101,236.85061203205865,-0.12055401087838875,6.941134251466335,8630100,4.132513926777137,1.1581912563612549,-308320200.0,-86.06697972031581,91.40936679472856,92.55270083870475,-37.106017566167516,28.3918224459513,22.922277580815596,0.12155276254709355,9.464654401229058,245.01148376464846,240.69426269531252,237.2050018310547,233.7157409667969,229.39851989746094,0.06,0.0,280.88027592826154,-0.09060257423997164,-0.09129566581232547,242.58857073102678,237.98428562709265,10.300139278850885
2022-08-23,0,226.3025016784668,215.4000015258789,249.18000030517578,225.169997215271,241.57999801635742,0.17696561977407652,9.874454902605805,-1.292396920920646,2.994835576606362,229.44624710083008,8.924099426269532,0.042390687388172525,223.12324867248535,246.57024955749512,0.8045326967382839,0.06448465866553106,0.9715086755099475,0.9383730549187685,0.9426462677245664,-0.08209537058052796,47.62213376671343,252.68815922537763,232.93924942016602,213.1903396149544,239.40571321759904,8.548426220861037,237.48982075282507,8.411857274389554,238.53774126403252,235.54316892087434,-6.460922600023885,2.6755921057093164,5276900,4.764252329099549,0.7288757393180456,-313597100.0,-94.23074403862066,91.40936679472856,92.55270083870475,-59.06110267027714,27.15586506493886,22.149850860307982,0.11911459520656979,9.188606621183329,245.11768304443362,240.86616152954105,237.43000030517578,233.99383908081057,229.74231756591797,0.08,0.0,280.7206503719345,-0.0860433846700378,-0.09859097386061819,239.0528564453125,237.82857186453683,9.474023093176793
2022-08-24,0,228.3275032043457,221.39749908447266,249.18000030517578,225.46624755859375,241.57999801635742,0.3738474518559691,9.166720162857468,-1.4673125569708803,2.994965051241899,229.44624710083008,8.487999420166016,0.039260529469359665,224.46925315856933,246.57024955749512,0.8179060259475293,0.022154733519020788,0.9779134203901749,0.9480671053649391,0.967393096964605,-0.05271071054065912,42.533175010582866,251.81781475351033,233.48437442779542,215.1509341020805,236.4267850603376,8.200868890809977,237.4648208618164,8.440533167302215,235.48962000542545,234.20646340148576,-8.312737234310786,0.3514271486107852,5426300,4.662883146691673,0.7767753295136118,-308170800.0,-76.85438498770444,91.40936679472856,92.55270083870475,-39.44305282213437,28.267628166426782,20.4135683773911,0.06448217769194242,9.257992213534353,245.11768304443362,240.86616152954105,237.43000030517578,233.99383908081057,229.74231756591797,0.1,0.0,280.56636249045044,-0.04785400612983837,-0.06544833599767476,236.26714215959822,237.80714307512557,9.378642003598213
2022-08-25,0,231.84500122070312,223.31499862670898,249.18000030517578,225.79687309265137,241.57999801635742,0.41910225577710974,8.828008519133576,-1.4631262993641292,2.995023101627113,229.44624710083008,8.210799255371091,0.037753819006833195,224.66725311279296,246.57024955749512,0.8319802670241575,0.01660748441731499,0.9915072232604182,0.9675871240137157,0.9929866329328262,-0.046778150186955414,44.26486048235006,251.48689167205623,233.83087463378905,216.17485759552187,234.3271424429757,6.968154624371186,237.88999966212683,7.948326580124712,233.70777918389388,233.34196796654618,-8.368447337383259,-0.15305330500470962,3766900,4.6311401093446785,0.5601017636908519,-304403900.0,-64.20680144808898,91.40936679472856,92.55270083870475,-17.65190715624103,27.153317487435956,19.57434486735015,0.05923988991642336,8.965278395258204,245.37020477294925,241.2749043273926,237.96500396728516,234.65510360717775,230.5598031616211,0.1,0.0,280.4663640442352,-0.04564180986653721,-0.02973252477884428,234.5942840576172,238.32142857142858,9.178916188247939
2022-08-26,0,229.25249862670898,223.31499862670898,249.18000030517578,226.20000076293945,241.57999801635742,0.3902550887387727,8.587016160887766,-1.4264604839186847,2.9950630354876124,230.7237491607666,7.920899353027346,0.036666369243311944,225.26899604797364,246.57024955749512,0.8291065344103598,0.02889034587430075,0.9789031029062067,0.962100772713482,0.9915465304120057,-0.04585465588832749,48.73411827018376,251.36728183349427,234.19324951171876,217.01921718994325,232.64428547450476,6.484561728473446,237.66964203970772,8.154201685763915,233.22732122326835,233.21089922270303,-5.961446139640239,2.635104422066583,5349800,4.689474979125533,0.8180585140137898,-309753700.0,-99.54922042116155,91.40936679472856,92.55270083870475,-57.50588797141418,24.27859385112232,21.98998166579807,0.04859631640578357,9.310616254498422,245.18376275634768,240.97312106323244,237.56999969482425,234.16687832641605,229.95623663330082,0.12000000000000001,0.0,280.311577647719,-0.07414166781928,-0.08928498410545388,232.0414276123047,237.59214237758093,9.275864365262272
2022-08-29,1,224.4724998474121,223.31499862670898,249.18000030517578,227.82125282287598,241.57999801635742,0.39133923055286923,8.425888500366568,-1.3974022105878852,2.995088944270348,230.7237491607666,7.764199218750003,0.03594829116703108,225.42649879455567,246.57024955749512,0.8073481100194595,0.020373853400579085,0.9576916171101778,0.9490374239984348,0.9802142739671966,-0.02101049899398566,45.849726120261586,251.2409016802986,234.38912467956544,217.53734767883228,229.9657140459333,5.114578698722489,237.30321366446358,8.645092092483305,232.22987807110667,232.73819540218147,-4.887307274360652,-1.327812618692352,7109400,4.730892525449473,1.074114083262198,-316863100.0,-89.99014463548681,91.40936679472856,92.55270083870475,-78.60300584538345,22.711785153578028,21.830637644149412,0.016430402803869332,9.242000082993563,244.79908520507814,240.3504650268555,236.75500488281253,233.15954473876957,228.7109245605469,0.14,0.0,280.09766161857937,-0.008695974310486743,-0.0687924866726032,229.09857177734375,237.20857129778182,9.360257365272941
2022-08-30,1,223.95999908447266,223.31499862670898,249.18000030517578,227.82125282287598,241.57999801635742,0.3884306115523128,8.437669047481783,-1.3969209450588127,2.9950870693815914,230.7237491607666,7.77229934692383,0.03600010694125882,225.4062484741211,246.57024955749512,0.765466348955883,0.005183266810654272,0.9555463567288783,0.9568660438878019,0.9821083940770284,-0.01035120061254291,41.061805619857424,251.2543376143117,234.37899951934816,217.5036614243846,227.63571439470564,2.853114535796495,236.11749921526228,9.279177977992534,230.26476535642018,231.86080259334918,-7.708990743768766,-2.23429506133164,5740400,4.851893887809716,0.8713676254837537,-322603500.0,-94.2556739749765,91.40936679472856,92.55270083870475,-97.39647459947689,20.7988822666313,22.11091780755199,0.029158572852155125,9.371142186023757,244.14300549316408,239.28850549316408,235.3650054931641,231.4415054931641,226.5870054931641,0.16,0.0,279.9190720209941,-0.017368110007883075,-0.02599982150705287,226.16857038225447,235.53285653250558,9.418118447184508
2022-08-31,0,226.96749877929688,223.95999908447266,249.18000030517578,227.82125282287598,241.57999801635742,0.40151992113548624,8.396451131658935,-1.4036632150971815,2.9950936218996516,230.7237491607666,7.746499328613282,0.03581931817715966,225.4062484741211,246.57024955749512,0.7761527786039041,-0.006873306055594709,0.9682449081369782,0.9791628438711645,0.9973458819914679,-0.005956375845934225,39.72859912571489,251.2041518055542,234.41124954223633,217.61834727891846,227.3039289202009,2.7622715578392696,234.82035664149694,9.19166534942502,228.66927315085775,231.4241949037116,-6.788195690876502,-6.9005662595832655,8615900,4.826818250630033,1.286230707621707,-313987600.0,-85.50378326186568,91.40936679472856,92.55270083870475,-65.28025386968048,21.78982650251199,19.94492437608329,-0.05876426351599105,9.646775917011404,244.14300549316408,239.28850549316408,235.3650054931641,231.4415054931641,226.5870054931641,0.16,0.0,279.67133868903846,-0.026349039831347176,-0.004408842038340434,225.74285670689173,234.16571371895927,9.579653682708463
2022-09-01,0,225.14999771118164,223.95999908447266,249.18000030517578,227.9875020980835,241.57999801635742,0.411076049774263,8.324898704711687,-1.3963142344262072,2.9951048979381065,230.7237491607666,7.6881993103027355,0.035503037658310935,225.7504981994629,246.57024955749512,0.8080844023049452,-0.0074777924658905905,0.9601929261895491,0.9772517073101173,0.9905433060558663,-0.028877066463676826,43.18509686544888,251.1339219745479,234.48412456512452,217.83432715570115,227.13928549630302,2.864369502728216,233.27249935695104,8.833109012089817,228.23127851416447,231.48284562460674,-1.0129086968028032,-7.408388049917348,7292900,4.821278699615524,1.0875064773358485,-321280500.0,-66.01507430686098,91.40936679472856,92.55270083870475,-66.27012361146075,20.047382702493596,21.25518959790315,-0.028098429001010106,9.736291560933227,244.14300549316408,239.28850549316408,235.3650054931641,231.4415054931641,226.5870054931641,0.16,0.0,279.46214815127854,-0.01683905681404574,0.0018727088307923837,226.52714102608817,232.78999873570032,9.576588840676848
2022-09-02,0,229.01499938964844,223.95999908447266,249.18000030517578,226.80124950408936,241.57999801635742,0.4004614169811802,8.481938632883068,-1.4187600464196701,2.9950799975967417,230.7237491607666,7.829299468994139,0.03619999191578743,225.08224792480468,246.57024955749512,0.794271386721877,-0.0032869630983584724,0.9774111185335697,1.0018866170545873,1.013517851995914,-0.0010359722946674532,41.86912146219628,251.2716266325264,234.30774936676025,217.3438721009941,227.23749923706055,2.9230861432404125,231.8321421486991,7.597279410743137,227.44973087682953,231.14554646613917,-0.509275840407035,-8.779678312306956,8164900,4.797596913818726,1.19416410048652,-313115600.0,-75.87562009146293,91.40936679472856,92.55270083870475,-53.363330730077124,21.330742149557096,19.86759808059909,-0.08739677630488106,9.67227151437019,242.08019616699218,237.61989794921877,234.01499938964844,230.41010083007814,225.94980261230472,0.02,1.0,279.2374402454728,0.012674676847575617,-0.03363533319468809,226.02714102608817,231.14714159284318,9.605293794866272
2022-09-06,1,221.38000106811523,223.95999908447266,249.18000030517578,227.9875020980835,241.57999801635742,0.40156308718471334,8.353367302257025,-1.394695147788321,2.995100427975795,230.7237491607666,7.7043994140624985,0.03562752395170233,225.08224792480468,246.57024955749512,0.8405808944846435,-0.01430034271073617,0.9441966341347264,0.973277519697958,0.9799347628728459,-0.013776737824896301,45.47307015384615,251.17060903993888,234.4638744354248,217.75713983091072,225.74249921526228,2.849053363795118,230.034820829119,6.78216014683487,227.86338195944472,231.3591661130395,0.30110090797403744,-8.092543900325412,7469000,4.646277055764558,1.121188649109534,-320584600.0,-88.3611269906868,91.40936679472856,92.55270083870475,-110.79512721095449,19.44979246244874,25.62113150321005,-0.1042775036336742,9.849966794370703,238.9775573120117,234.3362182922363,230.58499908447266,226.83377987670897,222.1924408569336,0.02,1.0,279.000098789621,-0.027519293463120542,-0.021900749804652234,223.7999986921038,229.19714137486048,10.239488356466422
2022-09-07,1,224.1925048828125,221.38000106811523,249.18000030517578,226.80124950408936,241.57999801635742,0.36512200527508076,8.821104969045974,-1.3996572607747084,2.9950242278612236,229.44624710083008,8.14269958496094,0.03771056703428697,224.42124977111817,246.57024955749512,0.7952365064266674,-0.03581187546537845,0.9584316832908495,0.9890820346673095,0.9951086496669401,0.001038157703564524,37.79231598340346,251.5582091598937,233.91599922180177,216.27378928370985,225.0196429661342,2.419620110763227,228.83196422031946,6.1450275118185544,226.27454327324767,230.42325562796478,-4.513791583811553,-10.206150469327254,8149300,4.909740368181677,1.2055025935324777,-312435300.0,-55.11164741678098,91.40936679472856,92.55270083870475,-64.29980418646377,19.686188406605943,23.584105250603873,-0.06486522861884769,9.936397620419209,238.9775573120117,234.3362182922363,230.58499908447266,226.83377987670897,222.1924408569336,0.02,0.0,278.76741685793047,0.0376615139236367,0.019548467054687574,224.6114283970424,228.32642800467355,10.259647654288342
2022-09-08,1,225.41000366210938,221.38000106811523,249.18000030517578,226.0143756866455,241.57999801635742,0.3733105851605894,9.029713445955332,-1.4385245922824477,2.9949887814739706,229.27124786376953,8.359099273681641,0.03864706772008394,224.16925430297852,246.57024955749512,0.8508087794990975,-0.06803914365248159,0.9647521738595162,0.9953799167936503,1.0003062172253885,-0.006862194479668737,38.006139373205826,251.70492650281156,233.64549961090088,215.5860727189902,225.15357208251953,2.4102152637453425,227.55964306422644,4.581373687687119,225.79712553637793,230.1828572436844,-2.207170597575756,-6.986606662763539,6737400,4.200923425295254,1.0155534603566512,-305697900.0,-55.419566148739094,91.40936679472856,92.55270083870475,-57.310889986441566,18.584143000132585,22.263851968435205,-0.09525895727343371,9.773797952089144,236.54039544677735,232.36479678344728,228.98999786376953,225.6151989440918,221.4396002807617,0.02,0.0,278.5776705998442,0.01735554180168375,0.03077275654993812,225.02142769949776,227.05999973842077,10.020821056490114
2022-09-09,0,231.89749908447266,221.38000106811523,249.18000030517578,225.34500217437744,241.57999801635742,0.5620841700678973,9.053318274780121,-1.2914554099514248,2.9949818603472744,229.1337490081787,8.197899017333981,0.03887412956209517,224.16925430297852,246.57024955749512,0.8365860510981772,-0.0804376969830483,0.9957468798648393,1.0253487998620314,1.0305204326575723,0.02996891601991747,38.17973759018105,250.99463627490204,232.88799972534179,214.78136317578154,226.28750065394811,3.413458719437859,226.96160752432687,3.102277809765241,225.7253198895383,229.79792354115554,0.41764751376428966,-7.323539638182146,6699600,4.036448144897217,1.025942583600171,-298998300.0,-15.18414401668185,91.40936679472856,92.55270083870475,3.1142005902504795,22.06326689468774,21.047948298937328,-0.018136040627657734,9.599954880488152,231.6966382446289,228.44667904663086,225.81999969482422,223.19332034301758,219.94336114501954,0.02,1.0,278.41458861445614,0.015345218836340102,0.04477549595160214,226.86714390345983,226.51785714285714,9.740438904099795
2022-09-12,0,235.75,221.38000106811523,249.18000030517578,225.34500217437744,240.46062183380127,0.7412618883224608,8.60719364219478,-0.9207594054339681,2.995051383878879,229.1337490081787,7.3708493804931665,0.03706378748530841,224.16925430297852,246.57024955749512,0.8034897390686287,-0.06045904152338626,1.0151726872771247,1.0423586698810436,1.0413951749747745,0.029408556768338867,47.733418738241085,249.44088722335442,232.22649993896485,215.01211265457528,227.54214368547713,4.966014415394619,227.423036302839,3.862514843945171,227.30554057910973,230.04517759153956,3.544159685858078,-3.4846205000916246,6047400,4.337901540687027,0.9264304759687084,-292950900.0,-11.935509474291814,91.40936679472856,92.55270083870475,46.149854267728614,24.629528049309517,20.06403217510321,-0.06152340834719412,9.351387284227034,233.63720477294925,230.0164043273926,227.09000396728516,224.16360360717775,220.5428031616211,0.04,0.0,278.2805378052762,0.046083756316916524,0.02821250948782431,228.72000122070312,227.23142896379744,8.942323662715735
2022-09-13,1,222.51000213623047,221.38000106811523,249.18000030517578,225.34500217437744,236.8799991607666,0.8359198434466958,7.984338484741366,-0.5452011714523257,2.995143819072986,229.1337490081787,6.635599441528319,0.034463828267942295,224.16925430297852,243.55449981689455,0.7248457484609767,-0.0538967826018452,0.9604485726873495,0.9810003187201555,0.9770952830883224,0.005104350269505842,52.03792106405138,247.64167692370637,231.67299995422363,215.70432298474088,227.1650014604841,5.268969340197542,227.15214347839355,4.074330694644564,229.44225387504815,230.69629061622706,3.8694972927569804,2.8173941213532925,8000100,4.4071098668702415,1.2119031640881224,-300951000.0,-86.12902412057397,91.40936679472856,92.55270083870475,-101.54043306410003,21.3292853579411,28.524013548805634,-0.10232268982665654,10.02700263610264,233.63720477294925,230.0164043273926,227.09000396728516,224.16360360717775,220.5428031616211,0.04,0.0,278.04017935188944,-0.0011905055522806185,-0.035292537729415804,227.01857430594308,226.77285766601562,8.398560061013473
2022-09-14,1,221.93500137329102,221.38000106811523,246.54249954223633,224.98062324523926,232.8606243133545,0.8950495779581635,7.130547834445025,-0.3630112537366119,2.9952573448283766,228.67125129699707,5.81834934234619,0.030956687120654254,223.81499938964845,241.2514976501465,0.5718817444205525,-0.09747811209275398,0.9635125600654031,0.9793125851184832,0.9736040897720596,-0.010069486982633546,38.80341884956042,244.6005957146664,230.33950004577636,216.0784043768863,226.15357317243303,5.5278345028996645,226.6955362047468,4.285220184162306,227.70421674765393,229.23498044137918,-1.1725496787868994,-1.6758540069631025,8230300,5.213675385545577,1.2182307582432954,-309181300.0,-61.9758406638065,91.40936679472856,92.55270083870475,-84.64217105972344,19.503852521163463,27.42971678943463,-0.0637909409024096,10.182216586425163,233.63720477294925,230.0164043273926,227.09000396728516,224.16360360717775,220.5428031616211,0.02,1.0,277.8013025414635,-0.021139113621394534,0.026237445595279674,226.73428780691964,226.3807144165039,7.620370878384726
2022-09-15,0,234.31000137329102,221.38000106811523,243.2224998474121,224.4025011062622,231.8581256866455,0.9208553252673584,6.30363468696024,-0.21822107172693928,2.995356839545373,227.6475009918213,4.968698883056641,0.02751367796102321,222.45250205993653,240.34624671936035,0.5530045135197091,-0.07923203816183413,1.0227004325246516,1.0348433195120008,1.029931802719638,0.039483596852794456,39.46671658008239,241.7163945112496,229.1091251373291,216.5018557634086,228.00071607317244,5.819485914280509,226.87160764421736,4.555212821803776,226.23924380214692,228.09057983889872,-3.0914996988085663,-2.7997073244976565,19454100,5.117764536861122,2.6122388143875153,-289727200.0,-25.036198171930124,91.40936679472856,92.55270083870475,93.51805371925246,26.642309165469175,24.118955322531924,-0.06693526562391308,10.752772655701037,235.77639544677734,231.74679678344728,228.48999786376953,225.23319894409178,221.20360028076172,0.02,1.0,277.3754265872853,0.034910316374322736,0.028039823465625707,229.16143144880022,226.48071507045202,7.23046091449152
2022-09-16,0,235.13500213623047,221.38000106811523,243.2224998474121,224.4025011062622,231.8581256866455,0.949430249924112,5.8195314031793695,0.1795739334005888,2.995411224037097,227.6475009918213,4.589549026489257,0.025438016700572167,222.45250205993653,236.20199966430664,0.3322211625321107,-0.03664339639512147,1.0278092335686542,1.0351302019792306,1.0255342313127942,0.013960922668590392,52.782211863713336,240.4120631420521,228.77300033569335,217.13393752933462,229.56392996651786,6.08945261995117,227.29178646632604,5.0374968855839,228.24709303086354,228.7402152284428,5.840636120151349,1.0632103947073468,18914200,5.898251771382428,2.3267617831511456,-270813000.0,-7.826047535566535,91.40936679472856,92.55270083870475,122.38295758385316,24.29114915577537,22.818836420427296,0.013203474582731028,10.951146028358048,235.77639544677734,231.74679678344728,228.48999786376953,225.23319894409178,221.20360028076172,0.02,0.0,276.97778554062955,0.0280857873566267,0.05579494506326118,230.75714547293526,227.68428693498885,6.689688826409325
2022-09-19,0,242.42000198364258,221.38000106811523,240.2699966430664,224.4025011062622,231.8581256866455,0.6282987264217861,5.028695481242006,-0.41417459009060176,2.9954908999427774,227.6475009918213,4.144736652374268,0.022020080347420812,222.45250205993653,235.1965019226074,0.1650426911767676,-0.02137176750563758,1.0615293651035111,1.062530271850149,1.0543300533365445,0.02829269134100776,54.321252890568786,238.4260164126183,228.3686254501343,218.31123448765027,231.9939297267369,7.406953842934485,228.5737509046282,6.371808954251768,229.95396959574592,229.2470458965069,4.88084883084638,2.5659495729640636,17912400,5.874809392837205,2.070949717117962,-252900600.0,-5.301031566123089,91.40936679472856,92.55270083870475,195.70015278550088,25.33308894631021,21.391389865331462,0.061543802401448355,10.847492702717545,238.03784057617187,233.57608093261717,229.97000122070312,226.36392150878908,221.90216186523438,0.04,0.0,276.65478261837757,0.03001735991272958,0.04307058801701991,233.07000296456474,229.04571533203125,6.956398805208494
2022-09-20,0,243.34250259399414,221.38000106811523,242.42000198364258,224.4025011062622,231.8581256866455,0.8425302750876061,5.297749451076009,0.2293249470223948,2.9954651224342927,227.6475009918213,4.262986946105957,0.023187321801990984,222.45250205993653,235.1965019226074,0.3009844181933511,0.05726374917715486,1.0650675287414255,1.060343628666393,1.0522372923325138,0.09362500677614083,63.68815708936099,239.0716246193151,228.4761257171631,217.88062681501108,233.6289302280971,8.55614800564206,229.9582154410226,7.326423586590678,233.05079311483303,230.50493034684501,7.546248190045402,7.995412421757899,16037400,5.527821622987899,1.7780354844324608,-236863200.0,-21.34077859882573,91.40936679472856,92.55270083870475,185.78388537588606,26.977129100832517,19.865720940808345,0.04934031461879149,10.846243354317439,242.04120477294924,236.8144043273926,232.59000396728516,228.36560360717775,223.1388031616211,0.06,0.0,276.3931320675311,0.11332691820175578,0.026719686115230734,234.39571707589286,230.63143048967635,7.6418933122333375
2022-09-21,0,241.12999725341797,221.38000106811523,243.34250259399414,224.4025011062622,232.50062465667725,0.8669922218833449,6.21206935815505,-0.12100636241381668,2.9953676635618756,227.6475009918213,5.052249908447266,0.027105782413382386,222.45250205993653,236.41700019836426,0.48790652913323346,0.0752974482789323,1.0521481429228279,1.0407429542351387,1.024217523857589,0.08648926830536885,65.3681361673792,241.60288970813139,229.1787509918213,216.7546122755112,234.39750126429968,9.008127549089263,230.9698224748884,7.841368174630951,235.6198069132072,231.9155909422959,4.93537168563963,8.654448825127401,9166800,5.459403481867336,0.9948530668612933,-246030000.0,-38.04471847749696,91.40936679472856,92.55270083870475,118.4990220870528,24.92318985886897,20.30577283196573,0.026260766471028776,10.90151244471823,242.04120477294924,236.8144043273926,232.59000396728516,228.36560360717775,223.1388031616211,0.06,0.0,276.228351026274,0.056889167757358194,0.08591202409060053,234.4442879813058,231.58214460100447,7.737012841939275
2022-09-22,0,236.1400032043457,221.38000106811523,243.34250259399414,224.4025011062622,234.51625156402588,0.6490006261785533,6.690900014392961,-0.7150254818234973,2.9953113723293003,228.67125129699707,5.64689994812012,0.029100975793087513,222.45250205993653,241.25899772644044,0.6031938122517689,0.05607074868074237,1.0270523400808482,1.0118088730632064,0.9869288647651351,0.007810173788267871,61.847915834278304,243.30192579935476,229.92012577056886,216.53832574178296,236.3446442740304,7.326462172981602,231.75482286725725,7.763647848601497,237.00623589907187,233.30697511418936,2.2820773079185446,6.239879520324054,10018000,5.495198202314624,1.0608006726098895,-256048000.0,-37.54190306066567,91.40936679472856,92.55270083870475,63.57705625537319,23.459843201356946,22.447754579462373,0.03392571703188568,10.75426125112153,242.04120477294924,236.8144043273926,232.59000396728516,228.36560360717775,223.1388031616211,0.06,0.0,276.0288944106118,0.007094902431397099,0.05769234435245053,237.1471448625837,232.0828595842634,7.899985127280638
2022-09-23,0,229.8574981689453,221.38000106811523,243.34250259399414,224.4025011062622,235.28875160217285,0.48110095178070894,6.81344821251449,-0.9705218470069239,2.9952966242632804,229.1337490081787,5.917325191497804,0.02958371760640004,222.45250205993653,241.25899772644044,0.6600641401452306,0.018525316314902916,0.9980319954665292,0.9803823177678879,0.9592043549551018,-0.022444569797513747,54.55276302380743,243.93764719559783,230.31075077056886,216.68385434553988,237.47642953055245,4.958846956476026,231.81500135149275,7.7440173977926134,236.78087055761307,233.7859940538565,6.125567811450716,4.881192806966777,11207200,5.5910159718965655,1.1417481464879418,-267255200.0,-67.2625692133073,91.40936679472856,92.55270083870475,-23.402801485463876,21.102165015773668,26.773734036592163,-0.004440966116613295,11.101814854521162,242.04120477294924,236.8144043273926,232.59000396728516,228.36560360717775,223.1388031616211,0.02,1.0,275.7618338669092,-0.05713572207437689,-0.0381085947600732,237.4742889404297,232.10428837367468,7.893817352462271
2022-09-26,1,226.34500122070312,221.38000106811523,243.34250259399414,224.4025011062622,235.28875160217285,0.5261562652580802,6.804834810450735,-0.9308995925875472,2.995297539880978,229.1337490081787,5.843400268554689,0.029559072796397617,222.45250205993653,241.25899772644044,0.6605746912454189,0.002639009589254016,0.9832051114463874,0.9662416286360335,0.9487253670191481,-0.06631053803895326,48.27844010450525,243.82104523888245,230.21137561798096,216.60170599707948,236.33857236589705,6.485372968953834,232.16964421953475,7.33211240192442,235.0492998828425,232.90658526075183,3.5697374216015563,0.3678793011559208,8234300,5.747448700290405,0.8267327975261168,-275489500.0,-76.16026609848319,91.40936679472856,92.55270083870475,-38.649830973017245,19.774489482446338,25.089222917016244,-0.010319185207910487,11.000971085271312,242.30316491699222,237.2384245605469,233.14500427246094,229.05158398437501,223.9868436279297,0.02,0.0,275.5613754016891,-0.08028566747352084,-0.06688042823482764,235.85857500348772,232.51000322614397,7.860942612103397
2022-09-27,1,226.0875015258789,221.38000106811523,243.34250259399414,224.4025011062622,235.28875160217285,0.5695683281904282,6.854641729469454,-0.9397237636779017,2.9952908033344174,227.99124908447266,5.959700164794924,0.02979424037968616,222.45250205993653,241.25899772644044,0.6476236701896724,0.008341785183324776,0.9827071396517859,0.9690329511573906,0.9605906665739327,-0.07090829133496834,45.91894480660554,243.77528420661957,230.06600074768068,216.35671728874178,235.04607227870397,7.575204639922208,232.30500112261092,7.189626856902756,232.86525803669565,231.74287448152708,-3.3993427962549707,2.242750080690548,7762200,5.698356806268922,0.7767878319051227,-283251700.0,-75.32430972568493,91.40936679472856,92.55270083870475,-53.04503093154208,18.491813864636466,24.959193619265516,-0.01103628249726447,10.923758716006688,242.30316491699222,237.2384245605469,233.14500427246094,229.05158398437501,223.9868436279297,0.04,0.0,275.3687195590772,-0.0761375541628877,-0.07909536545685301,233.605717250279,232.18143136160714,7.868605786782753
2022-09-28,0,237.22999954223633,221.38000106811523,243.34250259399414,224.91062450408936,235.28875160217285,0.5662356839834863,6.797547561448832,-0.9144374946669154,2.9952983964531845,227.99124908447266,5.895100097656251,0.02953570944141865,222.45250205993653,241.25899772644044,0.6365806191597131,0.00949947512994856,1.0307770962876424,1.0152340678471399,1.0229311086156814,-0.01617383882388923,45.78306616509625,243.74184595450166,230.146750831604,216.55165570870636,234.30464335850306,6.962387439105037,233.14928654262,7.00941518303612,231.17168222284,230.67731096507063,-3.8477897923124607,0.8452542354424107,17579700,5.697201991530611,1.6608666035879298,-265672000.0,-15.249374957113593,91.40936679472856,92.55270083870475,90.05352621092598,25.727514156702917,21.573044850814554,0.07786926053447314,11.735632790582063,242.30316491699222,237.2384245605469,233.14500427246094,229.05158398437501,223.9868436279297,0.04,0.0,275.06247633346453,0.03516697767876242,0.009676717256185284,233.8300018310547,233.4500023978097,8.253109524805106
2022-09-29,0,240.99499893188477,221.38000106811523,243.34250259399414,225.34500217437744,235.84750080108643,0.36394154127237327,6.808909334510809,-1.1027682042071696,2.995298586798386,229.43624877929688,6.006274948120117,0.02950003004330728,222.45250205993653,241.25899772644044,0.5750586365308519,0.0452157283229292,1.044126064763966,1.0246396860941982,1.0426725774371726,0.02055981901269721,56.66071490361547,244.42806952351378,230.81025085449218,217.19243218547058,233.96928569248743,6.495379613000378,233.79910796029228,7.300111677295813,232.67314627956216,231.30323352723207,-2.140913455547471,5.243776091608241,18994900,6.183634730610561,1.710696661129426,-246677100.0,-31.075232114800333,91.40936679472856,92.55270083870475,89.77806308536317,24.15473386511187,20.08536806665808,0.08753746505012176,11.704516374377132,242.30316491699222,237.2384245605469,233.14500427246094,229.05158398437501,223.9868436279297,0.04,0.0,274.7470755660586,0.011221276641488087,0.011989748196155612,233.38143048967635,233.8885737827846,8.262502181873645
2022-09-30,0,237.0349998474121,221.38000106811523,243.34250259399414,225.34500217437744,236.41250228881836,0.18022248955631348,7.093478478059125,-1.311229728762523,2.99526361461057,230.87749862670898,6.3233747482299805,0.03063983699152844,222.45250205993653,241.25899772644044,0.5660902196302,0.07037531148913805,1.0238578687559303,1.004946614001836,1.0212491866631466,0.031225875751903276,60.31928727071068,245.69858281823983,231.51162586212158,217.32466890600332,233.38428606305803,5.900098574850525,233.89089366367884,7.334524621229938,234.72721555458253,232.39293039438633,-0.9646911809837337,3.923069409255763,11848600,6.197242784567436,1.0456440030746448,-258525700.0,-43.38426633776777,91.40936679472856,92.55270083870475,47.81147781624573,22.780353990872943,20.442480044302226,0.028095295898805207,11.524194309120826,242.30316491699222,237.2384245605469,233.14500427246094,229.05158398437501,223.9868436279297,0.04,0.0,274.531892840284,0.039883391339779806,-0.00679181855990119,233.1771458217076,233.8107169015067,8.285087641211224
2022-10-03,0,237.81999969482422,221.38000106811523,243.34250259399414,225.91812705993652,237.08374977111816,-0.007966328030429095,7.033219113732354,-1.3072467034184874,2.995273019039272,233.10375022888184,6.242874717712402,0.030301771053283185,222.45250205993653,241.25899772644044,0.6070458051079892,0.0350195422969583,1.0246186086502005,1.0074631971743817,1.0183331633854151,0.05069693791440133,54.88113555327361,246.17231419639782,232.1058759689331,218.0394377414684,233.62428556169783,6.062801323130772,234.98446491786413,6.61297604053684,235.32508923921884,233.05240195898116,-1.698252997407942,0.5450688642257092,8657400,6.2419738475342275,0.76236250128236,-249868300.0,-33.00666301875046,91.40936679472856,92.55270083870475,50.74386428565077,21.53142413194875,19.58038425464359,0.07146716164809988,11.321750907662684,242.30316491699222,237.2384245605469,233.14500427246094,229.05158398437501,223.9868436279297,0.04,0.0,274.3793824464718,0.0668094143463529,0.05578370840394605,233.461430140904,235.30428750174386,8.287899964033802
2022-10-04,0,241.15750122070312,221.38000106811523,243.34250259399414,225.91812705993652,237.3774995803833,-0.16379346091181007,7.1012136724757005,-1.3344443408069768,2.995265126911648,234.72250175476074,6.330012073516846,0.030536796269650304,222.45250205993653,241.25899772644044,0.5843085081144878,0.07426144433728975,1.0370308264653552,1.0235963171104123,1.022575254636524,0.06665560720126429,57.87222344661637,246.7485533291433,232.5461259841919,218.34369863924047,235.23857171194894,6.388330138896151,236.3575006212507,5.615456535050119,235.9558507074671,233.82078200554784,0.7114408688411497,6.8805884731511044,13925900,5.946099556591469,1.1924023406394118,-235942400.0,-32.75108700276316,91.40936679472856,92.55270083870475,66.70573962839842,22.506687805356727,18.041977767797405,0.09355273621609327,11.40948321786631,243.4642844848633,239.117863861084,235.6050033569336,232.0921428527832,227.74572222900392,0.04,0.0,274.15076999313965,0.07300768781535116,0.07439638338041664,235.5085732596261,236.4914311000279,7.720972672224088
2022-10-05,0,236.11499786376953,221.93500137329102,243.34250259399414,226.28062629699707,238.61374950408936,-0.3026634918606586,6.85003895847099,-1.2552404789145237,2.9953007098673905,235.44250106811523,6.004499588012697,0.029331958504630697,224.0242546081543,241.28375129699708,0.5553333627623543,0.0756715588987169,1.0110475811376924,1.0031236663414915,0.98855963748673,-0.004700087175392387,60.32721787829174,247.23507890876326,233.53500099182128,219.8349230748793,236.63428551810128,5.048118119610203,236.48642894199915,5.585471652228315,237.25170279279502,235.25834916948963,4.9160906830423725,8.66131963343636,10825600,5.956295249111198,0.9164393331739,-246768000.0,-46.22105405054943,91.40936679472856,92.55270083870475,11.93459559626173,20.538968321486212,20.076165623258873,0.0747855189363914,11.609519550582018,243.4642844848633,239.117863861084,235.6050033569336,232.0921428527832,227.74572222900392,0.04,0.0,273.951033808272,-0.034543235424636,0.05513458318566586,237.317143031529,236.58785901750838,7.650163807036245
2022-10-06,1,238.7224998474121,221.93500137329102,243.34250259399414,228.97937393188477,238.61374950408936,-0.47557858937523523,6.521991770233142,-0.9624396619621085,2.9953424738170353,235.93249893188477,5.487537231445316,0.02785615006283763,225.1200035095215,241.28375129699708,0.5338355789163461,0.0474912116931021,1.0196102683655381,1.0163669889542513,1.000410688491307,-0.00942965245977967,53.59814993052521,247.1751091813354,234.13112564086913,221.08714210040287,238.4392852783203,1.9672653126877904,236.74267877851213,5.600973675605287,236.96229146632444,235.77357017519864,4.316418118525152,0.7703454739018525,9188900,6.100615510190522,0.7698958966087849,-237579100.0,-35.169632912644566,91.40936679472856,92.55270083870475,56.88744263260982,20.8862306987439,18.78541647958306,0.06252366706138297,11.520982078700353,243.4642844848633,239.117863861084,235.6050033569336,232.0921428527832,227.74572222900392,0.04,0.0,273.80118429282606,0.0012932190977066327,-0.021125582138056206,239.55428641183036,236.5800018310547,7.567103071919604
2022-10-07,1,230.53250122070312,221.93500137329102,243.34250259399414,231.38749885559082,239.29062461853027,-0.7001605905374942,6.27251605745929,-0.5614151549394188,2.9953731063268285,236.12750053405762,5.063474826812742,0.02671466298163882,225.72975158691406,241.28375129699708,0.5541349557062195,0.029431109821729164,0.9818385509115605,0.9804198898518239,0.9679325755388701,-0.02743265184843957,54.659228280684715,247.34178256505285,234.79675045013428,222.2517183352157,237.48249980381556,3.6024896459660964,235.8935715811593,5.575097954022882,237.3837174331772,236.2462648556016,5.588543478192645,1.5257182803873441,9806100,5.962267122868237,0.8110532377492385,-247385200.0,-86.46288813930448,91.40936679472856,92.55270083870475,-70.79725518517337,18.899982613840855,22.817238337263717,0.00937668155385556,11.822340933063858,243.4642844848633,239.117863861084,235.6050033569336,232.0921428527832,227.74572222900392,0.04,0.0,273.5937808363879,-0.045404359202156686,-0.062408770159204846,236.6328582763672,235.23143005371094,7.904263740136593
2022-10-10,1,228.4199981689453,221.93500137329102,243.34250259399414,230.36375045776367,239.29062461853027,-0.6655623019793308,6.3109989537025815,-0.6416503824260493,2.9953685740894613,236.12750053405762,5.152199687957767,0.026886376979055916,225.72975158691406,241.28375129699708,0.530012524096116,-0.022131490050039768,0.9731242589926995,0.9711569449500571,0.9643284517355517,-0.039525698166433365,44.58731292293521,247.35049846435095,234.7285005569458,222.10650264954063,235.68607112339564,4.565610284621502,234.82767840794153,5.4668529428249,235.64235375818026,235.3165076787235,-2.8232088414015206,-4.90367983898522,9991100,6.192852968695548,0.8130936802151084,-257376300.0,-66.42496775903297,91.40936679472856,92.55270083870475,-56.899704811236525,17.788833837844432,21.506412360281562,0.01646826976665729,11.663602711855859,241.7911226196289,237.7644423522949,234.51000213623047,231.25556192016603,227.22888165283203,0.04,0.0,273.38703757208515,-0.03790159727685771,-0.023190650090254068,235.24285670689173,234.31214359828405,7.9537960467778905
2022-10-11,1,221.11999893188477,221.93500137329102,243.34250259399414,229.4981231689453,239.29062461853027,-0.49913079758583145,6.452292037709492,-0.9286533636337881,2.9953514502261482,236.12750053405762,5.489849853515625,0.027531306376019207,225.72975158691406,241.28375129699708,0.5586021672785488,0.026560585933105528,0.9434976595727443,0.939291407312468,0.940978210719053,-0.08308886179111796,45.72641333788026,247.26658454081206,234.36200046539307,221.45741638997407,233.4124995640346,7.0620551843795365,233.3983928135463,6.251802852122946,233.8104727984608,234.25303843362337,-5.217950919593013,-6.132304988227373,15282400,5.41652777379883,1.2079158227535445,-272658700.0,-98.22717440044603,91.40936679472856,92.55270083870475,-165.30696814573506,16.02016485822467,25.622320747505373,-0.011128303316228756,12.026202951028328,239.12591601562497,234.26703619384764,230.33999633789062,226.41295648193358,221.55407666015626,0.06,0.0,273.00447355158155,-0.10986961702874243,-0.10353915953458905,232.22142682756697,232.69928632463728,8.396914069774262
2022-10-12,1,217.86999893188477,221.11999893188477,243.34250259399414,229.4981231689453,239.29062461853027,-0.5527843010671455,6.5856874567935,-0.8226353667207764,2.995335058758587,236.12750053405762,5.575000152587887,0.028108827419637276,225.67225151062013,241.28375129699708,0.4590562240602045,-0.003672257356267249,0.9299059878062677,0.927442824984749,0.9432336705037628,-0.07727166464203816,38.91966501729034,247.4638752187628,234.2925003051758,221.12112539158878,230.56249945504325,8.798877813979496,232.09339250837053,7.4311078663719465,230.67376385271945,232.74337441151448,-6.714198715705444,-8.298427632171993,12952600,5.6763563716925685,1.0050131944546823,-285611300.0,-76.03378973439749,91.40936679472856,92.55270083870475,-161.6534129019901,14.964409677469797,24.56709127503885,0.002193190701720694,11.955045502808876,238.87575659179686,233.86211712646482,229.80999755859375,225.75787799072265,220.7442385253906,0.08,0.0,272.68196597101576,-0.06699615974565964,-0.08253721825449077,229.62571280343192,231.54357147216797,8.627251239666524
2022-10-13,1,222.8499984741211,217.86999893188477,243.34250259399414,229.4981231689453,239.29062461853027,-0.7393675365446515,7.012810224272167,-0.3757194183427184,2.9952800426981105,236.12750053405762,5.839225311279298,0.029957848208692715,225.5907512664795,241.28375129699708,0.6275028313276112,-0.07016346867419823,0.9519873223559263,0.9565250006061092,0.9802800255243224,-0.06648933964513815,31.981796227467985,248.1148706316498,234.08925018310546,220.06362973456112,227.94714191981726,7.787484065462448,231.5928568158831,7.81916452178916,227.5382399543473,230.99330653752958,-8.388697665688222,-7.736937420404301,17505000,4.895923736236887,1.3685901332508765,-268106300.0,-41.049648853058514,91.40936679472856,92.55270083870475,-74.4254851227509,19.11645219637008,21.431316421963267,0.06247555282473844,12.725399862038632,238.66099572753905,233.51449572753904,229.35499572753903,225.19549572753903,220.04899572753902,0.1,0.0,272.30970713950063,-0.03128909937481705,-0.01782622099803556,228.4499969482422,231.97928510393416,8.624786536005685
2022-10-14,1,234.0275001525879,217.86999893188477,243.34250259399414,227.90124893188477,239.29062461853027,-0.5637180893723049,7.427299675523452,-0.8618126762248406,2.995223241634098,236.12750053405762,6.504750366210937,0.03180635041163146,222.67699851989747,241.28375129699708,0.7234805927370384,-0.052246596850739374,1.0021893556202508,1.0123862177633602,1.0440268874243033,0.015160547486268605,38.977919655119976,248.3708493891939,233.51625003814698,218.66165068710006,227.64892796107702,7.455465701755789,232.14160673958915,7.6910690902892815,226.40526028152897,229.97586735896124,-7.591512871841927,-3.0486278457941385,15293400,5.056693261142165,1.212847937209222,-252812900.0,-48.170200645500806,91.40936679472856,92.55270083870475,-6.6768605139760675,20.578264810351516,20.291796646036364,-0.052236181419610075,12.480014746010482,238.66099572753905,233.51449572753904,229.35499572753903,225.19549572753903,220.04899572753902,0.02,1.0,272.0347606913369,0.023359288097886566,-0.04174653818057041,227.48856898716517,232.4028560093471,8.526196659009628
2022-10-17,1,240.95750045776367,217.86999893188477,243.34250259399414,227.90124893188477,239.29062461853027,-0.5436892754402879,7.419148535016984,-0.8690790013785992,2.995224228107771,236.12750053405762,6.460450286865234,0.03177898025507109,222.67699851989747,241.28375129699708,0.706493388568425,-0.03461967561414745,1.0321108430727792,1.043722810366722,1.0716009099200912,0.05488793621101995,49.89181807812213,248.29917200899882,233.46087493896485,218.62257786893088,227.9682137625558,8.03413879015556,233.20374952043807,7.816436325833837,228.34099833258244,230.4983328104179,-0.8841021239938588,3.3941544502649568,21057800,5.438335072708976,1.649423326896046,-231755100.0,-12.62108341790467,91.40936679472856,92.55270083870475,97.46496758370449,24.43245803895408,18.07280146092163,-0.06657393423911925,13.01144217750107,240.90715759277344,235.33141723632812,230.8249969482422,226.31857666015622,220.74283630371093,0.04,0.0,271.76072680315235,0.06574489371627568,0.09054507721252768,228.2142835344587,233.88428497314453,8.626352578707433
2022-10-18,1,244.68999862670898,217.86999893188477,243.34250259399414,227.90124893188477,239.28125,-0.5698987204459157,7.337239913358643,-0.8522953251983401,2.9952349697547955,236.12750053405762,6.40195022583008,0.031437982146346556,222.67699851989747,241.13274765014648,0.6427917806678743,-0.009801009321457239,1.0484269151688062,1.0584518983913016,1.0761990600293307,0.10659370391044942,55.94656224826885,248.06222968938818,233.3877498626709,218.7132700359536,229.99071339198522,10.26071230645164,233.7366065979004,8.348214525130745,231.4645385071209,231.88395429527435,0.9362337491355619,6.577099057456161,25776700,5.677823212250981,1.9448638232407027,-205978400.0,-24.611787414736956,91.40936679472856,92.55270083870475,97.49144871056949,22.98117690298412,16.8161768349031,-0.08835124249998413,12.98491054775111,241.25095526123047,235.60951535034178,231.04999542236328,226.49047549438475,220.84903558349606,0.06,0.0,271.43051854218027,0.12399089157999499,0.04730848371569779,230.51571219308036,233.57428523472376,8.521231116505453
2022-10-19,1,269.83499908447266,217.86999893188477,244.68999862670898,227.90124893188477,239.28125,-0.5194944270727814,7.433891070052637,-0.8371108426080665,2.9952223029670684,236.12750053405762,6.45585006713867,0.03184291234018568,222.67699851989747,241.13274765014648,0.6349358944945396,0.014763826209269172,1.1558324087872474,1.1654404060720582,1.1626859813472334,0.238513794498316,59.50534220593131,248.32290680441193,233.45512466430665,218.58734252420138,235.9071420942034,18.128082993559374,235.79660660879952,12.700709232349004,234.72320022047302,233.56201134551858,6.14121537355464,3.1446271967574155,46685300,5.717860124055158,3.08568172902819,-159293100.0,-10.241207226212868,91.40936679472856,92.55270083870475,307.036684670958,32.67798333367342,13.697079487738806,-0.022131669020573924,14.803130437595106,263.3534696655273,253.4882508239746,245.5149917602539,237.5417326965332,227.67651385498044,0.08,0.0,271.4308473141408,0.23321415721630823,0.2710813076517037,236.57285635811942,235.90785653250558,12.222007962033945
2022-10-20,1,271.4250030517578,217.86999893188477,269.83499908447266,227.90124893188477,239.28125,1.326957659386807,10.79038337106259,3.122498782699994,2.9946964512557495,236.12750053405762,7.690337600708008,0.0459379545980882,222.67699851989747,241.51075096130373,0.47353324629117866,0.14269075727490657,1.1555390608656138,1.1554794170219835,1.1194076172471528,0.2179717518969495,74.10314729604981,256.47114149798455,234.89037475585937,213.3096080137342,243.09357125418526,21.028194777985806,238.25303540910994,15.885108207737876,243.46904370068052,238.56723493771176,18.131074882898712,11.967053374721388,17207100,7.845438484662306,1.1109159919453087,-142086000.0,-16.486584932661007,91.40936679472856,92.55270083870475,237.43931973824812,30.759892490178512,12.893105678223423,-0.06778228341528351,14.602906821595056,263.3534696655273,253.4882508239746,245.5149917602539,237.5417326965332,227.67651385498044,0.08,0.0,271.4274394200833,0.1533267816331454,0.21410788966528074,244.26857212611608,238.2449994768415,14.302535985962939
2022-10-21,1,278.7375030517578,217.86999893188477,271.4250030517578,227.90124893188477,240.96687507629395,1.3034336084530842,13.415687456553771,1.5225886307003167,2.994161408007161,236.57499885559082,9.332125282287597,0.05668888774443488,222.67699851989747,247.20449867248539,0.6600383552024409,0.1808403259147125,1.1778240266730413,1.1703165177000832,1.105281012693689,0.19104593635371314,76.33601829233524,263.48599966133753,236.65462474823,209.82324983512245,251.7889289855957,21.440251881592342,241.17571422031946,19.214562779188544,250.43739016493862,243.27263318855302,22.75009242170326,14.508407292798015,24889100,7.613495565310866,1.5389095729634292,-117196900.0,-1.4932834877009566,91.40936679472856,92.55270083870475,245.23105172378965,32.92756075406866,11.389064043714203,0.016459055093700548,15.3505569036635,272.1012789916992,260.5643583679199,251.23999786376953,241.91563735961913,230.37871673583982,0.1,0.0,271.5401367125628,0.25900003184442943,0.24540886054558506,254.0828595842634,241.85428619384766,18.350291177050057
2022-10-24,0,285.8824996948242,217.86999893188477,278.7375030517578,227.90124893188477,241.03562450408936,1.1829906578009852,16.132139305352858,0.6217597659194514,2.9935108721137755,237.13249969482422,11.410712947845463,0.06747064859058732,222.67699851989747,269.9939994812012,0.7149512029758163,0.2314718750071627,1.1956676861021114,1.1765038733400552,1.0947941391393954,0.18644366393124678,79.70002703071641,271.36290360307635,239.09862499237062,206.8343463816649,260.79357201712475,20.475314796754276,244.370356968471,22.626411456276784,257.5060272605866,248.31143430099692,27.937533583457153,17.2052406902026,13326400,7.570522956135594,0.8112097717224633,-103870500.0,-10.503653941032947,91.40936679472856,92.55270083870475,198.93060309565905,31.336827987240227,10.838857561881046,0.011959263915220019,14.977660309364245,272.1012789916992,260.5643583679199,251.23999786376953,241.91563735961913,230.37871673583982,0.1,0.0,271.61330548735333,0.15238680201313914,0.22804353133491848,261.21714782714844,244.8335723876953,20.27712016518209
2022-10-25,0,290.2774963378906,217.86999893188477,285.8824996948242,230.00437545776367,242.0406255722046,1.0589699450865018,18.779987617120586,0.06416317970018293,2.9927968444306594,237.52499961853027,14.019250392913822,0.07757905126140927,222.67699851989747,272.1562530517578,0.7548066209245466,0.2644772389689172,1.199119681415611,1.1669939687282072,1.0746480951879227,0.1863071558585785,81.75704170826876,279.63547515031786,242.07549991607667,204.51552468183547,268.82928575788225,19.219354043898978,248.23910685947962,25.54811715344626,264.6280983386622,253.41588574138024,28.284721405561463,18.545970267451708,15100700,7.595772338186149,0.8991329723273395,-88769800.0,-7.652000090280277,91.40936679472856,92.55270083870475,177.22038973643748,32.45935373994637,10.056868150806334,0.01374061052149842,14.989254868659796,277.3270361938477,264.7914761047363,254.65999603271484,244.52851596069334,231.992955871582,0.12000000000000001,0.0,271.73964698811903,0.2082537086947287,0.18735202679171872,269.93428911481584,248.71142905099052,22.47878978221059
2022-10-26,0,295.58250427246094,217.86999893188477,290.2774963378906,233.1537504196167,250.9762487411499,0.9023537672356652,21.1134522198637,-0.4279699728110353,2.992112589030892,238.27124977111816,16.973250293731695,0.08607722547002862,222.67699851989747,279.45200271606444,0.81668173120933,0.2236120933187868,1.2050574013338955,1.156176157225196,1.0585571614020055,0.09541944253098156,82.1957851680706,287.51190409640463,245.28499965667726,203.05809521694988,276.6328577314104,16.97512668307695,252.30053574698312,28.291178804853793,271.0709271295384,258.2827518476515,24.035635191858763,22.939033506618266,15714100,7.367975033783854,0.9408820967993508,-73055700.0,-7.465398383543517,91.40936679472856,92.55270083870475,157.8149346042455,33.55627354609795,9.224201524479064,-0.021343738487869284,15.175022125646297,283.46960272216796,269.760201385498,258.6800003051758,247.59979922485348,233.89039788818357,0.14,0.0,271.9093346256422,0.0963359635949208,0.23980733355670994,277.5800018310547,252.8971426827567,25.373490520903225
2022-10-27,0,298.8149948120117,217.86999893188477,295.58250427246094,233.1537504196167,270.23250007629395,0.7498204451881784,23.675158390310653,-0.8162599010558593,2.991277375516626,239.8400001525879,20.25242561340331,0.09538641422708169,222.67699851989747,286.32199935913087,0.8443242518196382,0.22650887189573954,1.20391553046872,1.1343391589249003,1.0507558292052483,0.10091182261138609,83.3296861624975,295.5529416738098,248.20262489318847,200.85230811256713,284.3650000435965,11.417299300969827,257.17785671779086,30.079116590482254,277.2230516992403,262.8328745076521,22.669974460609176,23.818452161565375,14612600,7.386680067856323,0.886561010147831,-58443100.0,-9.254527789274679,91.40936679472856,92.55270083870475,133.90968558627583,31.87123355469305,8.761005024540749,-0.03107369178235677,14.83609143509617,283.46960272216796,269.760201385498,258.6800003051758,247.59979922485348,233.89039788818357,0.14,0.0,272.074570426393,0.10732397966238327,0.09016813686144226,285.5914306640625,258.05357142857144,27.458152932280015
2022-10-28,0,296.7250061035156,217.86999893188477,298.8149948120117,233.1537504196167,273.2531280517578,0.5980838481575502,26.03148768006622,-1.1315496120622068,2.990452429190015,239.8400001525879,23.289962749481198,0.10367243577966384,222.67699851989747,290.8079971313477,0.8648515591849073,0.26063659377041193,1.1817305456208498,1.0948333025375452,1.0236874013861952,0.06453205203756807,85.36353739207777,303.15660004732723,251.09362468719482,199.0306493270624,288.2064296177455,10.1692436107168,262.05678585597445,30.590973550473933,282.6321843079837,266.46384872603124,22.119823649953936,29.619465034102724,9960500,7.208963895514081,0.6077946977456281,-68403600.0,-10.553783488691838,91.40936679472856,92.55270083870475,108.5614159116711,30.465400448917585,9.60863763886492,-0.019237598750623062,14.41208444997738,283.46960272216796,269.760201385498,258.6800003051758,247.59979922485348,233.89039788818357,0.14,0.0,272.1753725222166,0.021238366339503267,0.10277445249933795,288.9257158551897,262.74928610665455,28.877280263492263
2022-10-31,0,293.5325012207031,217.86999893188477,298.8149948120117,233.1537504196167,280.5237522125244,0.4072300905241586,27.621730767623973,-1.4032125209176447,2.989892342030382,241.0575008392334,25.46550064086914,0.10871353355438991,222.67699851989747,295.6967544555664,0.8926833827477489,0.24768735381498438,1.1552844276566632,1.0585653632820036,1.0002589854935886,0.026759250860214134,82.50311706247602,309.32158653524795,254.078125,198.83466346475205,291.3646436418806,7.04049766303392,267.22910744803295,29.22835688542766,286.18788842275694,269.52657063936437,9.965351829925135,29.90325211545189,7505100,7.288878875961281,0.4595807063180636,-75908700.0,-14.643236058968792,91.40936679472856,92.55270083870475,87.9523389763511,29.19988688289691,10.636782517341796,-0.04006959799826108,13.962649479844682,283.46960272216796,269.760201385498,258.6800003051758,247.59979922485348,233.89039788818357,0.14,0.0,272.24019231527785,0.03338641270395559,0.007977337086597328,292.3142874581473,268.2914297921317,29.792280534401097
2022-11-01,0,292.260009765625,217.86999893188477,298.8149948120117,233.1537504196167,286.9812488555908,0.2127972423309394,28.632435484249793,-1.5816372146329012,2.989550770240158,242.92374992370605,26.903875694274905,0.11146935087471609,222.67699851989747,295.6967544555664,0.9151521836007015,0.2171817162430594,1.1378016932277037,1.0343647160762226,0.9907572354036058,0.0068297179517722295,77.9662856712678,314.12862104479353,256.86375007629397,199.5988791077944,293.2964303152902,4.332936779502606,272.54267965044295,26.166341833775544,288.0486452399574,271.6784672288929,8.144974825598382,32.748056547849735,6916400,7.4223196110977,0.4328202182186373,-82825100.0,-20.106499512255045,91.40936679472856,92.55270083870475,74.41206911151164,27.209201355897136,11.492773082597362,-0.06995087196168634,13.913888713727546,283.46960272216796,269.760201385498,258.6800003051758,247.59979922485348,233.89039788818357,0.14,0.0,272.2937268794644,-0.014672493900311667,0.01522388956321563,291.9114292689732,272.9971444266183,30.23324422094846
2022-11-02,1,279.89249420166016,217.86999893188477,298.8149948120117,233.1537504196167,290.7731246948242,0.030328375714647714,29.38704039461626,-1.6766100893571911,2.989305137763033,257.2624988555908,27.888376235961914,0.11328027051838502,222.67699851989747,295.6967544555664,0.919264973201976,0.23778672430731937,1.0789210833574858,0.9741922367328039,0.9475578863253469,-0.053081660260710484,77.91282453127737,318.1929562927726,259.41887550354005,200.64479471430755,292.44071524483815,6.221192877731188,276.61714363098145,21.93179357383629,289.08515961241915,273.2504616978212,4.85134098060577,34.14421957976768,10367600,7.259786176361978,0.649723364967417,-93192700.0,-42.86652710850195,91.40936679472856,92.55270083870475,38.61523686756141,25.191184370019336,17.59129519537433,-0.11253822797698339,13.955038823749732,287.66568243408204,276.5521609191894,267.5699996948242,258.58783847045896,247.4743169555664,0.02,1.0,272.31690712239225,-0.08579464046650143,-0.06192010753194452,290.5614275251116,275.88928767613004,29.88575711618402
2022-11-03,1,271.3499984741211,217.86999893188477,298.8149948120117,233.1537504196167,290.7731246948242,-0.1517400997226624,29.199518620485915,-1.638734399881263,2.9894499394247047,270.63000106811523,27.527975807189943,0.1116156481783143,222.67699851989747,295.6967544555664,0.9363275098964514,0.17245963149918125,1.0372399064697189,0.9411646276668635,0.9285017616749512,-0.09191304591380767,62.76433099425319,320.0067875614064,261.60775032043455,203.2087130794627,289.73678697858537,10.174966554503136,279.2830363682338,18.329072558317907,286.7437953430126,273.18168916440294,-2.095268335612818,25.596812258521616,7057400,8.027064306282968,0.4452514357709,-100250100.0,-51.34072958550856,91.40936679472856,92.55270083870475,20.067342870535896,24.192364989685107,19.032447838658403,-0.13918300246352375,13.493251803985805,288.81972229003907,278.42014068603515,270.01499938964844,261.6098580932617,251.21027648925784,0.04,0.0,272.3142018818181,-0.09389103742704363,-0.09898867471012286,287.4242858886719,278.6792875017439,29.503350266756236
2022-11-04,1,265.7750015258789,217.86999893188477,298.8149948120117,233.1537504196167,290.7731246948242,-0.3015533367438311,28.78383815607754,-1.5286234543721164,2.9896700505731957,271.38750076293945,26.544550704956055,0.10934483287219478,222.67699851989747,295.6967544555664,0.9259254575863086,0.17705745193100056,1.009633356256155,0.9218519965606933,0.9268461936294514,-0.10430534650267898,56.589688077135015,320.8068015639251,263.23912525177,205.67144893961498,285.4785723005022,13.129151229234536,281.0557150159563,15.284583885705906,282.82388766524593,271.9835860203456,-6.520484054932535,15.947911376739324,11124700,8.051350632468111,0.6989501328826423,-111374800.0,-66.03827730766679,91.40936679472856,92.55270083870475,-3.948591618315426,21.755297870555083,24.02577947583767,-0.12551089445483848,13.9330191092493,289.605602722168,279.69220138549804,271.6800003051758,263.6677992248535,253.75439788818358,0.06,0.0,272.275003206872,-0.11811846520896008,-0.1217417444576794,282.02000209263394,279.8000019618443,28.132516928333477
2022-11-07,1,258.2249984741211,217.86999893188477,298.8149948120117,239.22500038146973,290.7731246948242,-0.44403703239770764,27.789199791902355,-1.313839493499281,2.9901305798984836,271.38750076293945,24.50737581253052,0.104864410125992,222.67699851989747,295.6967544555664,0.913085491288786,0.16353648391724823,0.9744293591593262,0.8997096710211429,0.920384790239348,-0.1202848154795465,52.303254790321716,320.5796498508335,265.0012502670288,209.42285068322408,279.6800013950893,15.076365726358269,282.02250071934293,13.075906805536535,278.51039922360917,270.59446889734176,-10.084325802688978,10.299534573925985,7927000,8.18382390193549,0.5012933900669034,-119301800.0,-87.840850342482,91.40936679472856,92.55270083870475,-27.1098670705732,20.71894615622116,24.579583649403908,-0.12162697110122943,13.584946131833377,292.99456286621097,285.17772161865236,278.86000061035156,272.5422796020508,264.7254383544922,0.08,0.0,272.22657671914624,-0.11401945396245461,-0.12552412743121807,276.54285975864957,281.06714521135603,26.988982853792244
2022-11-08,1,261.58499908447266,217.86999893188477,298.8149948120117,243.75687408447266,290.7731246948242,-0.5473085262693923,26.559466469248864,-1.0549788951549486,2.9906583684943726,271.38750076293945,22.641700668334966,0.09966346559314314,222.67699851989747,295.6967544555664,0.8767875945102478,0.1678048106072323,0.9815885264910228,0.9202848916757285,0.9564333469864376,-0.10495794722566343,47.85474652137411,319.6104332207853,266.4915002822876,213.37256734378988,274.6600003923689,14.284460517926503,281.4332150050572,13.831474903457005,273.342959391258,268.7782373612056,-13.583654449277656,5.531488791276941,7683800,8.19889854139676,0.49787584076241004,-111618000.0,-78.7635537867954,91.40936679472856,92.55270083870475,-21.547520920404754,22.346386320067907,23.36254105127503,-0.06788448677124807,13.271734378001165,292.99456286621097,285.17772161865236,278.86000061035156,272.5422796020508,264.7254383544922,0.08,0.0,272.195099945923,-0.0812206052133283,-0.09736882606653643,271.93428693498885,280.4300013950893,24.12508230247693
2022-11-09,1,257.36000061035156,217.86999893188477,298.8149948120117,254.84124851226807,290.7731246948242,-0.6291774029218749,24.486460534313853,-0.7302249409158326,2.991480568872298,271.38750076293945,20.213800659179686,0.0911922362100245,232.9097499847412,295.6967544555664,0.8347479174083,0.2006471766048662,0.9584575906257604,0.9146537036868625,0.9625774536977669,-0.08050410088908677,51.11064755613206,317.48767135854473,268.514750289917,219.5418292212893,269.4925003051758,12.783271481468407,280.42857197352816,15.069712651450114,270.3632474094311,268.23253499206135,-11.84261733801566,-3.0574239916955,7266000,8.110509937664542,0.4796408436688366,-118884000.0,-95.19983766520626,91.40936679472856,92.55270083870475,-51.814511691138264,21.210458970516516,23.63832922610518,-0.11102742157343616,12.983752646670734,292.99456286621097,285.17772161865236,278.86000061035156,272.5422796020508,264.7254383544922,0.08,0.0,272.1491949885358,-0.0671794737651672,-0.1119093159124347,266.6171439034598,279.46571568080356,21.68172732650516
2022-11-10,1,269.1024932861328,222.8499984741211,298.8149948120117,258.0087490081787,290.7731246948242,-0.5456875129268873,21.76384568342506,-0.6770717363962504,2.992439219809989,271.38750076293945,17.90982568740845,0.08046103737337244,240.2645004272461,295.6967544555664,0.8002104875796118,0.15485753813113898,0.9948731526824416,0.9695570302930383,1.0237522537217372,-0.008282679935974424,46.794220877050044,314.01694174069047,270.4892503738403,226.9615590069902,266.1842836652483,8.017218092954126,279.7403569902693,15.369901902531957,267.1073130444286,267.62024947292304,-12.32316709731368,-5.18191112950792,9667300,8.210311940625505,0.6551014945500255,-109216700.0,-57.2655935166402,91.40936679472856,92.55270083870475,-11.008025640510061,26.52445765799972,21.05604953480438,-0.13198062910998487,13.534911876071645,292.99456286621097,285.17772161865236,278.86000061035156,272.5422796020508,264.7254383544922,0.08,0.0,272.14136029310697,0.021965374696111484,0.007216121687557234,264.93428693498885,278.42285810198103,19.807507858445124
2022-11-11,1,281.7050018310547,234.0275001525879,298.8149948120117,260.74499893188477,290.7731246948242,-0.4029521203361034,18.83979788702288,-0.8001032703403612,2.993321116943231,271.38750076293945,15.648813343048095,0.06906036800194114,244.31674880981444,295.6967544555664,0.7976024275432951,0.1498755193756107,1.0326358706767647,1.0259459250121148,1.0735320304260638,0.05993791821547467,53.81422061125628,310.4814708884867,272.8018751144409,235.12227934039515,266.4432133265904,8.545593991302253,279.4419642857143,15.28178371555338,267.61754129657874,269.1291801710072,-7.92360080260831,-3.4566607148790838,9573800,8.245112129420876,0.6615866109873768,-99642900.0,-28.950312899175174,91.40936679472856,92.55270083870475,40.96410996635986,31.77113437339348,18.99420527520788,-0.056078010838252854,13.932418614679522,292.99456286621097,285.17772161865236,278.86000061035156,272.5422796020508,264.7254383544922,0.02,1.0,272.18742738309976,0.11250429608708234,0.0783096986374955,267.38143048967635,278.97142900739397,17.493358285352528
2022-11-14,0,297.11499786376953,240.95750045776367,298.8149948120117,264.72750091552734,290.7731246948242,-0.376697536998413,16.674705382423003,-0.7805862010526927,2.9938798712179087,275.0812530517578,14.155250930786133,0.060594363517744824,256.0930004119873,295.6967544555664,0.7589176027198618,0.1691065905642288,1.0796888925011483,1.0880194743449945,1.1186748245580078,0.15060509098442654,60.593813795841946,308.5351609632103,275.18575019836425,241.83633943351822,270.1239275251116,14.4914416531381,279.9303572518485,15.756600202461053,271.1551986595162,272.2332315017925,0.6475727884609278,-1.461263934738557,17978200,8.521850817481935,1.2557248416042757,-81664700.0,-19.911747168796758,91.40936679472856,92.55270083870475,104.0041397428714,38.19143014935014,16.869678597368893,-0.0863327571141658,14.566531408350748,297.0972391357422,288.49637860107424,281.5449981689453,274.59361773681644,265.9927572021485,0.04,0.0,272.38321735685247,0.1572698451286052,0.14755159019875452,271.6971435546875,279.5607147216797,16.765125492340896
2022-11-15,0,308.66500091552734,244.68999862670898,298.8149948120117,268.27062034606934,292.57813262939453,-0.33762021664694264,15.350165453395956,-0.8922656680815639,2.994196608028821,279.314998626709,13.25951333999634,0.05521768871356118,258.1384986877441,296.76400527954104,0.6641417073353902,0.21425068262409205,1.110331220146818,1.1288340695177166,1.1290962824468245,0.17997974652916282,67.43577329842152,308.69395597545645,277.9936250686645,247.2932941618726,276.25107029506137,20.263757952697294,280.8648212977818,17.087964200216156,277.6716441613426,277.0651868276071,9.495116836017107,2.355505201794863,14626900,9.020704319914087,1.0630400813983065,-67037800.0,-4.1405137746954805,91.40936679472856,92.55270083870475,137.57364706885147,36.50363189188111,15.75171491152964,-0.015661635585678606,14.486065052159367,298.40367260742187,289.5531533203125,282.3999938964844,275.24683447265625,266.3963151855469,0.06,0.0,272.59266135578724,0.17740841975212263,0.19953598176970086,278.7557155064174,280.38785879952565,15.843370804770087
2022-11-16,0,307.5149917602539,257.36000061035156,308.66500091552734,269.6518726348877,294.0450019836426,-0.014531644759967117,14.730093864592469,-1.1534760433512248,2.994358703684468,280.7987480163574,12.863626098632812,0.052384400021517646,261.2489990234375,297.2849975585938,0.7608479151082741,0.1439027626616325,1.0936107053400996,1.1179212887113092,1.0874342680861377,0.19488261979699817,69.5558196484811,310.6525629122904,281.19237518310547,251.73218745392052,283.29249790736606,21.483097691540994,281.4862496512277,17.92848442329355,285.4719311744475,282.97811744592553,16.13771014708175,4.426005076067449,8038600,7.652023766871803,0.679672601168581,-75076400.0,-11.035966645120112,91.40936679472856,92.55270083870475,114.92429790614366,35.21701996163945,15.196527844473804,-0.061606419267375444,13.94277503122548,298.40367260742187,289.5531533203125,282.3999938964844,275.24683447265625,266.3963151855469,0.06,0.0,272.7010783911474,0.20168061184711417,0.16154254512625132,285.5299987792969,281.0364292689732,16.604820561195275
2022-11-17,1,295.2050018310547,257.36000061035156,308.66500091552734,270.788122177124,295.8681297302246,-0.11544871294632136,15.544153827747461,-1.1464214057855795,2.9942200341647593,283.79375076293945,13.560625457763672,0.05491151933043533,261.2489990234375,299.68499450683595,0.8009621197897885,0.13296486433718166,1.0428457762397354,1.0625009688123366,1.0081432301463427,0.09699838981858644,68.37498177783,314.1646824723895,283.07637481689454,251.9880671613996,288.09535544259205,19.48658119324683,281.37767791748047,17.83345307598104,291.00054819569135,287.1547156442476,19.08800215989645,2.9114994559478067,9838200,7.684963439626333,0.8585775723641035,-84914600.0,-28.75287706982899,91.40936679472856,92.55270083870475,54.47459656833042,32.52204407434345,20.4582334551617,-0.012044455366878929,14.01971888827675,298.40367260742187,289.5531533203125,282.3999938964844,275.24683447265625,266.3963151855469,0.06,0.0,272.7888959359522,0.07386259398636019,0.15950677190393578,290.0757141113281,281.00500052315846,16.430131388020737
2022-11-18,1,292.57749938964844,257.36000061035156,308.66500091552734,270.788122177124,295.8681297302246,-0.3013402688633117,15.516908642760555,-1.073501728942828,2.9942328354345484,288.0799980163574,13.465588226318356,0.05458599611749131,261.2489990234375,299.68499450683595,0.8505901955420466,0.059078877434871335,1.0292407214242252,1.0440797206100643,0.9816686312556263,0.03859533017846184,57.51771179921444,315.2991920413805,284.2653747558594,253.2315574703383,293.12642669677734,14.003612102784952,281.30946350097656,17.785144532521933,292.0950589066165,289.16251239286737,12.852420002771355,-0.5122602548470985,8400100,8.190036318272034,0.7899084751468601,-93314700.0,-40.79508818986749,91.40936679472856,92.55270083870475,30.187641482353477,30.67091474195209,21.36355655847204,-0.15144322773005647,13.804024678945916,298.40367260742187,289.5531533203125,282.3999938964844,275.24683447265625,266.3963151855469,0.06,0.0,272.848920094654,-0.007410450006205993,0.04731428776909591,294.8357151576451,280.7264295305525,16.407729631941873
2022-11-21,1,287.6449966430664,257.36000061035156,308.66500091552734,270.788122177124,295.8681297302246,-0.42226205032787495,15.563492300853525,-1.0299566188353966,2.9942278040205217,291.2687530517578,13.466400909423829,0.054616913579402494,261.2489990234375,299.68499450683595,0.8654640027910306,0.023418711190685133,1.0094316635052598,1.0167529375126303,0.9581284051689982,-0.031873184756042616,54.6172396031491,316.08435917446093,284.9573745727539,253.83038997104688,295.77535574776783,9.835190513711192,280.97981970650807,17.608457244303636,292.25624513105254,289.9661386233832,13.684138442561206,-0.3253479008570279,7256500,8.085801207445071,0.7024158400507222,-100571200.0,-45.62851516011916,91.40936679472856,92.55270083870475,7.75567182170329,29.173642377134595,22.621049169114702,-0.13490164326147017,13.475879444395803,298.40367260742187,289.5531533203125,282.3999938964844,275.24683447265625,266.3963151855469,0.06,0.0,272.8877682702025,-0.047515627168528085,-0.017509450950775114,296.2757132393973,280.6050000871931,16.40226600554853
2022-11-22,1,284.0,257.36000061035156,308.66500091552734,270.788122177124,295.8681297302246,-0.4381807663750018,15.573467802806887,-1.025229717969491,2.994226363814944,291.2687530517578,13.536900787353511,0.05463502435395798,261.2489990234375,299.68499450683595,0.8676749301760311,-0.009068907263000229,0.9963321665408057,0.9935367693179703,0.951993073919434,-0.07990864154461563,50.431138316307056,316.1924350257798,285.04549942016604,253.8985638145523,296.10321262904574,9.312335433433473,281.2732129778181,17.623160160396246,291.1627137724862,289.41920512666456,6.890498534778574,-1.5790778650351642,6245100,8.108576994563,0.6315840572330387,-106816300.0,-42.92311301472619,91.40936679472856,92.55270083870475,-4.3875953315055085,27.65202927872286,24.31958038754584,-0.1042869902797834,13.20188909851373,298.40367260742187,289.5531533203125,282.3999938964844,275.24683447265625,266.3963151855469,0.06,0.0,272.9140598645055,-0.07578984152306911,-0.04203557668353749,295.78428431919644,281.58285740443637,16.339717328532725
2022-11-23,1,288.4100036621094,257.36000061035156,308.66500091552734,270.788122177124,295.8681297302246,-0.3833162541786841,15.528050291936415,-1.0361119472076248,2.9942333545794946,289.9525032043457,13.35896339416504,0.05453574155513038,261.2489990234375,299.68499450683595,0.8597157067979754,-0.039185351314922415,1.0129187583710209,1.0011142572288134,0.9830310516672971,-0.06212701367430973,47.0285589610828,315.7877251871443,284.7316246032715,253.67552401939867,294.8596420288086,9.726716021110848,282.4917847769601,17.473407964183803,289.43306182332043,287.9050693738652,0.8146813702376781,1.4675298135649257,5919000,8.03832356687241,0.629798770833688,-100897300.0,-34.98844137825491,91.40936679472856,92.55270083870475,26.037931038091894,29.360798278909098,23.144967202690015,-0.10221273184874179,12.881039263236586,298.40367260742187,289.5531533203125,282.3999938964844,275.24683447265625,266.3963151855469,0.06,0.0,272.951711296327,-0.047447845026303725,-0.060283724923101016,294.6742858886719,283.1857147216797,16.08582532957761
2022-11-25,1,286.9800033569336,257.36000061035156,308.66500091552734,270.788122177124,295.5850028991699,-0.3432878315628693,15.355167797899712,-0.9938093335451623,2.994263999334954,288.0275001525879,13.036200866699222,0.053996574291404385,261.2489990234375,299.68499450683595,0.8442828637486582,-0.03482084677995579,1.0091675503233306,0.9855285638444586,0.9910642701770219,-0.027861988865718,49.71597511164895,315.08333516855333,284.3729995727539,253.66266397695443,291.7617852347238,7.873772728956985,284.0064277648926,16.819711588357663,289.21845036850084,286.74485766739673,-2.92984004989593,6.287085050275137,3236000,8.072174650072911,0.3665024050304607,-104133300.0,-44.82016677439948,91.40936679472856,92.55270083870475,14.838267632417752,28.129479171831793,22.174324644588268,-0.06868491357482616,12.484535495461087,298.40367260742187,289.5531533203125,282.3999938964844,275.24683447265625,266.3963151855469,0.06,0.0,272.96852526262717,-0.03298560781170634,-0.0669236690542951,291.15142822265625,284.95357186453685,15.798758677753607
2022-11-28,1,283.8125,257.36000061035156,308.66500091552734,270.788122177124,293.950626373291,-0.2933562057789885,15.011404752947039,-0.9020033071087332,2.994324556158931,287.3125,12.525501251220703,0.052897803336009824,261.2489990234375,298.154997253418,0.8425519720096553,-0.03284186551901994,1.0001101200308335,0.968703682963401,0.9857253233017947,-0.029957872385720896,49.03588414443196,313.8040595058941,283.78125,253.7584404941059,288.37571498325894,4.217959609329269,285.8341064453125,15.105589524769746,288.682948022889,285.5337979113791,-7.0254150921789495,7.978553930697626,4703400,8.066881126176208,0.5490421762307018,-108836700.0,-53.92371908588125,91.40936679472856,92.55270083870475,4.795809008594398,26.648454481198247,23.131541002433046,-0.08102319046984113,12.237067887222748,298.90635375976564,290.3668151855469,283.4649963378906,276.56317749023435,268.0236389160156,0.06,0.0,272.98821841139454,-0.02364746613929758,-0.047785103663959376,287.6014317103795,286.56571524483815,15.530801857848797
2022-11-29,1,280.5899963378906,257.36000061035156,308.66500091552734,270.788122177124,292.8162498474121,-0.21372719324836326,14.71558521931349,-0.8071388214705055,2.994375296138502,285.4900016784668,12.009001007080077,0.05197362654443284,261.2489990234375,298.154997253418,0.8441677584083187,-0.03311388408534286,0.991009155560423,0.9570162837588886,0.9805027985852753,-0.024526761763668747,47.228563390770965,312.56679513345125,283.13562469482423,253.7044542561972,286.28785705566406,3.877527143472766,287.1916062491281,13.530612177176518,287.4535464647994,284.48316936759414,-7.70775162036098,9.908994743761513,5786900,8.066445948212532,0.6823655512051265,-114623600.0,-54.28279244495461,91.40936679472856,92.55270083870475,-12.741821690725992,25.522206729253746,24.917291337874115,-0.04885671713362363,11.864419392904182,298.90635375976564,290.3668151855469,283.4649963378906,276.56317749023435,268.0236389160156,0.02,1.0,273.00383636468285,-0.014348347704056685,-0.024376759717476628,285.5557163783482,287.81571524483815,15.378589280096312
2022-11-30,1,293.8925018310547,257.36000061035156,308.66500091552734,270.788122177124,292.33938217163086,-0.10700917131914608,14.527523408246028,-0.7354121323371965,2.9944061567868627,283.90625,11.681151123046874,0.05142695520878088,261.2489990234375,298.154997253418,0.8401901415019222,-0.039930243748000374,1.0403697934696345,1.0080692270231575,1.0320763072502923,0.03483275292624888,45.047437258968564,311.54354626717566,282.4884994506836,253.43345263419153,286.47571454729353,4.247259683225312,289.8010706220354,10.523432106066391,285.7176434347708,283.30237951842076,-4.950798733934802,7.265323822059367,16070100,8.0878513349301,1.7978861823181735,-98553500.0,-13.644989247511386,91.40936679472856,92.55270083870475,84.79726176500533,35.51305535549186,21.10622863237491,0.0626822253689627,13.006247024624052,300.2916726074219,292.6091533203125,286.3999938964844,280.19083447265626,272.50831518554685,0.02,0.0,273.158933229644,0.06571556795651134,0.07184708599672952,288.0628574916295,291.4492863246373,16.230177885258048
2022-12-01,0,310.94249725341797,257.36000061035156,308.66500091552734,270.788122177124,292.90625,-0.11363837679802888,14.586662285255738,-0.7609482614456988,2.994395953174558,283.90625,11.754613265991214,0.051621388970585234,261.2489990234375,298.154997253418,0.8344005613030794,0.050019232095976265,1.1004082554532388,1.0719835546258931,1.0844170655626213,0.07812660207759947,57.651177414565694,311.74344862446645,282.57012405395506,253.39679948344363,289.8039289202009,10.23028549524677,292.7896423339844,10.126663459851603,287.68508023262814,284.2167483825559,0.4494543989710425,14.195096803723628,14664900,8.15542024762947,1.6021618680690186,-83888600.0,-5.907910785410267,91.40936679472856,92.55270083870475,147.23860108536402,38.51784767224709,19.201741470936977,0.16947399398764568,13.275085740211725,308.41535009765624,301.3723115234375,295.67999267578125,289.987673828125,282.94463525390626,0.02,1.0,273.38412039471336,0.08730707446665953,0.10554958145709858,292.6200038364955,294.44785853794644,17.713499446510337
2022-12-02,0,315.72249603271484,257.36000061035156,310.94249725341797,270.788122177124,294.2206268310547,-0.09574644459941417,15.819341100927742,-0.8843879813301156,2.99417780214573,285.4900016784668,12.772125244140625,0.05567786495392873,261.2489990234375,307.62999267578124,0.762819036345191,0.14590933849985943,1.111219132634789,1.0871780871902796,1.0840499317491221,0.10015503637733447,68.33526600944958,315.7613064083984,284.122624206543,252.48394200468752,294.3357140677316,13.676497125708241,295.2194633483887,11.278063009488344,293.4134034983485,287.73386647371893,8.099393656153532,15.547980792135315,12690600,8.612253048023907,1.345076315428271,-71198000.0,-3.431024953511212,91.40936679472856,92.55270083870475,147.6197604095863,37.20217611247159,17.954336403973485,0.2487476881383584,13.183293203419712,311.1221931152344,304.39889489746093,298.9649963378906,293.5310977783203,286.80779956054687,0.04,0.0,273.59730315201807,0.12211947213590446,0.09917668494720197,297.43714686802457,296.6107155936105,18.931972704047656
2022-12-05,0,315.68499755859375,257.36000061035156,315.72249603271484,277.7181205749512,295.6825008392334,-0.12723936045168183,16.94402116042799,-0.8404201135017213,2.993974855804705,287.3125,13.491625061035155,0.05917422381373137,261.2489990234375,308.8927505493164,0.7588167845848881,0.18793149927598618,1.1024782442904846,1.079422712726521,1.0629410872183205,0.11230124662794538,71.52611824124868,320.22929140532864,286.3412490844727,252.45320676361672,298.23214176722934,15.474076503500127,296.54589189801897,12.539612403058218,298.89595091014064,291.57882561650786,11.16989296926579,12.075573376599564,8423000,8.436186684851052,0.9057213242908158,-79621000.0,-21.738192600316058,91.40936679472856,92.55270083870475,122.88340558346562,35.22193551975595,16.79319896401369,0.24635084217320688,13.088056230105767,311.7181121826172,304.8809341430664,299.35499572753906,293.82905731201174,286.99187927246095,0.06,0.0,273.73113503225875,0.11174727534816498,0.09473274141445988,300.4500034877232,297.5621446881975,18.58857258478247
2022-12-06,1,308.22750091552734,257.36000061035156,315.72249603271484,281.4262504577637,299.7149963378906,-0.2283351036118363,17.400476591709307,-0.7443042813355794,2.993906794161649,288.0275001525879,13.778924446105957,0.060243291959260044,261.2489990234375,311.41674728393554,0.7453217038371183,0.22251911869110227,1.067133950593887,1.0456613393631349,1.016023533079628,0.09849782578975197,73.39208056547622,323.637702069527,288.8367488861084,254.03579570268982,301.2674985613142,14.974896279241731,296.51464189801897,12.507591368170676,303.0098691066971,295.18123003811576,9.457020751762398,6.250105120354364,7195400,8.119975843769518,0.7767734441374947,-86816400.0,-36.749938906176176,91.40936679472856,92.55270083870475,76.34291034122623,33.25012238520267,20.17521946207736,0.2084901911468415,12.873909093618257,311.7181121826172,304.8809341430664,299.35499572753906,293.82905731201174,286.99187927246095,0.06,0.0,273.822643415657,0.08755697199488588,0.08674461345831969,303.3100019182478,297.230715070452,17.287618316784453
2022-12-07,1,306.6575012207031,257.36000061035156,315.72249603271484,283.2856254577637,307.69311904907227,-0.325853736714709,16.38511702862225,-0.583454848829001,2.994138996624973,290.4937515258789,13.217874526977539,0.05624113694637319,268.3507438659668,311.41674728393554,0.7540424441058813,0.17830725001165912,1.0525873261484033,1.0331212335027198,0.9927596602496687,0.04343424657015049,65.37967192897071,324.1071080654232,291.3368740081787,258.56663995093425,304.53107016427174,12.879596060459447,296.45339257376537,12.451553258878297,304.29587580463215,297.7061737325679,7.403825113266519,-0.14173942581839108,7821600,8.449044544020657,0.8437467637819739,-94638000.0,-30.64270702660432,91.40936679472856,92.55270083870475,66.05445727032179,31.822166807650028,19.897782619866977,0.21931425121579437,12.490771245297625,311.7181121826172,304.8809341430664,299.35499572753906,293.82905731201174,286.99187927246095,0.06,0.0,273.9197985717873,0.00945902091442452,0.09773641375215786,307.2028590611049,297.4021453857422,16.173082506934655
2022-12-08,0,309.13999938964844,257.36000061035156,315.72249603271484,283.953125,307.69311904907227,-0.43021255802865876,15.19442699660176,-0.2927604938514312,2.9943814134872833,293.23500061035156,12.372249603271484,0.05175381029837269,279.44124603271484,311.41674728393554,0.681764196808243,0.19155074795398766,1.0529632270851106,1.033595012835199,0.9925926426745434,-0.005796884889299969,64.8522348544487,323.9793531081937,293.5904991149902,263.2016451217867,308.6096420288086,7.38159808294228,297.4487495422363,12.893219856222704,304.9296327879475,299.77122254317254,8.049328771883946,-0.27884511732010175,7205300,8.358886417134816,0.7775186156968051,-87432700.0,-26.713608445610205,91.40936679472856,92.55270083870475,72.0901453153155,32.03462876938687,19.011484701096407,0.27052632664561127,12.13928810619648,311.7181121826172,304.8809341430664,299.35499572753906,293.82905731201174,286.99187927246095,0.06,0.0,274.0154140543195,-0.021107437083915825,0.015481330819318018,311.3885759626116,298.4721461704799,13.430160325832937
2022-12-09,0,322.49500274658203,269.1024932861328,315.72249603271484,286.2350025177002,308.33687591552734,-0.12826798244854765,13.062334703870857,-1.0378555980804776,2.9947572826459647,294.5487518310547,11.405449142456053,0.04410276452487108,281.59350128173827,311.41674728393554,0.6740106866953073,0.14878162448292265,1.0888498487460574,1.0708249743501461,1.0366730917573026,0.021450820891665057,64.62887348461292,322.3041684616968,296.17949905395506,270.0548296462133,312.69571358816967,5.571730770795858,299.5857140677316,14.41342754184877,306.07512805717283,301.7475574860629,10.174989637683831,4.720447645588582,14364000,8.0764907661342,1.5117008423596172,-73068700.0,-16.94306567663789,91.40936679472856,92.55270083870475,137.51081721900348,38.048032694326466,16.993509312304784,0.14779723254531277,12.610766831981026,316.4778405761719,308.7310809326172,302.4700012207031,296.20892150878905,288.46216186523435,0.08,0.0,274.2781752180815,-0.0012483814235282331,0.009654511565675424,313.45714896065846,300.76000322614397,13.187925870557889
2022-12-12,0,316.80249786376953,280.5899963378906,322.49500274658203,287.4787483215332,308.7837505340576,0.14900768819246998,12.70687854715066,-1.312091429517892,2.9948297788639913,296.1599998474121,11.540786705017092,0.04251937685031964,283.6017501831055,315.68874740600586,0.6599390728322115,0.14479686427431662,1.0600750407591417,1.0396630919618253,1.0139594275157437,0.0035399221179914786,70.03166347371284,324.26288162127884,298.84912452697756,273.4353674326763,313.5328565325056,5.703089135116704,301.66839272635326,14.65978492256534,310.2755839816002,304.5858006507269,9.73230032659003,10.225496977500004,10148600,8.129530572440581,1.064841531820595,-83217300.0,-26.046000678679682,91.40936679472856,92.55270083870475,86.56083389038808,34.989593604486444,21.61280442979067,0.09370762464152392,12.733568242568076,316.4778405761719,308.7310809326172,302.4700012207031,296.20892150878905,288.46216186523435,0.08,0.0,274.43520754506085,0.008285602124934899,-0.01632287046768824,313.2042890276228,302.91214643205916,13.391570286885193
2022-12-13,0,324.56500244140625,280.5899963378906,322.49500274658203,288.21875190734863,309.5906238555908,0.0001447653725682019,12.641412516031998,-1.3586622495767082,2.9948476048135775,301.8862495422363,11.581249237060547,0.04205337435385449,283.98125,315.8304962158203,0.7789862412537342,0.06626222217508836,1.0797095287032406,1.0537294498944603,1.0380615707824155,0.05300468477780762,62.08343536362041,325.8868243606772,300.60399932861327,275.3211742965493,314.7960717337472,7.081608666119849,304.5658929007394,14.905771610479896,311.9850389934828,305.9486222883335,1.884593023505457,10.136627287449103,10756400,7.670183316649525,1.1730590335600626,-72460900.0,-21.803460987967647,91.40936679472856,92.55270083870475,114.78214495311569,36.848288079042526,19.542145487035317,0.06527165592416931,13.076885408493139,319.31992150878904,311.0300416870117,304.3300018310547,297.6299619750977,289.3400821533203,0.1,0.0,274.6310729369571,0.048370201915788114,0.024792859946876626,313.1942879813058,305.3157174246652,14.042351593151382
2022-12-14,0,318.9824981689453,280.5899963378906,324.56500244140625,288.21875190734863,312.1281223297119,-0.030849490536865136,13.638892200970332,-1.3610324260331816,2.994711274505122,307.0862464904785,12.467599296569825,0.04516540929826078,283.98125,317.3717483520508,0.7822763382989343,0.0515121619837627,1.0563156359397838,1.0210282493026188,1.0096555506547342,0.04019140865356441,64.97638878450924,329.25428395943584,301.9764995574951,274.6987151555544,315.2671432495117,7.258072590397509,306.7496425083705,14.593015801650937,315.14617841953213,307.836573826545,2.8007210508608025,14.28345156387544,7543300,7.440113615249486,0.8557005677596465,-80004200.0,-26.224048905521812,91.40936679472856,92.55270083870475,84.95858266279824,34.74518112751375,19.968746234981484,0.011494334238919818,12.877820594761776,319.31992150878904,311.0300416870117,304.3300018310547,297.6299619750977,289.3400821533203,0.1,0.0,274.7551019010222,0.030510254636040735,0.040155743918406726,313.94285801478793,307.1964307512556,14.368641360316081
2022-12-15,0,295.6175003051758,280.5899963378906,324.56500244140625,288.21875190734863,315.694372177124,-0.05523009540313043,14.07041756713588,-1.4488562680988855,2.99464892010974,307.0862464904785,12.931886672973633,0.04651494965486925,283.98125,319.333748626709,0.8242155060893697,0.0372908856997507,0.9772725704964683,0.9387006970194528,0.9284556707250348,-0.043742314521481696,59.7085689489038,330.6332095544377,302.492374420166,274.3515392858943,313.46571459089006,10.246248041190606,307.36660657610213,13.856923748509155,316.07846141921186,308.64943955970244,1.044554108004299,10.60035855852405,17724600,7.567162086877163,1.9059426967681579,-97728800.0,-74.5156718355211,91.40936679472856,92.55270083870475,-42.74903539065206,29.27525253925209,30.85184088530657,-0.027773179180201727,14.192261898513982,319.31992150878904,311.0300416870117,304.3300018310547,297.6299619750977,289.3400821533203,0.02,1.0,274.877132521,-0.06397861625322132,-0.05839442637157173,311.778573172433,307.5442875453404,14.598842489523816
2022-12-16,0,290.7225036621094,280.5899963378906,324.56500244140625,288.21875190734863,315.694372177124,0.06369194230216453,14.096972554908994,-1.4584251916258637,2.9946425542962185,301.13750076293945,13.02449951171875,0.04669456541387067,283.98125,319.333748626709,0.802048530389297,0.0013973288784489021,0.9629841380238295,0.9276714885901491,0.9209040549936149,-0.09852090362293031,44.7181279803177,330.0914449572302,301.8974998474121,273.70355473759406,311.1892863682338,13.320038722518055,307.8601782662528,13.053163507107609,310.92999069277414,306.312817777524,-4.091134169694823,3.0097905244984036,14080000,8.853415826263921,1.4802759537161445,-111808800.0,-73.98733826838809,91.40936679472856,92.55270083870475,-51.46876218934534,28.350219681063827,29.87699134246352,-0.05021905600061073,13.608528119022434,319.31992150878904,311.0300416870117,304.3300018310547,297.6299619750977,289.3400821533203,0.02,0.0,274.9622458322683,-0.09155969318586687,-0.06301172466704699,309.24857003348217,308.22571454729353,14.74268793020683
2022-12-19,0,289.10250091552734,280.5899963378906,324.56500244140625,288.21875190734863,315.694372177124,0.09008166139271455,14.236535875745899,-1.4972656988979143,2.9946196964019944,301.13750076293945,13.248624420166015,0.0471918871813804,283.98125,319.333748626709,0.7891987371126613,-0.006340185870098708,0.9583295210391674,0.9299204396360201,0.9345845012872239,-0.08743616964836454,42.32724682829222,330.1464466904566,301.67337493896486,273.2003031874731,308.32678658621654,15.762877111086116,308.46821430751254,11.825714275601271,305.874758986447,303.93909652427647,-5.196350161062991,2.4347073022186745,6163700,8.90346336190604,0.6557183465391195,-117972500.0,-84.9168715368002,91.40936679472856,92.55270083870475,-62.852675039820355,27.402274586095636,30.28213444929509,-0.023632195868751656,13.073632902901487,320.374841796875,312.7375821533203,306.56500244140625,300.3924227294922,292.7551630859375,0.04,0.0,274.9936342858753,-0.08528461675060506,-0.09909071905557154,306.1114240373884,308.75,14.727232789573376
2022-12-20,1,284.87999725341797,280.5899963378906,324.56500244140625,288.21875190734863,315.694372177124,0.10312537945763277,14.367092983294718,-1.5257642671431644,2.994598142108119,301.13750076293945,13.42237434387207,0.04765210896221713,283.98125,319.333748626709,0.7783238359107495,0.005067024594450112,0.9448767879528881,0.9242411226904409,0.9377283465434231,-0.12227136286868334,42.09162098479122,330.23381098184825,301.4996250152588,272.76543904866935,302.9532143729074,16.521180352522492,307.8244639805385,12.878630249944083,301.64099106032035,301.4513058460493,-6.481690662380214,3.0337876220597098,6918100,8.839283318025807,0.7373015027176809,-124890600.0,-85.78307770723703,91.40936679472856,92.55270083870475,-76.49722508954929,26.10147929126588,31.82624304255893,0.02230154431760378,12.74480206748593,320.4692403564453,312.89037982177734,306.76499938964844,300.63961895751953,293.06075842285156,0.06,0.0,275.0216334205343,-0.10036209734663593,-0.08563357719897853,301.56570870535717,307.5114288330078,14.556470309907345
2022-12-21,1,293.7774963378906,280.5899963378906,324.56500244140625,288.05250358581543,315.694372177124,0.09704873751382574,14.512315897785028,-1.5362727382807397,2.9945739345854947,301.13750076293945,13.560624313354491,0.04815585904325207,283.98125,319.333748626709,0.7552038749681218,0.003098581878232284,0.9748346027863267,0.9603820114217707,0.992957829106524,-0.07901688016031883,40.15222466858191,330.3860068413464,301.36137504577636,272.3367432502063,299.6639284406389,15.568942032573323,306.59839248657227,13.366773307889071,297.3844959220552,299.15158423915307,-11.663748328752273,-3.0665990188540415,6376200,8.853010927618424,0.6790737154210184,-118514400.0,-66.96206379002308,91.40936679472856,92.55270083870475,-36.59053186460867,30.374127551856787,29.32038434219353,0.012036506408032046,12.84588789595101,320.4692403564453,312.89037982177734,306.76499938964844,300.63961895751953,293.06075842285156,0.06,0.0,275.06806661794974,-0.06251768541880365,-0.06986328631659953,299.10570853097096,306.1549987792969,14.152159713432049
2022-12-22,1,296.3824996948242,280.5899963378906,324.56500244140625,288.92937660217285,315.694372177124,0.08807154400606491,14.077400604135027,-1.4777601750972624,2.9946456586422943,301.13750076293945,13.071749496459962,0.04663703478973315,284.7732475280762,319.333748626709,0.7735935207753193,0.018610632806168568,0.9818858849037418,0.9729948434922354,1.019126951398931,0.002587801428733716,46.39579799431085,330.00505107094097,301.8502498626709,273.6954486544009,295.63785661969865,11.042276668576523,305.2169641767229,13.350645487698479,296.43647028177156,298.3691960038197,-7.267935600615134,-5.520313584391739,7856200,9.024475631050215,0.8281526793841509,-110658200.0,-67.36659363063914,91.40936679472856,92.55270083870475,-35.18842155493952,28.97397753752021,27.96880851546442,0.017476425154794896,12.504753568528514,320.4692403564453,312.89037982177734,306.76499938964844,300.63961895751953,293.06075842285156,0.06,0.0,275.12718604515686,0.025274598826942274,-0.06317838914076158,295.8785661969866,304.53642708914623,13.966804134611943
2022-12-23,1,295.3774948120117,280.5899963378906,324.56500244140625,290.31750297546387,315.694372177124,0.04985769969606208,13.801344490126171,-1.406768488967386,2.9946899707571264,301.5200004577637,12.673124694824219,0.045662186519154664,284.7732475280762,319.333748626709,0.760969665470863,0.03276359407591266,0.9772658215521013,0.9737738337566456,1.0151371269695988,0.01601180194606666,48.56521155604026,329.85156364455895,302.24887466430664,274.64618568405433,292.2657132829939,4.224675304632563,303.7664282662528,13.22845193194717,296.3887459554968,298.2151295880468,-8.683161318870114,-6.12563139494711,4251100,9.02915309724763,0.44574019336973125,-114909300.0,-72.74129667069766,91.40936679472856,92.55270083870475,-42.74515805261419,27.851765974524966,26.88552886293452,0.02359425434664178,12.07941315498104,320.4692403564453,312.89037982177734,306.76499938964844,300.63961895751953,293.06075842285156,0.06,0.0,275.1579531991589,0.014619380567993723,0.01566746233116211,292.6114240373884,303.27714102608815,13.508867286290537
2022-12-27,1,288.26500701904297,280.5899963378906,324.56500244140625,293.0137481689453,315.694372177124,0.026594211056528348,13.45379822139313,-1.3243624019368225,2.9947441905993166,301.5200004577637,12.253250122070312,0.044450569328040056,284.7732475280762,319.333748626709,0.7302090591289256,0.040748715479451116,0.9524108707809273,0.9588984396912198,0.9875336041606715,-0.002896875308349811,48.39823707504284,329.5763456798468,302.6687492370605,275.76115279427427,291.2153570992606,4.166047810511997,302.34053584507535,13.775183230534578,296.1486793458113,298.7271886824443,-7.400093576429225,-6.43283744987368,5778100,8.99583832096195,0.6024561811424469,-120687400.0,-93.52722860315805,91.40936679472856,92.55270083870475,-91.22670826878606,25.74807573187386,30.612422296000847,0.025122846001391256,12.133025542047857,320.4692403564453,312.89037982177734,306.76499938964844,300.63961895751953,293.06075842285156,0.06,0.0,275.1818971260685,-0.014325267222002669,-0.02249657122071891,291.7199968610491,301.74928501674106,13.266149037284997
2022-12-28,1,279.3500061035156,280.5899963378906,324.56500244140625,293.0137481689453,315.694372177124,0.05889343657376896,13.173860757755191,-1.321438682986195,2.9947867306179616,301.5200004577637,12.030624771118164,0.04349368078134954,287.92650604248047,319.333748626709,0.6692461134999027,0.02735311586771605,0.9222778512048498,0.9381488597092379,0.9575421897452511,-0.019411651232863036,43.92917966022557,329.239096103523,302.8913745880127,276.54365307250237,289.59071459089006,6.140075093711615,300.39000047956193,14.996122017236317,294.22328186727316,298.4817814849023,-2.4871644197459855,-6.476545356008089,5964400,9.124054700829488,0.6213059049269879,-126651800.0,-94.14938229043926,91.40936679472856,92.55270083870475,-135.18683698142397,23.958721129188433,33.62928174171417,-0.0006305673485812784,12.107809344657,318.722841796875,310.06358215332034,303.06500244140625,296.06642272949216,287.4071630859375,0.08,0.0,275.1890202414025,-0.03924493376862803,-0.03961145818138938,289.7442844935826,299.4964272635324,13.653862488708986
2022-12-29,1,287.70249938964844,279.3500061035156,324.56500244140625,293.0137481689453,315.694372177124,0.029758095132688196,13.281151728621337,-1.2785401494403186,2.9947704469264327,301.5200004577637,12.092624282836914,0.04385688054626577,287.92650604248047,319.333748626709,0.6997419653310647,-0.049482363915153156,0.950048189074014,0.9810969092322007,0.989925347147616,-0.020678905035173223,35.640044005381455,329.39167853353666,302.82937507629396,276.26707161905125,289.3907143729074,6.181290808851364,298.85875047956193,15.127844458102246,290.5744847478243,297.24835078405897,-3.911805042726026,-8.904884116150853,9588500,8.814489437047548,1.0337225222894229,-117063300.0,-70.13995585216134,91.40936679472856,92.55270083870475,-70.93169553761383,27.281544939556486,30.071892423226025,-0.049855490322115455,12.572965472148484,318.722841796875,310.06358215332034,303.06500244140625,296.06642272949216,287.4071630859375,0.08,0.0,275.2373390464753,-0.02295608985786224,0.010166878278079635,290.1471426827567,298.1292833600725,13.898040915379887
2022-12-30,1,289.6600036621094,279.3500061035156,324.56500244140625,290.31750297546387,315.694372177124,0.04134135658738464,13.555107308501386,-1.3447985131557807,2.9947284887349386,301.5200004577637,12.402124404907227,0.04480732814844811,287.4202491760254,319.333748626709,0.7881668290799541,-0.07474050047533047,0.9574908217383729,0.9984222031008434,1.0008448139685497,-0.022681825140272394,39.56947413995282,329.63008957122634,302.5198749542236,275.4096603372209,290.07357243129184,5.855368167693999,296.5133934020996,13.655110448307186,289.87109274397324,297.0355226122512,-0.484257839847595,-6.934560407040563,7566900,8.071964539609064,0.8482311003497445,-109496400.0,-63.80036738411192,91.40936679472856,92.55270083870475,-55.604301993381995,25.446049092597182,28.0486626620329,-0.06462040838233661,12.517039977248096,318.722841796875,310.06358215332034,303.06500244140625,296.06642272949216,287.4071630859375,0.08,0.0,275.2801903799259,-0.009638942459068045,-0.01033691321181951,291.1028573172433,296.3342830113002,13.553885623879847
2023-01-03,1,295.02500915527344,279.3500061035156,324.56500244140625,289.52062797546387,315.694372177124,0.22074720961421518,13.686868121453879,-1.343478767798889,2.994704438654508,296.0,12.517574386596682,0.04540257768837943,287.4202491760254,319.333748626709,0.787799356265526,-0.08254873408800398,0.9786677112195549,1.0190072196704985,1.0241399061514906,-0.0011933395838522598,40.30924753999322,328.82948651756595,301.4557502746582,274.0820140317505,290.2517885480608,6.003989849969934,294.95785849434986,12.343476699927633,289.81381720988156,296.3262277595208,1.6779017322298349,-10.181552831773502,6764000,7.985628714260334,0.7842800775004145,-102732400.0,-63.6823310882082,91.40936679472856,92.55270083870475,-35.25327956329981,25.97633969883968,26.4722505595086,-0.10965199763280387,12.315108724357758,318.722841796875,310.06358215332034,303.06500244140625,296.06642272949216,287.4071630859375,0.08,0.0,275.32549792154236,-3.383254792499457e-05,-0.009403821303001679,290.672860281808,294.8892844063895,12.841113664549828
2023-01-04,1,303.5750045776367,279.3500061035156,324.56500244140625,289.52062797546387,310.77624893188477,0.40444419841427504,13.347288635054,-1.1416013120064885,2.994750640738342,295.49749755859375,11.918799285888667,0.04442863231025622,287.4202491760254,319.333748626709,0.784132062936436,-0.06544494848693481,1.0104990328554175,1.0469827465588626,1.0540780284678808,0.05311084309856029,45.23074664829005,327.1154532008941,300.4208759307861,273.72629866067814,291.27928924560547,7.624735264614896,293.4585729326521,9.392716714902436,291.08110233251614,296.1445495883929,0.42464546567854716,-6.874153093913036,9345100,8.123073405224746,1.0777947252633187,-93387300.0,-29.824544704990725,91.40936679472856,92.55270083870475,33.56308307883486,30.823241792611153,24.041060386752864,-0.03222678403367036,12.59188684742435,312.6031943359375,305.1133961181641,299.05999755859375,293.0065989990234,285.51680078125,0.02,1.0,275.42550144329846,0.08882003392941962,0.048989736322364794,292.3385750906808,294.10857064383373,12.696194635604163
2023-01-05,1,308.8574981689453,279.3500061035156,324.56500244140625,289.52062797546387,308.4556255340576,0.5059808430918793,12.908572345734582,-0.8916346758544162,2.994811544419426,295.49749755859375,11.19219970703125,0.04305507111017655,287.4202491760254,319.333748626709,0.793172947788352,-0.015094358303757216,1.030158966492466,1.0599108655318092,1.0611380487401874,0.10562910836126993,53.424875907424465,325.63252097320736,299.8153762817383,273.9982315902692,293.2050040108817,10.124714199426577,292.73535864693775,7.46908628458508,294.1909047546394,297.0765419621279,2.4267643636916474,-6.467116819706665,8328400,8.247857880595605,0.9543010521672124,-85058900.0,-10.988426970749677,91.40936679472856,92.55270083870475,56.87246733109325,30.864608318263347,22.705326062038626,-0.007329811867245861,12.380323849653777,304.55827526855467,298.6058568725586,293.7949981689453,288.984139465332,283.03172106933596,0.04,0.0,275.526267348446,0.11853512982315051,0.08984057983932657,294.4442923409598,293.5278581891741,12.82701799986914
2023-01-06,1,311.8949966430664,279.3500061035156,324.56500244140625,289.52062797546387,308.9281234741211,0.4995137574473802,12.929812610094189,-0.9073574398000788,2.994808632420362,295.49749755859375,11.229999542236328,0.0431213850761182,287.4202491760254,319.333748626709,0.7836657232383035,0.007174117507266967,1.0401809105153217,1.0615994351016727,1.0502787997938263,0.08408858909721517,57.38464595138269,325.70650136459756,299.8468761444092,273.9872509242208,296.58071681431363,11.973604452526672,293.8980369567871,9.051535121477093,297.9314615307856,298.9189462913644,4.563652815023272,-3.1741553402210214,8959800,8.331425557717951,1.0199979850036458,-76099100.0,-2.8136569023521627,91.40936679472856,92.55270083870475,68.30342783514533,30.033062868991095,20.99875096403682,0.0037915858089546286,12.430299758477199,306.53703247070314,300.206474609375,295.0899963378906,289.97351806640626,283.6429602050781,0.06,0.0,275.64202715611714,0.08391726121713905,0.13966332789730715,298.9271458217076,295.32357134137834,13.165863933623632
2023-01-09,1,316.7300033569336,279.3500061035156,324.56500244140625,289.52062797546387,309.82874870300293,0.4503016315760906,13.116787160635738,-1.030545445946764,2.9947828114909787,295.49749755859375,11.54424926757813,0.04370678002764326,287.4202491760254,319.333748626709,0.7758446944543337,0.008911811020435098,1.0553840979001798,1.0714491145295224,1.0494611568650776,0.09345439257261612,58.97950818815386,326.34232523679884,300.10875091552737,273.8751765942559,301.92071642194475,11.326152681767958,295.7557155064174,10.841497371739194,301.50334271921537,301.1215150059064,8.197314640573916,5.506269527712948,6766600,8.34064003099309,0.7722489785670266,-69332500.0,-13.522463499301995,91.40936679472856,92.55270083870475,89.58891616450869,31.43434552056238,19.95173768992308,-0.03513988848903308,12.148136274409225,310.3035701904297,303.2532289428711,297.5550079345703,291.85678692626954,284.80644567871093,0.08,0.0,275.7401867802947,0.06880767840798585,0.0826120455960635,304.3971470424107,297.07071576799666,13.402499035486134
2023-01-10,1,319.75750732421875,279.3500061035156,324.56500244140625,289.52062797546387,313.1037483215332,0.4093555506383041,13.477433516914187,-1.178321610179802,2.9947319847477587,295.49749755859375,11.99964950561523,0.04485178194806008,287.4202491760254,319.333748626709,0.7363935908459526,-0.017876244098512743,1.0641264879372063,1.0742960497754455,1.0408213909301018,0.08383186984642532,60.01924286371457,327.44311814771993,300.4882511138916,273.53338408006323,306.5000032697405,11.097257508783681,297.94535882132396,12.380791774792511,305.3731831138995,303.27062385594576,13.381061906820392,8.945815809653075,13072300,7.831887162076161,1.5029752409137447,-56260200.0,-3.235605076152101,91.40936679472856,92.55270083870475,122.67197869212396,32.51478455350384,17.881897750535124,0.0989040420554864,12.586126453824221,316.14816552734374,307.98092517089844,301.3800048828125,294.77908459472656,286.61184423828126,0.1,0.0,275.9558843615602,0.11049328696082594,0.11075692865336428,309.6000061035156,299.87357439313615,14.063738841817678
2023-01-11,1,325.9975051879883,279.3500061035156,324.56500244140625,289.52062797546387,313.1037483215332,0.3852162473540469,13.26547531653837,-1.1999122303001157,2.994761902550956,295.49749755859375,11.83539978027344,0.044166520819932116,287.4202491760254,319.0599990844727,0.7455319766452291,0.009327607832561735,1.085387086143885,1.0863623040795491,1.044318202620311,0.07386148487932309,63.482511931577676,326.88232697585016,300.35137634277345,273.82042570969674,311.69107491629467,10.382928020609993,300.8823236737932,13.834601636898329,308.98086068382634,304.994756009188,11.141720354384816,10.603507860227218,9579700,7.7577854989058075,1.1050308160988884,-46680500.0,-3.736139161023042,91.40936679472856,92.55270083870475,130.87503596941383,31.084245263857714,17.095155422180422,0.1375279888012483,12.224974476693683,316.14816552734374,307.98092517089844,301.3800048828125,294.77908459472656,286.61184423828126,0.1,0.0,276.1233651397241,0.057690462144878385,0.10954397769583656,314.22572108677457,302.66428920200894,14.934942835085472
2023-01-12,1,329.6800079345703,279.3500061035156,325.9975051879883,289.52062797546387,313.1037483215332,0.4589375284273376,13.968381840671332,-1.1307571825938456,2.994661085266263,295.49749755859375,12.387100219726562,0.04643572195447695,287.4202491760254,320.23825683593753,0.7025838338926277,0.004413608170340673,1.095970124314965,1.0849912105850714,1.0411577723191163,0.06741785415303436,66.16018474252327,328.74789039032703,300.8111267089844,272.8743630276417,316.6417890276228,9.319407504303697,303.4467887878418,15.62765778180007,313.2113748645213,307.2200545876096,12.544880572558053,14.433273073221004,10856200,7.68633153532201,1.2515563466664208,-35824300.0,-4.7363233448162925,91.40936679472856,92.55270083870475,141.23786122905764,31.68912608023541,16.101266985741148,0.2009631226843513,12.052476125232921,318.89857019042967,310.2057289428711,303.1800079345703,296.15428692626955,287.46144567871096,0.12000000000000001,0.0,276.3228404729694,0.06596703865198439,0.06696616455662618,319.2514343261719,304.96214730399,15.719451572574844
2023-01-13,1,332.08250427246094,279.3500061035156,329.6800079345703,289.52062797546387,313.1037483215332,0.5392697905723179,14.439825746493316,-0.9706057033480344,2.994591134163771,295.49749755859375,12.69400054931641,0.04796218664492226,287.4202491760254,320.3815071105957,0.7308624527911615,0.033536353332963086,1.1030190620753788,1.0750903255115096,1.0351311672862662,0.06472533335472885,69.91227165775676,329.9465284766293,301.0668769836426,272.1872254906559,320.7142889840262,8.875867821731461,305.99678911481584,17.217998048254678,317.25237412309554,309.09251666354555,11.74646138594228,12.220987667273914,8286800,7.605384684683256,0.9512663673248705,-27537500.0,-6.056273187379117,91.40936679472856,92.55270083870475,148.97582348559195,32.443745221646466,15.341452768703817,0.21531892607633574,11.745869205156787,321.72535620117185,312.49231762695314,305.0299987792969,297.5676799316406,288.3346413574219,0.14,0.0,276.48576649134975,0.054729900806020026,0.07465287118468701,322.59572056361606,307.46714782714844,16.825214729536444
2023-01-17,1,328.3499984741211,279.3500061035156,332.08250427246094,289.52062797546387,313.1037483215332,0.6330961807842305,15.496113218239348,-0.8745649015860684,2.9944265075286314,295.49749755859375,13.480000915527341,0.051358931468552235,287.4202491760254,326.36575546264646,0.841346187402906,0.12335197993908047,1.0882538628772134,1.0479500400625632,1.0107757370670987,0.03668738355706869,79.37122178257074,332.714103725297,301.72187728881835,270.7296508523397,323.4989318847656,7.484729965349114,308.35196794782365,17.8954514047591,320.88134013193144,310.9813392992695,9.390595162630943,12.04524714326787,9247000,5.1035770183246285,1.115782830796668,-36784500.0,-16.492717087916116,91.40936679472856,92.55270083870475,107.03639404880961,30.596300775579657,17.734989672912263,0.26130248058785643,11.56545006325867,321.72535620117185,312.49231762695314,305.0299987792969,297.5676799316406,288.3346413574219,0.14,0.0,276.6493043405535,0.03506040334482008,0.033814019459683625,324.9557189941406,309.7000056675502,17.32487561923289
2023-01-18,1,326.1024932861328,279.3500061035156,332.08250427246094,289.52062797546387,317.4868793487549,0.44284044377754095,16.463312387140668,-1.2259579585209472,2.99427019550319,295.87999725341797,14.66985061645508,0.05427015319463514,287.4202491760254,328.48299942016604,0.8764870301407497,0.12942752741199584,1.0749739694919689,1.028082062069253,0.9967264728428364,0.01984311803969807,75.25289200962452,336.28512697154696,303.35850219726564,270.4318774229843,325.5285742623465,5.468366263279082,311.0546455383301,17.480859811976497,322.74731258705174,312.70732204119076,6.311163051160042,11.162835436428288,7814100,5.027926334691923,0.9799276663623504,-44598600.0,-16.31879968034714,91.40936679472856,92.55270083870475,89.28096541388103,28.899080622416562,18.227516857879035,0.3082797679580218,11.370059813749746,321.72535620117185,312.49231762695314,305.0299987792969,297.5676799316406,288.3346413574219,0.14,0.0,276.78248296096507,-0.003694272275413635,0.035409374842350384,326.4957188197545,312.71143232073103,17.640782698269252
2023-01-19,1,319.15750885009766,279.3500061035156,332.08250427246094,289.52062797546387,321.31750679016113,0.23656730165637244,16.905393493663176,-1.4210075604372863,2.994202932633363,299.97875213623047,15.330499954223631,0.05540435850806237,287.4202491760254,328.48299942016604,0.8903035728417684,0.1279822632230237,1.0459808017777934,0.9964244981798144,0.9717302330569474,-0.020981744427603255,72.30262748525105,338.93828866579304,305.1275016784668,271.31671469114053,325.87536076136996,4.860589400378908,313.8980385916574,14.986737296524112,323.6179827698839,313.990526759954,4.555217876523203,13.125938058999397,18008200,5.053463494597256,2.1021936324365527,-62606800.0,-37.508988263015084,91.40936679472856,92.55270083870475,49.34381247786252,26.572787940711166,21.649802482492042,0.23601018828036494,11.48219639312221,323.51895764160156,315.3955199584961,308.8300018310547,302.2644837036133,294.1410460205078,0.14,0.0,277.03794418656895,-0.035079174490490916,-0.035904040602148676,326.5828595842634,315.49000331333707,17.216605243648704
2023-01-20,1,338.9800033569336,279.3500061035156,332.08250427246094,292.7481231689453,321.31750679016113,0.04654072828670562,16.749211713090013,-1.4436310326953645,2.994240519679749,306.216251373291,15.230750274658202,0.05462348088531912,287.4202491760254,328.48299942016604,0.8914868689363626,0.12032263383584552,1.1055008469086252,1.053187558859561,1.0363999660632257,0.028209157966924803,63.711988199372065,340.12867550137537,306.6302520751953,273.13182864901523,328.62143162318637,6.1001252247617055,317.56071744646346,14.344432008032115,322.50932753871973,314.251215013696,0.766427388449343,14.250045418588968,28430300,5.260722824444254,2.9485910332871983,-34176500.0,-2.46791712755173,91.40936679472856,92.55270083870475,130.11838842629228,33.11469951418251,18.2075666991335,0.2915706158899205,12.677753881609968,329.65592028808595,320.7820404663086,313.61000061035156,306.4379607543945,297.5640809326172,0.16,0.0,277.64494694456226,0.037470072196492676,0.04656844643282104,328.7200012207031,319.1600036621094,18.208869279876563
2023-01-23,0,350.5050048828125,279.3500061035156,338.9800033569336,294.71313095092773,326.0237522125244,-0.008344080421786436,17.375002374613207,-1.3187886341447232,2.994153158874225,310.37624740600586,15.53800048828125,0.05616884024989238,288.2087562561035,329.9202575683594,0.8325313575630859,0.15386647235584353,1.1330910466415816,1.0788976986804242,1.0655768948735869,0.05547567358512984,73.74070068071657,344.08525712959744,309.3352523803711,274.5852476311448,332.1225030081613,10.078627959862411,321.90678896222795,14.457776729710718,326.6416199382679,317.2079771467616,6.011585527286512,17.823099929986263,15646900,6.464045071483515,1.548350259709288,-18529600.0,-6.566944084153013,91.40936679472856,92.55270083870475,163.70880943805403,39.06361130966097,16.09607271476095,0.30150625569691963,13.3164853988355,344.8922028808594,334.15390466308594,325.4750061035156,316.7961075439453,306.0578093261719,0.18,0.0,278.04679089708907,0.07391384400623302,0.08266442959224235,333.028573172433,323.62714712960377,20.724679742604266
2023-01-24,0,360.5374984741211,279.3500061035156,350.5050048828125,295.28937339782715,326.6643695831299,0.07015445322838387,19.14395255309823,-0.9853728280088507,2.9938522359454836,314.3125,16.562625885009766,0.061325088021439676,288.2087562561035,332.7722541809082,0.8126680715843083,0.18261032700553012,1.154933588956106,1.0967445419035364,1.0839353631498332,0.09802801933783734,77.81472978635112,350.45953291381363,312.1716278076172,273.88372270142077,336.5307159423828,14.576763732917977,326.5862524850028,15.641398057003247,332.5822919543623,321.1072002322019,7.517695474599363,21.005661966254507,11796500,6.7796244379607655,1.1450083450254283,-6733100.0,-2.5948214086036616,91.40936679472856,92.55270083870475,169.76207070759676,38.67935738100435,15.174792687869301,0.30571308509398,13.116020673663014,349.09695764160153,338.8565199584961,330.5800018310547,322.30348370361327,312.06304602050784,0.19999999999999998,0.0,278.37921932479276,0.11529024955805078,0.09317342276793565,337.84285627092635,328.5471452985491,23.196962932191216
2023-01-25,0,363.9824981689453,279.3500061035156,360.5374984741211,295.28937339782715,328.6825008392334,0.19008100792989055,21.4639069980907,-0.6987364190695242,2.9934223301831153,317.9437561035156,17.87068801879883,0.06805742072120415,288.2087562561035,340.1325035095215,0.8064656427952518,0.2205990801823931,1.1541100143250886,1.0926631783848664,1.0735157599656737,0.11615981374780637,81.03953479763605,358.3071917427634,315.379377746582,272.4515637504006,341.0878579275949,17.62258590744846,330.90107345581055,17.071810935815446,339.51637339945626,325.8272145205729,9.359830683356114,22.205740966308397,7766900,6.896414112837143,0.7412341750860227,1033800.0,-1.4415006357634614,91.40936679472856,92.55270083870475,160.17812425736435,38.25226201459585,14.302429263970911,0.33234003345321383,12.922018760903018,353.5104359130859,343.9897771606445,336.2949981689453,328.6002191772461,319.0795604248047,0.2,0.0,278.60601139341406,0.12757027118497288,0.12795043246332385,342.86285400390625,332.72928728376115,25.228706538804126
2023-01-26,0,366.0899963378906,279.3500061035156,363.9824981689453,301.4375057220459,330.28063201904297,0.18371187092308908,23.388930867010558,-0.699523652461945,2.993047818577178,319.4575080871582,18.822662315368653,0.07336331408814402,288.2087562561035,351.50825424194335,0.8143672459660783,0.2626662595397866,1.1483028248950888,1.084590582840306,1.0561329172455987,0.14705117751071395,83.93304376016947,365.58748964844983,318.8096279144287,272.03176618040754,346.47928619384766,18.80919356224736,334.98910903930664,18.202240067752527,345.5742517683416,330.6496346377149,9.606044728665276,19.898704662906425,8256800,6.434491619313454,0.7787766204784448,9290600.0,-6.352356879629547,91.40936679472856,92.55270083870475,144.2818972609676,36.723473372070046,13.705225980894095,0.3407729686359129,12.521872906827214,353.6021121826172,344.0639341430664,336.35499572753906,328.64605731201175,319.10787927246093,0.2,0.0,278.84602406957555,0.15545631936049342,0.11810133953591546,348.38428170340404,336.6700003487723,25.56677055443569
2023-01-27,0,362.62000274658203,279.3500061035156,366.0899963378906,307.53687477111816,333.8068790435791,0.1392677373872355,24.43405887948982,-0.7312270202192246,2.992869613553495,322.8775062561035,19.529873657226563,0.07571736116071705,289.4642532348633,360.8819984436035,0.80003822211628,0.31050649128045027,1.1237031820002084,1.0616994635614574,1.0185411522921943,0.06973862515647089,87.2126329750993,371.5689951393507,322.7008773803711,273.83275962139146,351.69607325962613,17.212009108839563,338.6123237609863,18.299896460645055,350.6723798386845,335.5173720787309,11.493832203183034,18.5303897455127,6703500,5.70027037876915,0.6300740890431399,2587100.0,-14.236415197179427,91.40936679472856,92.55270083870475,122.86934958530252,35.559166318906584,13.930980027917375,0.3217299973459903,12.00816891966151,355.34379333496094,346.88309600830075,340.0449981689453,333.20690032958987,324.7462030029297,0.2,0.0,279.03368872621456,0.05334303361656012,0.14247257713690456,353.30428205217635,339.9000004359654,24.184403711080694
2023-01-30,0,356.3399963378906,287.70249938964844,366.0899963378906,311.13562202453613,341.8612537384033,0.16002310511864531,23.77815024241948,-0.9225385290105366,2.9930917069381255,326.04999923706055,19.104811973571778,0.07274622718204354,294.488508605957,362.75625228881836,0.833403312368137,0.2603992093077699,1.0901769087740063,1.033346538723654,0.9877836717070734,0.016647384128021248,81.98097161189195,374.42067769736343,326.8643772125244,279.3080767276854,357.0078571864537,9.511589892541355,341.44160897391185,17.708944279477905,353.6664763661516,339.8781370966822,11.198169352359898,16.263488241065144,5127600,5.894843480461282,0.49227259897582415,-2540500.0,-27.454717323931423,91.40936679472856,92.55270083870475,87.38374236797237,33.80714909415027,17.95238250034187,0.28732582400425793,11.72830162924147,355.34379333496094,346.88309600830075,340.0449981689453,333.20690032958987,324.7462030029297,0.2,0.0,279.16503222477286,-0.012058720592721617,0.030978059420620437,358.6371372767857,342.60999843052457,23.05938902481235
2023-01-31,0,352.125,289.6600036621094,366.0899963378906,315.5212516784668,351.96375274658203,0.08733918565376687,22.81185298026583,-1.0313209921949371,2.9933483392564737,327.22624588012695,18.876748809814455,0.06906482540445637,302.7200050354004,362.75625228881836,0.8404617774400632,0.2302008970267223,1.0660883912667054,1.0139906956391311,0.9729521420668762,-0.02333321363166041,73.8211414978286,375.9199580204682,330.29625205993653,284.6725460994049,358.88571384974887,6.013546025058285,343.7535727364676,16.746961393106012,354.33770934806876,342.20798170259076,11.65019980941664,12.505917520014425,5660700,6.313023788259023,0.5484712044624145,-8201200.0,-27.251502153456915,91.40936679472856,92.55270083870475,68.46346497359073,32.274573705940995,19.737038695068684,0.2657198427576699,11.407710137878347,355.89131506347655,347.76933880615235,341.2050018310547,334.640664855957,326.5186885986328,0.02,1.0,279.3042192484938,-0.02740291231801162,-0.00996034900796529,360.25999232700894,344.48999677385603,21.826370288690885
2023-02-01,0,357.7874984741211,295.02500915527344,366.0899963378906,318.55063247680664,353.17874908447266,0.06740325304444315,21.257596868262816,-1.1709622063137808,2.993700215652763,329.0150032043457,18.38239852905274,0.06375630923987047,308.32924880981443,362.75625228881836,0.8448578854090835,0.19354288305326176,1.0730850968828207,1.0232908278829158,0.9932154732364143,-0.017020048288005185,68.29049039619221,375.9346956133568,333.4195018768311,290.9043081403054,359.9260700770787,4.836834733541175,346.02428654261996,16.30355427718822,353.79205584550436,343.51054624433266,3.877808871582671,10.12251219576908,8005200,6.523742913491116,0.7709962409454749,-196000.0,-12.637069960057776,91.40936679472856,92.55270083870475,80.93683616340417,34.987901523844485,17.871553757665975,0.2763015458732323,11.698588770018517,355.89131506347655,347.76933880615235,341.2050018310547,334.640664855957,326.5186885986328,0.02,0.0,279.51682936490016,-0.016224593323570513,-0.005057297105237796,360.91284615652904,346.97070966448103,20.498359107694412
2023-02-02,0,364.7000045776367,303.5750045776367,366.0899963378906,319.6075077056885,356.70187187194824,0.05325458697695488,19.950456355452644,-1.399555462993384,2.9939755292790977,330.8812561035156,17.994886169433595,0.059277980333548363,311.5912467956543,362.75625228881836,0.8443706631683341,0.17858022919874483,1.0836183049561954,1.0336935448403646,1.0158986770412959,-0.003796858079047283,70.12928386703457,376.4585390536787,336.55762634277346,296.65671363186823,360.52071380615234,5.168997633596661,348.5257148742676,16.289504539919207,354.8016899670997,345.2144261455181,2.0777145803505475,9.751606309932015,7857000,6.425701797420323,0.7621846966467074,7661000.0,-3.8288249986422604,91.40936679472856,92.55270083870475,90.95576383203017,34.6604887641412,16.780313974937304,0.27009170369458607,11.569404904146742,355.89131506347655,347.76933880615235,341.2050018310547,334.640664855957,326.5186885986328,0.02,1.0,279.73862029088076,0.005536271982576224,-0.002907861809675174,361.34999302455356,349.59642464774,20.290986947343917
2023-02-03,0,365.8524932861328,308.8574981689453,366.0899963378906,324.4375057220459,358.4749984741211,-0.017332245301986668,19.33615914391797,-1.5247667240677627,2.9941096008718096,335.53125381469727,17.816261291503906,0.056935715796258925,316.2465026855469,364.05424880981445,0.8305414846367872,0.18080346677594827,1.0772601438607787,1.0237451943765568,1.019898813263431,0.008914264285111217,72.80245908662789,378.28619463060943,339.61387634277344,300.94155805493745,360.78785596575057,5.4199567361647825,350.9378569466727,16.167164063150246,357.28131278923695,347.5280189092691,1.1545279259806047,10.622420468400566,9402000,6.468301645063772,0.9073358421301257,17063000.0,-20.487588251005846,91.40936679472856,92.55270083870475,93.89665969438403,37.01885487197291,14.77354020238294,0.25117383504910995,12.202304030894767,363.84455786132816,354.20272106933595,346.4100036621094,338.61728625488286,328.97544946289065,0.04,0.0,280.0135958253938,0.014219599853185327,0.002822919925125836,361.0557076590402,351.9592808314732,19.6104745643139
2023-02-06,0,363.56250762939453,311.8949966430664,366.0899963378906,326.0762462615967,361.0581245422363,-0.12180618913773245,18.785406245390135,-1.5776702271742855,2.9942233695013,344.74250411987305,17.590373229980468,0.05485372697648117,318.9147583007813,364.8152534484863,0.8276632276869483,0.17299891701954914,1.0616091167728425,1.0097443947500195,1.011691611252653,0.020268595627012775,72.99208877872464,380.03443858941307,342.4636260986328,304.89281360785253,360.42678615025113,5.081485766624054,353.4530361720494,15.085673802464248,359.44491251846944,349.7154114170783,0.5137596248706242,10.169156332898796,4994900,6.48047595323773,0.49143247316990624,12068100.0,-27.180477985654395,91.40936679472856,92.55270083870475,70.30050742048542,35.29026548504935,14.083692153613008,0.20070705989210447,11.885712280825988,363.84455786132816,354.20272106933595,346.4100036621094,338.61728625488286,328.97544946289065,0.04,0.0,280.1514367414309,0.023703735328901132,0.001968073826199947,360.57142421177457,354.4778529575893,18.80137768720162
2023-02-07,0,359.9550018310547,316.7300033569336,366.0899963378906,327.788122177124,362.85562896728516,-0.24612522998846417,17.93749545863097,-1.598162738058076,2.994374386515233,351.31500244140625,16.85854827880859,0.05198565810733391,319.69750747680666,364.8152534484863,0.8385636433358926,0.14786254467873644,1.0432057085321844,0.996112605862277,0.9976427771734855,0.02223642692525285,69.41375330513218,380.92199256521127,345.04700164794923,309.1720107306872,360.0460717337472,4.988766760020223,355.8710724966867,12.922475855005054,360.5070666721273,351.53588248664187,-0.6904009215710155,10.724077758157417,6289400,6.5598369575601785,0.6202502933896116,5778700.0,-24.95455171400341,91.40936679472856,92.55270083870475,53.23682556919903,33.14514654096344,17.178640151963066,0.24258335542211332,11.751018546444083,363.84455786132816,354.20272106933595,346.4100036621094,338.61728625488286,328.97544946289065,0.04,0.0,280.31792675700166,0.025688202203585586,0.02786674765277992,360.8828560965402,357.09356907435824,17.666901863721964
2023-02-08,0,363.3374938964844,319.15750885009766,366.0899963378906,329.347505569458,362.85562896728516,-0.40849901226485447,16.973583768844804,-1.4986049033125335,2.99452867082311,354.2324981689453,15.75584838867187,0.04888588820113877,325.37350540161134,364.8152534484863,0.8392147974393724,0.12571243391035572,1.0464540869977004,1.0056351660811358,1.002665752504612,0.01551198811035226,64.40632738762837,381.15541910934496,347.2082515716553,313.26108403396563,361.04571424211775,4.820619457377782,359.0267857142857,7.541257286647976,360.4151289310431,352.85572913490535,-0.7349293738188477,10.380941342640577,6253200,6.695787802041888,0.6381373068772836,12031900.0,-26.92309698723617,91.40936679472856,92.55270083870475,65.45745481440741,33.59722044338282,16.13509821085169,0.2206542214141223,11.617374713293271,368.38519555664067,361.5523973388672,356.0299987792969,350.50760021972656,343.67480200195314,0.04,0.0,280.4910192743615,0.013370525341755757,0.036652918548609935,362.84285627092635,360.73999677385603,17.398250701170802
2023-02-09,0,367.6199951171875,319.15750885009766,366.0899963378906,331.4818801879883,363.3937473297119,-0.5900373595309222,16.08368623157139,-1.3021286524260458,2.9946624597789873,357.06374740600586,14.53607349395752,0.046033981463629386,326.09199447631835,364.8152534484863,0.8404357184103453,0.11454071922103753,1.0521849156485776,1.0176698278805787,1.0113857097823882,0.008006554710445979,65.66487547131342,381.5546233634113,349.38725090026855,317.21987843712583,363.25928497314453,3.3855819411902717,361.0724994114467,5.208704552906047,361.1331266893786,354.62938328771907,1.9637137650859,13.842690151820065,6901100,6.63326086273388,0.7140141217758735,18933000.0,-43.63401546958553,91.40936679472856,92.55270083870475,69.0053836531454,34.5646808340312,14.939179743909008,0.16426550567111795,11.65113340077255,370.27319555664064,364.60839733886723,360.0299987792969,355.4516002197266,349.78680200195316,0.04,0.0,280.6848007567323,-0.011965478680699748,0.0014089057139253704,364.07714407784596,362.1685682024275,16.696942610224813
2023-02-10,0,353.9500045776367,319.15750885009766,367.6199951171875,337.25562858581543,363.6675052642822,-0.800014803363542,15.608379848196813,-0.9250216511906215,2.9947338129851366,358.8712501525879,13.542110671997074,0.04440905908128569,328.12524795532227,365.8762435913086,0.8307033300927665,0.11508124930082785,1.0070607467260946,0.9794128370331854,0.9722151815533138,-0.03253357275656765,67.89243395315073,382.6851350931221,351.4683753967285,320.2516157003349,362.7110715593611,4.534892112737372,361.3185708182199,4.730491246865575,362.70804621667287,356.5307641464973,4.400424598420305,8.448873525467825,7291100,6.642782302557821,0.7685391316080178,11641900.0,-99.31876477915617,91.40936679472856,92.55270083870475,-3.888324376900819,31.382220867653906,22.315376629254633,0.10573078811840451,11.91605139731612,371.8095578613282,367.095221069336,363.2850036621094,359.4747862548828,354.7604494628906,0.02,1.0,280.8556046921237,-0.05066960605133808,-0.053231291441902896,361.98714338030135,361.4499947684152,15.92453628875903
2023-02-13,0,353.0050048828125,319.15750885009766,367.6199951171875,347.6237545013428,363.6675052642822,-1.0270447586869251,14.789192539798622,-0.36452060178917867,2.9948397304707286,358.8712501525879,12.147061347961426,0.0419335202020257,328.12524795532227,365.8762435913086,0.8261244853748334,0.06584960069812752,1.0009162071448128,0.9791469762016548,0.9760012283813502,-0.029039030496907148,52.49066877584285,382.2602603084791,352.68187522888184,323.1034901492846,361.0403573172433,5.687769804175034,360.78053556169783,5.2283301799002855,360.4544972481008,356.1914650887014,-1.0725623206094057,0.982867476022494,7134400,7.50471291160424,0.7566171121202544,4507500.0,-59.295024714212175,91.40936679472856,92.55270083870475,1.1173185126467606,28.53613345650856,21.988000434674372,0.13810758748154603,12.168477169490457,371.1275144042969,365.99123547363286,361.8399963378906,357.68875720214845,352.5524782714844,0.04,0.0,281.0265189852738,-0.008050247797019794,-0.02003275948219701,360.79857090541293,361.07428196498324,15.22694709036733
2023-02-14,0,358.6649932861328,319.15750885009766,367.6199951171875,351.7200012207031,363.6675052642822,-1.2724537992264053,14.014790574546964,0.38116487715170067,2.9949334712239564,358.8712501525879,10.787098808288567,0.039620246529167874,328.12524795532227,365.8762435913086,0.7802110120977769,0.07508757887396364,1.0139570320220987,0.9957674858947722,0.9974733767234012,-0.0035838050266275845,52.46130463392726,381.7575814084934,353.72800025939944,325.69841911030545,360.0135716029576,5.310524635844871,360.4007137843541,5.1706562932392846,358.5373445725585,355.80978623403666,-3.2067451461560394,-2.0892399884028334,4624800,7.434732396432383,0.5027923850566902,9132300.0,-55.34396041562216,91.40936679472856,92.55270083870475,24.913859535621476,29.186717814528105,20.637723609442418,0.1689766185166007,12.03858637903892,371.1275144042969,365.99123547363286,361.8399963378906,357.68875720214845,352.5524782714844,0.04,0.0,281.14422540015715,-0.008238106216807761,-0.0042049891696708235,359.9499991280692,360.5028533935547,13.742346395147829
2023-02-15,0,358.7925033569336,319.15750885009766,367.6199951171875,352.7850036621094,363.6675052642822,-1.643664370192302,12.772368764207402,1.818819112951715,2.9950724930300554,359.30999755859375,9.288123016357428,0.03595381696147336,337.6922523498535,365.8762435913086,0.6980807295293818,0.09985357570212938,1.0099896292529669,0.9943161054575917,0.998544468586755,-0.012509005032235065,57.58410170719806,380.7884875284148,355.24375,329.69901247158515,359.3321424211775,5.080283326756553,359.8794642857143,4.914488116265005,358.5488467349005,356.54299725278264,-1.9645895905863526,-1.4609232338265723,3966000,7.445948584180042,0.4403816418817821,13098300.0,-51.19381181806045,91.40936679472856,92.55270083870475,20.163305649562627,27.65970334861591,19.557982382786584,0.18062971973228395,11.79583125538156,371.1275144042969,365.99123547363286,361.8399963378906,357.68875720214845,352.5524782714844,0.04,0.0,281.2454980447026,-0.014747903231911774,-0.004215453169413867,359.9414280482701,360.2564261300223,11.86031302778472
2023-02-16,0,354.37999725341797,319.15750885009766,367.6199951171875,353.71375465393066,363.6675052642822,-2.1447403905236757,10.89177911679585,4.702553157248732,2.9952557961554294,359.37375259399414,7.408523063659675,0.03051959345078613,349.3525047302246,365.8762435913086,0.47578789608092653,0.12418631367827776,0.992999704390511,0.98181434519958,0.9887655413950923,-0.03601544540456503,59.553191275636436,378.66180873713176,356.87825050354,335.09469226994827,358.5357131958008,5.393690193512722,359.290892464774,5.0525109243590265,358.63783266191047,357.5002175435939,-1.3120176509848882,-1.9933603906023298,5215700,7.175652398575081,0.6234252109679425,7882600.0,-81.63731438316834,91.40936679472856,92.55270083870475,-63.55558603503699,25.778580021234028,20.616386618955406,0.22838727436549913,11.752557768661925,371.1275144042969,365.99123547363286,361.8399963378906,357.68875720214845,352.5524782714844,0.04,0.0,281.36922462030077,-0.032524161503232785,-0.04394404957952328,358.19285365513394,359.53785487583707,6.868811269661627
2023-02-17,0,346.82749938964844,338.9800033569336,367.6199951171875,354.27249908447266,363.6675052642822,-1.1044859811872445,6.68570407859675,1.3344652616223058,2.9955572766994103,359.37375259399414,5.204248962402346,0.01864185738116182,351.96300048828124,365.8762435913086,0.38915223894041606,0.0454303904182476,0.9670647554062619,0.9636452795688345,0.9748958878989996,-0.020122913111662366,50.0417024236278,372.01078308089956,358.63937492370604,345.26796676651253,356.17714255196705,6.450278387803624,358.6114283970424,6.025760376230003,357.6719855362814,357.99957484193146,-1.548805975546175,-2.2723527193072726,5294700,5.960604256563548,0.7344141414982065,2587900.0,-85.07707361181699,91.40936679472856,92.55270083870475,-181.45255125678764,24.45486512056763,24.44432712453287,0.1449607055689989,11.503802857553236,370.7003549804688,365.29981640625005,360.93499755859375,356.5701787109375,351.1696401367188,0.06,0.0,281.4811465095635,0.0017273322455617635,-0.040110368399784484,355.4971400669643,359.1699981689453,6.235009687241262
2023-02-21,0,340.2250061035156,346.82749938964844,367.6199951171875,354.27249908447266,363.6675052642822,-0.3860027845182245,5.674165727504696,-0.8336971754290401,2.9956071237945983,359.37375259399414,4.793999481201172,0.01580407786176408,351.96300048828124,365.8762435913086,0.35287848974299646,-0.010492019919640223,0.9476181601314835,0.9503239606421318,0.9601816547527041,-0.03620344925007357,39.568483332477626,370.38008118035117,359.0317497253418,347.6834182703324,352.2635726928711,6.65777899437252,357.7614288330078,7.63543876747698,355.0344775679964,356.89132213063743,-4.543983151802019,-2.6695002093512388,5710300,5.670942213622245,0.8506850559918004,-3122400.0,-97.48898606521725,91.40936679472856,92.55270083870475,-230.27736585422556,22.70298958060444,26.43025464902979,0.0605977504398098,11.506386798252924,369.2796375732422,363.0001806030274,357.9250030517578,352.8498255004883,346.57036853027347,0.08,0.0,281.58825134250975,-0.05876120950954844,-0.028385495645341027,351.9257114955357,358.00142778669084,7.983845660052203
2023-02-22,0,336.77750396728516,340.2250061035156,367.6199951171875,354.27249908447266,363.6675052642822,-0.9656024299445017,6.780956582098724,0.5682317181199164,2.995552278498669,359.37375259399414,5.350199127197266,0.018913865732280093,351.59524993896486,365.8762435913086,0.5142653850042547,-0.05633947219518824,0.9393607545733907,0.9468666446789843,0.9573580612890805,-0.061024883187823176,31.400930383674705,372.0796629505744,358.51774978637695,344.9558366221795,349.8103583199637,8.763585392434758,356.26071493966236,9.473418113222639,351.3633483675986,355.17584370021797,-7.451985576828888,-3.3794799848020944,4546200,5.29632572873271,0.7159285520249761,-7668600.0,-95.58035141385281,91.40936679472856,92.55270083870475,-204.4966724667323,21.402389856455507,27.184949359194412,-0.01622983834793393,11.333787479632901,368.4300361328125,361.6249782714844,356.125,350.62502172851566,343.81996386718754,0.1,0.0,281.6690993839328,-0.06967437261814557,-0.06606799776197056,350.14285714285717,356.06500026157926,9.506978161508307
2023-02-23,0,325.11499786376953,336.77750396728516,367.6199951171875,353.71375465393066,363.6675052642822,-1.0187429506368366,8.246088405816453,0.33508368011613854,2.995463832547989,358.7287483215332,6.5007987976074215,0.023076971353233104,346.16725006103513,365.8762435913086,0.6244899027812354,-0.07474258882918251,0.9098458715184978,0.9200725544498759,0.9358506852431598,-0.09386345918064243,28.023416910381226,373.82192687266803,357.32975006103516,340.8375732494023,345.8260716029576,12.578658185458487,353.43321446010043,12.258751714698667,347.70266047000484,352.9644573565648,-4.851674074942661,-5.872199167505457,13238700,5.210060653704736,1.998697095943107,-20907300.0,-85.6440881275244,91.40936679472856,92.55270083870475,-256.3637823502215,18.779334204912782,34.88231102311245,-0.053467907170810874,11.994232451871534,364.05931152343754,354.55033081054694,346.864990234375,339.1796496582032,329.6706689453125,0.12000000000000001,0.0,281.8457576379947,-0.10450450480878548,-0.10087231475869485,345.15428379603793,352.97642735072543,11.797194235718264
2023-02-24,0,318.11749267578125,325.11499786376953,367.6199951171875,352.7850036621094,363.3937473297119,-1.3049051607456723,10.672292520063571,1.1816705081915089,2.995275183591978,358.22624588012695,8.068598632812495,0.030030111645920305,339.88025588989257,365.8762435913086,0.6230833640165654,-0.11192602607010965,0.8951313697234604,0.9101143220630967,0.9338132529636144,-0.10232661227689244,21.61649478645947,376.7309600859035,355.3863750457764,334.04179000564926,340.0335715157645,14.817736477138421,350.0235715593611,14.893992928164975,342.03042426206395,349.20977447961843,-7.90073982897258,-10.854128384152624,6830700,5.60971826131271,1.042479350951413,-27738000.0,-95.21248754920722,91.40936679472856,92.55270083870475,-229.07716657472002,17.740556917269853,32.95279893094112,-0.05845866161404041,11.789644768344099,359.7809068603516,351.0895270385742,344.0649871826172,337.04044732666017,328.3490675048828,0.12000000000000001,0.0,281.9245605428467,-0.09569159241615843,-0.1224891203765664,339.03856985909596,349.4942844935826,14.291564541934463
2023-02-27,0,324.75499725341797,318.11749267578125,367.6199951171875,350.8006248474121,362.7993755340576,-1.3249530571466046,13.109711250899222,0.9084425947309289,2.9950306452615134,357.06374740600586,9.873899917602534,0.037139281054369526,335.6112533569336,364.8152534484863,0.7044307190193111,-0.12272491791331622,0.9200177552330447,0.9424511389395183,0.9740336587662969,-0.06364115352754307,19.35967744050278,379.20717236446933,352.9877498626709,326.7683273608725,335.17107064383373,13.123908147583192,347.2516065325056,15.766147584375279,336.02713380152466,344.9341204671714,-11.30511797063058,-13.047608390362416,6142600,5.70763310392721,0.9414934747939055,-21595400.0,-85.33510639115917,91.40936679472856,92.55270083870475,-146.6832658662913,21.485145197399472,30.403705362316607,-0.04700850672340124,11.865384863721475,359.7809068603516,351.0895270385742,344.0649871826172,337.04044732666017,328.3490675048828,0.12000000000000001,0.0,282.009573041376,-0.07164614693640647,-0.07892558909125558,333.55428205217635,346.7478550502232,15.610608350095786
2023-02-28,0,323.6550064086914,318.11749267578125,367.6199951171875,345.17687606811523,360.8006248474121,-1.0308782559698546,14.265186072857356,-0.10868554203608438,2.994894638512266,355.3599967956543,11.47495002746582,0.04063061679860167,325.07899780273436,364.8152534484863,0.8219736744111372,-0.08863725489440416,0.9218458471678713,0.9472847950469356,0.9837598004516713,-0.04870306237802724,28.809503495766673,379.6248717337274,351.0944995880127,322.564127442298,330.7817862374442,10.505537755326085,344.6587497166225,16.484797005876725,333.2028570077473,342.30488368565534,-9.486682632734516,-10.67423333308501,3676100,5.961772796055446,0.5697842752497776,-25271500.0,-86.84693893767246,91.40936679472856,92.55270083870475,-128.0304232555757,20.622800417446058,29.774550518306636,-0.030263932888193755,11.478570351235886,359.7809068603516,351.0895270385742,344.0649871826172,337.04044732666017,328.3490675048828,0.12000000000000001,0.0,282.0586280334692,-0.0455407262731482,-0.07423263365495367,329.471426827567,343.83214024135043,16.86485264771667
2023-03-01,0,318.49749755859375,318.11749267578125,367.6199951171875,339.363130569458,360.8006248474121,-0.7850308615263976,15.39789887503538,-0.7675333461983427,2.994749624428824,354.16500091552734,13.07492469787598,0.044061946590496025,324.64499816894534,364.8152534484863,0.85403831231709,-0.08085195198099707,0.9113983563943331,0.9402667538198484,0.9779341260753488,-0.054279178963411834,28.773783329484857,380.25604784162357,349.4602500915527,318.6644523414819,326.7346431187221,8.57303142602862,341.45589283534457,16.92660731996646,330.8200943326496,340.2344949221223,-8.670069158207891,-10.084592584547757,4911300,5.932078821150362,0.7656833903156556,-30182800.0,-98.17793132825187,91.40936679472856,92.55270083870475,-132.22256361696975,18.826235341636536,32.57039401196075,-0.08135214997112565,11.675816808447896,359.3230662841797,350.348446105957,343.09498596191406,335.8415258178711,326.86690563964845,0.14,0.0,282.11430347509344,-0.06390346865879037,-0.07117033781828704,324.54571533203125,340.0214276994978,18.620447322987104
2023-03-02,0,312.19750213623047,318.11749267578125,367.6199951171875,333.86187744140625,360.8006248474121,-0.6180946213968017,16.788324070074218,-1.14963488983313,2.9945546779332273,354.16500091552734,14.82609985351562,0.0482729840090126,323.13925552368164,364.8152534484863,0.8524585680719705,-0.10981378914324813,0.8976896660661915,0.9327284451302649,0.9694731629978544,-0.039732081916909245,24.313295977954418,381.3555231096308,347.77887496948244,314.2022268293341,322.7307139805385,7.725495039890187,337.4971433367048,16.817389972932485,327.7529867917958,338.01487860218276,-8.168326295034332,-12.341142076205776,4911000,5.733328565692455,0.784559937120181,-35093800.0,-97.18943200817918,91.40936679472856,92.55270083870475,-130.31021347375128,18.203793418476227,32.75486611191123,-0.13577030360493664,11.212544353620121,351.15468115234376,343.3626618652344,337.06500244140625,330.7673430175781,322.97532373046874,0.16,0.0,282.16215858776815,-0.03636641197477164,-0.06868131767989132,320.8857160295759,336.4057137625558,19.87147326170788
2023-03-03,0,314.73500061035156,312.19750213623047,367.6199951171875,325.02499771118164,360.8006248474121,-0.4771291940695524,18.301496744219442,-1.3109400032912413,2.994316338190778,353.4775047302246,16.465499725341793,0.05297114281650057,318.4594970703125,364.8152534484863,0.83763116424672,-0.14396079457747746,0.9109567867419458,0.9535842176249527,0.9852572243131775,-0.010632838945694334,19.296384426822925,382.10236864102677,345.4993751525879,308.89638166414903,319.581784929548,5.0877055381479614,334.69607162475586,17.129134720853077,323.9063823351386,335.1222295876176,-8.23793179939208,-15.076027886701269,5953300,5.393101065759355,0.9657588968873568,-29140500.0,-91.00620529863428,91.40936679472856,92.55270083870475,-107.49723510706326,18.666811744344876,31.321617983750517,-0.1683256494732276,10.888075679061567,351.15468115234376,343.3626618652344,337.06500244140625,330.7673430175781,322.97532373046874,0.16,0.0,282.2235515208523,-0.006211575779964007,-0.02617024990092277,318.07142857142856,334.10714285714283,20.2087822201901
2023-03-06,0,316.04249572753906,312.19750213623047,367.6199951171875,324.4799995422363,359.08312797546387,-0.30151917338358525,18.910120506170635,-1.4853667557041026,2.9942029267040593,349.91625213623047,17.293512001037595,0.055131365848127604,317.7792434692383,363.79150619506834,0.8585000063858822,-0.1397215916629064,0.9214036711095848,0.9691871969279513,0.9914498787232915,-0.026827921354756645,22.649114328205325,380.8213659665648,343.00112495422366,305.1808839418825,318.2857131958008,4.572745254299173,332.05589239937916,16.937544867093436,321.63149270174597,332.9655157603231,-6.545123441224512,-11.079249458996289,5660700,5.454545747026222,0.9470313569147325,-23479800.0,-96.90838664522755,91.40936679472856,92.55270083870475,-92.42547535331614,21.065937995785877,28.975645417725183,-0.19385206327601587,10.928926805922865,351.15468115234376,343.3626618652344,337.06500244140625,330.7673430175781,322.97532373046874,0.16,0.0,282.28392178713017,-0.03405256490594699,-0.016143765460259262,316.4114292689732,330.7828565325056,20.47558793252499
2023-03-07,0,310.51749420166016,312.19750213623047,367.6199951171875,322.365629196167,358.696870803833,-0.13057057877879,19.01628777319566,-1.5928213701556486,2.9941679215769827,343.52625274658203,17.498875045776366,0.05584638590626921,315.9117462158203,363.35999526977537,0.8735299674899519,-0.1307065797617835,0.9119171953359353,0.9613195005207179,0.9794716630788455,-0.040591098382213864,24.873825597798135,378.5432006226853,340.51062507629393,302.4780495299026,317.1999991280692,5.439446937323816,328.61678532191684,15.980082510812741,320.2239578764965,331.2596188013597,-2.790551711192373,-10.470817309670702,4553100,5.527114784398981,0.7645561373047511,-28032900.0,-96.71168542056317,91.40936679472856,92.55270083870475,-103.05536637241192,19.985605955209216,30.97534690022701,-0.1810805411838214,10.696860082325646,349.602642578125,341.38868115234374,334.75,328.11131884765626,319.897357421875,0.18,0.0,282.3237437827223,-0.0424052508460947,-0.04507320562676765,315.1714303152902,327.1050000871931,20.911375430190652
2023-03-08,0,309.66500091552734,310.51749420166016,367.6199951171875,318.4024963378906,355.4512462615967,0.017636217462126173,19.313070640635267,-1.5918117106389116,2.9940977535076714,338.5012550354004,17.817375564575194,0.05716321424517797,314.48125076293945,360.29325103759766,0.8691283502192175,-0.1373435773302522,0.9165526870865972,0.9675791602875816,0.9849458420195094,-0.027731761507612807,22.659542057562962,376.4845156861777,337.85837440490724,299.2322331236368,315.0442853655134,4.910770246954427,325.1076780046736,14.131040510013564,317.7884053749825,328.7470581158698,-2.389053934191181,-13.424086539179456,3479500,5.563780755476807,0.598394593037504,-31512400.0,-89.16590395529708,91.40936679472856,92.55270083870475,-92.95746757718543,19.148394209903962,30.277188138823266,-0.19670731826390225,10.367083403014957,348.343,340.2035,333.625,327.0465,318.907,0.19999999999999998,0.0,282.35409095031764,-0.0053911011298259925,-0.03209883022741768,313.5657174246652,323.55999973842074,20.682596574363004
2023-03-09,0,304.3125,309.66500091552734,367.6199951171875,317.5987434387207,354.05750274658203,0.1827752016492181,19.544877982352393,-1.528164107651318,2.9940384477116946,330.94625091552734,18.01412582397461,0.0582830923025036,312.0295013427734,359.2470024108887,0.8593512654954671,-0.1477207661817815,0.90746401908061,0.9589787954162953,0.9733904013115497,-0.025256454911640414,20.940071987158657,374.4336303238356,335.34387435913084,296.2541183944261,312.28107016427174,4.69526674818436,321.531428200858,12.380005136878962,315.7680456357913,326.43727019161634,-4.646578640979421,-13.692455104763791,7443400,5.4020481733583345,1.2671266981998508,-38955800.0,-94.64154811875918,91.40936679472856,92.55270083870475,-111.80250512152297,16.93329148144272,33.90714190265435,-0.2757999336791921,10.885863508744999,336.22768115234373,328.3261618652344,321.94000244140625,315.5538430175781,307.65232373046877,0.2,0.0,282.3997640711509,-0.04520971489920822,-0.0500829770856298,310.08714512416293,319.779285975865,20.733974035394663
2023-03-10,1,294.6125030517578,304.3125,367.6199951171875,315.7156219482422,353.24125480651855,0.29220227705155977,19.551407969109654,-1.3837700161006512,2.9940106940759317,324.93499755859375,17.870888595581057,0.05882022198553657,310.4322448730469,358.67774429321287,0.8204189472904104,-0.17220906359298208,0.8863388691289281,0.9345375780804429,0.9471411108677327,-0.06393473086746337,16.98627756902311,371.49544060252595,332.39262466430665,293.28980872608736,308.8689280918666,7.3519666147253036,317.80178560529436,12.033392298051439,312.9176648229958,323.6082017691407,-5.976272891100251,-14.12819505656652,5759300,5.157766925116284,0.9900561185942589,-44715100.0,-93.17973982839746,91.40936679472856,92.55270083870475,-132.50435200820763,15.83765210327782,35.59940052476724,-0.23812551466654702,10.807588154181971,331.11932373046875,323.0703430175781,316.56500244140625,310.0596618652344,302.01068115234375,0.2,0.0,282.4200100455356,-0.0711339026307396,-0.06130561375478929,307.1271449497768,315.83643014090404,20.99748884656308
2023-03-13,1,291.35499572753906,294.6125030517578,358.7925033569336,314.1006259918213,348.37187576293945,0.2029079326042078,19.44867133847654,-1.2358341636447356,2.993987478427433,324.2050018310547,17.26845123291016,0.05916085119836482,309.12975082397463,354.8084968566895,0.8397968203130093,-0.1676437371336821,0.8862718305099064,0.9311470983494786,0.9489463468909254,-0.0781144951509406,14.915204202544448,367.63959273798827,328.7422500610352,289.8449073840821,305.8914271763393,9.64285848356065,314.3110705784389,12.116338271202661,308.34314344710515,319.7176874211099,-7.499272267419254,-15.055033533897761,6292400,4.802939016880688,1.0910648303078958,-51007500.0,-85.542557931062,91.40936679472856,92.55270083870475,-126.5293165970112,14.410906909647116,34.76922391757479,-0.1692208445573327,11.0291892619022,328.55711962890626,320.2964371337891,313.6199951171875,306.9435531005859,298.68287060546874,0.2,0.0,282.4404109182688,-0.05935323233703349,-0.06875430996169762,304.5028599330357,312.6942879813058,21.74065596332107
2023-03-14,1,294.6675033569336,291.35499572753906,358.7925033569336,311.7775001525879,341.8756294250488,0.2350410543364909,20.163687012576176,-1.0034095110744337,2.993821767789197,321.0762519836426,16.93850109100341,0.06192540838020299,303.3425003051758,354.8084968566895,0.8427560943175363,-0.174643442168021,0.9049637335856268,0.9518944811991502,0.9754214505412534,-0.0510437934760386,14.03758717822831,365.93987364368263,325.61249961853025,285.28512559337787,303.02464185442244,9.558127315285176,311.3032133919852,11.310110270637194,304.1298015114925,316.0351027713903,-6.676064435517672,-14.364026599828335,5956700,4.775425404896685,1.0435110124248357,-45050800.0,-79.0859340236038,91.40936679472856,92.55270083870475,-112.93938757061649,13.727313730752968,33.11991728791457,-0.20882468068737972,10.751391075213196,320.4357958984375,313.72709411621094,308.30499267578125,302.88289123535156,296.174189453125,0.2,0.0,282.462538468116,-0.04386163557478795,-0.05477036312133121,301.61143275669644,309.8414306640625,21.17034866067099
2023-03-15,1,298.7225036621094,291.35499572753906,358.7925033569336,310.30437088012695,337.6393795013428,0.36543473077315963,20.209608758688365,-0.8298489358116199,2.9937834102617416,318.3074951171875,16.493188400268554,0.06262746446394166,294.662003326416,354.8084968566895,0.8352443043216532,-0.17843249585872972,0.9257098049775719,0.9741155050780711,0.9993309404684029,-0.03533656441982913,17.373102525015447,363.114842059613,322.6956245422363,282.2764070248596,300.55035727364674,7.68479094172905,309.4180352347238,11.02687639629576,301.8162447709879,313.1212401822595,-6.375997971150957,-12.50380447455367,9215300,4.569362239302635,1.551959042414342,-35835500.0,-58.67468900021656,91.40936679472856,92.55270083870475,-81.4507645957969,18.235850689535564,30.098602647253394,-0.16145259467128462,10.985577339800743,319.4578768310547,312.93605487060546,307.6649932861328,302.39393170166016,295.8721097412109,0.02,1.0,282.5155948931123,-0.025658294944519988,-0.015171629841674049,300.43429129464283,308.422860281808,19.457631143403997
2023-03-16,1,308.2799987792969,291.35499572753906,358.7925033569336,308.3268756866455,328.03062438964844,0.4755817191548613,19.0654473555796,-0.6184029152495722,2.99396844349125,317.07999420166016,15.293951110839838,0.05963571099626594,294.662003326416,347.5827491760254,0.8213832902163855,-0.167422672248716,0.9642835318915844,1.0118065392315536,1.0389102616299646,0.013037580708307628,24.001133135944542,357.82939477219435,319.69850006103513,281.5676053498759,300.230715070452,7.234459346375305,308.7153570992606,10.739567442606079,301.06976554615676,310.96100494366704,-5.480273159328957,-8.117895014095659,7903700,4.805562101810397,1.2883523086164277,-27931800.0,-44.63845186360758,91.40936679472856,92.55270083870475,-37.89175417021507,23.039000127551613,27.256741691920855,-0.16984041148810464,11.264465719000297,319.4578768310547,312.93605487060546,307.6649932861328,302.39393170166016,295.8721097412109,0.04,0.0,282.5823086945873,0.04123849428986781,-0.005548641518058362,300.6614336286272,307.91643197195873,16.719594490563757
2023-03-17,1,306.0800018310547,291.35499572753906,354.37999725341797,307.28812408447266,324.84499740600586,0.4984554494094118,16.947405523049238,-0.4275459523280154,2.994315726879921,315.3887481689453,13.37941249847412,0.05343270773712204,294.662003326416,340.88525543212893,0.8116373424571783,-0.13008634469048455,0.9650257828417108,1.0058792479242424,1.0287452450251162,0.03892400580596633,37.664510642707725,351.0676858782518,317.1728748321533,283.2780637860548,299.7185723440988,6.549768280916729,307.3814288548061,9.703932400208263,302.84754841808183,310.1873263186753,-0.720569843614086,-3.0924089756078095,6918800,5.566410129767605,1.1123669389651585,-34850600.0,-57.03473692034473,91.40936679472856,92.55270083870475,-56.14333609474872,21.4620095470928,26.478846226278602,-0.14802047555262068,11.228433150900715,317.63955310058594,311.46521185302737,306.47499084472656,301.48476983642576,295.3104285888672,0.04,0.0,282.6302650972096,0.036685304946441066,0.0192088160526274,299.4771466936384,306.5214320591518,14.804038699276276
2023-03-20,1,302.1050033569336,291.35499572753906,346.82749938964844,305.638126373291,323.93000411987305,0.42730285370792037,14.77553463315475,-0.4239075233888907,2.994636822477171,313.466251373291,11.71916213989258,0.04694254156560691,294.662003326416,337.1222541809082,0.7993585772524824,-0.11748635165983588,0.9598012545304926,0.9956480375920826,1.0076178876077135,0.03689659620405972,37.40658769760405,344.30894432734476,314.7578750610352,285.2068057947256,299.40321568080356,6.3415497592989665,305.8421429225377,8.566489611611038,303.6197819274529,309.2991725233447,-1.1577023796275248,-5.750487469109062,5113400,5.433711213653189,0.8233044724332114,-39964000.0,-52.023239786561916,91.40936679472856,92.55270083870475,-60.756648633701445,19.89463996419129,27.085269622446475,-0.15314797569587033,11.247830782979907,316.8602814941406,310.8348586425781,305.9649963378906,301.0951340332031,295.0697111816406,0.04,0.0,282.6625793361772,0.039589774558170365,0.042253021944802335,300.5271475655692,305.30714634486606,12.520100118698549
2023-03-21,1,305.11500549316406,291.35499572753906,340.2250061035156,303.7606258392334,319.78687477111816,0.35171664645646333,13.034488384902891,-0.4702705021399689,2.994866145182405,311.3574981689453,10.52242458343506,0.041707459957855735,294.662003326416,326.2812484741211,0.7797863846218264,-0.11204350668740609,0.9763000662831063,1.0102083804100008,1.010411606654352,0.0354552233185188,35.646699291429144,338.59072702920525,312.5217502593994,286.4527734895936,300.903573172433,6.261091854270319,304.8862506321498,7.753808901938978,303.2178985095871,308.2804327985386,-0.7254045243183919,-6.6583252614809885,4886300,5.351307525235138,0.7919930303705655,-35077700.0,-46.115298090903316,91.40936679472856,92.55270083870475,-42.39689986088722,19.198467589375873,25.76546721347928,-0.10378088407358932,10.979415780755067,314.3390675048828,308.79544732666017,304.3149871826172,299.8345270385742,294.2909068603516,0.04,0.0,282.69615913470864,0.03678716353734046,0.041838432662323025,302.3885759626116,304.7578604561942,10.985647665886733
2023-03-22,1,300.0500030517578,291.35499572753906,336.77750396728516,303.7606258392334,318.2124938964844,0.26075568219065237,11.45362742900261,-0.4411271324360069,2.99505487665202,310.09124755859375,9.299624214172365,0.03685608530709793,294.662003326416,324.79099731445314,0.747252930104563,-0.09401607322678185,0.965516695686126,0.9952187754615286,0.986810192254051,0.004443921610773671,40.23734972655633,333.6735050868871,310.76625022888186,287.85899537087664,302.14571707589283,4.725117769910091,304.01857212611606,7.5497068235819045,303.6833935279331,307.87342905867723,3.5648529280378707,-4.20175736638801,5808000,5.45307773281651,0.9318571441177721,-40885700.0,-77.42953108058906,91.40936679472856,92.55270083870475,-84.27818884826722,17.606020589968743,28.055113973220113,-0.12678441055522804,11.117314915141641,314.3390675048828,308.79544732666017,304.3149871826172,299.8345270385742,294.2909068603516,0.04,0.0,282.7237442258255,-0.0325554309564301,-0.003526169852556662,302.4442879813058,303.47357395717074,9.875657174169502
2023-03-23,1,312.9925003051758,291.35499572753906,325.11499786376953,301.59125328063965,316.5612449645996,0.00594529679147578,9.98628757845135,-1.0068272330343353,2.995209659059203,308.9724998474121,8.399873352050781,0.03232541874602574,294.662003326416,323.76500549316404,0.7873673858226022,-0.07709578142105432,1.013150638537831,1.0414684004864412,1.0284776776597158,0.015286432932850369,38.36243242381601,328.9024503400081,308.9298751831055,288.95730002620286,304.7635737827846,4.9618080956614286,303.8941078186035,7.371711099758178,302.7477250384378,306.6655865760465,2.984334386478101,-3.89096613565216,15653300,4.996436446543342,2.463749981309353,-25232400.0,-7.716598845363409,91.40936679472856,92.55270083870475,62.004643446316,24.09104729658443,23.3826341311815,-0.04359557951927346,12.38607848429621,314.3390675048828,308.79544732666017,304.3149871826172,299.8345270385742,294.2909068603516,0.06,0.0,282.88385475146606,0.033251621104865015,0.05457712928637651,306.07714407784596,303.84428841727123,9.626125778242072
2023-03-24,1,325.37000274658203,291.35499572753906,324.75499725341797,301.59125328063965,315.06187438964844,-0.05431420816248103,9.331982027768964,-0.8763018743193953,2.9952738332601143,308.9724998474121,7.793748474121093,0.030266828353418318,294.662003326416,319.0132484436035,0.7865191051616361,-0.016110375847293485,1.05528686137391,1.0795360312176847,1.06584858822344,0.06302274176728062,53.971707240479475,326.9877143607136,308.3237503051758,289.659786249638,308.5703593662807,8.508880738725882,304.5603583199637,8.831168129639986,305.29914869375943,307.42114035149336,6.218872708893502,-0.5536404600049655,12991700,5.733327881667759,1.950267920339203,-12240700.0,-7.397789083501344,91.40936679472856,92.55270083870475,143.0543676777754,27.73737838792109,21.829026045030933,0.008666990868834127,12.319929410778927,320.85598657226564,314.06698657226565,308.5799865722656,303.0929865722656,296.3039865722656,0.08,0.0,283.06038011828315,0.0820099329437809,0.059117645727194544,309.5914306640625,305.0128609793527,10.488188684421559
2023-03-27,1,329.01499938964844,291.35499572753906,325.37000274658203,301.59125328063965,315.06187438964844,0.05397917494622235,9.83296791129225,-0.890879113598483,2.99522503747293,308.9724998474121,8.156373977661133,0.031854233558352645,294.662003326416,323.76500549316404,0.6712021702205057,0.0018937522081735718,1.0658552666202854,1.0806021780564228,1.0643377264857898,0.08907497636151684,61.9402637083063,328.3523116313003,308.6863758087158,289.0204399861313,311.5325023106166,11.481037040928523,305.88160869053434,10.926207249936882,310.33720651860835,309.5808596728565,8.920485988767068,2.951345830114009,8625800,6.219910785067219,1.271181632428999,-3614900.0,-17.178626595962555,91.40936679472856,92.55270083870475,157.6107015286212,28.47680366356458,20.303940046696766,0.014099098215347043,12.299220079958285,324.3780386962891,316.9159763793945,310.88499450683594,304.85401263427735,297.3919503173828,0.1,0.0,283.1835775723581,0.07383737560634085,0.07960462491634061,312.10571725027904,306.3835754394531,10.87227426295924
2023-03-28,1,326.0449981689453,291.35499572753906,329.01499938964844,301.59125328063965,315.06187438964844,0.18487855850396367,10.217362965907922,-0.7311830941113282,2.9951861309964274,308.9724998474121,8.369374084472657,0.03307667079489988,294.662003326416,323.82650604248045,0.6720322187698529,0.016560822093969915,1.055505525715619,1.0577642755185088,1.0366810305320262,0.06859706110471908,64.4853870533485,329.33410184734316,308.89937591552734,288.4646499837115,314.384644644601,12.34790827438863,307.05160849434986,12.16884321740887,315.00019361084173,311.7557210501816,6.726028510593098,5.956992933858793,6489400,6.26452989231916,0.9369188833319858,-10104300.0,-25.278828832325335,91.40936679472856,92.55270083870475,128.57207151224014,26.482612891025536,20.70259606144659,0.003035567615866744,12.280704970312415,324.3780386962891,316.9159763793945,310.88499450683594,304.85401263427735,297.3919503173828,0.1,0.0,283.2689341691376,0.05798090183886884,0.06026934040106016,314.96571568080356,307.22143118722096,10.967161446699539
2023-03-29,1,329.2250061035156,291.35499572753906,329.01499938964844,301.59125328063965,315.06187438964844,0.2219630364981543,10.401558171056728,-0.7320185273521971,2.9951669479736234,308.9724998474121,8.48887367248535,0.033659944409892756,294.662003326416,325.43750228881834,0.7437184929960353,0.02369720537274568,1.065388014136839,1.057317899748192,1.0330426328251432,0.09723380354948774,62.599094422163624,329.8219918456535,309.01887550354,288.21575916142655,318.2589307512556,12.105103061245446,308.83107321602955,13.487531588895536,317.75948778187137,313.3068013034721,6.522803260080544,5.289586231892645,6287300,6.1830724140707085,0.8988123148709386,-3817000.0,-8.628452930635973,91.40936679472856,92.55270083870475,145.43698281896084,25.020401816438095,19.559522854949808,0.06717764247853736,12.06994155027459,324.3780386962891,316.9159763793945,310.88499450683594,304.85401263427735,297.3919503173828,0.1,0.0,283.3593271921329,0.12973802543270008,0.08581048922833014,318.8085719517299,309.66785975864957,12.117101789356502
2023-03-30,0,339.32249450683594,291.35499572753906,329.2250061035156,301.59125328063965,315.06187438964844,0.3050252067508075,11.127752948145437,-0.8240639883089882,2.9950882224334143,308.9724998474121,9.025249099731445,0.03594755028282013,294.662003326416,326.3419982910156,0.7791919919502209,0.05454080782444901,1.0961613265694707,1.079174762507465,1.0455828918568422,0.08412340288022158,66.45457468401982,331.81075682707706,309.55525093078614,287.29974503449523,323.14571489606584,12.799397464266189,312.02464403424943,15.063072828615429,320.6497434056294,315.0652501297279,8.97701211341411,8.186487937076402,7131500,6.00235995260661,1.0035680386482404,3314500.0,-8.385117368370617,91.40936679472856,92.55270083870475,170.22117746063574,29.553158403796488,18.249887362921587,0.06984422358425989,12.012089279941367,329.611443359375,321.1492801513672,314.30999755859375,307.4707149658203,299.0085517578125,0.12000000000000001,0.0,283.48062612483903,0.05637231274416821,0.15151411944221052,323.471426827567,312.9300013950893,13.724947345161409
2023-03-31,0,342.1425018310547,291.35499572753906,339.32249450683594,301.59125328063965,318.3743724822998,0.49611499373980195,12.881880203656463,-0.6384186523496491,2.9948792579027788,308.9724998474121,10.545549316406255,0.04143262690796847,294.662003326416,329.03600006103517,0.7563736274704871,0.07812125708549397,1.100449810401222,1.0775055749335327,1.0374383569245005,0.051549002498352925,71.63582163172975,336.67526095662936,310.91150054931643,285.1477401420035,329.15892900739397,9.637619461489873,315.6523230416434,15.799854787400175,325.3512146843603,318.2051179820483,11.211342738906453,15.175863546844592,5610200,6.339102468411903,0.7913962355709346,8924700.0,-0.6482718521087245,91.40936679472856,92.55270083870475,160.08653710285208,29.551095016538287,17.293082331933647,0.09338034347444645,11.771224626431225,332.73491662597655,324.6275368041992,318.0749969482422,311.52245709228515,303.4150772705078,0.14,0.0,283.58224054295636,0.05204176611821332,0.07837817602099623,330.84000069754467,316.6421443394252,15.740565577504833
2023-04-03,0,344.7724914550781,291.35499572753906,342.1425018310547,301.59125328063965,325.53875160217285,0.5523683324719473,14.563746914534368,-0.7584524827337389,2.9946532703499558,308.9724998474121,12.189999389648438,0.046636542341977685,294.662003326416,330.2347549438477,0.7987578308319813,0.08258385013519352,1.104042592229293,1.0735952190362417,1.0348866620293506,0.04789292918153043,72.82819759749187,341.4093694394203,312.28187561035156,283.15438178128284,333.6989277430943,8.118405518631247,319.23125076293945,16.346158728453805,329.54759192563205,320.83699679826725,14.028494701276852,17.431486279030416,4413700,6.348261492147138,0.6281380574499335,13338400.0,-0.5328381136988721,91.40936679472856,92.55270083870475,146.658308406853,29.75128173473641,16.41558792527515,0.16225686375466675,11.514708058523418,335.293189453125,327.07339123535155,320.42999267578125,313.78659411621095,305.5667958984375,0.16,0.0,283.6658575075466,0.06293107149706101,0.060568175777673615,334.82714407784596,320.45214407784596,17.65794223157172
2023-04-04,0,347.24749755859375,291.35499572753906,344.7724914550781,301.59125328063965,326.7874984741211,0.53868924683235,16.189937778433194,-0.959854372502364,2.994411823441218,308.9724998474121,13.98638664245605,0.05160659702498901,294.662003326416,339.6044952392578,0.8328441414647815,0.11031583692728004,1.106876500681429,1.0671240369168677,1.0325481723904264,0.06502936560511818,75.83488551259474,346.09825095359497,313.7183753967285,281.33849983986204,336.8242841448103,8.575826811192176,322.6973217555455,16.801259271471533,333.3205863341715,323.0973255660093,10.153595092187842,17.003906955240964,3298100,6.13957946613527,0.47360024354204333,16636500.0,-5.421238745079405,91.40936679472856,92.55270083870475,128.65136155406734,29.416681279647594,15.798190086457678,0.17964820121983394,11.110084310475358,336.5226326904297,328.30867572021486,321.6699981689453,315.03132061767576,306.8173636474609,0.18,0.0,283.7292772142431,0.07180394341984986,0.05826160081953937,337.4499991280692,323.52071489606584,19.01745573473666
2023-04-05,0,342.3324966430664,291.35499572753906,347.24749755859375,301.59125328063965,329.06750106811523,0.4364787537529483,17.7324327724386,-1.1885718566303392,2.994164809602412,308.9724998474121,15.870098724365231,0.056194450301909005,294.662003326416,342.405500793457,0.8551020023529287,0.12136501229378012,1.0848588412097326,1.0385726432021951,1.0052577901141013,0.039813168187563086,77.21651704873142,351.0197411094524,315.5548755645752,280.09001001969796,338.7267837524414,8.013403107844477,325.12964303152904,17.017014893248064,336.7488115325608,325.49553573265115,6.723881927447148,16.24417086145338,4205500,6.1087175990000375,0.6007694076875056,12431000.0,-13.24206263320255,91.40936679472856,92.55270083870475,92.82096270198156,27.423052102916085,19.69747331790713,0.16407256697570002,11.066506859726498,336.5226326904297,328.30867572021486,321.6699981689453,315.03132061767576,306.8173636474609,0.18,0.0,283.80294155992107,0.031081550950697423,0.05820356617608564,339.54857090541293,325.82714407784596,19.854358728765558
2023-04-06,0,337.9449996948242,291.35499572753906,347.24749755859375,301.59125328063965,331.7493782043457,0.2649982198627036,18.598085310008948,-1.4280620736207235,2.99402066809147,310.6362495422363,17.0778235244751,0.05863421892025049,294.662003326416,342.5764961242676,0.8860271361263061,0.12493734776936999,1.065439843124409,1.0122766026836787,0.9847929725659542,-0.004059544634710255,72.10143418375316,354.38442097097015,317.18825035095216,279.99207973093417,340.4267839704241,5.842962601167639,327.40571430751254,16.392638771470654,338.09782493775003,327.097015545371,4.047686968108776,11.045964058196432,4660500,6.0818076625741115,0.6792697030845884,7770500.0,-18.610033918678706,91.40936679472856,92.55270083870475,70.04464425997656,25.687512754664795,20.807871480803612,0.22781077325720733,10.97032788550927,336.5226326904297,328.30867572021486,321.6699981689453,315.03132061767576,306.8173636474609,0.18,0.0,283.87888977195126,0.0026593207338647673,0.02198592843962004,341.80714198521207,328.3864288330078,19.831792875135726
2023-04-10,0,336.87499237060547,291.35499572753906,347.24749755859375,301.59125328063965,338.28937339782715,0.06783646738334223,18.876276100446272,-1.528274850426497,2.993980949144084,319.1812515258789,17.471873474121093,0.059197426789138016,294.662003326416,342.5764961242676,0.8837892341756297,0.1470830198793488,1.0564654061972993,1.0015854218593974,0.9824636466984205,-0.015395659505203052,69.33756708771803,356.6224275365858,318.86987533569334,281.11732313480087,341.51963915143693,3.7331028384393017,329.88928495134627,14.82339472441516,338.03795284760065,328.0446613718322,3.6498034298053343,10.410676186991752,2657900,5.643780497743396,0.39634803291094883,5112600.0,-19.21436463908584,91.40936679472856,92.55270083870475,63.53227098166751,24.56447730917533,19.89816965636799,0.257442530940892,10.652448717343988,336.5226326904297,328.30867572021486,321.6699981689453,315.03132061767576,306.8173636474609,0.02,1.0,283.9220507084223,-0.01878551738326173,0.0016546924643591867,342.80142647879467,330.8049992152623,19.198509818859453
2023-04-11,0,341.6100082397461,291.35499572753906,347.24749755859375,304.36250495910645,338.28937339782715,-0.11143094554545974,18.402084416654727,-1.5038638721648545,2.9940840246400158,325.7075004577637,16.947948265075684,0.05733040200891334,298.3170036315918,342.5764961242676,0.8652739752474969,0.15623551101088543,1.0642619965881608,1.012201052008485,0.9993432865681682,-0.009172666885299052,68.95163769798636,357.7871686349452,320.98299980163574,284.1788309683263,341.846426827567,3.6066958909809284,332.4960708618164,13.257813886953954,337.748932992755,328.85254674634035,2.3236346344495225,11.509239710469652,4044800,5.551181674527387,0.613443804176629,9157400.0,-20.600783172690175,91.40936679472856,92.55270083870475,72.14432501055674,27.893524064850318,18.620765481208807,0.2264341834098921,10.570130951818477,336.5226326904297,328.30867572021486,321.6699981689453,315.03132061767576,306.8173636474609,0.02,0.0,283.99199520939817,-0.028913538990219312,-0.021043242156020717,342.7699977329799,333.12071228027344,18.273389650069298
2023-04-12,0,336.1699981689453,294.6675033569336,347.24749755859375,305.83875274658203,339.8943729400635,-0.23956057444613124,17.598452709137266,-1.5045160430163935,2.9942450063015627,327.5299987792969,15.995348358154297,0.05440087755679852,299.917253112793,342.5764961242676,0.8494380412364778,0.1593066909246202,1.0391790239128649,0.9923786356867085,0.985252135835592,-0.03190087608271175,71.41358164240981,358.6926558455206,323.4957504272461,288.29884500897157,340.9932120186942,4.185050474372688,335.0760705130441,9.415886855215565,338.74878136784434,330.3891105475832,0.6741414936945986,11.961064546004337,3965400,5.572591991546291,0.6106223716243997,5192000.0,-41.10819109388806,91.40936679472856,92.55270083870475,40.99972378519533,25.523431485593342,22.09945083381793,0.19049475665826254,10.72654868726502,339.0242341308594,332.35787805175784,326.9700012207031,321.5821243896484,314.91576831054687,0.04,0.0,284.0527525006279,-0.04533525946850214,-0.04952911467916718,340.7057102748326,335.77285548618863,16.95090367760954
2023-04-13,0,342.8399963378906,298.7225036621094,347.24749755859375,307.7299995422363,339.8943729400635,-0.38088021464992344,16.488718306776832,-1.412699898563782,2.99444064984732,329.12000274658203,14.585198211669923,0.0506455569721221,301.89950332641604,342.5764961242676,0.8572586935522707,0.12535879971464586,1.0530425860763526,1.009052593652274,1.0113677014440232,0.0014824759548124344,63.1442084162315,358.5483117814003,325.5708751678467,292.5934385542931,340.7171412876674,3.9514140667599285,337.20803451538086,7.133489341986788,338.1018562078355,331.0311758261066,-1.7456187495403643,12.037991917952722,7406400,5.827996715321095,1.1566021220925466,12598400.0,-12.375685521247236,91.40936679472856,92.55270083870475,78.50942613225278,25.32930073424375,19.901568246713353,0.20129499176300095,11.060366202212544,342.9158718261719,338.6570543212891,335.2149963378906,331.77293835449217,327.51412084960936,0.04,0.0,284.1863419241709,0.011216580310880797,-0.0016149893542718096,340.40713936941967,337.6171417236328,16.656145572831512
2023-04-14,0,340.70750427246094,300.0500030517578,347.24749755859375,311.81437492370605,341.74313163757324,-0.5498992283222226,15.68060340592868,-1.2251847982376143,2.994577141767474,332.69750213623047,13.617648468017581,0.0478392790685071,304.814005279541,343.0332458496094,0.8699251273123727,0.11210587029791662,1.039449883125178,0.9987739318680962,1.0047760620104935,0.00817442063096463,66.26625338900713,359.1379566134931,327.77674980163573,296.4155429897784,339.7828565325056,2.7363711548529506,338.30357033865795,6.305255576834107,339.25444195717597,332.49151411805786,-0.5605131398481346,9.53616971768102,5350500,5.663510922958486,0.8525436489441796,7247900.0,-39.16545306101485,91.40936679472856,92.55270083870475,55.229156055379924,23.716166762501096,20.157892163621135,0.17753282650396993,10.968911386289161,343.0692703857422,338.9053519897461,335.5399932861328,332.1746345825195,328.01071618652344,0.04,0.0,284.2763058004309,-0.0020628347542284153,-0.010866076104518358,339.2471400669643,338.34856959751676,16.23196713311464
2023-04-17,0,334.15250396728516,300.0500030517578,347.24749755859375,322.27562713623047,341.74313163757324,-0.782842639580441,15.251443240907854,-0.8595640880822124,2.994646580874381,336.5224952697754,12.858560523986819,0.04630094126181008,304.814005279541,343.0332458496094,0.8555888463885347,0.11313219496293457,1.0144335335542363,0.9791605926553278,0.9838417505785765,-0.008081598411808555,64.11370059176643,359.90101155810964,329.3981250762939,298.8952385944782,338.61428615025113,3.1772018803236084,338.67053495134627,5.856618490922574,339.5666527702877,333.50828771543763,-1.8833809695141919,4.713864645298813,6136000,5.661009226900058,0.9838402317860885,1111900.0,-59.8877740243092,91.40936679472856,92.55270083870475,11.965882103878366,21.999077236679256,24.49446220315838,0.19599697476915903,10.980418064612353,343.0692703857422,338.9053519897461,335.5399932861328,332.1746345825195,328.01071618652344,0.06,0.0,284.3660241767486,-0.01849608895335475,-0.019479520269732483,337.87142508370533,338.70999799455916,15.019575423214642
2023-04-18,0,334.0975036621094,300.0500030517578,347.24749755859375,325.8762493133545,341.74313163757324,-1.0259643958598783,14.303140208992883,-0.24066264399134774,2.994782855627924,336.5224952697754,11.649648284912109,0.0432378008915485,304.814005279541,343.0332458496094,0.8125547820166418,0.10608066815923538,1.0099629263665613,0.9812969305094754,0.9852593410044143,-0.021991465110601682,57.11729486885237,359.4080306010912,330.80175018310547,302.19546976511975,338.0646438598633,3.614929779955999,339.2457139151437,4.826023576481826,338.1946803690658,333.83460234417583,-2.3894876343890115,1.5614803541380298,17944500,5.826954923833408,2.6088416681931976,-16832600.0,-66.88820564835652,91.40936679472856,92.55270083870475,9.793435655248658,21.014211243038453,23.3978815331206,0.15021227202032672,10.673959805809503,344.1194732666016,340.60525665283205,337.76499938964844,334.9247421264648,331.4105255126953,0.06,0.0,284.63148786170825,-0.013334849241572133,-0.015605115725353133,337.06714303152904,339.4371425083705,13.715725095871214
2023-04-19,0,322.2949981689453,300.0500030517578,347.24749755859375,328.27249908447266,341.74313163757324,-1.2668119623035696,12.703895279720912,0.6749357463335985,2.9949894711898306,336.5224952697754,9.899711112976082,0.03821854007715739,312.2047508239746,343.0332458496094,0.777318209166634,0.09498876701295063,0.969595862762638,0.9496085288780084,0.9546836563656905,-0.0412737605246587,56.37585560614027,357.80916575780606,332.40137519836424,306.9935846389224,335.9817875453404,7.015515251291608,338.7507133483887,6.115921011822179,337.1742870339183,334.3870580963357,-1.1384976952430907,2.469752806633007,22128300,5.83051271760768,2.858790973122975,-38960900.0,-79.16916074803424,91.40936679472856,92.55270083870475,-90.88224277161082,18.648857335701855,29.973647561482835,0.18489692326077933,11.168677398506414,341.8467921142578,336.92659478759765,332.9499969482422,328.9733991088867,324.05320178222655,0.08,0.0,284.8750759358059,-0.023895126397239563,-0.04461723993714395,334.8000008719308,338.8007136753627,12.41987554369385
2023-04-20,0,323.875,300.0500030517578,347.24749755859375,328.27249908447266,341.74313163757324,-1.3484877544187803,11.337138931664398,1.522059414174886,2.9951442511129542,336.5224952697754,8.78301158905029,0.03401886269069448,321.36474838256834,343.0332458496094,0.6057507461090302,0.07413762669867495,0.9718377114684569,0.9613315420731887,0.9673151237466124,-0.05531733910998937,45.356106938474746,355.93465269548216,333.26037483215333,310.5860969688245,333.44821493966236,7.802448663635498,337.64732088361467,7.286307667804662,333.4454582774769,333.21719100461297,-4.328013219105413,-2.1049457987985773,9947800,6.397833208878645,1.2517002351703632,-29013100.0,-72.55191386974873,91.40936679472856,92.55270083870475,-91.64511733981068,20.69379619292579,27.493086629265896,0.2190746193455344,11.306629448865152,341.8467921142578,336.92659478759765,332.9499969482422,328.9733991088867,324.05320178222655,0.08,0.0,284.9935071362409,-0.06019814607851903,-0.017158543626640297,332.9628601074219,337.8664289202009,8.53017263653415
2023-04-21,0,324.6925048828125,312.9925003051758,347.24749755859375,328.27249908447266,341.74313163757324,-0.673511013864824,8.73896254164632,-0.2978018841565473,2.9953887950186355,336.5224952697754,7.2997109603881825,0.02612922735842299,323.71699981689454,343.0332458496094,0.6035377213629411,0.03476920272598705,0.9708205340425449,0.9690671935713433,0.9808685521423157,-0.04700512665210155,43.57272980778569,351.92954976285813,334.45162467956544,316.97369959627275,331.8085730416434,8.323707173571982,336.4008925301688,7.922917428328241,331.0828733026703,332.85726930550516,-5.1915950387786785,-4.552452241425077,6348000,5.769759649868649,0.8484175369027548,-22665100.0,-64.74774083770345,91.40936679472856,92.55270083870475,-101.02971832018673,19.526103981733296,25.941729748230745,0.19457103273341445,11.126870812868072,341.8467921142578,336.92659478759765,332.9499969482422,328.9733991088867,324.05320178222655,0.08,0.0,285.06913060624856,-0.03145023696340776,-0.052601147712693475,332.5271475655692,336.6164289202009,7.994923767336292
2023-04-24,0,330.1575012207031,322.2949981689453,347.24749755859375,328.27249908447266,341.74313163757324,-0.23564490288306136,7.600300063227654,-1.2815065953331526,2.9954744727091103,336.5224952697754,6.656210708618164,0.02268498276958385,324.6107543945312,343.0332458496094,0.702821403460509,-0.0020822382458447093,0.9854370438184857,0.9892907928211994,1.0071227541405998,-0.011955627143746206,40.666477848249,350.23722503490256,335.03662490844727,319.83602478199197,329.99678802490234,6.754756228724356,335.3569646562849,7.694570204875036,329.5004052649785,332.23339503413115,-3.4141932202899,-5.1002131728313485,5586600,5.058536745568484,0.7855273759088628,-17078500.0,-61.661750949260195,91.40936679472856,92.55270083870475,-53.67686005665069,22.689122434763522,24.59668461023159,0.15273651040136266,10.897094587812534,341.8467921142578,336.92659478759765,332.9499969482422,328.9733991088867,324.05320178222655,0.08,0.0,285.1435129903867,-0.011120498297236159,-0.028379103241209534,330.0742885044643,335.240713936942,7.967015212316713
2023-04-25,0,325.20249938964844,322.2949981689453,347.24749755859375,329.1725044250488,341.74313163757324,-0.25807996460122695,7.3637880125653465,-1.1614858595071123,2.995490587311621,336.5224952697754,6.392898292541503,0.021963361577481907,324.6107543945312,343.0332458496094,0.7380421090674499,0.003472491628570516,0.9699546032297334,0.9764088802150219,0.9944315861446379,-0.026623977057478765,46.774972038798715,350.00357585728403,335.27599983215333,320.54842380702263,327.7817873273577,4.961225564456222,333.78232192993164,7.320670074532334,329.6584599335523,332.2231242040973,-3.699246077662448,-4.239024457169968,5426600,5.1438400978177645,0.7805867418494091,-22505100.0,-79.22042553526185,91.40936679472856,92.55270083870475,-109.89725377050516,21.48779335381659,27.07153814780014,0.16071113723363378,10.684443753693072,339.8145726318359,335.2827313842773,331.62001037597656,327.9572893676758,323.4254481201172,0.08,0.0,285.20586402087224,-0.03341331736944886,-0.030566282130385966,327.7771432059152,333.5121416364397,8.3043945860689
2023-04-26,0,322.2199935913086,322.2949981689453,347.24749755859375,328.43000411987305,341.74313163757324,-0.25154666654450986,7.569861308807519,-1.249400833400372,2.9954765788619033,336.5224952697754,6.602585792541504,0.022590843639771853,324.6107543945312,343.0332458496094,0.6955113018482418,-0.0025839954117631366,0.9616056616995323,0.9722435726744136,0.9907008200467575,-0.00023272026579013172,42.42587887990741,350.2250974497683,335.0853748321533,319.9456522145383,326.07714298793246,4.428870950875337,332.3457145690918,7.4853031051003125,328.5569529684019,331.67707995815414,-4.5508257635597245,-6.348497346687283,4623200,5.223858255587609,0.6740694948269628,-27128300.0,-83.7307139085987,91.40936679472856,92.55270083870475,-121.02750995674356,20.67936565190337,26.489545018230743,0.16734064785819658,10.30912581955462,339.8145726318359,335.2827313842773,331.62001037597656,327.9572893676758,323.4254481201172,0.08,0.0,285.2566528225181,-0.006096810010128406,-0.03760868400196732,326.12428501674106,331.9978550502232,8.494316998682645
2023-04-27,0,323.76000213623047,322.2199935913086,347.24749755859375,328.2193794250488,341.74313163757324,-0.29760237433250286,7.839368903012148,-1.236352882056306,2.995457613949213,336.5224952697754,6.812961044311521,0.02340849936468419,323.71699981689454,343.0332458496094,0.7111423753434144,-0.02127727961831824,0.9667533060479011,0.9810195670537305,0.9954816593159864,-0.00035506866466861187,38.57022933014727,350.57286240929574,334.8941246032715,319.2153867972473,324.60035705566406,2.691531997195479,331.3325004577637,7.627767784387081,327.0177437407034,330.9182467560525,-3.5709773933475604,-5.875136964495705,5618800,5.204870253616833,0.8232414656534629,-21509500.0,-68.58892617284702,91.40936679472856,92.55270083870475,-101.92388876075836,19.242147024177886,26.752265489565545,0.1607134176995551,10.287760387130977,339.8145726318359,335.2827313842773,331.62001037597656,327.9572893676758,323.4254481201172,0.08,0.0,285.3199662974736,0.0015368064872294251,0.008448907611978697,325.0028555733817,331.03499930245533,8.719922969436606
2023-04-28,0,327.4949951171875,322.2199935913086,347.24749755859375,325.07500076293945,341.74313163757324,-0.27839751724734424,8.122347447256086,-1.349153850898027,2.9954369657348816,336.5224952697754,7.113536262512207,0.02427328379229461,323.61350173950194,343.0332458496094,0.7886311152385745,-0.04586342674753603,0.978704618173052,0.9981073583433121,1.007037051446785,0.008631213200891219,37.15362573418628,350.8655692994194,334.6208744049072,318.37617951039505,325.3432137625558,2.6666915911353852,330.6625006539481,7.514598981871049,326.2503668013475,330.71177799503647,-3.0941570686902744,-4.197427857019125,4221900,4.616736746519161,0.6320460317662302,-17287600.0,-55.44464315384926,91.40936679472856,92.55270083870475,-52.51176019363178,20.70040582071925,25.456059736085006,0.1992067536211753,10.039348756520095,339.8145726318359,335.2827313842773,331.62001037597656,327.9572893676758,323.4254481201172,0.08,0.0,285.37318762469073,0.005945428453365098,0.014077106151362494,325.97571236746654,330.38785661969865,8.738526876111118
2023-05-01,1,325.7200012207031,322.2199935913086,347.24749755859375,325.07500076293945,341.74313163757324,-0.09705662152949522,8.18880027241059,-1.4382108097609372,2.995431490597906,335.16125106811523,7.2538500976562545,0.024515200861754023,323.61350173950194,343.0332458496094,0.8015716251886,-0.04281112880006918,0.9751234599675588,0.996711241559978,0.9998557340965811,-0.013440554836988583,41.87963441406475,350.407099980246,334.0294994354248,317.65189889060355,325.6067853655134,2.587389014053001,329.5275001525879,6.909551830794565,326.56875073083467,330.65579130431087,1.613427753388955,-2.7844148321638476,5341500,4.659023299248243,0.8012690697988389,-22629100.0,-73.55755831093734,91.40936679472856,92.55270083870475,-78.76853066041556,18.806909797975436,27.241681757544075,0.15774290937290514,10.260824891657947,339.27211584472656,334.84393780517576,331.26499938964844,327.6860609741211,323.2578829345703,0.02,1.0,285.43443468393724,-0.01489269363595036,-0.0117690582957555,325.7999965122768,329.38142830984935,8.608458071075818
2023-05-02,1,321.05999755859375,322.2199935913086,347.24749755859375,325.07500076293945,340.9331302642822,0.1027821230332703,8.157423074791305,-1.4286410492475232,2.995432807469682,334.12500381469727,7.3457873916626,0.02448144675043068,323.61350173950194,343.0332458496094,0.7709192614301272,-0.05526105100196902,0.9635412019040344,0.984993158855575,0.9882433309811366,-0.01273822261154045,38.99512847087395,349.5232205544898,333.2083744049072,316.8935282553246,325.08785574776783,3.1123369136160552,328.44821439470564,6.971991197494951,326.37000740740393,330.20146038554117,0.5696645992136241,-4.651505118635508,4318600,4.59315378898156,0.6482880472923324,-26947700.0,-93.73582334074895,91.40936679472856,92.55270083870475,-110.34755668660337,17.440590056387673,26.979754671124127,0.1067158549590695,10.274338271327519,339.1588332519531,334.6605736083984,331.0249938964844,327.38941418457034,322.8911545410156,0.02,1.0,285.4778269091048,-0.015501473226560147,-0.0348611075426986,324.3099931989397,328.4185703822545,8.529041578155958
2023-05-03,1,319.32999420166016,321.05999755859375,347.24749755859375,324.4881286621094,338.6356258392334,0.2333595878748749,8.113603277623339,-1.3416274362960332,2.9954342114954984,332.12750244140625,7.375000381469727,0.024436889594788333,322.28749771118163,342.3832466125488,0.7009313830798216,-0.07541451035390451,0.9617714282545218,0.9836199230151742,0.9854312939834241,-0.008969025656781593,33.53177999931925,348.24995626532973,332.022749710083,315.7955431548363,323.5410690307617,2.8525914157331345,326.76892852783203,6.002891188191311,325.02497762429283,328.8929852599854,-1.1187530569976627,-4.4947498862637625,5064100,4.585132275325396,0.7502542650979392,-32011800.0,-87.41022479429616,91.40936679472856,92.55270083870475,-100.50797816255444,16.365996363909534,25.317409870835732,0.09836504307500818,10.166884752923169,337.95172351074217,333.68414190673826,330.23500061035156,326.78585931396486,322.51827770996096,0.02,0.0,285.5288317339104,-0.005760567145182471,-0.01007595759726408,322.92142159598217,326.4978550502232,8.18585553362141
2023-05-04,1,320.3375015258789,319.32999420166016,342.8399963378906,323.8462505340576,337.14249420166016,0.21625840415566217,7.7683811331410935,-1.447232421659692,2.995456672849794,328.8262481689453,7.108813247680667,0.023495915581262624,322.10399398803713,341.6822570800781,0.7187069524175058,-0.06719345276002194,0.9688791994582914,0.9876253061481235,0.9903067750942794,-0.010571103866349296,33.062308415132264,346.1636368085185,330.62687454223635,315.0901122759542,322.8460693359375,2.9705495731978484,325.3139283316476,4.689531184741176,323.5790929563169,327.52439160441753,-3.2794975061932683,-6.857426900990824,3879700,4.510378620673565,0.5761741011991437,-28132100.0,-77.33860678060601,91.40936679472856,92.55270083870475,-84.71999698427443,15.693926039700022,24.277749377108655,0.08832969447412325,9.844962495179848,333.0162900390625,329.6918671875,327.0050048828125,324.318142578125,320.9937197265625,0.02,0.0,285.56877611620354,-0.015559328615166956,-0.001152094423849685,322.66856602260043,325.2228546142578,7.939338351748509
2023-05-05,1,322.48999786376953,319.32999420166016,342.8399963378906,323.3937511444092,336.34624671936035,0.36166234827078536,7.588199807552834,-1.325322561230465,2.995467836892697,326.6074981689453,6.881088485717771,0.0230275423076994,320.9877479553223,340.79775466918943,0.7605756099079105,-0.05210166797805998,0.9786447718767632,0.9953471825401031,0.9990752456702943,-0.01528266791261046,36.00868882988638,344.70352440148264,329.52712478637693,314.3507251712712,322.8846413748605,2.9628080723340835,324.4808921813965,3.981022388574889,322.77437350671414,326.610649067834,-1.4959903053944332,-5.978736156715912,3988600,4.471093379812053,0.5953169869670863,-24143500.0,-66.89841342603204,91.40936679472856,92.55270083870475,-65.81160817698957,15.543826356086617,23.41601065575381,0.07638029888257424,9.478178849457194,332.0994807128906,328.95025964355466,326.4049987792969,323.8597379150391,320.7105168457031,0.02,0.0,285.61130277436104,-0.02173183120457345,-0.009482879484461323,322.8985682896205,324.5114266531808,7.695667991556858
2023-05-08,1,327.19749450683594,319.32999420166016,342.8399963378906,322.4412479400635,334.6568775177002,0.5760495127765837,7.47774434457886,-1.0913136261912948,2.995474678285107,325.4612503051758,6.6575010681152325,0.02274568772360913,320.9877479553223,340.79775466918943,0.7743002419241669,-0.04270128336213989,0.9952643057923306,1.010563577710767,1.0168123250852454,0.00453608400035499,40.295719649696764,343.70986338398194,328.7543746948242,313.7988860056665,323.3757117135184,3.3866351337231033,323.98803438459123,3.0067999712414317,322.7170481974905,326.11697254566366,0.08379500894764479,-3.4901746852261897,5488600,4.523257270255141,0.8022515546675105,-18654900.0,-18.119803879769773,91.40936679472856,92.55270083870475,5.4321925362989845,20.608069426855693,21.57244175176296,0.0905057437170131,9.553308844445953,330.16656164550784,327.3867203979492,325.13999938964844,322.89327838134767,320.11343713378903,0.02,1.0,285.68002535005814,0.021874603371282886,0.0038796072127783676,323.6642804827009,324.33356802804127,7.322237438817213
2023-05-09,1,332.2175064086914,319.32999420166016,342.8399963378906,322.4412479400635,334.1112537384033,0.7628283125166574,7.246136749661846,-0.7371126587976815,2.9954899734219254,325.4612503051758,6.18415172576905,0.022073676294520752,320.9877479553223,340.79775466918943,0.7245758998365499,-0.04218996336546228,1.012023640898103,1.0270070019802504,1.0314655208986732,0.034752099093445565,46.277400870541626,342.76277330095945,328.27049980163576,313.7782263023121,324.05035618373324,4.597800320394404,324.69678497314453,3.672729581082535,323.88133771648864,326.19394833533295,1.0617409031147258,-2.065268096780449,5544900,4.5215024863346684,0.8016916070266753,-13110000.0,-20.19318942411742,91.40936679472856,92.55270083870475,60.501975013126064,22.446365318178266,20.486995974813972,0.10441247818701511,9.340930861973817,331.4348044433594,328.41260266113284,325.9700012207031,323.5273997802734,320.50519799804687,0.04,0.0,285.75589475771636,0.04594560672753323,0.02474398263627739,323.97999790736606,324.97785513741627,6.9978931079538595
2023-05-10,1,334.3125,319.32999420166016,342.8399963378906,322.4412479400635,332.6875057220459,0.8072472962761471,6.645883602461769,-0.4091496869367006,2.9955278384272095,325.4612503051758,5.5736391067504885,0.020274148469980713,320.9877479553223,336.6237487792969,0.7257479514641408,-0.011757419703668932,1.0198645756991225,1.0312470408635266,1.0308281039931966,0.046918567220084695,55.332398933374606,341.09264191500654,327.800874710083,314.5091075051595,325.2778560093471,6.038973382957376,325.44232068743025,4.466640188042014,325.9770951732686,326.79538284443083,1.4420102175344849,3.0787037639798456,4289900,4.554656148099299,0.6187898697842479,-8820100.0,-7.863995773831839,91.40936679472856,92.55270083870475,76.71101848544177,21.736510621931117,19.280314092992896,0.14550924402046328,9.216576913685211,332.03834765625,328.90080908203123,326.364990234375,323.82917138671877,320.6916328125,0.06,0.0,285.81601944159127,0.05048551910756016,0.05627468531479284,325.5942862374442,325.6971413748605,7.172724797500818
2023-05-11,1,339.2625045776367,319.32999420166016,342.8399963378906,322.4412479400635,332.6875057220459,0.8341170809310758,6.540420088280377,-0.2767119605248012,2.99553418110065,325.4612503051758,5.45290172576905,0.019958072711802412,320.9877479553223,334.9520004272461,0.6332897043775878,-0.024873108239933113,1.0352585374265961,1.0426270638614616,1.0365142158814489,0.059078325084048755,55.93348652056886,340.7888399781965,327.70799980163576,314.627159625075,327.87821415492465,7.629572130767278,326.48303495134627,5.78215704968065,328.0739959033567,327.8187318266625,2.638001580220652,3.222693940563489,8033500,4.298396455731928,1.1535622795832328,-786600.0,-2.3785303514377,91.40936679472856,92.55270083870475,164.3720809183571,25.78110427063282,17.31104000090994,0.1466709008625508,9.531821768623578,338.42539978027344,334.06729888916016,330.5449981689453,327.02269744873047,322.6645965576172,0.08,0.0,285.9437516807451,0.07475531852853101,0.0797369963858699,329.48143223353793,326.89571271623885,6.986284851608845
2023-05-12,1,342.54500579833984,319.32999420166016,340.70750427246094,322.4412479400635,332.6875057220459,0.6737082481387694,6.162106935554978,-0.6707127951964762,2.995556015558695,325.4612503051758,5.220364761352539,0.018813920537710627,320.9877479553223,334.8075004577637,0.5482328367332698,-0.004241173665692624,1.0458459398837372,1.047723279979083,1.034579110299542,0.06218799983695056,62.727025332272774,339.853339084733,327.52912521362305,315.20491134251307,331.19464438302174,8.309773080822806,327.36785670689176,7.169153439407836,330.83788625423074,329.14814896007823,5.669503257166441,4.487322459162646,6079900,4.440960244569748,0.8684889044432224,5293300.0,-25.437769958531742,91.40936679472856,92.55270083870475,173.85327726518602,25.716577839255482,15.922028171038987,0.14092017915988256,9.62312221916293,340.4882091064453,335.73590643310547,331.89500427246094,328.0541021118164,323.30179943847656,0.1,0.0,286.0419908984723,0.053073504661409476,0.05957358919465768,332.42286464146207,327.6721431187221,7.0929852993047975
2023-05-15,1,338.4875030517578,319.32999420166016,342.54500579833984,322.4412479400635,332.6875057220459,0.7795185879653341,6.368160692961008,-0.3754146685383857,2.9955442871978857,325.4612503051758,5.339802360534668,0.019437583937921325,320.9877479553223,334.8075004577637,0.6251716666977514,0.02511578315713099,1.0331679066733357,1.0305688437773561,1.0100878249952274,0.03450518030994876,69.00992208510898,340.35732167583905,327.621000289917,314.88467890399494,333.7875017438616,7.10119524463701,328.31678553989957,7.718654391462775,333.74051857910786,330.68121417051356,7.269912635271953,3.7519985255025117,3653000,4.223555835665569,0.5312372753184806,1640300.0,-37.72654952798568,91.40936679472856,92.55270083870475,115.78098241853233,24.472424910936247,16.53615765602058,0.12166979194213194,9.39004101433388,340.4882091064453,335.73590643310547,331.89500427246094,328.0541021118164,323.30179943847656,0.1,0.0,286.09659655649085,0.014130078542615943,0.04068039560522683,334.58143833705356,328.625002179827,7.2387543787984985
2023-05-16,1,333.70750427246094,319.32999420166016,342.54500579833984,322.4412479400635,332.6875057220459,0.755983505944386,6.654134591966014,-0.5940211986770803,2.99552730885395,325.4612503051758,5.621577301025394,0.020297035917952348,320.9877479553223,338.5650032043457,0.7110840270811888,0.013139874861466424,1.0179044482337654,1.0120813277665806,0.9891586274456052,0.0044850070662336705,61.46553729706736,341.14601942807263,327.83775024414064,314.52948106020864,335.3900026593889,5.114661683168129,329.13732201712475,7.630768626653776,334.9198002621921,331.5286044220636,5.665899696234171,4.085148080670702,3332200,4.34125311757824,0.5421927386005205,-1691900.0,-44.3010916004984,91.40936679472856,92.55270083870475,67.41411493617258,23.6997148790432,18.893834103113832,0.14595442437620207,9.003610298047064,340.4882091064453,335.73590643310547,331.89500427246094,328.0541021118164,323.30179943847656,0.1,0.0,286.1422985881935,0.004847309208637851,0.007668876575139115,336.1514369419643,329.5250026157924,7.240789513989554
2023-05-17,1,335.6800003051758,319.32999420166016,342.54500579833984,322.4412479400635,332.5900058746338,0.763542150917944,6.636309357930012,-0.5681243667167362,2.9955283887841846,325.4612503051758,5.596227340698249,0.02024386791269207,320.9877479553223,338.5650032043457,0.8252542651522767,0.03541012478739509,1.0239820389009175,1.0141734396325286,0.9941272712317499,0.004090485115500586,58.25529213707895,341.0908689905183,327.8182502746582,314.54563155879816,336.60178920200894,3.6434074534333667,329.9887504577637,7.649606487927628,334.59540410321347,331.4567855029616,3.478404441377451,3.5651141796379835,3958800,3.5227953285881983,0.7558842230076127,2266900.0,-25.222787570586508,91.40936679472856,92.55270083870475,94.83949079082039,26.35710474805774,17.168836464914534,0.10383401591139461,9.200495974302958,340.4882091064453,335.73590643310547,331.89500427246094,328.0541021118164,323.30179943847656,0.1,0.0,286.20033474407506,0.013535203164977139,0.02354421768457465,337.4014369419643,330.5328587123326,7.5983224778845875
2023-05-18,1,360.1949996948242,319.32999420166016,342.54500579833984,323.44250106811523,333.8587532043457,0.5434470973750252,6.719951352103396,-0.8922113234345153,2.99552376909252,326.45874786376953,5.847002258300779,0.020457251324021687,320.9877479553223,338.5650032043457,0.8244773910550836,0.03644924833709234,1.0965257407862792,1.0828901956399477,1.0658659122544087,0.061699995828443654,60.13406081083903,341.9274030856765,328.4875003814697,315.04759767726296,340.59857395717074,9.176456599393065,332.324465070452,11.061141376658997,334.86700922645116,331.85524762272746,2.5924727238895846,3.6817389703159384,20925200,3.529621783154463,3.6164101358754825,23192100.0,-7.6016374643412865,91.40936679472856,92.55270083870475,291.9318897773979,42.44874826258545,13.204413569040291,0.21249035992615511,11.108317952006358,361.6509951171875,352.8544951171875,345.7449951171875,338.6354951171875,329.8389951171875,0.12000000000000001,0.0,286.6699744767824,0.0769520768877241,0.10694053330516494,342.9942932128906,333.48714556012834,12.073227991158436
2023-05-19,1,367.25498962402344,319.32999420166016,360.1949996948242,323.44250106811523,334.65437507629395,1.4517652758073027,9.542767307071992,2.286152249639243,2.995320473547474,327.3462448120117,7.397952117919919,0.028890905777540436,320.9877479553223,339.590754699707,0.5142605858581409,0.1093418981901822,1.1118713220321432,1.091041660517728,1.073458922103214,0.07213645917299005,77.12887552207509,349.3890349803549,330.3035003662109,311.21796575206696,345.3046439034598,13.04648256783373,335.2912499564035,14.260845422720788,341.2030307239231,335.40651260107217,8.421438589607352,9.984886812067366,7850900,6.39909373686567,1.3394411673128517,31043000.0,-17.44399961099585,91.40936679472856,92.55270083870475,237.3885800725451,40.35828159256758,12.554137940358439,0.12605619970406726,10.849153168743255,361.6509951171875,352.8544951171875,345.7449951171875,338.6354951171875,329.8389951171875,0.12000000000000001,0.0,286.84894125218983,0.07493591928397669,0.059751638828244004,347.2714320591518,336.432859148298,14.237288936718558
2023-05-22,1,365.7200012207031,319.32999420166016,367.25498962402344,323.44250106811523,336.3818759918213,1.4789030299308366,12.378689733220284,1.6397301938733548,2.995051005445045,328.8262481689453,9.199201049804685,0.03723679944106757,320.9877479553223,344.3100051879883,0.660290589701334,0.11236300331253551,1.1001360103965996,1.0722222557865735,1.0537507437046707,0.08045348180780909,79.3592820901525,357.1890040697121,332.4316246032715,307.67424513683085,349.08428628104076,14.728338532672147,338.4812502179827,15.749840520681666,347.73069691060334,339.31313625485626,9.85380134575388,12.751746361187323,5406400,6.455932939175585,0.923805365910755,25636600.0,-21.426170785591346,91.40936679472856,92.55270083870475,185.28607160935988,39.150663489584815,11.761107274919095,0.10534935819216805,10.753500068520395,361.7052777099609,352.94235931396486,345.86000061035156,338.77764190673827,330.0147235107422,0.12000000000000001,0.0,286.9708736143367,0.0807407006295584,0.06802198982250621,349.87857491629467,339.68000357491627,15.676318632631078
2023-05-23,1,358.67749786376953,319.32999420166016,367.25498962402344,323.44250106811523,338.68125343322754,1.2074964291734236,14.325412735029643,0.35242113663270125,2.994828582924003,329.85625076293945,10.977950744628902,0.042863539295412034,320.9877479553223,360.74749984741214,0.76656884989076,0.12459160648242056,1.0732107554897572,1.0398310315218635,1.0174916246914318,0.07482598764372228,78.89182212014121,362.8605750733307,334.20974960327146,305.5589241332122,351.3889280046736,14.79657415596249,341.29178619384766,15.579269833078174,352.22547332694535,342.3014899569293,7.798532489172225,13.910173799823468,6866100,6.3067871766751615,1.1589743243494157,18770500.0,-34.32322297755124,91.40936679472856,92.55270083870475,119.26298063926066,36.57123192800411,16.4587993813853,0.09409902524611562,10.68967976856462,362.2008791503906,353.7445616455078,346.9100036621094,340.07544567871093,331.61912817382813,0.12000000000000001,0.0,287.1101526472631,0.0666366748595506,0.05984094408693671,352.17857142857144,342.30071803501676,16.075468439428587
2023-05-24,1,361.38999938964844,319.32999420166016,367.25498962402344,323.44250106811523,340.0831298828125,0.9183627970327134,15.109368572122996,-0.43422261736966217,2.9947335880280157,332.9625053405762,12.095800514221185,0.04498395602463776,320.9877479553223,360.74749984741214,0.8259803805388716,0.11314476133564272,1.0759385319570374,1.0397191435553381,1.0108655717813766,0.07659079796561907,70.18712973754826,366.10223667122347,335.8834995269775,305.66476238273157,354.6607131958008,13.977805354626085,344.2241074698312,15.190468787301056,353.8409951696623,344.25880476913727,4.709597802435067,12.321894083416739,7973300,6.540905987300957,1.308858883137072,26743800.0,-19.528602594346,91.40936679472856,92.55270083870475,123.73113054306317,35.83760049659888,15.235290753084591,0.15678114216760655,10.723274332389282,362.5525168457031,354.31373791503904,347.6549987792969,340.9962596435547,332.75748071289064,0.12000000000000001,0.0,287.28190871288353,0.0732145407520004,0.0931835388869382,356.31571306501115,345.4485757010324,16.83062350106655
2023-05-25,1,360.87000274658203,319.32999420166016,367.25498962402344,325.23000144958496,346.57812881469727,0.6831478143803438,15.736956576866179,-0.9362797945324299,2.99465811105911,334.01000213623047,13.07965026855469,0.046580817617097287,320.9877479553223,361.82299957275393,0.8343805920131525,0.11622806092515457,1.068162048952375,1.0301976697990203,0.9950985603816982,0.0018739933989357915,71.44265738234009,369.315912970627,337.84199981689454,306.3680866631621,358.5410701206752,10.538756873877938,346.96553639003207,14.409539307125284,355.7312774117646,346.5860910585517,6.766127591537294,12.815389290427193,6263100,6.542571755840077,1.0227122424685786,20480700.0,-31.333574042825507,91.40936679472856,92.55270083870475,100.29343666657196,33.632932070019834,14.212689370626824,0.08972143946276913,10.67375465002549,363.1637559814453,355.3031165161133,348.9499969482422,342.5968773803711,334.73623791503906,0.12000000000000001,0.0,287.41345924545215,-0.033100832939421565,0.056006615553282825,359.92285592215404,348.03714643205916,17.12919817179426
2023-05-26,1,369.9350051879883,319.32999420166016,367.25498962402344,326.82812118530273,359.0568733215332,0.4640250065866676,16.149558351592603,-1.2540717817576341,2.9946097832120255,334.9962501525879,13.876999740600592,0.047540998561504816,320.9877479553223,361.82299957275393,0.8589650478510614,0.1019099776393589,1.089013034697513,1.049601697735601,1.0197156893045929,0.007297424513438289,70.20526320449022,371.99661655059737,339.69749984741213,307.3983831442269,363.43464224679127,4.202306605004261,350.01821572440014,14.42649752491379,357.00200983552406,348.48174403723766,8.139612722626648,11.901145814458868,9360400,6.551501344927391,1.4669323539575314,29841100.0,-8.99540070564516,91.40936679472856,92.55270083870475,130.75439849833413,37.82074238626668,11.843321180214085,0.10913565377217488,11.894201443998089,370.957009765625,363.036509765625,356.635009765625,350.233509765625,342.313009765625,0.14,0.0,287.6399040566315,0.0370046531456929,0.02044223157966375,365.4828578404018,351.442147391183,18.961393466358732
2023-05-30,1,395.34000396728516,319.32999420166016,369.9350051879883,326.82812118530273,360.3637504577637,0.3051480579930139,17.16320567932987,-1.4053568894382262,2.994477291567901,337.0837516784668,15.203149871826167,0.05021131229115982,320.9877479553223,365.87350006103514,0.8300227489399036,0.1357454371901642,1.156575337455536,1.1130326185606718,1.0881361741077853,0.08099092925657914,75.56413488301763,376.1459117096118,341.8195003509521,307.4930889922924,368.45535714285717,12.496399888186366,354.5269655500139,17.88468508658785,360.19877216769567,350.62528014084626,10.204660644563377,13.061686412228763,10865000,6.689653303131444,1.6320896004422338,40706100.0,-16.044944818065122,91.40936679472856,92.55270083870475,180.5319464238505,44.14051655450881,10.125642533684767,0.08703991522691056,12.918185660052735,387.26839111328127,376.23079467773437,367.30999755859375,358.38920043945313,347.35160400390623,0.16,0.0,287.96792231504065,0.08255971024064346,0.07559674496972799,368.5814296177455,355.7878614153181,21.476768032369467
2023-05-31,1,393.072509765625,319.32999420166016,395.34000396728516,330.96250343322754,361.00000190734863,0.6040248760783284,20.31553073365171,-0.3899262168091169,2.994019564257912,338.87500381469727,17.697849578857426,0.05883435067404767,320.9877479553223,367.5229911804199,0.7172166336919543,0.23135864627649613,1.1383490878518578,1.0892146335185182,1.0645375540908713,0.0958939774775589,84.82352171376141,385.9315619555847,345.3005004882813,304.66943902097785,372.1435743059431,15.525799824649932,358.7241091047014,19.589470589200996,368.9522920400237,355.8708390773686,9.757216036379628,19.000352582546007,6988000,8.228555274337687,1.0290726270804555,33718100.0,-13.08779393739469,91.40936679472856,92.55270083870475,150.5095590435225,42.28964261531396,9.701060101350599,0.14241464189849815,12.520458548871174,387.29434765625,376.27280908203124,367.364990234375,358.45717138671876,347.4356328125,0.16,0.0,288.17554887154853,0.11022787670551759,0.08875788643267923,372.8485761369978,360.0600040980748,22.986503436322135
2023-06-01,1,400.28499603271484,319.32999420166016,395.34000396728516,333.33500480651855,362.4724998474121,0.5577536346781873,22.01100698763119,-0.5962231312014787,2.9937626202869763,340.9037551879883,19.23448745727539,0.06308666077910215,322.27474822998045,372.248755645752,0.7727181511678575,0.2309288726488865,1.1472734425040407,1.0912493541460213,1.064243845541217,0.10762610118917548,82.67279796385216,392.9231400738952,348.9011260986328,304.8791121233704,377.081430707659,18.377083128566426,363.08285849434986,21.61069389417024,374.96106461937086,360.4635975902285,7.029862322097298,17.576372335950644,7160100,8.248793667490334,1.0383909226177528,40878200.0,-5.63541010887999,91.40936679472856,92.55270083870475,154.3848327124629,45.197757961954736,8.910548717194027,0.16843101173524488,12.657568826909502,389.1355904541016,377.76219134521483,368.5699920654297,359.37779278564454,348.0043936767578,0.18,0.0,288.40309305884057,0.10491982496619734,0.13241949476557383,378.5800040108817,364.22928946358815,24.652961365009222
2023-06-02,1,401.45999908447266,320.3375015258789,400.28499603271484,334.16125106811523,366.1037483215332,0.5487214781275418,23.58797702628628,-0.7291654813704573,2.9935227572718097,350.6112518310547,20.32512435913086,0.06683114359479066,326.7267448425293,393.299259185791,0.778293598690523,0.24957269793894946,1.1374451830472667,1.0755102109808807,1.0457397043830714,0.1124781667330621,84.29276491428809,400.12483024275815,352.94887619018556,305.77292213761297,383.1932165963309,18.350456264188008,367.2910723005022,22.99558789790378,381.28372607089057,365.82299433746,9.451218062080391,17.986806862446468,5897300,8.251387373528239,0.8429217896418943,46775500.0,-9.05004922379964,91.40936679472856,92.55270083870475,138.32115647597857,42.44300040761321,8.367459800865912,0.15992522008823615,12.516313387543093,389.1355904541016,377.76219134521483,368.5699920654297,359.37779278564454,348.0043936767578,0.18,0.0,288.5893892217307,0.1155153237345492,0.09762914765329991,384.93429129464283,368.55643136160717,25.37707548549315
2023-06-05,1,404.50499725341797,322.48999786376953,401.45999908447266,335.33812522888184,367.92499351501465,0.4860053733091325,24.585196267585324,-0.957413664044982,2.9933838365329604,359.4362487792969,20.714499282836915,0.068865131283958,331.7155052185059,395.8345031738281,0.8017021248491714,0.24487581550998264,1.13305134674077,1.0718189210932918,1.0318517987196347,0.09344882636305907,84.4386157156405,406.1753936032859,357.00500106811523,307.83460853294457,389.35250200544084,16.998478400439115,372.00660760062084,23.40000756182258,386.34607892895883,370.68161776743096,11.927846456917262,17.199197853965135,7247400,8.267073881417026,1.0123198122695274,54022900.0,-12.25068613841013,91.40936679472856,92.55270083870475,139.11320593017123,43.2711661169599,7.717213460931065,0.11928583104508793,12.601576106652796,393.97934765625,381.6803090820313,371.739990234375,361.7996713867187,349.5006328125,0.19999999999999998,0.0,288.82736930627397,0.06508657977276133,0.12406687616969882,390.461434500558,373.3885737827846,25.847184404791207
2023-06-06,1,401.58499908447266,327.19749450683594,404.50499725341797,337.7856273651123,375.71938133239746,0.41196035183095525,25.315290533072503,-1.1611305590065528,2.9932949923822587,360.5325012207031,20.90107421875,0.0701049220632233,333.55850448608396,400.4024963378906,0.818715579126838,0.2362716831407977,1.112098043109428,1.0536817866190642,1.0066489891288704,0.015796517060045145,84.88009838764368,411.73633210374265,361.10575103759766,310.47516997145266,395.16893005371094,11.79869330091185,376.8550000871931,21.833720905958327,390.9243546776752,375.4125905713446,11.93032400912766,19.50367254520634,4991500,8.269574732610353,0.6996437654753169,49031400.0,-17.295795935046527,91.40936679472856,92.55270083870475,109.4921455229614,41.21087925669549,9.221750319319558,0.07627711445132333,12.286463701992126,393.97934765625,381.6803090820313,371.739990234375,361.7996713867187,349.5006328125,0.19999999999999998,0.0,288.9831702122527,0.016056790122114473,0.05386930795786435,396.21715000697543,378.0700029645647,26.014452391496974
2023-06-07,1,407.0950012207031,332.2175064086914,404.50499725341797,339.068754196167,393.63938331604004,0.27836078314239576,25.523913605771252,-1.3500621686387249,2.993297584426608,361.13000106811523,21.573136482238773,0.069962049672883,334.2520004272461,401.47249908447264,0.8460500318748237,0.20880143682267574,1.115863387444834,1.0581811852053922,1.017275913485118,0.035674057856244445,80.69544861058104,415.87295347802194,364.8251262664795,313.7772990549371,400.47750091552734,4.8899338584594645,381.95607158115934,19.71339222240028,393.6165821245422,378.89804289305613,11.282455185526294,20.34041606585869,11932400,8.410369899479898,1.6008650714005892,60963800.0,-26.426038408915325,91.40936679472856,92.55270083870475,110.29773885173519,44.389157864309794,8.208326087728935,0.007410893187325354,12.817430667614657,401.8211281738282,391.224445678711,382.6600036621094,374.0955616455078,363.4988791503906,0.2,0.0,289.37227553990414,0.011486926349580262,0.01727817659300736,399.20143345424106,382.34214564732144,25.811533296999798
2023-06-08,1,403.75499725341797,333.70750427246094,407.0950012207031,341.72438049316406,396.5762519836426,0.1441338300787941,25.954341457150328,-1.4380650813903313,2.993258047703915,363.5550003051758,22.472550354003907,0.07041921970169096,335.5432502746582,401.8769989013672,0.8411237351843682,0.2177079864519069,1.0954665100705578,1.0364551639666244,1.0019082517036746,0.00866882659878554,82.20016013027642,420.4776839213807,368.5690010070801,316.6603180927795,401.6796428135463,4.429085876181311,385.06749997820174,19.450424012242046,396.94101203655634,382.00753477597635,10.045006693495093,21.27472618285332,5991100,8.411688564233172,0.7947041829049263,54972700.0,-14.82056763437842,91.40936679472856,92.55270083870475,95.26707736320286,41.13081126709552,9.21291300284927,0.030240285622740497,12.844757920430142,403.69496875000004,394.25752661132816,386.6300048828125,379.0024831542969,369.565041015625,0.02,1.0,289.56516555721856,0.01547885336937127,0.03577659524278511,401.54285975864957,385.0621446881975,26.025259471214582
2023-06-09,1,421.2949981689453,333.70750427246094,407.0950012207031,354.6443748474121,400.5787467956543,-0.015084514274269704,25.78370634610812,-1.4797047308407567,2.9933270061031028,366.4874954223633,23.076849670410162,0.06930337683994327,338.2067527770996,403.82999725341796,0.8612348868191109,0.19009614032081407,1.1323882465521775,1.0698461856998212,1.0436360469751167,0.04940716168411852,77.3983551438673,423.60853856196724,372.041125869751,320.47371317753476,405.7114268711635,7.24100888222434,388.9275005885533,20.948101730419165,398.59799081078006,384.5079101540641,2.128545859687188,12.093448714029908,12363000,8.556075021780002,1.5941448733794052,67335700.0,-8.213444871627091,91.40936679472856,92.55270083870475,121.76498272394808,46.340863184882764,8.38305139313346,-0.02143813009484975,13.107989410349328,409.0047547607422,398.55261529541013,390.10499572753906,381.657376159668,371.20523669433595,0.02,1.0,290.0130937894671,0.04881760864328655,0.04189711489168164,405.0842851911272,388.9664306640625,27.170190147682018
2023-06-12,1,421.0175018310547,333.70750427246094,421.2949981689453,359.81562423706055,401.49124908447266,-0.07298790803237284,26.749794093842866,-1.3225914078266017,2.99319553152157,368.59499740600586,24.310774688720706,0.0711160697761093,338.2067527770996,404.7639976501465,0.8227156821481676,0.22989677571585,1.1193024489138856,1.0529840316781471,1.0327992191305397,0.04082150947394059,82.51050479410134,429.6423387370022,376.1427505493164,322.64316236163063,408.67321341378346,8.737064535259597,392.87732206072127,21.443061379044114,404.24078335372724,388.91168187823945,7.17997003152125,14.714574361602336,5959500,9.119990734848592,0.7690436539864903,61376200.0,-2.695897156736908,91.40936679472856,92.55270083870475,112.39054857172994,44.230611220708596,8.00130730266292,0.030958328855208037,12.752419086953681,409.0047547607422,398.55261529541013,390.10499572753906,381.657376159668,371.20523669433595,0.02,0.0,290.23042703302826,0.05062693225746662,0.058681049587654154,408.0614275251116,393.32071576799666,27.69358796646018
2023-06-13,0,432.85250091552734,333.70750427246094,421.2949981689453,360.7012519836426,402.127498626709,-0.18735244858239913,27.283756980872052,-1.2159133375916962,2.993140002943001,381.50375747680664,24.87462501525879,0.07178682133003297,338.2067527770996,408.4872512817383,0.8221354360713932,0.24381992846181175,1.138886597152491,1.0689273265094779,1.053298523127132,0.07786023358028271,83.3781798495138,434.6338893126963,380.06637535095217,325.49886138920806,413.1578565325056,11.901268111529545,398.1755365644182,21.506448638206656,408.4327378398665,392.8073775034437,5.179436152696915,15.120174019954918,7820500,8.979033415720465,0.9827699522846683,69196700.0,-1.8948913935311136,91.40936679472856,92.55270083870475,131.887383724103,47.96484022052264,7.407067654624842,0.08265021175136263,12.791531137383346,418.0902716064453,406.2248532104492,396.63499450683594,387.04513580322265,375.1797174072266,0.04,0.0,290.540581144794,0.09126199419364278,0.07976904832181683,413.09857177734375,399.0164315359933,28.168903393196242
2023-06-14,0,439.1699905395508,333.70750427246094,432.85250091552734,361.26000022888184,403.94249725341797,-0.18225050619528607,27.839183437360923,-1.00621293070267,2.993098844863823,394.2062568664551,24.963162689208986,0.07235004106439372,356.3777481079102,421.0452514648438,0.7765563275987716,0.2971014896989486,1.141339756651928,1.074573815564068,1.0526530026582945,0.07878993655699174,87.3644957704597,440.4629921188625,384.7846252441406,329.10625836941875,418.10999843052457,14.605559855896514,403.7312502179827,21.318286628437754,414.5560077500386,398.04234793074323,7.819583994082877,20.680138423384022,8413100,8.856120730235498,1.0245315956405865,77609800.0,-7.084202531425625,91.40936679472856,92.55270083870475,140.85522484123058,49.86716570542599,6.838337319341557,0.08077590832987412,12.865706525589253,425.7761097412109,412.44193170166017,401.6649932861328,390.88805487060546,377.5538768310547,0.06,0.0,290.8884260461576,0.10278409452212633,0.104109734571442,418.4299970354353,404.44571576799666,27.937353329127156
2023-06-15,0,444.37999725341797,335.6800003051758,439.1699905395508,364.63750076293945,405.15249824523926,-0.06950322670520656,27.652469654859413,-0.9522229837477498,2.9932108559797004,397.8125,24.073950042724608,0.07089327076882854,360.0432495117187,422.4507484436035,0.757653024120828,0.30829954164766876,1.139267192505595,1.0751944080961864,1.0490111365012833,0.10061794968819071,88.35588075485576,445.36268886721405,390.05774955749513,334.7528102477762,424.22356959751676,15.466852944796344,409.69624982561385,20.048400086403603,420.76481117855957,403.90936332330295,8.5697317762469,21.522452552993986,7099900,8.825403507345358,0.8483864299276711,84709700.0,-3.6481436648435173,91.40936679472856,92.55270083870475,144.09738925487278,48.028867249266476,6.4836362845652005,0.07239957612289667,12.600298480653091,426.78459533691404,413.2576962280273,402.3249969482422,391.39229766845705,377.8653985595703,0.08,0.0,291.1883590731711,0.08769571371787399,0.11381544700806426,424.9985656738281,410.6078578404018,27.707707589831973
2023-06-16,0,439.12999725341797,358.67749786376953,444.37999725341797,366.87124252319336,410.575626373291,0.12265600862633876,27.10753038771708,-1.1270075906202341,2.9933865203044454,400.87249755859375,22.697973518371583,0.06854115638910051,360.80250244140626,433.4842498779297,0.8262966995374065,0.23372061697113958,1.110336404179776,1.051275818554467,1.0171097146922072,0.04233375464220579,88.22167698562265,449.7078101803414,395.4927494049072,341.277688629473,428.7999976021903,14.245169461630725,414.6387492588588,17.907005938292418,426.717193401366,409.75846979995225,10.656523093867722,23.141295721794904,8745500,7.597484909489706,1.1270373627931403,75964200.0,-26.551075931791303,91.40936679472856,92.55270083870475,111.79515183457072,43.60703354158304,10.653532977472645,-0.06404367979021043,12.886706865545158,433.8150373535156,424.6374794921875,417.2200012207031,409.80252294921877,400.62496508789064,0.08,0.0,291.5377655861736,0.028427224307692622,0.05518234508472939,429.5971374511719,414.39928545270647,28.13175990215107
2023-06-20,0,433.7200012207031,358.67749786376953,444.37999725341797,369.26500129699707,421.08687591552734,-0.008257381928563932,27.42544953837405,-1.1490188995113018,2.9933713140957035,401.52249908447266,22.325598449707037,0.06865983356081297,361.3379997253418,439.1339965820313,0.8651004260472053,0.19570873006511477,1.085821512392776,1.029044193711307,0.9963474389588844,0.03017095330812558,80.99615486988586,454.29039835958497,399.4394992828369,344.5886002060888,433.0807124546596,9.002146721223264,417.38017763410295,17.661404672014616,429.7501767882279,413.76150251264005,7.86916958858636,18.704634893977435,4756000,7.8657926208248385,0.6253796854166612,71208200.0,-23.351161650217524,91.40936679472856,92.55270083870475,97.00849283783445,41.150675519732324,10.560387019403013,-0.041497825279470595,12.680513518006151,434.55135620117187,425.8293176269531,418.7799987792969,411.7306799316406,403.0086413574219,0.08,0.0,291.7246143836085,0.025308420301988654,0.03495077276639229,433.21571132114957,417.37928553989957,27.983805105949937
2023-06-21,0,428.54750061035156,358.67749786376953,444.37999725341797,387.2881336212158,424.1843738555908,-0.19471680301163088,27.350992587513606,-1.0954226241298015,2.9934128926273007,402.6699981689453,21.929248428344728,0.0679084463417717,361.3379997253418,439.1339965820313,0.872845029965424,0.18593459415134272,1.0640197008200794,1.0097726252383183,0.9787530289890317,-0.009945651916230758,74.9254482502157,457.46473503769806,402.7627498626709,348.0607646876437,434.11678423200334,7.749889341670355,419.9141055515834,16.40586928377109,430.6840457966881,416.0114545878755,7.421580951598114,9.708098565353877,5146400,8.049132810690589,0.6778732293815316,66061800.0,-43.548638653689956,91.40936679472856,92.55270083870475,66.6234261855975,38.32370669163314,14.049435019091444,-0.03289502102982728,12.643334242584945,435.53547216796875,427.42225109863284,420.864990234375,414.30772937011716,406.19450830078125,0.08,0.0,291.91538059293424,-0.025887587485110664,0.0011321814867705836,433.84857177734375,419.4664284842355,26.71792087932913
2023-06-22,1,422.1999969482422,358.67749786376953,444.37999725341797,394.7731304168701,429.6237506866455,-0.38856010010489705,26.511185677591524,-0.8884911933873307,2.99357795756306,404.12999725341797,21.4070365524292,0.06531391049192774,361.3379997253418,439.1339965820313,0.850799341555299,0.19479895773422504,1.0401470966150625,0.9885359525067001,0.9661559362042561,-0.03864105917269023,70.99861759710127,458.92649618733634,405.90412483215334,352.88175347697035,434.2857121058873,7.422752995681577,421.47946275983537,15.403799892713813,430.1000786618712,417.54357825559174,1.7214784113097619,9.025050076862161,4869500,7.929195948430552,0.6499469444685437,61192300.0,-49.61134200977489,91.40936679472856,92.55270083870475,42.602436259200026,36.967480566628254,15.817599807370119,0.005335305743290977,12.170953138064231,436.20099389648436,428.49949389648435,422.2749938964844,416.0504938964844,408.3489938964844,0.08,0.0,292.0884374886037,-0.04169118308747688,-0.03040873859022702,433.6357160295759,420.84857177734375,24.18811417940626
2023-06-23,1,421.54000091552734,360.87000274658203,444.37999725341797,399.0487480163574,429.6237506866455,-0.5142113091665312,24.38268348577622,-0.5768022158641259,2.993935163063875,405.79999923706055,20.059023666381837,0.05960366822526616,369.0805046081543,439.1339965820313,0.8347002271331121,0.16826696273083305,1.030457963041865,0.9835122817976565,0.9721964416627176,-0.05139744470736285,63.96462807330835,457.8456167579294,409.08024978637695,360.3148828148245,432.66964067731584,8.87600532902775,422.9137486049107,14.291002929158395,428.1254655231154,418.1509547835206,0.28086602386948034,5.474849452947334,8293900,8.239244088155449,1.1046485300032765,52898400.0,-47.08469897216839,91.40936679472856,92.55270083870475,37.62068749646162,35.83668568878809,15.048178318556088,0.006097974844475841,11.879456223766036,436.30483447265624,428.66757482910157,422.4949951171875,416.32241540527343,408.68515576171876,0.08,0.0,292.3834175167389,-0.04772385412066815,-0.03819806037615689,431.96285574776783,422.5307137625558,21.983666012893675
2023-06-26,1,421.05999755859375,360.87000274658203,444.37999725341797,401.1662483215332,429.6237506866455,-0.5988017574368526,21.897818796024442,-0.17928137020645574,2.994303465214762,414.0562515258789,18.29749870300293,0.05313872786396086,390.75875930786134,439.1339965820313,0.7811739865460199,0.16812147783740927,1.0217726629799426,0.9783327819943692,0.9814289250866447,-0.041149545255038,63.419924955663234,455.8833874547198,412.0877498626709,368.29211227062194,430.0824988228934,9.29495353936632,424.096248626709,13.301254769539842,426.49884974090384,418.64087486175447,-2.61347687169946,5.001744103234948,4640000,8.24262997710485,0.6247454397958806,48258400.0,-62.531051389247025,91.40936679472856,92.55270083870475,22.67319705773994,35.47574009334768,13.630678430263973,0.007853359348265733,12.178066319110945,436.30483447265624,428.66757482910157,422.4949951171875,416.32241540527343,408.68515576171876,0.02,1.0,292.54543170798894,-0.0370867425932383,-0.06587011767228053,428.4028581891741,423.4164276123047,18.060733583756534
2023-06-27,1,416.7125015258789,369.9350051879883,444.37999725341797,401.55374908447266,429.6237506866455,-0.41823767011496205,18.5288844723128,-0.3010708516628715,2.994728894752112,421.0387496948242,15.884273757934569,0.044637454211083664,395.11325454711914,439.1339965820313,0.7467486466880372,0.1381999314842495,1.0038912614433153,0.9682842468546838,0.9795469632815134,-0.039213085970111305,61.44054696810459,452.15501854789716,415.0972496032715,378.03948065864586,426.12999943324496,7.993326113796281,425.17678451538086,11.869228073458117,425.20466644643443,419.19444044599766,-4.1236863563258614,4.092656559890224,4818100,8.159903478550403,0.6691889204170608,43440300.0,-60.35176600583165,91.40936679472856,92.55270083870475,-4.816691262162703,33.491406158814996,14.895735394571789,-0.02769886981228114,11.978204787946726,436.30483447265624,428.66757482910157,422.4949951171875,416.32241540527343,408.68515576171876,0.04,0.0,292.7078418134334,-0.04053375923618319,-0.034447646025476765,424.37571498325894,424.68714032854353,15.921605508549561
2023-06-28,0,428.2800064086914,393.072509765625,444.37999725341797,403.21249771118164,429.6237506866455,0.07631238748921529,15.36223487278451,-1.2089980250554537,2.995055463301177,421.0387496948242,13.311511459350584,0.03680140259572219,399.7904968261719,439.1339965820313,0.8660041002004123,0.05406105464693208,1.0259773444466214,0.9961592880924796,1.0148526745785071,-0.0006241879868140732,51.39947686786481,448.16059416573506,417.43612442016604,386.711654674597,424.5800007411412,5.8046632003973455,426.68999917166576,10.677233560015129,423.1369096304652,419.2948954909887,-6.226089360129555,3.7669490832311214,8811300,6.291634192915514,1.2415134084096249,52251600.0,-35.95870471514397,91.40936679472856,92.55270083870475,57.932654592985706,38.97174767802858,13.184550187138019,-0.010683441789137868,12.566191729711816,436.30483447265624,428.66757482910157,422.4949951171875,416.32241540527343,408.68515576171876,0.04,0.0,293.03607973574094,0.012698748912346014,-0.011180160415606426,424.07285853794644,426.83499799455916,15.105710369446813
2023-06-29,0,431.64249420166016,393.072509765625,444.37999725341797,404.31749725341797,429.6237506866455,-0.05901652043276476,14.654460507304224,-1.1299726401067396,2.9951202421829968,421.17749786376953,12.419499511718755,0.03496790886846437,401.3424987792969,439.1339965820313,0.8060622545131505,0.08956997950342387,1.0299686838336486,1.0050491885030375,1.022950108872946,0.022364986550617028,61.60589487790766,448.3920455568448,419.0831245422363,389.77420352762783,424.283214024135,5.289727747342384,428.6819632393973,8.435297252565034,424.4317773410258,420.57650036640024,-2.4707924561266377,5.203946283905119,4932300,6.64741749639179,0.7051743956628408,57183900.0,-54.93945360793408,91.40936679472856,92.55270083870475,57.12837445177374,36.686993795913665,12.303372571410065,-0.06945577652677552,12.504321763806049,439.88259533691405,434.45869622802735,430.0749969482422,425.691297668457,420.2673985595703,0.04,0.0,293.2201221539875,0.01363373200686957,0.008929150473189477,423.1499982561384,428.18285478864397,14.162322558950956
2023-06-30,0,436.70249938964844,400.28499603271484,444.37999725341797,406.44750022888184,431.94499588012695,-0.1131091729827223,13.60490307833497,-1.1711777021061334,2.995209347986461,421.4174995422363,11.168387489318855,0.032314792063698534,401.57249908447267,439.1339965820313,0.8099999240993846,0.07833793042390852,1.0372694594161718,1.0186164087069687,1.0303305184745337,0.03596929933384785,62.7146994111529,448.22142992070803,421.01162376403806,393.8018176073681,425.44821384974887,7.005251061298397,429.78249904087613,8.402428024040745,426.21373892050843,422.49476732205244,-0.4789972823932108,6.907034498136136,7342000,6.538749110679664,1.0483277373497812,64525900.0,-21.965020195821843,91.40936679472856,92.55270083870475,94.24851359587345,36.935874145224254,11.208428665106606,-0.06621340597782681,12.745441986592267,439.88259533691405,434.45869622802735,430.0749969482422,425.691297668457,420.2673985595703,0.02,1.0,293.5087027039492,0.03884251131418259,0.0426291866590339,425.44142368861606,429.6449977329799,14.21353171952948
2023-07-03,0,438.5924987792969,401.45999908447266,444.37999725341797,414.30812644958496,433.0693759918213,-0.2625536846557333,13.138048768111782,-1.075099361027783,2.995248090329981,421.86999893188477,10.893249740600584,0.031071520758928765,403.5379974365234,439.1339965820313,0.7773158559226683,0.08778583267460298,1.0372724421306863,1.0248601756636833,1.0274386541575,0.04163896195877248,65.88332465652897,449.1085964681083,422.83249893188474,396.55640139566117,427.78999982561385,8.349399548905133,431.03785596575057,8.304486193843527,428.81538536667597,424.92330235413465,1.9029392932363987,3.657176393659556,3733200,6.581291764508766,0.5414099107656921,68259100.0,-19.407786378560967,91.40936679472856,92.55270083870475,83.33875744688346,34.84743651043649,10.574678827238769,-0.03461551766889006,12.544338464391442,439.88259533691405,434.45869622802735,430.0749969482422,425.691297668457,420.2673985595703,0.02,0.0,293.6546289665841,0.06130691890735429,0.04108300051668718,428.1499938964844,430.8928549630301,13.837828827471128
2023-07-05,0,445.3499984741211,401.58499908447266,444.37999725341797,419.94125175476074,434.46562576293945,-0.4010556158865606,12.599244476255633,-0.9100623154151224,2.9952903263933344,425.2400016784668,10.612624740600586,0.02966698172079652,404.429997253418,439.1339965820313,0.7663917840249042,0.08426966726575064,1.0486494082234872,1.0407811613075681,1.0347687852554772,0.06872243295648706,66.61640942494691,449.88761286913723,424.689123916626,399.49063496411475,431.1914280482701,10.054666457636044,431.93053436279297,9.143836188161472,431.22259814119263,427.35022406220594,3.882639021682479,4.174410059393364,6869500,6.575349653355534,0.9989914832322272,75128600.0,-12.845217044379995,91.40936679472856,92.55270083870475,117.60268007248344,37.980464001971704,9.88657963464779,-0.0027488215563225595,12.459029010043157,441.6550809326172,435.8924607543945,431.23500061035156,426.5775404663086,420.81492028808594,0.04,0.0,293.9358914055386,0.06909947312762088,0.07202959869025488,431.2757088797433,431.6192823137556,13.71451077229712
2023-07-06,1,438.0899963378906,401.58499908447266,445.3499984741211,421.049373626709,437.17499923706055,-0.46986302570225136,12.47172059007362,-0.6435329385211017,2.9953030883029297,428.4137535095215,10.432237129211426,0.029226162758603492,406.7610008239746,439.6909912109375,0.6948198040820275,0.10898066284702669,1.0266177343708132,1.0210394560413476,1.0045320699535707,0.02290555193425936,71.53583867164149,451.67481515780844,426.7313739776611,401.7879327975138,433.62428501674106,9.22036437206636,431.8533919198172,9.08241138669626,434.7176032831312,430.3560192754064,5.648336458433763,2.8872416197573685,4938800,6.565271883052382,0.7184963193575606,70189800.0,-30.732213092635963,91.40936679472856,92.55270083870475,61.22703685436277,34.72586775251531,14.063447651457428,0.02500478359925869,12.653383557595905,441.6550809326172,435.8924607543945,431.23500061035156,426.5775404663086,420.81492028808594,0.04,0.0,294.126763627008,0.020938023628972013,0.05217227022676797,434.54713657924106,431.4749973842076,12.363160939887818
2023-07-07,1,438.7174987792969,403.75499725341797,445.3499984741211,421.2362480163574,438.2156219482422,-0.5201921272088388,11.271476566908277,-0.4759744113674227,2.995384721622572,430.09499740600586,9.406373596191406,0.02630102054170491,415.7507514953613,439.6909912109375,0.7060918675906817,0.07613700739200142,1.0237095272216596,1.0202329204298506,1.001465503883532,0.016390889851385593,61.83224000707431,451.09957697414853,428.556623840332,406.0136707065155,436.7678560529436,5.490125203395641,431.4489277430943,8.594642337277941,435.5499174466811,432.26228075013506,4.044553953840514,-0.24591712205410676,4160100,6.850075731963536,0.641477459779482,74349900.0,-32.60702994464775,91.40936679472856,92.55270083870475,65.19904326864864,33.40778785269324,13.52964536309724,0.10372664407535237,12.213141177365783,441.6550809326172,435.8924607543945,431.23500061035156,426.5775404663086,420.81492028808594,0.04,0.0,294.2886059936992,0.023024509840251728,0.01921647551646621,437.5499965122768,430.96285574776783,10.503073077925787
2023-07-10,1,440.36499786376953,403.75499725341797,445.3499984741211,421.47875022888184,438.6237487792969,-0.6427197757802011,10.328520456563469,-0.05302912388696779,2.995442415710468,432.24749755859375,8.683223724365234,0.024012122831210993,420.5870018005371,439.6909912109375,0.6013694693198794,0.08659335924933356,1.0237766835763271,1.020145652521937,1.0019898029991499,0.008386712874874691,63.232555723246996,450.79478963138865,430.1377487182617,409.4807078051348,438.4942834036691,4.10042327766686,431.5371420724051,8.685403017965653,436.3620022038549,433.588872216526,5.28061845345223,-1.2742469303567512,4251700,6.755163159706673,0.6645134619577492,78601600.0,-23.460880362901698,91.40936679472856,92.55270083870475,76.93341229430571,33.133905605144726,12.912372909333312,0.06911082033608539,11.882916545974663,441.6550809326172,435.8924607543945,431.23500061035156,426.5775404663086,420.81492028808594,0.04,0.0,294.4561779040237,0.0027696457303241218,0.031454328245549924,439.24571010044644,431.65928431919644,9.534076636430552
2023-07-11,1,437.6749954223633,416.7125015258789,445.3499984741211,422.0349979400635,438.82062339782715,-0.23310936732362256,8.588070619839707,-1.26331857924357,2.9955343133815027,433.28625106811523,7.541924057006838,0.019881254339214848,421.05574798583984,440.76649780273436,0.725159402510713,0.045265193694934105,1.0132110327324149,1.0095115548637859,0.9942120183729238,-0.0020919266961637595,61.15330809851606,449.14438998845867,431.9682487487793,414.7921075090999,439.356069292341,2.8695620873327026,431.819641658238,8.825060549187253,437.435227735536,435.05663814146783,2.8217500873822896,0.2812380429658634,4574600,5.6534587771324905,0.761317368956671,74027000.0,-27.261234945138717,91.40936679472856,92.55270083870475,40.82777947366846,30.99316866075497,15.578014343272228,0.11277917802918343,11.796278429130481,441.6550809326172,435.8924607543945,431.23500061035156,426.5775404663086,420.81492028808594,0.04,0.0,294.63159304309744,-0.0027863605009185166,-0.0006356529898622528,440.9557102748326,432.0528542654855,9.25792849721645
2023-07-12,1,442.9399948120117,416.7125015258789,445.3499984741211,426.7600040435791,438.82062339782715,-0.43199614082628646,8.307624821760175,-1.029814647396964,2.9955475056464773,435.2112503051758,7.129798889160156,0.01919563214585057,421.05574798583984,440.76649780273436,0.7116685141517072,0.03956484829933006,1.023458977206781,1.0177551005031618,1.0065914479355211,-0.005411482363010256,57.669089569591364,449.4024982549705,432.7872486114502,416.1719989679299,440.2471400669643,2.876669325878512,432.8476769583566,9.242965612957148,437.5467080656576,435.41894428549233,1.3975688913253257,0.9118772919230936,5731700,5.7076398412653155,0.9556966721440356,79758700.0,-17.532336492821514,91.40936679472856,92.55270083870475,82.2790244728557,32.38184978185599,14.83690233833699,0.10304850461730511,11.500830231486086,441.6550809326172,435.8924607543945,431.23500061035156,426.5775404663086,420.81492028808594,0.04,0.0,294.85853137724007,-0.004148926057050306,0.005912435069608072,441.4642813546317,433.45285252162387,9.30875898369801
2023-07-13,1,447.55750274658203,416.7125015258789,445.3499984741211,428.4806270599365,439.1399955749512,-0.6192084390253827,8.12666639771775,-0.7219756921808012,2.995556163968734,437.18874740600586,6.839535903930664,0.0187300710249586,421.492000579834,443.08399505615233,0.7712435521863154,0.023304691263532712,1.031515679854997,1.0222046972963033,1.0182001357379007,0.021610871026119804,59.89326876080472,450.13670605593353,433.88337326049805,417.63004046506256,441.5278549194336,3.848664474984582,434.6589273725237,9.47749750089324,438.9698205817828,436.4559437583068,1.4283168589786035,3.3584361549564257,6157500,5.210652290490247,1.041128595233043,85916200.0,-3.211371953466217,91.40936679472856,92.55270083870475,119.30359346150527,34.17130755793596,13.864160951808218,0.10059233046262918,11.428629554376577,442.1898902587891,436.32506829833983,431.5850067138672,426.84494512939455,420.9801231689453,0.06,0.0,295.1103488487968,0.026296619818665157,0.010047120537454322,442.7414245605469,435.4457092285156,9.997547941995466
2023-07-14,1,447.72000885009766,416.7125015258789,447.55750274658203,428.4806270599365,439.46874237060547,-0.5716845617319342,8.648587746747722,-0.7606306772702105,2.9955335028972043,437.88249588012695,7.324648742675777,0.019899257146517104,421.492000579834,444.4769973754883,0.7691240710793457,0.019098554973500374,1.0301445561559253,1.0180932836279475,1.014200921404103,0.02052006153356012,62.63406454854048,451.91579884554625,434.6186233520508,417.32144785855536,441.86642783028736,4.3167286433652805,436.52892793927873,9.27041387233582,441.15404849384385,437.50578521990946,2.044039510989543,6.0060412083443095,7184900,5.124403749597553,1.2275910262445016,93101100.0,-32.392182671203365,91.40936679472856,92.55270083870475,98.56569259950082,33.61253209104364,12.457220930540016,0.051810998183532984,11.810870213299486,445.8647283935547,439.29764678955075,433.99000549316406,428.68236419677737,422.11528259277344,0.08,0.0,295.39984965426356,0.008696638907814913,0.006995732726820455,442.17142595563615,436.7235674176897,10.033748688847862
2023-07-17,1,449.3524932861328,416.7125015258789,447.72000885009766,428.4806270599365,441.0087471008301,-0.49352187603177744,9.064319109291505,-0.849255758904155,2.995514440392227,437.88249588012695,7.666649475097654,0.020835305967963142,421.492000579834,445.5707489013672,0.7799270847637132,0.007516115975793952,1.0328847177816838,1.0180834131741259,1.0137641798121564,0.020409195703477767,61.61148630119611,453.17476248616106,435.04612426757814,416.9174860489952,443.47535596575057,4.751562375674355,438.54982049124584,8.70546857717953,442.80302851000135,438.4869804953314,0.5321680440320652,6.2105631441170255,6891700,4.999623722288565,1.179593782386967,99992800.0,-14.674647980557602,91.40936679472856,92.55270083870475,132.22066488545485,30.78171469670534,11.364050036298488,0.027417360098424107,12.022235841897535,446.01751440429695,439.42123547363286,434.0899963378906,428.75875720214844,422.16247827148436,0.1,0.0,295.684912526211,0.018881158450631874,0.027276835249870984,443.7728533063616,439.15999494280135,10.347037270387734
2023-07-18,0,463.1824951171875,416.7125015258789,449.3524932861328,428.4806270599365,441.0087471008301,-0.3967955074526395,9.379638431306523,-0.8647726389395363,2.9954994195829636,437.88249588012695,7.8655493164062475,0.02154778676141374,421.492000579834,447.5737533569336,0.8116147381521124,0.023278974555718028,1.064066350691355,1.0464184943159325,1.0407449429917603,0.0582795452370064,65.33523949698191,454.05402593182697,435.2947490692139,416.5354722066008,446.97035544259205,8.323591464276939,441.86910574776783,8.59722842620914,444.4259027714296,439.3764981340744,2.5708181064138325,6.719350185623354,13196900,4.84017282495893,2.1759091707261575,113189700.0,-6.062264497926111,91.40936679472856,92.55270083870475,226.5482922732802,37.47646638089808,9.56633495485473,0.173283690685417,13.261361504418346,465.1086387939453,457.0406818237305,450.52000427246094,443.99932672119144,435.93136975097656,0.12000000000000001,0.0,296.2861473778933,0.07857612732404395,0.07491339788100722,449.01570783342635,443.28285217285156,13.590880074521385
2023-07-19,0,477.3624954223633,416.7125015258789,463.1824951171875,428.4806270599365,443.54249572753906,0.21736512915705028,11.166117186310428,-0.15553279115703944,2.9954055814650986,437.88249588012695,8.827649230957036,0.02558117838132108,421.492000579834,447.88325729370115,0.7328349939717993,0.06792975609508971,1.0936205436678776,1.072495753459737,1.0604508859207857,0.07771368811470913,77.15765363333222,458.8296083350231,436.4973739624023,414.1651395897815,452.2557122366769,13.541291776793699,445.374997820173,11.974008892918256,449.065457558874,442.0842508666653,5.5764806295538465,11.151571748183487,20996500,5.462469128210136,3.0531348561806477,134186200.0,-12.591338816644082,91.40936679472856,92.55270083870475,240.97104416655594,38.13204334330602,8.800610377329438,0.1567291777481319,13.385549968388473,471.1113985595703,462.51929766845706,455.5749969482422,448.6306962280273,440.03859533691406,0.14,0.0,297.2911231083762,0.07553205600032453,0.08491403104971777,454.1414228166853,446.69356645856584,16.28682209141394
2023-07-20,0,441.2300033569336,416.7125015258789,477.3624954223633,428.4806270599365,445.9018745422363,0.8214035160073077,14.248955133539216,0.810779698861908,2.9952091010102295,438.34124755859375,10.443199729919433,0.032481470359701885,421.492000579834,450.7354934692383,0.7062088945505889,0.11390801426326787,1.005814050330974,0.9842375559900219,0.9654184126834937,-0.014137846758947581,84.50645306607656,467.17740893956375,438.67949867248535,410.18158840540696,452.7635705130441,12.957385353438948,446.05981990269254,11.388027255586808,456.0907198039115,446.5609358033561,8.401552743308455,11.46037365256652,23989700,5.900582980821934,3.0680524018137416,110196500.0,-87.65657266450285,91.40936679472856,92.55270083870475,-1.2630819990332018,30.21572855029817,24.2776003255847,0.107664264578135,15.685867566210213,472.18992028808594,464.2650404663086,457.86000061035156,451.4549607543945,443.5300809326172,0.02,1.0,298.1851763257747,-0.028775681234894712,-0.014930693722539723,453.7428545270647,447.34928240094865,15.91520412028047
2023-07-21,0,431.5749969482422,416.7125015258789,477.3624954223633,430.80187225341797,445.9018745422363,0.7377055215535746,14.064956174070945,0.8554886399947192,2.995223477504545,438.6549987792969,10.123737564086912,0.03201575232768078,421.492000579834,450.7354934692383,0.7031750979600981,0.045073440422180554,0.9823847328146545,0.9620266106895733,0.9469150474079082,-0.03606051010166267,51.24020290580016,467.4435361579563,439.31362380981443,411.18371146167254,451.13999938964844,14.95194602157815,445.6935697283064,11.78756137837498,452.32945584026913,445.6574735521173,0.812248351345654,2.2211689729496893,17303700,10.344443756136572,2.049981607422427,92892800.0,-93.02702195626522,91.40936679472856,92.55270083870475,-68.98712545164408,28.138941318065477,26.63240216960412,0.04843204677480456,15.64044758240725,470.4128405761719,461.3885809326172,454.0950012207031,446.8014215087891,437.77716186523435,0.04,0.0,298.7794158648223,-0.03260845770110121,-0.05080155565246687,451.3785705566406,446.42142595563615,15.661509553124926
2023-07-24,0,425.3000030517578,416.7125015258789,477.3624954223633,431.62561988830566,445.9018745422363,0.7959784723797457,13.636486779347251,1.1279976116900423,2.995255192690285,438.6549987792969,9.701862564086912,0.03100735179815188,421.492000579834,450.7354934692383,0.6578273714521817,0.023805560589553073,0.9670692332832794,0.9495507988184564,0.9398054009188982,-0.05352699850061626,45.89823155461563,467.05534736850893,439.78237380981443,412.5094002511199,447.96035657610213,17.913981358078825,444.74410574776783,12.887553475229337,447.1184074831148,443.7162217938643,-2.5658098155243247,-1.174140850710183,8264400,10.612024881845677,0.979260447684263,84628400.0,-86.05076277717855,91.40936679472856,92.55270083870475,-99.69984801391115,26.889206618518205,27.32949015112967,0.06733389926824788,15.198273627023225,469.4688405761719,459.8605809326172,452.0950012207031,444.32942150878904,434.72116186523436,0.06,0.0,299.05219683839294,-0.04817241031846087,-0.03063974210295261,448.2342834472656,445.48785400390625,15.45269192215608
2023-07-25,0,427.9725036621094,416.7125015258789,477.3624954223633,431.62561988830566,445.9018745422363,0.8582826780581699,13.40769079077866,1.2644585266747823,2.995271690587861,438.6549987792969,9.532662467956545,0.030474076405243154,424.8760025024414,450.7354934692383,0.6165917015090508,0.010069836882507541,0.9727302769327141,0.9587423196903493,0.9558718531904165,-0.07601753482969997,42.782752412795105,466.78575549818333,439.970373916626,413.15499233506864,445.1392844063895,19.447415116841324,443.50285611833846,13.639611913686243,441.64032062258735,441.3151879554477,-4.973103915861948,-3.030716613835192,4859800,10.719351373005589,0.5750956757178933,89488200.0,-87.06881920478999,91.40936679472856,92.55270083870475,-85.64320858719809,27.36504536908221,26.68788166217432,0.0813985676233847,14.451968367950096,469.4688405761719,459.8605809326172,452.0950012207031,444.32942150878904,434.72116186523436,0.06,0.0,299.21564397653026,-0.09919961414673584,-0.049661095860797554,446.20428466796875,444.1878553118025,14.673327234096373
2023-07-26,0,421.9300079345703,416.7125015258789,477.3624954223633,431.62561988830566,445.9018745422363,0.976736316512164,12.998616977265026,1.5313542210257607,2.9953004365072355,438.6549987792969,9.221599693298339,0.02952110983983844,427.7052536010742,450.7354934692383,0.5735986126924004,0.027021032714400563,0.9582436447466679,0.9472648705567718,0.9574347553531588,-0.11612241853802763,45.09403992709191,466.3132331763318,440.31599922180175,414.3187652672717,441.22178649902344,21.14514753106076,442.348571232387,14.769882735885833,438.24019163073524,439.66798602434983,-4.410681854203214,-3.9019860495231393,6009200,10.676339010988311,0.7061360344771871,83479000.0,-89.7997165879582,91.40936679472856,92.55270083870475,-139.74933082349472,25.707970429837438,30.342195608017818,0.09185083489369912,14.28468604660656,468.6192391357422,458.4853786010742,450.2949981689453,442.1046177368164,431.97075720214843,0.08,0.0,299.40614422867145,-0.11499399763662732,-0.10979354613624173,442.29285975864957,443.0328565325056,14.238896889747842
2023-07-27,0,419.8675003051758,421.9300079345703,477.3624954223633,431.62561988830566,445.9018745422363,1.1931465094566567,12.567496409208417,1.6911314747534538,2.995329799708611,438.6549987792969,9.007999572753908,0.028525093202556688,427.7052536010742,450.7354934692383,0.592572454961145,-0.014826745071217569,0.9529948677887876,0.94710177016729,0.9773417862419418,-0.04841579876533597,39.93467554859379,465.7118673606532,440.57687454223634,415.4418817238195,435.03393009730746,19.9516475199459,441.0021427699498,15.939250915768831,434.2070781477462,437.3177233872034,-6.102666784158861,-3.6887371404062868,6594500,10.445234276089918,0.7851403745742865,76884500.0,-98.23576500127713,91.40936679472856,92.55270083870475,-153.2293843804634,23.710997911615483,29.827882267362845,0.06210330419198172,14.381493052624624,467.74368115234375,457.0681618652344,448.44000244140625,439.8118430175781,429.13632373046875,0.1,0.0,299.60826961229003,-0.05543870709063092,-0.13488553655671567,433.4885777064732,441.2521427699498,15.390127654175627
2023-07-28,0,420.6425018310547,419.8675003051758,477.3624954223633,431.62561988830566,445.9018745422363,0.9933434009646961,13.101461793172316,1.3665815258329035,2.9952933722284536,438.6549987792969,9.365374679565429,0.029765479453902052,424.96300354003904,450.7354934692383,0.6282889703316431,-0.02727950573602048,0.9556663174955944,0.9548137945381838,0.988981469584514,-0.0253316229959879,38.25053872261259,466.3591728234052,440.15624923706054,413.9533256507159,426.9310738699777,7.574312337771478,439.5933930533273,16.845682673697745,430.64183431555523,434.4712688165401,-9.351604447195873,-4.296614228192401,6424200,10.414382560470091,0.7581313069923162,83308700.0,-80.9901602506849,91.40936679472856,92.55270083870475,-113.67406355215674,22.026271707792763,27.708536002491055,0.1088236931034222,14.375671248363489,467.74368115234375,457.0681618652344,448.44000244140625,439.8118430175781,429.13632373046875,0.1,0.0,299.812521753119,-0.004023394668311364,-0.026610612891768227,426.087149483817,440.11428615025113,15.502912133470884
2023-07-31,0,432.72750091552734,419.8675003051758,477.3624954223633,430.674373626709,445.9018745422363,0.8625696935290809,13.666049801925217,1.0179514098200437,2.995253089194458,438.6549987792969,9.860374336242677,0.031087023475630693,421.80125732421874,450.7354934692383,0.6772507574595302,-0.03677560256934594,0.9843524774523292,0.9883199761215964,1.022651937544805,0.01746413780971845,37.85469901740157,466.9383492223807,439.6062496185303,412.2741500146799,425.7164306640625,5.212691555847317,439.2400005885533,16.940650109578602,428.167340879534,433.15182220228024,-11.881954308355034,-4.478670223198837,6587600,10.335038422319053,0.780890492069118,89896300.0,-62.95131544460008,91.40936679472856,92.55270083870475,-29.918176320927643,26.380930107844208,25.861149348683018,0.12812975942236257,14.302409452302923,467.74368115234375,457.0681618652344,448.44000244140625,439.8118430175781,429.13632373046875,0.1,0.0,300.042497828009,0.024744977996453255,0.026830412212171053,426.30857631138394,440.02571541922435,15.50619374645905
2023-08-01,0,438.15999603271484,419.8675003051758,477.3624954223633,430.674373626709,445.9018745422363,0.8871445961920679,13.735562841503576,0.990366296379448,2.995247912297657,438.6549987792969,10.039249267578123,0.0312592817624714,421.80125732421874,450.7354934692383,0.7043998775428362,-0.013372316854695783,0.9971609413517617,1.0045417023156589,1.0318678773177097,0.023804081531949572,47.03751505749188,466.8786253778313,439.4074996948242,411.93637401181707,426.65714481898715,6.798993036561626,438.8985721043178,16.908481177768323,429.3072642259859,433.758444365778,-1.9270000627151684,-1.130403737609348,5711500,10.72058266390031,0.6691915863349708,95607800.0,-63.42998903170122,91.40936679472856,92.55270083870475,-6.486206404374752,27.61539716221606,24.06830375021937,0.10668448291462375,14.270094927389545,467.74368115234375,457.0681618652344,448.44000244140625,439.8118430175781,429.13632373046875,0.1,0.0,300.2465997293911,0.025531874207359806,0.023927913058420323,427.8971470424107,439.63785879952565,15.50837117587907
2023-08-02,0,431.7625045776367,419.8675003051758,477.3624954223633,430.674373626709,445.9018745422363,0.8915290124108658,13.737169317987696,0.9941017441143907,2.995247774024814,438.43874740600586,10.058711891174317,0.03126447642820193,421.80125732421874,450.7354934692383,0.7076968311544011,-0.016144610903875537,0.9826499429743027,0.9955860064800975,1.0119461338145643,0.023303620169606853,49.64328327130892,466.86021319347054,439.38587455749513,411.9115359215197,427.58035932268416,7.019193059240111,437.77035794939314,16.812961584107757,431.5074549044882,435.0952239950418,1.5258064371283262,-1.0791526697257392,4912200,10.678617946870595,0.582217028206508,90695600.0,-75.62909120048606,91.40936679472856,92.55270083870475,-52.490371592327676,25.9297184344269,25.048891600680278,0.0947841048350743,14.11223082961841,467.74368115234375,457.0681618652344,448.44000244140625,439.8118430175781,429.13632373046875,0.1,0.0,300.41175445110275,0.01663235752705905,0.004676174755477644,428.087149483817,438.16071646554127,15.616958699809057
2023-08-03,0,431.97999572753906,419.8675003051758,477.3624954223633,430.674373626709,444.0943717956543,1.0224868132695721,13.761377862806539,1.156299569965654,2.9952452329022687,438.12499618530273,10.006899147033693,0.03136807379675088,421.80125732421874,450.7354934692383,0.7087578956715468,-0.01444336052671157,0.9846674162857458,1.0066724122364032,1.0078108843702671,0.02884837576987853,46.622603579587526,466.229255588284,438.7064998626709,411.18374413705783,428.1528581891741,7.217145856273612,436.6460712977818,16.621626919670696,431.542483729865,435.07248015857715,1.5195159838953582,-3.5291550408638384,6243900,10.651065280154548,0.7343764609991514,96939500.0,-73.85120843273528,91.40936679472856,92.55270083870475,-32.58677677983271,27.215273491517266,23.186014218323713,0.06631812674453852,14.157070787101029,467.74368115234375,457.0681618652344,448.44000244140625,439.8118430175781,429.13632373046875,0.1,0.0,300.6255278462415,0.04315411572186667,0.019708014071572733,428.55857631138394,437.38143048967635,15.729140016034755
2023-08-04,0,431.8574981689453,419.8675003051758,477.3624954223633,430.674373626709,444.0943717956543,1.0658170327510184,13.839273083456716,1.157487953080679,2.9952392740332043,437.91749572753906,10.281849174499513,0.031567612958809936,421.80125732421874,450.7354934692383,0.7130213596993672,-0.015357269929976533,0.9850741634583103,1.0085609941361717,1.001862869665882,0.026661586237890278,46.67099060917084,466.07954599906674,438.40099983215333,410.7224536652399,429.5710710797991,6.750856283106123,435.3964287894113,16.24626594309589,431.6456233514111,435.38989138902554,0.9363900790677108,-3.515592962437502,5439700,10.649512583179483,0.6350119859285724,91499800.0,-73.03063110288998,91.40936679472856,92.55270083870475,-41.33141928548907,25.78216606798104,22.438650270797122,0.07452795234634112,13.87656651561724,467.74368115234375,457.0681618652344,448.44000244140625,439.8118430175781,429.13632373046875,0.1,0.0,300.80852727338976,0.013669048196027545,0.044606317198294824,429.83428955078125,436.0635746547154,15.815304872222189
2023-08-07,0,436.80999755859375,419.8675003051758,477.3624954223633,430.674373626709,444.0943717956543,1.1179661555625822,13.911998151926188,1.1802873022230553,2.9952336056202746,435.2012481689453,10.534798927307127,0.031758347429394984,421.80125732421874,450.7354934692383,0.7160474999558297,-0.019319200517966876,0.9971510570663996,1.0200597737457466,1.0081064360665426,0.009434336006907351,46.25411127312978,465.88199610548804,438.05799980163573,410.2340034977834,431.99142783028736,5.637378919923075,433.51267896379744,14.173345919599006,431.6645767541436,435.61854166128614,2.3528760807916935,-3.8933788904220603,4781300,10.63932825757825,0.5564325843513882,96281100.0,-60.50327296038892,91.40936679472856,92.55270083870475,-6.156700927736232,26.542602828036454,21.017270535681842,0.09338537542822874,13.756810456605514,467.74368115234375,457.0681618652344,448.44000244140625,439.8118430175781,429.13632373046875,0.02,1.0,300.97567175703495,0.004077746861845144,0.035182514512836514,433.77571759905135,433.6321476527623,15.807086963005192
2023-08-08,0,439.3324966430664,419.8675003051758,477.3624954223633,430.674373626709,444.0943717956543,1.1579631357458529,13.904095115766095,1.2479980102905026,2.9952339748225474,434.76874923706055,10.446299133300784,0.03175319079257242,421.80125732421874,450.7354934692383,0.7189950002011631,-0.001976347456026805,1.0033165388422929,1.023200206711919,1.0120210319157106,0.002675964535712616,50.824331103097954,465.6884400179091,437.88024978637696,410.0720595548448,434.66142708914623,3.313385584829008,430.79625047956193,6.901764833757875,432.89598904864954,436.3307680974281,4.035200924363879,-5.693759551928096,3767200,10.69129481467369,0.4404842848298227,100048300.0,-27.85366894340179,91.40936679472856,92.55270083870475,6.278707141885769,26.655712028680117,20.06687975373756,0.06493246423334154,13.379181225469615,439.85768115234373,434.5111618652344,430.19000244140625,425.8688430175781,420.52232373046877,0.04,0.0,301.10907086671557,-0.000729577601981668,-0.0015263307876876213,435.5642874581473,430.82571847098217,15.802696725099715
2023-08-09,0,434.2124938964844,419.8675003051758,477.3624954223633,430.674373626709,444.0943717956543,1.139276774695151,13.907564031543048,1.2163984610621839,2.995233817883374,434.76874923706055,10.516936264038089,0.03175510275297376,421.80125732421874,450.7354934692383,0.7186052771332339,-0.008144439904272749,0.991436194651697,1.008607279155193,0.9996868766920329,0.005674391112874266,51.811504623827624,465.7782529104982,437.96312484741213,410.14799678432604,434.8735689435686,3.2150061068940845,430.2949998038156,6.315649916522715,434.58266643961974,436.96917298106587,4.443201704690863,-7.9666918000435905,3846600,10.63699879755437,0.454780300656763,96201700.0,-48.996129744994825,91.40936679472856,92.55270083870475,-32.18147113751862,24.79796120506929,22.685253991417675,0.025638149484872537,13.354239622171562,437.3746811523437,432.50266186523436,428.56500244140625,424.62734301757814,419.7553237304688,0.04,0.0,301.2384887087688,-0.001861806580916503,-0.022160415231654455,434.12571498325894,430.21714564732144,15.886399395535323
2023-08-10,0,431.97750091552734,419.8675003051758,477.3624954223633,430.674373626709,442.8118782043457,1.236765180334066,13.88145575957975,1.39723393858666,2.9952351965962607,433.46999740600586,10.368349304199217,0.031727101864910595,421.80125732421874,450.7354934692383,0.7058888907119647,-0.029817417355762498,0.9873167780287164,1.000561113206898,0.9934205561212002,-5.775295236820632e-06,46.57880533256738,465.28966132079523,437.52674980163573,409.76383828247623,433.990355355399,3.0039898168566634,430.3237500871931,6.322837030485392,434.57739733009157,436.5179551583168,0.3431704658971782,-1.5904424919110487,5467600,10.627605573238066,0.6490769149496269,90734100.0,-45.75963814213127,91.40936679472856,92.55270083870475,-29.260676170958433,23.520367002542777,21.516506740681923,-0.025391116187328863,13.073936268857961,437.3746811523437,432.50266186523436,428.56500244140625,424.62734301757814,419.7553237304688,0.04,0.0,301.42185683597313,-0.0023665638368256525,0.0006516145481557807,432.8914315359933,430.394289289202,15.687090594094233
2023-08-11,0,425.6500015258789,419.8675003051758,477.3624954223633,430.674373626709,439.8068733215332,1.4248663557186017,13.733057954818436,1.8814855874293004,2.995244916921601,432.3537483215332,9.916798858642574,0.031443912335975543,421.80125732421874,450.7354934692383,0.6946580395269218,-0.03516150188373891,0.9745900277870444,0.983147452775088,0.9788703012045635,-0.01437394665922409,44.7761723601664,464.2138656197198,436.747749710083,409.2816338004462,433.1171406337193,4.347497061167804,430.34874997820174,6.302103598113647,434.0053555164522,435.83766783520366,-1.4110131397586303,0.09326396805453205,3925200,10.630820153629035,0.4751672685145394,86808900.0,-70.69223790728215,91.40936679472856,92.55270083870475,-74.30620913141078,22.300137213643545,24.50598639786584,-0.015930925998993494,12.804370700407164,437.3746811523437,432.50266186523436,428.56500244140625,424.62734301757814,419.7553237304688,0.04,0.0,301.54542914952157,-0.02303058920490897,-0.021670525145917923,431.74285888671875,429.91500418526783,15.98645062911455
2023-08-14,0,424.3499984741211,419.8675003051758,477.3624954223633,427.39187812805176,438.45312118530273,1.627126264278851,13.693708224523874,2.4242752425227225,2.995246251580818,431.9787483215332,9.592023200988763,0.03143323536382748,421.80125732421874,450.7354934692383,0.6686326380212071,-0.05274810335849398,0.974074601267522,0.979012427928829,0.9786748747415209,-0.028524986044535905,39.74095978721537,463.03166579291985,435.64424934387205,408.25683289482424,432.02714102608815,5.4872180759420885,430.0899996076311,6.479053678472235,431.968210237167,434.33005034528514,-1.4157095595267704,0.08229449132604401,3966000,10.682300421204916,0.4887616251878608,82842900.0,-52.352423664890054,91.40936679472856,92.55270083870475,-66.37987571592063,21.028021526670905,24.552570347452928,0.009229422747204716,12.609059030679417,437.3746811523437,432.50266186523436,428.56500244140625,424.62734301757814,419.7553237304688,0.04,0.0,301.67063872038426,-0.029449157588571362,-0.008850804611208818,431.2828587123326,429.92071751185824,15.709492246423322
2023-08-15,0,424.5675048828125,419.8675003051758,477.3624954223633,425.56250190734863,437.147497177124,1.8855249293054728,13.525422012186835,3.3166366586486316,2.995256555473688,431.9174995422363,8.971273651123056,0.03113629132194062,421.80125732421874,443.425252532959,0.5985280037119473,-0.08383843744621997,0.9773785620847575,0.9814110689961625,0.9848366383693117,-0.03360778424786015,35.02931517037312,461.44496862764515,434.3941246032715,407.34328057889786,430.98571341378346,6.1736370380711225,430.27839224679127,6.258110886381418,430.1084354915323,432.7403934327986,-1.7662848578364274,-0.8464340949455722,3368000,10.075354887429214,0.44182428301941246,86210900.0,-64.57893600910116,91.40936679472856,92.55270083870475,-68.68817529481164,20.197154687365305,23.39915738628504,-0.06453541652560392,12.285553855078426,437.3746811523437,432.50266186523436,428.56500244140625,424.62734301757814,419.7553237304688,0.04,0.0,301.7763258324927,-0.033310463136115076,-0.03870586527953246,430.154288155692,429.9942888532366,12.695969276125986
2023-08-16,0,419.7350082397461,419.8675003051758,477.3624954223633,425.1168785095215,434.8618698120117,2.5006034047699592,11.941476284151229,7.18949830211521,2.9953593521855733,431.810001373291,7.259135818481445,0.027612688083986793,421.80125732421874,439.5222473144531,0.318830459900448,-0.11059727365644541,0.9705677576763303,0.9732985715531919,0.9803422580548742,-0.03334193709356892,30.54528031203551,456.3463276598552,432.46337509155273,408.58042252325026,428.5464292253767,6.827494602927171,430.26892852783203,6.275142632111997,428.7030261548671,430.7725635763795,-1.6880552768082129,0.6251029551449183,3967000,9.348187353232422,0.5858407301817258,82243900.0,-94.63320747695415,91.40936679472856,92.55270083870475,-129.16911167994087,19.09031084734069,25.543441519407196,-0.10253740467796499,12.069443562974607,437.8183623046875,433.22082373046874,429.5050048828125,425.78918603515626,421.1916474609375,0.02,1.0,301.8942887543625,-0.03135924896445497,-0.05213318782187735,426.53857421875,430.15714590890065,7.512170373437066
2023-08-17,1,408.70499420166016,419.7350082397461,441.2300033569336,424.51312828063965,433.0987491607666,0.047960426921262934,6.449849103596743,-1.0825952222309612,2.995619578738286,431.66875076293945,5.622297668457032,0.01501424429468642,420.5650016784668,438.27724609375,0.5447660466026127,-0.04871607767751708,0.9514015799191605,0.9503723011336543,0.9610798942362148,-0.053874349160647816,33.624829207464174,442.48169893961534,429.5820007324219,416.6823025252284,424.1710717337472,8.39667708603126,429.4162494114467,8.199731256906144,426.35399522162334,427.82097355650814,-3.909019805929972,-0.03155568490854548,6031500,5.13277665930221,1.0268908693287115,76212400.0,-96.74831007303392,91.40936679472856,92.55270083870475,-222.4726669436961,17.53981150959804,31.473620106493083,-0.08882964048126249,12.198056568102542,434.9438768310547,428.56805487060547,423.4149932861328,418.26193170166016,411.88610974121093,0.04,0.0,302.05507175277137,-0.06274712846403918,-0.060387023233988146,421.4957188197545,428.5300031389509,9.218829266778942
2023-08-18,1,402.1324920654297,408.70499420166016,439.3324966430664,423.7450008392334,432.16687202453613,-0.6395388912621673,7.346055726376769,0.22219522518620938,2.9955843842520538,429.7737503051758,6.085423202514647,0.01716545629229689,419.8542510986328,436.9449974060059,0.565912700029019,-0.052991954835893286,0.9396590460750781,0.9401775171286447,0.9560890549960203,-0.0552508149327926,27.228310332327204,442.64786172741174,427.9557502746582,413.2636388219047,419.5882143293108,10.49504547666159,427.2308916364397,10.88626761226964,421.87846155538125,424.8667509233407,-6.971371950727655,-2.837922363391864,4309200,5.260548033886597,0.8249119898618447,71903200.0,-86.45434383003979,91.40936679472856,92.55270083870475,-208.52179096428566,16.660429834897563,31.95021628731931,-0.007483883765500461,11.924623607322893,434.1343985595703,427.25779766845704,421.6999969482422,416.14219622802733,409.2655953369141,0.06,0.0,302.1657617782045,-0.040625159450834114,-0.05918882635648956,418.0142909458705,426.0700029645647,10.522178837346042
2023-08-21,1,404.9075012207031,402.1324920654297,439.3324966430664,421.6081314086914,432.16687202453613,-0.9537081221779649,9.191543281920007,0.6629258715923125,2.995498371983724,426.81125259399414,7.195623779296875,0.021551925425653314,418.6320068359375,436.9449974060059,0.65925006293912,-0.05447333839663458,0.9494092561976546,0.9532904623307239,0.9735740533415858,-0.04581712577666863,24.331475658564255,444.8667115943576,426.4836250305176,408.1005384666776,415.7210715157645,10.150708003405972,424.8557134355818,11.8987669974809,416.8904117104902,421.75263748516716,-7.38808815545103,-7.070271426097807,3861600,5.276039743577957,0.7717504481692511,75764800.0,-77.67500737407133,91.40936679472856,92.55270083870475,-154.80004914544483,17.511655255382802,29.994084523271358,-0.05716541012763322,11.795006589054292,432.8508841552734,426.21956219482416,420.86000061035156,415.5004390258789,408.8691170654297,0.06,0.0,302.26742992472833,-0.04556077958294258,-0.0317079993384939,414.9157191685268,423.90357535226,11.226773917816466
2023-08-22,1,411.32749938964844,402.1324920654297,439.3324966430664,420.44875144958496,432.16687202453613,-0.8311484763946774,10.32720874483889,-0.13565902963505616,2.9954356229095698,426.81125259399414,8.233849029541016,0.024272814495046313,408.32524490356445,436.9449974060059,0.7687403611790041,-0.05389365495222658,0.966773920822104,0.9757340055172882,0.9983446965853461,-0.03118468875006941,27.814188602570386,446.11841742864254,425.46399993896483,404.8095824492871,413.6749997820173,9.216255529648086,423.3960702078683,12.23497358849778,413.8862947938297,419.7812816154524,-6.266530001551567,-7.589121579581389,3603300,5.280067590654684,0.7292852567313618,79368100.0,-66.9308342342354,91.40936679472856,92.55270083870475,-92.85060303916816,20.399876135293525,28.446842041654545,-0.02723185280988669,11.548220142542599,432.8508841552734,426.21956219482416,420.86000061035156,415.5004390258789,408.8691170654297,0.06,0.0,302.3678826536883,-0.024852486372248905,-0.0341530351892403,413.70286342075894,422.72286115373885,11.51460830029996
2023-08-23,1,425.1699905395508,402.1324920654297,439.3324966430664,419.83437728881836,432.16687202453613,-0.6177698211064603,10.753418195345649,-0.6415158354337689,2.9954098638394164,425.1087532043457,8.81524887084961,0.025324103066483184,408.32524490356445,436.9449974060059,0.8385645576629541,-0.02512859560954961,1.0012675472678554,1.0153155618272083,1.038617436065252,0.012948603745485787,38.38316828096242,446.13858611603314,424.6317497253418,403.1249133346505,413.79214150565014,9.37833812643145,422.90964126586914,12.000576767047468,413.2340661185922,418.8833961462141,-3.36485424289601,-4.73292723924196,8174700,5.411931272067474,1.619028190939447,87542800.0,-35.27083838655995,91.40936679472856,92.55270083870475,19.484652777600452,29.83482939866928,24.54714770200773,-0.052727405079772804,12.42691695992796,432.8508841552734,426.21956219482416,420.86000061035156,415.5004390258789,408.8691170654297,0.02,1.0,302.6268248434439,0.029124985510669887,0.0090865600071217,413.67000470842635,422.4764317103795,11.52879702807025
2023-08-24,1,416.5250015258789,402.1324920654297,439.3324966430664,419.83437728881836,432.16687202453613,-0.6652698519372072,10.73588719618893,-0.5874851439600057,2.995411033213158,425.40999603271484,8.690873908996583,0.025273176041577316,408.32524490356445,436.9449974060059,0.8320791105775951,0.01262896087580236,0.9805346774711534,0.9968236437105625,1.0148045518727604,0.01913362311486777,53.50975769278357,446.2655232479687,424.7937488555908,403.32197446321294,412.6432124546596,8.264776245336451,421.8144629342215,11.819435164824503,416.2297370543854,420.1134636347385,0.1932348458532384,-1.5764630898055583,5687800,6.2756349990048115,1.1366949751239306,81855000.0,-80.6693170770053,91.40936679472856,92.55270083870475,-81.39770604059234,26.342115438562434,27.98049005409921,-0.05098223716156758,13.069278813515702,432.8508841552734,426.21956219482416,420.86000061035156,415.5004390258789,408.8691170654297,0.02,0.0,302.78641658763524,0.009751842867943727,-0.02050792942811184,411.27428763253346,420.7142878941127,11.931673042800128
2023-08-25,1,413.70999908447266,402.1324920654297,439.3324966430664,418.9325065612793,432.16687202453613,-0.6180999888062808,10.836814846862383,-0.7008556119870715,2.9954048224686063,425.40999603271484,8.874711341857909,0.025520808721099304,408.32524490356445,436.9449974060059,0.8072548997256255,-0.009788597888354893,0.9742912379552141,0.9937618148937682,1.004120025845827,0.028790279938780028,45.906793114319534,446.30025361035075,424.626623916626,402.9529942229012,411.7824968610491,7.697378398275727,420.1644630432129,11.158952596485355,416.318059954707,420.2266968462973,-1.8942814191946826,-3.550360178548582,5390900,6.581517225488487,1.0886000799654292,76464100.0,-60.634082789824475,91.40936679472856,92.55270083870475,-69.26598054810502,24.56111483640919,26.088718311198782,-0.07594136333494178,13.015759421423057,432.8508841552734,426.21956219482416,420.86000061035156,415.5004390258789,408.8691170654297,0.02,0.0,302.93823029945804,0.028428052393400183,0.03233250317443393,411.35714285714283,418.94785853794644,12.065739452236302
2023-08-28,1,417.2999954223633,402.1324920654297,439.3324966430664,415.82125091552734,432.16687202453613,-0.5319716001490483,11.0671306347224,-0.9123890196247948,2.995390417485956,425.40999603271484,9.291749572753906,0.026084497658536408,408.32524490356445,436.9449974060059,0.822653546433153,-0.043947985258203155,0.9835485920217406,1.0052684364629088,1.0071730539141293,0.030605741223117988,40.872395192579056,446.4142600487417,424.2799987792969,402.14573750985204,413.0103541782924,7.809354837335128,418.5907129560198,9.706884597290477,415.6858756869792,420.21484894611143,-1.435431650207277,-5.288340148630059,2928600,5.923838249917475,0.6140665396010643,79392700.0,-53.119842030040445,91.40936679472856,92.55270083870475,-43.76349914568781,23.974409449178737,25.11502016325723,-0.13206121110901822,12.554633574078103,430.5970748291016,424.3964546508789,419.38499450683594,414.37353436279295,408.1729141845703,0.02,0.0,303.0225796751351,0.023929042614808216,0.03344621862439072,413.5085710797991,417.5021449497768,11.577767697412932
2023-08-29,1,423.16500091552734,402.1324920654297,439.3324966430664,415.82125091552734,431.9781246185303,-0.3680180624142573,10.98882925509885,-0.9944940698338898,2.995394498743589,424.86874771118164,9.372649688720708,0.02594712042499529,408.32524490356445,436.9449974060059,0.8090408208904691,-0.04760818148445042,0.9991886290619829,1.0211313543335925,1.015255289363231,0.028778774926169648,43.2773214459111,445.4862820148364,423.50862350463865,401.5309649944409,416.01499829973494,6.92230573326085,417.80160631452287,8.740151961836634,416.0971118869661,420.4416927791518,2.102984143242997,-5.01499465417495,4486700,5.83209963705181,0.9530050234178358,83879400.0,-20.340266786385357,91.40936679472856,92.55270083870475,20.902963199064242,28.454580994426774,22.661558584170407,-0.10047037521705442,12.920017849339269,428.68707482910156,422.8514546508789,418.13499450683594,413.41853436279297,407.5829141845703,0.02,0.0,303.1611784333087,0.040709577800913,0.053148451432324474,417.14571271623885,417.5800018310547,11.106410954180435
2023-08-30,0,433.00750732421875,402.1324920654297,439.3324966430664,415.82125091552734,431.8874988555908,-0.34835297244629737,10.46255282795118,-0.8824681253856985,2.99542508795436,424.4587516784668,8.772849884033201,0.02474827490946638,408.32524490356445,434.4722442626953,0.8301153237461941,-0.019912575943850697,1.02424226719255,1.0452358628988343,1.033001831958197,0.018433842837124903,50.43755338083298,443.68397940468157,422.7588737487793,401.83376809287705,420.0292848859514,7.528582137438519,417.875178200858,8.871999992939829,417.86030206889706,421.0595919975741,5.230243580186881,-2.5442595817131735,3625400,5.888152437229867,0.7807287864398603,87504800.0,-8.722792758159885,91.40936679472856,92.55270083870475,78.69889529714983,30.253867939552936,21.4110126694531,-0.07461612778820051,12.697873542857444,428.7176413574219,422.87617993164065,418.1549987792969,413.4338176269531,407.59235620117187,0.04,0.0,303.28040548109664,0.016653083471056984,0.0520366902274249,420.9142848423549,417.91500200544084,11.333527461453011
2023-08-31,0,433.32250213623047,402.1324920654297,439.3324966430664,415.82125091552734,431.9781246185303,-0.34559418749508836,10.519486332570398,-0.9017556788986676,2.995421829366704,424.4587516784668,8.822649993896482,0.024879282841611148,408.32524490356445,434.4722442626953,0.7860326061067362,0.002378609210709298,1.0248364560256709,1.0426557202213456,1.0299019736731159,0.04032771273949076,58.29911153565948,443.8600965512492,422.8211238861084,401.7821512209676,423.17142813546315,7.873525244315517,418.42321395874023,9.596586431216922,421.67589418702306,422.79846860666885,6.939858120385659,0.23843982765501084,3803000,6.3220536222663855,0.8410804666083536,91307800.0,-11.197225425766115,91.40936679472856,92.55270083870475,80.3636922527027,29.206438667282868,20.669734844622948,-0.05052427294524237,12.213738497664497,428.7176413574219,422.87617993164065,418.1549987792969,413.4338176269531,407.59235620117187,0.04,0.0,303.4055201080402,0.06573612287485742,0.014337516215252305,423.8442818777902,418.77357264927457,11.453680996537482
2023-09-01,0,439.76000213623047,402.1324920654297,439.3324966430664,415.82125091552734,432.2350025177002,-0.3421057419816953,10.58181399759565,-0.9218804310774296,2.995418243238474,424.4587516784668,8.876350250244139,0.025022719400338272,408.32524490356445,434.4722442626953,0.7881532655670311,0.003392331899982521,1.039896480834697,1.0519146102238381,1.0369228111313356,0.06296682001741716,58.55752215275266,444.05187720173427,422.888249206543,401.7246212113517,425.2557155064174,10.1055360852366,419.52392850603377,11.09538318590986,424.61372159360917,423.89532030517415,5.347321241399977,1.8025374328314399,4792100,6.322165275664443,1.0674766132382605,96099900.0,-11.869048347958351,91.40936679472856,92.55270083870475,118.84778226975803,32.0773899471536,19.237622235894495,-0.06274931575809724,12.185614842418367,434.3253985595703,427.41229766845703,421.8249969482422,416.23769622802735,409.32459533691406,0.06,0.0,303.57056283960145,0.057327611406618795,0.08097218882876468,425.605712890625,419.63785879952565,11.93190996959054
2023-09-05,0,444.6300048828125,402.1324920654297,439.76000213623047,415.82125091552734,433.0862560272217,-0.2566862326211037,11.046677987335014,-0.9708277512746091,2.9953908916381886,424.4587516784668,9.204287757873534,0.026097594791823574,408.32524490356445,437.062247467041,0.7478262013313838,0.006753518907819881,1.0504310628970874,1.0540764590422689,1.03568276433465,0.06549247486280851,62.24681872245094,445.3767303795773,423.28337440490725,401.1900184302372,429.27071598597934,11.539983230015794,420.9569642203195,12.939281260203899,428.4198553948569,425.9072608654402,3.4315713529462926,3.631437190413741,6155900,6.390761382092768,1.3505956122481442,102255800.0,-8.6257105819805,91.40936679472856,92.55270083870475,152.8289013631051,33.799465061275825,17.528106757843705,-0.08541272683058912,12.418786082747864,440.3992078857422,432.32540521240236,425.8000030517578,419.2746008911133,411.20079821777347,0.08,0.0,303.79168419747157,0.07324306390471147,0.07847990287307428,431.5699986049107,421.4221431187221,12.657673493567708
2023-09-06,0,446.5625,402.1324920654297,444.6300048828125,415.82125091552734,433.0862560272217,-0.09028306630148945,11.640947908586062,-0.8749437606140806,2.9953543902237705,424.4587516784668,9.55618808746338,0.027476167079670225,408.32524490356445,439.3752471923828,0.72730725403075,0.01205808420780225,1.0540229161634964,1.048781475094177,1.0271069914615787,0.055291668814414274,64.97912039546009,446.95627058829024,423.67437477111815,400.39247895394607,433.96393040248324,10.814445051858751,422.8732136317662,14.621551834794339,432.481263541669,428.1623399056583,6.747494929229936,4.725396967329748,3862300,6.457674795125778,0.8464999660286631,106118100.0,-13.90596726066482,91.40936679472856,92.55270083870475,141.086084605757,31.661795784425287,16.419530180383976,-0.07663216458783845,12.310303106413196,440.3992078857422,432.32540521240236,425.8000030517578,419.2746008911133,411.20079821777347,0.08,0.0,303.929266788919,0.036675317773453786,0.06625846139021928,435.81714303152904,423.58714294433594,13.214090322806411
2023-09-07,0,441.3975067138672,402.1324920654297,446.5625,415.82125091552734,433.0862560272217,0.05654274663050203,12.219470554646412,-0.7809829043084613,2.9953171600632538,424.4587516784668,9.881538238525389,0.02881706779268444,408.32524490356445,440.2470024108887,0.7685538965481049,0.028442309415582703,1.0409437804699928,1.0281430867083652,1.0044168271567524,0.0193761060668316,67.67719738898533,448.47481604825765,424.03587493896487,399.5969338296721,437.40643201555525,8.12741181579889,425.2083930969238,14.794321216231682,436.0154706857386,430.1106570937848,7.940949212788887,6.391530664254353,2922700,6.338268666102794,0.6471197117220842,103195400.0,-18.643750713962174,91.40936679472856,92.55270083870475,105.65551783251688,29.96536718385631,17.781121862433846,-0.022997811121219805,12.078138424426086,440.3992078857422,432.32540521240236,425.8000030517578,419.2746008911133,411.20079821777347,0.08,0.0,304.0299804028647,0.019486049092529045,0.03058216403338786,439.4000026157924,426.45428684779574,13.866112017190988
2023-09-08,0,443.00499725341797,402.1324920654297,446.5625,415.82125091552734,433.0862560272217,0.07009355952789127,12.612673540409403,-0.899552771321765,2.9952908290599867,424.4587516784668,10.209376525878906,0.029719176258627418,408.32524490356445,441.7207565307617,0.8209099928793976,0.021806704697293747,1.0438503426450954,1.028001696724025,1.004240189933302,0.022344778010497723,62.087849069565095,449.6204726606528,424.395125579834,399.16977849901514,440.24071720668246,5.301293899838573,428.12785775320873,13.895852452648386,437.3829976283972,431.0227352793533,5.774625342881686,7.999048941417177,2697500,6.441389484600568,0.6161531486054038,105892900.0,-19.740541249913925,91.40936679472856,92.55270083870475,105.48656505802921,29.8591399542692,16.923192482297278,0.021402135801858565,11.78398506947266,440.7178093261719,432.8411075439453,426.4750061035156,420.108904663086,412.2322028808594,0.08,0.0,304.1237079585621,0.021029319477980923,0.018703784742643535,441.2300022670201,429.1878574916295,14.413588809756241
2023-09-11,0,445.2675018310547,402.1324920654297,446.5625,415.82125091552734,434.93187713623047,0.06772914492767809,13.16120302430726,-1.0559465496346665,2.9952528448755693,424.4587516784668,10.798650894165041,0.0309714352560146,408.32524490356445,443.1674980163574,0.8438146720648155,0.04077292532673445,1.0478201406891328,1.0269415991323212,1.0049574438925053,0.0125238759051991,65.10883747904207,451.268906445343,424.94650039672854,398.62409434811406,441.9921449933733,4.473981178005825,431.01071493966236,12.855593286817367,438.78381819615913,431.79240745888626,4.6884776139251425,10.163939993522844,2913800,6.239530923205789,0.6733373388177659,108806700.0,-17.11088634590085,91.40936679472856,92.55270083870475,107.66404395416976,30.45045746064434,16.169556418001132,0.05473289420748267,11.452272896541576,442.29193249511724,435.3890526733399,429.8100128173828,424.2309729614258,417.32809313964844,0.08,0.0,304.22712699547225,0.012457898535783496,0.02693228387990945,442.75714111328125,431.8357129778181,15.063568307436775
2023-09-12,0,439.2750015258789,402.1324920654297,446.5625,415.82125091552734,440.16937828063965,0.002034114110056247,13.888036525162015,-1.2334119932461445,2.995200523626582,424.4587516784668,11.953351898193365,0.03260658348557313,408.32524490356445,444.6937545776367,0.8528194354385334,0.04929304449663912,1.0313377981421852,1.0058003377362226,0.9889738770707388,-0.012043729163858319,67.09319742803862,453.70344846231137,425.9273754119873,398.1513023616633,442.84250204903736,2.806464471674281,433.00696509225025,11.68016358162502,440.38222485175015,432.94853885757965,2.8313584174549065,9.967708794891532,3124000,6.223706742744075,0.7290038037010245,105682700.0,-39.67853267762717,91.40936679472856,92.55270083870475,58.44855615628661,28.298769826275226,20.41401884043511,-0.013949273944945434,11.442825355661373,442.29193249511724,435.3890526733399,429.8100128173828,424.2309729614258,417.32809313964844,0.08,0.0,304.33165705058724,-0.031180329996315037,-0.011798677784385557,442.90142822265625,433.3728550502232,15.175173788341095
2023-09-13,0,424.2074966430664,402.1324920654297,446.5625,415.82125091552734,440.16937828063965,-0.11434291809862226,14.181121940016,-1.3283097354331852,2.9951790712115676,424.86874771118164,12.61648937225342,0.03323646246296925,408.32524490356445,444.6937545776367,0.8808978642906562,0.034641126496776795,0.9942201046098277,0.9664378254031867,0.9573596461322837,-0.05006018946269242,59.4116379672431,455.0358694446072,426.6736255645752,398.3113816845432,440.6207155500139,7.642695107334286,432.93821552821566,11.732555563403338,440.03992960456026,433.052961623374,1.373688040732548,6.7944647945251875,11843000,6.421438190410939,2.5149446278973464,93839700.0,-87.1616392483949,91.40936679472856,92.55270083870475,-31.98184187418474,23.855106651246874,30.485759104444803,-0.11215835685438498,12.604765791334003,442.29193249511724,435.3890526733399,429.8100128173828,424.2309729614258,417.32809313964844,0.02,1.0,304.67438178965034,-0.07519745781788367,-0.0812160181783235,438.9528547014509,432.27928379603793,15.509786422022675
2023-09-14,0,405.5699996948242,402.1324920654297,446.5625,415.82125091552734,440.16937828063965,-0.11056495150177892,14.18401205016899,-1.3302213350062313,2.995178822100735,424.6887435913086,12.632689743041993,0.03324463856557911,408.32524490356445,444.6937545776367,0.8692241038776863,0.010655504819759272,0.9505792863970265,0.9237581191978393,0.9246279019839516,-0.08116834933158767,46.25424549057597,455.0236492529259,426.6556251525879,398.2876010522499,435.0407148088728,14.972130521579198,432.15571539742604,13.18664981737647,436.03829463412814,431.0623165407888,-3.536589370932864,-0.22637860571084698,10709000,7.245583566780686,2.12221198339328,83130700.0,-99.08327385880271,91.40936679472856,92.55270083870475,-106.9506657044538,22.197054143160134,34.437191034132944,-0.16403763490864648,12.57871039440836,440.8358093261719,433.03210754394536,426.7250061035156,420.41790466308595,412.6142028808594,0.04,0.0,304.93867469633113,-0.09624503092526782,-0.10155693319158982,432.06856863839283,431.8192836216518,16.390977403592103
2023-09-15,0,399.4175033569336,402.1324920654297,446.5625,413.1143741607666,440.16937828063965,-0.09123569070491971,14.849916238692522,-1.440350285831745,2.9951237123524566,424.6887435913086,13.270115127563475,0.03486326508824712,405.5037498474121,444.6937545776367,0.7804330656151904,-0.007670555905390018,0.9377156124380034,0.9154658057529165,0.925723995971749,-0.09839052418532979,36.31269740016877,455.64720720272686,425.9473747253418,396.2475422479567,428.3057152884347,18.99003372170164,431.134822845459,15.134005289038804,428.3944366687964,427.0286347152041,-8.784833402838617,-2.630094662006513,9110700,8.025294716247233,1.7520206303328199,74020000.0,-96.73056620489817,91.40936679472856,92.55270083870475,-126.1802777497183,20.957711308428966,35.38406410063515,-0.16623985274362427,12.37094632536022,439.662889038086,431.13356707763677,424.24000549316406,417.3464439086914,408.8171219482422,0.06,0.0,305.1509612565536,-0.1035681721224534,-0.1042560154349495,425.0942818777902,430.4557124546596,16.876585414690105
2023-09-18,0,395.4925003051758,399.4175033569336,446.5625,413.1143741607666,440.16937828063965,-0.1716606898789763,15.512288290763202,-1.364645075286162,2.995066048369932,424.6887435913086,13.68805221557617,0.03645806832255938,404.63000030517577,444.6937545776367,0.7461330927029843,-0.006751478087610853,0.9295142229771264,0.9135690656244921,0.9355288907306945,-0.11178673790741811,34.06453483907936,456.5075767646319,425.48300018310545,394.458423601579,421.7478572300502,21.47867874242303,429.57714462280273,17.59042387025156,421.1466037037829,423.2900598988987,-10.557312054430545,-3.4547136301196275,4704700,8.008175080998596,0.9013033812047584,69315300.0,-97.04192668459774,91.40936679472856,92.55270083870475,-136.44800244294657,20.099118656087207,35.383532889476996,-0.20870987768304228,11.978021239062167,439.0894107666016,430.2053098754883,423.02500915527344,415.84470843505864,406.96060754394534,0.08,0.0,305.25624680929513,-0.11442427054790483,-0.10930441560697096,418.1314217703683,428.76571219308033,17.661569279651744
2023-09-19,0,394.3800048828125,395.4925003051758,446.5625,413.1143741607666,440.16937828063965,-0.264037546375054,16.069538169095942,-1.2206690022432467,2.9950152734788276,424.6887435913086,13.988750839233399,0.037797248851826934,404.3585014343262,444.6937545776367,0.7564182342416079,-0.023252226464422807,0.9276233722390175,0.9204109940528818,0.9553952762980166,-0.10220248474672533,31.56542379106911,457.2900769332847,425.1510005950928,393.0119242569009,414.80142974853516,21.320433078609433,427.5210734776088,19.924932611318816,414.74414832191786,419.81533515203336,-10.399924265645886,-5.2258555850486905,4076800,8.019430490305911,0.77940674620434,65238500.0,-90.58542554146953,91.40936679472856,92.55270083870475,-131.25711542859523,19.11929712084418,35.094210814270234,-0.21641149828042597,11.692449078152592,438.5348093261719,429.3076075439453,421.8500061035156,414.392404663086,405.1652028808594,0.1,0.0,305.3466804842998,-0.08854583730520271,-0.11038255514968374,411.47428240094865,426.3521423339844,18.44027536701002
2023-09-20,0,391.864990234375,394.3800048828125,446.5625,413.1143741607666,440.16937828063965,-0.35114680757800193,16.876188314616055,-1.137770584529208,2.9949384199199782,424.6887435913086,14.51512565612793,0.039743781425035145,399.02500305175784,444.6937545776367,0.800025850937775,-0.041201948646719735,0.9228503634621154,0.925393904003929,0.9704108190704575,-0.07624218493221213,29.40009616619059,458.3770024074304,424.62462577819826,390.87224914896615,407.17249952043807,17.878571318900157,424.5823222569057,21.98143606271041,409.6475570476084,416.6771802859054,-10.976172429673491,-6.802310202979413,3866600,7.852200425494156,0.7373646261020136,61371900.0,-99.7326709786201,91.40936679472856,92.55270083870475,-136.4853384858519,17.73439796441594,35.072440003158434,-0.264801270083124,11.705130938083657,437.56012817382816,427.729945678711,419.7850036621094,411.84006164550783,402.00987915039065,0.12000000000000001,0.0,305.4277357819847,-0.06292451740710159,-0.11132074438486829,403.0371398925781,422.8971405029297,20.170988942587016
2023-09-21,0,387.4925003051758,391.864990234375,446.5625,411.67499923706055,440.16937828063965,-0.39733553167278735,18.129472314780394,-1.1857369646917992,2.9948109290682723,424.6887435913086,15.543850746154783,0.042793362707479896,395.38125076293943,444.6937545776367,0.846810487931618,-0.07833337499410753,0.914649186919179,0.9270427185458114,0.9752041691798928,-0.044573068528863224,24.20732001316308,459.9104449499954,423.6515003204346,387.3925556908738,399.7749993460519,12.18968516631351,421.30875069754467,23.90787167675078,405.1976114530952,413.7478695745918,-11.993354865799727,-9.50157131087288,5547900,7.04471160479692,1.085170181927718,55824000.0,-98.95761747611824,91.40936679472856,92.55270083870475,-125.59474665893708,16.39015624244433,34.05386377330558,-0.32104704749881857,11.760477333131254,436.9229324951172,426.69855267333986,418.4350128173828,410.1714729614258,399.9470931396485,0.14,0.0,305.5405970672958,-0.040800011826333304,-0.06813991122481915,395.817138671875,419.3592834472656,21.88245883821392
2023-09-22,0,382.5124969482422,387.4925003051758,446.5625,404.03187561035156,440.16937828063965,-0.32652968778338143,19.758217447795786,-1.3322900729717109,2.9946287105992697,423.6862487792969,17.415613746643068,0.04684621634937131,394.1285034179688,444.6937545776367,0.8624465761471486,-0.06970170125285821,0.9069271170702016,0.9270844566124544,0.9715108904111355,-0.0423241502102738,23.26870973440355,461.2840607043074,421.7676258087158,382.2511909131242,393.8185708182199,7.574346241740491,417.21964318411693,25.36082940768361,400.7223258484218,410.71519408122873,-11.78817393223604,-10.576418627031371,3692800,6.887562535666453,0.7366858711438101,52131200.0,-98.06896832009105,91.40936679472856,92.55270083870475,-130.5512361253769,15.524982353238402,35.391254715561466,-0.29902454826969116,11.529016061568306,435.72876586914066,424.7656219482422,415.9049987792969,407.0443756103516,396.08123168945315,0.16,0.0,305.6099557474964,-0.0431551488321994,-0.05163672795836643,391.1842825753348,415.06856863839283,23.54593733922302
2023-09-25,0,383.7824935913086,382.5124969482422,446.5625,398.43625259399414,440.16937828063965,-0.31781856219279914,21.521362228477603,-1.3999232810781808,2.994411790979612,423.6862487792969,19.28630149841309,0.05123316565874223,391.42774124145507,444.6937545776367,0.8697385564547975,-0.07540910832532347,0.9136220961455184,0.9440029073925592,0.9831791207895314,-0.029608669456010817,21.557718785156677,463.1097250367892,420.067000579834,377.02427612287875,390.70606994628906,6.311859996029253,412.8733923775809,25.515437539179867,396.1501840228332,408.16956219435866,-9.828916279126233,-13.017897241653628,3757300,6.92571477358804,0.7619690775171161,55888500.0,-91.18170634270612,91.40936679472856,92.55270083870475,-108.05862696493801,14.850229804006394,33.853066858306796,-0.31429749695040815,11.191943311355837,434.154927734375,423.4925434570313,414.875,406.2574565429687,395.595072265625,0.16,0.0,305.6826124257174,-0.024340786643205048,-0.03058400406552521,388.94285365513394,410.5057111467634,24.768484294664002
2023-09-26,0,381.0124969482422,382.5124969482422,446.5625,395.21437644958496,440.16937828063965,-0.2649499097237844,22.907151550905454,-1.533770056927802,2.99422638956974,423.6862487792969,20.932314300537108,0.05472708825232079,387.1214996337891,444.6937545776367,0.8969425901219357,-0.08031991900007213,0.9102705109094783,0.9515808539692978,0.9819745280175738,-0.03389499408962782,22.12078868318374,464.3849284069868,418.5706253051758,372.7563222033648,388.076783316476,5.8980463966923224,408.19124930245533,24.863835923665217,393.0670579793972,406.3350681027156,-5.372070448975487,-13.684976412588481,4089400,6.852459234287637,0.8196701596286289,51799100.0,-97.39416257409546,91.40936679472856,92.55270083870475,-103.99750657396838,14.127795082073838,34.462045567896276,-0.3436200586841776,10.923947534930862,432.772927734375,422.18354345703125,413.625,405.06645654296875,394.477072265625,0.18,0.0,305.7578266363111,-0.042781453015640514,-0.03841276402367465,386.41571044921875,405.7549961635045,26.20911212962532
2023-09-27,0,380.11499786376953,381.0124969482422,446.5625,393.7512512207031,440.16937828063965,-0.18096486515863866,24.32890381996725,-1.6510182040337693,2.9940210203169966,423.6862487792969,22.928126716613768,0.058376818098584624,383.65549392700194,444.6937545776367,0.9052511114906101,-0.09961245347816391,0.9120798968601879,0.9633572461136989,0.9864584715007334,-0.02998479747725813,18.79504686985979,465.4140580214043,416.7562503814697,368.09844274153517,385.87999725341797,5.527775228723282,403.8139272417341,23.945613801914547,390.0910517825558,404.312459237153,-4.607961908029865,-14.678797044480406,3843500,6.613591709639507,0.7753806799383488,47955600.0,-98.18034210844762,91.40936679472856,92.55270083870475,-94.57296994101297,13.377044624153555,33.370816266885406,-0.40567185019111063,10.71295136962888,432.51097119140627,421.75952905273436,413.07000732421875,404.38048559570314,393.62904345703123,0.19999999999999998,0.0,305.8274001949612,-0.02254722166790757,-0.04697126525936642,384.0142822265625,401.0728519984654,27.29784948370596
2023-09-28,0,375.50499725341797,380.11499786376953,446.5625,390.7718677520752,440.16937828063965,-0.051396633746912994,25.54090384671675,-1.7378162013888379,2.9938312696580702,414.8887481689453,24.439751815795898,0.06160316647550077,382.3624969482422,444.6937545776367,0.9096835693811363,-0.12215148367126442,0.9056960942734372,0.9624286166348239,0.9804743293202517,-0.03093609048514967,14.256436814184806,465.6855579223154,414.60375022888184,363.52194253544826,383.1835675920759,5.288874466683005,398.9924986703055,22.17779656185425,387.63112151632777,402.2035166298548,-3.8881906558380837,-13.88374603797289,4369900,5.987959018883736,0.8750046304222244,43585700.0,-93.32405295393778,91.40936679472856,92.55270083870475,-94.57925110689884,12.662407557013722,35.08839997661282,-0.39831306884943496,10.50916808262414,431.29557263183597,419.79223138427733,410.49501037597656,401.1977893676758,389.69444812011716,0.2,0.0,305.9021769685666,-0.02027855959571101,-0.0257313040525732,381.17999267578125,396.327137538365,27.971806144871085
2023-09-29,0,378.8824996948242,375.50499725341797,446.5625,386.564998626709,440.16937828063965,0.10372853662110296,26.524934177048074,-1.7161441958389472,2.993659875711272,402.4937515258789,25.18698905944824,0.0644233424254689,380.9227470397949,444.6937545776367,0.9066158276646262,-0.13342834631891676,0.9202238487731361,0.9786262735107609,0.9955253238976806,-0.009489878846779543,12.749117432444173,464.7784930794379,411.7286247253418,358.67875637124564,381.3289260864258,3.805421109136427,394.2507128034319,18.27643135670267,384.61134392056647,399.41299196504883,-4.785995079796989,-15.236848437036272,4198700,5.954711184420823,0.8374069841421798,47784400.0,-91.25638913074981,91.40936679472856,92.55270083870475,-79.40902063011303,14.542505723544974,33.3248273792104,-0.406016812656813,10.274940395918843,427.89576330566405,417.042123840332,408.27000427246094,399.49788470458986,388.6442452392578,0.2,0.0,305.9770025268572,-0.005818676362612574,-0.0170505997580043,379.93713814871654,391.4871390206473,28.295357533021182
2023-10-02,0,379.85499572753906,375.50499725341797,446.5625,383.464994430542,440.16937828063965,0.28660666123747613,26.959070232973122,-1.6527904250454462,2.9935715740900357,397.4550018310547,25.20520141601562,0.06591352954031711,379.991748046875,444.6937545776367,0.9080598531272134,-0.13843346858668468,0.928725778209561,0.9863699101927161,0.999988149979642,-0.010233655597516544,16.14193898047861,462.92476506921776,409.00662460327146,355.08848413732517,380.23785400390625,2.6688678759353204,390.0064266749791,13.214845525962897,383.215472994895,397.3839966336891,-3.3130008709851664,-14.909015785620607,3102100,5.7333884027824356,0.6293019679760135,50886500.0,-86.28531628097217,91.40936679472856,92.55270083870475,-68.85674868780497,15.29481748930289,31.439503120403767,-0.40822657520415895,10.113159636612144,422.51719677734377,412.6913985595703,404.75,396.8086014404297,386.98280322265623,0.2,0.0,306.03381204463255,-0.011616427657237915,0.0013690766883819473,379.3914228166853,387.6042807442801,27.81816183007166
2023-10-03,0,380.4024963378906,375.50499725341797,446.5625,382.1374969482422,439.805627822876,0.4914327844043004,26.70247750987725,-1.4723547436735085,2.9935905653643706,394.93625259399414,24.226538887023928,0.0657678065227692,379.75774612426756,444.6937545776367,0.8957815551658375,-0.14568294636873563,0.9369257130045165,0.9918189785066863,1.0035045897347274,-0.0016009989573503303,15.713543553306463,459.4163293025914,406.0113742828369,352.60641926308244,379.9364253452846,2.4817408659866684,386.8774980817522,9.01143471268261,382.43324929545884,395.5060285527271,-1.9710070702327613,-13.526835260813094,8878100,5.5060568957462,1.7526463121404627,59764600.0,-85.97668727177151,91.40936679472856,92.55270083870475,-62.68421442167999,19.670432674775217,26.923896947779358,-0.47713378960406394,10.965790219209044,401.8815726318359,395.9992313842773,391.24501037597656,386.4907893676758,380.6084481201172,0.02,1.0,306.19777623154846,-0.0065919578114700395,-0.02091992736054808,378.9542803083147,385.0692814418248,26.398042389973
2023-10-04,0,376.7999954223633,375.50499725341797,446.5625,380.8599967956543,427.97437286376953,0.7084513512017238,25.708562251512042,-1.1673036315838234,2.993723756645792,393.12249755859375,22.56850116729737,0.06382463337773966,379.75774612426756,443.23124771118165,0.8785719642389952,-0.14815396201452063,0.9354518284332247,0.9860196101789785,0.994321175325558,-0.008721051418745462,15.87171610727541,454.2171233586149,402.79999885559084,351.3828743525668,378.93892560686385,2.04263465352642,384.8224977765764,7.588967185672035,382.001172782887,393.53969974150385,-0.5516161242274568,-10.326314516321212,4303700,5.443670261183913,0.8459178278209218,55460900.0,-82.73813470420211,91.40936679472856,92.55270083870475,-73.71280003968648,18.79498973490872,25.725634769904016,-0.4738103864703486,10.65680624986822,396.77041076660163,391.86480987548833,387.90000915527344,383.9352084350586,379.0296075439453,0.02,0.0,306.27216278111905,-0.001827385386525937,-0.006196456436428807,377.8257097516741,383.38428170340404,24.651077698233582
2023-10-05,0,374.11000061035156,375.50499725341797,445.2675018310547,380.33062171936035,410.22937393188477,0.9251819308311087,24.224065287089598,-0.7332343794800371,2.9939241805153514,389.6787452697754,20.295689163208003,0.06066452536729504,378.67424926757815,441.5582557678223,0.8697310969884692,-0.1463477031676547,0.9368867427170047,0.9828550204126734,0.9889529002660855,-0.003714988224577387,14.927996132028717,447.76000420088815,399.311873626709,350.8637430525298,377.9528547014509,2.4915392052357697,383.01481900896346,6.820202289787464,380.7524507908962,391.1238204230749,-1.8193894420783563,-7.093721008484172,5034800,5.429409496553596,0.9694957747753559,50426100.0,-83.40054520681026,91.40936679472856,92.55270083870475,-85.32773671960355,17.370616670770275,28.005550987419614,-0.4847303797688285,10.707035508387678,391.8637186279297,387.1581370239258,383.35499572753906,379.5518544311523,374.8462728271484,0.02,1.0,306.35395953284154,-0.010016976194082594,-0.01324187623743531,376.87428065708707,381.6449955531529,22.71905527962326
2023-10-06,1,375.0574951171875,374.11000061035156,445.2675018310547,380.0499973297119,400.95562744140625,1.1764408962267965,22.774613331479145,-0.043039432285245205,2.9941128163796717,385.6374969482422,18.105751037597656,0.05751927573232143,376.6704956054688,439.6480010986328,0.832477119240662,-0.1555174254697075,0.9472404717976479,0.9888207827341444,0.9921893535608179,-0.010095490239632632,13.032113570218469,441.4967249844915,395.9474983215332,350.3982716585749,377.23035430908203,2.4933512259731763,381.55517578125,6.0922127255583725,379.1309295333837,388.58672733628117,-1.8116194070212557,-6.336102582857104,4773400,5.304166752352038,0.901149893996802,55199500.0,-53.95285583876015,91.40936679472856,92.55270083870475,-65.46413931007328,18.252651268223975,25.32218113535513,-0.43615302581781207,10.995818686359986,390.91636608886716,386.391823059082,382.73500061035156,379.0781781616211,374.55363513183596,0.02,0.0,306.43651221009355,0.01035488241236271,0.013683772490456972,377.4342825753348,380.72428240094865,19.690255784255527
2023-10-09,1,382.23250579833984,374.11000061035156,445.2675018310547,379.61187171936035,396.47375106811523,1.4652661748954472,20.450918223631597,1.007886595734342,2.994407426724676,383.1474952697754,15.575914573669433,0.05209759726007044,375.4602470397949,425.7142471313477,0.7689568949030536,-0.1576805098623761,0.9737164331222533,1.0097219313112245,1.0132208755574097,0.006258993820120962,13.972374048598265,433.45195966198474,392.5501232147217,351.6482867674586,378.1914269583566,2.9687213888598607,380.68749727521623,4.866985619180415,378.11008914112915,386.3392009847614,-1.330519125792191,-5.166976661307084,3299800,5.235007306323902,0.6206936766290905,58499300.0,-39.15440008892258,91.40936679472856,92.55270083870475,-30.855076273499854,20.177390736057614,23.758196980139196,-0.4042128253122402,10.882546184627799,390.732990234375,386.243490234375,382.614990234375,378.986490234375,374.496990234375,0.02,0.0,306.4985818927844,0.014776709260861276,0.022113363264158963,378.80428641183033,379.9921395438058,14.914374199501207
2023-10-10,1,379.9625015258789,374.11000061035156,439.2750015258789,379.61187171936035,394.6581287384033,1.7092919739298724,16.573264326203425,2.26336092876085,2.9948471624187136,382.372501373291,12.441888275146487,0.04256120584412917,375.4602470397949,407.4337493896485,0.6964806774346384,-0.12985600257104213,0.9757680757510582,1.0041365349680507,1.0059356134406856,-0.0011566559532272258,30.096198382623935,422.5449020654928,389.39837341308595,356.2518447606791,378.3457129342215,3.0378812399499777,379.83731951032365,3.6522719584755965,379.0956775581206,384.9185190812928,1.7915896177492585,-3.0801508530033637,7288900,5.73291903850055,1.319364184083605,51210400.0,-78.78570721230605,91.40936679472856,92.55270083870475,-60.020258362655746,18.075619067335634,24.772477559958897,-0.42093614681396435,11.280222329085193,389.1362330322266,384.9518724975586,381.5699920654297,378.18811163330076,374.0037510986328,0.02,0.0,306.6255171354479,-0.00910416105051437,-0.01843130832576353,378.19285801478793,379.0649980817522,10.366846840414789
2023-10-11,1,370.4649963378906,374.11000061035156,424.2074966430664,379.61187171936035,392.4937438964844,1.6219748671492022,12.08081293225248,2.361929477524142,2.9952514592886126,381.622501373291,9.339575653076178,0.03126239425065089,375.4602470397949,400.03275299072266,0.650104445807386,-0.10430036118483733,0.958679091922804,0.9793089807481524,0.9810198980153301,-0.016812630470899093,31.302905881028256,410.5943742775909,386.43274841308596,362.27112254858105,377.0042844499861,4.135296874499808,378.62106922694613,3.7410109502018454,379.2535249196517,383.27255204730125,0.2850492783183675,-3.0373952777402233,9151400,4.9778801692016055,1.697855741445925,42059000.0,-98.00407176380446,91.40936679472856,92.55270083870475,-131.29829804194992,16.658996003601516,27.173838865125465,-0.4107350629674505,11.36520653562933,387.92383447265627,383.60807482910155,380.1199951171875,376.63191540527345,372.31615576171873,0.04,0.0,306.76560122398985,-0.02910586733444198,-0.028719329327720484,376.1357160295759,377.7635694231306,8.962441286127975
2023-10-12,1,363.88999938964844,370.4649963378906,405.5699996948242,378.361873626709,388.5856227874756,0.8734127943058374,8.951383992504946,-0.06184227516513863,2.9954619910489306,380.7074966430664,7.178062858581546,0.023326348098112615,374.9627456665039,395.88500061035154,0.6975549517006034,-0.08655719945594781,0.9482583701349618,0.9643883418159718,0.9668526990589532,-0.02731817167151218,27.205435709385625,401.64839138283696,383.74562339782716,365.84285541281736,374.64535631452287,6.111313503279765,377.29089082990373,5.255232432638577,377.0174117858403,380.78161138838624,-2.4719957602936624,-4.394279619315181,7376100,3.6405922889276465,1.4121451258105462,34682900.0,-94.00272232073145,91.40936679472856,92.55270083870475,-191.0598279077196,15.624733601534588,29.479723995489383,-0.36971064039213014,11.251977410177012,386.4393924560547,381.20529156494143,376.97499084472656,372.74469012451175,367.51058923339843,0.06,0.0,306.8661441243622,-0.030569752926297267,-0.041655563660648584,373.91428920200894,376.43428475516185,9.084188357527212
2023-10-13,1,355.5749969482422,363.88999938964844,399.4175033569336,376.47624588012695,384.7099952697754,0.2842480013949954,8.466483302867664,-0.11113838869333348,2.995486684994547,380.2587471008301,6.388200836181636,0.022183218809979924,373.7455001831055,394.49125442504885,0.6675687409869531,-0.08894829011921523,0.9316498572659019,0.945261492507514,0.9499187123799001,-0.05194536417105322,23.76597591979919,398.59458998830365,381.66162338256834,364.728656776833,371.6132136753627,9.298457131846911,375.2760696411133,7.501964674579146,373.7212216159178,378.2279669992568,-4.340796158596984,-4.868467751293774,6312600,3.668005765144814,1.2418005576948612,28370300.0,-91.52857790954975,91.40936679472856,92.55270083870475,-237.45929129183082,14.70489431089249,32.24799025137451,-0.3222444165677979,11.10183791045455,384.7873924560547,378.5312915649414,373.47499084472656,368.4186901245117,362.1625892333984,0.08,0.0,306.9404932526282,-0.0677046903846954,-0.04538501792402983,370.8828604561942,374.35428510393416,9.786724411305837
2023-10-16,1,358.7199935913086,355.5749969482422,395.4925003051758,375.39312171936035,382.8299961090088,-0.5404596094697843,9.22702369945193,0.7011880251869655,2.995435244603858,380.0387496948242,6.547100372314458,0.024315587277955897,369.80749664306643,392.1164916992187,0.6466088287830573,-0.10093112594077475,0.9453197040162957,0.9595677108936058,0.9684011435278628,-0.06151363855861103,19.846166668275288,397.9235454610376,379.46949806213377,361.01545066322996,369.4146412440709,10.367681870315636,373.6837479727609,8.491323089357373,369.1797739856035,375.04682215031187,-5.6329614469155,-7.3498653831523315,5128900,3.9198074009861097,1.0047535230236835,33499200.0,-79.53321287734796,91.40936679472856,92.55270083870475,-171.06678621165398,16.62322157798079,30.49228108635326,-0.27605831048665713,10.902420742464495,384.7873924560547,378.5312915649414,373.47499084472656,368.4186901245117,362.1625892333984,0.08,0.0,307.00569480315545,-0.06511207173983036,-0.05423187311419929,369.20143345424106,373.03785705566406,9.76530088257195
2023-10-17,1,358.3525085449219,355.5749969482422,394.3800048828125,374.8206214904785,382.30250358581543,-0.6647529227225372,9.510399043699868,0.26975620450930204,2.995413265639001,379.908748626709,7.092450714111328,0.025184379060525848,363.3729988098145,387.9297492980957,0.7173491724362205,-0.09042043422586815,0.9489491840475553,0.9640349303684682,0.9798481387859079,-0.05687401492035182,25.66100893850436,396.65167081384016,377.63087272644043,358.6100746390407,367.02821459089006,10.767208853795953,372.1292844499861,9.186906706848044,366.5599268203023,372.70097554996545,-4.113765201126551,-5.850858839404911,5908400,4.087989902018502,1.137058416558976,27590800.0,-91.4352090898926,91.40936679472856,92.55270083870475,-159.6019525769512,15.650396321049643,29.292349341629745,-0.3236974443296934,10.752961943616588,384.7873924560547,378.5312915649414,373.47499084472656,368.4186901245117,362.1625892333984,0.08,0.0,307.0775837731921,-0.04714455630081038,-0.0783262340463723,365.5171465192522,371.47571454729353,9.695232315688745
2023-10-18,1,349.17750549316406,355.5749969482422,391.864990234375,373.1987495422363,381.3174991607666,-0.7546082394313441,9.579083130219072,-0.25116354381128136,2.9954052775006783,379.36874771118164,7.496099548339839,0.02548784271458264,358.6832450866699,384.1534942626953,0.7436645388637038,-0.085520479054302,0.9290848840641125,0.9449578195495902,0.9661788140737738,-0.057461544424323496,25.81655532636657,394.9876641699841,375.8294979095459,356.67133164910774,362.30607169015065,10.222390687059073,370.24874932425365,10.965222156535292,364.5056328636334,370.38189604066713,-4.453980200301321,-5.725238267669505,11429600,4.098457564326403,2.0503860080924015,16161200.0,-97.08991039982482,91.40936679472856,92.55270083870475,-188.44119615132908,14.509665329136757,33.232418719753014,-0.34087088517981584,10.769892535813616,383.0598779296875,375.7350604248047,369.81500244140625,363.8949444580078,356.570126953125,0.1,0.0,307.19168724013485,-0.05394471792276656,-0.07267224994788651,359.83714512416293,369.32071576799666,11.187391378145264
2023-10-19,0,401.9300003051758,349.17750549316406,387.4925003051758,368.8212471008301,380.5549964904785,-0.9577108600649645,10.481548765091011,-0.29676997732486,2.995335251521261,377.84124755859375,8.599074172973634,0.02804839587437933,358.0747573852539,382.63949661254884,0.7190127057085043,-0.09887931968189358,1.0755559140167859,1.0959109538261267,1.1254035481927867,0.10453708807423046,21.273097980141447,394.6582212026674,373.69512367248535,352.7320261423033,365.44428580147877,17.39899957774432,371.8949993678502,13.740135845310231,360.65508521450613,367.23534130550945,-8.647877876355997,-7.011222740795167,28074400,4.389319316317515,4.189777470678393,44235600.0,-11.180353561009811,91.40936679472856,92.55270083870475,191.32697620924768,36.72895049252084,22.946473102756162,-0.21777348209626154,14.483472337943006,393.79409191894536,384.4179717407227,376.8400115966797,369.26205145263674,359.8859312744141,0.02,1.0,307.82104309594945,0.11231997628889001,0.09794222134080512,363.90142822265625,371.0471431187221,12.730333877962284
2023-10-20,0,403.8100051879883,349.17750549316406,401.9300003051758,368.8212471008301,380.5549964904785,-0.24931310077662547,11.81878986298101,0.24649000108264163,2.9952324966153734,377.84124755859375,9.062898979187008,0.031565847450530114,358.0747573852539,382.63949661254884,0.2798289130345093,0.05076305614025724,1.0785033976013838,1.0927480182377454,1.10708402199542,0.1356535432854611,65.58834816280732,398.05457839844746,374.41699867248536,350.77941894652326,370.20785849434986,22.745807796859992,373.60607147216797,16.09707244196737,370.95664723781647,371.87544613326315,5.781491250078184,6.083020627480939,12768900,12.94015100615036,1.7847381261710296,57004500.0,-14.686728350046002,91.40936679472856,92.55270083870475,184.52318744993352,35.261233464442626,21.504003114080536,-0.23448791205045785,14.351081805433685,395.0852537841797,385.4623932495117,377.6850128173828,369.9076323852539,360.2847718505859,0.04,0.0,308.11122698357775,0.12730544228438423,0.1100774582068877,368.9057137625558,372.52071489606584,14.087858827957183
2023-10-23,1,404.0550003051758,349.17750549316406,403.8100051879883,368.8212471008301,380.5549964904785,0.10914677192495824,13.359282210007706,0.0807061963342317,2.9950997510864155,377.84124755859375,9.850749664306637,0.035579033588721914,358.0747573852539,385.5972442626953,0.4292259145355788,0.052184536634980176,1.0760972185152005,1.0849691775936527,1.0792124890431305,0.12637992730764136,66.19421602512875,402.2004385044881,375.4818740844727,348.76330966445727,375.94571576799666,25.75358634066433,375.29553604125977,17.994636902580883,379.1618477422847,376.4020314525019,9.000852760643712,6.306356301716662,7390000,12.941483219257208,1.0073431086962745,64394500.0,-5.765465178894302,91.40936679472856,92.55270083870475,171.5451434740864,33.63504277620463,20.51227349522809,-0.19569714897599158,13.970291642991992,395.0852537841797,385.4623932495117,377.6850128173828,369.9076323852539,360.2847718505859,0.04,0.0,308.28029320381467,0.1275427860970031,0.14383717025304846,375.4257114955357,374.6700003487723,15.700647422230826
2023-10-24,1,412.1225051879883,349.17750549316406,404.0550003051758,368.8212471008301,380.5549964904785,0.23621880216878868,14.656709990199616,-0.2506526926156796,2.9949763295904357,377.84124755859375,10.760700149536131,0.038929309945994445,358.0747573852539,402.11800079345704,0.5373335082409597,0.0604770277654797,1.094627972506154,1.1001852122428992,1.0747330288923784,0.15004777519598678,66.83956991096544,405.80891940056523,376.495499420166,347.1820794397668,384.02393123081754,27.130776523150967,377.8185724530901,20.52078256967285,385.3800662668021,380.4622639391618,11.03767649094396,6.217757295229719,6459200,12.912071868756625,0.866469384086647,70853700.0,-4.113384945196852,91.40936679472856,92.55270083870475,188.83819383760866,36.68362961479695,19.457003403425777,-0.1671351446598546,13.675985533029394,399.7074444580078,389.2012857055664,380.7100067138672,372.21872772216796,361.7125689697266,0.06,0.0,308.44082675071917,0.16307772845652613,0.1466382201321962,383.7185712541853,377.3007158551897,17.859810115941066
2023-10-25,1,414.05499267578125,349.17750549316406,412.1225051879883,368.8212471008301,380.85999870300293,0.3761364042146118,16.578407036585702,-0.4483564045653421,2.9947752742647173,377.84124755859375,12.28575096130371,0.04385230311240062,358.0747573852539,403.83450469970705,0.5974926720373798,0.08420479987398448,1.0952358090829357,1.0959351669413127,1.0503171821095443,0.18580087824095903,70.18702374802464,411.2078139053247,378.0509998321533,344.8941857589819,391.9289311000279,26.58516641354882,380.6717861720494,22.633681115016294,392.07093016177464,384.94430313846306,15.903117127208244,9.374339223659288,6299600,12.989904186942782,0.8313642167358964,77153300.0,-10.24152993943427,91.40936679472856,92.55270083870475,156.99779330735734,36.119345203463794,18.54631373946968,-0.1783047655078515,13.322701636836447,401.3500397949219,390.5299819335938,381.7850036621094,373.040025390625,362.21996752929687,0.08,0.0,308.59761209931884,0.18793147433425772,0.15610592204188095,390.92285592215404,380.0621446881975,19.39953245801659
2023-10-26,1,408.45250701904297,349.17750549316406,414.05499267578125,368.8212471008301,387.1568794250488,0.37713827589529686,18.34571182569896,-0.7476702685942844,2.9945714159384638,377.84124755859375,14.069300689697263,0.04831022637733264,358.0747573852539,404.861750793457,0.6703914547006392,0.10266173740518013,1.075588304556137,1.0687752627697376,1.0030894481245654,0.016227966832321084,71.91633796257842,416.4394232241518,379.7479995727539,343.05657592135594,399.08607373918807,22.463696689206362,383.05714416503906,23.729687506086957,397.56697761321925,389.03324088095695,15.425680216619341,10.677338750704441,6849700,12.904917733289555,0.8894079854156671,70303600.0,-20.644974790358898,91.40936679472856,92.55270083870475,111.04397864667466,33.105023267748685,21.533756849335575,-0.2182259899894789,13.497507878038977,401.3500397949219,390.5299819335938,381.7850036621094,373.040025390625,362.21996752929687,0.08,0.0,308.7579309612865,0.004405554371035292,0.16566049192371549,397.75428553989957,381.6357160295759,20.137677183443074
2023-10-27,1,402.5299987792969,349.17750549316406,414.05499267578125,368.8212471008301,402.4000015258789,0.22957478087552632,19.342920677726244,-1.056853013425633,2.9944501355884205,379.36874771118164,15.688989105224612,0.050716190972768804,358.0747573852539,408.8195068359375,0.7326730274949959,0.0780453236769613,1.0554139486218979,1.0411380464032234,0.9853879611319106,-0.0031698234126108504,66.46818292238066,420.0812164164877,381.39537506103517,342.70953370558266,406.70785849434986,4.865871436233635,384.50696509225025,24.288900926892985,400.28148306294736,392.1223783961349,13.980646787586455,8.90397134749197,4997600,13.010880218076265,0.6455713208015129,65306000.0,-28.295783788413615,91.40936679472856,92.55270083870475,74.75047387937197,30.563677005284948,22.99554480743004,-0.22918306186406873,13.575542768028381,401.3500397949219,390.5299819335938,381.7850036621094,373.040025390625,362.21996752929687,0.08,0.0,308.8672111623116,-0.007706495420346182,-0.00970703139390449,405.1371416364397,382.48714338030135,20.494718512706335
2023-10-30,1,406.16500091552734,349.17750549316406,414.05499267578125,368.8212471008301,402.8500003814697,0.09336588243699524,19.868781006084753,-1.2340293989758346,2.994384813304617,379.908748626709,16.891075935363773,0.051933968991380974,358.0747573852539,408.8195068359375,0.7655566666161233,0.05969383924602127,1.0616534832444589,1.0379343764042868,0.9949098946610452,0.005222062859655097,61.33942087956207,422.31531202742826,382.5777500152588,342.84018800308934,407.31285858154297,4.415216467706309,386.3785721915109,24.91329084554876,400.8367584331736,392.4176617250256,15.279476039208175,5.3102477348343795,5317100,13.117820107916478,0.6771555671023457,70623100.0,-11.820282683999084,91.40936679472856,92.55270083870475,87.25974194570293,29.54020293817714,21.19969273924528,-0.2035860626046332,13.673719156528582,401.3500397949219,390.5299819335938,381.7850036621094,373.040025390625,362.21996752929687,0.08,0.0,308.99098398376395,0.007963794768310217,0.022745399320493714,406.3242841448103,385.11285618373324,21.466315178214124
2023-10-31,1,409.5199966430664,349.17750549316406,414.05499267578125,368.8212471008301,403.87125396728516,-0.03157401140317674,20.50573501343759,-1.3725254300567675,2.9943037655385267,380.18249893188477,18.197400817871095,0.053415200706880536,358.0747573852539,408.8195068359375,0.7730206840373417,0.0677243310063699,1.0667548761278647,1.0339716817156817,1.002092167730595,-0.006314890626355707,63.11529751360467,424.90472030153336,383.8932502746582,342.88178024778307,408.1285716465541,4.1814786187645625,389.168215070452,25.179464947458083,402.18375644930836,393.17250218824154,1.0536662123096132,6.896075082257507,3877600,13.127931788891155,0.5100705924756169,74500700.0,-9.647814478125015,91.40936679472856,92.55270083870475,83.96940399753596,28.28475545620855,20.298713794595024,-0.1524072693626955,13.260595226123638,401.3500397949219,390.5299819335938,381.7850036621094,373.040025390625,362.21996752929687,0.08,0.0,309.0830433637108,-0.00493077246211493,0.01192116347254997,407.85714285714283,388.38142830984935,22.340847872818298
2023-11-01,1,417.43499755859375,349.17750549316406,414.05499267578125,368.8212471008301,404.5825004577637,-0.14634152962450273,21.227172084393363,-1.464670668726732,2.9942097888807977,381.0975036621094,19.449787940979,0.05508555927932397,358.0747573852539,409.7802474975586,0.7800099381219519,0.08683652234131947,1.0832644222159244,1.0405134237952793,1.0227627675250115,0.008163178666122706,65.5640899632669,427.8034694587037,385.34912528991697,342.8947811211302,410.03999982561385,4.989142488647673,392.99285779680525,25.11098936869423,404.03966470238066,394.34770765996376,1.4140292171363895,10.542156665607031,4806100,13.081469198881845,0.6301259766847751,79306800.0,-0.5404029108952627,91.40936679472856,92.55270083870475,100.32639021636379,31.3514480105433,19.30111938085281,-0.12442321771353457,12.949838685836903,402.6946872558594,391.61766796874997,382.6650085449219,373.7123491210938,362.6353298339844,0.1,0.0,309.2067787845334,0.021738607760258377,0.015614026740959814,409.76428658621654,392.59499904087613,23.608814622084413
2023-11-02,1,422.4175033569336,349.17750549316406,417.43499755859375,368.8212471008301,406.73687744140625,-0.24915718070595982,22.23253483279397,-1.467395730413495,2.994076088838504,392.0812530517578,20.626625061035156,0.05739192676981009,358.0747573852539,412.3157539367676,0.7753071969828969,0.1158081764121742,1.0904449088363564,1.0353179852894925,1.0332591031216345,0.03419001254224052,69.75822632624424,431.84594506231645,387.3808753967285,342.9158057311406,411.51071384974887,6.8686973962824664,397.7673225402832,23.767915506176273,407.429727393811,396.41441926804566,3.311429692322156,14.714611079929696,4476000,13.107526885535053,0.5890043313399388,83782800.0,-2.415826247875293,91.40936679472856,92.55270083870475,102.78154673104893,33.084296175400176,18.260881944332404,-0.10566678494588919,12.709849946697883,407.3474444580078,395.3812857055664,385.7100067138672,376.03872772216795,364.07256896972655,0.12000000000000001,0.0,309.32651634730075,0.05246067914428276,0.03272946250474924,411.3328552246094,397.5257132393973,24.799447080177632
2023-11-03,1,430.3675003051758,349.17750549316406,422.4175033569336,368.8212471008301,408.7193794250488,-0.3500518629195076,23.259923196319374,-1.3880602391111283,2.9939377512086542,402.2299995422363,21.473375205993655,0.05967200342345799,358.0747573852539,414.3929931640625,0.7842778333874956,0.12627399493762512,1.1040832222360573,1.0495328372740222,1.0455621617841013,0.06915634017414418,71.6829018734338,436.3160969266964,389.7962505340576,343.2764041414188,413.84107208251953,9.951256853281365,402.8850015912737,22.38696091255162,411.20101622727356,399.04318321937455,2.498043188456618,18.798427049813366,3664800,13.116897284313486,0.4858006570928447,87447600.0,-2.7306272312740045,91.40936679472856,92.55270083870475,114.70580981637248,35.81341109090752,17.207957092811068,-0.12232238840928768,12.524147512586646,413.5587681884765,400.4056287231445,389.77500915527344,379.1443895874023,365.9912501220703,0.14,0.0,309.4313225503068,0.0866865826969847,0.07141789214546344,414.3485674176897,402.6357116699219,26.491737062384725
2023-11-06,1,433.4399948120117,349.17750549316406,430.3675003051758,368.8212471008301,410.1706237792969,-0.39968215783315847,24.593003176748155,-1.2425262289299719,2.9937512194109113,403.1700019836426,22.211899871826176,0.06264747680343302,358.0747573852539,417.93324813842776,0.796022706652993,0.12593119051007987,1.104132009641618,1.0502238716673107,1.0389734792947602,0.06715249673163481,74.00605360884735,441.74775714695323,392.561750793457,343.3757444399608,417.4107131958008,11.972536996043495,408.2483934674944,19.734837033582433,416.0016437804739,402.6609398875185,3.9396959142979746,19.973101024164137,3003200,13.13258992434794,0.39888404908749564,90450800.0,-0.32116122273103637,91.40936679472856,92.55270083870475,109.76493006527016,34.784427090029226,16.65356620446962,-0.12098510038070037,12.016709363668626,413.7192016601563,400.5354034423828,389.8800048828125,379.2246063232422,366.0408081054687,0.16,0.0,309.5186431756358,0.060134618780679494,0.09266844841196913,418.8057076590402,408.2799965994699,28.10364997209865
2023-11-07,1,434.8574981689453,349.17750549316406,433.4399948120117,368.8212471008301,412.6056270599365,-0.4369128796021719,26.009174621994426,-1.1775011214198423,2.9935420519533515,403.93250274658203,22.971237487792962,0.06582565986636083,358.0747573852539,423.21250305175784,0.8114814317098039,0.14074413414843387,1.100564788418904,1.0462094920042087,1.028917318155927,0.06187121931426187,75.67141915545784,447.14047448812954,395.12212524414065,343.10377600015175,422.028927394322,11.501515700111245,414.36839294433594,11.626701504038339,420.3550673449705,406.27895602319035,6.11759932025678,20.953526060688123,3291100,13.083836808035594,0.44904466637513535,93741900.0,-6.677014038891414,91.40936679472856,92.55270083870475,105.33709739029938,34.96883695824903,15.974567063829594,-0.07906700028098596,11.632659741152118,426.93033349609374,420.3048527832031,414.95001220703125,409.5951716308594,402.96969091796876,0.18,0.0,309.6151904593393,0.05567291596646995,0.059817595548458,424.0542776925223,414.59570966448103,29.007735406218416
2023-11-08,1,435.8499984741211,349.17750549316406,434.8574981689453,368.8212471008301,414.8999938964844,-0.5234637962403368,27.136650426793544,-1.0867450603871478,2.9933750204466856,405.11000061035156,23.1021250152588,0.06820535240987301,358.0747573852539,430.67474975585935,0.8155194503992969,0.17381534684136288,1.0954669156374066,1.0428929649710743,1.0190470726937642,0.044114655031871175,78.83182389864042,452.140175929881,397.8668750762939,343.5935742227068,426.2696413312639,10.05966732388046,416.7912499564035,12.34723544738331,423.81989139876725,409.6588399696076,8.031078301662998,24.537661025663816,2356800,12.766408171396,0.33719704952581664,96098700.0,-3.345142566293809,91.40936679472856,92.55270083870475,105.91288235746487,34.25865651825329,15.523911486905353,-0.017685887613965796,11.11532794881535,428.05180444335934,421.8541026611328,416.8450012207031,411.8358997802734,405.63819799804685,0.19999999999999998,0.0,309.6851873266964,0.03917273461872384,0.06062812141917523,427.84999302455356,417.0871385846819,29.266799334724016
2023-11-09,1,436.97750091552734,349.17750549316406,435.8499984741211,392.42000007629395,418.6806240081787,-0.6765641516586146,27.573584013655665,-0.837570127735118,2.9933289145284876,407.30875396728516,21.996562194824207,0.06873872055544543,358.0747573852539,433.5817451477051,0.8071506164445725,0.1977520657483606,1.0893496583387035,1.0401662955157265,1.0129605398053638,0.03446826289840277,81.24801950935738,456.2832932104169,401.1361251831055,345.9889571557941,430.1921419416155,7.456395715881339,419.1603567940848,12.837144340488308,426.71272149056244,413.0256143030186,7.308605490793512,8.439280009750622,2735500,12.565803847298712,0.40481815740034377,98834200.0,-11.684561763310189,91.40936679472856,92.55270083870475,102.9244630515599,34.42088476896699,14.902044575439835,-0.0025820071939536156,10.752090150992602,429.816642578125,423.28168115234377,418.0,412.71831884765623,406.18335742187503,0.2,0.0,309.76665110673497,0.024581485369906897,0.03560292098373814,431.20142037527904,419.52928161621094,28.634430687561853
2023-11-10,1,441.92750549316406,349.17750549316406,436.97750091552734,402.3799991607666,424.40500259399414,-0.8651366955514385,27.23627350700568,-0.3973917614295601,2.9934199932881276,408.9862518310547,20.417399291992183,0.06728486337883924,358.0747573852539,434.9567481994629,0.7754516779725132,0.22893202465283063,1.0917437667385137,1.044854562993352,1.017566275231758,0.026860776382489515,84.58289450747048,459.2630472734108,404.79050025939944,350.3179532453881,433.6910716465541,6.094580704034406,421.865535736084,13.387764029873798,429.21420326588753,416.24281848430394,6.704801840578405,8.213638914691671,4440600,12.260342419936318,0.6663810419200585,103274800.0,-0.462824293302906,91.40936679472856,92.55270083870475,119.35208442201723,36.298445682959176,13.694064430431249,0.026748427760259392,10.864799218053397,435.24104724121094,427.6694849243164,421.5500030517578,415.4305211791992,407.8589588623047,0.2,0.0,309.9057299600447,0.03441577709998578,0.05304796033196193,435.0657043457031,422.4149954659598,27.683526033576335
2023-11-13,1,445.7249984741211,349.17750549316406,441.92750549316406,403.49000358581543,431.13562393188477,-1.020025524470751,25.904097644900205,0.25305271524295403,2.993679820251294,410.82125091552734,18.8780611038208,0.06331846281816786,358.6832450866699,435.9627487182617,0.745334563912431,0.23195671662688025,1.0895041444752973,1.0441073700654573,1.0208755834096666,0.028343032044003014,85.7321537712189,460.91632097644595,409.1081256866455,357.29993039684507,437.02071380615234,5.211844175875167,424.2657138279506,14.474684224066648,432.36957973585754,420.028132745273,5.867382485373041,9.37310642347795,2896100,12.258138971851464,0.44200994640661834,106170900.0,-7.214538410774464,91.40936679472856,92.55270083870475,117.52506759467474,35.50549404357212,13.151228218087454,0.0025678563773861764,10.505169743354275,435.9668332519532,428.25657360839847,422.0249938964844,415.79341418457034,408.08315454101563,0.2,0.0,309.99750484982826,0.02272623891233483,0.028356023177436473,437.9099905831473,424.62142290387834,26.264168067494257
2023-11-14,1,449.2874984741211,349.17750549316406,445.7249984741211,403.9937515258789,433.7943706512451,-1.1581304330037003,24.334937301002668,1.149391443636067,2.9939563389539963,413.08874893188477,17.846873092651368,0.05885704273427609,397.5722511291504,437.47250137329104,0.6913381125179475,0.24381715725661368,1.086657145263234,1.0427890778644062,1.023276599069259,0.03318328502080847,86.84157722242243,462.1282505327914,413.45837593078613,364.78850132878085,439.72357068743025,6.028413655869855,426.78232138497486,15.583222669837916,435.71787162550635,423.78109010595296,5.5176442576275475,8.153520582625099,4060900,12.208432424439936,0.6286475926275671,110231800.0,-9.288391155434516,91.40936679472856,92.55270083870475,122.96959215359578,37.074501203469126,12.29926017261571,0.020325551271397856,10.430514151334549,440.2834285888672,431.7482698364258,424.84999084472656,417.95171185302735,409.41655310058593,0.2,0.0,310.13001035697937,0.03230484576548487,0.031996144763701814,440.2371346609933,427.29285103934154,23.588975773739026
