date,buy?,todays_price,Minimum,Maximum,25th Percentile,75th Percentile,Skewness,Standard Deviation,Kurtosis,Shannon Entropy,Median,Mean Absolute Deviation (MAD),Coefficient of Variation (CV),10th Percentile,90th Percentile,Autocorrelation,Cumulative Return,curr_to_avg_one_month,curr_to_avg_one_two_week,curr_to_avg_one_one_week,momentum,rsi,upper_band_current,middle_band_current,lower_band_current,rolling_mean_7,rolling_std_7,rolling_mean_14,rolling_std_14,ema_7,ema_14,roc_7,roc_14,Volume,Volatility,Relative Volume (RVOL),On-Balance Volume (OBV),Williams %R,Stochastic Oscillator %K,Stochastic Oscillator %D,Commodity Channel Index (CCI),ADX1,ADX2,Chaikin Money Flow (CMF),Average True Range (ATR),Fib_23.6,Fib_38.2,Fib_50,Fib_61.8,Fib_76.4,Parabolic SAR 2,Parabolic SAR 3,VWAP,Adj Close Momentum,Adj Close Return,Adj Close 7d MA,Adj Close 14d MA,Adj Close Volatility
2021-12-30,0,340.79500579833984,320.0824966430664,342.1324996948242,329.16625022888184,335.31562423706055,-0.09928439674091684,6.314396885802081,-0.8184806974616423,2.9955512541513545,331.9262504577637,5.150125885009766,0.01902007694442715,323.9557586669922,340.8444953918457,0.6714048643643097,0.025002230683312063,1.026534655611461,1.028223012581574,1.0099125968242402,0.032039760694645425,62.41031169836906,344.614668710569,331.98587493896486,319.3570811673607,336.081787109375,6.727503883716023,333.2032143729074,7.5835968871854496,336.1170532497663,334.1322031971388,6.24625822621075,2.293165706834202,15994500,4.711347907086042,0.5569732303228561,-15083800.0,-18.410287305358686,89.02914134005623,91.58768807638091,93.46670917712981,28.58482915646463,18.417330643239907,0.18480945315446518,7.141599652530133,337.9161906738281,333.96689245605467,330.7749938964844,327.5830953369141,323.63379711914064,0.06,0.0,331.14785230279267,0.01836726311359249,0.03675639293709932,329.2988019670759,326.0471758161272,6.9276009756127985
2021-12-31,0,337.51000213623047,320.0824966430664,342.1324996948242,329.16625022888184,338.8593807220459,-0.13531802443979257,6.596012172907457,-0.9973672256006054,2.995535130292319,331.9262504577637,5.516376113891601,0.019846457035820955,323.9557586669922,340.8962547302246,0.7174040222483646,0.03186791756677678,1.015519313937827,1.0152310273486391,0.9939452131709205,0.0100855780403315,62.01130812248875,345.5441495136616,332.3521251678467,319.1601008220318,337.93642970493863,4.397277494217026,333.1091068812779,7.516310514241567,337.2571035722091,335.09114668709833,6.470990876570979,2.025269300292038,18000800,4.647311311341425,0.6410870073109163,-33084600.0,-29.50086532321571,89.02914134005623,91.58768807638091,51.0219979516834,27.251729341836533,21.5046090827006,0.18778203824240136,6.81285975546473,337.9161906738281,333.96689245605467,330.7749938964844,327.5830953369141,323.63379711914064,0.06,0.0,331.32130259082834,0.004870007108395358,0.009363636568240796,330.5587071010045,325.6132507324219,6.925905338544023
2022-01-03,0,334.4700012207031,320.0824966430664,342.1324996948242,329.16625022888184,338.8593807220459,-0.26919692196386796,6.670063890468322,-1.0266687710548663,2.9955309355087616,333.57250213623047,5.633963088989259,0.02004743223315135,323.9557586669922,340.8962547302246,0.7332492301930569,0.03393503801381012,1.0052774296624167,1.00384843143167,0.9830413834960671,-0.013231846664375269,57.93683846733249,346.05425360491125,332.7141258239746,319.37399804303794,338.5442875453404,3.312236185280194,332.66142872401645,7.207303507921933,337.30143488147365,335.3958030128946,4.000430783288571,-0.3888423624173031,28865100,4.621399512466701,1.0522093038091194,-61949700.0,-35.3049615625007,89.02914134005623,91.58768807638091,12.405226400072069,24.38372895318294,27.012899039806882,0.22765890982180434,6.937849943123309,337.9161906738281,333.96689245605467,330.7749938964844,327.5830953369141,323.63379711914064,0.06,0.0,331.44722365055327,-0.022485073851972737,0.00017925031914959168,330.7749720982143,325.28885541643416,6.5296151942848075
2022-01-04,0,331.29000091552734,320.0824966430664,342.1324996948242,330.09249687194824,338.8593807220459,-0.42768095100323855,6.519928246901644,-0.7987149464901604,2.995540169586269,334.0850028991699,5.327400245666501,0.019572545996792798,323.9557586669922,340.8962547302246,0.7072612071066938,0.031662039329179964,0.9945184265299329,0.9905116700274642,0.9762688493379854,-0.031690934912550484,53.88230052157386,346.155857241484,333.1160007476807,320.0761442538774,338.13714381626676,4.039225930851329,332.748035975865,7.181102455123879,336.6237227428101,335.267474235394,1.2885559196283716,-1.8393908172305031,32674300,4.650873691199194,1.185357411508498,-94624000.0,-56.52489806785849,89.02914134005623,91.58768807638091,-43.76626324787036,21.67068269135191,28.492210574567775,0.16725278743243946,7.124875539374174,337.9161906738281,333.96689245605467,330.7749938964844,327.5830953369141,323.63379711914064,0.06,0.0,331.38364425916063,-0.035868062359333486,-0.03924668597267827,329.9824698311942,325.3355974469866,6.394491982485117
2022-01-05,0,321.07250213623047,320.0824966430664,342.1324996948242,330.1856212615967,338.8593807220459,-0.5195671608197416,6.211312024705012,-0.43995288365337615,2.9955582186745606,334.0850028991699,4.9377257156372085,0.018626285309518632,324.24600372314455,340.8962547302246,0.7718195159313975,-0.005478602127018772,0.9628220263358096,0.9567567631470402,0.9522443160683385,-0.06066278029932637,45.911532223390246,345.8928743698446,333.47025032043456,321.0476262710245,335.58250100272045,7.55801761183472,332.05767931256975,7.824962751104323,335.3294111565179,334.7044748405758,-0.852937703850949,0.3673384366159348,40054300,4.274014283752706,1.4296654246034175,-134678300.0,-98.58759101670385,89.02914134005623,91.58768807638091,-151.06949909507915,18.491149396960065,35.72965226879469,0.06047175105228791,7.63237436157317,337.6164732666016,333.481756652832,330.13999938964844,326.79824212646486,322.6635255126953,0.02,1.0,330.7278681009489,-0.07477706423183617,-0.07287912888853076,326.34505789620533,324.061043875558,7.434337287936953
2022-01-06,0,314.3050003051758,320.0824966430664,342.1324996948242,330.09249687194824,338.8593807220459,-0.4395047360405901,6.774713308183038,-0.8340350934267406,2.9955245116385507,334.0850028991699,5.600063400268556,0.02035254443505964,321.64850158691405,340.8962547302246,0.6778880274425723,-0.03912222130562072,0.9442327953783418,0.9375556947420267,0.9437809129907385,-0.07773002844073107,34.317692195403076,346.41755176895396,332.8681251525879,319.3186985362218,331.6071439470564,10.343654160499804,330.9296439034598,9.15461777465456,331.78123489284985,332.5606946261422,-5.275773951769973,-2.9222550874645403,39646100,4.820975244592613,1.378476475453925,-174324400.0,-92.71559028869389,89.02914134005623,91.58768807638091,-169.96479126030587,17.004427634037068,37.86392332068508,0.002339384293401416,7.596595775339668,336.55682836914065,331.76656872558596,327.8949890136719,324.0234093017578,319.2331496582031,0.04,0.0,329.89878123035754,-0.07497338954365385,-0.08208798859390533,322.5262756347656,323.2922668457031,8.492528324880833
2022-01-07,0,313.6949996948242,314.3050003051758,342.1324996948242,328.6900005340576,338.8593807220459,-0.5541505051788704,7.877857382323203,-0.6484210549566316,2.995449244133754,332.6599998474121,6.464376068115234,0.02373734288465232,320.97350158691404,340.8962547302246,0.6738037335442054,-0.05905157784092908,0.9452171329815338,0.9401981526148999,0.9571765691204268,-0.07056087905742625,29.22365049844277,347.6318401003398,331.87612533569336,316.12041057104693,327.591073172433,11.14931286973508,330.3569652012416,9.988366851363004,327.4435146205208,329.8141602579825,-8.133544581257274,-4.784191312367278,32720000,5.00471701468239,1.1172535776358068,-207044400.0,-88.4536299513021,89.02914134005623,91.58768807638091,-153.40859955369777,15.789006022069346,36.718639739636835,0.03619844097685313,7.497394224111831,336.22642980957033,331.2317710571289,327.1949920654297,323.15821307373045,318.16355432128904,0.06,0.0,329.2295378010019,-0.0662463736042801,-0.0745019109157708,318.6321454729353,322.61139133998324,9.331120930657985
2022-01-10,0,310.79249572753906,313.6949996948242,342.1324996948242,323.8237533569336,338.8593807220459,-0.492723583721595,8.793324991418825,-0.8798042948266871,2.99537746764351,331.0137481689453,7.207126235961914,0.026577227806467377,319.50474700927737,340.8962547302246,0.7310496446949916,-0.07417493209253001,0.9393492185893351,0.9372420050107192,0.9623056722764013,-0.07079111850614139,26.798215646508226,348.44602536430733,330.8593753814697,313.2727253986321,323.3050003051758,10.99316824079075,329.6933937072754,10.982560730170006,324.03171495792174,327.41346161528384,-8.22465739457381,-2.4921325074492793,44289500,4.814921805352096,1.4964797358002608,-251333900.0,-75.81421329183166,89.02914134005623,91.58768807638091,-149.43138222017402,14.091715839664463,38.558986897080906,0.04678140569006502,7.706578689496796,334.95203125,329.1689733886719,324.4949951171875,319.8210168457031,314.037958984375,0.08,0.0,328.28473924715945,-0.061180050998777435,-0.06556248456581082,315.1370588030134,322.21793038504467,9.599780114691232
2022-01-11,0,313.71500396728516,310.79249572753906,342.1324996948242,321.5525016784668,337.8712520599365,-0.4209299201727617,9.6081781114843,-0.958744214926964,2.995305149805404,330.47624588012695,8.00158737182618,0.029163623445729384,314.24400024414064,340.8962547302246,0.7416162691073479,-0.08788290134522973,0.9522165533174145,0.9541587827536295,0.9858090638811466,-0.053050188353627625,24.07088147690189,348.6739810398631,329.4576248168945,310.2412685939259,319.9057148524693,9.437500105426892,328.92107227870395,11.728624153442201,320.7078084760135,324.91411941461234,-8.803682436753284,-2.9023770474668917,29386800,4.764517486876322,0.9921215820576256,-221947100.0,-74.02168050911445,89.02914134005623,91.58768807638091,-112.23978894197384,15.10181911268847,35.783522969222474,0.11443889037175296,7.62598828173695,334.95203125,329.1689733886719,324.4949951171875,319.8210168457031,314.037958984375,0.08,0.0,327.79822707870863,-0.042643157598126535,-0.059059115681423975,312.15960693359375,321.3591570172991,9.813174476208788
2022-01-12,0,319.6074981689453,310.79249572753906,342.1324996948242,320.82500076293945,335.23000144958496,-0.2599411115437858,9.824524442833276,-1.146776196728085,2.9952826905602574,330.15624618530273,8.49494979858398,0.029943096023769565,313.71300354003904,340.8962547302246,0.8486312178052096,-0.04957167771998828,0.9740968189631375,0.9805557757957479,1.0155425774254963,-0.004562844708088876,31.47617556428587,347.7555491298072,328.10650024414065,308.4574513584741,317.78250013078963,6.96195207219813,328.163393838065,11.9785689060489,318.9124131346408,323.15430812386995,-7.050160889555162,-3.3317669127637277,34372200,4.348751944956325,1.1804923165584447,-187574900.0,-65.71574957239935,89.02914134005623,91.58768807638091,-59.883677160454,20.912262065052026,32.61223928095015,0.09458632558245023,7.690996133716135,334.95203125,329.1689733886719,324.4949951171875,319.8210168457031,314.037958984375,0.08,0.0,327.4872709371233,0.0059738529983976996,-0.03264343966288228,309.8602382114955,320.3176051548549,10.053011981615214
2022-01-13,0,312.5374984741211,310.79249572753906,342.1324996948242,319.96374702453613,335.23000144958496,-0.12151809746184324,9.983217825233194,-1.277638421791844,2.995267201292679,330.15624618530273,8.873699951171876,0.03047538431375555,313.71300354003904,340.8962547302246,0.8792807259538381,-0.03365205762111906,0.9540711767687134,0.965440593533699,0.9940032977829393,-0.005623524377081246,40.95585047972561,347.5494358335718,327.58300018310547,307.61656453263913,315.1035712105887,3.7778632352571457,326.62035751342773,12.528228786661945,319.05625021569654,322.795586372912,-4.443598229292514,-3.2123005576921924,45366000,4.595068319668262,1.5318029935089317,-232940900.0,-98.01491802657983,89.02914134005623,91.58768807638091,-115.9732375121325,17.556961636850414,39.81240851337563,-0.030036741022465084,8.427036015135087,334.7891906738281,328.9053924560547,324.1499938964844,319.39459533691405,313.51079711914065,0.1,0.0,326.64978346235375,-0.028928503059595267,-0.03660171347174121,306.48233904157365,318.23240443638394,11.087184400453774
2022-01-14,0,307.2550048828125,310.79249572753906,342.1324996948242,318.28187370300293,335.23000144958496,0.006401558221646536,10.471740662219977,-1.4077264314028688,2.9952183837139077,327.3125,9.468250274658203,0.032055727444444695,313.5792495727539,340.8962547302246,0.8475220532628458,-0.053196397336056855,0.9405583092789221,0.9574804716736319,0.9783025911750539,-0.02052947869196775,34.716578196284345,347.61648166013333,326.67300033569336,305.7295190112534,313.12964303152904,3.7490135049028037,324.35607201712475,12.983807381756598,317.3855788869731,321.7949727534107,-5.660449270905638,-6.465106868717677,39846400,4.817972942108661,1.3345900043742334,-272787300.0,-84.093676575287,89.02914134005623,91.58768807638091,-111.97370102962233,16.372102215558282,37.36424184398918,0.06784721472769716,8.319272442961015,334.73019067382813,328.8098924560547,324.0249938964844,319.24009533691407,313.3197971191406,0.12000000000000001,0.0,325.911640093116,-0.012227668880541387,-0.01172420926319348,305.62008231026783,315.9825701032366,11.63006729371219
2022-01-18,0,304.5649948120117,307.2550048828125,342.1324996948242,314.1575012207031,335.23000144958496,0.05235324481055784,11.252531840586677,-1.4034601436412975,2.995135015235534,323.12000274658203,10.153712806701662,0.03456671141773241,312.3629981994629,340.8962547302246,0.8492614204532472,-0.04493918195436813,0.9355948005974348,0.9581311912446269,0.9737308458917311,-0.02003748803827865,32.24403924101998,348.0359394593716,325.53087577819826,303.0258120970249,311.7382136753627,4.877667106151884,321.67267881120955,12.909171671685996,314.81300835118225,320.3813351733059,-4.303544265386897,-9.352272949800698,42333200,4.610452250502685,1.4308618609498711,-315120500.0,-97.86183337802935,89.02914134005623,91.58768807638091,-119.80886984285571,15.062190815455692,36.27569699522967,-0.04404967337293099,8.330361044053854,334.2558283691406,328.0420687255859,323.0199890136719,317.99790930175783,311.78414965820315,0.14,0.0,325.0454672343316,-0.0369746198061518,-0.036269291888096425,304.05321829659596,313.2897469656808,12.66033807937904
2022-01-19,0,306.55750274658203,304.5649948120117,342.1324996948242,313.7100028991699,335.23000144958496,-0.0024339146362315728,12.129871783948834,-1.4025337696867073,2.995034099383699,322.8000030517578,10.925350608825681,0.03736021500805196,310.4387466430664,340.8962547302246,0.8564438026303295,-0.04847969505923568,0.9442024135901694,0.973558483806595,0.9840195119874501,-0.02281529773899349,30.580881373958512,348.93324401040246,324.67350044250486,300.41375687460726,310.7185712541853,5.13943703017478,319.15482221330916,12.091670897327912,312.2505743791849,319.00357938431705,-3.0989024939809937,-10.98039645936063,45933900,4.627014894353805,1.5077015739586608,-269186600.0,-96.1585025968319,89.02914134005623,91.58768807638091,-98.19933181957512,17.267856318090335,32.54358377247603,-0.10480019541049185,8.559481185665335,333.36196142578126,327.31901928710937,322.43499755859375,317.55097583007813,311.50803369140624,0.14,0.0,324.263782196379,-0.036986609574181206,-0.03481101763771749,302.5589032854353,310.5955243791853,13.453780008062166
2022-01-20,0,305.86500549316406,304.5649948120117,342.1324996948242,313.40562438964844,335.23000144958496,0.015637184709815705,12.729182168423053,-1.4921325044146976,2.994960361027978,322.8000030517578,11.58700065612793,0.039287932656984666,307.1852546691895,340.8962547302246,0.8907488935586771,-0.05537281432551442,0.9440358052030589,0.9790492002215979,0.9863288203614144,-0.042998029628569356,32.0715255256138,349.4556150845268,323.99725074768065,298.5388864108345,310.01464407784596,5.45536310133529,316.6598221915109,10.819789197076014,310.85203523460757,318.16831200949537,-2.275298285017564,-10.312820190944066,35380700,4.5111880627219865,1.1413799132723277,-304567300.0,-98.79646308823436,89.02914134005623,91.58768807638091,-96.39099190044016,15.649455628591484,30.884627626540567,-0.1905531282919522,8.710997423583514,330.340072265625,324.7599565429687,320.25,315.7400434570313,310.159927734375,0.16,0.0,323.64691404476787,-0.05237685329485875,-0.04247880508935779,300.7911289760045,307.96409388950894,14.251166950765937
2022-01-21,0,299.60999298095703,304.5649948120117,342.1324996948242,312.1012477874756,335.23000144958496,0.09808124601001651,13.326147756509004,-1.5752946472017062,2.994882328642172,320.3400001525879,12.37378776550293,0.04124923410335543,306.4882530212402,340.8962547302246,0.8988184341430585,-0.07373980925993613,0.9274009988475265,0.9637185963797813,0.9747979272619414,-0.041363054213587436,29.035516791477722,349.7164213369926,323.0641258239746,296.41183031095665,307.9996425083705,6.386292629089326,313.9526786804199,9.904341728702759,309.6408564126817,317.1033827300514,-1.5854598492927445,-10.249563435752068,57984400,4.233866810655947,1.775621960247521,-362551700.0,-99.00916894882495,89.02914134005623,91.58768807638091,-116.29049098770439,14.468401175912597,33.463758445446594,-0.29494140538866365,8.694708816212517,327.99595654296877,321.80701440429686,316.80499267578125,311.80297094726564,305.61402880859373,0.18,0.0,322.40956793598565,-0.028772832098781675,-0.06987782376564657,298.1471383231027,305.1533726283482,15.118191894081894
2022-01-24,1,290.4324951171875,299.60999298095703,342.1324996948242,309.9081230163574,335.23000144958496,0.17346649083109078,14.14894407253316,-1.499899831328079,2.9947660718076428,316.95624923706055,12.882900848388669,0.04400452065481612,305.7350044250488,340.8962547302246,0.8707389888106998,-0.10333995724169012,0.9032718388522069,0.9386351735622656,0.9529547477288526,-0.054750970686518574,22.942926442306664,349.83176380119426,321.5338756561279,293.2359875110616,303.831784929548,7.035309731531985,310.8071425301688,9.879912601749117,307.16816980812536,314.9760828069597,-4.496122534132612,-11.22929955123988,85731500,4.184929410309028,2.3839794268928083,-448283200.0,-65.64666282810897,89.02914134005623,91.58768807638091,-145.87981445868056,12.043251646073033,43.42250830105327,-0.15894471190022846,9.643810133600665,321.2406064453125,312.60470288085935,305.625,298.64529711914065,290.0093935546875,0.19999999999999998,0.0,320.1941879182659,-0.04458429152929588,-0.02765736843659172,295.09154837472096,302.47589329310824,15.621437880947877
2022-01-25,1,290.04249572753906,290.4324951171875,342.1324996948242,307.0806293487549,335.23000144958496,0.12247671632276963,15.3569468987325,-1.1528314454805915,2.994577471106703,314.01000213623047,13.350350646972657,0.048088363952852195,304.0694946289062,340.8962547302246,0.822216850767875,-0.143153239963257,0.9082319023640474,0.9444754132837827,0.9622983531543033,-0.047682758464860586,16.401669338408702,350.0623938585002,319.34850006103517,288.63460626357016,300.6182131086077,7.517083205934069,307.8608921595982,9.442385377380893,303.01766401500777,311.93260739571923,-9.128385040683819,-13.166354513945503,72848600,4.184165406832369,1.886947280244124,-521131800.0,-75.1299528509093,89.02914134005623,91.58768807638091,-135.5750357104234,10.988389508582467,39.619153420846416,-0.20422134388649418,9.762621656421144,314.26528271484375,306.9623598632812,301.05999755859375,295.1576352539063,287.85471240234375,0.19999999999999998,0.0,318.51961491209687,-0.04678654974322416,-0.06998703602413898,292.81591796875,299.64912850516185,15.926017432306429
2022-01-26,0,301.5574951171875,290.04249572753906,342.1324996948242,306.38437843322754,332.0850009918213,0.16923061137734588,15.924072463852621,-0.9817111871138247,2.9944722965744184,313.7050018310547,13.34620071411133,0.05024906282759491,298.6922431945801,340.8962547302246,0.822082524553428,-0.15225096713626582,0.9515770260825375,0.9886523234111653,1.0102377935130915,-0.016310178627491734,14.717757910501279,348.75101968356455,316.9028747558594,285.0547298281542,299.80428314208984,6.967030826857962,306.4669630868094,8.757616383885054,299.8145329187889,309.14857816764,-7.197537209585325,-12.450573537987829,90428900,3.998696245077978,2.1355292341756846,-430702900.0,-56.37669607376282,89.02914134005623,91.58768807638091,-81.57610002078155,19.140890968060294,33.905242455582034,-0.23353150615467322,10.541164956232898,312.2330399169922,305.31847760009765,299.72999572753906,294.1415138549805,287.2269515380859,0.02,1.0,317.3059051983798,-0.021824247142174458,-0.01962660705550615,290.93372889927457,298.27690560477123,15.325115434716821
2022-01-27,0,301.9324951171875,290.04249572753906,341.8074951171875,305.540002822876,323.6268768310547,0.3178089743416764,15.146207163100193,-0.8040049775372626,2.9945802786939266,313.11624908447266,12.243363380432129,0.04810241929486495,298.6922431945801,337.83850250244143,0.8385145654287692,-0.11775634114225736,0.9588990380545505,0.9938430389265095,1.0148940367572685,-0.012857013078812152,34.073990680355514,345.16653885317794,314.87412452697754,284.58171020077714,299.428211757115,6.734389530053623,305.58321271623885,8.527053543512393,300.2822036616801,308.1175416280927,-1.854326105378833,-6.078068625996127,53481300,5.09816203346071,1.2081548469879035,-377221600.0,-49.76773527556346,89.02914134005623,91.58768807638091,-63.88702268575397,17.687050089590095,31.329979498459416,-0.2588784880379099,10.544858120883443,312.2330399169922,305.31847760009765,299.72999572753906,294.1415138549805,287.2269515380859,0.02,0.0,316.740469080366,-0.005835720248036802,-0.011505573495028608,290.54166085379467,297.2974395751953,14.136773254090993
2022-01-28,0,302.8550109863281,290.04249572753906,340.79500579833984,303.90686988830566,319.9737491607666,0.43527176139164403,14.054768528388697,-0.5507167240939959,2.9947291037418693,311.6649971008301,11.053664360046389,0.04492058202639632,298.6922431945801,334.77400131225585,0.8130347595130578,-0.11403485972487705,0.9679578383405923,1.002713300074834,1.020693312713119,0.010830806987059738,34.77517049831418,340.98991158375503,312.88037452697756,284.7708374702001,298.89928436279297,6.20577456461003,304.8089278084891,8.220458085574943,300.70575155688147,307.07993307774115,-0.8643474265481792,-3.936464636571211,49743700,5.123355229584711,1.0824581810854395,-327477900.0,-31.988996664074133,89.02914134005623,91.58768807638091,-45.960188136597175,15.957740924202492,30.69190317144126,-0.18358199610700135,10.807339630242154,312.2330399169922,305.31847760009765,299.72999572753906,294.1415138549805,287.2269515380859,0.02,0.0,316.3165729842743,0.04131362216115697,0.0220823496709948,291.22953142438615,296.8942173549107,12.621057929335333
2022-01-31,0,309.67000579833984,290.04249572753906,337.51000213623047,302.62438201904297,315.63062477111816,0.48810982015334753,12.64918867461664,-0.27559561517710796,2.99490991890407,309.0237503051758,9.935213394165038,0.04067480675873981,298.6922431945801,331.6080009460449,0.7909388533457679,-0.10267841228573255,0.9957767228266164,1.0285742023428337,1.0413836491671022,0.06623745966645411,36.77621632161003,336.2817521356102,310.98337478637694,285.6849974371437,299.44285583496094,7.029565034423442,304.7287499564035,8.162880808066214,301.2410131094066,306.2102265082776,-1.2077641966292365,-3.455582243593839,46444500,5.155818005020401,0.9803263511900503,-281033400.0,-26.245752767748808,89.02914134005623,91.58768807638091,5.7210708325115,18.06962262182522,29.36730672810994,-0.1379809996407388,10.447429862465867,312.2330399169922,305.31847760009765,299.72999572753906,294.1415138549805,287.2269515380859,0.04,0.0,316.127436996326,0.04929657131826071,0.050501698434602935,292.53826904296875,296.6646990094866,11.08925400479882
2022-02-01,0,308.73250579833984,290.04249572753906,334.4700012207031,302.62438201904297,313.8625030517578,0.41851891569702515,11.089069375418864,0.09065915304090622,2.9950935830529013,308.4625053405762,8.524125671386718,0.03581840539489175,298.6922431945801,322.0942520141602,0.7510661824646849,-0.07414714423371792,0.9972257974847417,1.0246383698572628,1.0249691835647294,0.06443886791112785,46.533696713291995,331.76951372032016,309.59137496948244,287.4132362186447,300.7460719517299,7.862037091053665,304.3728572300502,7.843312511371124,303.3244615784001,306.487692495504,1.244012958932898,-0.36117021634372615,40950400,5.492136123782417,0.8534741006487278,-321983800.0,-30.933253774583687,89.02914134005623,91.58768807638091,2.6816889644051094,17.28752940038119,29.0136514780832,-0.12888170007094313,10.103752937413402,312.2330399169922,305.31847760009765,299.72999572753906,294.1415138549805,287.2269515380859,0.04,0.0,315.9256452618457,0.07026233784154234,0.04180603293719838,294.3144226074219,296.2307804652623,9.344339361998848
2022-02-02,0,311.77249908447266,290.04249572753906,331.29000091552734,302.62438201904297,313.70000076293945,0.17668721111124755,9.507943707320353,0.36010360675357145,2.995257350198189,307.9937553405762,7.237250900268554,0.030839458072142657,298.6922431945801,319.75399856567384,0.6889522361801088,-0.06808987610507217,1.0112486158452991,1.0332984735460955,1.0223741847867938,0.03387415047772402,46.36399310834397,327.320387613005,308.3045001983643,289.2886127837236,303.7946439470564,7.31465940245428,303.81321443830217,6.894835186511733,304.6278020637963,306.7829703371015,3.0447959117180154,-1.5882243775196987,36636000,5.474647597618594,0.7604155510335225,-285347800.0,-16.55144010510623,89.02914134005623,91.58768807638091,57.088679894758066,19.858717805726094,27.614296483671893,-0.09823630473760742,9.824818077177143,310.30012084960936,303.7549383544922,298.4649963378906,293.17505432128905,286.6298718261719,0.06,0.0,315.84932403035754,0.0564523339365135,0.08655386558642081,296.6988961356027,295.89522225516185,8.073075076542365
2022-02-03,0,305.4824981689453,290.04249572753906,321.07250213623047,302.62438201904297,312.8268737792969,-0.5240737284948316,7.977051460284486,-0.00992773498961963,2.9953937714770418,307.9937553405762,6.261375808715821,0.025956096531886925,298.6922431945801,314.8352500915527,0.7211638656775828,-0.028965429894746448,0.9939929873527903,1.010704814425183,0.9950812962157821,0.011757605124218085,53.137482789624755,323.2827280273805,307.3286251068115,291.37452218624253,306.00035858154297,4.0966751747552275,303.30928584507535,6.451725702928848,306.38148401960575,307.3729692929077,7.347664027289581,-2.451444077301045,43730000,5.11209511658855,0.9042091421478596,-329077800.0,-35.50036477364507,89.02914134005623,91.58768807638091,-23.3559334847042,17.886670390158674,31.43351089074121,-0.0945964434680758,10.097802647246317,305.8994733886719,300.19525231933596,295.5849914550781,290.9747305908203,285.27050952148437,0.06,0.0,315.5473173348277,0.004702504212453773,0.015301005783515858,298.4792175292969,295.64756774902344,7.831581594133193
2022-02-04,0,303.72999572753906,290.04249572753906,319.6074981689453,302.62438201904297,311.96374893188477,-0.6850713988490649,7.331536734159026,0.21396212148081561,2.995444626202859,306.90625381469727,5.659964065551759,0.02391635186154465,298.6922431945801,313.77400360107424,0.74133467774911,-0.0280698752093165,0.9908036626046474,1.005033760077969,0.9870897760384542,0.002889120897690667,47.3934301959613,321.2121983767653,306.54912490844725,291.8860514401292,306.3107158115932,3.7735426630457827,303.05749947684154,6.35393692568794,306.1564575396411,306.88636942648844,5.323358703929483,-2.257329229170865,35096500,5.082256500843885,0.7291230071117357,-364174300.0,-23.49626556146241,89.02914134005623,91.58768807638091,-10.027061830580774,16.71732227188624,29.378532741705264,-0.06832368091046427,10.003899564304529,305.8994733886719,300.19525231933596,295.5849914550781,290.9747305908203,285.27050952148437,0.06,0.0,315.3313352816265,-0.007526387107132937,0.020344205592546273,299.7670244489397,295.35037667410717,7.614801593648819
2022-02-07,0,303.71500396728516,290.04249572753906,319.6074981689453,302.62438201904297,311.03749656677246,-0.5888494291492218,7.131728289007797,0.3132047091112202,2.995459392825842,306.21125411987305,5.413126754760742,0.023304749876459845,298.6922431945801,313.69700012207034,0.7239079232712845,-0.031766537486984284,0.9924666103860104,1.0036159262185174,0.9864800222950224,-0.019230153775153247,45.55867834823256,320.28383125758097,306.0203746795654,291.75691810154984,306.5653599330357,3.477373134724496,302.99678584507535,6.3424749589349,305.5676536842819,306.3472270449038,0.7204266667314346,-1.14725849839871,28533300,5.090376531996275,0.5953629656121149,-392707600.0,-36.268185958011195,89.02914134005623,91.58768807638091,-29.11326433137993,15.72199210481415,27.681864292813493,-0.09845194082001267,9.851435538885994,305.8994733886719,300.19525231933596,295.5849914550781,290.9747305908203,285.27050952148437,0.06,0.0,315.12953132721907,-0.03225289154292521,-0.023713932619621823,299.9219011579241,295.2317810058594,7.412694917199123
2022-02-08,0,302.8300018310547,290.04249572753906,319.6074981689453,302.62438201904297,309.95062828063965,-0.4969788808548923,6.923387238284453,0.4810239816258117,2.9954744740880765,305.6737518310547,5.129127120971679,0.02266089317222043,298.6922431945801,312.6552490234375,0.7286976895679338,-0.022772402350597604,0.9911908845557051,0.996318465544419,0.9874252739805821,-0.01911850503730439,46.39721249611699,319.36814936975736,305.52137489318847,291.67460041661957,306.5617871965681,3.481830576990643,302.7305357796805,6.259193340466668,305.11103722016287,305.8223029950595,0.5903666809383403,-0.2790835648237273,32421200,5.060125070216716,0.6849673506403373,-425128800.0,-27.028399229523075,89.02914134005623,91.58768807638091,-19.410134154561923,15.040608568393449,26.482145678225233,-0.12023498357223052,9.538875197583396,305.8994733886719,300.19525231933596,295.5849914550781,290.9747305908203,285.27050952148437,0.06,0.0,314.9163648198053,-0.013602896343391735,-0.020644418793642424,299.40565272739957,295.31759207589283,7.089952665920838
2022-02-09,0,310.0999984741211,290.04249572753906,319.6074981689453,302.6056251525879,308.96688079833984,-0.3670800971498666,6.837230892991247,0.5375104236503798,2.9954804487118225,305.0237464904785,4.996252059936523,0.022408095379641776,298.6922431945801,312.6552490234375,0.7002804995937899,-0.03469710405488154,1.0163106163575584,1.0159626616385364,1.0150373436918847,-0.005364490502731689,44.1442123049199,318.79771198434673,305.12325019836425,291.44878841238176,306.6232147216797,3.548952140738542,303.0330352783203,6.519264430664016,304.5528818499114,305.1147012111631,-0.008257798077036438,-1.2159222599776687,31284700,5.000710602775019,0.659633878075044,-393844100.0,-10.007686022842485,89.02914134005623,91.58768807638091,76.06874920139427,19.165116145387003,24.95217659890262,-0.11342555785219612,9.379407317903455,305.8994733886719,300.19525231933596,295.5849914550781,290.9747305908203,285.27050952148437,0.06,0.0,314.8349753684186,-0.007177746056555967,0.007934989133652282,299.43774850027904,295.98800877162387,6.850515854471647
2022-02-10,0,304.0600051879883,290.04249572753906,319.6074981689453,302.6056251525879,308.96688079833984,-0.4036579682040107,6.653010232294022,0.7741918300221595,2.995493506504092,305.0237464904785,4.81550178527832,0.02181726139832443,298.6922431945801,311.8489990234375,0.5813817803771689,-0.0297474237910355,0.99710602905158,0.9933939392140191,0.9963578038999887,-0.004656544939508511,52.590233012649534,318.2485203882941,304.94249992370607,291.63647945911805,305.9557146344866,3.5254410477325115,303.35089329310824,6.4476202521066766,305.95358659246216,305.4023832923453,0.13885512569185193,1.3845954603824993,45386200,5.102862181365055,0.9459780270444392,-439230300.0,-32.60810812921891,89.02914134005623,91.58768807638091,3.253464566084125,17.603257033362276,28.106162287578186,-0.11819536185256865,9.462359185788552,305.8994733886719,300.19525231933596,295.5849914550781,290.9747305908203,285.27050952148437,0.06,0.0,314.57323544752313,0.003751137321186926,-0.03534735402478508,298.5475769042969,296.4309997558594,6.041206485634753
2022-02-11,0,299.1850051879883,290.04249572753906,312.5374984741211,302.6056251525879,307.62438011169434,-1.053992298969222,5.739692062934356,1.0008834584538215,2.995553005512629,304.3125,4.088626098632813,0.018870316107908392,298.6922431945801,310.2672485351562,0.5779917749436607,-0.027124723681228192,0.9836269194827221,0.9767878905649994,0.9812980027675688,-0.014963917306435093,46.93751659740822,315.64450940052694,304.1651252746582,292.6857411487894,304.1575012207031,3.2645809375514765,303.9760725838797,5.445048662169394,305.48551118810803,304.5681668500272,-1.5134462755287519,1.4852682858659154,39175600,5.037838151698328,0.821833263231208,-478405900.0,-67.04507128075068,89.02914134005623,91.58768807638091,-83.88944375456217,16.237822735909024,30.917463280181646,-0.1102877526553102,9.506856839963163,308.05179943847656,303.6791021118164,300.14500427246094,296.61090643310547,292.2382091064453,0.06,0.0,314.22958477814075,-0.035627702625619984,-0.020613881687064805,295.97754342215404,296.33821977887834,6.297312758635252
2022-02-14,0,294.2200012207031,290.04249572753906,311.77249908447266,301.8387451171875,306.73187828063965,-1.046477149755174,5.498508019385762,0.9183587834946239,2.995567084989594,303.8950004577637,3.9535012817382835,0.018117144320226476,298.3097541809082,309.71300506591797,0.5744995000824018,-0.02626482747743077,0.9694313812436978,0.9617303411399366,0.9678989873775786,-0.03126287019921081,42.81792789832778,314.49451664912306,303.49750061035155,292.50048457158005,302.54857308524,4.878911649615084,304.27446583339145,4.6840239039575104,303.9159379599354,303.54255567054264,-4.037397119196802,3.01361253232673,36359500,5.0180318676284905,0.7655565557945437,-514765400.0,-84.64452846660974,89.02914134005623,91.58768807638091,-117.0972927592115,15.540405648199085,31.868049889454475,-0.13191167364059275,9.207386374879151,309.5102777099609,306.0398593139648,303.23500061035156,300.4301419067383,296.9597235107422,0.02,1.0,313.8579088657472,-0.01977090531087866,-0.035758739019318725,295.1055123465402,296.79236493791853,6.287673237131834
2022-02-15,0,299.5749969482422,290.04249572753906,311.77249908447266,301.0706195831299,306.03812980651855,-0.7817865873307526,5.7798330396681665,0.10329790666557637,2.9955492128837267,303.7224998474121,4.295602111816402,0.01908507229014818,293.84125061035155,309.71300506591797,0.5684710775001979,-0.03396645631482991,0.9891999360255521,0.9842049048657843,0.9917107597270998,-0.010748620886739002,38.449194238378745,314.40541650658247,302.8457504272461,291.28608434790976,301.9550018310547,4.963244588215755,304.13285882132396,4.800988531339001,301.46703833335425,302.1690829730184,-3.6867895921204394,1.4403080771613341,27058300,5.097173600982123,0.5790291813947477,-487707100.0,-61.632312442627054,89.02914134005623,91.58768807638091,-40.14437846205791,18.09707137071592,30.362429421525903,-0.0751038260732219,8.958728478818008,309.5102777099609,306.0398593139648,303.23500061035156,300.4301419067383,296.9597235107422,0.02,0.0,313.65972256592886,-0.013429145289596045,-0.0015948749703576066,294.34232003348217,297.05467224121094,6.296822100199241
2022-02-16,0,298.10499572753906,290.04249572753906,311.77249908447266,299.6012439727783,306.03812980651855,-0.6517913561354591,5.8078671750507604,-0.07461931287670875,2.995547277521534,303.28500747680664,4.421502685546875,0.019193453867324364,293.84125061035155,309.71300506591797,0.593256108596495,-0.02277714861251327,0.9851575992809168,0.9823308470375699,0.9889757897050252,-0.03868107966979906,45.24832782172899,314.21198488415916,302.5962505340576,290.98051618395607,301.15357208251953,5.083169828617908,303.8594660077776,5.03900557676414,300.9724534364491,301.76032801883787,-1.3679909254086697,-0.6574196301023455,29982100,5.238595569614552,0.6527373534464534,-517689200.0,-65.7130935491947,89.02914134005623,91.58768807638091,-53.42385064156138,17.023349780022354,31.31712306288395,-0.011827209804340688,8.829853555752665,309.5102777099609,306.0398593139648,303.23500061035156,300.4301419067383,296.9597235107422,0.02,0.0,313.42519556436133,-0.035637541750193846,-0.014580780627164702,294.2264142717634,297.07415771484375,6.302620550375735
2022-02-17,0,293.47249603271484,290.04249572753906,311.77249908447266,299.4774990081787,305.578125,-0.47084469155762304,5.811772661422417,-0.2441468546917287,2.995546724996117,302.8425064086914,4.490265350341798,0.019233222813211142,293.84125061035155,309.71300506591797,0.5885904917193919,-0.025370701539109,0.9712048689056894,0.9714407578131653,0.9814181741372933,-0.03482045969422254,43.8543745593085,313.7971705059503,302.17362518310546,290.5500798602606,299.81678553989957,5.754870658795995,303.1892863682338,5.755818116798753,300.22267029796194,301.16954953343276,-1.847129106716894,-1.2676672605785244,32461600,5.244008391071702,0.7089711110696145,-550150800.0,-97.09390474431805,89.02914134005623,91.58768807638091,-112.70302293365059,15.698066265321836,31.894749046148352,-0.0044480635587495175,8.878612578328962,309.19167626953123,305.52415698242186,302.55999755859375,299.59583813476564,295.92831884765627,0.04,0.0,313.09111748898994,-0.036539650092417886,-0.0638761650043565,292.3806631905692,295.8931579589844,6.710571237468168
2022-02-18,0,290.28749084472656,290.04249572753906,311.77249908447266,298.915002822876,304.41562843322754,-0.27121577950171855,6.041269215665956,-0.6059512510419389,2.9955312013768043,302.3812484741211,4.778951873779294,0.02003378904433067,293.1684959411621,309.71300506591797,0.6047017597634448,-0.020484954080394382,0.9626385029673352,0.9647331816722217,0.977690294244252,-0.02973917204731269,40.638347236463865,313.6365381414149,301.553999710083,289.4714612787511,296.9864273071289,4.613345005760338,301.8048210144043,6.3748600678034135,298.48406978442483,299.8550833635626,-3.090019397602582,-3.098022028117223,34264000,5.160653321071785,0.768235704687092,-584414800.0,-94.37696891888743,89.02914134005623,91.58768807638091,-134.12994660221224,14.71744031067406,32.95542568900001,0.032085378809700145,8.782071906911156,308.32083569335936,304.11457604980467,300.7149963378906,297.3154166259766,293.1091569824219,0.06,0.0,312.6977582222904,-0.022080764759906835,-0.04581874110606525,289.21558925083707,294.326668875558,7.19252435913403
2022-02-22,0,287.19000244140625,290.04249572753906,311.77249908447266,297.1337471008301,304.41562843322754,-0.25860693862288037,6.514400518349061,-0.887114571314882,2.9954977353901087,302.3812484741211,5.338302001953127,0.021636210116175426,290.4179946899414,309.71300506591797,0.6087766599634548,-0.0004992701398733956,0.9538411429547677,0.9587221140701188,0.9730900281336706,-0.023893680749540458,39.68863436916557,314.1166756399696,301.0878746032715,288.0590735665733,294.57642691476,4.707714160957465,300.2660707746233,7.129335413751782,296.4107117321551,298.65607339774914,-6.389070534306356,-6.259086960535456,41736100,4.77886667753215,0.9843158642606771,-626150900.0,-89.48399172377502,89.02914134005623,91.58768807638091,-147.2388549178641,13.848722813832795,32.527763831021836,-0.06443592789438188,8.655645869473005,307.8936762695312,303.42315698242186,299.80999755859375,296.19683813476564,291.7263188476563,0.08,0.0,312.2072512567926,-0.022661137481168714,-0.022793935737936036,287.253165108817,292.9003710065569,7.652284932557177
2022-02-23,0,285.5625,287.19000244140625,311.77249908447266,297.1337471008301,304.41562843322754,-0.38817176797762204,6.811153841188712,-0.7050757277010016,2.9954753236348437,302.3812484741211,5.532851562500002,0.02263400138366174,290.2629913330078,309.71300506591797,0.5955788938066193,-0.00983474259169386,0.9489467087112338,0.9585770531803829,0.972207102881563,-0.04677458763577369,36.73591375734883,314.54805765185984,300.9257499694824,287.303442287105,292.63035474504744,5.267462105918525,298.39392798287525,7.314289202334393,294.11247070409684,297.62755962045736,-5.548247865138322,-6.977724389995035,37811200,4.828255438053827,0.9301818692618106,-663962100.0,-99.46596612672039,89.02914134005623,91.58768807638091,-179.5231280273264,12.535721021531776,33.04004275052844,-0.0833415742416529,8.869081523312387,304.4181158447266,299.7709378051758,296.01499938964844,292.2590609741211,287.6118829345703,0.1,0.0,311.7106894979447,-0.06529934386184022,-0.0479675307404799,285.2732413155692,290.6253923688616,8.403365010924885
2022-02-24,1,283.4449996948242,285.5625,311.77249908447266,297.1337471008301,304.41562843322754,-0.5416640743959176,7.226399662386796,-0.4975236393665119,2.9954421865699654,302.3812484741211,5.8016513061523485,0.024031784510686903,289.97774200439454,309.71300506591797,0.7398836210323292,-0.05304127861578013,0.9426117391143446,0.9570162326057265,0.9742939384706535,-0.049177290695637144,30.17621936806413,315.15454950787904,300.70175018310545,286.24895085833185,291.09106881277904,6.214699046559722,296.8198209490095,8.009696014982474,292.01735507339924,296.69655162032007,-4.55320452287667,-8.40677069383571,56989700,3.9732361610660965,1.4621255784938385,-720951800.0,-42.91015779874712,89.02914134005623,91.58768807638091,-125.26333268832775,10.376567517902648,33.600584856452336,0.04347730095300127,9.93868641208497,302.39323181152344,296.49337127685544,291.72499084472656,286.9566104125977,281.0567498779297,0.12000000000000001,0.0,311.0737973918641,-0.016393941002968315,-0.017542115500906553,285.301034109933,290.2032732282366,8.441237230782042
2022-02-25,0,295.43250274658203,283.4449996948242,311.77249908447266,294.03312492370605,304.41562843322754,-0.520397221532418,8.139646967504829,-0.7412269766823578,2.9953618558477872,302.3812484741211,6.712264060974121,0.027150607621493184,287.0272521972656,309.71300506591797,0.7774931916237559,-0.06123055888763422,0.985444699595738,1.0065491866889344,1.0258375854864457,0.006678672585551881,28.207761867682596,316.07541934699697,299.7961254119873,283.51683147697764,290.49928392682756,5.418401547366914,296.22714287894115,7.7622081883965635,289.89512386984455,295.1351933987578,-3.6622260489341305,-7.213997072242543,32546700,3.972041301599386,0.8580599840788029,-688405100.0,-36.17914821150092,89.02914134005623,91.58768807638091,-38.40731590617183,11.762706966284158,32.0946513808312,0.12474595459520905,9.652309435338308,302.39323181152344,296.49337127685544,291.72499084472656,286.9566104125977,281.0567498779297,0.12000000000000001,0.0,310.84750793041195,0.022632689085526403,-0.0073122128415838185,284.94590541294644,289.6441127232143,8.454801184642804
2022-02-28,0,296.3100051879883,283.4449996948242,311.77249908447266,294.03312492370605,304.41562843322754,-0.4023941748041882,8.177535347890759,-0.8524265192049181,2.9953579821190175,301.20249938964844,6.834013824462891,0.02730659033061753,287.0272521972656,309.71300506591797,0.8174259488597229,-0.024508454443506533,0.9894443225633415,1.0125150774053204,1.0274859902385782,0.020746723621250185,47.00344605429912,315.8261964892385,299.471125793457,283.11605509767554,290.24285670689176,5.026791506793091,295.69821439470564,7.459101179013884,291.3009349895527,295.3995601790378,-1.3827903676406808,-2.7318648463026007,34627500,4.908121487906858,0.9314789028199378,-653777600.0,-32.51666156907613,89.02914134005623,91.58768807638091,-21.421960869210313,12.368520671441553,30.57921605501778,0.10373936569553269,9.398456134599215,302.39323181152344,296.49337127685544,291.72499084472656,286.9566104125977,281.0567498779297,0.02,1.0,310.6359405481885,0.037717561119196,0.02772329856650376,284.8466360909598,289.5365251813616,8.240295366148933
2022-03-01,0,295.8675003051758,283.4449996948242,311.77249908447266,294.03312492370605,304.41562843322754,-0.29020048848898267,8.1665226282636,-0.8973234436887974,2.99535855563746,299.38000106811523,6.8269885635376,0.027299648420069222,287.0272521972656,309.71300506591797,0.7999165941537179,-0.043142701457020434,0.9890474936421506,1.0119971994516586,1.021684248820186,0.03021518085588637,45.98102087616004,315.47692076006723,299.14387550354,282.8108302470128,290.58500017438615,5.354101348234126,295.20089285714283,7.173670549050265,292.5753031328758,295.82383001462847,-0.6021336660829932,-2.438140586592327,31217800,4.619949901969404,0.8573157918152153,-684995400.0,-42.019250012271975,89.02914134005623,91.58768807638091,-28.922287885788162,11.61621909034966,29.380402484388323,0.05967703698119685,9.284469313312744,302.39323181152344,296.49337127685544,291.72499084472656,286.9566104125977,281.0567498779297,0.04,0.0,310.4332099568407,0.02512867520354156,0.024381075612946376,285.43664986746654,288.90865652901783,7.8484346785235735
2022-03-02,0,297.6800003051758,283.4449996948242,311.77249908447266,294.03312492370605,303.81249809265137,-0.1901511300530086,7.823846861748194,-0.7801443420013832,2.9953880118825635,298.6450004577637,6.464500808715821,0.026214603957055816,287.0272521972656,308.86925506591797,0.7849349730652988,-0.04167039508812629,0.9974074712644331,1.0176232996695287,1.0218193818337218,0.042433794021188964,45.724538571536044,314.1014439523783,298.45375022888186,282.8060565053854,291.64107295445035,5.978320479311074,294.31375013078963,5.831904646116662,293.3787972210147,295.971937906594,0.8160915604827086,-2.2991452246409865,31873000,4.619950631095024,0.8863570317203636,-653122400.0,-23.74997666541945,89.02914134005623,91.58768807638091,5.606748728506874,12.086057512144578,27.585064779721872,0.0719258488192109,9.175187825768989,300.2463936767578,294.7567927856445,290.3199920654297,285.88319134521487,280.39359045410157,0.06,0.0,310.26956762638724,0.07107416188066362,0.04334066535256768,287.1507568359375,288.1831730433873,7.528074342747813
2022-03-03,0,298.9975051879883,283.4449996948242,311.77249908447266,294.03312492370605,303.71875190734863,-0.12753563573542503,7.460192937604534,-0.5655477321692861,2.99541829587574,297.8924980163574,5.954375076293945,0.025042513480776178,287.0272521972656,305.9442481994629,0.7301414785793594,-0.04520122467722404,1.0036803494244377,1.0227897794558671,1.0178742370495129,0.054869570851166616,47.311495178844105,312.82151082943267,297.90112495422363,282.9807390790146,293.3278590611049,6.175627220877132,293.95214298793246,5.315158953070789,294.4534637276578,296.3733725341572,2.5466166106356396,-4.005159055162589,27314500,4.575891876136556,0.7695639832391729,-625807900.0,-25.541623828468403,89.02914134005623,91.58768807638091,6.1617971262614395,12.528509875341706,25.615197088413346,0.02609077667301561,9.16832552363473,296.5562839355469,291.7718610839844,287.9049987792969,284.03813647460936,279.25371362304685,0.08,0.0,310.1241290228025,0.004514667907498104,0.05583894597677018,288.29722377232144,287.7751944405692,6.6908092139899455
2022-03-04,0,291.74500274658203,283.4449996948242,310.0999984741211,294.03312492370605,303.0512523651123,-0.31908732446314814,6.759129304979224,-0.4484121323306942,2.9954730844481428,297.8924980163574,5.357387886047365,0.022737924027825655,287.0272521972656,304.202254486084,0.7586547564621017,-0.021228689106014,0.9814393849608355,0.9976763317456712,0.9827779323321857,-0.012481700441616894,51.52851425869386,310.7806338693578,297.2623752593994,283.74411664944097,294.21107373918807,5.253163888218618,293.42071424211775,5.120071221914721,295.58696684488586,296.76068837425584,4.111390593755453,-1.6649674122284042,32356500,4.402438176478716,0.9264619983507422,-658164400.0,-41.98042666661518,89.02914134005623,91.58768807638091,-73.10847255594695,11.66409882509112,29.272862189948718,0.05782028984854362,9.138182485205816,295.6700411376953,291.0549788208008,287.3249969482422,283.5950150756836,278.97995275878907,0.08,0.0,309.8641505339623,-0.02505795436584657,-0.016056221862712265,289.6380310058594,287.4556361607143,6.8067449616166815
2022-03-07,0,283.91500091552734,283.4449996948242,310.0999984741211,293.04062271118164,300.3887481689453,-0.15774376799555148,6.584647367178281,-0.39503813292689127,2.995485462661487,296.99500274658203,5.222250366210938,0.022202263357348574,287.0272521972656,303.762996673584,0.7148657566102422,-0.03945936571805758,0.9573110403525925,0.9714740801260189,0.9587835954415425,-0.041831203993929145,42.3089860607508,309.74479522263783,296.57550048828125,283.40620575392467,294.27821677071705,5.093191418837575,292.68464279174805,5.703785455424934,294.6472740426045,296.2695180479357,2.1650261314360364,-2.4867564591786406,43157200,4.659053032472227,1.2216202889308105,-701321600.0,-76.62128776198425,89.02914134005623,91.58768807638091,-158.4959516776178,10.640372765089705,33.396614216758174,-0.017255889771619792,9.296016939095404,295.6700411376953,291.0549788208008,287.3249969482422,283.5950150756836,278.97995275878907,0.02,1.0,309.3772058855035,-0.06653506739635906,-0.06188833012031791,287.4457571847098,286.37339564732144,7.485903930035307
2022-03-08,1,276.9024963378906,283.4449996948242,310.0999984741211,291.38062477111816,299.28250312805176,-0.06551955900250311,6.9160008868380505,-0.5163734173338379,2.995458345747954,296.08875274658203,5.499276008605955,0.02339769175961902,285.3977500915527,303.74950408935547,0.6427105131310321,-0.06519270629741618,0.9367956081545704,0.949549814852489,0.942996701937591,-0.06409965253947625,34.651307833116945,309.4167525213567,295.5847507476807,281.75274897400465,291.6310729980469,8.237872766951348,291.06517846243725,6.72431323959249,291.9677651401771,294.4494841101279,0.16581743237988308,-3.502481225756537,48159500,4.923967935494745,1.3263738377755796,-749481100.0,-82.34227213606434,89.02914134005623,91.58768807638091,-187.8238904862148,9.530464519528268,36.286714692979466,0.0013740161765573836,9.631679796532646,295.31132373046876,290.4743430175781,286.56500244140625,282.6556618652344,277.81868115234374,0.04,0.0,308.74187564068166,-0.06475671301736452,-0.07677622488551594,284.44537353515625,284.69563947405135,8.47477702423888
2022-03-09,1,285.5800018310547,276.9024963378906,310.0999984741211,289.5131187438965,299.0443801879883,-0.278736608761766,7.757581612472109,-0.1823343573431888,2.9953837659543003,295.6500015258789,6.145713806152344,0.02636444008123242,283.86800079345704,302.95300216674804,0.6244027460166822,-0.0856173606855133,0.9705546422570951,0.9827735892465904,0.9852750432937235,-0.040647670188512564,29.63533680463782,309.7592885911552,294.24412536621094,278.72896214126666,290.0982153756278,8.220409303906777,290.17053604125977,6.5464952206429885,288.2052745643457,291.8810690741641,-6.2721624182922735,-7.56822192817003,35204500,5.1006119790439906,0.9658746866452793,-714276600.0,-44.1593804002196,89.02914134005623,91.58768807638091,-74.59701521568157,12.667358048555828,32.671743994632685,0.008996669628053684,9.92791213609454,295.31132373046876,290.4743430175781,286.56500244140625,282.6556618652344,277.81868115234374,0.04,0.0,308.4282113554975,-0.03894207312607845,-0.02186833602337167,283.0066920689174,283.92666407993863,8.220437332777294
2022-03-10,1,283.94749450683594,276.9024963378906,310.0999984741211,286.78750228881836,298.32812309265137,-0.08646403218452711,7.713861181166659,-0.22891190805454187,2.9953862421863953,294.8262519836426,6.242550811767581,0.026292925371648283,283.86800079345704,300.0234977722168,0.6250209267291309,-0.07907125689687058,0.9678434842413907,0.9771497157166905,0.9878908565624305,-0.05033490387048534,39.2494604716355,308.8093477285442,293.3816253662109,277.95390300387766,288.39535740443637,8.059150249454223,289.4901787894113,6.670709211820751,287.5628183281086,290.82062067473873,-3.6212085886624537,-4.201537738714022,30628000,5.23395784832122,0.841071000721534,-744904600.0,-52.94296999642595,89.02914134005623,91.58768807638091,-87.29735169293804,11.930116633581996,30.917224112241946,0.0076166765632214185,9.783555657249032,295.31132373046876,290.4743430175781,286.56500244140625,282.6556618652344,277.81868115234374,0.04,0.0,308.1379064654065,-0.03490792490685013,-0.04863562617579256,281.6980460030692,283.56734793526783,7.312051810116088
2022-03-11,1,284.2425003051758,276.9024963378906,304.0600051879883,285.575626373291,297.7862491607666,-0.36894276090955125,6.947568779633536,-0.7869010210511167,2.9954484750570547,293.846248626709,6.009101219177245,0.02378701553592913,283.86800079345704,299.2240043640137,0.622931905839211,-0.06614651824634935,0.9731865901854654,0.9779958017162454,0.9993829540927287,-0.025715958699464414,39.12013067780795,305.9691377271138,292.0740001678467,278.1788626085796,286.47571454729353,7.011251004153171,289.0583937508719,6.809331744801957,286.6483432974836,289.38820416710195,-4.028832428720567,-3.2456198296746375,27209300,5.114628534395167,0.7663160373147212,-717695300.0,-69.6045703589891,89.02914134005623,91.58768807638091,-92.00495284183981,13.181521459410751,28.633137099808835,0.01276959374812541,9.804859623479896,295.31132373046876,290.4743430175781,286.56500244140625,282.6556618652344,277.81868115234374,0.04,0.0,307.87256149429203,-0.03377515588326607,-0.053561929931043785,278.88500540597096,283.01788112095426,7.371135680783496
2022-03-14,1,279.5,276.9024963378906,299.5749969482422,285.23250007629395,296.65250396728516,-0.3685480955850941,6.5704095676065455,-1.0454047307992897,2.995476770301705,292.60874938964844,5.867563743591307,0.022572279204878927,283.86800079345704,299.0162551879883,0.6484414601003058,-0.04994403002725223,0.9602068140269483,0.9653951575276625,0.987920511124118,-0.015550432000037029,40.63029031809495,304.22394405891913,291.08312492370607,277.942305788493,283.6903566632952,4.699355747718566,288.50910786220004,7.26646131063534,286.0478115967935,288.2842443907866,-4.514075512706307,-2.082415098893882,30660700,5.041350822558784,0.8740001855711451,-748356000.0,-80.56142018636629,89.02914134005623,91.58768807638091,-120.20690323906024,12.254884361601436,29.26929600246565,0.02162345346065779,9.788707040325841,295.31132373046876,290.4743430175781,286.56500244140625,282.6556618652344,277.81868115234374,0.04,0.0,307.5357153202142,-0.008855760917821365,-0.04629820676959699,276.1614510672433,282.2293374197824,7.949200616598359
2022-03-15,1,283.5125045776367,276.9024963378906,299.5749969482422,284.1687488555908,295.9781265258789,-0.23734206298605473,6.75484635443609,-1.187620861335287,2.9954606422001686,291.0162467956543,6.06048759460449,0.023284634806848482,283.0504997253418,298.19424667358396,0.659309411992929,-0.050030593296277015,0.9772961198339998,0.9849733203416324,1.0052405148618415,0.02387124828112852,37.31651368664427,303.60856737317886,290.09887466430666,276.58918195543447,282.514285496303,3.1084822333480173,288.3626796177455,7.350574802146566,284.41816190764945,287.0125216388888,-6.520959155070422,-2.6776706626391698,34245100,5.031880250390605,0.9791261885397824,-714110900.0,-48.23425484799245,89.02914134005623,91.58768807638091,-55.01255275706195,12.998350931025305,26.854280645091197,0.04526922881683984,9.902963782397755,295.31132373046876,290.4743430175781,286.56500244140625,282.6556618652344,277.81868115234374,0.04,0.0,307.2380268218699,0.04096404418454824,0.02954350084682634,275.7825491768973,282.71029009137834,7.89928336091732
2022-03-16,1,290.3175048828125,276.9024963378906,299.5749969482422,283.9393711090088,295.9781265258789,-0.04969479502923857,6.8308968958967995,-1.2828757083993243,2.995453868564963,288.7387466430664,6.183749771118164,0.023590324401578093,283.0504997253418,298.19424667358396,0.669559426576518,-0.05361760004751197,1.002603936791399,1.012963102008873,1.0245662429930997,0.016589057431831256,41.26821212621444,303.2252936239469,289.5634998321533,275.90170604035967,283.4289289202009,4.302096227972893,288.853572845459,7.225310473626239,284.20973307911106,286.7710166999673,-2.8218129158826737,-0.7178797714557343,37826300,4.954135752985373,1.065122580625178,-676284600.0,-26.380890269379996,89.02914134005623,91.58768807638091,20.021034838445754,16.779230033098173,24.664584114822997,0.06470855719492469,10.008258855007567,295.31132373046876,290.4743430175781,286.56500244140625,282.6556618652344,277.81868115234374,0.04,0.0,307.0048962438291,0.020416291572494583,0.0672105313311873,277.94686453683033,282.6963108607701,7.624434195804369
2022-03-17,1,293.37249755859375,276.9024963378906,298.9975051879883,283.9393711090088,295.54125213623047,-0.031139077979800173,6.4392407906186415,-1.157565687839187,2.9954841270758266,288.7387466430664,5.72087516784668,0.022273354772306964,283.0504997253418,297.7224998474121,0.6342525355553787,-0.02612331546380439,1.0147764202389042,1.026258793979673,1.0318971828635743,0.033192767092829145,50.23007916241773,301.97910681011905,289.1006252288818,276.2221436476446,285.7817862374442,4.629198344139254,288.7064296177455,7.1009300302600185,285.6968316922134,287.4493264035033,2.2550777333495247,2.4246344777250184,30816600,5.235808804571384,0.8667233483400079,-645468000.0,-23.87564894749835,89.02914134005623,91.58768807638091,57.54599691887827,16.7740397516436,23.530588161194995,0.07645681688155441,9.737887665282335,295.31132373046876,290.4743430175781,286.56500244140625,282.6556618652344,277.81868115234374,0.02,1.0,306.8502417587535,0.03371958840463951,0.02329314543119356,280.65504237583707,282.55020795549666,7.387745420057224
2022-03-18,1,297.3824996948242,276.9024963378906,298.9975051879883,283.9393711090088,293.96249771118164,-0.05805179100816694,6.185979378278172,-1.067557250139657,2.9955028465932383,288.7387466430664,5.484250259399414,0.02141485048817476,283.0504997253418,296.447004699707,0.638396486254093,-0.00034074223469972607,1.0294896538334308,1.0423373681469343,1.0391122585867631,0.046228130471483775,54.88718985759484,301.2359590769909,288.86400032043457,276.4920415638782,287.46785736083984,6.366747584099607,288.7830363682338,7.194438904947742,287.57514443985883,288.1698898574196,5.947942484637475,-0.6972845468378697,43390600,5.190702347129189,1.2018977478647843,-602077400.0,-8.149748895545706,89.02914134005623,91.58768807638091,107.04556174660564,19.75461394012389,22.08157145997605,0.16241584942746243,9.632600532828892,295.31132373046876,290.4743430175781,286.56500244140625,282.6556618652344,277.81868115234374,0.04,0.0,306.7116581589329,0.07269644868557679,0.05196258767932615,282.3230242047991,282.66485813685824,7.794762946831142
2022-03-21,1,298.2725067138672,276.9024963378906,298.9975051879883,283.9393711090088,295.54125213623047,-0.04475730473402635,6.387053349546807,-1.1551394096877299,2.995488040050785,288.7387466430664,5.679750442504883,0.022095981410126968,283.0504997253418,297.41224975585936,0.6392639927707672,0.02444131791367043,1.031872352212185,1.0433951655888647,1.0327387422732492,0.06716460362743182,59.869004346279645,301.8336072026337,289.05950050354005,276.2853938044464,289.51428767613004,7.282916112021885,288.9548225402832,7.402321030821527,290.00170511054654,289.46153871211817,4.132816649658729,0.3619501495251615,28351200,5.207339873880929,0.7917980455844116,-573726200.0,-11.98309880951065,89.02914134005623,91.58768807638091,94.61340271875666,18.9157917353515,21.14394177442321,0.2158520063582074,9.338423171912792,295.31132373046876,290.4743430175781,286.56500244140625,282.6556618652344,277.81868115234374,0.04,0.0,306.6235787320426,0.08218773243551691,0.06816170927499504,284.2202802385603,282.9591631208147,8.06324452091877
2022-03-22,0,301.9074935913086,276.9024963378906,298.9975051879883,283.9393711090088,295.9781265258789,-0.08797040884492249,6.693551034507392,-1.2915103437821072,2.9954646830449825,288.7537536621094,6.079001235961914,0.023124369204645404,283.0504997253418,297.73925094604493,0.6697320865799508,0.03858945011403048,1.0430069646833326,1.0508330679382467,1.0319101170827152,0.06488246097319705,61.80770194650427,302.8458533660119,289.4587512969971,276.0716492279823,292.03785814557756,8.159515487454778,289.25678634643555,7.857838060117412,292.0523554634061,290.7498601145122,5.044951085731936,0.812866031656311,27599700,5.143182401910514,0.7863323692109924,-546126500.0,-2.685721261160714,89.02914134005623,91.58768807638091,126.39009166033144,21.810954840906792,20.108037741863736,0.2527181582990725,9.115595859441978,296.74,291.63,287.5,283.37,278.26,0.06,0.0,306.5841612387442,0.05888936777724241,0.09991323535350277,287.5744062151228,283.2297058105469,8.598761275275404
2022-03-23,0,300.2375030517578,276.9024963378906,301.9074935913086,283.9393711090088,296.57812881469727,-0.11814960165539577,7.193977498867239,-1.2862647243188225,2.9954246427365683,291.03125381469727,6.514413452148437,0.024790181684737348,283.0504997253418,298.3450065612793,0.6723539585417386,0.0572378851960905,1.034607385190866,1.0360037151806722,1.01345821376472,0.03416947997314024,65.69240866501909,304.58258085222667,290.1946258544922,275.8066708567577,295.00035858154297,6.429976487998112,289.3453576224191,7.9820845279468,294.51252124255876,292.544835945031,6.214761433341906,1.420146896599996,25715400,5.158344618476305,0.7454929758346913,-571841900.0,-15.742885044642858,89.02914134005623,91.58768807638091,91.8338369867595,20.699532835105085,19.927308025844425,0.2970233167789276,8.916677365452259,296.74,291.63,287.5,283.37,278.26,0.06,0.0,306.52578897610954,0.01732387884141695,0.04297431149482991,290.7970973423549,283.4792742047991,8.429999237962683
2022-03-24,0,301.4400100708008,276.9024963378906,301.9074935913086,283.9393711090088,297.4568748474121,-0.26892050362956654,7.428664926563893,-1.2857045412017059,2.995405464647507,292.5587501525879,6.699288101196288,0.025534342949011985,283.0504997253418,299.1215049743652,0.700739361181707,0.05924430974267855,1.036131346855849,1.034918754950855,1.0107482868260327,0.02749921202343031,63.81072554486813,305.7857058602079,290.9283760070801,276.0710461539523,297.56143079485213,4.3137816227529315,290.03785814557756,8.602711012000464,295.97415054299205,293.79078545414654,7.419500197408878,0.41471846495505343,24484500,5.14570047109841,0.7449064063867635,-547357400.0,-2.5714111328125,89.02914134005623,91.58768807638091,100.74526205023601,20.49598331298414,18.962220148713907,0.26517744440791946,8.699100438336222,296.74,291.63,287.5,283.37,278.26,0.06,0.0,306.4888190220519,0.03007922149910347,0.03298331800129541,293.1669355119978,284.4747423444475,8.833441938985601
2022-03-25,0,303.4250030517578,276.9024963378906,301.9074935913086,284.1687488555908,297.82812690734863,-0.4312475549295447,7.556466639774097,-1.1395056809597612,2.9953957169373195,294.4025001525879,6.679063262939451,0.025893551556292502,283.111254119873,300.3577537536621,0.789381804537705,0.020334618799109954,1.0397387210887998,1.035514825632046,1.0119293788717527,0.020318960810183695,62.05300017556235,306.94105980542713,291.82812652587893,276.7151932463307,299.43393053327287,3.3915458971032124,291.4314297267369,9.10039712312689,297.40336218977643,294.9082510873666,6.323356184896182,3.323109987470842,22566500,4.435349795996901,0.6971376777791439,-524790900.0,-5.126781194982395,89.02914134005623,91.58768807638091,98.4828144559914,20.518840963764177,17.972257394143007,0.23879856873853303,8.520795760831184,297.122,291.939,287.75,283.561,278.378,0.08,0.0,306.46012800341686,0.010817651501092485,0.02865647925479148,294.4657897949219,286.20632716587613,9.120223381794045
2022-03-28,0,307.5399932861328,276.9024963378906,303.4250030517578,284.1687488555908,298.45375633239746,-0.3719169327270747,7.938216977760421,-1.1870971430762616,2.9953619929160253,294.61999893188477,7.038725776672362,0.027164487068378023,283.111254119873,301.48675842285155,0.7933489068349446,0.024012006814469716,1.0523983148904992,1.0427320124321129,1.021535791186221,0.031070535713692005,63.981099082831925,308.1041854966585,292.2277515411377,276.3513175856169,301.45785849434986,3.3987447275507283,293.61982236589705,9.021227117227292,298.9490834062274,295.726144743481,4.514883859392561,6.871775733341839,29578200,4.449597957338277,0.9209298719664559,-495212700.0,-0.2858080096037075,89.02914134005623,91.58768807638091,136.78907279002814,23.784092923023376,16.88388990778382,0.23753788072750895,8.420471498186554,302.54471240234375,297.43763525390625,293.30999755859375,289.18235986328125,284.07528271484375,0.1,0.0,306.4819603702694,0.03857479049896462,0.03418429770010865,296.6300964355469,288.642569405692,9.86711518321754
2022-03-29,0,313.54750061035156,276.9024963378906,307.5399932861328,284.1687488555908,299.30750465393066,-0.21238347938449625,8.578461681752152,-1.1358047651533765,2.9953020492485245,294.61999893188477,7.544075241088865,0.029299100475969956,283.111254119873,302.0592445373535,0.788476284735673,0.03945175786092528,1.0708982641857023,1.0530889670792944,1.0351176916528535,0.038554879445291235,68.24794419286827,309.9461743095492,292.78925094604494,275.6323275825407,303.7671443394252,5.188610663215541,295.61750085013256,10.132114133253276,301.0963335967924,296.8435856982879,4.829183323399107,11.064362854590065,30393400,4.5213547735540125,0.9475275306388299,-464819300.0,-1.0250091552734375,89.02914134005623,91.58768807638091,154.25156803111167,26.725004116476843,15.8980386665627,0.2932952954400521,8.30228993240623,306.38000732421875,300.5400073242188,295.82000732421875,291.1000073242187,285.26000732421875,0.12000000000000001,0.0,306.5536806705971,0.03732819040749025,0.054318924376166484,298.7244960239955,290.5237601143973,10.997730355688262
2022-03-30,0,313.7874984741211,276.9024963378906,313.54750061035156,284.1687488555908,300.53812980651855,0.06821228389191199,9.689169948904151,-0.8765649475699484,2.995188203656983,295.377498626709,8.369750595092773,0.032993028534903435,283.111254119873,303.8365020751953,0.7764630565765172,0.05330388433522147,1.0684919292001427,1.043369897075788,1.0280092793280842,0.04513092230195981,72.74033287892067,313.051590859112,293.6732509613037,274.2949110634954,305.9835717337472,5.735251887450439,297.74892970493863,10.615425998337356,304.2052011786707,298.6074106301725,5.435760655760164,9.793227326835748,28163600,4.674312600968154,0.8831188296784696,-436655700.0,-5.2081400477573805,89.02914134005623,91.58768807638091,138.68874562821992,25.79859433169718,15.277910326966254,0.26341316729739916,8.020767708625252,306.4793310546875,300.6203503417969,295.885009765625,291.1496691894531,285.2906884765625,0.14,0.0,306.62233661655205,0.04798142967358254,0.032230319176374346,300.77974591936385,292.50001307896207,11.75066945047921
2022-03-31,0,311.3100051879883,276.9024963378906,313.7874984741211,284.1687488555908,301.55688095092773,0.16141046452319918,10.614039343751458,-0.9651680902252036,2.9950836828551872,295.377498626709,9.17512550354004,0.036043496577731544,283.111254119873,308.1407440185547,0.8180417594775427,0.04946527321970102,1.0571565398626992,1.0271164362583418,1.010917440858071,0.03274281710271065,72.6787674178959,315.70670455725394,294.478625869751,273.25054718224806,307.32678767613004,5.722551326682881,299.68232291085377,10.429549373424136,306.57983517098984,300.02754963072107,5.201616445037436,10.5089865360889,33422100,4.674652597961196,1.038068022727354,-470077800.0,-19.038160276201918,89.02914134005623,91.58768807638091,103.0626645010297,24.117800542960925,17.59846080168581,0.23997106779098665,7.9655952760611655,306.4793310546875,300.6203503417969,295.885009765625,291.1496691894531,285.2906884765625,0.14,0.0,306.6648773286013,0.013844268868488108,0.02945014716952451,301.3739536830357,294.47417994907926,12.110124798454002
2022-04-01,0,308.61500549316406,276.9024963378906,313.7874984741211,284.1687488555908,302.2868709564209,0.13877825773866218,11.199222741920911,-1.1531647923611432,2.9950130684829315,295.377498626709,9.790750503540039,0.037951341677829015,283.111254119873,311.5337547302246,0.8695579220345689,0.06706199680273861,1.0458184277855718,1.0122341345198091,0.99578282720042,0.017104728974892458,71.19855403929179,317.4926963535928,295.09425086975097,272.6958053859091,308.52357373918807,4.793416189816636,301.7619661603655,8.883863232461184,307.73763616565816,300.9489947999164,3.11436840630655,9.52268040625578,27110500,4.35346427822174,0.8489502380602331,-497188300.0,-17.54432714973865,89.02914134005623,91.58768807638091,80.26626825379354,23.092054205216318,19.027490211668393,0.28981608968785577,7.7240029099780045,307.1660919189453,301.73197174072266,297.3400115966797,292.9480514526367,287.51393127441406,0.14,0.0,306.6800655765883,0.01890154175900638,0.017494238091483223,302.76229422433033,296.7796957833426,12.399154395241734
2022-04-04,0,312.4699935913086,276.9024963378906,313.7874984741211,284.1687488555908,304.45375061035156,-0.01136819682051535,11.545161959508585,-1.29980184296104,2.994970859443522,297.8275032043457,10.214975814819336,0.0390121298152069,283.111254119873,311.5337547302246,0.8815633294504621,0.08699788492326145,1.0558639191112626,1.0211162332941708,1.0048559074414496,0.016030436407628246,69.50876412118562,319.02807492609725,295.93775100708007,272.8474270880629,310.0992856706892,3.783259427627015,303.83035823277066,7.584005942770371,307.93009458405515,301.5812262352204,2.7902918044059457,10.416817707751006,24289600,3.934270897049413,0.783768971175768,-472898700.0,-2.9923999582538165,89.02914134005623,91.58768807638091,103.18254750166918,26.553749837371196,18.005181086569284,0.4006822736328989,7.578447478365438,308.22101220703127,303.43951220703127,299.57501220703125,295.71051220703123,290.92901220703123,0.14,0.0,306.732390585847,0.013743076123897913,0.03717734813261524,304.2820608956473,298.7244982038225,12.325848378846338
2022-04-05,0,312.22249603271484,276.9024963378906,313.7874984741211,285.24562644958496,307.8087463378906,-0.1840396323534615,11.734168991006209,-1.2642955234310556,2.994951471810726,299.2550048828125,10.154900512695315,0.0394604248499481,283.111254119873,312.5777442932129,0.8295514711524974,0.12844773060484324,1.049962068094068,1.0155955065311262,1.000886356487126,-0.004225849592350284,76.76244042265546,320.83383862288156,297.36550064086913,273.8971626588567,311.3560703822545,2.407755886915235,305.3950004577637,6.800906030840759,309.04045297538346,302.86721306530944,3.6590973832296325,10.21383132881964,23156700,3.4435719925777106,0.7786218346117474,-496055400.0,-19.074507390576528,89.02914134005623,91.58768807638091,87.85269429684593,25.24452799899178,17.117442954407746,0.4074296174782127,7.401113323233302,309.6771281738281,305.79644567871094,302.6600036621094,299.5235616455078,295.6428791503906,0.14,0.0,306.77105298173154,-0.014362457947858509,0.0005791808810695065,305.28871372767856,299.8772517613002,11.456975968503103
2022-04-06,0,302.0999984741211,279.5,313.7874984741211,289.13312911987305,309.2887554168701,-0.2664943753023431,11.165650644358623,-1.2722941152597127,2.995033031617719,300.8387565612793,9.60559955596924,0.037326896769502814,283.903995513916,312.5777442932129,0.8853656900947637,0.09329257661893811,1.0099237219828148,0.979383023078743,0.969260233093313,-0.037246544418862215,74.35966852197079,321.4628019143275,299.13150062561033,276.8001993368932,310.5789282662528,4.11640021036977,306.01839338030135,5.962420757310693,309.83280319584287,304.1317817801578,2.8993961909778303,7.5451844210166925,40110400,3.0718592148084167,1.3376411329050435,-536165800.0,-70.84414876069988,89.02914134005623,91.58768807638091,8.072451266709528,21.999070265018155,26.856538590865117,0.32942363663826585,7.885373569411416,310.4700919189453,307.07997174072267,304.3400115966797,301.6000514526367,298.2099312744141,0.02,1.0,306.6977433628725,-0.045752826188617646,-0.05044240202366339,303.7228044782366,300.17645045689176,11.144564131031299
2022-04-07,0,299.5074996948242,279.5,313.7874984741211,292.60874938964844,309.2887554168701,-0.4294917585857015,10.735358474873452,-1.0082280666574308,2.9950882664629566,301.6737518310547,8.911249542236328,0.03578959838807256,283.903995513916,312.5777442932129,0.8747570460481351,0.06392908660389021,0.9984997849286892,0.9703924297685222,0.968203631016013,-0.03791238731963331,54.347066125244844,321.42821740751066,299.9575004577637,278.4867835080167,308.57321384974887,5.586775766004376,306.17017909458707,5.7488897184091,307.87075814914294,303.581477943817,-1.7688739451035853,2.9748872127266277,31411200,3.9676733643673914,1.0461654057208174,-567577000.0,-69.26367889446726,89.02914134005623,91.58768807638091,-2.926342596209501,20.534439629996626,25.39682440312601,0.314737856989555,7.843498682529228,310.9822078857422,307.9089052124023,305.4250030517578,302.9411008911133,299.86779821777344,0.04,0.0,306.6355217411927,-0.022509902981827645,-0.03979469889505754,301.75982666015625,300.2421613420759,10.591488972315664
2022-04-08,0,298.70249938964844,279.5,313.7874984741211,296.3799991607666,309.2887554168701,-0.549157937846333,10.091419508042806,-0.63218527696234,2.9951655630921343,301.6737518310547,8.027448997497562,0.033555797316837645,284.16950073242185,312.5777442932129,0.8535376223980405,0.05370414126409399,0.9932399024303199,0.9683905949237148,0.9730261959007572,-0.03211932643286586,50.34931085864194,320.9183397332487,300.73550071716306,280.55266170107745,306.4182139805385,6.12381212307701,306.20089285714283,5.704426981112737,305.76438889403255,302.9148681460274,-4.47779072969712,0.7145679393308915,24361900,4.044611862537431,0.8152506917879938,-591938900.0,-96.49210996250079,89.02914134005623,91.58768807638091,-31.930507468314076,19.556751111448854,24.25311263961548,0.3268427724188759,7.646550843190982,311.30788903808593,308.4360670776367,306.11500549316406,303.7939439086914,300.9221219482422,0.06,0.0,306.5702080158052,-0.04023663355780127,-0.03678136251032372,299.3983851841518,300.0890655517578,9.458376082987451
2022-04-11,0,288.66500091552734,279.5,313.7874984741211,298.05000495910645,309.2887554168701,-0.6447634832104626,9.376551623272421,-0.13860185029936112,2.995245082092752,301.6737518310547,7.233998107910156,0.03110395494699814,289.6370048522949,312.5777442932129,0.7750757603943524,0.06870303896117509,0.9575613236071744,0.9372841337418353,0.9464410823644777,-0.07618329172085792,50.888884869001586,320.2116039179316,301.45850067138673,282.70539742484186,303.18321337018693,8.592601466611013,305.25500052315846,7.335763763939653,303.9852624816081,302.4062939328124,-4.807393270231496,0.14416101588395538,34569300,3.8514016450435835,1.1493164138473988,-626508200.0,-99.15990415808,89.02914134005623,91.58768807638091,-141.61450418966467,17.4523307184082,31.783632807625356,0.3155514703985951,7.955761039941436,308.6458093261719,304.1271075439453,300.4750061035156,296.8229046630859,292.30420288085935,0.08,0.0,306.366138932809,-0.09432641828157962,-0.07808155620334209,296.1756896972656,298.77482169015065,8.379238586309592
2022-04-12,0,285.6324920654297,283.5125045776367,313.7874984741211,298.05000495910645,309.2887554168701,-0.33807873090872387,8.47258056632292,-0.6480937297394251,2.995337148823164,301.6737518310547,6.77667377471924,0.028062638280908336,290.15225448608396,312.5777442932129,0.6864871374362652,0.018173788650227497,0.946063745674752,0.9331566731481666,0.9513488168965533,-0.08516363908800162,36.85253513521468,318.86191184980896,301.9167507171631,284.97158958451723,299.89999716622486,10.376766451552031,304.21178545270647,8.962339923416973,300.17687771287615,300.9506762611926,-7.274101023122106,-4.386274920922492,30966700,4.498500703224514,1.0351832673557926,-657474900.0,-95.57245811796336,89.02914134005623,91.58768807638091,-172.8663898819665,15.876845391864018,32.88645727670127,0.2325766647065036,8.119828544489549,307.5814470214844,302.4042838134766,298.2200012207031,294.03571862792967,288.85855541992186,0.1,0.0,306.1565182098271,-0.09270446886676154,-0.10448609638898451,292.3504071916853,297.5563507080078,8.912969785699897
2022-04-13,0,285.0574951171875,285.6324920654297,313.7874984741211,298.05000495910645,309.2887554168701,-0.234004196256398,8.252055851669688,-0.8542473960583021,2.9953581141418737,301.6737518310547,6.681274337768554,0.027322629997800586,290.15225448608396,312.5777442932129,0.723027922052936,-0.016137548506673517,0.9438278905505545,0.9398493943597496,0.9665538014217143,-0.05641345065545744,31.197209848624027,318.5268617948921,302.0227500915527,285.51863838821333,295.98392595563615,10.008408571501011,303.0416058131627,10.318913157527525,296.5633782446018,299.1797310730672,-7.446985084541991,-4.8644858946253535,21907200,4.27738108329518,0.752352518256153,-679382100.0,-79.89283568884827,89.02914134005623,91.58768807638091,-151.17403235754915,14.851382528216426,30.762367772657104,0.2037343845029956,8.05977500678767,307.5814470214844,302.4042838134766,298.2200012207031,294.03571862792967,288.85855541992186,0.1,0.0,306.02004992522353,-0.03966614922190681,-0.07481983417391828,288.5265197753906,296.40429033551897,9.335198502997127
2022-04-14,0,283.8874969482422,285.0574951171875,313.7874984741211,298.05000495910645,309.2887554168701,-0.35897438002504667,8.692963365254922,-0.7455305664960314,2.9953157738796463,301.6737518310547,6.932749176025391,0.02880756421850066,288.36175003051756,312.5777442932129,0.7720293315682192,-0.028342815057998197,0.9407732387154807,0.9449427551329176,0.9738416449512112,-0.05215229255527043,29.240064108225074,319.1456763337813,301.7597496032715,284.37382287276165,291.9360689435686,7.841618292336868,301.64606966291154,11.514897343131631,293.69656732485856,297.48562887473446,-8.772841884451454,-5.434751329050657,28221600,4.206121797407546,0.9735441777545348,-707603700.0,-98.60775544617476,89.02914134005623,91.58768807638091,-164.9690740810793,13.676627438994464,30.07117858178533,0.1149825011918129,8.126286516533094,307.3053310546875,301.9573503417969,297.635009765625,293.3126691894531,287.9646884765625,0.12000000000000001,0.0,305.8182233848288,-0.0714736611318052,-0.06567612955484134,284.1853288922991,294.73702130998885,10.449945287244855
2022-04-18,0,280.0574951171875,283.8874969482422,313.7874984741211,298.05000495910645,309.2887554168701,-0.44579053889728804,9.369966375789765,-0.8057352582112354,2.9952462607652435,301.6737518310547,7.422450256347656,0.03109995797699226,285.57499237060546,312.5777442932129,0.8169086959958999,-0.04537927672418749,0.9295418980147755,0.9407815524177987,0.9711101953959842,-0.06241998078542721,26.109033969136195,320.0254323243335,301.2854995727539,282.5455668211743,288.7871398925781,7.498117965260895,299.68303407941545,12.71306500630229,291.2442382533876,296.12287793434587,-9.075258651927406,-6.438990164624945,20778000,4.074829237617539,0.7458570526800581,-728381700.0,-94.20369115672202,89.02914134005623,91.58768807638091,-155.27530893974233,13.162761732541878,29.835054822756646,0.054678481564932754,7.839852658358592,307.07404846191406,301.5829861450195,297.14500427246094,292.70702239990237,287.2159600830078,0.14,0.0,305.6589864799932,-0.05539265875542976,-0.06918402654730368,281.5316816057478,292.6272430419922,11.403546789303242
2022-04-19,0,282.31500244140625,280.0574951171875,313.7874984741211,295.8706302642822,309.2887554168701,-0.49212807883333676,10.431472507767749,-0.9199629611519131,2.9951257372032076,301.6737518310547,8.375325508117674,0.03472304963996319,284.940495300293,312.5777442932129,0.825817334852645,-0.061068355905002494,0.9397367281157707,0.9575510164515852,0.9917621245556433,-0.021997812183608967,22.728900647504616,321.2821943594076,300.4192493438721,279.5563043283366,286.33106885637557,6.083681622161277,297.45214135306225,12.832755630412747,288.4306105779438,294.41301441618424,-7.2964261728792525,-8.936235536487057,22297700,4.113391382318943,0.8092008734464372,-706084000.0,-81.49431396334809,89.02914134005623,91.58768807638091,-114.51692848237371,15.616259046223686,27.722295362656276,0.054464978139533535,7.834144594892747,307.07404846191406,301.5829861450195,297.14500427246094,292.70702239990237,287.2159600830078,0.14,0.0,305.50939538084344,0.0001402459080277474,-0.039296798226497474,279.2848859514509,290.52235630580356,11.870791443637653
2022-04-20,0,287.7074966430664,280.0574951171875,313.7874984741211,287.90687370300293,309.2887554168701,-0.40153035600548215,11.15064017996718,-1.2051479735293558,2.9950360252618133,301.6737518310547,9.314601135253906,0.03721577011097967,283.7302474975586,312.5777442932129,0.8722095121462585,-0.06489567687387267,0.9602368905697511,0.9859251425431171,1.0152351895302187,0.007264595713996735,25.907986848316863,321.92265449018333,299.621374130249,277.3200937703147,284.7603541782924,2.9899648908666023,295.58928407941545,12.154030382654588,286.89485074491006,293.2348878656238,-5.740256010596008,-9.961010088789779,22906700,4.043331033452893,0.8384418181764942,-683177300.0,-78.20656243702643,89.02914134005623,91.58768807638091,-76.91773491970532,18.294312487119626,26.573229164156547,-0.003088078774512003,7.588650626995865,306.45521032714845,301.0824076538086,296.74000549316406,292.3976033325195,287.0248006591797,0.14,0.0,305.3840613849221,0.015245101648382553,0.0038562705716316086,277.80147879464283,288.5999319893973,12.168698765645123
2022-04-21,0,285.68749237060547,280.0574951171875,313.7874984741211,287.1887454986572,309.2887554168701,-0.2431351184003786,11.431027222837034,-1.3995243341101022,2.994998485832425,300.8387565612793,9.926601562500002,0.03824219553458923,283.7302474975586,312.5777442932129,0.9073224421299368,-0.04173364846606576,0.9557598571015946,0.9872970899396488,1.0066330583865883,0.0022100708250416545,37.34263115852075,321.773428728511,298.9113742828369,276.0493198371628,284.33499581473217,2.5161528575247436,293.75910459245955,11.517132784751805,287.09828798376384,293.0878622566641,-3.6809209059343626,-8.311357832251426,29454600,4.284932972914469,1.0707835530065961,-712631900.0,-93.28256198340247,89.02914134005623,91.58768807638091,-81.93675015438184,16.128032819416514,28.17565219186964,-0.03382848180442598,7.992622838293937,306.43226794433593,301.0638495483398,296.72499084472656,292.3861321411133,287.0177137451172,0.14,0.0,305.2043420324076,-0.02367696704463762,-0.004431660319930344,277.1793125697545,286.67750113351,12.784851002490424
2022-04-22,0,278.07250213623047,280.0574951171875,313.7874984741211,285.6737422943115,309.2887554168701,-0.10739033076593375,11.781118287668253,-1.5515093380762772,2.994950370626383,300.4737548828125,10.646101837158199,0.0395095755499973,283.7302474975586,312.5777442932129,0.9051635693381265,-0.05225755431900177,0.9325537918610155,0.9664624358501032,0.9793664846886142,-0.02048344810716307,34.663176200906484,321.7461103241159,298.1838737487793,274.62163717344276,283.25499725341797,3.3505398450645396,291.57749720982144,11.378510355393407,286.76637031024944,292.7677599855479,-1.0314754249661149,-8.230545883647508,29405800,4.271631473377692,1.0595315884416374,-742037700.0,-98.44238149842623,89.02914134005623,91.58768807638091,-112.39110194223454,14.73442535525146,31.61893594433289,-0.12210208364919427,8.123241904132607,305.2617099609375,299.1691328125,294.2449951171875,289.320857421875,283.2282802734375,0.16,0.0,304.9603999009366,-0.020726808926777807,-0.04724974823558926,276.0566144670759,284.2035108293806,13.703905568086945
2022-04-25,0,276.47249603271484,278.07250213623047,313.7874984741211,285.48874282836914,309.2887554168701,-0.016103109088433733,12.53486694224846,-1.5968362207482745,2.9948411644833004,299.1049995422363,11.605701141357423,0.04220273693391903,282.08925170898436,312.5777442932129,0.870528618076087,-0.08355442254441618,0.9308352512467668,0.968113841317291,0.9777361591153779,-0.01280093961767581,27.20729602553083,322.08523223654765,297.01549835205077,271.9457644675539,282.02856881277904,4.073924003956463,289.0062473842076,10.311392388970662,284.6068988365296,291.3947498995865,-2.646754182107355,-9.89663587748332,35678900,4.471953166706226,1.2558922363367788,-777716600.0,-77.43761716568551,89.02914134005623,91.58768807638091,-96.134715618191,13.419534312349876,31.04985692470499,-0.07766301689095517,8.281684684947068,304.4623936767578,298.02379278564456,292.8199920654297,287.6161913452148,281.17759045410156,0.18,0.0,304.6768571306963,0.0007130783006661368,0.0031807167265539703,275.09191458565846,281.80921718052457,14.002106807204283
2022-04-26,0,274.0199966430664,276.47249603271484,313.7874984741211,284.7649955749512,309.2887554168701,0.09946210709580286,13.20429683334853,-1.5923156198357844,2.994736061683103,293.6837501525879,12.312376022338867,0.044659220832218946,279.8589958190918,312.5777442932129,0.8696850514545059,-0.10101937286742739,0.9267831295355116,0.9670537524938393,0.9715264213180365,-0.029382093500544437,24.08571395848888,322.0764666677957,295.66787300109866,269.2592793344016,280.61892591203963,4.938844388645243,286.2774974278041,8.609346488261387,282.59054548449825,289.89596797708344,-3.0116728139154354,-11.520305404325079,46518400,4.283538144064065,1.5900348011525072,-824235000.0,-99.40540210620777,89.02914134005623,91.58768807638091,-108.98683233687356,12.20361642862755,28.887303238194217,-0.1997200281043309,8.455955531352238,298.26800000000003,292.866,288.5,284.134,278.73199999999997,0.19999999999999998,0.0,304.2537064382682,-0.05285665883381607,-0.03671758553354764,273.7483128138951,278.9668208530971,14.534579543079271
2022-04-27,0,283.8625030517578,274.0199966430664,313.7874984741211,283.4943733215332,309.2887554168701,0.22811612959306793,13.708706903399626,-1.4838981395038209,2.9946483791130425,288.1862487792969,12.633563842773436,0.04662954372048844,277.9125015258789,312.5777442932129,0.8469302339764904,-0.1260654410905554,0.9655454077420482,1.0069938611887657,1.012377337180305,-0.013364245409561715,19.310014686631984,321.40928697574464,293.9918731689453,266.57445936214594,281.1624984741211,5.074288022039422,284.9748191833496,7.313286540840882,280.4844202397338,288.16709247668894,-3.4758488525385127,-12.235665230747998,63477700,3.8873378286458853,2.0536013248602494,-760757300.0,-60.71321361492341,89.02914134005623,91.58768807638091,-43.58750895639789,19.91948210072082,24.29801312212135,-0.26432264273042827,9.334594917683189,295.7085953369141,290.79569622802734,286.8249969482422,282.85429766845704,277.9413985595703,0.02,1.0,303.9007106221419,-0.010965324203911497,-0.007290562325810154,274.1258065359933,277.8287440708705,13.736862797852645
2022-04-28,0,286.81500244140625,274.0199966430664,313.7874984741211,283.4756278991699,303.72875022888184,0.4131254383702371,13.104759668928569,-1.3045502621918872,2.994734322307425,286.69749450683594,11.865401000976567,0.04480142951997751,277.9125015258789,312.2472457885742,0.8553382474814952,-0.09536707347450707,0.9805385555919484,1.0181070334942837,1.0257203607885128,0.003946655352129014,37.68626223518272,318.7171426288729,292.50762329101565,266.2981039531584,281.80535561697826,5.510899384347155,284.0682122366769,6.050902321547628,281.34704736870924,287.6291004505832,1.3586524199176107,-6.036906823726968,33646600,4.696217990121313,1.0789499169140646,-727110700.0,-36.92156824288544,89.02914134005623,91.58768807638091,-22.261072311454036,18.477352501517597,22.529552100550365,-0.22531472100845606,9.347846442143917,293.77567626953123,289.2321569824219,285.55999755859375,281.8878381347656,277.34431884765627,0.04,0.0,303.7458643500245,0.03140922548835956,0.011419181912768505,274.731201171875,277.00804356166293,12.741407907881063
2022-04-29,0,283.1274948120117,274.0199966430664,312.4699935913086,283.4756278991699,300.15562438964844,0.5743921516863523,12.20223665322193,-1.0241112443415006,2.9948606345004176,286.25124740600586,10.681450843811035,0.04190918610288808,277.9125015258789,311.40125427246096,0.8499476405330398,-0.07868363476397243,0.9724154028587885,1.0043908884113215,1.0117170352896707,0.018178685907263015,42.58276840373249,315.5634717958238,291.1589984893799,266.754525182936,281.1510696411133,4.935183626068733,282.95571190970287,4.344491090636221,282.72146452840065,287.28173913951764,1.5939641751535905,-4.237789459813419,37073900,4.796746299225727,1.1819332123363377,-764184600.0,-67.7253521311235,89.02914134005623,91.58768807638091,-56.590487267498794,16.643849498108647,23.972414594368097,-0.22698642404407043,9.635997266809934,287.8011906738281,284.39939245605467,281.6499938964844,278.9005953369141,275.49879711914065,0.04,0.0,303.5167424237712,0.012735782607201429,-0.01171616434255173,273.4952479771205,275.6483633858817,12.328464379299856
2022-05-02,0,280.83499908447266,274.0199966430664,312.4699935913086,282.92437171936035,298.9037494659424,0.784264050204371,11.394342615136408,-0.5820597227788666,2.9949665373112446,285.6599922180176,9.511825485229497,0.03932475447985201,277.9125015258789,308.97575454711915,0.8315445737568317,-0.0825867512191234,0.96923251839695,0.996526964738832,0.9999127695098752,0.01577915747265357,39.530634857061195,312.53855820085386,289.74987297058107,266.9611877403083,280.45785631452287,4.51466464131214,282.3964260646275,4.046765751522763,282.8515592781933,286.5117511525992,-1.5918952006790064,-5.214219703371009,35151100,4.81713206745206,1.106452161212747,-799335700.0,-37.89695793287177,89.02914134005623,91.58768807638091,-49.77023398303254,15.560169255580037,22.620639542518727,-0.20422301520655223,9.570539550274384,287.8011906738281,284.39939245605467,281.6499938964844,278.9005953369141,275.49879711914065,0.04,0.0,303.309310006465,0.013358219416521155,0.03809788128775429,274.0069580078125,275.59313528878346,11.39995537400926
2022-05-03,0,282.50499725341797,274.0199966430664,312.4699935913086,281.94500160217285,291.1743755340576,1.0399201031170597,10.68086182414491,0.10852479547203675,2.9950546344629556,285.3449935913086,8.350225219726553,0.03703991365397016,277.9125015258789,303.1122482299805,0.7582056680210032,-0.10124170370167623,0.9796925451677588,1.0021763646327249,1.002743735355061,0.030964895680237525,35.892342033327665,309.7225962984363,288.36087265014646,266.9991490018566,281.09106990269254,4.434473592795238,282.17303357805525,3.939280247795742,282.3736582755133,285.7166875369417,-1.6985319328708868,-2.7124874183642365,25978600,4.661166450609438,0.8155611680294095,-773357100.0,-49.44203883724037,89.02914134005623,91.58768807638091,-45.09796534387549,15.037792220584526,21.861232467966143,-0.24720865288159355,9.195344907760582,287.8011906738281,284.39939245605467,281.6499938964844,278.9005953369141,275.49879711914065,0.04,0.0,303.1595518449223,0.042780035929381954,0.0037758999544799283,275.0905107770647,275.5735626220703,9.539461215454688
2022-05-04,0,285.04500579833984,274.0199966430664,312.22249603271484,281.94500160217285,287.94687271118164,1.2098074048882659,9.191742761738553,0.9378780348539681,2.995225219778363,284.47249603271484,6.772925415039071,0.03204231583381131,277.9125015258789,299.7667495727539,0.6655403312281765,-0.09518051760172674,0.9936638066787506,1.0111188046319002,1.005701627121976,0.004165758893369675,38.67235783108143,305.2461083567291,286.862622833252,268.47913730977484,282.31571415492465,4.118888319558298,282.1721414838518,3.9385781331344405,282.40161219229293,285.0523260700278,1.594006988514088,-1.094936640224847,33599300,4.711253963013065,1.0377912130611215,-739757800.0,-14.248834961374943,89.02914134005623,91.58768807638091,7.50038985423178,18.49646327752205,19.546526627114954,-0.17661882452261118,9.549385645719735,287.8011906738281,284.39939245605467,281.6499938964844,278.9005953369141,275.49879711914065,0.04,0.0,303.0036105989645,0.023868313663360174,0.0731255700512169,276.38517107282365,275.73854282924106,7.699971255464511
2022-05-05,0,280.89500427246094,274.0199966430664,302.0999984741211,281.94500160217285,287.0381259918213,0.9230682783581743,7.116925123184348,0.380944980014819,2.9954238573879137,284.466251373291,5.078749542236324,0.024927606607704832,277.9125015258789,298.782999420166,0.6802430622536171,-0.056454792326793866,0.9838575007292657,0.9973397479525974,0.9902332303129532,-0.020640475981219653,45.554326078531744,299.7375985679019,285.5037483215332,271.26989807516446,283.29785810198103,2.169434885646718,281.95839200701033,3.919479572832501,283.0381391004627,284.7417633762513,3.100673625274689,-0.00438133326139061,43260400,4.333956923197373,1.3297275897173602,-783018200.0,-68.45489290027164,89.02914134005623,91.58768807638091,-73.5775248412298,16.42620728530062,19.06914429558496,-0.18070732284883945,9.984587224103606,287.8011906738281,284.39939245605467,281.6499938964844,278.9005953369141,275.49879711914065,0.04,0.0,302.7321439093539,-0.04239885973448709,-0.020725778793862462,277.38204520089283,275.56517900739397,7.077281571271989
2022-05-06,0,275.01499938964844,274.0199966430664,299.5074996948242,280.88000297546387,285.96936988830566,0.9740125627997513,6.067680272592709,1.1139072218601305,2.995506257902063,283.875,4.28284969329834,0.021331759390574644,277.9125015258789,289.66875076293945,0.5774972873955984,-0.06214367066376643,0.9668528222025524,0.9781267200412503,0.973568177569012,-0.02865315298236837,41.27817981111933,296.57885915663564,284.4434986114502,272.30813806626475,282.03392900739397,3.7714496234762285,281.59821374075756,4.318931992878564,282.4980960582616,283.81329671311806,2.508943768198711,-1.0541121775175732,37780300,4.379726810830825,1.1500244964230961,-820798500.0,-79.69951302826217,89.02914134005623,91.58768807638091,-132.4418653048949,15.474500816641648,20.193267323585648,-0.20453751756380675,9.841355333758543,287.8011906738281,284.39939245605467,281.6499938964844,278.9005953369141,275.49879711914065,0.02,1.0,302.45781052346786,-0.010053261815706205,-0.05144501781422625,276.19503348214283,275.1604200090681,6.062346519179922
2022-05-09,0,267.57999420166016,274.0199966430664,298.70249938964844,280.64062309265137,285.64624214172363,0.7327464418689245,5.330634193901723,1.5605852074681712,2.995555914720382,283.49499893188477,3.8873748779296875,0.018821606506005843,276.3267463684082,287.8032470703125,0.36332320427423753,-0.07930131166763478,0.9447816482144868,0.9527191798666373,0.9527200235592281,-0.04719855048702637,35.480500038129044,293.88014198399486,283.21887359619143,272.557605208388,279.28607068743025,6.035250399877627,280.54571315220426,5.704110153947086,280.6074124326013,282.15204215410716,-3.1168271846374065,-1.8005216126885217,47726000,4.5136401585879,1.4028831326569065,-868524500.0,-95.79726461343019,89.02914134005623,91.58768807638091,-239.1639271352063,14.207035280793873,24.24619777096786,-0.22250858501258444,9.953436428717001,286.22471240234376,281.8476352539063,278.30999755859375,274.7723598632812,270.39528271484374,0.04,0.0,302.0158281338734,-0.06991957913295155,-0.046627431447448804,272.6927054268973,273.71195329938615,6.283042341737379
2022-05-10,0,270.00250244140625,267.57999420166016,288.66500091552734,279.56124687194824,285.20124435424805,-1.038905697331702,5.122082499969879,0.6951240926313056,2.9955658477055493,282.81624603271484,4.035449981689453,0.018185161261883527,274.9154991149902,286.9042518615723,0.4106311223029629,-0.0730431699270579,0.9586021013987861,0.9643979809826666,0.9705058886290161,-0.044255835944723154,31.32838075641661,291.9069133367317,281.662748336792,271.4185833368523,277.41107177734375,6.650366381125492,279.2810707092285,5.9514510617866945,277.3050669519792,279.79082820483376,-6.706416357587722,-5.21935005661072,39336400,4.278136387467044,1.1482299396394362,-829188100.0,-79.38626850600173,89.02914134005623,91.58768807638091,-162.0543996028923,14.270004349839201,22.641153792199745,-0.1727637467053322,9.897461511301106,286.22471240234376,281.8476352539063,278.30999755859375,274.7723598632812,270.39528271484374,0.04,0.0,301.6868184975399,-0.04358014588427195,-0.05262405593145411,271.57140677315846,272.5333273751395,6.654633365683408
2022-05-11,0,264.2224884033203,267.57999420166016,287.7074966430664,277.67250061035156,285.04812812805176,-0.938902853212895,5.450825320213349,-0.027618319766524735,2.9955425891791942,282.4099998474121,4.388737792968743,0.01941663745330007,273.6182472229004,285.80024337768555,0.5734588268333652,-0.05472062898377501,0.9411991694746235,0.945109067799145,0.9583434880569713,-0.07304992885843009,35.93103234218279,291.63127405351264,280.72962341308596,269.8279727726593,275.03785596575057,8.043160844360404,277.7478561401367,6.868351119911912,275.4638139066866,278.3685402323163,-4.6357180461473995,-6.153817473732775,48975900,4.322280745409651,1.3929930112713036,-878164000.0,-96.05429581799669,89.02914134005623,91.58768807638091,-194.56206240767128,13.046773699620855,24.801576528734923,-0.19300300116193736,10.051969719554902,283.5035255126953,278.87824212646484,275.13999938964844,271.40175665283203,266.77647326660156,0.06,0.0,301.2155292270336,-0.10148989428131527,-0.07534270299221556,268.2270769391741,271.1170174734933,7.87401847361323
2022-05-12,0,255.73500442504883,264.2224884033203,287.7074966430664,276.10812187194824,284.1768741607666,-0.9526570578824994,6.402178948598271,-0.051278337731441415,2.9954682593417172,281.6050033569336,5.222888336181637,0.022892794894924188,269.76025161743166,285.80024337768555,0.5923626534272759,-0.07309054163021354,0.9144525716571835,0.9212215069526973,0.9417845665396702,-0.08957083417192979,31.314315033560174,292.463481127177,279.6591232299805,266.854765332784,271.21357127598355,10.02181306852863,276.15232058933805,9.038742195838154,272.66501964881763,276.381602489026,-5.915398983499008,-7.513455975678444,51033800,4.460637930571265,1.3937916571817326,-929197800.0,-86.98730235009913,89.02914134005623,91.58768807638091,-231.33707400367476,12.07360865933633,29.52520925165021,-0.20169793823614018,10.086122049120405,281.31344940185545,275.33328842163087,270.50000762939453,265.6667268371582,259.6865658569336,0.08,0.0,300.62618432224804,-0.07932230837613197,-0.11942198287106534,264.5318167550223,269.81116376604353,9.144290388897755
2022-05-13,0,259.21500396728516,255.73500442504883,287.7074966430664,274.76624870300293,283.8687515258789,-1.2105600694504837,8.124003090650156,0.8175755004711851,2.9953006070741743,280.8650016784668,6.442400588989256,0.029202758979373484,267.2442436218262,285.80024337768555,0.618044760136033,-0.09916777887659514,0.9317811921324819,0.9443298584366512,0.9726240422874878,-0.05745139522363807,26.068467324935913,294.4410048766739,278.19299869537355,261.9449925140732,267.5235710144043,8.755614827879816,274.9196425846645,10.105529474321578,268.4436626766627,273.46607722509964,-9.475936032506857,-8.032976126578053,34925100,4.7564383868453435,0.9451922665767439,-894272700.0,-72.90041741870958,89.02914134005623,91.58768807638091,-151.43512924320947,13.681614851991704,27.88913900733916,-0.14235201637612424,9.914931147263006,281.31344940185545,275.33328842163087,270.50000762939453,265.6667268371582,259.6865658569336,0.08,0.0,300.27266485186334,-0.04953968112903173,-0.05851838210535062,260.49681091308594,268.4409909929548,9.780238850603654
2022-05-16,0,260.76499938964844,255.73500442504883,287.7074966430664,273.01562309265137,283.31124687194824,-0.9611548491833029,8.992466019926134,-0.1138225408803879,2.995199410200976,280.4462471008301,7.341250686645504,0.032468538213918714,263.7217399597168,285.80024337768555,0.7546923264138624,-0.0744221865627306,0.9415279778399249,0.9583249093649983,0.9901804082347075,-0.025468999774608148,31.937010293321226,294.94430608617796,276.9593740463257,258.97444200647345,264.64785603114535,6.69526763795196,273.9728570665632,10.79379222997017,266.1505741816151,271.5475159148953,-9.061727553763415,-6.242028524742518,32550900,4.845736476836942,0.8671243873522683,-861721800.0,-71.97267127485006,89.02914134005623,91.58768807638091,-119.28968428814147,14.694083689297214,25.873311930568043,-0.13568623669325444,9.923867161748268,281.31344940185545,275.33328842163087,270.50000762939453,265.6667268371582,259.6865658569336,0.08,0.0,299.95823939839164,-0.011640995717979497,-0.04815650557861321,258.280763898577,267.83140454973494,10.249520006224845
2022-05-17,0,265.92999267578125,255.73500442504883,287.7074966430664,269.3968753814697,283.31124687194824,-0.7230962375912838,9.621170144976597,-0.7470471786242139,2.995119273364104,279.45375061035156,8.140300521850588,0.034859975310308496,260.6099998474121,285.80024337768555,0.8006299656678488,-0.0763331840865611,0.9635327968696684,0.984568537052667,1.0150464637867844,-0.015083229706394197,33.427213178706396,295.2370895499019,275.9947492599487,256.75240896999554,263.3499979291643,5.022197657275447,272.69196346827914,10.592051778077662,264.797829650876,270.34952475932636,-7.166380525332132,-4.837237214729147,28828800,4.8224782631809155,0.7613482049339952,-832893000.0,-58.984374272404395,89.02914134005623,91.58768807638091,-71.1799778939765,15.803240799728659,24.57214878263779,-0.13887449572482505,9.702831714299807,281.31344940185545,275.33328842163087,270.50000762939453,265.6667268371582,259.6865658569336,0.08,0.0,299.7180282716176,-0.009944349040669431,0.008466457270012433,257.17484174455916,266.684937613351,10.150328799464223
2022-05-18,1,258.3625030517578,255.73500442504883,287.7074966430664,267.16749382019043,283.31124687194824,-0.5118219482189473,9.744918154457782,-1.0258472325214627,2.995101163041192,277.27249908447266,8.409450740814208,0.0354134659443057,260.6099998474121,285.80024337768555,0.8140230413161105,-0.07569321001844663,0.9389008258549189,0.9624572429882733,0.9892370598684916,-0.022178223310869605,38.97353583092271,294.665335080583,275.1754987716675,255.685662462752,262.0332134791783,4.935916050157385,270.6596420833043,10.40169688201745,265.0625709266926,270.10628836385376,-3.303458623722306,-6.317322711942286,31356000,4.806514249239009,0.8189527115924929,-864249000.0,-90.06363803732995,89.02914134005623,91.58768807638091,-124.01982568071845,14.219102260337166,29.02243631839025,-0.15214862027167778,10.013401329406362,281.23704473876955,275.2714846496582,270.4500045776367,265.62852450561525,259.66296441650394,0.08,0.0,299.3917128016912,-0.022560632338938902,-0.05502124427760547,255.78955078125,264.24112810407365,10.642625645261008
2022-05-19,1,254.14750289916992,255.73500442504883,286.81500244140625,265.503116607666,282.6606216430664,-0.375452099692136,9.954491495618633,-1.2578126211906786,2.9950676529887876,275.74374771118164,8.78535041809082,0.03636898605956511,259.12975387573243,285.10925445556643,0.7739243304408071,-0.09564643202300423,0.9285343198174857,0.9562604961327985,0.977484753792071,-0.006207603567794595,33.453258571477214,293.61723208333933,273.70824909210205,253.79926610086477,259.7682135445731,4.261120654378749,268.5896426609584,10.611146884226347,263.3641573108057,268.60024988438084,-3.444760949862206,-9.920157295628576,32692300,5.01470935963943,0.8502590780032463,-896941300.0,-92.36418240190372,89.02914134005623,91.58768807638091,-125.07618546652611,13.61347759758479,28.44100250457165,-0.14155481286193494,9.7116786555465,281.23704473876955,275.2714846496582,270.4500045776367,265.62852450561525,259.66296441650394,0.08,0.0,299.0363832887107,-0.006345882304957362,-0.026176815260157887,253.5846405029297,262.5780236380441,11.263432464630961
2022-05-20,1,253.69499969482422,254.14750289916992,286.81500244140625,263.35811614990234,281.2975025177002,-0.276713359569302,10.419260995945683,-1.3202407146326671,2.994996408285687,274.5174980163574,9.322125511169435,0.038287631466622285,258.0997531890869,283.980753326416,0.8075763158774453,-0.0860387095209416,0.9322523600301336,0.9642623003929446,0.9769373519633298,-0.021295080099443586,31.838237804698764,292.9697716104216,272.13124961853026,251.2927276266389,258.26428658621654,4.284734205331916,266.65107127598355,10.680832960627837,261.0454020987917,266.87432849862495,-5.872167627660063,-10.235668539391998,39199300,4.849026289227456,1.0066722762255331,-936140600.0,-86.22863460627245,89.02914134005623,91.58768807638091,-119.49223726003949,12.422680521646685,29.885835111654146,-0.10643258968553063,9.88230065281619,280.3921643066406,273.9039239501953,268.6600036621094,263.41608337402346,256.92784301757814,0.1,0.0,298.60158881875327,-0.030529065825656176,-0.00862259191006116,252.5497828892299,260.388429914202,11.940531176414485
2022-05-23,1,257.7674980163574,253.69499969482422,286.81500244140625,260.3775005340576,281.2975025177002,-0.13882074621254864,11.059167447278602,-1.4287898802811427,2.994897117514219,272.0112495422363,9.946875381469727,0.04082193538716746,255.57625427246094,283.980753326416,0.8360919118715403,-0.08238612037269478,0.9514792319674039,0.9877455023385154,0.9968578330601079,-0.011495029548854396,31.795291623379498,293.0307093910172,270.91237449645996,248.79403960190274,258.5546428135463,4.151567308923738,264.8841070447649,9.871883672509703,259.2106863032519,265.684706313072,-3.98432728876071,-9.664037416321094,33175400,4.851550998846553,0.8547208490889057,-902965200.0,-68.02432341489208,89.02914134005623,91.58768807638091,-72.41797800768514,13.768783563825465,27.941148336155504,-0.11553655595377438,9.814983680285644,280.3921643066406,273.9039239501953,268.6600036621094,263.41608337402346,256.92784301757814,0.1,0.0,298.287100240894,-0.0009288430725621355,0.0005250743293047183,253.37566920689173,258.95374298095703,11.862569947579143
2022-05-24,1,258.08499908447266,253.69499969482422,286.81500244140625,259.0018787384033,281.2975025177002,0.03534402736710678,11.336848484430242,-1.518904411924829,2.994850666700844,268.7912483215332,10.235125923156739,0.04199188542884881,255.57625427246094,283.980753326416,0.8734654575049239,-0.0593113598489646,0.9559513587346304,0.9926947481793003,1.0004050686667838,-0.02950022113855022,38.313344154443335,292.6508215645027,269.97712459564207,247.30342762678146,258.3932135445731,4.143572115133427,262.9583922794887,8.108646295393076,258.85549975361096,265.06369247522395,0.7947655018436398,-8.756482001226352,29043900,4.979894320214929,0.7655100731841641,-873921300.0,-66.97571669657762,89.02914134005623,91.58768807638091,-67.97772381672618,12.972589381729373,26.32542247023521,-0.038561989018220826,9.673178695236727,276.9312452392578,271.10438470458985,266.39500427246094,261.685623840332,255.85876330566407,0.1,0.0,298.0132308682607,-0.024718205330442333,-0.004876798765215364,253.25049700055803,256.873653956822,12.034800559592995
2022-05-25,1,260.5924987792969,253.69499969482422,286.81500244140625,258.2931270599365,281.2975025177002,0.18359679607585308,11.582021193644284,-1.5634527822980173,2.994808642897722,266.7549934387207,10.547913608551028,0.04302698963767425,255.57625427246094,283.980753326416,0.8645127094681602,-0.09080982408791427,0.9680962033453531,1.006955377858197,1.0163058139787935,0.008631266926115488,35.10582570764804,292.344417105001,269.1803747177124,246.01633233042384,258.36857060023715,4.127597682383447,261.50821331569125,6.258440562451131,258.694645684323,264.5317396141375,-0.43593343962262115,-9.458157892771686,28547900,4.312424889639639,0.7887446833523535,-845373400.0,-50.99058894000472,89.02914134005623,91.58768807638091,-42.77293599364411,14.687167642392016,24.852844175238143,0.0046036060975415604,9.514358652879327,271.5068405761719,266.7165809326172,262.8450012207031,258.97342150878904,254.18316186523438,0.1,0.0,297.76937504586283,0.03321756420038269,-0.013824478187127485,253.47858537946428,255.87967463902064,11.639424958907629
2022-05-26,0,264.177490234375,253.69499969482422,286.81500244140625,258.2931270599365,280.8500003814697,0.3800923249685729,11.211548430914275,-1.400747566447995,2.994861572254597,265.0762405395508,10.01050094604492,0.041831502033813965,255.57625427246094,283.31924591064455,0.8420078528411754,-0.09142654128584643,0.9856748412695344,1.0222420042278404,1.0284982550567834,0.039465220868939,38.06791986192055,290.4399713659179,268.01687450408934,245.5937776422608,258.1182131086077,3.613679269150867,260.734105518886,5.003747721953899,259.18827597617957,263.9181500991466,-0.06615174994931096,-7.227791589155909,25002100,4.29010837883124,0.6991273107362674,-820371300.0,-28.74407471722908,89.02914134005623,91.58768807638091,-14.148142384958609,15.998151173416217,23.761518217658892,-0.008978309626206512,9.240442928446289,267.3048405761719,263.3175809326172,260.0950012207031,256.87242150878905,252.88516186523438,0.02,1.0,297.5782029417469,0.05040681539839187,0.046520678506581245,253.43654087611608,255.3056913103376,10.525020535402485
2022-05-27,0,270.6549987792969,253.69499969482422,285.04500579833984,258.2931270599365,276.4699993133545,0.5089199662786895,10.367557026733321,-1.2017553353233863,2.994982384996035,264.19998931884766,8.992500610351566,0.03884653341217293,255.57625427246094,282.56724700927737,0.8473549231717353,-0.06693099372146447,1.014125934020968,1.0438966538401393,1.0455510404004877,0.06685192496846315,44.64118339823674,287.6201129472045,266.8849988937378,246.1498848402711,259.87428392682756,5.970439563773019,260.95374870300293,5.3806627692662925,260.4561444314567,263.9011467721975,-0.6590089458404493,-3.9406974817102873,26910800,4.3904225254259694,0.7633465012127091,-793460500.0,-1.8674837466783774,89.02914134005623,91.58768807638091,42.07358311777288,19.94929781872238,22.375523488347,0.07230357234871246,9.111825892182809,267.3048405761719,263.3175809326172,260.0950012207031,256.87242150878905,252.88516186523438,0.04,0.0,297.41564510734014,0.08188158492550368,0.0794027241709198,256.12159729003906,255.95557403564453,10.368664239362198
2022-05-31,0,272.0249938964844,253.69499969482422,285.04500579833984,258.2931270599365,271.74499893188477,0.57891922238128,9.727129179950822,-0.9431303329511715,2.995069376705585,264.19998931884766,8.244150848388676,0.0365322578729956,255.57625427246094,281.05600357055664,0.8273203275536153,-0.036249044237231014,1.0216464735977386,1.0445716381218975,1.0372518289617236,0.055311456990680075,53.74640301259175,285.7156324520038,266.2613740921021,246.80711573220037,262.4282112121582,6.868561364224255,261.09821237836564,5.6620889271221975,263.0164512197389,264.85743434761787,4.757848210301827,1.149190763237426,37827700,4.6813671693626455,1.0689551931336294,-755632800.0,-10.236481719067948,89.02914134005623,91.58768807638091,53.81232679080418,20.162488121262566,21.324089366881218,0.028084278524336342,8.878099913699456,268.08411218261716,263.9479341430664,260.60499572753906,257.26205731201173,253.12587927246093,0.06,0.0,297.1946453777935,0.043046210399668716,0.07645711738414494,258.7463945661272,256.1655175345285,9.640775654044162
2022-06-01,0,273.83750915527344,253.69499969482422,285.04500579833984,258.2931270599365,270.99749755859375,0.6336527256494477,9.244697939710132,-0.6730862782395541,2.9951316875263845,264.19998931884766,7.726462421417239,0.03477792321730304,255.57625427246094,281.05600357055664,0.7841844564437663,-0.03709670079758845,1.030158035397988,1.0470046084132265,1.0329320354691465,0.06103613199791158,54.855869524075594,284.31026971212293,265.82087383270266,247.33147795328242,265.30571256365096,6.8191618404570065,261.78499957493375,6.579077394900426,265.2905369386276,265.8331867890158,7.034297324733952,0.7490639667375044,25292200,4.674401463219676,0.715414223172002,-730340600.0,-16.86396484375,89.02914134005623,91.58768807638091,75.59691357687443,21.281988371222344,19.998412775907973,0.021244919465472488,8.79036973647136,270.31500244140625,265.75250244140625,262.06500244140625,258.37750244140625,253.81500244140625,0.08,0.0,297.0577765915807,0.049302838553870965,0.045156386035387575,261.52955191476,257.03966740199496,9.100024459482121
2022-06-02,0,268.8199996948242,253.69499969482422,285.04500579833984,258.2931270599365,270.99749755859375,0.6075302104614241,8.635505196601034,-0.49637545360147595,2.995206133507003,264.19998931884766,7.24975057601929,0.03253923118164997,255.57625427246094,275.6029998779297,0.7064630561254293,-0.03931834066580822,1.0129339184190274,1.0247222547988812,1.0020968715868837,0.03157228605607498,56.25581230649213,282.6585098209975,265.38749942779543,248.11648903459337,266.8846413748605,6.0149845023532915,262.7196420942034,6.5829287625985895,267.45107118682256,266.65359894855277,7.939655682878703,3.6389865261114163,44008200,4.651845839673818,1.2267548873588903,-774348800.0,-9.952050781250001,89.02914134005623,91.58768807638091,60.95286006384086,19.100533236191275,24.57781010645805,0.04074345983756694,9.094654961425373,270.31500244140625,265.75250244140625,262.06500244140625,258.37750244140625,253.81500244140625,0.08,0.0,296.792575790657,0.0459396079211174,0.05762257048573581,263.481680733817,258.42867497035434,7.5551707285796414
2022-06-03,0,270.54750061035156,253.69499969482422,280.89500427246094,258.2931270599365,270.1656265258789,0.36174125947641134,7.42846202195539,-0.7910249330540555,2.9953393412621443,264.19998931884766,6.357375240325927,0.02807682868961008,255.57625427246094,273.95525817871095,0.6783243945996978,-0.042987608871549295,1.0225691138472695,1.0272125628762552,1.0023879032920566,0.02411261599285064,50.58022349552944,279.43317316653037,264.57624912261963,249.71932507870886,268.66499873570035,4.670391817886156,263.5291061401367,6.811607718162961,267.7769022862297,266.5105775169421,4.2877793994669675,5.1166226927727285,28059000,4.690660224058326,0.799092089674656,-746289800.0,-24.54404296875,89.02914134005623,91.58768807638091,74.32198455327865,18.15311076631572,23.358704374316925,0.05792037173607723,8.885732733254505,270.31500244140625,265.75250244140625,262.06500244140625,258.37750244140625,253.81500244140625,0.08,0.0,296.6284082918992,0.015494652229669947,0.028569576528309285,264.93912179129467,259.09480939592635,7.130753982773856
2022-06-06,0,270.55249786376953,253.69499969482422,275.01499938964844,258.2931270599365,270.1387519836426,0.03190672331074942,6.58650701555867,-1.3032372589138792,2.9954212165823555,264.19998931884766,5.81648561477661,0.02494332766513042,255.57625427246094,272.2062454223633,0.6794376901509614,-0.016244564075456866,1.024591576216987,1.0208748165258215,0.9976970666299405,-0.0003787142893707518,54.83935182445317,277.23188797063153,264.05887393951417,250.88585990839684,270.08785574776783,3.0304317973480814,264.2282131740025,7.005597939275057,268.4413740397807,266.56799042267374,4.828836069546165,4.371852118751834,22400300,4.548434732101888,0.6522218922334224,-723889500.0,-28.608007812500002,89.02914134005623,91.58768807638091,73.79816815955603,17.121424806277084,23.00287933911942,0.04824956497189002,8.748169340896483,270.31500244140625,265.75250244140625,262.06500244140625,258.37750244140625,253.81500244140625,0.08,0.0,296.4959460301991,-0.01643237709304224,0.010718472127795664,265.8121991838728,259.64539228166853,6.837817148180451
2022-06-07,0,269.55250549316406,253.69499969482422,273.83750915527344,258.2931270599365,270.1387519836426,-0.06677479754215206,6.280032898469679,-1.3700645311815745,2.995448792786458,264.19998931884766,5.615673046112062,0.02380281264206324,255.57625427246094,270.7919982910156,0.7477217604602576,0.011108841193370998,1.0216678621247326,1.0106728266200746,0.994084616265764,-0.009089195694499952,57.90005824043169,276.3958146601596,263.8357488632202,251.27568306628078,270.855715070452,1.6496476940769997,264.48696408952986,7.138917926232426,268.9307064234977,266.6204126162141,3.822059012108426,3.75337890323851,22860700,4.220146189567885,0.6906277345007384,-746750200.0,-16.6080078125,89.02914134005623,91.58768807638091,74.66709741437066,16.10326617097192,22.693627562967997,0.13053666896299052,8.636863858421895,270.31500244140625,265.75250244140625,262.06500244140625,258.37750244140625,253.81500244140625,0.08,0.0,296.3645110043529,0.0023173984536182246,-0.00270814063477013,266.73712158203125,260.08683122907365,7.104115976203633
2022-06-08,0,271.1824951171875,253.69499969482422,273.83750915527344,258.2931270599365,270.1387519836426,-0.08487759590602383,6.3531238666070875,-1.4132147819235137,2.9954423288644065,264.19998931884766,5.704436054229734,0.02407084670339184,255.57625427246094,270.7919982910156,0.7507784090297078,-0.001666639916938704,1.0274618291198554,1.0123112601361652,1.0019230351832962,-0.00969558204891674,55.20451892523183,276.6406221610096,263.93437442779543,251.22812669458125,270.93107169015065,1.6509983300982891,265.4026778084891,7.11507397212831,269.08449530322895,266.5438985973989,2.034622728083462,1.3622054364508398,17372300,4.192530106178824,0.5428312793154919,-729377900.0,-23.29599609375,89.02914134005623,91.58768807638091,78.23834551388644,15.631282073024742,22.028481050407418,0.11941055259346205,8.262064379621217,270.31500244140625,265.75250244140625,262.06500244140625,258.37750244140625,253.81500244140625,0.08,0.0,296.26736861307586,-0.00737827445901984,-0.00537011205946601,266.3405325753348,261.23106493268693,7.163579524310935
2022-06-09,0,267.47750091552734,253.69499969482422,273.83750915527344,258.2931270599365,270.54874992370605,-0.08025483943598641,6.414386619512936,-1.4290565213318414,2.995436850922481,264.19998931884766,5.757535724639894,0.024297528838798,255.57625427246094,271.26674499511716,0.7843180579497029,0.026341462287809283,1.013197781445568,0.9936226421868515,0.9901769924861263,-0.004994043526601155,60.45806187184805,276.8221473006103,263.99337406158446,251.1646008225586,270.28142983572826,2.0054515885714794,266.3548205239432,6.343073007698968,269.6020207823261,266.598065561374,0.19489621114323738,4.962017287338889,26439700,3.978086447975129,0.8563099488540085,-755817600.0,-41.27998046875,89.02914134005623,91.58768807638091,34.55920924068495,14.53757947258593,24.799599781234072,0.1455176968828801,8.249058031343772,270.31500244140625,265.75250244140625,262.06500244140625,258.37750244140625,253.81500244140625,0.08,0.0,296.0999017342944,-0.03565421713324424,-0.02800809429025933,265.3483581542969,262.04737636021207,7.095347464310555
2022-06-10,0,256.66999435424805,253.69499969482422,273.83750915527344,258.2931270599365,270.54874992370605,-0.14635392771262815,6.459272425443045,-1.457096340668649,2.995432908793817,265.0537414550781,5.904011287689206,0.024452480263677044,255.57625427246094,271.26674499511716,0.8041425014948916,0.045916657036757055,0.971660205335721,0.9510426106814274,0.9511139723164502,-0.051294158049126515,56.982196383436346,277.07466953808085,264.15612468719485,251.23757983630884,267.82892772129605,5.076959815925904,266.5673201424735,5.922201297039616,269.07123236202955,266.28657660334113,-1.6717188063562722,5.244984847105086,31422800,3.536726518413597,1.0510784636087314,-787240400.0,-98.17167469430865,89.02914134005623,91.58768807638091,-98.09585660118063,13.045998516638576,32.381387639321176,0.09681765267867619,8.535570755866042,271.7522415771484,268.0788810424805,265.11000061035156,262.14112017822265,258.4677596435547,0.02,1.0,295.8212084306164,-0.06306935665441527,-0.07862906446598143,262.6254643031529,262.07750810895647,7.2272020893179425
2022-06-13,1,244.47999954223633,253.69499969482422,273.83750915527344,258.2931270599365,270.54874992370605,-0.13841452401408805,6.401277903300763,-1.4529240391471827,2.9954383871253754,265.0537414550781,5.85512523651123,0.024228645971697705,256.41774520874026,271.26674499511716,0.7369017365828525,-0.009818141597074791,0.9253495076374205,0.9084018248163962,0.91535717083778,-0.09636761267183502,38.990005338833214,277.00542999025635,264.2028741836548,251.40031837705325,264.3517848423549,10.117721178583386,265.6182131086077,8.10386275520061,265.98077151393994,265.0029428882311,-6.269234208996159,1.1726658637350047,46135800,4.287486855344995,1.5148193452882746,-833376200.0,-97.98120671015317,89.02914134005623,91.58768807638091,-185.68225316734714,11.824695491484615,38.3357408920608,0.005353337828325797,8.744469987567768,269.1562415771484,263.8768810424805,259.61000061035156,255.34312017822265,250.06375964355468,0.04,0.0,295.3085020773991,-0.0985675126927057,-0.10280722375332718,258.09618486676897,260.78893280029297,8.68430811407903
2022-06-14,1,243.9000015258789,244.47999954223633,273.83750915527344,258.00562381744385,270.54874992370605,-0.6317880856493314,7.657623955774995,-0.35205882200041216,2.9953071406781278,265.0537414550781,6.66301208496094,0.02906492812285715,254.10225257873535,271.26674499511716,0.6318283505317155,-0.062450865283029136,0.9257357183448921,0.9151472127523559,0.9313692822979616,-0.0951670025116339,28.031822781892625,278.78137187395225,263.4661239624023,248.15087605085236,260.5449992588588,12.197383070974745,264.60499899727955,9.822668646240565,260.6045327657673,262.1672861743834,-9.054385901428347,-5.154838595391066,28651500,5.0358961704256755,0.9468022478188751,-862027700.0,-91.76337663685045,89.02914134005623,91.58768807638091,-159.12363500151852,11.40045737134386,36.97732494522829,0.01724964326127897,8.421992935700539,269.1515205688477,263.8692394104004,259.5999984741211,255.33075753784178,250.04847637939451,0.06,0.0,294.99301085475895,-0.10278899307963296,-0.09026973591300663,254.51844787597656,259.7287848336356,9.62517504173594
2022-06-15,1,250.4474983215332,243.9000015258789,273.83750915527344,257.4931221008301,270.54874992370605,-0.6885973583410918,8.758138382548614,-0.528339078714783,2.9951716851587666,265.0537414550781,7.59058696746826,0.03334872643363281,252.77349967956542,271.26674499511716,0.7291750615741466,-0.08284131822904629,0.9536393172497538,0.94973681623864,0.9754831698304861,-0.07646141314060106,25.45220412755685,280.13915083431107,262.6228740692139,245.1065973041167,257.67285646711076,11.809050131285398,263.8803561074393,10.492802721115334,256.41475225686736,259.6310725348471,-9.84947154357599,-5.496250308585708,33111700,4.833647259786233,1.0865029853508459,-828916000.0,-71.66943683777906,89.02914134005623,91.58768807638091,-86.67974225213139,18.323367371595076,33.65433155836538,0.005175616354607817,8.592572403415682,269.1515205688477,263.8692394104004,259.5999984741211,255.33075753784178,250.04847637939451,0.06,0.0,294.68424421750365,-0.06896952203014661,-0.07611028063459416,252.13748604910714,258.97484261649,9.873366803512038
2022-06-16,1,245.3474998474121,243.9000015258789,273.83750915527344,256.0393714904785,270.54874992370605,-0.4783133270103028,9.10883394871502,-0.9348083595615915,2.995123604498872,262.38499450683594,8.033999824523926,0.034786623847828546,249.85074844360352,271.26674499511716,0.8200551258561449,-0.030635268805392378,0.9369817516984267,0.9387231569247928,0.9713078282819565,-0.08273593476972163,37.8186166413957,280.06641724893154,261.84874935150145,243.63108145407136,254.21499851771765,11.282825249411406,262.5353567940848,11.60019218872519,254.88248995465426,258.2154179036675,-7.4310899736581755,-3.8930516055858377,33169200,4.876191051905307,1.085161554582947,-862085200.0,-90.43668890254402,89.02914134005623,91.58768807638091,-121.85676527172006,16.993674565248934,34.03511432234328,0.03787803877527473,8.603102690383455,269.1515205688477,263.8692394104004,259.5999984741211,255.33075753784178,250.04847637939451,0.06,0.0,294.3370670183544,-0.07485194493257308,-0.0940794484237555,248.2794647216797,257.50829315185547,10.426802707407802
2022-06-17,1,246.71999740600586,243.9000015258789,273.83750915527344,254.0343770980835,270.54874992370605,-0.4252520139656012,9.775185227448485,-1.177565469454202,2.9950279598438976,262.38499450683594,8.684749984741211,0.03742442613540001,245.26074981689453,271.26674499511716,0.8000464693253055,-0.03462557354045344,0.9445707783746247,0.952528940871172,0.9941612315811418,-0.03876571927807626,34.34165921891391,280.7483696461811,261.19799919128417,241.6476287363872,250.72035598754883,8.627516923275321,260.82571383884977,12.065891738298376,252.46600193412752,256.5094317453676,-8.97969974401362,-7.127780027835512,43084800,4.91631406900877,1.3859977388364095,-819000400.0,-83.02930336346978,89.02914134005623,91.58768807638091,-98.09311172987816,18.667737468205168,32.173772581688,0.07519004584788773,8.450732362258197,269.1515205688477,263.8692394104004,259.5999984741211,255.33075753784178,250.04847637939451,0.06,0.0,293.9136574977139,-0.021107572855074697,-0.06473067294959578,245.08990696498327,255.71521977015905,10.71456490838396
2022-06-21,1,252.06499862670898,243.9000015258789,273.83750915527344,252.88312435150146,270.54874992370605,-0.3957386227474008,10.169143450791216,-1.3159178181404303,2.9949679961993008,262.38499450683594,9.056125259399414,0.03898813433264318,245.26074981689453,271.26674499511716,0.8271844419644778,-0.02749365299753151,0.9664082402388582,0.9822002609598209,1.023909428968954,0.031025029035809837,36.558884869869885,281.16491081820845,260.826623916626,240.48833701504353,248.51856994628906,4.720088538325209,259.39999989100863,11.81746972230363,251.01800822070862,255.49041868089316,-9.020677275135526,-8.843362022220987,29928300,4.9333823045042395,0.9773394903014038,-789072100.0,-66.1967708563096,89.02914134005623,91.58768807638091,-60.065547123414895,21.16834312961617,30.220598271811888,0.10561684932544439,8.354248424053486,269.1515205688477,263.8692394104004,259.5999984741211,255.33075753784178,250.04847637939451,0.06,0.0,293.65684230353475,0.04738714111016207,0.0029645028816533466,243.54136875697546,254.44486345563615,10.669416906344322
2022-06-22,1,253.1400032043457,243.9000015258789,273.83750915527344,251.66062355041504,270.54874992370605,-0.37902206149544215,10.232308485774896,-1.3544941089566,2.9949581345540848,262.38499450683594,9.137625312805175,0.0392425688893898,245.26074981689453,271.26674499511716,0.8660025285519071,-0.022122647089070042,0.9708331241397866,0.9935465166455307,1.021978570819143,0.03788438548856021,42.87491891262733,281.20974083477,260.7451238632202,240.28050689167043,248.01428549630302,3.8036653527067643,257.92160660879955,11.148061263988325,251.28035395565462,255.67093957825415,-5.762167747217668,-7.337559311689907,25939900,5.001367258767547,0.8572215076846206,-763132200.0,-64.93660051301573,89.02914134005623,91.58768807638091,-50.33023390621349,22.01804071991671,28.43985065967735,0.05554267609591394,8.243228257185011,266.8289540405273,261.99051412963865,258.07999420166016,254.16947427368163,249.33103436279293,0.06,0.0,293.4416020289837,0.035338674303944106,0.04486907101332642,243.56098284040178,253.09322357177734,10.817550700308967
2022-06-23,0,256.8574981689453,243.9000015258789,273.83750915527344,251.66062355041504,270.54874992370605,-0.3179471871222685,10.348680249436624,-1.4444638425717287,2.9949396202085126,262.38499450683594,9.376875019073486,0.039724123138566735,245.26074981689453,271.26674499511716,0.8743414307782656,-0.01916033825161775,0.985965228453438,1.0146735216821388,1.02930745160352,0.025594185968600636,44.24583089254224,281.2111096214929,260.51374912261963,239.8163886237464,249.78249958583288,4.666054478819707,257.0671422140939,10.697829875482874,251.7619048346584,256.1792364501976,-1.3753033964033825,-7.558316614394735,25861400,5.009145023114915,0.8591451901686022,-737270800.0,-46.89319921291356,89.02914134005623,91.58768807638091,-23.68563523780322,22.746497569232584,26.874886271781197,0.06398813554224696,8.100135362591518,266.46987310791013,261.7000533752441,257.8449935913086,253.98993380737303,249.220114074707,0.06,0.0,293.24915516429337,0.02820139596446647,0.05877512852786794,245.8872789655413,251.99173191615515,10.823319416259556
2022-06-24,0,264.80250549316406,243.9000015258789,273.83750915527344,251.66062355041504,270.54874992370605,-0.3000968770640751,10.366527056987692,-1.4618422801392685,2.9949366926663767,262.38499450683594,9.444387569427487,0.039802006388811706,245.26074981689453,271.26674499511716,0.884031622836574,-0.014332724955045001,1.016702214490229,1.0520121581894395,1.0557219190717448,0.07929571590438678,48.396708833324745,281.1854281908186,260.4523740768433,239.71931996286798,252.7685715811593,6.57283295971481,256.65678542000904,10.241411476381906,253.05634470961843,257.0674060526603,5.062785769749909,-4.450004292634194,33923200,5.051441347432818,1.116994094187437,-703347600.0,-19.83465207203343,89.02914134005623,91.58768807638091,33.63396093174031,28.458449272125712,24.73275321020431,0.09326741775402696,8.172986778306507,266.46987310791013,261.7000533752441,257.8449935913086,253.98993380737303,249.220114074707,0.02,1.0,293.0588305042533,0.09278703478584349,0.06331452807779668,249.13989911760603,251.8291734967913,10.923164595472857
2022-06-27,0,266.1699981689453,243.9000015258789,273.83750915527344,251.66062355041504,270.54874992370605,-0.3533856751663049,10.409888243986199,-1.4596559649191554,2.9949307386317345,264.48999786376953,9.633837871551515,0.039936213653161245,245.26074981689453,271.26674499511716,0.8695809601144695,0.0023658914248695325,1.021127380601554,1.0585699285343106,1.0449636167316665,0.07883431001716601,56.36312707583959,281.482650900509,260.6628744125366,239.84309792456426,255.0146429879325,8.145651138888816,256.34374972752164,9.843244973980958,256.0154776414206,258.5915872405546,8.570112274094145,-2.123470039171261,24615100,5.310410699190241,0.8110216788854832,-678732500.0,-26.059416604857788,89.02914134005623,91.58768807638091,31.17997887765439,27.462065093127446,23.616882768125024,0.05514690941061672,7.947766593521793,265.66768243408205,261.05116091918944,257.3199996948242,253.58883847045897,248.97231695556638,0.04,0.0,292.92082074553224,0.06961434429586211,0.08131610125920935,250.97992379324776,251.55870492117745,10.902921425971297
2022-06-28,0,260.9225082397461,243.9000015258789,273.83750915527344,251.66062355041504,270.54874992370605,-0.37226451717792236,10.452494554759307,-1.4677564531580478,2.9949245637261437,265.4862518310547,9.723500728607178,0.04008434710667672,245.26074981689453,271.26674499511716,0.8574788644738295,-0.016570913637581897,1.0006136174894702,1.0337945513869131,1.0089537696225017,0.03513978402909679,56.13921834741935,281.6674889187837,260.76249980926514,239.85751069974654,257.2396441868373,7.12863472023536,255.72732135227747,9.201743799967003,258.57552962429475,260.07920808012057,6.277762785726459,-1.61983338887188,27295500,5.102540941994197,0.8987662646302029,-706028000.0,-52.46105472181662,89.02914134005623,91.58768807638091,-3.221954662694677,24.908928328112154,27.531407900585872,-0.03124021034857665,8.136502004135288,265.5683587036133,260.9708179016113,257.25499725341797,253.53917660522458,248.94163580322262,0.04,0.0,292.7385484436224,0.010798359532100843,0.03565503835654021,252.5929173060826,250.43619101388114,10.568623993296637
2022-06-29,0,258.8950004577637,243.9000015258789,273.83750915527344,251.66062355041504,269.80125427246094,-0.30248558965143046,10.204216889517008,-1.4286172867099616,2.9949603897163075,262.8625068664551,9.285538654327393,0.03920538881465604,245.26074981689453,271.26674499511716,0.8415717083968882,-0.040814211582937084,0.9946945723531762,1.0191221938525945,0.9943025165974201,0.02273444410432557,49.13980890208719,280.6843090613216,260.2758752822876,239.8674415032536,258.97893033708846,5.413040113933583,254.84964316231864,8.138817175557563,259.1621236953057,260.3607558136292,6.348142288802813,-3.2016015720680544,20069800,5.205831123519964,0.6807459584757787,-726097800.0,-39.90379136929546,89.02914134005623,91.58768807638091,-3.0269926728727117,23.52759236908836,26.504733447964394,-0.017328324293258857,7.99889200574121,265.346792175293,260.7915926208496,257.10999298095703,253.42839334106444,248.87319378662107,0.04,0.0,292.60348834751227,0.0281673609982398,0.025695498031192202,254.3600616455078,249.72498430524553,10.221169944995651
2022-06-30,0,256.5774917602539,243.9000015258789,273.83750915527344,251.66062355041504,269.0031261444092,-0.22179039265073464,9.843185554614877,-1.3724341627354306,2.995011242943759,259.9087543487549,8.76712646484375,0.03791390966669596,245.26074981689453,270.6154975891113,0.8129531324534233,-0.05456706330554939,0.988283294176537,1.0040727643423708,0.9810651941536702,-0.0010901235536726617,46.272754965322456,279.3057467195813,259.61937561035154,239.9330045011218,259.62357221330916,4.670145128951257,254.0710710797991,7.317842850171958,259.100421021042,260.0561551743083,4.93474512798509,-4.531079579496446,31730900,5.183346766156512,1.0646522170426425,-757828700.0,-42.81449830239517,89.02914134005623,91.58768807638091,-20.077389634321584,21.97236983821663,27.32135091812334,0.008763787141299249,7.953257013062384,261.9775493774414,258.066210357666,254.90499114990234,251.74377194213866,247.83243292236327,0.04,0.0,292.3736871244571,-0.007841931221581055,0.014617064794823715,254.79308864048548,249.16722869873047,9.796566030319914
2022-07-01,0,257.58749771118164,243.9000015258789,271.1824951171875,251.66062355041504,267.81312561035156,-0.16414780436360926,9.300452577923325,-1.343147506970061,2.995084824664913,257.8762493133545,8.13587646484375,0.035942892565436854,245.26074981689453,270.54800033569336,0.8241454496014138,-0.04554165593508118,0.9954827121434565,1.0056129181195053,0.9851380614075723,-0.027246750435934497,45.03220107525914,277.3572798964472,258.75637474060056,240.15546958475394,260.25892857142856,3.8760960068176735,254.1366070338658,7.346958744673437,258.4922665822071,259.3195522562143,1.7902101275979279,-4.075112530199612,22837700,5.101770439231309,0.7944796886327868,-734991000.0,-32.5494714670825,89.02914134005623,91.58768807638091,-2.433891801581971,21.148988303272688,26.022615583140585,-0.02984170718022148,7.753733836131434,261.9775493774414,258.066210357666,254.90499114990234,251.74377194213866,247.83243292236327,0.04,0.0,292.2172190275859,-0.030332760841313422,0.0027814267178365537,255.69698006766183,249.62898145403182,9.105088036157705
2022-07-05,0,259.1825065612793,243.9000015258789,271.1824951171875,251.66062355041504,266.4968738555908,-0.0630526905569447,9.010409630904736,-1.2361266096941115,2.9951226821460675,257.2224979400635,7.634976558685304,0.034897726012703266,245.26074981689453,270.54800033569336,0.7987939183094773,-0.0479028742454923,1.003825627442977,1.0070277432648411,0.9967388721373556,-0.026251988036724017,45.874282176291686,276.21556890322796,258.19474964141847,240.17393037960895,260.5910726274763,3.6277044938369762,255.18678610665458,6.897503477856586,258.3221436258694,258.7866525094297,1.7569307302432657,0.35746420583439287,22941000,5.086707670455128,0.8052417761160396,-712050000.0,-20.34334847061783,89.02914134005623,91.58768807638091,23.23991390838343,22.494724620531073,24.056059085020333,0.026664894697909232,7.788468170994952,261.9775493774414,258.066210357666,254.90499114990234,251.74377194213866,247.83243292236327,0.04,0.0,292.0714954863054,-0.0077012315816498145,-0.01811734455586585,256.25614275251115,251.07171085902624,8.759054626305357
2022-07-06,0,265.0874938964844,243.9000015258789,271.1824951171875,251.66062355041504,265.1443786621094,-0.024242246374811226,8.56059778017721,-1.0848026494798286,2.995179856505548,257.2224979400635,7.009901885986329,0.03322871592093721,245.26074981689453,269.6525047302246,0.7705824194098372,-0.042025083457981345,1.0289605066221337,1.0250077064274368,1.024956184736015,0.01596253878148124,48.193245599142266,274.7476954993193,257.62649993896486,240.5053043786104,260.63178525652205,3.6840076498897356,256.70017841884066,6.545989526479666,258.568265153527,258.2284923261084,0.9051744289764648,6.01378724090801,23824400,5.110347516428891,0.834164747222459,-688225600.0,-8.267395966437894,89.02914134005623,91.58768807638091,78.6234615057445,26.007068416236827,22.797396177449546,0.06371869001531404,7.631431760514621,262.3339116821289,258.64303408813475,255.65999603271484,252.67695797729493,248.98608038330082,0.04,0.0,291.94668706284983,0.03793693336203163,0.004983357099956757,256.0473371233259,252.59361812046595,8.613935123601006
2022-07-07,0,266.8999938964844,243.9000015258789,271.1824951171875,251.66062355041504,264.87375259399414,-0.08441816055865785,8.224257966964148,-1.0408335860877809,2.995221016033556,257.2224979400635,6.73275146484375,0.03195707835534929,245.26074981689453,267.685001373291,0.7244499893325042,-0.016564533831769267,1.0370958756709172,1.0268455029165156,1.0286511368509812,0.030919845592100037,56.09582168553133,273.8017656745289,257.3532497406006,240.90473380667228,260.7360703604562,3.872423526189713,257.87535667419434,6.808678499266684,260.1898103335879,258.4728760786937,0.10762300107000669,8.686958687188602,20859900,5.3104714342753905,0.7329358384680373,-667365700.0,-2.5345769288690647,89.02914134005623,91.58768807638091,101.59296355712428,26.025780393005377,21.90534357408192,0.05549204380451022,7.3748974228554625,262.9145591430664,259.112720123291,256.04000091552734,252.96728170776368,249.1654426879883,0.06,0.0,291.8464064315543,0.031276384972948046,0.04647532845451034,256.53921944754467,253.7595716203962,8.296250605365286
2022-07-08,0,265.9600067138672,243.9000015258789,271.1824951171875,251.66062355041504,264.87375259399414,-0.13145657122545298,8.045915343565289,-1.0367039524096406,2.995242219766157,257.2224979400635,6.600125885009765,0.031280210791093006,245.26074981689453,266.9577445983887,0.6809684636536425,-0.01579195301249996,1.0339762123726064,1.017840752046808,1.0187423535313136,0.036567958043569604,57.697843833367884,273.3124548478972,257.2206241607666,241.128793473636,261.45571299961637,4.351312772066611,259.3476785932268,6.081001067061473,261.858411167904,259.07657699796147,0.27425920748427646,6.569239335674611,19658800,5.314000115118253,0.6879703181829476,-687024500.0,-5.593263942315312,89.02914134005623,91.58768807638091,95.585742267305,24.708801099424356,22.51002551334364,0.09942563244405998,7.213115583570366,263.1529178466797,259.49853802490236,256.5449981689453,253.5914583129883,249.93707849121094,0.06,0.0,291.7482481484646,0.04216787094183605,0.02843306094822281,258.105967930385,255.3494426182338,8.097590853216486
2022-07-11,0,264.7174987792969,243.9000015258789,267.47750091552734,251.66062355041504,264.87375259399414,-0.2779750888650269,7.664249219153615,-1.1263911995936273,2.995286103732752,257.2224979400635,6.33900146484375,0.02982668174124965,245.26074981689453,266.24299774169924,0.6951464347234365,-0.005673352698698196,1.0301915245263475,1.0095687153033017,1.006746692825967,0.027679918984692797,57.64389165914113,272.2879981789078,256.95949974060056,241.63100130229333,262.2874984741211,4.336712757827956,260.63321440560475,5.015067035557664,262.84530208921353,259.44347401130113,1.930649259853212,8.401351910769225,19455200,5.254241370566482,0.6892690015126208,-706479700.0,-23.27359121593404,89.02914134005623,91.58768807638091,78.60992429991003,23.344511899591367,22.385554885340984,0.14809305399350178,7.089320688763873,264.4461968383789,261.59189639282226,259.28499603271484,256.9780956726074,254.12379522705075,0.06,0.0,291.6444716819361,0.018992387812470257,0.029903069501126953,258.7015598842076,256.5308107648577,8.0846501341215
2022-07-12,0,259.3824996948242,243.9000015258789,266.8999938964844,251.66062355041504,264.7387504577637,-0.32448755094880116,7.496638051970323,-1.1154536132958803,2.995304782815167,257.2224979400635,6.204601211547851,0.029190071947481213,245.26074981689453,265.981005859375,0.7901378616185535,0.031353506845610904,1.0099719068095427,0.9892543862402547,0.9811362495475693,0.0007716305247540411,60.165026709567655,271.8147757377297,256.8214996337891,241.82822352984843,262.68821389334545,3.819975928552567,261.1558930533273,4.396562730097207,263.25305659189377,259.71913114392135,2.2489805949277457,7.294707183250361,35868500,4.6225322233955595,1.260838585875416,-742348200.0,-82.34348517554545,89.02914134005623,91.58768807638091,1.5194095100565146,20.285024647620865,29.01238070734964,0.14759571344108482,7.575804673672306,264.64915698242186,261.92041662597654,259.7149963378906,257.5095760498047,254.78083569335936,0.06,0.0,291.4052317504496,-0.034924977228527165,-0.02276741154643843,258.2587214878627,256.5259050641741,8.067814855188644
2022-07-13,0,251.1425018310547,243.9000015258789,266.8999938964844,251.66062355041504,264.7387504577637,-0.3739892956563793,7.517178742210233,-1.1102569338607404,2.995302680046872,258.24124908447266,6.307913570404054,0.029254603253798733,245.26074981689453,265.981005859375,0.800548438326822,0.060955907151878645,0.9773712323719081,0.9603139402662426,0.9498240538423388,-0.05260524312352188,55.75497570901687,271.9914823852383,256.95712490081786,241.9227674163974,261.7675001961844,5.6110822194071845,261.0132143838065,4.698735040713779,262.2459887962945,259.5033385856819,1.0932400637821,2.903021485720813,29497400,3.8221956060881754,1.06811905036933,-771845600.0,-77.99522061153156,89.02914134005623,91.58768807638091,-68.51286233658458,19.201017155911305,31.239227676603708,0.25639931445358727,7.4318167369348735,264.1157982788086,261.05709872436523,258.58499908447266,256.1128994445801,253.05419989013672,0.02,1.0,291.17825312955443,-0.050674439949450645,-0.038539179242263855,257.29737636021207,256.49717821393693,7.37724274847347
2022-07-14,1,251.43250274658203,243.9000015258789,266.8999938964844,251.8343744277954,264.7387504577637,-0.3416156333705729,7.092500483746852,-1.0207069620460363,2.9953510381237596,258.24124908447266,5.941475944519044,0.027566145562555232,246.58274765014647,265.981005859375,0.7147727923376549,0.029694548010928645,0.9772329216970742,0.9650317311460547,0.9610581073371812,-0.05795238480185694,43.84415514097853,271.4752509827525,257.2902500152588,243.10524904776506,260.6603567940848,6.836849623410657,260.6257147107805,5.258204702701543,259.45960234939196,258.5484814593571,-2.502060828803642,-0.7890895741510064,25102800,4.316818421832623,0.9148659151146508,-746742800.0,-64.79238274753298,89.02914134005623,91.58768807638091,-75.04606943695065,17.531560722815307,30.57389034742084,0.2719067561097927,7.558116719703179,263.6036787109375,260.2281594238281,257.5,254.77184057617188,251.39632128906248,0.04,0.0,290.98836350185195,-0.053353100201586345,-0.045565685587321235,256.068357195173,256.16224997384205,6.775081155842206
2022-07-15,1,256.8950004577637,245.3474998474121,266.8999938964844,251.90687465667725,264.7387504577637,-0.21496015316331982,6.550758665846811,-1.091500734570661,2.995408444028674,258.24124908447266,5.535126113891602,0.025423363650865723,250.07474822998046,265.981005859375,0.7640396204700645,0.003932977696524024,0.997004370009526,0.9888297443445234,0.9936873073874997,-0.034084095455209185,41.67064425028149,270.76839240798756,257.66687507629393,244.5653577446003,259.4900005885533,6.651382143585262,260.0608929225377,5.199405539281816,257.43455978798613,257.6815948370211,-2.990172414612754,-2.1120642617156724,29774100,4.065176584765577,1.0917503165804943,-716968700.0,-53.37369785479332,89.02914134005623,91.58768807638091,-10.973682317526906,21.47941519494172,28.73438942645484,0.24469406974072863,7.46753554460001,263.6036787109375,260.2281594238281,257.5,254.77184057617188,251.39632128906248,0.04,0.0,290.7970878186027,-0.040872669818071805,-0.04351707225025639,254.73843383789062,255.39288548060827,6.61821932439684
2022-07-18,1,257.0349998474121,245.3474998474121,266.8999938964844,252.87125205993652,264.7387504577637,-0.31576519235220707,6.342896252789645,-0.8639702277323762,2.995429192463669,258.24124908447266,5.212751007080078,0.02458589359164319,250.70025138854982,265.981005859375,0.702429169408581,0.04706589884768848,0.9963012011740175,0.9892477242067756,1.0012504154219488,-0.029021500155114066,52.05695328739124,270.67504268868475,257.98925018310547,245.30345767752618,258.08071572440014,5.811794724769169,259.40839304242814,4.940522474594798,257.27343515942846,257.4984072840938,-3.090486585504422,-2.9861896588454013,20975000,4.044810636219623,0.7866947138803515,-695993700.0,-64.05709639438435,89.02914134005623,91.58768807638091,-36.67784704042237,19.93134260539759,28.06856065387345,0.22793540218870514,7.472711146901089,263.6036787109375,260.2281594238281,257.5,254.77184057617188,251.39632128906248,0.04,0.0,290.6590316788521,-0.03878876244674079,-0.05010082195258108,252.75547354561942,254.64734649658203,5.93154433509625
2022-07-19,1,257.6274948120117,246.71999740600586,266.8999938964844,255.71811962127686,264.7387504577637,-0.1983367190144566,5.652050587237016,-0.8456020301550651,2.995492988313449,258.24124908447266,4.628376007080078,0.021858573484571722,251.40350265502929,265.981005859375,0.6408909719478298,0.04180853822088745,0.9963409633506751,0.9917389355463987,1.0096011360237258,-0.0067660882475777395,51.77204367849524,269.87772635757955,258.5736251831055,247.26952400863144,256.8903568812779,4.670211469303086,259.1730349404471,4.941328502115825,257.23159759370463,257.6037344078273,-3.696138731609843,-3.432016524918399,25012600,4.041908113761283,0.9710397411347483,-670981100.0,-41.21972660890501,89.02914134005623,91.58768807638091,-24.75012652614988,18.764639457565554,26.42553646236113,0.2714757621843149,7.370374340950848,263.6036787109375,260.2281594238281,257.5,254.77184057617188,251.39632128906248,0.04,0.0,290.5029836809061,0.02310082521868506,-0.018827343917872885,251.61614772251673,254.8610578264509,5.320158262187297
2022-07-20,1,261.4874954223633,251.1425018310547,266.8999938964844,256.78749656677246,264.7387504577637,0.05633251301106208,4.96664631835056,-1.1061922121579841,2.9955486230890576,258.2612476348877,4.105401096343996,0.01916743394859855,252.0017490386963,265.981005859375,0.655652316923221,0.022067705614060327,1.0091405700410596,1.0072009497032537,1.0261393359206905,0.04119172786718406,50.61762900933561,269.0522926901069,259.1190000534058,249.18570741670467,256.42892783028736,3.856690422685022,259.35821315220426,4.9785447852447975,257.3620608945628,257.8482550045926,-3.1329943192624423,-1.2628321910453137,22788300,3.880836074221838,0.8971215367551028,-648192800.0,-29.36855527220313,89.02914134005623,91.58768807638091,39.03236926909085,22.725987738846985,24.878029669498222,0.24481013799166473,7.2696318782413565,263.6036787109375,260.2281594238281,257.5,254.77184057617188,251.39632128906248,0.04,0.0,290.38084281138674,0.03778892562162528,0.033902410339068254,251.30223955426897,255.00189971923828,5.170943834896375
2022-07-21,1,261.6375045776367,251.1425018310547,266.8999938964844,256.8856248855591,264.7387504577637,-0.06121446590729781,4.715735228590717,-0.952483031013112,2.9955671904803642,259.0387535095215,3.9326501464843773,0.018166080972960984,252.96925315856933,265.981005859375,0.6102044289611402,0.032975792495661446,1.0078869706052596,1.009178135921717,1.0184588906586385,0.040587440842285494,56.28658448013214,269.0215953503699,259.5901248931885,250.15865443600703,256.75107138497486,4.221445561728832,259.71964263916016,4.944699776441052,258.4229973563366,258.6256394344854,-1.220169944120901,1.0013692655384248,22404700,3.959412139919036,0.8882007657935251,-625788100.0,-18.25260429041336,89.02914134005623,91.58768807638091,37.194319311225385,20.98098136132671,24.80435937231283,0.3000489748585664,7.311802485149426,263.6036787109375,260.2281594238281,257.5,254.77184057617188,251.39632128906248,0.02,1.0,290.2627683033689,0.04234877778172996,0.047958132558893016,252.86758640834265,255.56315394810267,5.015161941617064
2022-07-22,1,262.49999237060547,251.1425018310547,266.8999938964844,257.0,264.7387504577637,-0.20265030188129005,4.492997285862679,-0.70255872038592,2.9955827869957194,259.28250312805176,3.7550005531311057,0.01727976188497529,256.06299285888673,265.981005859375,0.6280600716389337,0.018609565392353887,1.0095571117401572,1.0145642808631439,1.0137620357138042,0.021818221074190625,55.115143872264674,269.0009945335784,260.01499996185305,251.02900539012768,258.37357003348217,3.8749224248331804,260.07053511483326,4.956047367775434,259.2538113802839,259.5325212853907,0.869374335379457,1.9721187477001647,21881300,3.8833621495638924,0.8743493217602147,-603906800.0,-37.629818531248844,89.02914134005623,91.58768807638091,22.305153694715695,20.118865086510038,23.271730232860737,0.23424740516966988,7.236671721490525,263.6036787109375,260.2281594238281,257.5,254.77184057617188,251.39632128906248,0.04,0.0,290.14568303567063,0.014178838738620136,0.024716549692519296,253.93824332101005,255.61780984061105,4.999336626492355
2022-07-25,1,259.53499603271484,251.1425018310547,266.8999938964844,257.44937324523926,264.7387504577637,-0.3703343484464733,4.462924909036346,-0.5780782914862397,2.9955849607016325,260.15250396728516,3.72137508392334,0.01714550214360288,256.06299285888673,265.981005859375,0.6855762427948864,-0.008695208975724868,0.9970720819902189,1.004447795526524,0.9979908236505282,0.009726287030119796,53.192085993060466,269.2229744900087,260.29712467193605,251.37127485386335,259.53106907435824,2.376342071821968,260.0957129342215,4.9520827330259625,260.0796406723684,260.30529379105565,4.5223291385346815,1.90711688380619,21056000,3.441800283874874,0.8635719544180342,-624962800.0,-44.24746170782316,89.02914134005623,91.58768807638091,-17.369050388752758,19.16350128421483,24.454894726319587,0.1711020618226277,7.054765575860161,263.6036787109375,260.2281594238281,257.5,254.77184057617188,251.39632128906248,0.04,0.0,290.0239724071186,0.018013699103646585,0.008218977386602948,254.60389709472656,255.33612714494978,4.741407235552934
2022-07-26,1,255.30249786376953,251.1425018310547,266.8999938964844,257.44937324523926,263.0543689727783,-0.27577932149495415,4.3430923648742334,-0.4463421872668252,2.9955925637370315,259.45874786376953,3.507874927520754,0.016702033402410284,256.06299285888673,265.981005859375,0.6419125309194752,-0.024927685997198877,0.9818052412438014,0.9900530275134726,0.9798317114379724,-0.009024646029876293,46.5391548050772,268.71993392866204,260.0337491989136,251.34756446916512,259.3035687037877,2.721876547997202,259.3967846461705,4.8833990931774585,259.917741066326,260.17402935850856,3.2225321697168514,0.13600048711320212,39348000,3.478936454572208,1.566457708766976,-664310800.0,-74.22148480192597,89.02914134005623,91.58768807638091,-106.01674718196863,17.226890386739033,29.080094594667635,0.14073044904397242,7.287283566871472,263.6036787109375,260.2281594238281,257.5,254.77184057617188,251.39632128906248,0.04,0.0,289.76084886071885,-0.029399287762930992,-0.009242878552923202,253.92842755998885,254.33343069893974,4.948791116042376
2022-07-27,1,264.6999969482422,251.1425018310547,266.8999938964844,257.0,261.8531265258789,-0.1365432563204982,4.219449522310429,-0.44832481721799855,2.995599958447688,259.28250312805176,3.3334122276306175,0.01626052425098476,254.91549835205078,265.1747451782227,0.6598453420205458,-0.021539001805136224,1.0200763622965847,1.0281228635631232,1.0177148504608151,0.01228548814806607,41.48381003026507,267.9292732282757,259.4903741836548,251.05147513903395,260.3985682896205,3.1631612917521537,259.23964200701033,4.653359625726673,258.7291789225393,259.4189572682847,-0.6199040818842114,-3.6912326148950076,45994000,3.4104293508907833,1.7653321829030606,-618316800.0,-5.4334232870400845,89.02914134005623,91.58768807638091,107.16029986034741,23.466301667946652,24.404471252373224,0.2540986184888545,8.063195850158191,264.36003125,260.83997338867186,257.9949951171875,255.15001684570314,251.629958984375,0.06,0.0,289.55988310516165,0.02466892923856223,0.03548706992085176,255.9590301513672,254.3572518484933,5.277405231124857
2022-07-28,1,272.9674987792969,251.1425018310547,266.8999938964844,257.0,263.04999351501465,-0.17019068352694833,4.361483553643554,-0.6454018365151346,2.995591076401583,259.28250312805176,3.5555993652343774,0.016795656860673386,254.91549835205078,265.1747451782227,0.5627856963961144,0.022422203905886343,1.0511717830010732,1.0546808998884256,1.046915455674316,0.043304167038094254,58.20880252834711,268.4022157263667,259.6792486190796,250.9562815117925,262.5899974278041,5.427033718771339,259.740177154541,5.692654370562658,260.2079535603518,260.1239836524054,2.98208302580597,-0.8242776315294498,33459300,4.007102279500988,1.2520555413878312,-584857500.0,-4.482736518450701,89.02914134005623,91.58768807638091,198.3928723134619,28.21442672764613,22.284856397139237,0.2755067628428532,8.199396951385259,270.31159777832033,265.6541986694336,261.88999938964844,258.1258001098633,253.46840100097657,0.08,0.0,289.46544967760985,0.04368673158439651,0.05391373062931794,258.32456970214844,254.9703587123326,6.3625055279940534
2022-07-29,0,279.2675018310547,251.1425018310547,272.9674987792969,257.0,264.70437240600586,0.3164007900204155,5.2273873133027635,-0.05047449360898293,2.995531142395814,259.45874786376953,4.25116195678711,0.02007577242823912,254.91549835205078,266.0540054321289,0.50349765381791,0.06387936411178965,1.07252638408781,1.0701185650786222,1.0618495962177097,0.06387622837251872,67.82202554554881,270.83764816176176,260.38287353515625,249.92809890855074,265.12999834333147,8.251046194275133,260.7794630868094,7.659600030502146,263.3982280357277,261.7841542430018,5.9543349511194865,2.634791656088613,32152800,4.326760543912048,1.2022169717314792,-552704700.0,-3.494203690883825,89.02914134005623,91.58768807638091,227.00645616542747,30.516781440234613,21.17440449504849,0.29618634324823995,8.013010281389256,273.4898405761719,268.2250809326172,263.9700012207031,259.7149215087891,254.45016186523438,0.1,0.0,289.4092053821525,0.07827626465699478,0.06003629215750627,260.91292681012834,256.10758318219865,7.60560059947471
2022-08-01,0,278.2375030517578,251.1425018310547,279.2675018310547,257.44937324523926,264.80999755859375,0.8340804474297092,6.568553836410304,0.837379345607907,2.995418918424515,260.51124572753906,5.008112144470215,0.02511708394348731,254.91549835205078,267.5067443847656,0.5717926138229812,0.08416559154661153,1.0639350600491555,1.0571092806627398,1.0446134938098885,0.07206159980323235,72.39259673758603,274.6544817115169,261.5173740386963,248.38026636587568,267.50142669677734,9.387243469461541,262.12624904087613,8.944878823484547,267.39232009231307,264.1396431941705,6.799562778316626,5.496426612843074,21539600,4.494246139864227,0.8073408662808426,-574244300.0,-11.064865514457344,89.02914134005623,91.58768807638091,172.34354408966487,29.002198410539542,20.844248385751175,0.24909679890987435,7.829223172160257,273.4898405761719,268.2250809326172,263.9700012207031,259.7149215087891,254.45016186523438,0.1,0.0,289.3664083645936,0.07410282915915745,0.06779082214907242,262.75855582101,257.81307111467635,8.32296843049628
2022-08-02,1,275.2725067138672,251.1425018310547,279.2675018310547,257.4793710708618,265.3056221008301,0.7317072553968257,7.435440942782012,0.089259199027103,2.9953338673915146,261.5625,5.7438499450683596,0.028320108560112446,254.91549835205078,273.49449920654297,0.6995328497423043,0.07351960880111824,1.048457964193604,1.037486900046876,1.019169207222988,0.07822096930972355,70.270349868624,277.4207561912891,262.5498743057251,247.67899242016105,269.3260716029576,9.493788107732593,263.8498208182199,8.99030561558452,270.1503158262208,266.0109587135036,6.34465555728281,7.26918869974551,22754200,4.5184501388309055,0.8531648165781133,-596998500.0,-19.911240049627036,89.02914134005623,91.58768807638091,116.66671976727012,27.48201067856976,22.972980435435815,0.20265523440932556,7.672135488818437,273.4898405761719,268.2250809326172,263.9700012207031,259.7149215087891,254.45016186523438,0.1,0.0,289.3078989064342,0.09098853490441439,0.06177810900323806,264.78496224539623,259.3616027832031,8.707481367232992
2022-08-03,0,279.83499908447266,251.1425018310547,279.2675018310547,257.4793710708618,266.1950035095215,0.5204812835910821,7.884470321121262,-0.49429981595374484,2.99528627548235,262.0687484741211,6.292063179016111,0.02993863436549513,254.91549835205078,275.5690063476562,0.7884699646584683,0.03842132522992586,1.0625796507617853,1.0477150547367173,1.0209639846506788,0.05717794601709003,63.803426950605456,279.123314955597,263.35437431335447,247.58543367111196,272.226072038923,9.096651894117372,265.8785705566406,9.175415793959823,271.4659436657819,267.2867591077429,4.865719891233023,9.608092898208414,23518900,4.445483880575254,0.882342458676717,-573479600.0,-3.0356587139262,89.02914134005623,91.58768807638091,148.49616983813823,30.456211149793177,21.133742226238475,0.2174690460822306,7.744125569885098,275.4925217285156,270.53874279785157,266.5350036621094,262.5312645263672,257.57748559570314,0.12000000000000001,0.0,289.27241248473734,0.05109060651298569,0.1213578546124363,268.0978480747768,261.3508725847517,9.623943083920768
2022-08-04,0,282.35499572753906,251.1425018310547,279.83499908447266,257.4793710708618,268.4168701171875,0.4802277892641996,8.663227714848313,-0.8331473632301032,2.9951968465386645,262.0687484741211,7.103175964355467,0.03280385596620732,254.91549835205078,278.3405029296875,0.782079266437834,0.048463864682608604,1.0691549288621525,1.0499376073147138,1.0189054179465584,0.03439052997233305,67.51214525860672,281.4182050024505,264.0917495727539,246.76529414305725,276.09071459089006,5.889736156273104,267.69714164733887,9.762229246596998,273.5527667002356,268.9345033944411,7.821682378895431,11.296270779485262,18098700,4.528675204136929,0.6825317032350178,-555380900.0,-0.4381945137868565,89.02914134005623,91.58768807638091,140.39860359397068,29.68388128025146,20.398242899374136,0.22342597673249484,7.450256557782898,275.72171240234377,270.72413525390624,266.68499755859375,262.64585986328126,257.64828271484373,0.14,0.0,289.250719822257,0.026193114384901905,0.05548141713557545,272.54725428989957,263.2378409249442,10.476774606138662
2022-08-05,0,281.09749603271484,251.1425018310547,282.35499572753906,257.4793710708618,273.54375076293945,0.46845522587264293,9.52561640691807,-1.033850749618391,2.995088927078534,262.0687484741211,7.984351425170905,0.035964111532466536,254.91549835205078,279.32425155639646,0.804088570808357,0.06164456534741484,1.06128792793667,1.0372706632100672,1.007541375484771,0.006552836222122327,69.97029020391736,283.9157324781428,264.86449966430666,245.81326685047057,278.43321446010043,3.2924718291374693,269.4158913748605,9.858402817083467,275.73442422966014,270.3576792819308,10.596252715946735,9.910662030949602,16774600,4.52940549613435,0.6360568464478553,-572155500.0,-2.600013551488524,89.02914134005623,91.58768807638091,115.28411344397585,28.235004807157765,20.865944602176434,0.2165280769792102,7.27309486390191,275.72171240234377,270.72413525390624,266.68499755859375,262.64585986328126,257.64828271484373,0.14,0.0,289.22837649336645,0.007729633693995597,0.023515919165294042,274.5330287388393,265.24602944510326,11.161735116247751
2022-08-08,0,282.40250396728516,251.1425018310547,282.35499572753906,257.4793710708618,276.01375579833984,0.36563237260509857,10.16267734136074,-1.2991583259852066,2.995003472276164,262.0687484741211,8.968288230895997,0.03826001342940651,254.91549835205078,279.96124877929685,0.8440388600538148,0.06187727418456185,1.0631768805954878,1.0349835437188715,1.0108927881238519,0.014969229057351763,68.20257430647774,285.9467288129705,265.621374130249,245.29601944752753,279.7810723440988,2.523436467539642,271.1855348859514,9.80301467863656,277.04960433333,271.2261290139938,6.194748497741359,9.361564066989844,18739200,4.529773487484568,0.7115161180088848,-553416300.0,-15.405791370621023,89.02914134005623,91.58768807638091,100.13343093177767,28.63689092897728,19.504447116553603,0.18939474393735645,7.225016944515575,277.3414119873047,272.0343110961914,267.74501037597656,263.4557096557617,258.14860876464843,0.16,0.0,289.2039268507209,0.008309090931471141,-0.0014959723437930612,275.0809762137277,266.70277295793807,11.58060168146922
2022-08-09,0,280.6574935913086,251.1425018310547,282.40250396728516,257.4793710708618,278.49500274658203,0.24661298975979082,10.795257228117787,-1.4932747653944094,2.9949142745490214,262.0687484741211,9.939001007080083,0.04050667693352101,254.91549835205078,281.22324600219724,0.8539805973231466,0.08874925756188279,1.053101578002606,1.0200395015017008,1.0016595493656195,0.01956238544025335,71.92613355247849,288.09613884588407,266.50562438964846,244.91510993341285,279.97964259556363,2.5309661578001705,272.5548204694475,9.682279962006053,278.34956309151676,272.05341156309197,3.4564573548797437,9.616601354351374,23405200,4.287863296512384,0.9102181763241461,-576821500.0,-9.958803375319134,89.02914134005623,91.58768807638091,83.68101478897698,27.060916850706263,20.15149068025837,0.2799041458937457,7.099658313448417,277.3414119873047,272.0343110961914,267.74501037597656,263.4557096557617,258.14860876464843,0.16,0.0,289.17008343653515,0.027217765670930927,0.015431025000120294,275.2995910644531,268.10625893729076,11.631482196282231
2022-08-10,0,288.52000427246094,251.1425018310547,282.40250396728516,257.4793710708618,279.4093761444092,0.056294263564084346,11.085253268741083,-1.5975165421808357,2.994874396064925,263.5999946594238,10.396813201904298,0.04142945472242809,254.91549835205078,281.22324600219724,0.8467018015821256,0.11752288658854265,1.078299806394786,1.0390405646672805,1.0257777919453912,0.031036164941493194,72.52931603129193,289.73988062195474,267.56937408447266,245.39886754699057,281.44857134137834,3.9419370008439945,274.47499901907787,10.010706563561808,278.90326358270886,272.78494106398944,0.49772771666600646,7.33113380354242,24687800,3.7453024522077714,0.9691616985669929,-552133700.0,-1.615293375317765,89.02914134005623,91.58768807638091,117.46746039207112,31.767814713774946,18.63515945092999,0.26882422817745383,7.12896921072556,280.3133598632813,274.4383212890625,269.69000244140625,264.94168359375,259.0666450195313,0.18,0.0,289.1677733615963,0.023684002430879314,0.05217979844997745,276.86214338030135,269.8103496006557,11.903678638564136
2022-08-11,0,288.89749908447266,251.43250274658203,288.52000427246094,259.05812072753906,280.04062271118164,0.02407774162347406,11.306833529880421,-1.5182248027560896,2.9948516790605373,268.83374786376953,10.623001098632812,0.04196447075787282,256.73575019836426,282.3597465515137,0.7922430960707517,0.14750480196770452,1.0722215570181084,1.0315511295106632,1.0208157777043685,0.02317119744977636,78.19771131518777,292.05191626630386,269.438249206543,246.82458214678212,283.3949988228934,3.7429020506554393,276.3605352129255,10.067539101532999,281.3118502254898,274.87054939258604,3.6955842069896563,10.274711853035301,20065900,3.9848981971458644,0.7955867828690669,-532067800.0,-10.06244965953539,89.02914134005623,91.58768807638091,105.18334822512979,31.672219020826297,17.735711839030774,0.2020646539410941,6.955469666387449,281.38295520019534,275.30351751708986,270.38999938964844,265.476481262207,259.3970435791016,0.19999999999999998,0.0,289.1645424720366,0.01188086300030311,0.016107879410236434,278.57183837890625,271.6784003121512,11.849036179314677
2022-08-12,0,289.8100051879883,255.30249786376953,288.89749908447266,260.9993705749512,280.76749420166016,-0.017804845689909726,11.27200934206046,-1.5359177108966062,2.994868647100394,274.12000274658203,10.5083512878418,0.04154637522785836,257.02099990844727,283.01425399780277,0.8304892608557471,0.12457423682704383,1.0681817992644418,1.0289566191263735,1.0193271751759008,0.0309946167370323,77.58480660338961,293.85551770755836,271.3114990234375,248.76748033931656,284.8199996948242,4.048049132945221,278.5230358668736,9.405150851856924,283.22886337452496,276.69732919595555,4.949637918169579,10.056193326130991,22619700,3.9101969034533717,0.909744652766131,-509448100.0,-0.0,89.02914134005623,91.58768807638091,108.34551745041826,30.755886697950903,16.81165589521173,0.2686351888090052,6.81365016100928,281.9177645263672,275.7361250610352,270.74000549316406,265.74388592529294,259.56224645996093,0.2,0.0,289.168830630036,0.03181212636704367,0.029120271926080188,279.89474051339283,273.9962942940848,12.098027233093196
2022-08-15,0,292.1899948120117,255.30249786376953,289.8100051879883,261.60000228881836,281.4118709564209,-0.14045348820630488,11.448478752123092,-1.4526801251853545,2.9948505631778652,276.7550048828125,10.383301620483394,0.04194238761990242,257.56824531555174,288.5577537536621,0.8316227000830158,0.12751183831008592,1.070460651271243,1.0335380581698392,1.021437975110386,0.03465794639646824,78.18967434610302,295.85420676419494,272.95724925994875,250.06029175570256,286.2249995640346,4.703591212001367,281.1578570774623,7.33977381432128,284.8938588621902,278.28538642110857,3.564602760966476,11.665097045894042,18085700,3.89792444354491,0.7316421463773788,-491362400.0,-2.0096001271494255,89.02914134005623,91.58768807638091,115.17509524735114,31.85491785193655,16.073117401079113,0.32575950599967723,6.617675248344458,285.84211584472655,280.6839378051758,276.51499938964844,272.3460609741211,267.1878829345703,0.2,0.0,289.1795596089982,0.04691062245671307,0.03732632063941165,281.2709001813616,276.9090772356306,11.992069561378925
2022-08-16,0,292.29000091552734,255.30249786376953,292.1899948120117,262.2843704223633,282.3668727874756,-0.23532160064297283,11.567065544734332,-1.3085670820765654,2.994842453251403,278.75250244140625,10.196251525878903,0.04210569348778063,259.34424591064453,288.9887496948242,0.8228863654506883,0.13415687648253508,1.0639753998536694,1.02881430136882,1.0148429822576543,0.04144734272143791,79.69158392133292,297.8491300976474,274.7149990081787,251.58086791871006,287.8239288330078,4.570549693734095,283.1285716465541,6.1957248226183985,286.7118559512664,280.11053419194326,3.4832034967651238,14.448545257839784,18102900,3.8910204453605637,0.7427184227023728,-473259500.0,-5.587234348575498,89.02914134005623,91.58768807638091,106.22113392733011,30.56863588628752,15.424094818730476,0.29214260165136896,6.403554808480055,287.97083325195314,284.12957360839846,281.0249938964844,277.9204141845703,274.0791545410156,0.2,0.0,289.1896155712404,0.03687570362964898,0.04419941068044313,282.6442565917969,278.5886426653181,11.965062242794312
2022-08-17,0,290.9700012207031,255.30249786376953,292.29000091552734,264.149995803833,283.9318790435791,-0.3528646472491374,11.473368145937082,-1.1475567166178282,2.9948663622990983,279.5512504577637,9.81825057983399,0.04150278890274545,261.29224548339846,290.0480041503906,0.8460878586678531,0.1177972409097836,1.0525302059596833,1.0180699880385782,1.002164693522494,0.00849160166353169,79.10632024142517,299.3948606052286,276.44812431335447,253.50138802148035,289.04785701206754,3.98663328300177,284.41446467808316,5.778756870057459,288.08380370292736,281.75060602064616,3.981716322905234,10.423122132744087,18253400,3.8777810406801594,0.7559252986746439,-491512900.0,-13.119206206550924,89.02914134005623,91.58768807638091,93.61746985248422,29.207315632847433,15.827598219652023,0.28711560019598353,6.223300905840824,289.03519555664064,285.8523973388672,283.2799987792969,280.70760021972654,277.5248020019531,0.2,0.0,289.1965117081514,0.009608183594231212,0.03414229253890295,284.2724347795759,279.6767054966518,11.866762761047605
2022-08-18,0,290.3375015258789,255.30249786376953,292.29000091552734,270.9006233215332,288.61437797546387,-0.5371053238084301,11.349817436714217,-0.9049725189810607,2.994891802332477,280.2462463378906,9.354075393676755,0.04083810293316154,261.42725372314453,291.092000579834,0.8500214296259679,0.11211120779652009,1.0446716732479315,1.0119145196060872,0.9983014263659644,0.004984475275728206,75.41362150836505,300.62188447669985,277.9222496032715,255.22261472984317,290.4307152884347,1.4853941761251113,285.2051789419992,5.777678099065581,288.76664358591,283.02492810872496,3.0337894080466326,6.595108400052367,17186200,3.92078808413509,0.7195042152006789,-508699100.0,-18.39441052045099,89.02914134005623,91.58768807638091,82.18443886799109,28.220160966118197,15.7584388204373,0.23568761791957377,5.980923070233232,289.03519555664064,285.8523973388672,283.2799987792969,280.70760021972654,277.5248020019531,0.2,0.0,289.2000292489186,0.013120713315562638,0.005622767523097909,285.4616437639509,280.380617414202,11.703844735268962
2022-08-19,0,287.4649963378906,255.30249786376953,292.29000091552734,274.6962547302246,289.12562561035156,-0.748210861747183,11.009378241856478,-0.5041892566100783,2.9949475594011483,280.8774948120117,8.707550201416018,0.03940967439901724,262.20349273681643,291.092000579834,0.8470064004626168,0.10604765700705848,1.0290228619559714,0.9991232582575741,0.9874467207269284,-0.008091538622265748,73.44553724869114,301.3760059343965,279.3572494506836,257.33849296697065,290.27999986921037,1.742796674634736,285.86428560529436,5.438019293359918,289.13784710790094,283.9115800937267,3.449046669199672,3.963941247099031,20570000,3.948574123772584,0.8635381007325381,-529269100.0,-36.83487741165996,89.02914134005623,91.58768807638091,52.552703400561896,26.640602700642198,19.1502050715502,0.23396684827148312,5.883000969668467,289.03519555664064,285.8523973388672,283.2799987792969,280.70760021972654,277.5248020019531,0.02,1.0,289.1922271912712,-0.017651389428264164,-0.0009151213313449162,285.1249346051897,280.9935389927455,10.871909361031427
2022-08-22,0,279.8774948120117,255.30249786376953,292.29000091552734,277.49625396728516,289.12562561035156,-1.0067379114898045,10.427209736104139,0.17424701303121548,2.9950327162172363,281.72624588012695,7.972649688720708,0.03715967701682757,264.18349685668943,291.092000579834,0.8097298041601363,0.10761554600388132,0.9974055931264831,0.9706038228120654,0.962934850657923,-0.04213867763652068,67.62619315771,301.4599191212561,280.60549964904783,259.75108017683954,288.99142783028736,4.337855062191664,286.1932133265904,4.8562242022310205,288.7168280862558,284.3694935306125,-0.3656619710756785,3.316408889859938,25061100,3.9431627943889507,1.043305693468094,-554330200.0,-93.51158694813925,89.02914134005623,91.58768807638091,-25.582050271304425,23.855173586581234,26.912728428809668,0.19647811144859414,6.100643559714878,290.03347094726564,287.4682498779297,285.3949890136719,283.32172814941407,280.7565070800781,0.04,0.0,289.14925583011274,-0.05155706884982447,-0.046488414930209936,283.90846470424106,281.24015154157365,9.603116070312115
2022-08-23,0,276.78499603271484,255.30249786376953,292.29000091552734,279.01000213623047,289.12562561035156,-1.183068783907832,9.247721511760776,1.2309251813128395,2.9951857178917525,281.72624588012695,6.901125717163086,0.032837281895548416,272.14074859619143,291.092000579834,0.6866447949789091,0.0962583490325093,0.9828223014313042,0.9607204295164172,0.9604320687511517,-0.05304664830903161,53.655524378498114,300.1180676115343,281.6226245880127,263.1271815644911,287.1307122366769,6.284809595890754,285.97535596575057,5.2183188732287915,286.51347500252325,283.9270259928194,-3.1222161150739205,1.6728834103767578,17527400,4.2571892674337715,0.7643929326994574,-571857600.0,-94.46214796313839,89.02914134005623,91.58768807638091,-69.38892905040022,22.857946901773804,27.986605593546518,0.23760346219068895,5.912025290439775,289.7479129638672,287.00603314208985,284.7899932861328,282.5739534301758,279.83207360839845,0.06,0.0,289.11273075528567,-0.05357955149325111,-0.056030521242008476,281.822745186942,280.8587428501674,6.74028754264873
2022-08-24,0,275.88500213623047,264.6999969482422,292.29000091552734,279.01000213623047,289.12562561035156,-0.5367323965252632,7.134373679803777,-0.1205487104329852,2.9954122866884965,281.72624588012695,5.890600738525393,0.025236843693857598,275.04200592041013,291.092000579834,0.6776880962046468,0.0456554560778317,0.9759044015456046,0.9588854312646135,0.9677221482753611,-0.051843829333562685,44.64671028544248,296.96549685606755,282.69674949646,268.4280021368524,284.80142756870816,7.069696787165602,285.51321356637135,5.81588837055127,284.11300971494137,283.31907989728455,-4.4943269459674555,-1.0899290874037955,18137000,3.9047826811934794,0.8421329267148876,-589994600.0,-96.43406957429035,89.02914134005623,91.58768807638091,-91.63055355818217,22.244351868076162,27.602547504357087,0.15607518073484133,5.641167823082233,289.6794709472656,286.8952498779297,284.6449890136719,282.39472814941405,279.61050708007815,0.08,0.0,289.0725288445858,-0.05330898885743651,-0.055804655117440746,279.4271327427455,280.34901646205356,6.069634005313971
2022-08-25,0,277.42999267578125,272.9674987792969,292.29000091552734,279.01000213623047,289.12562561035156,0.08525241842853347,6.059073109092602,-1.359454482059563,2.9955036007777136,281.72624588012695,5.443200531005857,0.021390802363639133,275.82375259399413,291.092000579834,0.7344020448126919,0.010688097923674388,0.9794320082007103,0.9685085252674365,0.9835501629975375,-0.04445691232535165,39.00435492922099,295.37414597404455,283.25599975585936,271.1378535376742,282.6785692487444,6.665799595175504,285.25124904087613,6.1054728970480845,282.0819223509702,282.53399505280413,-5.580270702380314,-2.291439389849461,16583400,3.4746929777377384,0.8013942754583212,-573411200.0,-77.97550211962081,89.02914134005623,91.58768807638091,-78.09087113256516,23.258010645686976,26.006718832908042,0.14182718321546464,5.559655738166299,289.5402318115234,286.6698712768555,284.34999084472656,282.03011041259765,279.1597498779297,0.1,0.0,289.0399690337718,-0.039011562024454105,-0.042805052238891854,277.56776210239957,280.1060093470982,5.91573192227651
2022-08-26,0,273.87249755859375,275.2725067138672,292.29000091552734,279.01000213623047,289.12562561035156,0.21764363559055455,5.750394562072096,-1.48031571037699,2.995526812898112,281.72624588012695,5.26470077514648,0.020285072395418956,276.6949966430664,291.092000579834,0.8133556399798084,-0.00657974573921263,0.9661116954883178,0.9599322089260915,0.9799061538750558,-0.04728401354062617,39.0138238210519,294.9799135748277,283.47912445068357,271.9783353265394,280.23606872558594,6.240134858122033,284.64196286882674,6.797973751870574,280.92738648308534,281.9553184717271,-5.083994728933844,-1.30470865400621,27549300,3.1818860286499278,1.3462975388273768,-600960500.0,-99.58020828844023,89.02914134005623,91.58768807638091,-133.38595259041122,19.86145800646882,29.93598539016311,0.035610384941323,6.045394107498461,287.9967969970703,284.17159967041016,281.0800018310547,277.9884039916992,274.16320666503907,0.12000000000000001,0.0,288.96157747847917,-0.06311376775180155,-0.07609344536175297,274.305428641183,279.2889317103795,6.783597534790564
2022-08-29,0,265.58250427246094,273.87249755859375,292.29000091552734,278.0356254577637,289.12562561035156,0.1371875921111782,6.059847209248873,-1.4510899835321092,2.995503553510022,281.72624588012695,5.480500946044924,0.021397057302829512,275.82375259399413,291.092000579834,0.7848462141908756,-0.0156880558705707,0.9377602877302887,0.9361047277260222,0.9595783773302808,-0.05107588428698939,34.15775189647735,295.3290686555584,283.20937423706056,271.08967981856273,276.6996405465262,6.567336281284031,283.56517791748047,8.466750614689236,279.1631763951124,280.8780226067891,-5.876036564037672,-3.0205137308837613,20338500,3.2697445001878997,0.9968408987815736,-621299000.0,-95.45003134266335,89.02914134005623,91.58768807638091,-188.1875166120144,18.844768869020392,33.389711235359556,0.035297157672742635,5.9164365549148865,287.02211584472656,282.59393780517576,279.01499938964844,275.4360609741211,271.0078829345703,0.14,0.0,288.8815015019789,-0.04507654461181143,-0.07310849960120012,270.8029479980469,278.13229588099887,7.737799431753325
2022-08-30,0,264.3375015258789,265.58250427246094,292.29000091552734,277.26874351501465,289.12562561035156,-0.3910006543203613,7.1148245092528,-0.4997145758269248,2.995414172161565,281.72624588012695,5.986700897216792,0.025178390204517523,275.1325057983398,291.092000579834,0.7006072326590834,-0.03520149017816208,0.9354542407125086,0.9405371747777473,0.9650488769692518,-0.04497170975757914,26.13924074809809,296.8062733166013,282.5766242980957,268.3469752795901,273.39571271623885,6.045624548461097,281.8378562927246,9.747972305540788,275.75218218569563,278.9902379222887,-8.526283075151234,-5.371311888361601,22767100,3.6930021989220174,1.115837401242918,-644066100.0,-93.10859691018524,89.02914134005623,91.58768807638091,-187.2391395580474,17.39923946850469,34.65785024263641,0.026217543733816965,5.950261414179645,286.2692752685547,281.3753568725586,277.4199981689453,273.464639465332,268.57072106933595,0.16,0.0,288.7851531340723,-0.048726483373704554,-0.05321328658432314,267.54764229910717,276.33628845214844,8.667633573606013
2022-08-31,0,263.8249969482422,264.3375015258789,292.29000091552734,277.26874351501465,289.12562561035156,-0.6190715948821487,8.017952683952373,-0.342148908468233,2.9953256375659754,281.72624588012695,6.493876266479492,0.02842944461568727,273.04349822998046,291.092000579834,0.7812017937064683,-0.0553808408858664,0.9354505363926224,0.9481436422865385,0.9720121556479634,-0.04371388475127447,22.31325506735575,298.06577940660105,282.0298740386963,265.9939686707915,271.10249873570035,6.2192007221811405,280.0469632829939,10.61573907535938,272.9005122765508,277.51417967038464,-8.045325554985943,-8.381568830057804,24791800,3.4955760239120948,1.2112915050364619,-668857900.0,-97.58353871099608,89.02914134005623,91.58768807638091,-158.46478876488968,16.26169529766439,32.248198796444065,-0.07177123592832237,5.938099786581208,286.2692752685547,281.3753568725586,277.4199981689453,273.464639465332,268.57072106933595,0.16,0.0,288.68000778386374,-0.051923505960309924,-0.05415250306854564,265.26134817940846,274.5849064418248,9.73340853283815
2022-09-01,0,258.8925018310547,263.8249969482422,292.29000091552734,276.55999755859375,289.12562561035156,-0.5979449759135292,8.942973136031828,-0.6864645242170253,2.9952232604614912,281.72624588012695,7.294376373291016,0.03179956990622844,265.45800399780273,291.092000579834,0.8302962573195136,-0.06562660147574495,0.9205741854467869,0.939583139459066,0.9623916745768026,-0.06681862572223907,20.179362726267282,299.1153202039484,281.22937393188477,263.34342765982115,268.54642813546315,7.107853827794682,277.83857018607006,11.598863208902367,270.6273868164408,276.1282054086679,-5.735544358274209,-8.67868438310688,23263400,3.4077565641316867,1.122454099977419,-692121300.0,-87.1292451679175,89.02914134005623,91.58768807638091,-162.30721982144962,15.078035863640775,37.01155484780142,-0.06484576057698578,5.946806777490268,285.0302752685547,279.36985687255856,274.7949981689453,270.220139465332,264.5597210693359,0.18,0.0,288.5651471904927,-0.06616461666316897,-0.05580331866490668,263.0087629045759,272.41575404575894,10.672745977951813
2022-09-02,0,259.2425003051758,258.8925018310547,292.29000091552734,275.3818759918213,289.12562561035156,-0.5881563875442863,10.17270802211879,-0.8071586643710433,2.9950675389023584,280.8774948120117,8.401875534057615,0.036323802985406155,264.28625106811523,291.092000579834,0.8283668016736703,-0.07899392387001512,0.9256801125181588,0.9517144730514385,0.9771599908319124,-0.0534190084212014,17.113455099206146,300.4016652812981,280.05624923706057,259.71083319282303,266.16892787388394,7.026976216381727,275.48517772129605,11.803680004786672,267.6832717929797,274.2043862026012,-6.464401776874255,-10.668197371888052,22855400,3.5207093962106906,1.0868246160635144,-669265900.0,-95.98181439577984,89.02914134005623,91.58768807638091,-140.36148374319382,17.705924259796028,32.671349909487766,-0.1294301372841007,6.25560574555752,284.70148681640626,278.9242657470703,274.2550048828125,269.5857440185547,263.80852294921874,0.19999999999999998,0.0,288.4513611960777,-0.044872940210597734,-0.08172864919084376,260.23795427594865,269.8325435093471,11.816937706572611
2022-09-06,0,254.80500030517578,258.8925018310547,292.29000091552734,271.79999923706055,289.12562561035156,-0.4804578067352078,11.130870760778638,-1.1054874023960894,2.9949307387918735,280.26749420166016,9.481900177001956,0.03990081420220499,263.3667472839355,291.092000579834,0.8666975494407768,-0.08201061724577463,0.9133990676447667,0.9452170708125794,0.9711444619812502,-0.040580624829971934,17.203580640432094,301.2252409722409,278.96349945068357,256.70175792912625,262.93678610665455,6.130123095061001,272.8076776776995,11.949093194189697,265.5750431462236,272.5551648628096,-6.032405423342554,-11.276051573235282,21328200,3.4917326492487715,1.0079980263689585,-690594100.0,-96.83651909504076,89.02914134005623,91.58768807638091,-143.13206972426855,16.510140875029297,33.365813886185194,-0.1257560237490346,6.229489897331226,283.5772452392578,277.53138470458987,272.64500427246094,267.758623840332,261.71276330566405,0.2,0.0,288.3316164092597,-0.0451683080776899,-0.055354482656400986,256.64278520856584,267.1052736554827,13.011834914252098
2022-09-07,0,256.2099952697754,254.80500030517578,292.29000091552734,265.27125358581543,289.12562561035156,-0.40243021297759257,12.271207960796739,-1.223719379089797,2.9947487589029267,278.6537437438965,10.517874908447265,0.04420724743102225,259.2075004577637,291.092000579834,0.8663783874787192,-0.09211403178772425,0.9230011170356379,0.9593517547068253,0.9845880516311818,-0.030746701505415475,14.925406482347254,302.1260401891716,277.5836242675781,253.04120834598461,260.41357149396623,4.214342595922909,270.3248201097761,11.487316373762406,262.8929241027671,270.57319322160424,-8.155207788599188,-12.824592183427047,24126700,3.5640937878840284,1.1383179417642189,-666467400.0,-84.61347583522493,89.02914134005623,91.58768807638091,-111.24489876686346,16.595347835060434,31.204194741397586,-0.1231085014856486,6.185239543361114,282.47708337402344,276.6414631958008,271.9250030517578,267.20854290771484,261.3729227294922,0.2,0.0,288.20655641040673,-0.018557326453992662,-0.02692003421909786,255.2384251185826,264.7719268798828,13.585760838317908
2022-09-08,0,257.81249618530273,254.80500030517578,292.29000091552734,264.2093753814697,289.12562561035156,-0.2684518832293769,13.094178537712281,-1.4277203703943087,2.9946043781315352,277.10749435424805,11.45987440109253,0.04738066052472469,258.62425117492677,291.092000579834,0.8876409368354973,-0.11198533385634474,0.9328822213326778,0.9728470599801807,0.9969740221202492,-0.02278973119487615,13.327971231747577,302.54960642692606,276.36124935150144,250.17289227607682,259.30357033865795,3.605253339089653,268.00160544259205,10.36246165509421,261.24738521738936,269.2786760189204,-6.449169758288544,-11.946250749252322,20319900,2.917639788366407,0.9686913782706009,-646147500.0,-82.36401232154455,89.02914134005623,91.58768807638091,-92.19169806047184,17.36704284467026,29.15892331098973,-0.1409518688776321,6.146293794172894,280.4448405761719,274.9975809326172,270.5950012207031,266.19242150878904,260.74516186523437,0.2,0.0,288.10597795038234,-0.011282495566418582,-0.016922094018309835,254.29610116141183,262.54952457972934,13.739633861537005
2022-09-09,0,262.62000274658203,254.80500030517578,292.29000091552734,262.6793727874756,289.12562561035156,-0.07687119871069625,13.37576839231333,-1.5197561874859977,2.994545716304579,276.33499908447266,11.885287132263182,0.048669974919777204,257.65224609375,291.092000579834,0.9012673472908269,-0.10759872618378317,0.9555868920736733,0.9977925769884659,1.020309465085723,0.014397871275390495,18.15015298445115,301.57741073177027,274.8258739471436,248.07433716251685,259.05821337018693,3.246125132598216,266.2269630432129,8.77932463491502,260.4026967153895,268.1042655431332,-2.925647571719166,-11.202481653124336,22084700,2.9758028899108653,1.0477810793359204,-624062800.0,-58.97774075848008,89.02914134005623,91.58768807638091,-55.99840983033045,21.56356831386439,26.899912024999356,-0.0669497857408466,6.186560115603473,275.2572740478516,270.8013556518555,267.1999969482422,263.5986382446289,259.1427198486328,0.02,1.0,288.01688278383506,0.015591222936176319,0.011435119758641255,254.5053471156529,261.02649470738004,13.590498406558476
2022-09-12,0,266.26000213623047,254.80500030517578,292.29000091552734,261.77562713623047,288.05124855041504,0.11984147198485785,13.218681701981401,-1.48771615735863,2.994565976985996,274.8787498474121,11.828049278259277,0.04832943981988351,257.65224609375,291.092000579834,0.9104852198300696,-0.09382009576849899,0.9734856349371163,1.0173467921698767,1.0314638031071555,0.027069256864880487,30.746401526066677,299.94936253421184,273.511999130249,247.07463572628617,259.4060712541853,3.9055616381725433,265.2542849949428,7.856470490574094,260.98819404182586,267.6318678412474,-0.6497370858779681,-8.64278917705355,18747700,3.2644696788545438,0.897706807942352,-605315100.0,-48.20424430830927,89.02914134005623,91.58768807638091,-33.8746966449458,23.45200709784495,25.93568439243031,-0.10820222408028835,5.9582357544113576,273.6375977783203,269.4911986694336,266.13999938964844,262.7888001098633,258.6424010009766,0.04,0.0,287.9511640915341,0.04135759071148182,0.0240015087895694,255.23280334472656,260.24707576206754,12.974813675624578
2022-09-13,0,255.70499801635742,254.80500030517578,292.29000091552734,261.77562713623047,281.77437019348145,0.2976224053120573,12.755209221181394,-1.3250003706481102,2.994639877219382,270.0662498474121,11.375748825073241,0.04683655309578559,257.65224609375,291.092000579834,0.8954926751483445,-0.0887436022320477,0.9389372223360222,0.9798674996214595,0.9852181584749253,0.0035321038052775755,37.640089274295086,297.84491742002393,272.33449897766116,246.82408053529838,258.95071356637135,4.153376246096305,263.74857085091725,7.487963700776554,262.33443840954044,267.7083746125252,0.9229622727773541,-4.865518996062137,33353300,3.352818531991903,1.5407552972947753,-638668400.0,-98.60866380774456,89.02914134005623,91.58768807638091,-94.59557857648349,19.63446990827398,36.38143129157902,-0.20162778531518002,6.608361917309252,273.55499633789066,269.3574963378906,265.9649963378906,262.57249633789064,258.37499633789065,0.02,1.0,287.77190840055505,-0.004975324715999485,-0.015894702679084736,254.0517316545759,258.5302472795759,12.714204942590749
2022-09-14,0,252.45999908447266,254.80500030517578,292.29000091552734,259.1550006866455,278.04186820983887,0.4429972536399754,12.388803580970519,-1.1550946944663192,2.994689981301076,265.9212532043457,11.032024097442626,0.045797908287962784,256.1594955444336,290.4007514953613,0.8283313195119654,-0.12516679593751512,0.9332733228743374,0.971108314172845,0.9720412063770362,-0.014636416433926325,27.428396823249148,295.28785629981945,270.5102491378784,245.73264197593736,257.98178482055664,4.812755275188822,262.0753563472203,7.178218325770735,260.68853270639624,266.16135264143026,-1.23120746725115,-7.616019046735413,23913000,3.9063159094714854,1.0900326490145467,-662581400.0,-92.25721475997692,89.02914134005623,91.58768807638091,-103.49514985321673,18.68405106369646,36.53664954577437,-0.2055339025321868,6.448478501426947,273.1467173461914,268.6966379699707,265.0999984741211,261.5033589782715,257.0532796020508,0.04,0.0,287.63474077297883,-0.022743957809265414,-0.004067120793144215,253.51245771135603,256.87520599365234,12.165699884513893
2022-09-15,0,247.64250183105472,252.45999908447266,290.9700012207031,258.6225004196167,276.94624519348145,0.524605988651436,11.920112353830271,-0.9594045159708986,2.99475395079109,264.9600028991699,10.447248992919924,0.044392104447700136,255.61499824523926,287.75224685668945,0.8009871743377464,-0.13235042091854796,0.9222540426342097,0.9569495031743499,0.9562538819184557,-0.039447251412275786,25.383132631003782,292.3589737539862,268.5187490463257,244.6785243386652,256.95857075282504,6.170571606614742,259.9476784297398,6.673788478567316,258.6247472765708,264.3683451029737,-2.616276734223317,-8.490857737960933,31530900,3.9142525526696335,1.3950645414624974,-694112300.0,-96.25550410941301,89.02914134005623,91.58768807638091,-131.41045441503428,17.01928019110147,39.62693168518018,-0.24166824090239122,6.573587014967922,271.76847821044925,266.4657593688965,262.1800003051758,257.8942412414551,252.59152239990237,0.06,0.0,287.42939727147683,-0.050827784479371974,-0.049246319524052284,252.4072265625,254.52500588553292,11.83369442421264
2022-09-16,0,244.0900001525879,247.64250183105472,290.3375015258789,257.4118709564209,276.11000061035156,0.4827770372327175,11.575139165440653,-0.7336632246230907,2.994793921792172,264.08124923706055,9.718586254119872,0.04345799133782528,254.57050018310548,280.6362449645996,0.7542028944936848,-0.14705299684139708,0.9164175877860483,0.9491571573496888,0.9499975652748129,-0.0705582301431733,22.49999523769032,289.50265240772455,266.35237407684326,243.202095745962,255.22714287894112,7.8794095630784176,257.8203571864537,6.640327365059134,255.8734608279251,262.02389007845113,-2.8109724948657435,-10.736939635628259,39791800,3.9472032210198287,1.6767128644283695,-733904100.0,-89.44463809226171,89.02914134005623,91.58768807638091,-144.89856959491536,16.38280466222934,40.35278699278306,-0.16698675991459122,6.341188374115948,261.45796875,257.75102661132814,254.7550048828125,251.75898315429689,248.052041015625,0.08,0.0,287.1548464572002,-0.07456699835414238,-0.05330346165510304,250.53240530831474,252.88541521344865,11.213231330151546
2022-09-19,0,243.24500274658203,244.0900001525879,287.4649963378906,256.0837459564209,274.37562370300293,0.27608573511650053,11.164815983301331,-0.6867201724241614,2.9948411513036137,263.2224998474121,9.113499641418455,0.04228456304060014,251.97824935913087,277.6747428894043,0.7306385130952054,-0.15088792283537408,0.9212430073484716,0.9513473256578996,0.9605637628496826,-0.0864380650679667,20.934868073505797,286.36963097478144,264.0399990081787,241.71036704157598,253.1460723876953,8.93571690914637,256.2248213631766,7.284182354584977,252.93061195103962,259.3551870214378,-4.730492697767624,-10.874584951573691,26826900,3.9557849062023376,1.1157013708742507,-760731000.0,-86.20301756825418,89.02914134005623,91.58768807638091,-136.6288104614965,15.57240639185711,39.751878447581866,-0.09605748505908643,6.19467438568745,261.17241076660156,257.28880987548825,254.15000915527344,251.01120843505856,247.1276075439453,0.1,0.0,286.96945055287256,-0.0829928016848458,-0.07539890712050282,248.56629725864954,251.43119921003068,10.601590298373686
2022-09-20,0,241.91749954223633,243.24500274658203,279.8774948120117,255.479998588562,268.1631259918213,0.04813591383688497,10.674720831903892,-0.8904940285641998,2.9949012411567053,260.9312515258789,8.818499755859374,0.04076981869569913,247.28725166320802,276.8494956970215,0.7782806222235644,-0.13088759455287757,0.9239522748151107,0.9521124808135748,0.9730079181827915,-0.053919550188999854,21.506445970296,283.1784409924211,261.8289993286133,240.4795576648055,250.18857192993164,8.700383603415252,254.6233926500593,7.809022921318957,250.50414001429982,256.7592153492186,-5.650421781049091,-8.410757925139103,26660300,3.7616656434277567,1.1050977136216682,-787391300.0,-89.8957343995277,89.02914134005623,91.58768807638091,-136.1512577733974,14.682665628004663,38.89731744689188,-0.029319594516769035,6.100769389312785,260.8868491821289,256.826587310791,253.54500579833984,250.26342428588868,246.20316241455077,0.12000000000000001,0.0,286.77988057028824,-0.03785853411457274,-0.0907556426385207,245.47530473981584,249.99032592773438,10.628820099046713
2022-09-21,0,242.44499969482422,241.91749954223633,277.42999267578125,254.21875,265.7518787384033,0.020705196086304396,10.6716092255719,-0.8671923424942296,2.994889227808951,259.06750106811523,8.721849994659424,0.04105554644665681,244.0055004119873,275.9750015258789,0.7935993696852275,-0.12597321744404572,0.9327283013586101,0.9590529919424596,0.9860658598728305,-0.039669648363966914,21.15514325923808,281.2742180162682,259.9309995651245,238.5877811139808,246.78642872401647,5.397994109064483,253.09624998910087,7.960210348152326,248.3598429116339,254.36627816111718,-7.883064118433813,-8.481582013230778,28625600,3.753546476491867,1.1598823245540018,-758765700.0,-99.8248580746468,89.02914134005623,91.58768807638091,-125.50729773684498,17.934404816680033,35.02833891710163,-0.07182980871168844,6.290715190363712,260.7122078857422,256.54390521240236,253.1750030517578,249.8061008911133,245.63779821777345,0.14,0.0,286.5779675230154,-0.05261277658856878,-0.05174805351773673,241.58522251674108,248.4090129307338,10.761871081310781
2022-09-22,0,240.06999969482422,241.91749954223633,277.42999267578125,251.25562477111816,264.6487522125244,0.0848001804071149,10.583964513301487,-0.8482285463494326,2.9948926897786707,258.3524990081787,8.580750465393065,0.040989119581515014,243.16500244140624,274.0737480163574,0.8009125429890428,-0.12120993233584247,0.9297327020568329,0.9548573629989079,0.9844259964969757,-0.03057836227723365,22.56654013485975,279.38192877483294,258.21399974823,237.04607072162702,244.552857535226,4.192805371567946,251.7517855507987,8.478592094575433,246.8929258933637,252.67826206528548,-8.94426584929622,-8.10385577588478,31061200,3.7856613697651245,1.226457205661149,-789826900.0,-88.58772474538058,89.02914134005623,91.58768807638091,-119.80788307704071,16.653512033978163,34.03674032242084,-0.05199404951148,6.290663625760694,260.3983310546875,256.0358503417969,252.510009765625,248.98416918945313,244.6216884765625,0.16,0.0,286.3559042418378,-0.017931401282281878,-0.04456427548135596,240.03902108328683,247.04537636893136,10.469792089802132
2022-09-23,0,238.4474983215332,240.06999969482422,277.42999267578125,246.75437641143802,263.95312309265137,0.10523885936936835,10.471892830152237,-0.8137691768267254,2.994899083037257,257.01124572753906,8.564249992370604,0.04083831261564326,242.39224967956542,267.0212516784668,0.7621948861258522,-0.13466457833424597,0.9298981222224063,0.9551443858682908,0.9838830384592113,-0.02311648091903562,20.01102613020044,277.3670352864641,256.42324962615965,235.4794639658552,242.55107171194894,2.9490167733100368,250.2664282662528,8.877499883020418,245.18597040977875,250.92593960765709,-6.114467234830128,-7.270392924903424,34176000,3.705897971009588,1.3041494780597342,-824002900.0,-91.56589167826256,89.02914134005623,91.58768807638091,-127.17518429080584,15.527562629127411,34.43764619661649,-0.08488753735499364,6.264902497958295,259.839008605957,255.13050637817383,251.32500457763672,247.5195027770996,242.81100054931642,0.18,0.0,286.0996073500248,-0.027866252894648502,-0.030401819454765888,238.0307856968471,245.77162170410156,9.718080616327061
2022-09-26,0,238.21249771118164,238.4474983215332,273.87249755859375,243.87875080108643,262.92125129699707,-0.0412251287073494,9.997683299227083,-1.0821849610052972,2.994959718785705,255.9574966430664,8.547549819946287,0.0392876222791766,241.7327495574951,265.6502540588379,0.7605070945794088,-0.12934850907941764,0.936097128919822,0.963532677165991,0.9875116497509862,-0.02068903771331887,19.523227071486215,274.46949150690136,254.47412490844727,234.47875830999317,241.2039282662528,2.322972055901854,249.08124950953894,9.321454072474275,243.49205949929248,249.17599963381127,-5.55038454161243,-8.021447856413614,27694200,3.687312583853745,1.0565131654994901,-851697100.0,-93.02325911493388,89.02914134005623,91.58768807638091,-109.20607132305665,15.078096624177883,32.61552003038758,-0.07330458547130848,6.14240964945175,259.839008605957,255.13050637817383,251.32500457763672,247.5195027770996,242.81100054931642,0.18,0.0,285.89612063495497,-0.028913715456807876,-0.02978666378647314,236.91712733677454,244.66217694963728,9.74706493646879
2022-09-27,0,238.17250061035156,238.21249771118164,266.26000213623047,243.04500198364258,260.08687591552734,-0.14676447596536607,9.548914349825086,-1.4464812788965569,2.9950166881761593,255.2549991607666,8.569012546539305,0.037788879023734824,239.90774955749512,264.4620018005371,0.8268492259947655,-0.10305651208560193,0.9425439879989969,0.9744255397807133,0.9914827609399529,-0.015480479663402491,20.8262392700734,271.7889536157269,252.69112491607666,233.5932962164264,240.35857118879045,2.1692908832137046,247.7928570338658,9.505083629140632,242.15217691301342,247.70870578724796,-3.807910213371354,-6.511843399510045,27018700,3.373910721561317,1.0177746202561209,-878715800.0,-94.20332942486203,89.02914134005623,91.58768807638091,-103.93440688825787,13.815119011213637,32.637389970475624,-0.08811711087023,6.225094911854931,259.67380932617186,254.86310754394532,250.97500610351562,247.08690466308593,242.2762028808594,0.19999999999999998,0.0,285.6949835263535,-0.02491240836144748,-0.03316692359720528,235.74729701450892,243.13985116141183,9.843514961123383
2022-09-28,0,238.73500061035156,238.17250061035156,266.26000213623047,242.31312465667725,258.98000144958496,-0.010288451880612256,9.567321151159943,-1.4874956173311786,2.9950073209132815,253.63249969482422,8.764312229156491,0.03806818943461264,238.42399826049805,263.87624740600586,0.8370890532424461,-0.09898331021701726,0.9499220402782625,0.9837835526620875,0.9969328094031804,-0.015302435971633055,21.049485586301028,270.45526703529106,251.3206247329712,232.18598243065134,239.71428516932897,1.8089453915291378,246.43017877851213,9.3239191918001,241.14633585505067,246.5846119511135,-2.4243105160134064,-7.040121381849803,29029700,3.388284987297831,1.0807793158369128,-849686100.0,-80.0606831859784,89.02914134005623,91.58768807638091,-81.14532233967832,13.22777765296214,29.835458969599532,-0.03922965702169382,6.323302875491958,259.67380932617186,254.86310754394532,250.97500610351562,247.08690466308593,242.2762028808594,0.19999999999999998,0.0,285.4887765441902,0.008872101006357047,-0.005692024040829265,235.2627934047154,241.9145453316825,9.63495808991204
2022-09-29,0,237.6875,238.17250061035156,266.26000213623047,241.4556245803833,258.0824975967407,0.14949151150399775,9.452135025078446,-1.4644876291500935,2.995018849275803,250.05125045776367,8.742749595642088,0.037802416156195645,238.42399826049805,262.74050216674806,0.8399308486131697,-0.09510090638914265,0.9505960046366543,0.9850381941390546,0.9956435710493873,-0.009924187519693595,23.064059935647773,268.94476973735175,250.04049968719482,231.1362296370379,239.10999952043807,1.6498119644697213,244.64928572518485,8.320886645625498,240.51797569351896,245.66775622239325,-1.8540985776916814,-7.399755968864761,27484200,3.411148436002913,1.018137337888814,-877170300.0,-90.64771326045685,89.02914134005623,91.58768807638091,-88.91187455016708,12.236396270424718,27.959479049706726,0.01054213061862097,6.347352936539655,259.6525701904297,254.8287289428711,250.9300079345703,247.0312869262695,242.2074456787109,0.2,0.0,285.2864604025417,-0.014441019193286775,-0.006068231010981435,234.567631312779,240.02146802629744,9.579722154510256
2022-09-30,0,236.11499404907227,237.6875,266.26000213623047,239.73624992370605,256.6106204986572,0.30155547573376335,9.260893396002189,-1.3704696643547416,2.995041493650916,245.8662509918213,8.540487232208251,0.03723217318111866,238.20849800109863,259.5802505493164,0.8670183990645809,-0.08190658934144189,0.9492684963730235,0.9825750451318275,0.9910346424294708,-0.00978204547701178,23.234503387808253,267.25541163178707,248.73362483978272,230.21183804777834,238.20571299961634,1.187081149768972,242.4960708618164,5.824255650997029,239.77584722245086,244.64467482738266,-1.7485297881469766,-9.493756182251248,35694800,3.303240707768039,1.2925330675952051,-912865100.0,-99.3856227676366,89.02914134005623,91.58768807638091,-95.52930680170171,11.178376642136863,27.40191079758475,-0.08609499022638477,6.451827572007704,253.86987432861326,249.83005459594725,246.56499481201172,243.29993502807616,239.26011529541015,0.2,0.0,285.0159430286862,-0.02109957810107832,-0.03352976640588668,233.7179914202009,237.651606968471,9.740873649495171
2022-10-03,0,238.1050033569336,236.11499404907227,266.26000213623047,238.66312503814697,255.8312473297119,0.47380808567176774,9.341759063776202,-1.1879769610034339,2.9950244383897493,243.66750144958496,8.440475082397462,0.03773003702421772,238.1240005493164,259.5802505493164,0.8565381952673282,-0.08921186236391879,0.961672264396543,0.9941556651996911,1.0013478791201038,-0.00045125404956025683,21.227215956638467,266.278267578236,247.5947494506836,228.9112313231312,237.92499923706055,0.8600335237267867,241.23892838614327,4.503549172568912,238.87179771980942,243.67365148328932,-2.610903773523809,-11.321643448246753,28880400,3.2861839985412753,1.0344942457054576,-883984700.0,-62.74414062499973,89.02914134005623,91.58768807638091,-61.98257719427331,11.282466148991233,24.824019660717866,-0.01813177302045335,6.613126110249621,249.15599572753902,246.01699572753904,243.47999572753903,240.94299572753903,237.80399572753902,0.02,1.0,284.81498767987944,0.01385565335248562,0.011852822522639783,233.68429129464286,236.86165618896484,9.603310870386341
2022-10-04,0,247.32749938964844,236.11499404907227,266.26000213623047,238.3887481689453,255.0299997329712,0.6921374317080328,9.158096800663795,-0.8719600729283679,2.9950479164802446,242.84500122070312,8.121199874877933,0.037146814928136276,238.06325302124023,258.2932468414307,0.8935683085600463,-0.06554030308761945,1.003202853872443,1.0348831494644588,1.0402270314361584,0.038438521474292164,29.85214059804337,264.8540682045991,246.5378746032715,228.2216810019439,239.19357081821985,3.6811916730425946,240.8723212650844,3.6473602177840765,238.69563043746456,243.05343794748623,-0.8185097431534629,-6.88292946792458,34888400,3.2680516936630792,1.2200695076344394,-849096300.0,-13.497532195067445,89.02914134005623,91.58768807638091,16.49192497765834,19.300645487051668,22.325793903808307,0.0304427604717688,6.827902502643124,246.9938743286133,244.26805459594726,242.06499481201172,239.86193502807618,237.13611529541015,0.04,0.0,284.6221579494344,0.0527474038292286,0.0481365325822363,235.22347368512834,236.62712969098772,9.49004794926474
2022-10-05,0,247.46750259399414,236.11499404907227,266.26000213623047,238.3887481689453,253.27124881744385,0.8242054119525869,8.963529520065345,-0.5901931450463267,2.9950756172489914,242.84500122070312,7.6725498199462905,0.03641283671120961,238.06325302124023,258.2932468414307,0.8746162268842479,-0.0346688109133844,1.0052952626657115,1.0331302771839632,1.0328618543446066,0.03657822255353005,51.90981393895468,264.0910585976258,246.16399955749512,228.23694051736445,240.51571437290735,4.770849510944403,240.85982131958008,3.6225889556630184,240.89069717769118,243.8021415574796,3.7240906826965516,-2.032995212483897,20347100,3.950545256101149,0.7162847579633351,-828749200.0,-7.731117148137562,89.02914134005623,91.58768807638091,20.727860511663753,17.987494116455974,21.730765849811963,0.019941579064613534,6.803052014973056,246.367400390625,243.76129949951172,241.65499877929688,239.54869805908203,236.94259716796873,0.06,0.0,284.5102843788413,0.03372464058698532,0.05410084580603366,236.87359619140625,236.8953617640904,9.112005882945043
2022-10-06,0,247.78499603271484,236.11499404907227,266.26000213623047,238.3887481689453,248.8468761444092,0.9841334473020843,8.671368866987963,-0.15549678140219036,2.995116483209999,242.84500122070312,7.1480002593994145,0.0352886466719616,238.06325302124023,258.2932468414307,0.8513067426218656,-0.04012603634182701,1.0083756451533752,1.0322912437852605,1.0267029203885996,0.04248223416340724,51.44312649516531,263.06961265768194,245.72687492370605,228.38413718973013,241.88892800467355,5.334132633330588,241.123749596732,3.991816005273955,242.57019504996006,244.36124482522305,3.885188632728094,-0.07066607539765621,20239900,3.923618978738425,0.7126113108592079,-808509300.0,-21.232533607791947,89.02914134005623,91.58768807638091,25.574328677618993,17.160882365487677,20.73213278326593,-0.015352654126399348,6.621405024761216,246.367400390625,243.76129949951172,241.65499877929688,239.54869805908203,236.94259716796873,0.06,0.0,284.3989996763593,0.03911575829585212,0.023727549604282094,238.3313206263951,237.03930882045202,8.620667191607733
2022-10-07,0,237.40750122070312,236.11499404907227,266.26000213623047,238.3887481689453,247.67812538146975,1.1738177770749094,8.237107634972498,0.5255104325695608,2.99517518741072,242.84500122070312,6.546350250244144,0.03358993105444367,238.06325302124023,256.3964984893799,0.7847301271820647,-0.05648848739135223,0.9681191446319852,0.9858890346889495,0.9755403604283243,0.005474057998037241,49.650465053777815,261.69971518602165,245.22549991607667,228.75128464613167,241.69928523472376,5.48637711442088,240.70678520202637,4.057533279030808,243.8956204712045,244.75207853277607,4.035938405034111,1.5137842098476388,37769600,3.724309654298994,1.2940695389010435,-846278900.0,-91.5405644296802,89.02914134005623,91.58768807638091,-89.36444146269552,14.816496804976389,30.848948623366102,-0.08869285478755234,7.1213043818453565,246.367400390625,243.76129949951172,241.65499877929688,239.54869805908203,236.94259716796873,0.02,1.0,284.1285821618371,0.005753611394004654,-0.013726274457519826,237.3721444266183,236.31746891566686,7.668463952153224
2022-10-10,0,230.89749908447266,236.11499404907227,266.26000213623047,238.20249843597412,247.51125240325928,1.4437986510660983,7.361276068125774,1.8441861353460611,2.995283344670631,242.18124961853027,5.701850051879883,0.0301735078582935,237.6595001220703,252.78449897766114,0.5803358805515981,-0.10836212981311823,0.9464374707060117,0.9592690511232954,0.9477831059331039,-0.030270276436217713,31.6300333705231,258.68742697603426,243.9648748397827,229.24232270353116,240.72928510393416,6.765104883886788,239.9196423121861,4.804712766183328,242.27001858177942,243.51210776773166,-0.5560556207738888,-2.3998443791096267,29743600,4.140626372529409,1.0002394365439353,-876022500.0,-89.43394705425463,89.02914134005623,91.58768807638091,-163.30856521480115,13.661066819208662,34.857166508258615,-0.11437112586062233,7.171925634307575,244.951400390625,241.46929949951172,238.65499877929688,235.840698059082,232.35859716796872,0.04,0.0,283.8910609781087,-0.04772801126516457,-0.015671994765893652,236.21354457310267,235.39058794294084,6.205185144515491
2022-10-11,1,226.54999923706055,230.89749908447266,255.70499801635742,238.15562629699707,247.36250019073486,0.4886264283095104,5.894599154669473,-0.20495562614157858,2.9954371963398496,240.99374961853027,4.839675235748293,0.024338060532532103,237.27825050354005,248.25249633789062,0.5606130306864028,-0.0970160893386129,0.9353965300098264,0.9440763408974863,0.9354728134839088,-0.0840080468361275,27.840747635092843,253.98594799653378,242.19674968719482,230.40755137785587,239.36285727364677,8.576036916779502,238.78428513663155,5.912385078882251,239.39205461559067,241.39991980294874,-2.856692470377005,-4.555272139723688,30474000,3.756726608244202,1.0297874310446409,-906496500.0,-95.08876844803088,89.02914134005623,91.58768807638091,-198.72062740873497,12.947289336876281,35.699186117980645,-0.08813503634364016,7.02678802918942,244.33308154296876,240.4684613647461,237.34500122070312,234.22154107666015,230.3569208984375,0.06,0.0,283.6319640283372,-0.09430253442302206,-0.06367874164397117,235.16167994907929,234.43983568464006,6.6904722274447845
2022-10-12,1,225.74250030517578,226.54999923706055,252.45999908447266,238.0006275177002,244.89937496185303,-0.2588632651948347,5.978182470115873,0.07208918186419222,2.9954231844649555,239.4025001525879,4.772900333404543,0.024832629845467434,235.5932445526123,247.65675125122073,0.5469771374346475,-0.10263011939068681,0.937706397971505,0.9452896764174156,0.9484122260068721,-0.08778931399514434,24.930804734037654,252.69536468846175,240.73899974823,228.78263480799822,237.59678540910994,10.028204507335088,237.76089232308524,6.8399521755314385,236.16836822494918,239.13530971746056,-4.050990006176315,-6.556126328763795,21903900,3.7945576413980167,0.7427049856808917,-928400400.0,-93.2757565196656,89.02914134005623,91.58768807638091,-183.79438054965888,12.417155071783514,34.39493909063984,-0.09472939343287337,6.803445567970715,244.29768298339843,240.41116369628907,237.27000427246094,234.1288448486328,230.24232556152344,0.08,0.0,283.44608164649554,-0.09410110225006918,-0.09293645288546704,233.05653817313058,233.37041473388672,6.830523788211738
2022-10-13,1,227.33000564575195,225.74250030517578,247.78499603271484,237.61750030517578,243.4562520980835,-0.6255952704243701,6.191103479890526,-0.07170691558205267,2.995395973965163,238.59124946594238,4.736187839508058,0.025860579241908557,230.46274909973144,247.4850025177002,0.6472378893620773,-0.08843393748630206,0.9495699182158464,0.9571447173406548,0.9728406855090177,-0.08255136797815732,25.227217211275086,251.7853317690462,239.40312480926514,227.02091784948408,234.7400005885533,9.634839121707609,236.9667857033866,7.3782830474941585,233.55060594838582,236.85024449157996,-5.192038334963371,-5.9680507384768955,42551800,3.7070976255678754,1.416358262569731,-885848600.0,-51.95547829394583,89.02914134005623,91.58768807638091,-116.20312296745756,18.234948239121668,28.857934376236358,-0.0045627168570827135,7.529628184543998,243.15780255126953,238.56610299682617,234.8550033569336,231.143903717041,226.55220416259766,0.1,0.0,283.11301158362704,-0.0508528836479516,-0.06003203030421564,231.00055149623327,233.1120125906808,6.741852000672885
2022-10-14,1,232.4199981689453,225.74250030517578,247.78499603271484,237.0843744277954,242.64500045776367,-0.5214526016370699,6.4180925653170116,-0.4551811613628316,2.99536804188067,238.32999801635742,4.765499877929687,0.026922940864420375,227.25200500488282,247.341499710083,0.7383963926193504,-0.06866317545314748,0.9749672200469627,0.9828616535265126,1.0123461501564717,-0.02100819488058736,29.963605508352906,251.223685130634,238.3875,225.55131486936597,232.59035709926061,7.831848264386062,236.55303573608398,7.464957217956645,231.9892195922173,235.20295223654017,-8.085430772253808,-4.66244886360264,30198600,3.7096414134568367,1.021484471786018,-855650000.0,-70.0159186301342,89.02914134005623,91.58768807638091,-85.0536242340413,17.78272000310909,26.452769974948644,-0.09722122295800799,7.627512548351333,243.15780255126953,238.56610299682617,234.8550033569336,231.143903717041,226.55220416259766,0.1,0.0,282.8859660374928,-0.02424870091393594,-0.07386846819569722,228.1019505092076,232.48777335030692,6.912420733355992
2022-10-17,0,236.8625030517578,225.74250030517578,247.78499603271484,235.19124507904053,242.0493745803833,-0.3266572705051248,6.403598075839922,-0.5947446947338091,2.9953685440493154,238.1924991607666,4.828200149536133,0.026928050320897474,227.25200500488282,247.341499710083,0.7804974799487696,-0.044502474687689454,0.9960408704250023,1.0032157649104725,1.0361983242593733,0.025833991233932263,41.139140130476406,250.61119605249772,237.80399990081787,224.99680374913802,231.0300009591239,4.802053087849691,236.45946448189872,7.451293882907674,232.0948354719137,234.55245709769517,-6.080598166352538,-2.431652242385446,28142300,3.9422009626589736,0.9498159164864813,-827507700.0,-41.49444934202834,89.02914134005623,91.58768807638091,-4.34292086719016,17.664605684453853,23.941680916026197,-0.11725646172209409,7.825548036722324,243.15780255126953,238.56610299682617,234.8550033569336,231.143903717041,226.55220416259766,0.1,0.0,282.69991456633625,0.036117921312216916,0.014045463141791843,226.80151585170202,232.56641823904855,6.727923054106905
2022-10-18,0,240.2599983215332,225.74250030517578,247.78499603271484,235.19124507904053,240.53187465667725,-0.22606073092850934,6.2823819351002115,-0.49319595967945773,2.9953815707707094,238.13875198364258,4.655399856567385,0.026453819163516433,227.25200500488282,247.341499710083,0.7849829334671998,-0.020895538768562566,1.0116854743125736,1.0181414356359229,1.0456042796460203,0.06051643844909749,49.163318931063934,250.04963878627706,237.48487491607665,224.92011104587624,231.43750054495675,5.5032752897346295,236.56839288984025,7.498117836161209,233.28108879252824,234.89374281415425,-4.408052608445647,-0.5500204915499024,26329600,4.091545309619723,0.8891326283200305,-801178100.0,-38.410184430017466,89.02914134005623,91.58768807638091,26.57881681054935,20.79982182470505,22.083517865873063,-0.14962264685544546,7.878008720901932,243.15780255126953,238.56610299682617,234.8550033569336,231.143903717041,226.55220416259766,0.02,1.0,282.53502222439994,0.05807183222171841,0.04034893506961287,227.39976937430245,232.38595690046037,6.629774476810336
2022-10-19,0,236.85499572753906,225.74250030517578,247.78499603271484,235.19124507904053,240.11749935150146,-0.20503197205888074,6.234108753036451,-0.43742393670921365,2.9953867663071745,238.13875198364258,4.589649944305418,0.026259714563664247,227.25200500488282,247.341499710083,0.7656683031815391,-0.009012358992931879,0.9976958739697372,1.0067272929929667,1.018630391868496,0.04922642128682275,53.900603655826956,249.87021736111438,237.4019998550415,224.93378234896863,232.28857149396623,5.85524883675415,236.5089282989502,7.4918584530195975,235.02349771867034,235.82991786181867,1.2015193648739377,0.6387826281369807,19985700,4.170273586628265,0.6848948199810937,-821163800.0,-44.83309211991429,89.02914134005623,91.58768807638091,-5.127086881360977,19.772707927568987,21.995483598553072,-0.10939952109181574,7.695294322339582,243.15780255126953,238.56610299682617,234.8550033569336,231.143903717041,226.55220416259766,0.02,0.0,282.4035857955804,0.04753045615580098,0.049110467219726485,228.41512407575337,232.31433432442802,6.617194264782629
2022-10-20,0,237.02499771118164,225.74250030517578,247.78499603271484,235.19124507904053,239.06875038146973,-0.10702641938193538,6.12612111293703,-0.3068869822085274,2.995398135412996,237.8962516784668,4.42075019836426,0.025835258660847717,227.25200500488282,247.341499710083,0.7699158320471347,-0.01339194389708024,0.9995888119194224,1.012014798773184,1.0097105057447242,0.04264721692981155,49.599856172947185,249.3747418825513,237.12249965667723,224.87025743080318,233.7849998474121,5.470086390029045,236.57392856052942,7.492125368627407,235.47767713119407,236.24087394002237,2.5801477567701534,-0.35025160029910596,21811000,4.205842638868127,0.7594841942428445,-799352800.0,-45.88238262254207,89.02914134005623,91.58768807638091,7.1302900771780235,20.173382981156458,20.66516301346195,-0.1385969346943095,7.605630610596076,243.15780255126953,238.56610299682617,234.8550033569336,231.143903717041,226.55220416259766,0.02,0.0,282.2630364736192,0.00815406857891543,0.04606875594660155,229.92340959821428,232.54254477364677,6.553936281668522
2022-10-21,0,238.5900001525879,225.74250030517578,247.78499603271484,235.19124507904053,238.5193738937378,-0.039652714081604,6.088699968416642,-0.25053065917269324,2.9954019721736986,237.54750061035156,4.298950119018554,0.02569394250875938,227.25200500488282,247.341499710083,0.7732679826339001,-0.005965676387316924,1.0068352487205352,1.0233984614439964,1.0080508084293576,0.026546777524529608,50.46553208246122,249.14764949432842,236.97024955749512,224.79284962066183,235.620356968471,4.365729213609947,236.60857118879045,7.500865622243549,235.85843643161303,236.6486239029283,4.623702718780466,0.3854069775510517,26299700,4.192267546755409,0.9285187732397131,-773053100.0,-26.89986497547192,89.02914134005623,91.58768807638091,41.96655253600917,20.15034640035066,19.029243624412967,-0.09872583399602837,7.669514142355395,243.15780255126953,238.56610299682617,234.8550033569336,231.143903717041,226.55220416259766,0.02,0.0,282.10385166639975,0.059327919749309066,0.03364059385352615,232.22234671456474,232.63944244384766,6.656346491069997
2022-10-24,0,245.0374984741211,225.74250030517578,247.78499603271484,235.19124507904053,238.6262502670288,-0.042899996362252314,6.090507609587213,-0.25352372913107146,2.9954017867242353,237.54750061035156,4.304650192260743,0.025700797886747475,227.25200500488282,247.341499710083,0.7704810504190064,0.0015847297897188797,1.0340122082836385,1.0505212628189562,1.0299220090549286,0.03451367488325885,52.99340095898517,249.15838986822226,236.97737464904785,224.79635942987343,238.14999880109514,3.862567450828496,236.44499969482422,7.2705709257025255,236.51562073219742,237.16031814497975,5.691218902087063,0.20369030000065044,24911200,4.207887605044863,0.8838394320993174,-748141900.0,-10.588242143663575,89.02914134005623,91.58768807638091,112.59710155311274,23.465522733850783,17.857869137860117,-0.02574313458650818,7.588834076570569,243.15780255126953,238.56610299682617,234.8550033569336,231.143903717041,226.55220416259766,0.04,0.0,281.97398292243764,0.040921053542995356,0.08177285833256877,234.04941885811942,232.52498517717635,7.031183695461024
2022-10-25,0,248.6974983215332,225.74250030517578,247.78499603271484,235.19124507904053,239.11625003814697,-0.09727759583414344,6.336389721974917,-0.5212693012142839,2.995375416528063,237.54750061035156,4.60701292037964,0.02669992601856172,227.25200500488282,247.341499710083,0.7270808840737872,0.02882363768351501,1.0479476638183651,1.0597878428333134,1.038171015316113,0.035118205522953305,61.43132249880347,249.99140413114466,237.3186246871948,224.64584524324496,240.47535596575057,4.6562216649679735,236.53285653250558,7.419909337586456,238.6283591857607,238.29217633753734,7.789333738882981,-0.9258982204480205,34775500,4.445670559509758,1.217073431082786,-713366400.0,-1.19081717993958,89.02914134005623,91.58768807638091,138.01857535467173,25.369386863685666,16.962095788068297,0.04912220719909521,7.418916737417077,243.5092360229492,238.85037771606446,235.08499908447266,231.31962045288086,226.6607621459961,0.06,0.0,281.8125037461496,0.05098551008353547,0.055277236016000444,237.15306091308597,232.62750571114677,7.598952563277637
2022-10-26,0,232.7125015258789,225.74250030517578,248.6974983215332,235.19124507904053,241.45437335968018,-0.07733185077392356,6.805172945737906,-0.7580403719028919,2.9953225279050137,237.54750061035156,5.14011260986328,0.02861181245953772,227.25200500488282,247.4992519378662,0.7248742337570416,0.0417303608005171,0.9784213426667512,0.9823984174847163,0.9646473998222406,-0.01748957917875371,65.1098149765016,251.4552204642297,237.8448745727539,224.23452868127808,239.88249860491072,5.398012675733509,235.4562497820173,6.722368110819737,241.1350932076035,239.62241650505092,7.0034851909584095,0.49703323250368214,82543200,4.5064375935741765,2.6414901727990503,-795909600.0,-61.79878761680199,89.02914134005623,91.58768807638091,-53.84885141598603,20.904391153567516,27.450126175115912,-0.07781423670916417,8.360423167257736,243.5092360229492,238.85037771606446,235.08499908447266,231.31962045288086,226.6607621459961,0.06,0.0,281.2512621867293,-0.021819975260096602,-0.030104694664208856,236.28095136369978,231.5412336077009,7.710528361394234
2022-10-27,0,229.31499862670898,225.74250030517578,248.6974983215332,232.6393756866455,241.45437335968018,0.035953171353340425,6.891817541100529,-0.8584866967152132,2.9953114209758605,237.21624946594238,5.306375007629396,0.029012834697473823,227.25200500488282,247.4992519378662,0.6479473648047688,-0.020930837650785565,0.9653590085824788,0.965215776253547,0.953839751903212,-0.0325282107749133,44.63723190390479,251.32738470073133,237.54374961853028,223.76011453632924,238.31892721993583,6.698849484627126,234.8782138824463,6.887574407162837,239.0515565036386,238.53252165318193,-1.7520719710422346,-6.08289232526651,40424600,5.822802603774848,1.2673978927283247,-836334200.0,-76.12034507541651,89.02914134005623,91.58768807638091,-96.6164433387891,19.48620767873055,29.25868036743231,-0.1290408375522608,8.32825034398442,243.5092360229492,238.85037771606446,235.08499908447266,231.31962045288086,226.6607621459961,0.06,0.0,280.9558645230532,-0.03980531938674836,-0.04114515323814303,234.63082885742188,231.01529911586218,8.076257094714753
2022-10-28,0,231.19000244140625,225.74250030517578,248.6974983215332,232.03937339782715,241.45437335968018,0.1320059261380845,7.120848685891865,-1.0215361430141932,2.9952818376049306,236.94375038146973,5.655137691497802,0.030029920698657984,227.25200500488282,247.4992519378662,0.6466985908829983,-0.0287995069934018,0.9749705050456965,0.9722955427058896,0.9678466072729642,-0.031015540074810555,41.91831496167549,251.36682192164946,237.12512454986572,222.88342717808197,237.509642464774,7.226587332956395,234.89910697937012,6.875002421340463,236.65852770656102,237.2621271308033,-4.555481466447374,-3.4086970935560457,40647700,5.85857359509114,1.2645741472819139,-795686500.0,-47.53996766531835,89.02914134005623,91.58768807638091,-47.62962918353639,20.205133709231973,26.660748160334162,-0.02046105599570206,8.486946972733348,243.5092360229492,238.85037771606446,235.08499908447266,231.31962045288086,226.6607621459961,0.02,1.0,280.68522982318314,-0.02581362096138473,-0.0011858120327878571,234.545161655971,231.48014286586218,8.023238012211543
2022-10-31,1,232.98999786376953,225.74250030517578,248.6974983215332,231.11687660217285,241.45437335968018,0.2004954024305913,7.235752392959111,-1.1012887939810538,2.995266553465637,236.94375038146973,5.891374588012695,0.030546212252533317,227.25200500488282,247.4992519378662,0.6714850396197988,-0.029041812721429233,0.9835828454259001,0.9803727613710814,0.9814630239355704,-0.04916594678517716,43.62231544415213,251.35037975540064,236.8788749694824,222.40737018356418,236.93321391514368,7.429757786064055,235.3591068812779,6.477346658819072,235.34314906302828,236.45089643401775,-2.3917558794704137,0.12668104162816546,28357300,5.856203608084526,0.8829309247822859,-767329200.0,-59.26040512553957,89.02914134005623,91.58768807638091,-44.628835078938714,19.3762071455073,25.56697651413234,-0.0753770786800225,8.217879408366054,243.5092360229492,238.85037771606446,235.08499908447266,231.31962045288086,226.6607621459961,0.02,0.0,280.49780414973503,-0.06115260138838374,-0.04126039255669576,233.98060825892858,231.95200892857142,8.05778151297428
2022-11-01,1,231.46000289916992,225.74250030517578,248.6974983215332,231.11687660217285,241.45437335968018,0.29460567790713055,7.278166197969579,-1.1071285997204863,2.9952605205956284,236.85874938964844,6.046061935424805,0.03075847387002568,227.25200500488282,247.4992519378662,0.6695911466550024,-0.05796970236330697,0.9781799779615232,0.9755244516722293,0.9850158231501793,-0.06931109294906324,43.03106749343874,251.17945709076335,236.6231246948242,222.06679229888508,235.91464287894112,7.650234136457664,235.76749992370605,5.985991069829367,234.79379983178296,235.89021440930742,-1.7023520246285646,2.8426389973059365,30592300,5.436186672321683,0.9589332223282051,-797921500.0,-71.67033352731592,89.02914134005623,91.58768807638091,-63.50357103058263,17.96219695335563,27.015929281841274,-0.13884926558278476,8.231602569852141,243.5092360229492,238.85037771606446,235.08499908447266,231.31962045288086,226.6607621459961,0.02,0.0,280.2875008060567,-0.08972330490965352,-0.07716894423920599,232.02152361188615,232.12193516322546,7.76638360572763
2022-11-02,1,225.22500228881836,225.74250030517578,248.6974983215332,231.11687660217285,239.00749969482422,0.481905350168617,6.924302784147799,-0.817696544889233,2.9953031262043854,234.9224967956543,5.768999290466309,0.029361447349013303,227.25200500488282,247.4992519378662,0.6197997372367166,-0.06468525978979475,0.9550321891647926,0.9527798258361535,0.9727534099200532,-0.03217489042473254,41.41211803256812,249.6783554385959,235.8297498703003,221.9811443020047,233.08428628104073,7.37249377181016,235.61714254106795,6.2354668077730375,233.9534588567683,234.7539681511435,-2.988388972236074,2.532754171795204,38407000,5.434512063084089,1.1707514839390132,-836328500.0,-99.80641026650716,89.02914134005623,91.58768807638091,-128.18872205859418,16.252100750386372,30.607695685798518,-0.2107439361215584,8.447917376933319,243.7239932861328,239.1979932861328,235.5399932861328,231.8819932861328,227.35599328613282,0.04,0.0,279.99135350197554,-0.04850420777954745,-0.12191814913982468,228.20868573869978,231.1290522984096,7.849978148758226
2022-11-03,1,217.18249893188477,225.22500228881836,248.6974983215332,230.50187397003174,237.70312595367432,0.5688341401004362,6.749838230465066,-0.5090983791439934,2.9953208987243514,232.85124969482422,5.606136531829833,0.028757270505926757,226.46924934387206,245.31224822998047,0.5202670868668449,-0.09104664973708863,0.9252926748300807,0.9232997826699751,0.9441239551807135,-0.05290757153906944,35.578089058133536,248.21730131597164,234.7176248550415,221.21794839411135,228.58214351109095,5.67643389405703,234.52874973842077,7.934751076519948,231.7340542943623,232.82839823602245,-8.08549561135647,-0.9259681100847803,36633900,5.556495667486866,1.0894799647584954,-872962400.0,-99.27144012345367,89.02914134005623,91.58768807638091,-200.13104206573476,15.353188897576764,34.127538406640234,-0.2354412657845942,8.303780983624932,242.2938338623047,236.88307421874998,232.50999450683594,228.13691479492186,222.72615515136715,0.06,0.0,279.6739330571472,-0.055126804375578264,-0.07379396400908508,223.09540230887276,230.12423161097936,8.464747078261016
2022-11-04,1,218.48999786376953,217.18249893188477,248.6974983215332,228.81875038146973,237.120623588562,0.07661695823367311,7.074973967989265,0.15192125780442245,2.9952721410941083,232.5662498474121,5.523499298095703,0.03034027968046857,225.69075050354004,240.737748336792,0.5782844588211782,-0.08519108362130656,0.9369713122005662,0.9367604086813207,0.9599335573173305,-0.05493319107021277,31.440328040729877,247.33744793597853,233.1875,219.03755206402147,226.55035727364677,6.444970516552016,233.21642793927873,8.970756286222516,228.0337220361302,230.50191469975297,-12.672021070716072,-6.5560189988403925,36789100,5.3747251151868305,1.0956930673901972,-836173300.0,-78.83539860492232,89.02914134005623,91.58768807638091,-146.46808127933068,15.29046507381931,31.729098394680907,-0.1422097443682968,8.293511174643015,242.16403314208983,236.6729730529785,232.23499298095703,227.79701290893556,222.30595281982423,0.08,0.0,279.3712122576874,-0.06138961777193308,-0.02363824162828546,221.70087323869978,228.99091230119978,8.812788631006907
2022-11-07,1,224.88750076293945,217.18249893188477,248.6974983215332,227.1350040435791,236.90312671661377,0.07290197981988791,7.685765072630372,-0.12789824570393016,2.9951848266679075,231.94000053405762,5.903374099731446,0.03309383095379677,224.55150184631347,240.737748336792,0.6950118305440496,-0.05373597059257842,0.968334168887559,0.9725706043209821,0.9991913644160242,-0.03477615852663185,34.640279521069765,247.61315497741407,232.24162483215332,216.87009468689257,225.91785757882255,6.344910410082232,232.1183923993792,8.983093882104058,225.60265219723172,229.00236443533274,-6.111619946867252,-7.756611937843799,33498000,5.239634963099743,0.9921270756685707,-802675300.0,-61.605949994502616,89.02914134005623,91.58768807638091,-65.15061523141308,20.275252726402194,29.76096273730993,-0.08363214434677635,8.210403580098285,242.16403314208983,236.6729730529785,232.23499298095703,227.79701290893556,222.30595281982423,0.08,0.0,279.1299601618908,-0.018351919354102186,-0.033917004244404865,221.85816083635603,228.24449484688895,8.84061705596128
2022-11-08,1,228.76499557495117,217.18249893188477,248.6974983215332,226.34812450408936,236.90312671661377,0.1425034998478925,7.848216860669275,-0.3068844627523406,2.9951604262522933,231.94000053405762,6.203874015808106,0.033837107858768034,224.24775047302245,240.737748336792,0.7440643241688609,-0.007338329197615514,0.9863063122493921,0.9980367577281716,1.0237906413211346,-0.011643512012711632,44.55798581090236,247.63755863741522,231.94112491607666,216.2446911947381,225.5714280264718,6.0692931761114375,231.54053524562292,8.914908337864006,225.41190724005008,228.6709547666644,-1.9307493579941735,-6.398275895274572,28192500,5.388125159382954,0.8378220993948097,-774482800.0,-58.94708271513127,89.02914134005623,91.58768807638091,-36.44573442437334,22.107403534643215,28.22459283816945,-0.06061606609161106,8.038946002782852,242.16403314208983,236.6729730529785,232.23499298095703,227.79701290893556,222.30595281982423,0.08,0.0,278.9396841603993,0.003068041820607492,-0.01404387826806678,220.87511117117745,227.71013641357422,8.741092005189488
2022-11-09,1,226.20999908447266,217.18249893188477,248.6974983215332,226.9331293106079,236.90312671661377,0.11643410660302181,7.786746460838563,-0.23877420763716506,2.9951697117758096,231.94000053405762,6.093124198913574,0.03355605926389949,224.24775047302245,240.737748336792,0.7457070219506274,0.013389128168994997,0.9748251305652198,0.9955472977652863,1.0148041811204236,0.0043733901016511645,49.39344053802006,247.6253676546483,232.05187473297119,216.47838181129407,224.60285677228654,5.161130376667689,230.76803534371513,8.871576828855265,226.25759923521616,228.9862851504026,-1.048923760044374,-3.415591943812764,27852900,5.456302619771717,0.8204772146859262,-802335700.0,-70.5397456760342,89.02914134005623,91.58768807638091,-68.18534560186995,21.18699198423761,28.434228479814887,-0.09502720645060186,7.789020802847441,242.16403314208983,236.6729730529785,232.23499298095703,227.79701290893556,222.30595281982423,0.08,0.0,278.74208333472967,0.020036149455360475,-0.016040688629129402,219.8049817766462,226.8927950177874,8.791720755394868
2022-11-10,0,239.18499755859375,217.18249893188477,248.6974983215332,227.05000400543213,236.90312671661377,0.11375590091005364,7.76845153996151,-0.21986076748409955,2.995172445771493,231.94000053405762,6.069749259948731,0.033473847603064405,224.24775047302245,240.737748336792,0.7402349870924776,-0.004926787196867455,1.0306355283327633,1.0556711587520586,1.07206407341388,0.10130880128425845,46.16229858496936,247.61215275185907,232.07524967193604,216.538346592013,225.70642743791853,7.267701378906081,230.81053515842981,8.913258114351127,226.26076384600847,229.00947218147437,-2.9099956399249276,-4.562809294860627,46268000,5.477591450817526,1.3555208514456902,-756067700.0,-21.430463780357904,89.02914134005623,91.58768807638091,79.6873955084098,30.108416518183535,23.977661768286694,-0.08109786709877356,8.5769484287566,242.16403314208983,236.6729730529785,232.23499298095703,227.79701290893556,222.30595281982423,0.02,1.0,278.5068193425049,0.13409574495060195,0.10395267425574858,221.88484409877233,226.95318385532923,9.102527231904892
2022-11-11,0,245.00500106811523,217.18249893188477,248.6974983215332,228.12624645233154,237.4162483215332,-0.06806886575190778,7.835754332084844,-0.30075981986502187,2.9951644516553215,232.5662498474121,6.153499603271484,0.0336778343250951,224.24775047302245,240.737748336792,0.6925369536142909,0.029106787036161073,1.0530240593436704,1.0766682043404376,1.0769095657945147,0.12135568430403865,57.93427752942113,248.33950793174782,232.66799926757812,216.99649060340843,228.53214154924666,10.273164493888476,230.80821391514368,8.909271379214644,229.4959882637823,230.8981495625932,3.3375073717548682,0.2493806972737058,34620200,6.113729336780384,1.007746240367048,-721447500.0,-10.449328933803796,89.02914134005623,91.58768807638091,115.8534806048952,32.52030964741722,22.741658727580045,-0.003043590566608742,8.397167310005852,242.16403314208983,236.6729730529785,232.23499298095703,227.79701290893556,222.30595281982423,0.04,0.0,278.3566346272765,0.11617492907762395,0.1533722423827061,225.67801993233817,226.94335283551897,9.586987425870522
2022-11-14,0,241.6650047302246,217.18249893188477,248.6974983215332,228.12624645233154,238.73874950408936,-0.12076249194185094,8.283121129859973,-0.5902419001532961,2.995100763484804,232.85124969482422,6.78422456741333,0.03550458117580732,224.24775047302245,245.00825080871581,0.6806214149273699,0.03437647542962159,1.0358673552249704,1.0555822720996806,1.0380331040295718,0.07460398603909435,61.584524536649084,249.86349167225657,233.29724941253662,216.73100715281666,232.02964237758093,9.926879131848724,230.30589294433594,7.9720056149974345,233.36584065625317,233.35941781667103,8.78232815108684,-0.013262217500678367,31123300,6.169670469735327,0.9020426694559784,-752570800.0,-18.6342594125634,89.02914134005623,91.58768807638091,72.36967689763412,30.325680414759418,23.53046048003376,-0.013471235719831802,8.361654922655775,239.83384246826174,234.78808059692383,230.70999908447266,226.6319175720215,221.5861557006836,0.04,0.0,278.20591358245025,0.060034386870893464,0.09106101473246157,229.51193019321985,226.3036662510463,9.71282721285219
2022-11-15,0,243.66500091552734,217.18249893188477,248.6974983215332,228.12624645233154,239.4537477493286,-0.15419244329480422,8.450908257296334,-0.7168367944117668,2.995075993561727,232.85124969482422,7.048362159729004,0.03618653449161061,224.24775047302245,245.00825080871581,0.7068009013637045,0.0058478582306952555,1.043366191132807,1.0603004725025635,1.0317530945388127,0.06513236565379343,57.11459119553279,250.43919101105263,233.53737449645996,216.6355579818673,235.6260713849749,8.686935202739877,231.08821432931083,8.727908297577153,235.47265305151495,234.81692481974966,11.272780228032243,-2.82772992843559,31390100,6.182445576955563,0.9031521318810823,-721180700.0,-17.41898738368827,89.02914134005623,91.58768807638091,81.56849494179872,31.169705029019553,22.112589011227733,-0.023215452143659134,8.262251085060631,239.83384246826174,234.78808059692383,230.70999908447266,226.6319175720215,221.5861557006836,0.04,0.0,278.06108345889885,0.057237659062070234,0.06187743105647636,232.40210178920202,227.0514875139509,9.82927473679717
2022-11-16,0,242.18499755859375,217.18249893188477,248.6974983215332,228.12624645233154,239.80499935150146,-0.14728304324136107,8.617286264022685,-0.8019533536155108,2.995050925516723,232.85124969482422,7.235637302398681,0.03687208013776596,224.24775047302245,245.00825080871581,0.7213097016413305,0.028751790381580218,1.0362734119008508,1.0482928376065204,1.012707705245646,0.0706202136898273,59.75351457630408,250.94219715420502,233.70762462615966,216.4730520981143,238.09714235578264,7.5026254365473735,232.0074999673026,9.192204394496477,237.54635756106236,236.00196015932366,11.522267974689923,4.706450799950023,24093300,6.1400283769167,0.6891372634043008,-745274000.0,-18.113447465148003,89.02914134005623,91.58768807638091,67.63570296556657,30.218766748218545,21.43796898005262,-0.02577657815740747,7.913519207798668,239.83384246826174,234.78808059692383,230.70999908447266,226.6319175720215,221.5861557006836,0.04,0.0,277.94752560019475,0.07973481715081032,0.05916556290492444,234.4442182268415,228.15118953159876,9.994311028261547
2022-11-17,1,240.08499908447266,217.18249893188477,248.6974983215332,228.12624645233154,241.7950029373169,-0.18714663885998592,8.791165770624783,-0.911170103477748,2.9950243931617497,232.85124969482422,7.528787403106691,0.037573239268364575,224.24775047302245,245.00825080871581,0.7419836275787461,0.02176985506693114,1.0261177357715643,1.0316297403722352,0.9906907981797172,0.003762784184064172,57.890160323943036,251.556456258962,233.9741247177124,216.39179317646284,239.71428571428572,6.275519540084925,232.64285687037878,9.435539499701818,238.72913210588314,236.7709647342297,7.691622138612362,5.6123668355575935,23123500,6.153732431714001,0.6601590508395413,-768397500.0,-18.25813216773189,89.02914134005623,91.58768807638091,55.15797702853343,28.65345813195975,22.89902213317937,0.0075954133397853965,7.749696055994743,239.83384246826174,234.78808059692383,230.70999908447266,226.6319175720215,221.5861557006836,0.04,0.0,277.8358055897759,-0.002547196828224463,0.07951143701457944,236.33885192871094,228.6069815499442,10.148907905049237
2022-11-18,0,241.875,217.18249893188477,248.6974983215332,228.12624645233154,241.7950029373169,-0.21968773667370498,8.869212736246427,-0.9597887963018397,2.9950124030778214,232.85124969482422,7.6970874786376955,0.03788203841967864,224.24775047302245,245.00825080871581,0.7526548973641994,0.006265974814236363,1.033092599675037,1.029192913181907,0.9973363103830252,-0.012775253788574914,54.936799934051244,251.8655502588698,234.12712478637695,216.3886993138841,241.9521429879325,1.9807307402307757,233.2774998801095,9.754113250138884,239.08124808280286,237.18666426895518,4.948311030309123,3.8474832601469395,27613500,6.16759148371568,0.7868695778670616,-740784000.0,-19.589125467730785,89.02914134005623,91.58768807638091,57.955115141105225,27.83835622300892,21.87627811821687,-0.024888087213302795,7.532575385654561,239.83384246826174,234.78808059692383,230.70999908447266,226.6319175720215,221.5861557006836,0.04,0.0,277.7049791096862,-0.021084478679750718,-0.0044456167344582844,238.78101239885603,229.2929970877511,10.140591883888204
2022-11-21,0,242.33499908447266,217.18249893188477,248.6974983215332,228.12624645233154,241.95249938964844,-0.24055412942755952,8.980065266487722,-1.0184300542592517,2.9949951119448586,232.85124969482422,7.877762470245361,0.038328620825107296,224.24775047302245,245.00825080871581,0.7341673365331872,-0.012906181681637971,1.0343317132921392,1.020990906818525,1.0018189653604925,0.002772409497171502,55.157243523700224,252.25150531172304,234.29137477874755,216.33124424577207,242.40214320591517,1.5605420629825544,234.05428532191686,10.027435007172224,239.7879947308572,237.35422363028638,6.924981644899626,3.8134693410425182,26394700,5.999866759895289,0.750552435050671,-714389300.0,-17.187500689868386,89.02914134005623,91.58768807638091,71.33256115840447,27.800112038932916,21.125521254503298,-0.07284300246250158,7.243105406304755,239.83384246826174,234.78808059692383,230.70999908447266,226.6319175720215,221.5861557006836,0.04,0.0,277.5852613126268,0.0048939258488527315,-0.017716168073071185,238.74620492117745,230.3155245099749,9.896712691665508
2022-11-22,0,243.6599998474121,217.18249893188477,248.6974983215332,228.12624645233154,241.95249938964844,-0.2588017760006665,8.836534915212564,-0.9787766411710379,2.9950175381894018,232.85124969482422,7.729125003814699,0.03773777092181171,224.24775047302245,243.79900093078612,0.6959532007425898,-0.025583286040274805,1.0405872149297248,1.0190821752283512,1.006738864034158,-2.0524359659601643e-05,54.66876269179513,251.82931963969028,234.15624980926515,216.48317997884,242.21000017438615,1.2356274283275677,235.3710708618164,9.989153583737082,240.42099344373892,237.21535080718132,1.3169728695493297,4.698434307909419,19665700,5.934650308257812,0.5714856120940824,-694723600.0,-8.564831065046379,89.02914134005623,91.58768807638091,85.78271761976367,27.15329056155986,20.141551527591886,-0.09250477185692565,7.054311506765907,239.83384246826174,234.78808059692383,230.70999908447266,226.6319175720215,221.5861557006836,0.04,0.0,277.4992495811842,0.015499966931813214,0.017265580701228706,238.5510733468192,232.11454663957872,9.532882700137561
2022-11-23,0,246.31000137329102,217.18249893188477,245.00500106811523,228.12624645233154,241.95249938964844,-0.3849272941703278,8.483193747356053,-1.0242975763543538,2.99507124513811,232.85124969482422,7.452062587738038,0.03626778572015411,224.24775047302245,243.66049995422364,0.8213911886937764,0.0470430176709513,1.0530371716809552,1.0237876588620471,1.017692177243784,0.017032449806059002,62.60089867875065,250.87076238027123,233.9043748855591,216.93798739084696,242.87357112339564,1.9404190190132966,237.45160675048828,8.88134041711652,241.21823219032774,237.24836473440251,-0.5489688842429765,8.185147017982285,19508500,4.652332414001164,0.6240761898546712,-675215100.0,-2.008599212760461,89.02914134005623,91.58768807638091,98.59354087486759,29.11864109432303,19.29772735282049,0.010128288701090732,6.836860290043196,240.05539733886718,234.9672964477539,230.85499572753906,226.74269500732422,221.65459411621094,0.06,0.0,277.4219539053375,0.02420065583142117,0.026068315731072184,239.49588884626115,234.50390951974055,10.00753916722664
2022-11-25,0,247.55749893188477,217.18249893188477,246.31000137329102,228.12624645233154,242.22249794006348,-0.42786076700196213,8.89529631166438,-1.0808987681277897,2.995009105288033,236.08749771118164,8.012750244140625,0.03791940983375147,224.24775047302245,243.79900093078612,0.8172904330083873,0.07411204172583316,1.05530315466919,1.020447486190342,1.0193717971625627,0.031124392927118993,67.06246051844923,252.37484250125848,234.5842498779297,216.7936572546009,243.42964226858956,2.6375388965768285,239.52785682678223,7.377990881200334,242.50284524616038,238.0332992633587,1.922080794549342,13.411532966356349,9200800,4.575825565939012,0.30980569295908245,-666014300.0,-4.412806476582773,89.02914134005623,91.58768807638091,95.38522580348835,28.949526294044126,18.879269588304716,0.05848864716358234,6.489227495750956,242.2288773803711,238.22555764770507,234.98999786376953,231.754438079834,227.75111834716796,0.08,0.0,277.38673327546314,0.02404010913913801,0.023828251361235665,240.3690468924386,236.38557434082034,10.232366286512288
2022-11-28,0,243.8224983215332,217.18249893188477,247.55749893188477,228.12624645233154,242.66624927520752,-0.5315155222782171,9.236954776452132,-1.0088615042711047,2.99495728810586,239.6349983215332,8.306737632751464,0.039223341678366115,224.24775047302245,245.1355010986328,0.8314949082740134,0.07079673133628156,1.03535563310527,1.0015948785420297,0.997851414374173,0.008051672647165775,67.86826013681774,253.97028444609276,235.4963748931885,217.0224653402842,243.66357094900948,2.5807558846614147,240.88035665239607,6.1152148321047965,243.76135843563745,239.06577003202298,1.597479326834819,13.303813150402922,24778200,4.570891165339766,0.8572247012123103,-690792500.0,-28.4776521621528,89.02914134005623,91.58768807638091,54.43321848358977,26.82242592301648,24.004993015673225,-0.029281520006951292,6.503568563436631,242.94867810058594,239.39065881347656,236.51499938964844,233.6393399658203,230.08132067871094,0.08,0.0,277.277786821468,0.0022385733908718564,0.0003310448817830249,240.37327139718192,237.40874481201175,10.332268910941854
2022-11-29,1,240.68249893188477,217.18249893188477,247.55749893188477,228.12624645233154,243.66125011444092,-0.6748853760626314,9.352077739430227,-0.921010273896627,2.9949405278692782,240.87500190734863,8.38140022277832,0.03960596689854307,224.24775047302245,245.1355010986328,0.8597008352288791,0.04649341412543165,1.019288264207224,0.9891766219524338,0.9834332340924208,-0.0068190734265828334,59.81557845024153,254.8321551660553,236.12799968719483,217.42384420833437,243.74892807006836,2.4491977779165532,241.73160689217704,5.032650913376735,243.75150313650505,239.5128530307909,0.6761363335659466,8.41976432409807,17956300,4.676941779716048,0.6325961975107354,-708748800.0,-34.34549361597684,89.02914134005623,91.58768807638091,31.299433746122578,25.444087045232635,25.67741697136757,-0.008184498492083381,6.366169848546147,242.94867810058594,239.39065881347656,236.51499938964844,233.6393399658203,230.08132067871094,0.08,0.0,277.1932374417815,-0.007105913038173539,-0.003689504153459468,240.1831534249442,238.2610026768276,10.336645340771554
2022-11-30,0,247.72500228881836,217.18249893188477,247.55749893188477,228.12624645233154,243.66125011444092,-0.7858771057943615,9.373272748028942,-0.8187058984672562,2.994938340206833,241.1737518310547,8.336837577819825,0.039631173001057535,224.24775047302245,245.1355010986328,0.8656320130933173,0.0398448799671553,1.0474070995597597,1.018531759688342,1.013577800977721,0.01668309301465931,54.895962077837275,255.2591702366585,236.5126247406006,217.76607924454268,244.5846426827567,2.6894871232356206,243.2683928353446,2.6485845677021334,242.9574488070392,239.41611804892023,0.248870129200318,5.209496027563804,47594200,4.728524957071426,1.6279766999935181,-661154600.0,-0.9345913639614906,89.02914134005623,91.58768807638091,99.24742584700749,34.2029078796156,21.63355227916808,0.11332216089579551,7.016443523415192,250.53212139892577,247.5639411315918,245.16500091552734,242.76606069946288,239.79788043212892,0.1,0.0,277.02945788906965,0.041260328868781615,0.054079705191863864,242.1435328892299,240.462272644043,10.949551931899027
2022-12-01,0,253.89999771118164,217.18249893188477,247.72500228881836,228.12624645233154,243.7043752670288,-0.8987483094320178,9.602410511774774,-0.6690808976453106,2.994903268798843,241.7700023651123,8.319525375366208,0.04046086640786668,224.24775047302245,246.43475112915038,0.8116746773155327,0.09990009888487876,1.0698369826777023,1.0421808144249243,1.0353988885173466,0.030814811804526387,65.81982770364174,256.53069573363257,237.325874710083,218.1210536865335,246.23678534371513,4.203331244332532,244.31946427481515,3.638315244271251,244.0889470549978,240.34138220934292,2.418605597444283,9.511075236029441,26041500,4.664386067300193,0.910003910275428,-635113100.0,-7.733874694659009,89.02914134005623,91.58768807638091,126.20760057590131,33.177580312884245,20.466764431581325,0.20263583455235473,6.886697338468364,251.756357421875,249.05681884765625,246.875,244.69318115234375,241.993642578125,0.12000000000000001,0.0,276.95321240465734,0.028717917298620055,0.03942382583636899,243.92364719935827,241.3349260602679,10.750321139595004
2022-12-02,0,252.64750289916992,217.18249893188477,253.89999771118164,236.5799970626831,244.1181240081787,-0.9461444638082173,9.826707038751712,-0.1610601950220678,2.9948736104263776,242.02999877929688,7.826313018798828,0.041157323228766515,224.24775047302245,247.57424926757812,0.713074184290302,0.16906288011177473,1.058166779446674,1.0320768207547695,1.0239525961006486,0.020560895910027188,74.70554708197092,258.4130385587046,238.75962448120117,219.10621040369773,247.5207143511091,4.635481303797889,244.86535726274764,4.267945552343581,246.494220628,242.164462711545,4.772318761384392,6.152141774269567,21528500,4.245804934791524,0.7726932082964247,-656641600.0,-5.949115336370085,89.02914134005623,91.58768807638091,131.99942955951397,30.973748151785347,20.389873474199646,0.29436950894558145,6.849790036682605,251.756357421875,249.05681884765625,246.875,244.69318115234375,241.993642578125,0.12000000000000001,0.0,276.8896889181959,0.030425470012815703,0.030050802169126218,245.33055986676897,241.94081660679413,9.525744256755099
2022-12-05,0,251.02249908447266,218.48999786376953,253.89999771118164,239.85999870300293,245.33125114440918,-0.9704526627869614,8.932233536944695,0.2808430394498389,2.9950339389405234,242.2599983215332,6.557475814819338,0.037135188064600706,226.07774925231934,248.2172523498535,0.6722499857835323,0.1563344105879753,1.0436099407155108,1.0202030840971947,1.013186383565865,0.02952968168443859,71.92198438807985,258.3973417534548,240.53287467956542,222.66840760567604,248.19392830984933,4.770574260883436,245.53374971662248,4.456743641838294,248.03763202189873,243.8257806408186,3.6885426649372413,3.1193248291817324,23435300,4.3037252651518125,0.8617835952482078,-680076900.0,-32.01731365947052,89.02914134005623,91.58768807638091,101.69492053295826,28.7283194422386,20.609511326284792,0.22619920975698773,6.857662656534132,251.756357421875,249.05681884765625,246.875,244.69318115234375,241.993642578125,0.12000000000000001,0.0,276.8123824392512,0.03491057191437852,0.010949829526308534,245.69953264508928,242.59771074567524,8.438534346214109
2022-12-06,0,247.89500045776367,224.88750076293945,253.89999771118164,240.53312397003174,246.62187576293945,-0.8692359737292763,7.63846037898447,0.31139853857480704,2.99522996196639,242.99749946594238,5.392100219726563,0.03154309612947966,228.5094959259033,251.18499946594238,0.6778217900681874,0.11621365452890543,1.0236848057718442,1.0037606377832007,0.994781207026667,0.029966871533605444,67.18830995856992,257.43642049856953,242.15949974060058,226.88257898263163,248.2421428135463,4.7647720426527265,245.83589254106795,4.463687243745671,248.80018402981037,245.09417318699116,1.9132384738367538,3.8720932576456413,22463700,4.224547958241747,0.8431612437920467,-702540600.0,-59.49164851125636,89.02914134005623,91.58768807638091,48.347303301243805,26.340930868726225,23.298763840606785,0.1493647526424222,6.944972598113278,251.756357421875,249.05681884765625,246.875,244.69318115234375,241.993642578125,0.12000000000000001,0.0,276.7280645736254,0.019930791435295303,0.013898067309518076,245.36575971330916,242.86740330287392,7.644354984042766
2022-12-07,1,244.3925018310547,226.20999908447266,253.89999771118164,241.41937828063965,247.59937477111816,-0.9428194881216846,6.614485266852575,1.0662385061908806,2.9953594015835865,243.66250038146973,4.680138092041017,0.02718543698367885,238.1429973602295,251.18499946594238,0.6558043645029848,0.08362295479137175,1.0044495814521914,0.987355689624349,0.9750815971837495,-0.013452418718229997,60.03471218972906,256.538845259047,243.30987472534179,230.08090419163662,248.3235718863351,4.680783038333452,245.99357141767229,4.362645768379101,248.59363848706414,245.79809354715036,0.13633258024301234,1.735989791862954,20481500,4.295187402078934,0.780048966577464,-723022100.0,-63.54789727338746,89.02914134005623,91.58768807638091,0.4973495257949461,25.236808261954053,23.988204160665106,0.15290112059125457,6.73104576474656,251.756357421875,249.05681884765625,246.875,244.69318115234375,241.993642578125,0.12000000000000001,0.0,276.64474276011845,-0.04221221469045355,0.01681003002515621,245.73332868303572,243.05330004010884,6.7609094509727425
2022-12-08,1,246.0099983215332,226.20999908447266,253.89999771118164,241.82250118255615,247.59937477111816,-1.0512913337316683,5.7115494012987575,2.6740340693911318,2.995456119701451,243.74374961853027,3.9633755302429194,0.023399238606079273,239.99499893188477,251.18499946594238,0.4671091018941769,0.08037886397670783,1.0078607827322215,0.9935964027601483,0.9841521850734662,-0.03107522434333987,54.98257283644521,255.51434884074447,244.09125003814697,232.66815123554946,249.08464322771346,3.5206627867857327,246.4167856488909,4.019245184915526,247.56996671550138,245.9825800077222,0.23377806127218428,0.9114950532502982,22611800,4.341502718017242,0.8698642758138893,-700410300.0,-48.68792220483239,89.02914134005623,91.58768807638091,22.361212027865,26.467227659958674,22.526002802266596,0.22650338111459475,6.655971633617872,251.8932378540039,249.27837954711913,247.16500091552734,245.05162228393556,242.4367639770508,0.02,1.0,276.5593307158483,-0.028623130583575573,-0.030336377998116684,246.72900390625,243.45607866559712,4.816226839777367
2022-12-09,1,245.64749908447266,239.18499755859375,253.89999771118164,242.1074981689453,247.59937477111816,0.6715396581232361,3.9798014528796726,-0.3472421819299707,2.9956008899202002,244.10750007629395,3.2417501068115255,0.016238702278855165,240.62274894714355,251.18499946594238,0.6126312876340348,0.028534401541081254,1.0023104545307837,0.9922525521754737,0.9889449545636628,-0.02770660202207076,52.66205609259053,253.04085290575938,245.08125,237.12164709424064,248.78785705566406,3.7353973662963877,246.68624986921037,3.8124668527924728,247.2203068181558,246.2988240364897,2.2134967907060688,2.467875652229262,20609700,3.3034156767415226,0.8340052481181496,-721020000.0,-59.743181889824825,89.02914134005623,91.58768807638091,9.103525045159246,25.255916339829362,21.4950673925512,0.13613509932415982,6.476973222933012,251.8932378540039,249.27837954711913,247.16500091552734,245.05162228393556,242.4367639770508,0.02,0.0,276.4807793160097,-0.03764414707550712,-0.03639724592327047,245.36011614118303,243.75182451520647,4.756030705803949
2022-12-12,0,249.91749572753906,240.08499908447266,253.89999771118164,242.29749870300293,247.59937477111816,0.7430197941895719,3.7432809202699486,-0.21960498190435773,2.995616365720041,244.69875144958496,3.007562446594238,0.015253521536061439,241.56675415039064,251.18499946594238,0.6855091690288594,0.00262238735354956,1.0183905468264045,1.0102799433063983,1.0118383519184508,-0.004402009226120218,49.456155324988046,252.89093691683382,245.40437507629395,237.91781323575407,248.218928200858,3.0712511581652016,247.22785677228654,3.683169406786968,246.83552175538017,246.05668553805373,-0.8386328328392051,1.5596895439680232,30665100,3.043780528943669,1.2509239633253868,-690354900.0,-20.156353700833982,89.02914134005623,91.58768807638091,94.7618761301365,27.918814389684268,19.81916188178284,0.1489756620490974,6.522903358448869,251.8932378540039,249.27837954711913,247.16500091552734,245.05162228393556,242.4367639770508,0.02,0.0,276.3828240119435,0.00923261732842029,-0.009842465920541412,245.05309840611048,244.48837280273438,4.984537559074463
2022-12-13,0,258.90000915527344,240.08499908447266,253.89999771118164,242.29749870300293,247.7675018310547,0.5620971852247254,3.8681078655234247,-0.6358348625860826,2.9956086524869363,245.02000045776367,3.2134998512268056,0.01574641916762392,241.56675415039064,251.18499946594238,0.6370565841590798,0.03414847344789069,1.0539385685173877,1.0440190074263043,1.0491444959053133,0.04439383076378256,58.44580637818701,253.38621554031195,245.64999980926513,237.9137840782183,249.11214338030135,4.9241561892693655,248.3164288657052,4.668011179271993,247.59397964760842,246.33224663248174,-1.5685317130931153,3.1289317150690703,42196900,3.074016917403825,1.6833216050653352,-648158000.0,-27.2267529056086,89.02914134005623,91.58768807638091,194.7932817767984,36.43629567265628,17.46865494844087,0.12151413951817482,6.871983042976898,257.85245184326175,254.0987908630371,251.06501007080078,248.03122927856447,244.27756829833984,0.02,1.0,276.2869073125245,0.04813971822590224,0.026858613120348374,245.3206787109375,245.32561928885323,5.3727912099300825
2022-12-14,0,257.8125,240.08499908447266,258.90000915527344,243.32874965667725,248.40062427520752,0.8980929087802637,4.712087977740023,0.3151425300182096,2.9955505900631247,245.82874870300293,3.7471006011962915,0.019115064402231038,241.75574989318847,252.7727523803711,0.5255480612669525,0.0625244010526883,1.0458426422597844,1.0320519016189256,1.0355017668417437,0.05491166082592169,68.54107929998284,255.93592598599764,246.5117500305176,237.08757407503754,250.08214351109095,5.929366600170019,249.13803591047014,5.262153336717702,250.4119004520158,247.9433006676028,2.474794401035047,6.2546209133239445,35410900,3.609897983796739,1.4013751410837447,-683568900.0,-26.05993954648588,89.02914134005623,91.58768807638091,162.31527941709626,33.34568378581293,15.98692274613765,0.12726618087384367,6.972555595971382,257.85245184326175,254.0987908630371,251.06501007080078,248.03122927856447,244.27756829833984,0.02,0.0,276.207488125966,0.05258440451155599,0.04936373030689641,246.309326171875,246.00442940848214,5.669326398527091
2022-12-15,0,251.06749725341797,240.08499908447266,258.90000915527344,243.32874965667725,250.19374656677246,0.7426662144337693,5.261515204915038,-0.3157974396627399,2.9955069429710033,246.1599998474121,4.24053813934326,0.021282800047285128,241.75574989318847,254.29124794006347,0.6420560281955435,0.06452712843051049,1.0155666446473925,1.0010087009552515,0.9976555310162722,0.020558103192515942,67.04282559569934,257.74215539457134,247.2191249847412,236.6960945749111,250.53535733904158,5.85510941429437,249.38875007629395,5.2646723050969255,252.2474417406241,249.25381623163764,2.7049371830380875,4.669927555753842,35560400,3.5978840767344673,1.3760680999000272,-719129300.0,-57.9930572824645,89.02914134005623,91.58768807638091,37.46294693792993,30.068276886206863,21.349357497966693,0.09962006047514228,7.180230545798816,257.85245184326175,254.0987908630371,251.06501007080078,248.03122927856447,244.27756829833984,0.02,0.0,276.09423546769625,0.00650773523206194,0.018987662076531606,246.85716247558594,246.11146109444752,5.50564938326876
2022-12-16,0,246.64749908447266,240.08499908447266,258.90000915527344,243.78187370300293,251.03374862670898,0.5814707768288673,5.1922703857043375,-0.4417106193594922,2.9955133595386374,246.9337501525879,4.191825485229492,0.020965041790997008,241.75574989318847,254.29124794006347,0.6579074595722345,0.04574420813805688,0.9958986612461278,0.9844979367201356,0.9761684213186037,0.004070873930029695,55.76685997068446,258.0477907408911,247.66324996948242,237.27870919807373,250.85749980381556,5.512836160007109,249.59053584507532,5.0860240001606885,251.955679828002,249.6440093400182,1.2797744165053568,1.4178517462316809,86102000,3.930589523834069,2.969960291070044,-805231300.0,-74.79582249955637,89.02914134005623,91.58768807638091,-32.44760089223137,28.1587100982603,23.836076213956165,-0.02193229366679748,7.119499923108726,257.85245184326175,254.0987908630371,251.06501007080078,248.03122927856447,244.27756829833984,0.02,1.0,275.78057704012406,-0.0029744900723248646,-0.010953876399953252,246.90223039899553,246.3177795410156,5.366925679521559
2022-12-19,0,242.30750274658203,240.68249893188477,258.90000915527344,244.25000095367432,251.03374862670898,0.6740597505486502,4.90225447236775,-0.2732620900693359,2.9955377234244587,247.1024990081787,3.9327877044677733,0.019767842623442115,242.28899917602538,254.29124794006347,0.6302469823898456,0.01973126236474483,0.9770803632844092,0.9694966225575314,0.958233324419515,-0.030450020951128143,48.840747361553795,257.79588391421794,247.99137496948242,238.1868660247469,250.32857186453683,6.191311127510552,249.70660754612513,4.8815205244861675,250.6483680225224,249.42288471977812,0.9226949421618584,1.1586300617812852,29696400,4.0718728546227405,1.0206665348002697,-834927700.0,-93.09801756848447,89.02914134005623,91.58768807638091,-106.55860733806865,26.310904436950842,27.117780426615294,-0.04224000344541381,7.0752499284599795,257.97045184326174,254.2897908630371,251.31501007080078,248.34022927856446,244.65956829833985,0.04,0.0,275.65758010259253,-0.04776034702700249,-0.020250914695272595,245.92345319475447,246.3262285505022,5.420262745512085
2022-12-20,0,240.63249969482422,240.68249893188477,258.90000915527344,244.25000095367432,251.03374862670898,0.6911439492080991,4.876110058154192,-0.25815815169774137,2.99553984375593,247.1024990081787,3.9176501083374005,0.019660703495599837,242.3322494506836,254.29124794006347,0.5797964213581945,-0.0001134641632224175,0.97024147762896,0.9661637391871006,0.9573716738895802,-0.07055816459818431,43.37993978565772,257.7652202231199,248.01300010681152,238.26077999050312,249.61214338030135,7.053397356388682,249.2000002179827,5.4391721253189225,248.55939083499214,248.63181831154498,-1.5050183326744462,0.6751649255383358,25150800,4.198029160326114,0.866285880402619,-860078500.0,-86.74508682245782,89.02914134005623,91.58768807638091,-110.26388573397617,25.08629322836348,26.156239976986992,0.0025573012350568955,6.890589611106825,257.90200982666016,254.17900759887695,251.17000579833984,248.16100399780274,244.43800177001953,0.06,0.0,275.5528468963049,-0.05885103670402336,-0.042414104938436094,245.41364179338728,245.38687896728513,5.434844752496228
2022-12-21,0,242.96249771118164,240.63249969482422,258.90000915527344,244.25000095367432,251.03374862670898,0.6086259696610575,4.988066516686228,-0.30065251349314037,2.995530675790132,247.1024990081787,3.9772375869750958,0.02011902257430029,242.1450023651123,254.29124794006347,0.5907158189167945,-0.01242510118396048,0.979972492308914,0.9783718162371771,0.9808997731093434,-0.05760000887784089,41.00816710700297,257.90400817070156,247.9278751373291,237.95174210395663,248.61857223510742,7.4801598437423005,248.4187502179827,5.497350785229841,246.56159160213397,247.61218333802302,-2.0415430274435207,-2.8630548101580446,23690600,4.201585963151902,0.8103740299659764,-836387900.0,-76.43140819390499,89.02914134005623,91.58768807638091,-72.36298901668991,26.482623822248822,24.64057811480529,-0.0039835204030734045,6.791975674816574,257.90200982666016,254.17900759887695,251.17000579833984,248.16100399780274,244.43800177001953,0.06,0.0,275.46143192455554,-0.04972406443035815,-0.048614337162905745,244.27572413853235,244.6644112723214,5.453798791815722
2022-12-22,0,238.82749938964844,240.63249969482422,258.90000915527344,244.25000095367432,251.03374862670898,0.6002245161195653,5.020119717347555,-0.33081093065916534,2.9955280128832595,247.1024990081787,4.001850204467774,0.02025115560636863,242.1450023651123,254.29124794006347,0.6417710899319055,-0.013590612007005438,0.9634297836576543,0.9622749440736598,0.9759075040796741,-0.048751821711971566,43.66692874579892,257.9332394652127,247.89300003051758,237.85276059582247,245.75107084001814,6.687251058213484,247.43160711015975,5.9052693257484385,245.65424549242746,246.794029769542,-2.7829176169161784,-4.3077983846387085,28651700,4.190918631338971,0.9649858889712362,-865039600.0,-85.62394445296387,89.02914134005623,91.58768807638091,-138.9824759978374,23.65368733798837,28.320650929795825,-0.022214945900242287,7.061120095772927,256.8282091064453,252.44090643310545,248.89500427246094,245.34910211181642,240.96179943847656,0.08,0.0,275.33317138340794,-0.043452086510955,-0.07398350398066794,241.63794163295202,243.47931017194472,5.874207712981029
2022-12-23,0,236.9124984741211,238.82749938964844,258.90000915527344,243.6074981689453,251.03374862670898,0.45699253658690375,5.389388021167575,-0.49266653949574124,2.9954959676268933,247.1024990081787,4.325625419616699,0.021773644626748776,240.6774990081787,254.29124794006347,0.6338629283880527,-0.03526453280511765,0.9571492216092341,0.9573295530659651,0.9778640380174614,-0.0394692857072817,38.527652711990115,258.2976509736706,247.51887493133546,236.7400988890003,242.76535633632116,4.805497038050859,246.42374992370605,6.426357691538304,243.9427544823799,245.5434524495896,-7.752996931563125,-5.470073264502822,21207000,4.266347597114047,0.7000944980667099,-886246600.0,-83.82696289856906,89.02914134005623,91.58768807638091,-131.87345487616045,22.448073035447834,26.877164283069757,0.014710912232013328,6.908896708270097,256.8282091064453,252.44090643310545,248.89500427246094,245.34910211181642,240.96179943847656,0.08,0.0,275.23668593925214,-0.02435727649091668,-0.04128341996023551,239.0339573451451,242.67164175851002,6.192003862078748
2022-12-27,0,237.60499954223633,236.9124984741211,258.90000915527344,242.79874897003174,251.03374862670898,0.33194908314269506,5.864034416916113,-0.6049680214046469,2.995451102429457,246.32874870300293,4.800788040161132,0.023742315678388606,240.45199966430664,254.29124794006347,0.6720694192288054,-0.0283402880988438,0.9620156542092573,0.9635288078943942,0.988667594290602,-0.019407171263961298,37.477346045165206,258.7146937422795,246.98662490844725,235.258556074615,240.84214237758093,3.424648050373514,245.68874985831124,6.821445708181013,242.18811135198513,244.38988412988905,-8.106667258522727,-5.621010332465596,16688600,4.211812090166037,0.5583872263476488,-869558000.0,-89.7171057776189,89.02914134005623,91.58768807638091,-120.85045428925494,21.76369891213426,25.980448120108093,0.03519287695740938,6.636832003132873,256.8282091064453,252.44090643310545,248.89500427246094,245.34910211181642,240.96179943847656,0.08,0.0,275.1612194597489,-0.014514508521936476,-0.03159096809192731,237.33693368094308,242.09704807826446,6.489760980207718
2022-12-28,0,236.32749938964844,236.9124984741211,258.90000915527344,241.90125179290771,251.03374862670898,0.2664343485767486,6.179839503401048,-0.7577188918925697,2.995419085473969,246.32874870300293,5.080575485229491,0.025052480854585786,238.70524940490722,254.29124794006347,0.7064849674230077,-0.012786552421991415,0.9580491775899568,0.9631573011736116,0.9872153174510867,-0.017890352760477013,39.595431448233924,259.0354289762845,246.6757499694824,234.31607096268033,239.36785670689173,2.640533177100163,245.11267825535364,7.265430860484189,241.06713216582784,243.72562182866673,-5.362102963727363,-4.150951369138465,17457100,4.165537850564145,0.5845888370191263,-887015100.0,-97.80364971731905,89.02914134005623,91.58768807638091,-127.44084727306651,20.44833194103288,26.21794218916942,0.01201668561461898,6.55920136359039,256.8282091064453,252.44090643310545,248.89500427246094,245.34910211181642,240.96179943847656,0.08,0.0,275.0803173097391,-0.030066156913829634,-0.02462057279134265,235.9060821533203,241.4041562761579,6.904179834341781
2022-12-29,0,238.5574951171875,236.32749938964844,258.90000915527344,241.88875198364258,251.03374862670898,0.16891956040844575,6.457659238333372,-0.810812905105526,2.995389425760405,246.32874870300293,5.295500373840332,0.02620186497712907,237.5357494354248,254.29124794006347,0.7683238963878358,-0.046008690256794375,0.9679438083753512,0.9812728824720516,1.0001278522597474,-0.018130380760369547,34.631934215033226,259.3733184690374,246.45799999237062,233.54268151570383,238.83214133126395,2.3036464962392627,244.5803565979004,7.46490469033908,239.91404598907775,243.19988527818134,-4.184108792155152,-3.300020410193059,19770700,3.8070504484294942,0.6944151261230282,-867244400.0,-76.23961717473419,89.02914134005623,91.58768807638091,-77.42686463310588,21.191768364946107,24.12694955214266,-0.0442843257986024,6.618544079849936,256.8282091064453,252.44090643310545,248.89500427246094,245.34910211181642,240.96179943847656,0.08,0.0,274.9970307608549,-0.013991822499518247,-0.003267197757002167,235.98494393484933,240.95419856480186,6.714372017882279
2022-12-30,0,238.66250610351562,236.32749938964844,258.90000915527344,240.18124961853027,251.03374862670898,0.2761498860315075,6.673221785034348,-0.9345574845912132,2.9953651641872425,245.82874870300293,5.582375335693359,0.027126959217797737,237.5357494354248,254.29124794006347,0.7940467267881167,-0.06042734435723259,0.9701742694071345,0.9895422793151563,1.0042774030611314,-0.0006908471032627261,36.21810554655469,259.3460682038577,245.99962463378907,232.6531810637204,238.55071367536272,2.1630918562912744,244.08142852783203,7.619911057353995,239.58827172887868,242.87891411618313,-1.547623406988139,-3.0293497236666527,21938500,3.5293451947275307,0.7761483287612689,-845305900.0,-80.1996386639707,89.02914134005623,91.58768807638091,-77.52766870529203,20.171933056258474,22.965861217254048,-0.029820547216098333,6.4565045627700535,256.8282091064453,252.44090643310545,248.89500427246094,245.34910211181642,240.96179943847656,0.08,0.0,274.9032182151292,0.006843324645800619,-0.01886021456487697,235.70609828404017,240.55987003871368,6.519740077945384
2023-01-03,0,241.45249938964844,236.32749938964844,258.90000915527344,238.78625106811523,250.19374656677246,0.47915758590923413,6.597143836107213,-0.7228149192874804,2.9953718983763173,245.02000045776367,5.519000053405762,0.02690101273017936,237.5357494354248,253.16400260925295,0.8014587660590989,-0.055353789905596744,0.9845649755678602,1.0062858337552707,1.0161586262904165,0.019163197149867806,36.869176991397566,258.4320377256202,245.23775005340576,232.04346238119132,238.3349996294294,1.668561874697155,243.47678593226843,7.455265921495345,239.3366048484836,242.3380907254114,-0.8186731193030807,-2.8435025827619147,25740000,3.5333519066202053,0.9039052816829073,-819565900.0,-80.99832534257358,89.02914134005623,91.58768807638091,-46.568764632345605,24.620819641626078,20.88788554741212,-0.07665384982745613,6.591754673044473,256.8282091064453,252.44090643310545,248.89500427246094,245.34910211181642,240.96179943847656,0.08,0.0,274.8001267119464,0.0035604509658180294,0.0058357034136500814,235.02306256975447,239.64939335414337,6.2100363323414545
2023-01-04,0,230.0525016784668,236.32749938964844,258.90000915527344,238.78625106811523,248.40062427520752,0.6957193836545545,6.417177791128291,-0.34221265303668735,2.995390334418658,243.67749977111816,5.281799926757813,0.026227032239636718,237.5357494354248,251.74199752807618,0.8158697667065663,-0.038124071466612945,0.9402255282176591,0.9608551409703907,0.9644957960379549,-0.03178593833597765,43.739225932694026,257.51235546018626,244.6779998779297,231.84364429567313,237.08142852783203,3.5133489513738883,241.4162496839251,6.824430817588274,239.8233605175597,242.34361647115503,-0.6214944017114086,-3.3871163414342123,50623400,3.6115589075501164,1.696731179681886,-870189300.0,-91.42779066585082,89.02914134005623,91.58768807638091,-171.0696897028367,21.244261695784473,29.54241718418233,-0.0708046798931587,7.093771848388399,253.9453187866211,248.59734030151367,244.2750015258789,239.95266275024414,234.6046842651367,0.1,0.0,274.53041002904627,-0.03317013573425165,-0.04033848629970368,233.74290248325892,237.69042205810544,6.9078053301649485
2023-01-05,1,224.70499801635742,230.0525016784668,258.90000915527344,238.6362533569336,246.9593744277954,0.4968781836240725,6.983082785916535,-0.013885288474321467,2.995323282551639,242.63500022888184,5.5624500846862786,0.02866271443194628,236.85399856567383,251.74199752807618,0.7050289769962866,-0.07197603318481156,0.9223226169627269,0.9433488910961212,0.9480803495967188,-0.04917964013205356,30.96791336037553,257.59566557946243,243.6295000076294,229.66333443579632,235.33749989100866,5.858330398311779,239.0514281136649,6.430592153817866,237.35201618967483,240.87205241754398,-3.674199048939997,-11.142335440979283,39585600,4.329016182313019,1.2897720524952239,-909774900.0,-98.30455298901019,89.02914134005623,91.58768807638091,-198.25418636981212,19.67802402798408,31.583010632885696,-0.09660915841087948,7.1113604018625765,246.54415637207032,241.80791601562498,237.97999572753906,234.1520754394531,229.41583508300778,0.12000000000000001,0.0,274.2966297575454,-0.05210418143619244,-0.06182476702161746,231.4304417201451,235.2321995326451,8.300620513074307
2023-01-06,1,223.2599983215332,224.70499801635742,258.90000915527344,238.3193712234497,246.16937351226807,0.10071243509145278,8.025965283893322,0.185303251344636,2.9951847297668217,241.88000106811523,6.112749919891357,0.03310085902454495,235.69999961853028,251.74199752807618,0.7250523732803936,-0.08055690607196687,0.9207736974755945,0.9435919926589827,0.951313662781204,-0.0641249891902983,27.337996166819526,258.5219304533457,242.46999988555908,226.41806931777248,233.2882140023368,7.2714933272849605,237.06517818995886,6.721569159231125,234.19517643966083,238.9032495080361,-5.152746493489514,-12.841697739109849,43613600,4.405446205309005,1.3694065724833855,-953388500.0,-81.69895585609385,89.02914134005623,91.58768807638091,-174.11867504622978,18.402089633035686,31.97298651507546,-0.045374030483490375,7.061262401901109,242.64435864257814,238.19282006835937,234.59500122070312,230.99718237304688,226.5456437988281,0.14,0.0,274.0388826970322,-0.06671922193372115,-0.04093297513809481,229.7362322126116,233.53658294677734,9.110065633378195
2023-01-09,1,227.80500030517578,223.2599983215332,258.90000915527344,237.43187427520752,246.16937351226807,-0.05837271448562846,9.031393541131019,-0.09965058590758424,2.995031515752718,241.04249954223633,6.859125137329102,0.03741049373083391,229.51775131225585,251.74199752807618,0.773405531190017,-0.09247591624412729,0.9436304039854886,0.9708857891720142,0.9835014543450421,-0.04549313579079994,25.47438947720237,259.476161792345,241.41337471008302,223.350587627821,232.0707141331264,7.3903081410161136,235.71928542000907,6.53925091786157,231.49212635247062,237.10228486074809,-6.037331389633987,-11.075706427987743,27369800,4.36120849549356,0.8530020781364339,-926018700.0,-70.56821662861594,89.02914134005623,91.58768807638091,-112.16251468256533,22.804285329471384,29.91654671577425,-0.09375923163480389,7.007601717227423,239.51960144042968,235.66520233154296,232.5500030517578,229.43480377197264,225.58040466308591,0.14,0.0,273.8939989223817,-0.0529564647129549,-0.0576324697785807,228.69266619001115,232.29937417166573,9.498438272313487
2023-01-10,1,228.8125,223.2599983215332,258.90000915527344,236.76624870300293,245.89749908447266,0.0831758333000959,9.430824973393568,-0.37059249078258727,2.9949637674318557,239.72999954223633,7.231625175476074,0.03921289996075034,227.49500007629393,251.74199752807618,0.832231760731871,-0.07263456312722825,0.9513909650091383,0.9797823886834767,0.9971998886774396,-0.05234983867054699,34.33906806182143,259.36477475605227,240.50312480926513,221.641474862478,230.6785719735282,6.863807735378201,234.75535665239607,6.487824628292591,230.60856009430753,236.00744441460873,-3.606224035071374,-7.639444490310292,27033900,4.544475572603359,0.8341826698325858,-898984800.0,-64.01514319567671,89.02914134005623,91.58768807638091,-93.43723689236658,21.874996874261544,28.60106817742632,-0.09019148192190647,6.806344625870139,239.51960144042968,235.66520233154296,232.5500030517578,229.43480377197264,225.58040466308591,0.14,0.0,273.75461586703267,-0.04478670219374292,-0.04574265350865162,226.9801526750837,231.4825483049665,9.73527122379315
2023-01-11,0,233.52999877929688,223.2599983215332,258.90000915527344,234.75874996185303,243.8837480545044,0.24282238368006648,9.68205674331274,-0.4917358546511994,2.9949183563722244,238.74500274658203,7.474762706756593,0.0403989034493727,227.49500007629393,251.74199752807618,0.8360352765187375,-0.08444785214456456,0.9744165029535812,1.0034633256288985,1.0290974592038764,0.015116102087385341,34.270933212542126,259.025488341667,239.66137485504152,220.297261368416,229.94535664149694,6.100482731503349,234.24803515842981,6.266834125886483,230.2001127266991,235.17105708218534,-4.084967069427196,-5.569370569881122,28669300,4.4038703202159954,0.8873784893211745,-870315500.0,-37.803022859289506,89.02914134005623,91.58768807638091,-42.03468756017867,25.104539473270048,26.47654345718104,-0.09632858461365053,6.827319355810444,239.51960144042968,235.66520233154296,232.5500030517578,229.43480377197264,225.58040466308591,0.02,1.0,273.624588485524,0.029114053271697804,-0.01590268012006055,226.40978785923548,231.05794307163782,9.271208563013166
2023-01-12,0,236.8074951171875,223.2599983215332,258.90000915527344,232.66062450408936,242.47125148773193,0.4425893576196429,9.47054040177765,-0.21182358762702247,2.994950173446182,238.61000061035156,7.104650497436523,0.03965190544994235,227.49500007629393,251.74199752807618,0.7870355483027871,-0.09799153912258489,0.991481795955582,1.0193313665310426,1.0403518811613883,0.05385949225726194,38.91726417414317,257.78308081118473,238.8420000076294,219.90091920407409,229.28178460257394,4.7414423371929955,233.80839211600167,5.807519681932758,231.0484740547784,234.84456579867026,-2.1505293847843094,-2.951596698091447,27269500,3.971107479936401,0.864011806793659,-843046000.0,-27.42426957200251,89.02914134005623,91.58768807638091,-3.866214170426153,27.5845504073789,24.711351517132506,-0.05494119025947801,6.792510568782291,239.51960144042968,235.66520233154296,232.5500030517578,229.43480377197264,225.58040466308591,0.04,0.0,273.5112170702985,0.0728711511058946,0.04107369801714616,226.25909641810827,230.6410794939314,8.238158754053952
2023-01-13,0,237.62999725341797,223.2599983215332,257.8125,232.66062450408936,241.66625022888184,0.3533299087250941,8.280199968570095,0.13143753316091633,2.9951278490150237,238.0812473297119,6.155625343322754,0.034829189111519075,227.49500007629393,247.0894989013672,0.7276415333623166,-0.08147395833333333,0.9995483375189925,1.0226605096167114,1.0329807853231678,0.06436441386687397,44.74700202000323,254.29777424286527,237.7373743057251,221.17697436858492,230.3642839704241,5.712321012577765,233.72285624912806,5.736291362538369,232.4782576083178,234.9916087807843,-1.9237756014962495,-2.5333138455428688,21333300,4.102871695050033,0.6913464782269269,-821712700.0,-24.696991590324618,89.02914134005623,91.58768807638091,14.980997545266932,26.26112529804923,23.525773989122595,-0.0067551195482365095,6.625188167163904,239.51960144042968,235.66520233154296,232.5500030517578,229.43480377197264,225.58040466308591,0.04,0.0,273.4242768122459,0.06357542177001951,0.07610994319894725,227.68572344098772,230.71431296212336,6.897715291156465
2023-01-17,0,239.0800018310547,223.2599983215332,251.06749725341797,232.66062450408936,240.83749961853027,-0.1821565505679939,6.884287972349792,-0.2982115266460341,2.9953085139165356,237.61749839782715,5.260524768829347,0.029080973633411503,227.49500007629393,243.33099784851075,0.7337880546696297,-0.053521463936993405,1.0099343980742483,1.0293115815821523,1.0264600848596663,0.049494091485149605,48.39353234794669,250.49682511309558,236.728249168396,222.9596732236964,232.41785594395228,5.918893244903993,233.87767791748047,5.856982135246375,233.7477551861558,235.2854861095048,3.2938114211606657,-0.5014088156894936,29831300,3.898293219515173,0.97579891894827,-791881400.0,-20.454527064127472,89.02914134005623,91.58768807638091,45.617926424780364,26.85795335121313,22.52665032825331,0.05750980729358563,6.42481810678536,239.51960144042968,235.66520233154296,232.5500030517578,229.43480377197264,225.58040466308591,0.06,0.0,273.30888110102944,0.05825118989853828,0.06855469823867001,230.22632925851005,230.8283854893276,6.35312938505119
2023-01-18,0,238.82000350952148,223.2599983215332,246.64749908447266,232.66062450408936,239.46812629699707,-0.6186294561746177,6.085228509851776,-0.4168279350592985,2.9953983453903823,237.61749839782715,4.8608249282836935,0.025770793704854626,227.49500007629393,242.37300224304198,0.7298425003873571,-0.030681427062944706,1.0113968658814505,1.0280074316231151,1.0155120717394335,0.04373669930410928,52.52968924222788,248.29933141698137,236.12887439727783,223.95841737757428,234.6407138279506,4.703425001688854,233.96446391514368,5.9250662245934995,235.06577553529564,235.84196424861025,6.397278183216395,0.9148961624624287,30028700,3.823698138302363,1.0814337197924624,-821910100.0,-37.65153310406608,89.02914134005623,91.58768807638091,31.525868641132977,24.81944701103569,22.553938440805457,0.11105344626468297,6.455902571350027,239.51960144042968,235.66520233154296,232.5500030517578,229.43480377197264,225.58040466308591,0.08,0.0,273.1882406981627,0.03041292863292311,0.0382617804044292,231.75858197893416,230.7474070957729,6.048857359837207
2023-01-19,1,232.97749710083008,223.2599983215332,242.96249771118164,232.66062450408936,238.890625,-0.8924000932471411,5.630885128388628,-0.3600026186925658,2.9954448967455787,237.61749839782715,4.626000061035154,0.02388625117981021,227.49500007629393,241.5379997253418,0.7518632682970167,-0.014392865253982489,0.9882920514463485,1.003995891500664,0.9823083008443882,-0.0023658702580174884,54.04748407919181,246.99926987530753,235.73749961853028,224.47572936175303,235.37964194161552,3.7627659971278034,233.72517803737097,5.889834042041034,235.99612142628837,236.19191383024102,6.969455032235183,0.5113545462536359,28623000,3.7091538714535752,1.0328060151938636,-850533100.0,-52.348524694390605,89.02914134005623,91.58768807638091,-37.276026111757936,23.389753010733223,26.689496879145796,0.11119465798314113,6.361195593528808,239.51960144042968,235.66520233154296,232.5500030517578,229.43480377197264,225.58040466308591,0.08,0.0,273.05719779006773,-0.016287219332142167,0.013458578529161177,232.4359850202288,230.56432560512002,6.010623654336851
2023-01-20,1,237.58250045776367,223.2599983215332,242.96249771118164,232.24624824523926,238.82187747955322,-0.8204404948454896,5.450860340853439,-0.42068324361148024,2.9954621215904047,237.2587490081787,4.575450115203855,0.02316843281250837,227.49500007629393,240.71449966430663,0.7245429543234994,-0.031812006290515185,1.0098248450852094,1.022551818192517,1.0021914069156095,0.0032727230199898205,44.63498264608212,246.1727200179496,235.27099933624268,224.36927865453578,236.63249914986747,2.438856349664931,233.65553556169783,5.8337982903958885,235.23355120686566,235.7450933743705,2.2705808866025916,-1.4175253821371816,35389800,3.908720685408576,1.2538116763510792,-815143300.0,-20.946969915903225,89.02914134005623,91.58768807638091,49.1816545423188,26.842396914328056,24.11987355542207,0.13887862543768167,6.5361111096359235,239.51960144042968,235.66520233154296,232.5500030517578,229.43480377197264,225.58040466308591,0.08,0.0,272.9193867227805,0.007169652951287242,0.018874275203213456,234.03724670410156,230.50869968959265,5.934831252309556
2023-01-23,1,242.125,223.2599983215332,242.96249771118164,232.24624824523926,238.7018804550171,-0.8333248150264755,5.340270572181698,-0.3494237115893668,2.995472643607649,237.24749946594238,4.46870014190674,0.02271310248402933,227.49500007629393,239.31725158691407,0.6697363788417205,-0.022143323780830435,1.0297998696157618,1.0363586978543118,1.0206856139451945,0.018915973566200783,51.404217318788426,245.79904051875303,235.11849937438964,224.43795823002625,237.86035646711076,2.759128596271111,233.90285655430384,6.128353768452647,235.81511008569004,235.84433526638958,3.832832759470602,-0.4087042660071853,31934000,4.023757010280873,1.1150941722763579,-783209300.0,-12.007571597838325,89.02914134005623,91.58768807638091,109.33423544249558,30.100557134740363,22.648521844507044,0.11681799069146141,6.463532049792419,239.51960144042968,235.66520233154296,232.5500030517578,229.43480377197264,225.58040466308591,0.1,0.0,272.810227179994,0.014003315624682378,0.017064397020700173,234.9963095528739,230.7030487060547,5.802904658380329
2023-01-24,1,242.2324981689453,223.2599983215332,242.125,232.24624824523926,238.7018804550171,-0.8847010743996822,5.281559744386443,-0.3464263207966676,2.9954781517253553,237.24749946594238,4.439387722015383,0.022467396560041174,227.49500007629393,239.31725158691407,0.6626352059968437,0.013807039050271473,1.0304406007857014,1.028513859932059,1.017283510119352,0.01318594743912671,59.384731718464806,245.63974397760347,235.07662448883056,224.51350500005765,238.63535690307617,3.1485306089533824,233.95857075282507,6.205330985576724,237.37022316639136,236.35084683372222,3.680469860673462,1.4507908900372393,40234400,4.052997447983171,1.3770851462714868,-742974900.0,-12.122408383708418,89.02914134005623,91.58768807638091,98.29468628015866,28.893592029037805,21.74036670838458,0.10528101032261701,6.252565082316146,239.0764800415039,235.30676119995115,232.26000213623047,229.21324307250975,225.443524230957,0.1,0.0,272.67234991921447,0.007031369238170049,0.011745926849604538,235.49344526018416,230.8762708391462,5.961664744955911
2023-01-25,1,237.3224983215332,223.2599983215332,242.2324981689453,232.24624824523926,238.7018804550171,-0.8012911161949667,5.451858542920435,-0.4313304427629707,2.9954620066828666,237.24749946594238,4.558562679290773,0.023175051979675846,227.49500007629393,241.5197494506836,0.6966980701296231,0.022455546790855964,1.0088231730975659,1.0015308469093285,0.9940313447186268,-0.006270434494523358,60.41057376626992,246.15059151363627,235.2468744277954,224.34315734195454,238.59142848423548,3.1669862556589305,234.4778562273298,6.157316809134638,238.6052028700413,236.88289884407502,2.2908916160247266,0.3230444005626703,66526600,4.02319587215677,2.1130922650295534,-809501500.0,-17.66072408945126,89.02914134005623,91.58768807638091,41.385744258778224,25.06921143328555,29.046041307321783,0.12575042222689364,6.691668230620774,239.0764800415039,235.30676119995115,232.26000213623047,229.21324307250975,225.443524230957,0.1,0.0,272.41849116120756,0.020355491696562256,0.0010818977258896193,235.68779645647322,231.68675994873047,6.028297312813208
2023-01-26,1,245.48999786376953,223.2599983215332,242.2324981689453,232.24624824523926,238.7018804550171,-0.8081544499524093,5.458849409587627,-0.43179666187384935,2.995461343905541,237.45249938964844,4.572912673950194,0.023202747185160577,227.49500007629393,241.5197494506836,0.7127909175639822,-0.001188953183844551,1.0434510882301378,1.0322914285429217,1.029532640613905,0.05370690697017921,51.45600775726214,246.18507323934125,235.26737442016602,224.3496756009908,239.50714220319475,4.1162411235775584,235.96249907357353,6.125378218911348,238.3166032916762,236.70443750948635,-0.1294024051840714,3.160146744775385,33454500,4.184243223565653,1.0350588697563685,-776047000.0,-1.0704338745217126,89.02914134005623,91.58768807638091,137.78901889463924,28.32152025777841,26.68411869474844,0.17615218362190102,6.7636917104868575,241.4754395751953,237.2472808227539,233.8300018310547,230.41272283935544,226.18456408691404,0.12000000000000001,0.0,272.32120285148886,0.06928808057510949,0.05169408114431582,236.7651585170201,233.49574388776506,6.621224563492158
2023-01-27,1,248.4525032043457,223.2599983215332,245.48999786376953,232.24624824523926,238.88500308990479,-0.5880811077920973,5.881792313840028,-0.5088851953204028,2.9954192010404306,237.45249938964844,4.848887615203855,0.024958634357233615,227.49500007629393,242.13574981689453,0.6424601694831388,0.0387703441105442,1.0542764605995119,1.03952086827234,1.0311350433979136,0.045752539541583204,61.95140787242426,247.42520896392276,235.66162433624268,223.8980397085626,240.88321358816964,5.290761800618887,237.76196370806014,5.798388466181082,240.13299860716,237.63337813707992,2.681109245282862,9.249905445315935,26498900,4.549792850280704,0.808548019371784,-749548100.0,-7.130650296803781,89.02914134005623,91.58768807638091,146.25020134776162,29.058761506116035,25.803725823927568,0.19231845028103653,6.494856588184507,244.3028822631836,240.88356253051757,238.12000274658203,235.35644296264647,231.93712322998044,0.14,0.0,272.25098709022933,0.03305291222421736,0.06997800361445461,238.50443158830916,235.13150678362166,7.117436948776615
2023-01-30,1,243.75500106811523,223.2599983215332,248.4525032043457,232.24624824523926,239.67312622070312,-0.3346891479831849,6.510460902345424,-0.5229664362365267,2.9953513356664305,237.60624885559082,5.273262748718258,0.02755542163901782,227.49500007629393,242.55824813842773,0.672509821371105,0.04147850430059823,1.0316891433341386,1.0149216498661366,1.0025933279355341,0.00673206429784301,64.31440798266067,249.2887963316684,236.26787452697755,223.2469527222867,242.4228570120675,4.022981059443427,238.9012494768415,5.230684483617294,242.21651682948936,239.03029408106377,4.033372227314359,11.28393132321488,25867400,4.5675083320613075,0.7820057122083905,-775415500.0,-31.644422743055557,89.02914134005623,91.58768807638091,82.79699216990319,27.14279300202413,29.224451126622256,0.14196610038337384,6.45665302571681,244.52000183105469,241.2350018310547,238.5800018310547,235.9250018310547,232.6400018310547,0.14,0.0,272.1692819748311,0.0005358483366719735,0.010365419871670462,240.02260044642858,236.2292927333287,7.178517766839128
2023-01-31,1,245.53999710083008,223.2599983215332,248.4525032043457,232.24624824523926,241.62062454223633,-0.35600844862899067,6.697708642549952,-0.6649539651187175,2.9953298792068,237.60624885559082,5.455175457000729,0.028316798546973335,227.49500007629393,243.92850074768066,0.7322854080781126,0.02133764137375994,1.038102283064005,1.0197531890969722,1.0085828428277848,0.013654232841944891,56.88895082912725,249.92316710962385,236.52774982452394,223.13233253942403,243.5596422467913,3.5201279734980204,240.09607069832938,4.624221495086877,242.5874159636566,239.4128036739617,4.625984956229816,7.001602573065673,26541100,4.714056878772716,0.7968289084992212,-748874400.0,-10.548320139599925,89.02914134005623,91.58768807638091,106.23492344317161,28.183102225876635,27.507228835372246,0.14845745047098896,6.369748540586204,245.31059967041017,242.51469833374023,240.25499725341797,237.9952961730957,235.19939483642577,0.14,0.0,272.093877909302,0.023839173318164875,0.021559887815129252,241.09151349748885,237.5643801007952,7.552160617586577
2023-02-01,1,250.3499984741211,223.2599983215332,248.4525032043457,232.24624824523926,242.15187454223633,-0.35742625177118403,6.969520943678455,-0.8131778293270324,2.995297755376756,237.60624885559082,5.702300567626952,0.029423199009530637,227.49500007629393,245.4949977874756,0.7348817639536559,0.016928786082207273,1.0569015986415835,1.0369475957556804,1.0255538399377326,0.05489365839617011,58.107751911081536,250.81066626174658,236.87162437438965,222.93258248703273,244.7346420288086,4.257036794187417,241.29749924795968,4.959886973046984,243.29120653286162,239.85603787635114,3.349361433495416,7.3105696152221045,31259900,4.691044284702111,0.9307863174569145,-717614500.0,-9.918337452168368,89.02914134005623,91.58768807638091,147.10282092822067,33.03997435737652,24.62023770693145,0.1887947645713253,6.60833732028139,249.39799267578124,245.82099267578124,242.92999267578125,240.03899267578126,236.46199267578126,0.16,0.0,272.0223402216188,0.05045496739480759,0.04424895227516255,242.52377101353235,238.76004028320312,8.280146850325544
2023-02-02,0,261.34000396728516,223.2599983215332,250.3499984741211,232.24624824523926,242.6131238937378,-0.18588370618836272,7.510686791687004,-0.8439167353413524,2.995230299265458,237.60624885559082,6.058200531005861,0.03164839702648285,227.49500007629393,245.83124771118165,0.7629846813520904,0.08822984600281862,1.1012298121143547,1.0773231190386456,1.0592682093981158,0.06456477347933065,67.61631010303668,252.3378729119873,237.31649932861328,222.29512574523926,247.46428571428572,7.371734443886452,243.04982130868095,7.1163907558925095,244.99938345317892,240.80821383137877,3.397005048681918,7.202500656337674,39940400,3.910067633916261,1.2084749737142684,-677674100.0,-0.26461720684828255,89.02914134005623,91.58768807638091,222.00697449171636,38.727381333351104,21.615939878221855,0.25779032936055174,6.989170543350232,256.66364013671875,251.6981787109375,247.68499755859375,243.67181640625,238.70635498046875,0.18,0.0,271.9796069982566,0.06693569647505959,0.0997049225252765,245.70094517299108,240.5971952165876,9.884207553685005
2023-02-03,0,259.7975082397461,223.2599983215332,261.34000396728516,233.39187335968018,244.1887502670288,0.3530935462957434,8.954401277991028,0.20513157566384743,2.995032303049413,238.22500038146973,6.843713169097901,0.03748479780504835,227.49500007629393,248.64225273132325,0.6539966570909101,0.1630360084303104,1.0875609395078554,1.058587592587049,1.0396578758303239,0.04566267149286651,77.45037900976857,256.78967699903626,238.8808744430542,220.97207188707213,250.67500141688757,7.108052608946209,244.63321495056152,8.201171843453332,249.06067313198062,243.5757713583466,7.888085183769724,10.359684281934321,29077300,4.190929339099154,0.8940029980167463,-706751400.0,-18.641559886579806,89.02914134005623,91.58768807638091,171.99941083965368,35.77437531353903,20.12019637926699,0.28228715508006863,7.0256583616940445,256.66364013671875,251.6981787109375,247.68499755859375,243.67181640625,238.70635498046875,0.18,0.0,271.9414925363446,0.04106225655451157,0.04173396780729514,248.19929940359933,241.94354793003626,9.830816548004305
2023-02-06,1,256.82249450683594,223.2599983215332,261.34000396728516,235.98812103271484,245.50249767303467,0.45310122784111023,9.430275521364026,0.014222804202218331,2.9949683474700035,238.9500026702881,7.336300849914551,0.03918904535348258,228.71175003051758,251.2947494506836,0.698152283637283,0.16365452921661552,1.0672676914075088,1.0370779167470778,1.0185043522735417,0.053609129582818715,75.31599184672525,259.4960509969517,240.63549995422363,221.77494891149556,252.2939295087542,7.020296570515545,245.90053585597448,8.636348868609236,251.7419037578967,245.7456010582962,9.470239895992888,9.328582772606701,22518000,4.195113887142143,0.7155373576563498,-729269400.0,-23.287301245468576,89.02914134005623,91.58768807638091,127.83281609076755,34.42864314270853,21.807925204844025,0.2450751762697533,6.778826144658117,256.66364013671875,251.6981787109375,247.68499755859375,243.67181640625,238.70635498046875,0.18,0.0,271.90418886717697,0.057929206543337886,0.03469539102530118,249.4343981061663,243.09977831159318,9.58546980725421
2023-02-07,0,264.23499298095703,227.80500030517578,261.34000396728516,237.19374752044678,246.26812362670898,0.5523235092806559,9.171669985139022,-0.3963330960478637,2.9950205031393704,240.60250091552734,7.3038506317138685,0.03785040974931174,232.56099739074708,257.11999588012696,0.7581285856934175,0.1273786535097442,1.0904669237599194,1.0607150564211858,1.0371511265305449,0.07613829152425189,69.31728068704564,260.65696473376676,242.31362476348878,223.97028479321077,254.54857090541296,8.041102428877913,247.7158922467913,9.645668216049534,253.02683608925685,247.27935846301264,4.616276321512366,7.4211529780391,50841400,4.282893319140759,1.5574674817923924,-678428000.0,-3.1766646663456535,89.02914134005623,91.58768807638091,174.71821544043596,40.759310321268856,19.194234494248235,0.32204902572507504,7.151767134428383,259.7807498779297,254.21961041259766,249.72499084472656,245.23037127685546,239.66923181152345,0.19999999999999998,0.0,271.86902006816626,0.07969793580220741,0.102385390794301,252.1665322440011,245.33548191615515,10.256915254970675
2023-02-08,0,270.7250061035156,228.8125,264.23499298095703,237.51749992370605,248.92687702178955,0.6378924758775907,9.711023604290117,-0.5700765714079661,2.99494735602146,242.17874908447266,7.894650115966795,0.03977724888323525,233.4747486114502,259.9517578125,0.7122193236859081,0.15481013048219408,1.1089146093659528,1.0772530656847517,1.047255633215989,0.08138609048763668,74.0869283996396,263.55717160585806,244.13512439727782,224.71307718869758,258.401428767613,8.457937884731036,250.41214288984025,10.451088213176016,255.85630859219495,249.6842764112558,6.352316669408093,10.64190147305742,54686000,4.476413929971822,1.607171406538013,-623742000.0,-21.87090123980115,89.02914134005623,91.58768807638091,177.4167746625663,44.32364517385279,17.238151856452433,0.24590855207984738,7.394499361356232,265.9370460205078,259.2414837036133,253.8300018310547,248.41851995849612,241.72295764160157,0.2,0.0,271.85751139697555,0.05531166002710686,0.0763488290212281,255.54931640625,247.78595842633928,10.575465595032547
2023-02-09,0,268.5499954223633,232.97749710083008,270.7250061035156,237.6181230545044,251.9681224822998,0.8111221047721331,10.654777499317854,-0.46946678998331537,2.9948063040629997,242.99374961853027,8.810725955963132,0.0432715146755356,236.47974548339843,261.62950286865237,0.7295930677617842,0.15927293075255305,1.0906436167979847,1.0545815987278875,1.0227203265863392,0.027588548808550106,76.95912490297077,267.5403047010893,246.2307497024536,224.9211947038179,261.68857138497486,6.966109795410151,252.6241068158831,10.798187777904888,259.5901639566579,252.62092414931777,11.064390440081208,16.202212433567713,42375100,4.552722286671101,1.220778801741093,-666117100.0,-28.652442436853743,89.02914134005623,91.58768807638091,130.73865025952057,39.7057508560055,18.619938090562904,0.1507436842574629,7.664893920849411,265.9370460205078,259.2414837036133,253.8300018310547,248.41851995849612,241.72295764160157,0.2,0.0,271.8347087615325,-0.003703775199634496,0.04300697956005231,257.775868007115,249.43369075230189,10.83813897433572
2023-02-10,0,262.3450012207031,232.97749710083008,270.7250061035156,238.5225019454956,257.5662479400635,0.6721382618411185,11.28274195053893,-0.8644911284722299,2.99470704070087,244.62249946594238,9.641850662231445,0.04549827546468042,237.27099800109863,264.66649322509767,0.8019372068822457,0.13404347818242646,1.0579205998548362,1.0209694865445327,0.9936332094813471,0.009805686737403896,72.92539333269532,270.54723343568475,247.98174953460693,225.4162656335291,263.4021432059152,4.872943666582128,254.0683926173619,10.636917765532166,261.82667065534247,254.6745582869539,9.371181311892023,13.03441747811088,25818500,4.631643390290117,0.7453597074740653,-691935600.0,-29.786303827472615,89.02914134005623,91.58768807638091,88.64277233038531,38.384457948584085,20.07649090300999,0.1447116948870024,7.362400974706232,265.9370460205078,259.2414837036133,253.8300018310547,248.41851995849612,241.72295764160157,0.02,1.0,271.8094556170385,0.01838592143941753,-0.005669029347194704,259.23347909109935,250.87862505231584,11.042008163462967
2023-02-13,0,270.17750549316406,232.97749710083008,270.7250061035156,239.0150022506714,260.18313217163086,0.4630063944929421,11.390426121885417,-1.1471691431418305,2.994694862203608,245.5149974822998,10.009600219726565,0.045697219621615506,237.55650024414064,264.66649322509767,0.844898719351975,0.10400624606719203,1.0839244004769242,1.045797130936456,1.02132797861892,0.052000939450312256,63.539074106792484,272.03947708355355,249.25862483978273,226.4777725960119,264.66464342389787,5.3691906303034385,256.0644645690918,10.864575920427521,261.94869765547026,255.30742641119193,4.79129331723242,8.351058841797883,44630900,4.9539860068228645,1.2465387810141142,-647304700.0,-11.862190490576893,89.02914134005623,91.58768807638091,125.45113066455903,44.07024113381583,17.92298811465613,0.11953201314986843,7.657943762287894,265.9370460205078,259.2414837036133,253.8300018310547,248.41851995849612,241.72295764160157,0.02,0.0,271.8057503590927,0.05666546668309502,0.05020317598590155,260.1798640659877,252.94040461948939,11.737526555600933
2023-02-14,0,272.2725067138672,232.97749710083008,270.7250061035156,241.36375045776367,261.59125328063965,0.3077731973161755,11.925275087770146,-1.3097321804669801,2.994607398266012,246.9962501525879,10.690450592041014,0.04753264461071104,237.55650024414064,268.71274642944337,0.8120350995054425,0.13007153849732841,1.0852439213054348,1.0432366451276678,1.0189591438273315,0.030418051909912647,68.7046299366098,274.7365504273103,250.88600025177,227.03545007622972,266.446786063058,5.551690438972847,258.5608937399728,10.223262462746296,264.0126534778344,257.0148205608408,3.3816106955386727,11.536440211555956,37047900,5.164629625721223,1.0244218877584739,-610256800.0,-13.204818896310499,89.02914134005623,91.58768807638091,115.35176551234693,42.039134867132816,16.95397750865522,0.08999843996113197,7.517376525055264,268.5566474609375,263.48168603515626,259.3800048828125,255.27832373046874,250.2033623046875,0.02,0.0,271.80705304144686,0.01722990714801642,0.059975829935724125,262.12615966796875,255.16272953578405,12.307932059079889
2023-02-15,0,268.6375045776367,232.97749710083008,272.2725067138672,242.20562362670898,262.8174991607666,0.16279902307106053,12.464264236816065,-1.3839435940793239,2.9945168083609435,249.4012508392334,11.335438518524171,0.04935450460620983,237.55650024414064,270.23225555419924,0.8166240179505361,0.14007412575476322,1.0637187005323385,1.0188726956366974,0.9993434180841687,-0.007710782080768364,70.07471616226734,277.4741539695427,252.54562549591066,227.61709702227856,268.134644644601,3.5860329495843413,260.2142870766776,9.810175539767597,266.0583988559048,258.8975106586138,4.801816059994281,14.726799456232943,28922400,5.145847653086551,0.8009665080051925,-639179200.0,-21.527776857953356,89.02914134005623,91.58768807638091,85.57751012214096,39.611201903411974,18.963755199215285,0.14342826081902776,7.4082796841000835,268.60384674072264,263.55808486938474,259.4800033569336,255.40192184448242,250.35615997314454,0.02,0.0,271.79775991881235,0.01223912674359906,0.009099269927228749,263.9885995047433,256.7114988054548,12.194561908786554
2023-02-16,0,263.7024917602539,232.97749710083008,272.2725067138672,243.37437534332275,265.3137435913086,-0.02607111262951358,12.516507828211772,-1.4193635815524492,2.9945171811614872,253.58624649047852,11.453751373291016,0.04927050955727493,237.55650024414064,270.23225555419924,0.8088631042255313,0.15306202496189314,1.038049615665608,0.9932661928285237,0.9825109087550501,-0.018050656282773136,66.95854225126591,279.06951620574,254.0365005493164,229.00348489289283,268.0585730416434,3.686777765747408,261.30357197352816,9.233427996718856,266.68273765177804,259.92953520878444,4.600457640398122,9.429103798645393,29603600,4.995596875299237,0.8187197416478963,-668782800.0,-42.27433579478349,89.02914134005623,91.58768807638091,49.446508852366215,36.77766955225786,21.733398217628906,0.1256625541843377,7.409117808645528,268.60384674072264,263.55808486938474,259.4800033569336,255.40192184448242,250.35615997314454,0.02,0.0,271.77237655247654,-0.003085545202426987,-0.014709328283679969,263.31917463030135,257.7428534371512,11.116681822195567
2023-02-17,0,258.38500213623047,237.3224983215332,272.2725067138672,245.05624866485596,265.3137435913086,-0.10818918428854042,11.696170012613555,-1.4761578182256607,2.994682786988786,258.310001373291,10.730475788116456,0.04576454258012559,241.67075004577637,270.23225555419924,0.8293166319170383,0.10994072060090018,1.0110037234049274,0.9723719743936657,0.966188904819419,-0.015094623743721391,59.58591697172852,278.96509030751463,255.5727502822876,232.18041025706052,266.29571533203125,4.9374153059789245,262.3485720498221,7.813242507525328,265.957197440871,260.2751163265821,-0.20152562485980102,6.137989498687194,30000100,5.17245836592281,0.8359153744386847,-698782900.0,-55.30909529089848,89.02914134005623,91.58768807638091,8.969063638604773,34.57033376396847,26.18685474498455,0.0858387451126635,7.3191803863345735,268.78084674072267,263.8445848693848,259.8550033569336,255.86542184448243,250.92915997314452,0.04,0.0,271.7294699044804,-0.016699535088613993,-0.018639154319181905,262.1891871861049,258.8692517961775,10.49594025288247
2023-02-21,0,253.55749893188477,237.3224983215332,272.2725067138672,245.52749729156494,265.3137435913086,-0.19508411295311506,10.951324867832893,-1.3613410899253406,2.9948186484942316,259.0912551879883,9.763550872802739,0.04267644346451562,242.22174835205078,270.23225555419924,0.840550534434981,0.06715540376347122,0.9880934406351753,0.9547122772988269,0.9509535391093774,-0.061515138097608224,52.42426009528451,278.51552510187673,256.6128753662109,234.71022563054512,264.1539301191057,6.724805950923274,262.9212507520403,6.701154794072704,264.0726418416465,259.9356315731129,-4.55813230735205,6.001928577468245,28397400,5.3210927899755145,0.795176087425855,-727180300.0,-76.98946953656012,89.02914134005623,91.58768807638091,-29.928748124696842,32.36927550140118,28.859292564391307,0.065771231531116,7.258524731638014,269.37556774902345,264.80722650146487,261.11500549316406,257.42278448486326,252.85444323730468,0.06,0.0,271.67493719414693,-0.06640551684605756,-0.03723738648569573,260.73620169503346,259.2560348510742,9.995634960962809
2023-02-22,0,252.56999588012698,237.3224983215332,272.2725067138672,247.7243766784668,265.3137435913086,-0.2560506689411493,10.4678842612858,-1.1820770106209504,2.994900653324715,259.0912551879883,9.11380151748657,0.04070184730632698,243.60275077819824,270.23225555419924,0.814766014517919,0.046752606890264656,0.9820576106761265,0.9521646142553872,0.9592079141766353,-0.07236320358428883,47.505491960049696,278.12026883537686,257.1845003128052,236.24873179023353,262.7575007847377,8.047808138014577,263.0798219953264,6.4003079751804774,261.4314408228313,259.14799987389716,-5.582758051028448,3.265252881697449,22491100,5.469651273301267,0.6458334081121495,-749671400.0,-95.57154589589628,89.02914134005623,91.58768807638091,-45.103652761820626,31.05292718269236,28.956514502931512,0.05914779962522358,7.025772965061807,270.5248865966797,266.66756463623045,263.5500030517578,260.4324414672852,256.57511950683596,0.08,0.0,271.62920742163243,-0.07359386016723546,-0.07069157847164934,259.19267708914623,259.2130780901228,9.425421333186472
2023-02-23,0,254.4124984741211,237.3224983215332,272.2725067138672,249.87562465667725,265.3137435913086,-0.2889079094055979,9.95971914326976,-0.9895448180071562,2.994982267379581,259.0912551879883,8.545239143371582,0.03864829644623868,245.3164981842041,270.23225555419924,0.7495686320607909,0.06424800710607685,0.9872376438747695,0.9633470792132203,0.9808844868295613,-0.052952420496463426,47.717758785892144,277.62081348490375,257.70137519836425,237.78193691182474,260.50535692487443,7.8281630975413625,262.58500017438615,6.800446239152847,259.18230396094435,258.20660286488845,-3.7260116621596002,0.8867575073044671,29219100,5.330181501230977,0.88651392388549,-720452300.0,-83.23237818675776,89.02914134005623,91.58768807638091,-39.63305023668438,31.590348112666096,27.07142972611141,0.02083298083237017,6.978217796862409,270.5248865966797,266.66756463623045,263.5500030517578,260.4324414672852,256.57511950683596,0.08,0.0,271.57605519119244,-0.05402489429595425,-0.06158599759259255,256.9517800467355,258.5658220563616,8.547644462639745
2023-02-24,0,249.57000350952148,243.75500106811523,272.2725067138672,252.01499652862552,265.3137435913086,-0.09426640928963166,8.845436084054134,-1.1958723860642917,2.9951462436312455,259.0912551879883,7.622376441955565,0.03421092665949633,245.534997177124,270.23225555419924,0.7838067413270746,0.03634567879748384,0.9652459195161858,0.9508841445071233,0.9728857599088252,-0.053592547254278644,47.53403345846016,276.24674737410186,258.55587520599363,240.86500303788537,257.2621421813965,6.772098049424799,261.8544641222273,7.622574588491967,257.9928795039395,257.8428306914407,-5.835055361202841,-2.650763521849206,24990900,5.049954091607098,0.7680912160760405,-745443200.0,-96.09213198158713,89.02914134005623,91.58768807638091,-82.86772811923672,29.426733534465896,27.661166305310555,-0.033995969529691444,6.956202109151551,269.99624890136715,265.81188836669924,262.4300079345703,259.0481275024414,254.86376696777342,0.1,0.0,271.5190225858485,-0.04932286840273592,-0.07463238198450141,253.80759974888392,257.96687970842635,8.437406343337402
2023-02-27,0,251.20750427246094,243.75500106811523,272.2725067138672,252.01499652862552,265.3137435913086,-0.05548091424804422,8.584961291297953,-1.17311892011438,2.995181382987506,259.0912551879883,7.418376159667967,0.03317732811201152,248.16125259399413,270.23225555419924,0.7645579923225168,0.004497842810046741,0.970813205866756,0.9640950688852151,0.9901793246484458,-0.02777830680739468,41.59872106718703,275.92979807087715,258.75987548828124,241.58995290568532,254.77214213779993,4.813642781873281,261.45339339120045,8.043785901775886,255.8891099033429,256.8710848423917,-8.338154842862595,-3.936721641220082,21190000,5.1469783504591895,0.6566282187448919,-724253200.0,-92.8122913629728,89.02914134005623,91.58768807638091,-73.19866552284483,30.235664722634283,26.602145815817266,-0.047713265441485124,6.716473823009438,269.99624890136715,265.81188836669924,262.4300079345703,259.0481275024414,254.86376696777342,0.1,0.0,271.47383666707333,-0.030613038551968175,-0.04573717062637268,251.10250200544084,257.54555075509205,8.284999678274868
2023-02-28,0,249.6775016784668,243.75500106811523,272.2725067138672,252.22937297821048,265.3137435913086,-0.052114441487940304,8.439336743783029,-1.1211083866035125,2.995200506367151,259.0912551879883,7.280626106262206,0.03259719638650818,249.16700286865233,270.23225555419924,0.7288584995201254,0.03057374483267798,0.9643869894753606,0.9623365669694239,0.9897488200513893,-0.015302238229050746,44.97770329467341,275.7762990292531,258.89762554168703,242.018952054121,252.76857212611608,3.085749732708424,260.4135725838797,8.579624961457705,254.70135085715754,256.38044341153926,-6.4882974298692835,-2.1863311643153374,22491000,5.031970411341309,0.7006082622930802,-746744200.0,-95.3943060126861,89.02914134005623,91.58768807638091,-88.14373264818104,29.309197896361525,26.519749096844915,-0.03727710676565005,6.433869247454329,269.99624890136715,265.81188836669924,262.4300079345703,259.0481275024414,254.86376696777342,0.1,0.0,271.42399089413294,-0.012862605173419417,-0.03348059717780406,249.3052215576172,256.31219809395924,7.682082500637964
2023-03-01,0,248.43749618530273,245.53999710083008,272.2725067138672,252.22937297821048,265.3137435913086,0.09056650250041243,7.99501688844637,-1.2439442700817818,2.995256855196158,259.0912551879883,6.984501075744627,0.030845716267449776,249.66675186157227,270.23225555419924,0.7026939490880204,0.01685063381318551,0.9585011044318932,0.9651834471913618,0.987872142478716,-0.016361799747526606,42.6858918791442,275.1837843490973,259.1937505722046,243.20371679531183,251.3474998474121,2.2438403194423766,258.8216075897217,8.58688332153005,253.44084496347313,256.09443981096354,-5.318489783000603,-5.509297288092107,27565300,5.038121234059474,0.8573081811315567,-774309500.0,-98.35500049415863,89.02914134005623,91.58768807638091,-110.92412401199748,27.61232077407314,28.29591735357046,-0.11103843485754357,6.341449971888368,268.08351934814453,263.8232381896973,260.37999725341797,256.9367563171387,252.6764751586914,0.12000000000000001,0.0,271.3569586048464,-0.020834091723729964,-0.025329368313596726,247.64065769740515,254.914922441755,7.755609658500844
2023-03-02,1,248.66749954223633,248.43749618530273,272.2725067138672,252.22937297821048,265.3137435913086,0.18143999900800323,7.769356956860399,-1.3397109378749903,2.995284224636296,259.0912551879883,6.839626121520995,0.029958348630442066,249.66675186157227,270.23225555419924,0.7261550148871462,-0.0076393141620732085,0.9588525389824569,0.9751064387010542,0.9920470225715798,-0.022581433562978592,39.49140246481906,274.87733944014906,259.33862552642825,243.7999116127074,250.64892850603377,2.2019388624701146,257.40142931256975,8.49785963541418,252.2078257396007,255.81288707455775,-3.849877457548031,-8.232527256714121,24808200,4.92779781390369,0.7793789209358378,-749501300.0,-81.26703036218315,89.02914134005623,91.58768807638091,-92.56277380355154,26.33297689854286,26.43900564428579,-0.10162476969103486,6.302060208616792,268.0410410766602,263.75448098754885,260.29000091552734,256.82552084350584,252.53896075439454,0.14,0.0,271.3012841275675,-0.014365804038874996,-0.0015902410702332752,247.42041669573103,254.07830919538225,7.802640211016222
2023-03-03,1,253.62249755859375,248.43749618530273,272.2725067138672,252.22937297821048,265.3137435913086,0.15624836682399423,7.874624193618829,-1.337003309063736,2.995271592843049,259.0912551879883,6.923751068115233,0.030374107975008686,249.47975311279296,270.23225555419924,0.8156418698263417,-0.048490488377872634,0.9782761610361864,1.0023861801678877,1.0164741435438078,0.016237905165224165,34.91863084913377,275.0037489670716,259.254500579834,243.50525219259637,250.79928588867188,2.3834348526611016,256.7783933367048,8.42698973258786,251.35955522419442,255.51221347790514,-1.92855640643548,-7.403647819415027,30760100,4.182630714429608,0.9805042535927666,-718741200.0,-67.02999838369097,89.02914134005623,91.58768807638091,-43.722341577335314,29.841188919980297,25.059502913294807,-0.12385253953751174,6.174055515622417,268.0410410766602,263.75448098754885,260.29000091552734,256.82552084350584,252.53896075439454,0.14,0.0,271.24743872173013,0.024356040638439547,0.002041072338682034,247.954097202846,253.5733871459961,7.734848082281221
2023-03-06,1,257.3499946594238,248.43749618530273,272.2725067138672,252.22937297821048,265.3137435913086,0.27877855821597797,7.951686180327789,-1.3482133754121817,2.9952617296243473,257.6037483215332,7.062488517761231,0.030717071921557884,249.47975311279296,270.23225555419924,0.8452445564599447,-0.02376855237369685,0.9941335857195754,1.0211865757568226,1.0280737641094806,0.024451858652680736,44.56825988840012,274.77199762005506,258.86862525939944,242.96525289874378,251.218928200858,3.2328612894668085,255.8621425628662,7.504979537479187,251.9150433411267,255.54027622417618,0.4167168292493062,-3.3248217505663047,24109800,4.358969303681564,0.7746533630387998,-694631400.0,-61.64852086935597,89.02914134005623,91.58768807638091,-9.421416149774675,33.435703118077505,23.637084638988327,-0.11665564310776837,6.078051681003451,268.0410410766602,263.75448098754885,260.29000091552734,256.82552084350584,252.53896075439454,0.02,1.0,271.21417479078724,0.026822823204626145,0.030695721995930535,248.2505820138114,252.60118103027344,7.739869223915423
2023-03-07,1,255.38249588012695,248.43749618530273,272.2725067138672,252.22937297821048,265.3137435913086,0.3241257882269455,7.955281771816854,-1.3326163414449568,2.9952610780752553,257.0862445831299,7.0675007629394475,0.03074549596262044,249.47975311279296,270.23225555419924,0.8523727896052447,0.0020539484035494017,0.9869997972696747,1.0137957395976256,1.0152314957481012,0.022849452446888963,51.340524276572694,274.65681312401694,258.7462495803833,242.83568603674965,252.04928425380163,3.476067166140778,254.65571321759904,5.836059898555474,253.27093449969908,256.2073574674857,1.154619447912673,-4.7478085972870865,21473200,4.401240370697609,0.6910988024241176,-716104600.0,-66.00322548313899,89.02914134005623,91.58768807638091,-32.637733886675946,31.710033233155077,25.525828703553334,-0.1439273896140636,5.951048207477326,264.80168853759767,261.13416702270507,258.17000579833984,255.20584457397462,251.53832305908202,0.02,0.0,271.17907348387195,0.018963929566632842,0.01594971654144445,248.94661821637834,251.37710898263114,7.7789732083391625
2023-03-08,1,253.2724952697754,248.43749618530273,272.2725067138672,252.22937297821048,265.3137435913086,0.3452888177830956,7.97884856025847,-1.3388435253876283,2.9952581266800635,256.3662452697754,7.125100708007811,0.030845159775600567,249.47975311279296,270.23225555419924,0.8591210792227553,-0.03350236469803249,0.9791175411290408,1.0046917675611013,1.002297257182934,0.019461631833812998,45.594049961243456,274.63194676956476,258.67424964904785,242.71655252853094,252.3442829677037,3.4803433648927693,253.55821255275183,4.227514555664785,253.8259123772179,256.5289782623739,2.3290028003640724,-6.203347902287486,17340200,4.057893014903221,0.5898821746058313,-733444800.0,-61.71320250582224,89.02914134005623,91.58768807638091,-47.638115159889104,30.25149327710396,27.533248599746543,-0.1983134869223278,5.792401601757499,261.7533126831055,258.66833419799804,256.1749954223633,253.68165664672853,250.5966781616211,0.02,0.0,271.1472274434439,0.030170032517907064,0.017159801260518973,249.4464111328125,250.27445656912667,7.553187424606632
2023-03-09,1,254.82000350952148,248.43749618530273,272.2725067138672,252.22937297821048,264.91436767578125,0.5227760658333367,7.954523094183608,-1.204158067200496,2.99525986487387,254.89749717712402,6.978601531982416,0.030816420079416748,249.47975311279296,270.23225555419924,0.8176161805096512,-0.06446582487864831,0.9871918378777176,1.0105488769836628,1.0045770382408445,0.024741890189152516,39.723821801205176,274.03517095185606,258.12612476348875,242.21707857512146,253.07892608642578,3.3644292680600407,252.92374910627092,3.1056342447556706,253.712074803762,256.31949581847243,0.8220259993008622,-5.7196069223539165,26653400,3.7225398420956584,0.952097222266874,-706791400.0,-53.75596654632795,89.02914134005623,91.58768807638091,-28.555952111972303,33.380573890380596,24.89501617105984,-0.15897421657689664,5.948658325036711,256.6956364135742,254.57717721557617,252.86499786376953,251.1528185119629,249.03435931396484,0.02,0.0,271.10244568844064,0.004818471726463658,0.024566480149080323,249.85584803989954,249.58053479875838,7.352029808710959
2023-03-10,1,250.01499938964844,248.43749618530273,272.2725067138672,252.22937297821048,262.6843738555908,0.7149892876840923,7.433165289659972,-0.8183341228368328,2.995317831897482,254.6162509918213,6.277300491333004,0.02888563333194358,249.47975311279296,268.79150466918946,0.8148675758610253,-0.05112639041846896,0.9715701613552904,0.9913332937202954,0.9808760343755591,-0.014223888667888707,43.55083501959611,272.19720521310904,257.33087463378905,242.4645440544691,253.3042836870466,3.038793037204004,252.32589176722936,2.759821698469423,254.00463069866765,256.121616674323,2.059657676996933,-3.368374789119539,28333900,3.7491206319632444,1.0381627085978304,-735125300.0,-79.4624613666452,89.02914134005623,91.58768807638091,-74.76962181876286,31.28121122782335,28.152244321263826,-0.12892490237452892,5.894467529146674,256.6956364135742,254.57717721557617,252.86499786376953,251.1528185119629,249.03435931396484,0.02,0.0,271.0413514194058,-0.02624469225833248,-0.010035551969192475,250.1833953857422,248.91202654157365,7.4112126092535355
2023-03-13,1,251.23999786376953,248.43749618530273,272.2725067138672,250.9093780517578,259.37500190734863,0.954703007848232,7.12571042033947,-0.27353152366657785,2.995349388947837,254.01749801635742,5.804113273620611,0.0277909352082541,249.47975311279296,268.79150466918946,0.833737079679555,-0.04699918722934545,0.9798594231985763,0.9960147874515374,0.9884800608103885,-0.0237419736640766,38.93995921928245,270.65554567283226,256.40412483215334,242.15270399147443,253.67178344726562,2.490705889771317,252.1603559766497,2.7497508346633768,253.03199620717373,255.27930741185628,0.6349698530084551,-3.239353165772774,33339700,3.653178232417189,1.2049734697440149,-701785600.0,-42.72914745295906,89.02914134005623,91.58768807638091,-39.21150053812775,32.75625300409853,24.29117068045665,-0.12612123389868232,6.343434700985198,256.6956364135742,254.57717721557617,252.86499786376953,251.1528185119629,249.03435931396484,0.02,1.0,270.97946425733613,-0.011484363631424022,-0.005366496500413259,250.58011954171317,249.0002681187221,7.2687541094175145
2023-03-14,1,258.61750411987305,248.43749618530273,272.2725067138672,250.9093780517578,257.6087465286255,1.1628438235673653,7.073623965105776,0.12509704459809612,2.995354025160551,253.58999824523926,5.543175735473629,0.02764766495215941,249.47975311279296,268.79150466918946,0.78601776430149,-0.07009283617015881,1.0108213470127592,1.0252489351286687,1.0224218045494708,0.01266730606808908,37.44057026761101,269.9961225945182,255.84887466430663,241.70162673409504,254.38535581316268,3.1122103666869125,252.59232085091728,3.2487788432686955,252.61962192696438,254.690230623557,1.0345132863236366,-0.9139942923706641,33620300,3.102183555856075,1.2397834933999266,-668165300.0,-1.8111168027224984,89.02914134005623,91.58768807638091,55.579174471753674,33.6689703775537,22.353071576515017,-0.08318622651308463,6.4010471620084735,257.4214457397461,255.16428475952148,253.34000396728516,251.51572317504883,249.2585621948242,0.02,1.0,270.9400407784857,0.02612646605112179,0.015260733167948367,251.35663495744978,249.65536608014787,6.505373257039636
2023-03-15,1,262.77750396728516,248.43749618530273,272.2725067138672,250.9093780517578,257.6087465286255,1.332344123018805,6.310297481257905,1.0447709725522483,2.9954299667961495,253.58999824523926,4.745137767791745,0.024720005724325717,249.47975311279296,264.1959930419922,0.6534288382970891,-0.05015197002003682,1.0294065250629703,1.0380615883561206,1.0362174978633572,0.037528783721206826,50.45714979106084,267.8914695581579,255.27087459564208,242.65027963312627,255.16071428571428,4.38835432374445,253.18982124328613,4.23025864013533,254.1151513046873,254.79330759137812,1.9694650945251075,2.3943890162694905,46028000,3.5684838745223395,1.6696844783151958,-622137300.0,-4.9832679820755015,89.02914134005623,91.58768807638091,139.98030578337134,36.94278118009921,20.55708635559712,-0.02329583275218581,6.4631166169569845,261.55468853759766,258.50766702270505,256.04500579833984,253.5823445739746,250.53532305908203,0.04,0.0,270.9069523668023,0.04627531961450915,0.04442283508062799,252.56659371512276,250.40858786446708,5.822864032595766
2023-03-16,0,270.3125,248.43749618530273,268.6375045776367,250.9093780517578,257.6087465286255,1.01558250420004,5.287642773586677,0.37954489664356883,2.9955184033569036,253.58999824523926,4.130350494384764,0.020752445842055125,249.47975311279296,262.87000274658203,0.5429587549737985,-0.02181378441392576,1.0608972195894826,1.0618124645240488,1.0579993977444495,0.060797803457763644,57.85841101820352,265.3714100054863,254.796124458313,244.22083891113962,257.29357201712475,7.225300115604357,254.67142813546317,6.088999966714311,256.2686380809635,255.37373953557065,2.108999191954162,3.287969554693459,54768800,3.6566170241891833,1.8977930958250582,-567368500.0,-1.1631191827401632,89.02914134005623,91.58768807638091,255.29767355384328,42.260312843063815,17.751365519686654,0.04843993931858933,6.950036771429414,269.2557982788086,264.73709872436524,261.08499908447266,257.4328994445801,252.91419989013673,0.06,0.0,270.9129446678679,0.09464176904730182,0.08868752626762236,255.67972019740515,252.31316920689173,6.818922917193797
2023-03-17,0,279.33499908447266,248.43749618530273,270.3125,250.9093780517578,257.6087465286255,1.1728757966045968,5.514604010629748,0.9333794293731028,2.995500123465915,253.58999824523926,4.236837291717528,0.021636090441828116,249.47975311279296,262.87000274658203,0.5032368003802292,0.025066157682558446,1.0959476495701193,1.0880030845527389,1.0802130685564377,0.1172729626878466,68.10282866174309,265.90908225069063,254.87987422943115,243.85066620817165,261.01678684779574,10.691499105934284,256.68053490774975,8.865528709316484,259.756408380116,256.9786576339217,5.84613446916933,8.311293905033406,69527400,3.8796071740696547,2.253330414340831,-497841100.0,-10.339330190690436,89.02914134005623,91.58768807638091,286.40848043060424,46.114254273552994,16.452984377622762,0.07562463418888127,6.962889456701677,274.42806988525393,268.92095193481447,264.4699935913086,260.0190352478027,254.51191729736328,0.08,0.0,270.97290282521067,0.1240596542085115,0.1074429127683824,259.3124019077846,254.37940652029855,8.576185961875801
2023-03-20,0,274.135009765625,248.43749618530273,279.33499908447266,250.9093780517578,257.6087465286255,1.8282770804367858,7.470652365086579,2.9810241834205335,2.9953126006042887,253.58999824523926,5.280850639343258,0.029220873603973498,249.47975311279296,263.53100357055666,0.5927044545394484,0.08108054560069453,1.072257693079329,1.057161821036208,1.03659773430295,0.09112805324202355,76.88955116010531,270.60280432581527,255.66149959564208,240.72019486546893,263.77607345581055,11.300744293167321,258.42749977111816,9.745447070000035,264.63371539407626,259.61935585532854,10.290301671698131,11.196916626146843,43466600,4.093029656424988,1.3786350984118607,-541307700.0,-29.427305718366824,89.02914134005623,91.58768807638091,167.501178617477,41.70082018939326,21.342022671508456,0.04773224948116831,7.149824964962726,274.42806988525393,268.92095193481447,264.4699935913086,260.0190352478027,254.51191729736328,0.08,0.0,270.9823134286614,0.0721094807053062,0.09509647901394577,262.1233934674944,255.98962075369698,9.293326267690055
2023-03-21,0,273.2949981689453,248.43749618530273,279.33499908447266,250.9093780517578,257.66687202453613,1.4868831425108888,8.478392860958513,1.127593778280115,2.9951943293899044,253.58999824523926,6.383351173400887,0.03306073668337647,249.47975311279296,270.6947509765625,0.7682711691205212,0.0811552051129363,1.0656894672755088,1.047144380566025,1.0158324634773568,0.05675367604765458,69.8332450236026,273.40578569902885,256.44899997711184,239.49221425519482,267.1017875671387,9.91682977959896,260.2030356270926,10.04515019846782,267.0010018263016,261.46577810458353,7.579862644253437,9.795639544108559,34558700,4.1221747753792055,1.0854959129824195,-575866400.0,-25.318110676423345,89.02914134005623,91.58768807638091,134.39682582975178,39.3791071930332,20.489084124503112,0.09727681226504999,7.030552537913557,274.42806988525393,268.92095193481447,264.4699935913086,260.0190352478027,254.51191729736328,0.08,0.0,270.98832378997196,0.04981020112559098,0.07821367236780373,265.6798357282366,257.9316155569894,9.968736913990305
2023-03-22,0,274.72750091552734,248.43749618530273,279.33499908447266,250.9093780517578,259.6575040817261,1.1482363386702104,9.202204472497623,-0.026345975801706167,2.9951017508209627,254.01749801635742,7.38572654724121,0.03574561810656484,249.47975311279296,273.3789993286133,0.8169417090418605,0.08205646999596376,1.0671686725117941,1.0454578310196307,1.0101352669806407,0.045475722875158775,68.8204719778407,275.8402838839601,257.43587493896484,239.03146599396956,270.4571451459612,7.277903056178555,262.06446429661344,10.157029464642637,268.5738221368746,263.0342146031186,9.31144084800088,10.005535543274856,34873300,4.11840548185362,1.074482771157597,-540993100.0,-29.361650839050963,89.02914134005623,91.58768807638091,129.28515950874498,41.923576246152315,18.678405065511786,0.05741052289101695,7.161228490147969,274.45638873291017,268.96679006958004,264.52999114990234,260.0931922302246,254.60359356689452,0.08,0.0,271.00248934007607,0.025806100366130957,0.04409675710871055,268.27339826311385,259.4267589024135,10.349586156186307
2023-03-23,0,277.96500396728516,248.43749618530273,279.33499908447266,250.9093780517578,264.66125297546387,0.8706099219827943,9.859987681284165,-0.7411525457941286,2.9950127354969394,254.6162509918213,8.33937646865844,0.03813663132065726,249.47975311279296,274.1942588806152,0.839921564313772,0.07985064634500533,1.0751178621112394,1.049211585079761,1.0131359863811744,0.02830984126625724,69.5994194418952,278.2637255533032,258.54375019073484,238.8237748281665,273.22107369559154,5.485176609628163,263.8032147543771,10.671251939186137,270.0981529453098,264.4115344979295,9.34863208544266,10.479858212779716,36610900,4.115483335615511,1.1153193928437006,-504382200.0,-15.079745454117488,89.02914134005623,91.58768807638091,126.47925931851331,38.33385496986988,17.070317258653212,0.03228320214584679,7.276139956117151,274.45638873291017,268.96679006958004,264.52999114990234,260.0931922302246,254.60359356689452,0.08,0.0,271.027192013585,0.005286116860724999,0.04603676990060733,270.65518624441967,261.0059106009347,11.100608258169686
2023-03-24,0,278.4300003051758,248.43749618530273,279.33499908447266,250.9093780517578,271.0581245422363,0.6590943319730109,10.66951023538189,-1.1689817751219085,2.9948956590585025,255.10124969482422,9.449788761138915,0.04108060114907086,249.47975311279296,275.05125122070314,0.831682553934249,0.11377569442827835,1.0720334427855962,1.0418646713793032,1.009201073258519,-0.003239833111722601,74.29181454815216,281.06039593615685,259.72137546539307,238.38235499462928,275.4571446010045,3.255448016496619,265.3089294433594,11.166369030245363,272.0359285245643,265.8963895920918,7.481125422370582,9.597928670766922,28172000,3.894151908130215,0.8540971012480393,-476210200.0,-7.340372127867055,89.02914134005623,91.58768807638091,113.60181990171934,36.28175654992942,16.156504361361822,0.08249621508793292,7.138558966642067,274.45638873291017,268.96679006958004,264.52999114990234,260.0931922302246,254.60359356689452,0.08,0.0,271.0484023955551,0.0040798248412587945,0.015821903856220124,272.7913077218192,262.67895071847096,11.690242690506361
2023-03-27,0,278.4649963378906,248.43749618530273,279.33499908447266,251.23187446594238,273.50500106811523,0.46291472790133076,11.140211607764456,-1.4369397224662517,2.9948280750018514,256.3662452697754,10.166251373291015,0.04265593879236744,249.57650146484374,278.0115036010742,0.8538859332929974,0.10836657173739996,1.0662441843857866,1.0310329748605345,1.0099905287871105,0.015795087887415793,74.33801111576169,283.4447985207047,261.1643753051758,238.88395208964687,276.62178693498885,2.4722699544600704,266.9576794760568,11.291358522266671,273.6294447135426,267.22793503071784,5.956558724235125,8.19118169155168,26840200,3.9006812722629367,0.8068103423657944,-449370000.0,-18.483998355621573,89.02914134005623,91.58768807638091,94.13350017225483,34.9397131815043,15.184573614291219,0.07068546170686647,7.052947786266031,274.45638873291017,268.96679006958004,264.52999114990234,260.0931922302246,254.60359356689452,0.08,0.0,271.0658154504187,0.015244447111313564,-0.010914932132397217,272.8167245047433,264.2482223510742,11.81696226277446
2023-03-28,0,274.80250549316406,248.43749618530273,279.33499908447266,252.76437091827393,274.2831325531006,0.2662755942390735,11.500239034441957,-1.6063652411293003,2.99477610379247,257.98374938964844,10.669726333618167,0.04380588696393424,249.57650146484374,278.4334999084473,0.8591963138043129,0.11529871320362775,1.0467580245060184,1.0073184014199983,0.993585881496829,0.005516044326895564,75.20950043718985,285.52772797733127,262.5272499084473,239.52677183956334,275.9742878505162,2.224342289009891,268.495537349156,10.736634042694195,274.8380759451967,268.1840735522529,3.0159524024566475,9.038403504599737,21878600,3.8534867307986413,0.6582716615472841,-471248600.0,-21.542493505882128,89.02914134005623,91.58768807638091,65.99363853749385,33.36408129852886,18.113708441776186,0.10593549155015072,6.858452736517259,274.45638873291017,268.96679006958004,264.52999114990234,260.0931922302246,254.60359356689452,0.08,0.0,271.0729783004744,0.005296185780772733,0.01101996745234827,272.22375052315846,265.7680762154715,11.688176349212016
2023-03-29,0,279.7550048828125,248.43749618530273,279.33499908447266,253.53499698638916,274.7462520599365,0.07547382407208826,11.39980819191239,-1.6763760096010067,2.9947990704513043,260.6975040435791,10.741601314544676,0.043216532450384815,249.88024940490723,278.4334999084473,0.8663872368499513,0.10612330953535447,1.0605477779225203,1.0194242972012384,1.010390870579884,0.018299966150207236,67.77030443200341,286.5831164830069,263.7835000991821,240.9838837153573,276.7771442958287,2.4523804698816907,270.2766088758196,10.3549445630385,274.83193235608235,268.8206280630206,-1.6226013947997757,8.500729698444276,25087000,3.9805181294841816,0.7576289508664624,-446161600.0,-7.499940141703858,89.02914134005623,91.58768807638091,90.6275331698164,36.54929756184779,16.98767280539476,0.160579000314373,6.790706374058155,274.45638873291017,268.96679006958004,264.52999114990234,260.0931922302246,254.60359356689452,0.08,0.0,271.09449173549285,0.03018834673272286,0.02458169189207723,273.3927525111607,267.75807298932756,11.448227302808208
2023-03-30,0,283.5550003051758,248.66749954223633,279.7550048828125,254.52062702178955,275.59313011169434,-0.07634520662487093,11.335039363905299,-1.689436076674084,2.9948185270281917,266.5450019836426,10.772876358032226,0.04271741488402502,251.11749801635742,278.5519966125488,0.8350148235626068,0.1250163587835327,1.0686100155105942,1.0269183246266973,1.0204096251237111,0.02011043209795038,72.10186711940358,288.0194542618682,265.34937553405763,242.6792968062471,278.24285888671875,3.0238158953872993,272.6723232269287,9.11192793159841,276.0862519966481,270.19091405709764,2.0500829580258215,9.785339074590864,25053400,4.047353612019415,0.75633419396811,-421108200.0,-1.0586204682120337,89.02914134005623,91.58768807638091,101.5583378704524,38.583671671675965,16.26012640665154,0.15423462618645767,6.58779746801105,275.3197124633789,269.6651330871582,265.0949935913086,260.524854095459,254.87027471923827,0.1,0.0,271.1238026270744,0.02301352203174334,0.04318911709414184,274.84271240234375,270.2612740652902,11.585478973764156
2023-03-31,0,286.0749969482422,250.01499938964844,283.5550003051758,255.2418727874756,278.0812530517578,-0.17452104522947184,11.318050293340493,-1.6182812972576819,2.994831872894589,271.80374908447266,10.67462629318237,0.04237482258230836,253.0692455291748,279.37699966430665,0.8430032162162866,0.118019903733764,1.0710658573454952,1.0310996713450784,1.0253528939674534,0.02745751763346993,74.08440074222763,289.72985115888565,267.0937505722046,244.45764998552357,279.86392974853516,3.7738204601154646,275.1605374472482,7.405632734195444,277.97443030843823,271.94094012452143,3.7541858449556944,13.415195487233646,32766000,4.005507368666061,0.9861830238431402,-388342200.0,-2.903327020031906,89.02914134005623,91.58768807638091,113.51207218321983,41.184879710872714,15.150896619812775,0.14875359265359403,6.565096864129276,281.3852317504883,276.5073734436035,272.5649948120117,268.6226161804199,263.74475787353515,0.12000000000000001,0.0,271.1729401129643,0.027550928992276402,0.03832005982310192,277.1030752999442,272.68823678152904,12.08722136403601
2023-04-03,0,286.4925003051758,250.01499938964844,286.0749969482422,256.8581199645996,278.4387493133545,-0.2871219359992026,11.593360317981713,-1.4339755275759964,2.994797292115649,273.71500396728516,10.625600967407228,0.04314348276918907,253.0692455291748,280.1350044250488,0.8558535913725333,0.11161842970633412,1.0661519966085249,1.0301020548458222,1.0212525892723099,0.02882769494498527,75.26092060233891,291.9030961776504,268.716375541687,245.5296549057236,281.082143511091,4.385469193708963,277.15160860334123,6.276969382538759,279.98715029753714,273.66389498968584,4.130455085457188,13.865228220293698,24883300,3.980357594308208,0.7480606888971761,-363458900.0,-6.78635460088568,89.02914134005623,91.58768807638091,103.15885792698926,39.18754702890021,14.416127423146898,0.18863385276426176,6.406873915684392,282.1758295898438,277.7870699462891,274.239990234375,270.6929105224609,266.3041508789062,0.12000000000000001,0.0,271.20916837471594,0.03925749844252624,0.023737404086822022,278.45421055385043,274.554698399135,12.364300275458977
2023-04-04,0,287.63250732421875,250.01499938964844,286.4925003051758,257.8087520599365,278.68249702453613,-0.42441344696634714,11.900528947765025,-1.2645135998589254,2.9947555713307294,274.4312553405762,10.508950576782222,0.044047728261546064,253.0692455291748,283.80699996948243,0.8542188450017717,0.12181729338118552,1.064621461568206,1.0296261728122293,1.0194817595286982,0.04668808171173633,76.67886506178876,293.97455871950467,270.1735008239746,246.37244292844457,282.39678737095426,4.816108793163858,278.92696598597934,5.344388288987396,281.5820645755438,275.18600767885704,3.0678309197852336,10.778464621011214,25824300,3.9055565539357495,0.7713051763223053,-337634600.0,-12.035399025280045,89.02914134005623,91.58768807638091,106.45106828812918,39.5359757274285,13.63368649552134,0.19394012828261073,6.290668548797787,284.03788903808595,280.0710670776367,276.86500549316406,273.6589439086914,269.6921219482422,0.14,0.0,271.24972962123627,0.04341810060619422,0.03907638905647932,279.38743373325894,276.08937072753906,12.254044972179798
2023-04-05,0,285.06500244140625,250.01499938964844,287.63250732421875,261.73750400543213,279.4400005340576,-0.5740228097922737,11.97182463860732,-0.9957461146092506,2.99475330525589,274.7650032043457,10.144700565338137,0.04404871692106075,253.0692455291748,286.1167472839355,0.8375258184966635,0.13566420632388249,1.0488582965164215,1.0152249037978025,1.0012750190929147,0.018980884938298415,78.80572514274955,295.7296506733938,271.7860013961792,247.8423521189646,283.3396453857422,4.557172839376418,279.9807161603655,4.955442506588427,283.0553548835608,276.80088071881903,3.3051420496916553,9.458573501036051,22064800,3.8076290208915435,0.654401434506027,-359699400.0,-29.19259005445916,89.02914134005623,91.58768807638091,82.77914518403941,37.578455516992946,16.15488745659748,0.167696851729689,6.145619313027798,285.5105267333984,282.45474334716795,279.98500061035156,277.5152578735352,274.4594744873047,0.14,0.0,271.27803927816007,0.013653799623035257,0.033099637400878186,280.5112609863281,276.6639927455357,11.723798051051906
2023-04-06,0,287.22999572753906,250.01499938964844,287.63250732421875,268.4287509918213,280.7050037384033,-0.7780570173457095,11.509855532553711,-0.5851611533463323,2.9948356200625885,276.3837547302246,9.255188026428225,0.04210271291990105,254.46200294494628,286.1167472839355,0.8447369192063412,0.1186916196347774,1.0506788741090176,1.0191830669393873,1.005130087257949,0.012960432432537194,72.03651730861208,296.3953378198681,273.37562675476073,250.3559156896534,285.11500113351,2.732392045633458,280.5446444920131,5.312657071596511,283.51530917020693,278.11119958593423,2.3701385058490976,5.457573157514451,29770300,3.9313327452221505,0.878870204105732,-329929100.0,-2.1275732300208587,89.02914134005623,91.58768807638091,105.21950618127651,38.86078097334898,14.34978476281201,0.238717397154183,6.424502775884413,286.7558271484375,283.46206750488284,280.79998779296875,278.13790808105466,274.8441484375,0.16,0.0,271.3266335396139,0.02657994355337201,0.039535176590227934,282.8224530901228,277.5231018066406,11.223277155081654
2023-04-10,0,288.22750091552734,250.01499938964844,287.63250732421875,272.549373626709,283.9325008392334,-0.9859894384799227,11.055875120136728,0.011856842832075998,2.9949127384721583,278.19750213623047,8.504261760711671,0.04020374856275524,257.8797534942627,286.5662498474121,0.7756075618615175,0.1488510546516893,1.0481147670141069,1.019371335264739,1.0060331811381429,0.007524264581831197,76.90198286744658,297.10787660593513,274.9961263656616,252.88437612538812,286.32535770961215,1.6072311357641214,281.55125100272045,5.339788956071896,284.4316206386614,279.44560899288524,4.522335126483824,2.8263542588442023,23103000,3.631036822935105,0.6873472821920139,-306826100.0,-11.923635704488087,89.02914134005623,91.58768807638091,96.60269192815925,35.89920988319427,13.256190999664739,0.2980596019110319,6.457753623924328,286.7558271484375,283.46206750488284,280.79998779296875,278.13790808105466,274.8441484375,0.16,0.0,271.36269893716883,0.00378078859416231,0.01879956228968674,284.076171875,278.73446219308033,9.652753028224716
2023-04-11,0,284.0500030517578,251.23999786376953,288.22750091552734,273.9250068664551,285.31750106811523,-1.055797274174517,9.804719009959038,0.521739273525049,2.9950971154395294,278.4474983215332,7.534649124145505,0.03540801717149275,262.3615039825439,287.270246887207,0.7113795048631675,0.14721980324093792,1.0257965960476034,1.0011278397858454,0.9899644397751358,-0.008525518995492698,77.46931849054016,296.51618946187364,276.9067514419556,257.2973134220375,286.3960723876953,1.4700627114427838,282.31946563720703,4.807761337690061,285.4030646741748,280.8814844941251,3.0285413611327225,5.140711929479889,27276600,3.633810427188904,0.8189037840742689,-334102700.0,-46.18073172106658,89.02914134005623,91.58768807638091,51.40173061939851,32.86522451596717,15.483676548908885,0.2650230550218091,6.550056936502214,287.35290686035154,284.4285270385742,282.0649871826172,279.7014473266602,276.77706750488284,0.02,1.0,271.3937597538022,-0.015318710584080741,-0.018973134433227668,283.90393502371654,279.3733237130301,7.933221240046973
2023-04-12,0,284.3125,258.61750411987305,288.22750091552734,274.57937812805176,285.31750106811523,-0.8912056921384224,7.940621133075385,0.23943378631321988,2.995322315933115,278.89999771118164,6.194499397277832,0.028507267921598228,269.5590003967285,287.270246887207,0.7171487854996854,0.09834020716593268,1.0206975594389502,1.0000844151640014,0.9925691438096153,-0.011542531666896894,64.80059337147065,294.4284939675057,278.547251701355,262.6660094352043,286.144287109375,1.6713726856360382,283.0041084289551,4.2990281115117295,285.0992218631097,281.60108529446376,0.17457027597795316,3.935309813523912,27403400,3.6409376074667676,0.8304606696864612,-306699300.0,-42.88565582325095,89.02914134005623,91.58768807638091,52.02593116374355,32.167113893457525,14.616800799739277,0.20568939385811943,6.442911320361412,287.35290686035154,284.4285270385742,282.0649871826172,279.7014473266602,276.77706750488284,0.02,0.0,271.4265255687818,-0.012849052503612568,-0.01302108138221554,283.22483607700894,280.16395568847656,6.705794154489064
2023-04-13,0,286.625,262.77750396728516,288.22750091552734,274.7837543487549,285.31750106811523,-0.7376156155029979,6.573054420131958,0.049314297839520016,2.995454727441549,279.5450019836426,5.4151993560791025,0.02348928780485071,272.99674835205076,287.270246887207,0.6646173438030027,0.08195144450186981,1.0242752739798822,1.0048573174614082,1.0029673471674982,0.005472427499809918,63.77616307461034,292.9781103356252,279.83200149536134,266.68589265509746,286.16321563720703,1.6767152588251921,283.622679574149,4.138216017307434,284.9236132315558,282.166069090512,-0.6160961171175212,3.4889113949388824,24222700,3.5855700277433713,0.7591522574662153,-282476600.0,-11.183177088808748,89.02914134005623,91.58768807638091,87.36964031204346,32.96848537892811,13.529684593377207,0.1985076313799108,6.463416259532227,287.35290686035154,284.4285270385742,282.0649871826172,279.7014473266602,276.77706750488284,0.02,0.0,271.46323732489753,0.019342820631806257,0.009262440214616101,283.5933183942522,281.02376447405135,6.041297582800383
2023-04-14,0,286.32750701904297,270.3125,288.22750091552734,277.1743793487549,286.1793727874756,-0.3310576933437613,5.435782729274942,-1.203784267070181,2.995544782192308,281.65500259399414,4.902124404907227,0.01934274457220111,274.051008605957,287.270246887207,0.6925644775270325,0.06034682080924855,1.0188707143199613,1.0014024804142123,1.000833681407286,-0.003142041993943301,64.4682751293668,291.8959417555469,281.02437629699705,270.1528108384472,285.9767870221819,1.5541947835983432,284.1867871965681,3.9077826021880524,285.37114538935117,282.9207311751927,0.04624892263604745,3.115498681169977,20987900,3.270638925691602,0.6945376543920748,-303464500.0,-29.65537836161885,89.02914134005623,91.58768807638091,60.671001768179046,30.719998313772518,12.60694518165745,0.1246924414949406,6.441028947885747,287.35290686035154,284.4285270385742,282.0649871826172,279.7014473266602,276.77706750488284,0.02,0.0,271.4919092986412,-0.0187242124850463,0.006330464540678056,283.44649396623885,281.41696384974887,5.9813716502385885
2023-04-17,1,289.12249755859375,273.2949981689453,288.22750091552734,278.3137512207031,286.3687553405762,-0.3595954041960762,4.957366018157296,-1.3528285153796864,2.9955772261819043,283.8025016784668,4.551612091064453,0.017590220138000493,274.6682518005371,287.270246887207,0.8347897666844373,0.025032695356788193,1.0258932586935738,1.0101981409093965,1.0112413423757176,0.0031051743508982987,59.79794403221248,291.73985868426377,281.8251266479492,271.9103946116347,286.5564291817801,1.8799546526912252,284.94803728376115,3.7419582046690447,285.6200399302291,283.4746961850971,-0.45370403968449496,2.8364424470103984,23836200,2.6493218889721377,0.8533054389710589,-279628300.0,-16.375431748338904,89.02914134005623,91.58768807638091,90.44038273194019,32.337479377908515,11.835208283699767,0.14766038313425942,6.370954841256037,287.35290686035154,284.4285270385742,282.0649871826172,279.7014473266602,276.77706750488284,0.02,1.0,271.5304395501955,-0.0020387952637463957,-0.009602277005206135,284.076171875,282.29371643066406,6.121245404370773
2023-04-18,1,289.67750549316406,273.2949981689453,289.12249755859375,278.3137512207031,286.52562522888184,-0.4562580358942396,5.166094692152399,-1.2880086912105204,2.9955643633315434,284.1812515258789,4.694099273681639,0.018299076609216168,274.6682518005371,287.69200668334963,0.7845913638422056,0.05467192171398495,1.026080856210073,1.011060767980612,1.0125486221807576,0.01981166126015088,68.80152099905189,292.64669095596014,282.3145015716553,271.98231218735043,286.9060734340123,2.2225002701588044,286.01053728376115,2.5669591768218174,286.49107681800314,284.05711558421723,1.4233578595890595,3.8272319181443066,20161800,2.3494946670930563,0.753185060772424,-259466500.0,-27.139693439717107,89.02914134005623,91.58768807638091,88.71836672834473,30.766177911826052,11.193256812191281,0.16853239055744212,6.25517235259398,288.8538706054687,286.85805310058595,285.2449951171875,283.63193713378905,281.6361196289063,0.04,0.0,271.56325927994436,0.01958769426082063,-0.0035245431703986602,283.6201477050781,283.22130039760043,5.744282671912297
2023-04-19,1,287.0074996948242,273.2949981689453,289.67750549316406,278.4562473297119,286.77624893188477,-0.5871828814031242,5.044809060989883,-1.017122044305297,2.995572919329812,284.6887512207031,4.420137443542484,0.01782041074789546,274.7950050354004,288.317000579834,0.748866513644581,0.059944409645182835,1.0138325297260453,1.000629291316613,0.9992844950684864,0.009479005301646026,70.3914327714348,293.18124448001197,283.0916263580322,273.00200823605246,286.7317875453404,2.1481981754361725,286.5285726274763,1.8348303670938844,287.2843027861548,284.79896897699626,0.8521079977826067,5.412978303565732,17150300,2.3190463402746886,0.6622172111683006,-276616800.0,-34.24512005527725,89.02914134005623,91.58768807638091,59.26208824615586,29.149501708203648,13.482958919703753,0.1614852217021789,6.1305157022682755,289.57839233398437,288.0307958984375,286.7799987792969,285.5292016601563,283.9816052246094,0.04,0.0,271.5883750179057,0.017496269052178492,0.019870467857103474,283.4874354771205,283.7818036760603,5.385049903054951
2023-04-20,1,286.36749267578125,274.72750091552734,289.67750549316406,279.43250274658203,287.06312370300293,-0.7174329969791997,4.576901104713959,-0.801212932566663,2.9956016950863145,285.5699996948242,3.8740747833251987,0.0161284989602952,277.64875411987305,288.317000579834,0.7449443103933228,0.044698833347130776,1.0091277268645142,0.998615559064122,0.9951885329452225,-0.0008984119466856066,60.805786000023204,292.9310536437541,283.77725143432616,274.6234492248982,287.0628574916295,1.8194332415297143,286.72946493966236,1.6263370472813674,287.20966755316044,285.277792409029,-0.4232771740475516,2.592445062796907,23244400,2.443544242780488,0.9181393186475967,-299861200.0,-57.18407352300663,89.02914134005623,91.58768807638091,44.154375986365075,27.77298757088997,12.84625906282186,0.21039154873231264,5.974765452607431,289.61615319824216,288.0919172973633,286.86000061035156,285.62808392333983,284.10384802246097,0.04,0.0,271.62098233086635,-0.012869204987746463,0.009241836328893303,283.9505092075893,283.9272221156529,4.636743665332746
2023-04-21,1,285.0250015258789,274.80250549316406,289.67750549316406,282.60500144958496,287.06312370300293,-0.8743498444416793,4.104859128363197,-0.40000527142878006,2.9956276342730157,286.2012519836426,3.353899383544922,0.014435468913373684,278.38350067138674,288.317000579834,0.7682005197408759,0.030228584852663744,1.0023412303315138,0.9934828061986078,0.9907004021269983,-0.00454900581059936,57.13539254169805,292.5689692790653,284.35925102233887,276.14953276561243,287.16464342389787,1.652164837197369,286.65446526663646,1.6820947643535946,286.9911184993334,285.600597883634,0.8158738247227405,0.991868373888144,21676400,2.3796982899699284,0.8822256943695455,-321537600.0,-60.536339108498474,89.02914134005623,91.58768807638091,5.749253722986913,26.670750777274176,14.833878485623366,0.2588318594625257,5.777281595639806,289.61615319824216,288.0919172973633,286.86000061035156,285.62808392333983,284.10384802246097,0.04,0.0,271.647838935658,-0.0013280147991742153,-0.014076498652341934,284.271004813058,283.74792044503346,4.3287308374131195
2023-04-24,1,281.8824996948242,274.80250549316406,289.67750549316406,283.9262523651123,287.06312370300293,-1.1175096363987504,3.834462278662202,0.3886529900577522,2.9956411176169473,286.2012519836426,2.9615745925903356,0.01346785137112126,278.4614967346191,288.317000579834,0.7407643005250822,0.02368638872777579,0.9900610135443889,0.9832850314063081,0.9806655312182541,-0.025041281549881056,52.82516244872008,292.38117545759303,284.71225090026854,277.04332634294406,286.48714338030135,2.6068715312212456,286.32517950875416,2.1124206234783616,286.48916150676314,285.5813912289804,0.25060506515855135,-0.36703502003471156,26611000,2.4127850362136263,1.0865144977478434,-348148600.0,-77.17072502170039,89.02914134005623,91.58768807638091,-70.17882463756752,24.38499912717342,18.845934354293412,0.20230025716891528,5.8674763777319106,288.9270300292969,286.9764721679687,285.3999938964844,283.823515625,281.8729577636719,0.02,1.0,271.6727728359499,-0.02434209766606177,-0.015272386022584884,283.1316484723772,283.3624834333147,4.270071068122769
2023-04-25,1,277.9750061035156,274.80250549316406,289.67750549316406,283.9262523651123,287.06312370300293,-1.234374358314727,3.619439535847094,1.0552575522706045,2.995651135196131,286.2012519836426,2.737162132263177,0.012704919925275,279.6260040283203,288.317000579834,0.6698531559896016,0.01227264971137263,0.9757450452743776,0.9718055111258428,0.9719677693134362,-0.040398371180825454,44.78965457091737,292.1237549414452,284.884875869751,277.6459967980568,285.29392896379744,4.148078828937754,285.63535799298967,3.0301625918086996,285.3298237144162,285.17442411091326,-1.6546010659139228,-1.6091173784447852,45772200,2.5356163223150383,1.7993150588002207,-393920800.0,-99.70066824581365,89.02914134005623,91.58768807638091,-167.29706156067743,22.4973702466112,21.438992412886527,0.14372995315096646,5.905513343357293,288.1364285888672,285.6967698364258,283.72499084472656,281.7532118530273,279.3135531005859,0.04,0.0,271.697100187787,-0.0449076314853919,-0.04632955698755128,281.61814662388394,282.53232029506137,4.376963973616311
2023-04-26,0,296.0925064086914,274.80250549316406,289.67750549316406,283.9262523651123,287.06312370300293,-1.2360292251923635,3.6641935915990116,0.9885737200090565,2.995649095902187,286.2012519836426,2.7690114974975586,0.012863121359474719,279.57700500488284,288.317000579834,0.4913047297134892,0.011544656787819865,1.039430299834126,1.0373477607931707,1.043860182203879,0.03165424849011722,38.72493112185295,292.18876354123023,284.8603763580322,277.5319891748342,286.28964451381137,5.74819593407395,286.42303684779574,4.111007972625073,283.4976716660085,284.2582140856048,-2.917114392006996,-3.3575833658527374,64599200,2.5556675597561345,2.342697348403664,-329321600.0,-17.35541358863839,89.02914134005623,91.58768807638091,239.57864196168504,34.91976477026904,16.308760724654707,0.08386247136513945,7.208690525730092,293.85880444335936,290.3256026611328,287.4700012207031,284.61439978027346,281.0811979980469,0.02,1.0,271.8397002757508,0.0239903139508868,0.024274308574659374,282.5457327706473,283.31095232282365,4.27065137216204
2023-04-27,0,300.3125,277.9750061035156,296.0925064086914,284.24687576293945,287.330623626709,0.3302761216421386,3.68010234725683,1.5780985311637723,2.995649550870114,286.3474998474121,2.5778993225097677,0.012870871515423729,281.66975021362305,289.1779983520508,-0.05180749014184727,0.058399318120233724,1.0503195936539356,1.047807949315289,1.051998727185707,0.048696195206789694,66.30624159784995,293.2850810983222,285.9248764038086,278.56467170929494,287.8089294433594,7.823637539214898,287.3575014386858,5.5452397616395706,286.6654519268567,286.0191403501782,2.4107459325904275,3.868417333885736,46462600,4.669585156888923,1.6220998209366246,-282859000.0,-1.240447277154286,89.02914134005623,91.58768807638091,313.21490220741475,36.99908357579816,14.743376880401401,0.13222582158370372,7.404499217252521,298.1601281738281,293.80494567871096,290.2850036621094,286.7650616455078,282.4098791503906,0.04,0.0,271.96601000867764,0.0654295741973252,0.05678628280736987,284.86962890625,284.24488830566406,5.72512796936778
2023-04-28,0,305.87750244140625,277.9750061035156,300.3125,284.8468761444092,287.7812557220459,1.1639776897493799,4.575308369996116,2.288789202575334,2.9956059189643134,286.4299964904785,2.9680503845214843,0.01594446594955382,283.38775024414065,290.3190055847168,0.2574806501065674,0.05909788110521407,1.065950757416534,1.0621521038806574,1.061125901414315,0.07316025192138809,69.2110853755344,296.10336789966016,286.95275115966797,277.8021344196758,290.50464412144254,10.34584234716663,288.61821583339145,7.440677281226592,290.0874825861076,288.08811180776536,3.6713221790315735,4.554713806726075,36446700,4.68442152464296,1.2476125909714304,-246412300.0,-4.976111536481967,89.02914134005623,91.58768807638091,294.80979224377563,38.619282167622174,13.930077525521122,0.12387430226618842,7.277034638675894,301.0098332519531,296.11007360839847,292.1499938964844,288.1899141845703,283.2901545410156,0.06,0.0,272.07999208191086,0.07523797143273026,0.07392291977250202,287.5253165108817,285.50637599400113,7.1372096926124335
2023-05-01,0,306.5699996948242,277.9750061035156,305.87750244140625,285.0550022125244,288.45125007629395,1.4518628965032154,6.084224390735773,2.098281663056227,2.9955114286537556,286.5587501525879,4.089675521850586,0.021120728034178648,283.83325271606446,296.5145057678223,0.47494594236633103,0.06922137797574393,1.06422465234054,1.05737857053197,1.0483606105552656,0.08758081834355647,72.98344385024988,300.23732504795106,288.0688762664795,275.9004274850079,293.3907165527344,11.725275066416492,290.2267870221819,8.704113869364928,294.0501815875448,290.5542603114755,6.574742042157975,6.123635485793462,21294100,4.788648482228932,0.7435205010132837,-225118200.0,-10.041702509970955,89.02914134005623,91.58768807638091,213.6039583683571,37.2604345635663,13.439937590042552,0.05851080193302754,7.003675893557315,301.0098332519531,296.11007360839847,292.1499938964844,288.1899141845703,283.2901545410156,0.06,0.0,272.146117024306,0.08443067364154211,0.06928886121123728,290.27136666434154,287.1109379359654,8.05688974463972
2023-05-02,0,306.56500244140625,277.9750061035156,306.5699996948242,285.0550022125244,289.2612495422363,1.2491150957470818,7.272102465011454,0.7688768713153133,2.995419082170618,286.8162498474121,5.309075317382804,0.025154834976727283,283.83325271606446,300.86900024414064,0.63654734656134,0.07008036639095826,1.0604350094290682,1.051036460482731,1.0309366736258374,0.10285096037463148,73.40213489341335,303.6378313338315,289.09362640380857,274.5494214737856,296.46785954066684,11.987405962699635,291.8162514822824,9.533300774679798,297.18652937986053,292.7542137238486,7.054748718254759,7.928180391169703,26404400,4.787153736537355,0.9195136513705174,-251522600.0,-11.150515486250391,89.02914134005623,91.58768807638091,161.82634014432648,35.221744617591334,13.99197172544495,0.01608607524758959,6.879841116422176,301.2008332519531,296.26457360839845,292.2749938964844,288.2854141845703,283.34915454101565,0.08,0.0,272.22711558527084,0.10888834126257851,0.08389839628569694,293.045645577567,288.6583251953125,8.765604504332963
2023-05-03,0,305.92999267578125,277.9750061035156,306.5699996948242,285.0550022125244,291.2812557220459,0.9996434170965794,8.17314915377854,-0.17609245596766865,2.9953389727113224,287.11874771118164,6.493125343322765,0.028173824850868435,283.83325271606446,305.9462524414063,0.7258255055860573,0.06582181997894568,1.054577356671652,1.0428216880258634,1.0093917697858161,0.03322436756812519,73.18036139632302,306.44354981817713,290.09725151062014,273.75095320306315,299.90321568080356,10.459245903778847,293.1951795305525,10.103762095374778,299.5287422295153,294.7257342875608,7.5572321025219305,7.82677597411519,22360800,4.792929333086045,0.7834228608346028,-273883400.0,-14.137826455068481,89.02914134005623,91.58768807638091,128.276783321899,33.527348948359474,13.318866615149881,-0.0009572543816663699,6.711280251939424,301.2008332519531,296.26457360839845,292.2749938964844,288.2854141845703,283.34915454101565,0.08,0.0,272.2944698769904,0.030571844058306263,0.10522112604775576,296.2406572614397,289.68615286690846,9.253290415586092
2023-05-04,0,305.70249938964844,277.9750061035156,306.5699996948242,285.0550022125244,297.14750480651855,0.7659225342645347,8.842703693405298,-0.8067904725856869,2.995274046986086,287.11874771118164,7.527474899291997,0.030386031749566934,283.83325271606446,305.9934936523438,0.7739391696404448,0.07319379810106187,1.0504802800645043,1.0353680073578784,1.0021357082590714,0.01794796883129557,73.16476395821897,308.6975331650089,291.01212577819825,273.3267183913876,303.86428615025113,4.068777676341995,294.57910755702426,10.412908555535031,301.1236500288205,296.3991095131479,8.531034387374769,6.73527873555386,22519900,4.736391049893745,0.7883685022979888,-296403300.0,-11.150515486250391,89.02914134005623,91.58768807638091,107.46575824371244,31.931615899791478,13.438178621959533,0.00866116392323239,6.543332796024681,301.2008332519531,296.26457360839845,292.2749938964844,288.2854141845703,283.34915454101565,0.08,0.0,272.3616727227517,0.001902808080370244,0.03399136677410283,300.4747881208147,291.04646737234935,9.60832497712963
2023-05-05,0,308.1524963378906,277.9750061035156,306.5699996948242,286.00188064575195,301.6599998474121,0.5387927262676205,9.28173383327117,-1.2018066386921809,2.995229958933045,287.7287483215332,8.274199867248536,0.03178197057083193,283.83325271606446,305.9934936523438,0.8101459639347307,0.06431258551294218,1.0551577696435228,1.0368758215808425,1.0066099487918987,0.007437597987188349,72.1351375573602,310.6074682921527,292.04400062561035,273.480532959068,305.58714185442244,2.4678018051592163,295.93839318411693,10.877527031292319,302.26344971191463,297.382509840065,9.974815245010669,6.766724081915358,28181200,4.73815726715522,0.9893090367320632,-268222100.0,-3.6065767871332572,89.02914134005623,91.58768807638091,114.84677427855686,33.81948794080483,12.322714894142983,-0.006072317919309073,6.62595275395397,303.3323997802734,297.98879888916014,293.6699981689453,289.3511974487305,284.0075965576172,0.1,0.0,272.4540719105615,0.011032900014984248,0.01909260852661429,302.632088797433,292.5889107840402,10.423582336388023
2023-05-08,0,308.7675018310547,277.9750061035156,308.1524963378906,286.00188064575195,305.7462501525879,0.35685517802453554,9.84233991080933,-1.4415407695512197,2.9951705113670317,288.67499923706055,9.048149414062504,0.033581274322277886,283.83325271606446,306.56550216674805,0.8193383289951768,0.069129404234757,1.0534899500275914,1.0309225901858836,1.0071220407347419,0.007168027329542914,74.18180720965671,312.7748054777466,293.09012565612795,273.4054458345093,306.7949992588588,1.1986576394492525,297.3019643511091,11.22334267883856,303.72548090073377,298.42973019229606,4.073048006339283,6.58198477807499,21318600,4.749651781235465,0.7507469225102231,-246903500.0,-9.071056750178645,89.02914134005623,91.58768807638091,96.43647129463827,32.11914360086632,11.703165048811018,-0.034052623035602005,6.478384525713542,303.3323997802734,297.98879888916014,293.6699981689453,289.3511974487305,284.0075965576172,0.1,0.0,272.52242204795317,0.010112510228271532,0.0045237281920031324,303.1714128766741,294.02052089146207,10.913178143658104
2023-05-09,0,307.8375015258789,277.9750061035156,308.7675018310547,286.00188064575195,305.890625,0.18824926114022347,10.340390516996859,-1.5931179858876356,2.9951154375409224,289.4000015258789,9.691586990356445,0.03515739007825449,283.83325271606446,306.72824935913087,0.8250090806978664,0.08701812537841447,1.046649360492801,1.0186734066297707,1.0026512726048864,0.004150829593524419,77.51800214837286,314.797906735898,294.1171257019043,273.4363446679106,307.0749991280692,1.1773481430077097,298.78982162475586,11.13398796061775,304.9812431748281,299.2959440533002,2.815401234066077,6.590085863032647,21340800,4.589982814571068,0.7594663720968138,-268244300.0,-13.57923604342167,89.02914134005623,91.58768807638091,83.29339949406292,30.756936581738124,11.206821379950675,-0.03641669594646295,6.282072130042646,303.3323997802734,297.98879888916014,293.6699981689453,289.3511974487305,284.0075965576172,0.1,0.0,272.5895735523913,0.005205899392447977,0.004712508389026905,303.1346958705357,295.33000619070873,10.922822595068201
2023-05-10,0,310.4000015258789,277.9750061035156,308.7675018310547,286.3574962615967,306.0887451171875,-0.004660031416366099,10.481133099515459,-1.6382210755007154,2.9951022030562924,292.88500595092773,9.87424964904785,0.03549238867857989,284.0694999694824,307.8690010070801,0.8381635018094185,0.08274346546802869,1.0511113059424455,1.017102164034014,1.010160191066629,0.014611214843635478,74.73094210243396,316.26876682464126,295.30650062561034,274.3442344265794,307.62214224679127,1.6843371233401552,300.50642939976285,10.922036905224996,305.70533674106235,300.1021724544241,0.64077909255458,7.2576507071081,30078000,4.611853966356639,1.0653317021718203,-238166300.0,-1.833649619645435,89.02914134005623,91.58768807638091,94.22349862998284,32.02831127502414,10.439816964703361,0.02235478332329903,6.261924120753838,304.11931884765625,298.6253381347656,294.18499755859375,289.7446569824219,284.25067626953125,0.12000000000000001,0.0,272.6923775734794,0.025985511373175507,0.022592464898170066,304.0876900809152,297.17952837262834,11.156996582613148
2023-05-11,0,309.39749908447266,277.9750061035156,310.4000015258789,286.5606231689453,306.56625175476074,-0.17644736663309035,10.65363988004222,-1.5833221693013946,2.995085664164731,298.2025032043457,10.000624084472657,0.035917900362996774,284.71075134277345,308.21399688720703,0.8404584595920169,0.08294810824554351,1.043109084764036,1.009086414893234,1.0039766719945904,0.012086913591486725,76.63523795014154,317.91815546198876,296.6108757019043,275.3035959418199,308.0267846243722,1.7277224134296645,302.24732208251953,10.181915266906746,306.893524563085,301.22564108757973,1.2493074452383701,8.392191664473144,31680200,4.615255736039031,1.1074539957670215,-269846500.0,-7.680080450261951,89.02914134005623,91.58768807638091,74.60245558072111,29.812647342438286,11.329870132628487,0.012837697057715314,6.246785811626298,304.11931884765625,298.6253381347656,294.18499755859375,289.7446569824219,284.25067626953125,0.12000000000000001,0.0,272.79491905844384,0.015388994096360964,0.01875813885875765,304.7512512207031,298.898448399135,11.396571889548127
2023-05-12,0,309.19249725341797,277.9750061035156,310.4000015258789,286.8474979400635,306.8868751525879,-0.36681086731664214,10.742093702204114,-1.4783864449962434,2.9950783862032573,303.0074996948242,10.026798973083498,0.03607762121693766,284.71075134277345,308.8305015563965,0.8480154672690123,0.0805720425033958,1.038431623133117,1.0054386627219483,1.000911256615424,0.0033749553480397765,73.84482467505161,319.2336880605361,297.7495006561279,276.2653132517197,308.49285670689176,1.4917515198761142,304.19803619384766,8.44877619807151,307.53479496681217,302.1021151392082,0.9239465106940187,8.551003395532248,19758100,4.630368024948863,0.6921775192683652,-289604600.0,-10.70953562681459,89.02914134005623,91.58768807638091,66.11463596897117,28.396468569283847,10.791671649275928,0.017917351846648593,6.089871667436148,304.11931884765625,298.6253381347656,294.18499755859375,289.7446569824219,284.25067626953125,0.12000000000000001,0.0,272.8578390066461,-0.005407942563385615,0.011656426210579636,305.39646693638394,300.81856209891185,11.303019764781453
2023-05-15,1,309.0124969482422,277.9750061035156,310.4000015258789,288.59374809265137,307.91625022888184,-0.5727255862559281,10.682208071596774,-1.2671698386950734,2.9950890264020624,305.79000091552734,9.799199218750005,0.0357392678999342,284.71075134277345,309.21299743652344,0.8621609138240414,0.06941694217606438,1.0338574514594705,1.0037712915978132,0.9996554618259818,0.0007934614741986756,72.42343090584264,320.2571663110401,298.89275016784666,277.5283340246532,308.96571350097656,0.8436737887427328,306.41499982561385,3.8698676880522984,307.9714293017012,302.92727456179597,1.0664219448056074,9.688433155006253,16336500,4.624918018283838,0.5799283347521074,-305941100.0,-17.46428447758003,89.02914134005623,91.58768807638091,62.89269933614032,27.591398390703496,10.485716244973972,0.03735056741437386,5.8198806596611705,308.21628259277344,305.25686419677737,302.86500549316406,300.4731467895508,297.5137283935547,0.12000000000000001,0.0,272.91004836342114,0.0026242982545829907,-0.003830737809167469,305.96825735909596,303.22152273995533,11.26376735785018
2023-05-16,1,311.2774887084961,277.9750061035156,310.4000015258789,289.0100040435791,308.30624771118164,-0.777034610293824,10.652141148056682,-1.004374496081167,2.995095343608475,305.90374755859375,9.518323936462405,0.035520486926932326,284.71075134277345,309.21299743652344,0.8645343833109882,0.06674660989696489,1.037981736689209,1.0103271136277427,1.0068231170299493,0.011174685233494852,71.64715145712813,321.1915324334425,299.8872501373291,278.5829678412157,309.4121409824916,1.122394223143174,307.49964141845703,2.7076252922809965,308.1912155267006,303.5477371130114,1.0827512255223097,11.165568904841917,26730300,4.6320178688282345,0.9379617054149048,-279210800.0,-10.671734196069744,89.02914134005623,91.58768807638091,77.55152148805372,30.891879346104172,9.928024350867659,0.05131275139793251,5.707746326828029,309.3534334716797,306.6582747192383,304.47999572753906,302.3017167358398,299.60655798339843,0.14,0.0,273.0017008022527,0.01543985268958492,0.010011371192086307,306.1221487862723,304.3771187918527,11.200368546537144
2023-05-17,1,312.86499786376953,277.9750061035156,311.2774887084961,293.8212547302246,308.82875061035156,-0.9759751625754879,10.657234411483962,-0.6511659601797488,2.9950978000650714,306.24749755859375,9.210823898315436,0.035409947216311265,284.71075134277345,309.4977493286133,0.840083982304909,0.0845622119264417,1.039531705171979,1.0139289048087596,1.0097109663575154,0.00794135414231012,76.76678612085426,322.2817181210637,300.9672492980957,279.65278047512766,309.99749755859375,1.6666722089037544,308.3962484087263,2.1694281786568808,308.9155917053213,304.431338338237,1.0141058105136687,5.128458833350249,24315000,4.5556884256047745,0.8426171970840559,-254895800.0,-3.866842307481201,89.02914134005623,91.58768807638091,83.72782212924093,30.352777943651333,9.457693080418544,0.061177692282504206,5.5636217635833765,311.805673828125,310.1821545410156,308.8699951171875,307.5578356933594,305.93431640625,0.16,0.0,273.0874735694337,0.007609184967195315,0.02503731895366314,306.97440011160717,305.0729064941406,11.161804421707405
2023-05-18,1,316.45249938964844,277.9750061035156,312.86499786376953,299.25750160217285,309.05749702453613,-1.2147772768962561,10.451756329427278,-0.02707245534070646,2.995125691101242,306.56750106811523,8.59057388305664,0.034578680720336416,284.71075134277345,310.4877502441406,0.8186358627515375,0.09252972444741887,1.0469541763749406,1.0232554800506184,1.0196665801958182,0.02280238310281102,79.03429764254312,323.1636368653975,302.26012420654297,281.35661154768843,311.22821153913225,2.6791057269146066,309.15160533360074,2.931980736830594,309.85967108547186,305.5910481753081,1.327048995900103,4.179811983773413,27276000,4.533445047684382,0.9386711450507775,-227619800.0,-3.3249299501260507,89.02914134005623,91.58768807638091,114.11906025671567,34.21028998919537,8.80969717618571,0.11764915563558356,5.546220732200162,315.34896508789063,313.06552294921875,311.2200012207031,309.3744794921875,307.0910373535156,0.18,0.0,273.19292878006263,0.02936466881714761,0.022113492428930664,308.6991533551897,305.9169246128627,11.053268465864656
2023-05-19,1,317.5499954223633,277.9750061035156,316.45249938964844,304.3549995422363,309.24374771118164,-1.4226146382060334,10.218553230059669,0.8544406482136266,2.9951570016332627,307.20375061035156,7.753435897827143,0.033639735553119804,284.71075134277345,311.4362396240234,0.7723915264406283,0.1102622496115172,1.0453826124307746,1.0232474126256692,1.0185719767235333,0.02703008075288249,83.37916673778165,324.2014810023557,303.76437454223634,283.327268082117,312.24963923863004,3.5365110584453787,309.9358907427107,3.5842761473129707,311.48102612276625,307.1106795193188,2.798553724308114,3.4572653640219677,27529500,4.51038712947657,0.9379486149504501,-200090300.0,-4.475777182863342,89.02914134005623,91.58768807638091,126.28561637102075,33.117114622080024,8.528187023895464,0.12202218588845383,5.320062457243576,315.34896508789063,313.06552294921875,311.2200012207031,309.3744794921875,307.0910373535156,0.18,0.0,273.30060613875867,0.03257881080549496,0.02878305318830615,309.6487470354353,306.8682185581752,10.637974887867655
2023-05-22,0,320.0950012207031,277.9750061035156,317.5499954223633,305.8337516784668,309.6481246948242,-1.6747525471885145,9.680811130575133,2.243715384952912,2.9952204811254823,307.99499893188477,6.529998474121101,0.031699765357106606,294.6715057373047,313.22374801635743,0.698477891398587,0.12653320360843234,1.0481494054389446,1.02833425825958,1.0212598467171572,0.03586425915427349,87.13018944710232,324.75224649821075,305.39062423706054,286.0290019759103,313.7778538295201,4.322583816792474,310.90231922694613,4.348123583400066,312.9931266990245,308.73794768710957,2.3034774037809598,3.581562363724149,24115700,4.370262300374019,0.8251457007957643,-175974600.0,-7.347595011593179,89.02914134005623,91.58768807638091,162.32230357785332,36.26765947895863,7.998507621975781,0.13934752604933504,5.267199894030795,318.06115576171874,315.25941540527344,312.9949951171875,310.73057482910156,307.92883447265626,0.19999999999999998,0.0,273.4003543171884,0.04014133380032159,0.041790769711721146,311.310791015625,308.03102111816406,9.61158870814965
2023-05-23,1,318.31500244140625,277.9750061035156,320.0950012207031,305.9168701171875,310.6193733215332,-1.814909319198026,8.558443498259093,4.49300919470198,2.99533752215239,308.45999908447266,5.338498535156248,0.027850337469770794,299.89050064086916,316.56224899291993,0.5068879782366389,0.15152439677077426,1.0358402484619287,1.0189079811878503,1.0084493041293001,0.0226084891718612,92.41141052051294,324.41813630987264,307.3012493133545,290.18436231683637,315.08106885637557,4.07799014777221,311.78696278163363,4.515340051061614,314.7940113934952,310.686437046877,3.457527021997616,4.4134192329676845,30797200,4.152844101240265,1.0814671646550016,-206771800.0,-38.61277757243183,89.02914134005623,91.58768807638091,128.8440132815877,32.70028235778054,10.846043363099001,0.16815876509541786,5.4245428459361555,318.1604794921875,315.33975842285156,313.05999755859375,310.78023669433594,307.959515625,0.2,0.0,273.51947266694646,0.013502250804368066,0.020969469644016237,312.296142578125,308.8463047572545,6.114824985098219
2023-05-24,1,314.42250061035156,296.0925064086914,320.0950012207031,306.40625,311.67436599731445,-0.07190483818001454,5.678237200900756,0.13279373991830123,2.9955636749766636,308.88999938964844,4.1806492614746045,0.018357265427652605,305.1634994506836,317.6264961242676,0.727194471765893,0.07505254456538496,1.0165016176525468,1.0030841757751254,0.991695464474488,0.004978194292159843,81.24970500531239,320.6747235320505,309.318249130249,297.9617747284475,315.8539265223912,3.141257874350559,312.40982001168385,4.202031506574728,315.7339195738631,312.3710047830778,2.950429026908555,4.04831499432303,23384900,1.9191907689631478,0.885237554901714,-230156700.0,-48.075822485402846,89.02914134005623,91.58768807638091,65.14685039301392,30.99075185878706,13.826999748906296,0.19312020168089009,5.3149336889718395,318.36579833984376,315.6720965576172,313.4949951171875,311.3178936767578,308.62419189453124,0.02,1.0,273.6025263399246,-0.00047768013094007244,0.008969340999585755,313.01281302315846,309.4905351911272,5.1680458871102255
2023-05-25,0,324.01499938964844,300.3125,320.0950012207031,306.5687503814697,313.25437355041504,0.36249982010499493,4.894799446644954,-0.4155992422014738,2.99560802919988,309.1024971008301,3.9499496459960937,0.015777727881682756,305.8600021362305,317.6264961242676,0.781600768165087,0.04698439329149324,1.0444187848099784,1.0323617736795172,1.0209473561415947,0.02389774141328016,63.898402011716804,320.02434773362194,310.23474884033203,300.4451499470421,317.67357090541293,3.6897740155420182,313.5428559439523,5.0239770621042155,315.42152613541606,312.8294250257021,1.750739441135133,2.8524468194120356,43301700,2.0880462630310936,1.6490558478632427,-186855000.0,-4.70918108467199,89.02914134005623,91.58768807638091,190.60484561254586,38.72801183199981,11.630346290242443,0.1714230584752723,5.867437553543636,321.98883447265627,318.9505748291016,316.4949951171875,314.0394154052734,311.00115576171873,0.02,1.0,273.79280340921815,0.02323262926384584,0.037961832690277225,315.1154044015067,310.6187765938895,6.034996682863112
2023-05-26,0,328.54750061035156,305.70249938964844,324.01499938964844,307.52062606811523,314.9300003051758,0.8782574188419574,5.2083351070383594,-0.30502757650333434,2.995593086938686,309.2949981689453,4.377587966918952,0.016724478895072423,305.92474365234375,318.4930023193359,0.6832286115077142,0.059296603390164654,1.0549985027962505,1.0419502830780563,1.0303186651980092,0.03463235820035471,75.2437162402911,321.83654402389107,311.4198738098145,301.0032035957379,319.9139284406389,4.85922066876019,314.95571299961637,6.217305473695176,317.5797006733182,314.39763001751595,4.092011514870809,5.147614651923671,36630600,2.685732015709763,1.3945124568504825,-150224400.0,-1.879069809281892,89.02914134005623,91.58768807638091,216.34828419033633,42.00680725843086,10.339844460693223,0.20547273129206226,6.128334086410196,326.99495764160156,323.0325199584961,319.8300018310547,316.6274837036133,312.6650460205078,0.04,0.0,273.9709673749513,0.04570589274350234,0.04511504393275974,317.78821236746654,312.38130623953685,7.593246654788843
2023-05-30,0,333.1749954223633,305.70249938964844,328.54750061035156,308.0737476348877,316.72687339782715,1.0268178515805473,6.242901450160383,0.16267529983808426,2.9955341185289335,309.8987503051758,5.183550720214839,0.019973873184897333,306.5015014648437,320.4870010375977,0.7010550850335213,0.07168836134457023,1.065977920694883,1.0501796179863148,1.0376729544307783,0.04086285056554684,79.00931603714889,325.0391766185825,312.5533737182617,300.0675708179409,322.3028564453125,6.653291420848103,316.7655339922224,7.5341812104424974,320.32211093799515,316.1491828603672,5.012546259141026,6.406114199842088,29503100,2.8004372500474872,1.1058910624341103,-120721300.0,-15.366356107660456,89.02914134005623,91.58768807638091,197.23593074043498,42.18025920564464,9.704021001962504,0.19205862621865713,6.06345316743106,328.78271484375,324.4786376953125,321.0,317.5213623046875,313.21728515625,0.06,0.0,274.11983653685894,0.031228475046114923,0.04042838718419633,319.5837620326451,314.1414576939174,8.41097157200203
2023-05-31,0,330.9875030517578,305.70249938964844,333.1749954223633,308.6137504577637,317.741247177124,1.1026321063961344,7.528398227537846,0.3227481343812433,2.9954470877346187,310.8387451171875,6.150350646972652,0.023984679874280185,306.5015014648437,324.46824951171874,0.7258308146012555,0.08680049180122247,1.0544911497966902,1.0353988547957058,1.022528934224529,0.03981119492690022,82.11952463897232,328.9404199597144,313.88362350463865,298.8268270495629,324.2225003923689,6.983741702166446,318.23606981549943,8.17783244978547,323.5285824426579,318.2771221716574,5.2843621285873965,8.23080156605102,45950600,2.8889429172907612,1.6615395852569306,-166671900.0,-25.43797053942506,89.02914134005623,91.58768807638091,148.26239288851767,38.02662407985489,12.396863909615695,0.14321337137029116,6.245350503267612,328.93552416992185,324.6022452392578,321.1000061035156,317.59776696777345,313.26448803710934,0.08,0.0,274.34255224173995,0.04164813785707988,0.022448500318689234,321.00577218191967,315.3272596086775,8.707932450617859
2023-06-01,0,329.1899948120117,305.70249938964844,333.1749954223633,308.9512481689453,318.76000213623047,0.895331510961519,8.193574164978125,-0.38173910224609386,2.995396729649352,312.0712432861328,6.829950866699221,0.0260026997468874,307.64675064086913,328.7915008544922,0.800154734230311,0.08190602744377545,1.0447002031620731,1.0234654788484638,1.0090748843889925,0.046967040122744885,76.74688178887065,331.4918968651125,315.10474853515626,298.71760020520003,325.5217851911272,6.933717779260097,319.64981951032365,8.242883979834543,325.3923813854502,319.80737287188333,4.231619531759629,6.632571335268653,26773900,2.9662793411652246,0.9604610976647012,-193445800.0,-11.451998256732539,89.02914134005623,91.58768807638091,126.36936727518736,34.30422268963124,14.083341091580133,0.21435188064413704,6.428539578648196,329.01576330566405,324.732123840332,321.27000427246094,317.80788470458987,313.5242452392578,0.08,0.0,274.4708779110787,0.05967817560719313,0.05493874302249826,322.6187962123326,316.96479361397877,9.102730990902312
2023-06-02,0,334.9249954223633,305.70249938964844,333.1749954223633,309.147497177124,321.07500076293945,0.6944959505661092,8.455352696876702,-0.8714863080269759,2.9953770220430336,313.64374923706055,7.1917753982543955,0.026734792697590607,308.12099685668943,329.3697456359863,0.8314478352353347,0.07683121815901844,1.0589919359799045,1.036037417718033,1.0174431753418582,0.033671268469873894,72.37592831081461,333.17845403572124,316.2677486419678,299.3570432482143,327.8946413312639,6.8984077229607434,321.48785509381975,8.59322154615699,326.3459338039321,321.0144399470116,2.841341963049796,6.397109151207216,25864000,3.0294008512104766,0.9222881975887641,-167581800.0,-7.021082736194904,89.02914134005623,91.58768807638091,147.28920107915775,36.87077449543495,13.29581395938568,0.22319192204194843,6.322930480675479,330.4412391357422,326.0743786010742,322.5449981689453,319.0156177368164,314.64875720214843,0.1,0.0,274.60506127068885,0.029086710583859476,0.06866320729562346,325.4684622628348,318.8823024204799,9.575117618567267
2023-06-05,0,336.0950012207031,307.8375015258789,334.9249954223633,309.346248626709,325.1481246948242,0.6077544054113714,9.010078902300037,-1.0771811117039827,2.9953324006119506,315.4375,7.741900482177732,0.0283577592575933,308.7060012817383,331.20625228881835,0.8097768036376232,0.08688068213835427,1.0578044027854447,1.03374962008755,1.0142742999032088,0.02297232697351337,76.60634782298078,335.7490312482036,317.7288734436035,299.7087156390034,330.9907128470285,4.166851120658404,323.4223196847098,8.617107075692578,328.49884668463767,322.984209295376,5.218099320975144,8.322484664902667,21307100,3.1835611438180207,0.7692207718598001,-146274700.0,-9.119366917173434,89.02914134005623,91.58768807638091,133.31127621557584,36.43178636494646,12.693552129849804,0.17931819525429277,6.149863581804568,331.7797149658203,327.5851333618164,324.1949920654297,320.80485076904296,316.6102691650391,0.12000000000000001,0.0,274.7174070630799,0.009162348974888657,0.03074386265708155,328.59405517578125,320.8034340994699,10.153572492070692
2023-06-06,0,334.1374969482422,307.8375015258789,336.0950012207031,310.14937591552734,328.7081241607666,0.4705695153686364,9.566083076711891,-1.2609253213628526,2.995284994197384,317.00124740600586,8.40220016479492,0.02997588136362414,308.9879974365234,333.3499954223633,0.8288363860158077,0.0885051024722186,1.0470394086418087,1.0218998676229256,1.0037942196534866,0.002888876833805565,77.34800448370001,338.2581648411679,319.12599868774413,299.99383253432035,332.43678392682756,2.909172578121237,325.0551774161203,8.29874832895394,330.39476085070845,324.5567450754025,6.892795702687078,8.76421003678602,20396200,3.1786836160305225,0.7375638572663756,-166670900.0,-17.541350100811094,89.02914134005623,91.58768807638091,99.27819440243955,34.79119436955405,15.096188998982635,0.16807044398311574,5.979872541223553,331.9944758300781,327.93275476074217,324.6499938964844,321.3672330322266,317.30551196289065,0.12000000000000001,0.0,274.8199688319707,0.007457668618514379,0.0023731955522390876,329.6920427594866,322.40372358049666,10.262293639941635
2023-06-07,1,328.00499725341797,307.8375015258789,336.0950012207031,311.0581169128418,329.63937187194824,0.2879596367291506,9.787910141837372,-1.4497174814586735,2.9952668927663764,317.93249893188477,8.791649932861333,0.030549557465513907,309.1744972229004,334.2162467956543,0.8484401856898981,0.08543467021399381,1.0237535252533496,0.9988549832643939,0.9848018534902255,-0.009010931744675155,73.11240866308067,339.97031872727825,320.39449844360354,300.8186781599288,332.3592834472656,3.034575057242263,326.1366059439523,7.539781888590593,331.32384373767877,325.58511277865466,3.124083013953564,7.343932365489476,40717100,3.2268904142155908,1.4225663674301336,-207388000.0,-58.497054084884695,89.02914134005623,91.58768807638091,40.9075821714313,30.142204852754602,23.855943643395687,0.12518156939520161,6.409166662163194,332.43579467773435,328.6470928955078,325.5849914550781,322.52289001464845,318.7341882324219,0.02,1.0,274.99962570139104,-0.015256217189984933,-0.0236404169432694,328.346444266183,323.0673283168248,9.715390012909259
2023-06-08,1,324.7975082397461,309.0124969482422,336.0950012207031,312.4681205749512,329.63937187194824,0.1391210189292867,9.476203947889903,-1.4960981962152626,2.9952981239736016,319.2050018310547,8.645162506103514,0.029483880628251843,309.3769989013672,334.2162467956543,0.8803039604854032,0.05671712513207344,1.0105619311229261,0.9861773485487576,0.9769212938958303,-0.013343317359247209,59.760045300902284,340.35528112576026,321.40287322998046,302.45046533420066,331.1624995640346,4.117865371136443,326.7326780046736,7.027774997175504,330.4850322178956,325.64528450923655,-0.16512174219124195,4.839147713238549,23277700,3.6199525232216367,0.823049210689241,-230665700.0,-51.25233732786095,89.02914134005623,91.58768807638091,23.196084350381113,28.997197856057443,22.949731821203624,0.09390889181630672,6.1863696537886925,332.43579467773435,328.6470928955078,325.5849914550781,322.52289001464845,318.7341882324219,0.02,0.0,275.09841120095183,-0.022009763444051922,-0.009531382676781183,327.5045645577567,323.5441632952009,9.46710565558694
2023-06-09,1,326.5449981689453,309.0124969482422,336.0950012207031,314.03312492370605,329.63937187194824,0.007281494940359304,9.154410894137042,-1.4160572192327145,2.995328395115147,322.0550003051758,8.264750671386718,0.02841901397805395,309.3769989013672,334.2162467956543,0.8676486797698341,0.04977418757696189,1.0137284610384165,0.9883697141175486,0.9847794830673352,-0.025020519125036444,54.74732040668068,340.4315703539479,322.1227485656738,303.81392677739973,330.5278560093471,4.476087941358034,327.375178200858,6.516248045202923,329.04987047869577,325.3518447933962,-2.514440548576316,2.637049435916268,22514900,3.7140582011674903,0.8091897625809081,-208150800.0,-45.356391048181294,89.02914134005623,91.58768807638091,33.98277246074552,31.01101135852703,21.460719751770032,0.05624286406139118,6.143056576537023,332.43579467773435,328.6470928955078,325.5849914550781,322.52289001464845,318.7341882324219,0.02,0.0,275.1973596834374,-0.025670759496682738,-0.017409403075078166,327.2781720842634,324.14197213309154,9.032010144429517
2023-06-12,1,329.42250061035156,309.0124969482422,336.0950012207031,315.9449996948242,329.63937187194824,-0.12545876603666958,8.714893164365597,-1.3043038384747943,2.9953677529997926,324.40625381469727,7.763863182067871,0.026982753828282278,311.0689895629883,334.2162467956543,0.8418712466057936,0.056121998656730086,1.0199466673683937,0.996316245263666,0.998504165438137,-0.01985301949186069,57.11972691776961,340.4099098486286,322.98012351989746,305.5503371911663,330.56107112339566,4.465355432302656,328.04142815726146,6.182950862282955,328.41336251478884,325.4911114510239,-1.3421971651049944,2.8326256892613273,24260300,3.711548806044817,0.8649221196461991,-183890500.0,-25.8573730198864,89.02914134005623,91.58768807638091,51.58908010038571,30.96245236831806,19.74484536075701,0.0899213007792288,6.199981281170566,332.43579467773435,328.6470928955078,325.5849914550781,322.52289001464845,318.7341882324219,0.02,0.0,275.308963484722,-0.012174919389070227,-0.010584211469631184,327.1748831612723,324.8968396868025,8.540315767569542
2023-06-13,0,334.03250885009766,309.0124969482422,336.0950012207031,317.27562141418457,329.8137512207031,-0.2605347738592086,8.215625934907635,-1.1935702429244615,2.9954100006850783,325.6712532043457,7.194300689697263,0.025357525732904968,312.7062469482422,334.2162467956543,0.800100612715317,0.06604912054908878,1.0309911875130164,1.0099916237631834,1.0165895176749355,-0.00031420627467260154,60.731427839986296,340.4228755575594,323.99162368774415,307.5603718179289,330.4335730416434,4.3306975784905815,329.1641071864537,5.68817554619339,328.6696603027794,325.9311162596532,0.07062966736659759,2.913978460793643,22951300,3.7269087585626326,0.8087180149440509,-160939200.0,-16.454670539672833,89.02914134005623,91.58768807638091,84.79668611077966,34.21923462556899,18.25248583279795,0.07848053445203525,6.227839499507725,332.43579467773435,328.6470928955078,325.5849914550781,322.52289001464845,318.7341882324219,0.02,0.0,275.4222134149307,0.0018281312819505846,-0.004911681091458599,327.01783534458707,326.24314880371094,8.01297817796947
2023-06-14,0,335.8824996948242,311.2774887084961,336.0950012207031,318.1237506866455,331.5343761444092,-0.3291293637199008,7.730055877008905,-1.2025194464913107,2.995449052619286,327.27499771118164,6.739362525939941,0.023767044353592188,314.26675033569336,334.2162467956543,0.7597469986788219,0.07310204228392209,1.032713656260302,1.015322063336384,1.022285079952779,0.024016409833293118,65.10391748034056,340.7027360368548,325.2426242828369,309.78251252881904,330.40321568080356,4.284900441427194,330.696964263916,4.071912757387156,330.03264486815254,327.0057275160405,-0.2664735640707074,4.937720901667085,26003800,3.8023649647729907,0.917451002045264,-134935400.0,-8.928631534068597,89.02914134005623,91.58768807638091,103.4041954063594,34.13681355452913,16.94831474190349,0.10014790811762476,6.227994605709182,334.54656652832034,331.7667252807617,329.52000427246094,327.27328326416017,324.49344201660153,0.02,1.0,275.5554835088374,0.04316892719156584,0.010968510674133337,327.2159162248884,327.9049857003348,7.676294742639104
2023-06-15,0,343.1550064086914,312.86499786376953,336.0950012207031,319.6500015258789,333.3893737792969,-0.3948548204662256,7.358623805184718,-1.145661178768471,2.9954774589807154,328.27624893188477,6.327049407958986,0.022539770904299303,316.24949951171874,335.0207458496094,0.73380499531333,0.07357007651292835,1.0510980631549092,1.0357731361894404,1.039435272654738,0.05651982451600257,66.54943853469133,341.1901224425227,326.4728748321533,311.7556272217839,331.6914313180106,6.418840033390628,332.0641076224191,4.803309608779405,331.4898671561524,328.27581365558575,-0.06322662494446417,6.825210995655487,38899100,3.8042327435381256,1.3379924523784914,-96036300.0,-6.3642665231945905,89.02914134005623,91.58768807638091,177.37716790634974,41.065049457726104,14.65966654102888,0.11404551270753302,6.685993857505797,343.38775720214846,339.3961177368164,336.1699981689453,332.94387860107423,328.95223913574216,0.04,0.0,275.7819477446308,0.07022076254468268,0.07644251978257037,329.2562473842076,329.4741450718471,8.418828183224916
2023-06-16,0,346.7675018310547,314.42250061035156,343.1550064086914,323.0349998474121,334.0587558746338,-0.13994611188132272,7.517419283212528,-0.7541484258518278,2.995469281434205,328.86874771118164,6.170649719238281,0.022919843415519073,317.4402458190918,335.9037498474121,0.6876810615074549,0.08438077458874525,1.0572586873406404,1.0422836220800282,1.038824768700036,0.061928689079619126,72.0119904107996,343.02221382582445,327.9873752593994,312.9525366929744,334.37178911481584,8.272614709741386,333.36553628104076,6.076717397004685,334.3947930300178,330.5512984529142,2.6987421474118567,5.90713610638312,46533600,4.0088563589534445,1.5492807455415845,-49502700.0,-31.549928420112316,89.02914134005623,91.58768807638091,164.33265496868947,38.70147341812997,13.212519193802727,0.0025797101167502547,6.888422082946302,344.6330809326172,340.40346075439453,336.98500061035156,333.5665404663086,329.33692028808593,0.06,0.0,276.0517169096669,0.047553460435350914,0.05248103869087513,331.93753923688615,330.1419917515346,8.609595472899622
2023-06-20,0,338.82498931884766,314.42250061035156,346.7675018310547,324.6018810272217,334.33437156677246,0.09217235834715076,8.074409197142591,-0.3394997847608403,2.9954321773964523,329.30624771118164,6.362938041687011,0.02450480306611584,318.23850173950194,336.80100173950194,0.6948985208247259,0.09200915392812435,1.0282906692511213,1.0147985149566572,1.0028799173301461,0.02854233906632131,74.36907303449141,345.65194377575494,329.5031253814697,313.3543069871845,336.37571498325894,7.195728251237372,333.76910727364674,6.24828329782203,337.4659629562427,333.0417056121317,5.720188635766648,5.545621618443402,26375400,4.037920519903968,0.8798278465710251,-75878100.0,-46.32382762256805,89.02914134005623,91.58768807638091,87.39390792780773,36.093684263092506,18.6647214447077,-0.040525122386373985,6.858534878500351,344.6330809326172,340.40346075439453,336.98500061035156,333.5665404663086,329.33692028808593,0.06,0.0,276.18922857321013,0.018683140448522817,0.034456465813145196,333.7472403390067,330.6259024483817,8.370252047001925
2023-06-21,0,334.93250274658203,314.42250061035156,346.7675018310547,326.1081256866455,335.1643714904785,-0.04650740716560344,7.827228886524732,-0.2443970009091565,2.9954517697917895,330.2050018310547,6.231374740600586,0.023678200922939506,319.91700134277346,339.257991027832,0.7595776649466532,0.058513841286857035,1.013206488609243,1.002320771411224,0.9858712414712338,0.002694330260197164,60.641441254889,346.2213328493434,330.56687507629397,314.9124173032445,337.5739299229213,5.860330843609843,334.0508929661342,6.2019729907648005,337.79974417438166,334.09567533036176,4.318838883686052,1.6958036989906529,25117800,4.547199787656346,0.8364788681502923,-100995900.0,-61.82258511370089,89.02914134005623,91.58768807638091,35.60559688511791,33.825054787688906,21.475111485146897,-0.07569195807150637,6.795780992089592,344.6330809326172,340.40346075439453,336.98500061035156,333.5665404663086,329.33692028808593,0.06,0.0,276.31083624553486,-0.002183800153298332,0.005152900421485305,334.7051522391183,330.99166216169084,8.088770958655866
2023-06-22,0,336.82249450683594,314.42250061035156,346.7675018310547,327.6399974822998,335.1700019836426,-0.20463232032790304,7.495669520371743,0.11390221882111762,2.995475877877566,332.08124923706055,5.883999633789062,0.022624423643865518,323.4449996948242,339.257991027832,0.7306759984952983,0.052204577785285644,1.0166423143116765,1.0077370161081363,0.9909094090592018,0.0027985822806064764,55.929479467318195,346.30008919333136,331.3087501525879,316.3174111118444,338.6310719081334,4.696752010482519,334.5960715157645,6.075996061668084,337.0842977503215,334.3739031150469,2.5685601141246868,1.1918878079838935,23556800,4.638378846852628,0.7940674162454352,-77439100.0,-40.59374963788688,89.02914134005623,91.58768807638091,67.18321088897542,33.92665339484414,19.944483390593966,0.010053261800115617,6.794653691175827,344.6330809326172,340.40346075439453,336.98500061035156,333.5665404663086,329.33692028808593,0.06,0.0,276.4308143469296,0.00702548668424674,0.016213285188280756,335.8172825404576,331.496082850865,7.365058171298639
2023-06-23,0,335.19749450683594,314.42250061035156,346.7675018310547,328.41187477111816,335.93562507629395,-0.3066673407158164,6.957509487119533,0.6631509035431726,2.9955124697319224,333.60375213623047,5.417462005615232,0.020941585974144663,324.7192573547363,339.257991027832,0.6126392317734484,0.07124170138269968,1.008919522499846,1.0002364642003023,0.9855836599166282,-0.02318926360753193,59.161294075065555,346.1491437300985,332.2341247558594,318.3191057816203,338.79749843052457,4.524114346998626,334.615535736084,6.077567077337133,337.019370872228,334.83762204683876,2.2463535073571848,2.3185697667339062,23084700,4.503346436373083,0.7785474917612349,-100523800.0,-56.782918584329956,89.02914134005623,91.58768807638091,30.75122488029963,31.68139412119055,18.62456138797857,0.012526215829138453,6.7564626595237485,344.6330809326172,340.40346075439453,336.98500061035156,333.5665404663086,329.33692028808593,0.06,0.0,276.5436410582199,-0.0375754549113394,-0.006877337494176102,335.92056710379467,331.46920122419084,5.949755519416754
2023-06-26,0,331.72999572753906,324.01499938964844,346.7675018310547,329.0293712615967,335.93562507629395,0.4440196906905116,5.6483907100933815,-0.03818903593332568,2.9955889921753798,334.0850028991699,4.477087249755857,0.016948246146354786,326.37024917602537,339.257991027832,0.6773415825609579,0.03451227609293434,0.9953705241517552,0.9868268770997299,0.979973941836286,-0.043364807901871694,54.17669129595854,344.56965587087035,333.2728744506836,321.9760930304969,338.20428357805525,5.192859096033601,334.30374962942943,6.107720558607105,336.5887514405647,335.1555658218735,0.3487641549466932,0.08136122660209827,21520600,4.076724486057626,0.7534714915973816,-122044400.0,-78.94371471701453,89.02914134005623,91.58768807638091,-44.049711799186866,29.152301113042206,22.334024527094382,-0.0778529825735692,6.818143549356889,344.6330809326172,340.40346075439453,336.98500061035156,333.5665404663086,329.33692028808593,0.02,1.0,276.64059369895955,-0.040107470729608186,-0.05601842012859145,334.6839163643973,330.94991629464283,5.799206577487117
2023-06-27,0,332.9699935913086,324.7975082397461,346.7675018310547,329.3643741607666,335.93562507629395,0.6039574373517183,5.25253518770363,0.2687918392227666,2.995608740633909,334.0850028991699,4.052762451171873,0.01574224313618026,327.8589973449707,339.257991027832,0.6885741985377339,0.009686560120759686,0.9979361220535474,0.9889901639027902,0.9924545738095947,-0.017280294878218916,47.91578095585035,344.1636946429854,333.65862426757815,323.1535538921709,336.74928174700057,4.997726756044824,334.2203565325056,6.118126655094006,335.3897274595649,334.5742699427424,-1.2362966129697244,-1.298741569291505,24354100,4.06073862595901,0.8714043402942704,-97690300.0,-58.336186345780895,89.02914134005623,91.58768807638091,-9.982114327965778,26.90562289365256,20.580943323884377,-0.1146041125019521,6.870418138186319,344.6330809326172,340.40346075439453,336.98500061035156,333.5665404663086,329.33692028808593,0.02,0.0,276.7544620087402,-0.010294430088519602,-0.022668183807313776,332.7695094517299,331.01287841796875,5.798750265575221
2023-06-28,0,335.5750045776367,324.7975082397461,346.7675018310547,330.59625244140625,335.93562507629395,0.5704264865183233,5.124232737307136,0.4495626426759576,2.99561482799771,334.0850028991699,3.809525337219236,0.015347539807173877,327.8589973449707,339.257991027832,0.7188605972947189,-0.000615297768053717,1.0050774437997856,0.995678462855359,1.0037223895992218,0.001918302421490603,48.07424586623958,344.1282143912403,333.879748916626,323.6312834420117,335.15035356794084,2.3445621600461237,334.76107134137834,5.855440102198111,334.8092745746643,334.0811032189949,-2.968050189322503,-0.34940806332623,20259500,3.9333734502155626,0.737086345102084,-77430800.0,-55.547645197279024,89.02914134005623,91.58768807638091,30.130595648261718,27.663012421369626,19.662909440233957,-0.07784563822541962,6.677532087439712,344.8336823730469,340.7281630859375,337.4100036621094,334.0918442382812,329.98632495117187,0.02,0.0,276.8530743406521,0.006865394827865412,-0.006507880851302748,331.8526393345424,331.8950892857143,5.78267698680361
2023-06-29,0,334.6224899291992,324.7975082397461,346.7675018310547,330.59625244140625,335.93562507629395,0.49884025444542857,5.134415424335314,0.37294252366335323,2.995614402985244,334.53124618530273,3.8350503540039087,0.015372512805630895,327.8589973449707,339.257991027832,0.7083749822840475,0.013860044514011578,1.0018644940781423,0.9923980821407549,1.0004888292700713,-0.006531643858459946,52.66893496045156,344.2685802230602,333.99974937438964,323.73091852571906,334.5499965122768,1.6948216372814235,335.46285574776783,5.110862643282133,335.0171865372335,334.14284327686045,-3.2276661435450658,2.307893900278029,16997000,3.939360340728142,0.6527705688305798,-94427800.0,-60.68002553281712,89.02914134005623,91.58768807638091,5.208455621464351,26.593844308677546,20.22080589300321,-0.0028513784022277584,6.4498505265064745,345.083841796875,341.1330821533203,337.94000244140625,334.7469227294922,330.7961630859375,0.02,0.0,276.933755293602,-0.013717580254433814,0.0044668527601292585,331.4281529017857,332.58769662039623,5.633213665034671
2023-06-30,0,339.5550079345703,324.7975082397461,346.7675018310547,331.1531219482422,335.93562507629395,0.4156731552593793,5.088702960497324,0.422615189382308,2.9956165666902623,334.77374267578125,3.680349426269532,0.015227362915106965,327.8589973449707,339.257991027832,0.6922693868897594,0.01650261308910618,1.016079613135133,1.0074030216897696,1.016573944416005,0.012999838898394511,51.85168377276783,344.35890463925637,334.1814987182617,324.00409279726705,335.21035439627514,2.5523140763654624,336.3921421595982,4.512371207548542,334.9308597906756,334.26047135883425,-1.240315656202595,3.0249559926429335,26823800,3.9208166676472684,1.0300705740313063,-67604000.0,-41.54311550747802,89.02914134005623,91.58768807638091,93.60342210187763,31.595164364726408,18.524099721713146,-0.0324614378371957,6.537720002710269,345.260841796875,341.41958215332033,338.31500244140625,335.21042272949217,331.3691630859375,0.02,0.0,277.0728652862271,0.01647667685662091,0.0024433711392690713,332.41577584402904,333.56046404157365,5.776824503668765
2023-07-03,0,338.6624984741211,324.7975082397461,346.7675018310547,332.6599941253662,336.2768745422363,0.21686937125165445,5.081760382011279,0.30634689040189134,2.9956171231239823,334.92874908447266,3.60352550506592,0.015183042089245502,327.8589973449707,339.9150077819824,0.7011531419409727,0.01382402799279961,1.0118397133763575,1.0058293806925775,1.011263383525755,0.020898028022391824,56.818276157390486,344.8632701384122,334.6997493743896,324.53622861036706,335.4732121058873,2.8260834688100958,337.05214200701033,4.068449318853188,336.094250981895,335.0408339803953,1.3801303695765172,3.984139961897068,12508700,3.865827103512018,0.4929930368827463,-80112700.0,-58.65972385456216,89.02914134005623,91.58768807638091,58.97559958236716,30.063524120998014,18.33143796623765,-0.049520460673470566,6.380024757678482,346.0467186279297,342.6916370239258,339.97999572753906,337.2683544311523,333.91327282714843,0.02,0.0,277.1358153554137,0.028575782026139418,0.008865159029228666,332.1724112374442,333.9948468889509,5.819830768375988
2023-07-05,0,337.4049987792969,324.7975082397461,346.7675018310547,332.6599941253662,337.2824954986572,0.12168620241594426,5.154803438521143,0.11481952457791644,2.995613865675395,335.064998626709,3.7717131423950208,0.015392682361686519,327.8589973449707,339.9150077819824,0.7175399822990574,0.007639200952387784,1.0075200801342141,1.0045126530869757,1.0033543771403186,0.013319534112229636,54.87047183073252,345.1962314040198,334.8866245269775,324.57701764993527,335.78856985909596,2.912047178122435,337.2930341448103,3.974665495085169,336.7126658837127,335.4979899751583,0.5462829820731622,2.8049079363582425,18172400,3.8672493874213716,0.7206625571457125,-98285100.0,-57.96345063604817,89.02914134005623,91.58768807638091,51.14808253816391,27.748385376564684,18.96738502313624,-0.03572869445419688,6.418593197141186,346.0467186279297,342.6916370239258,339.97999572753906,337.2683544311523,333.91327282714843,0.02,0.0,277.2265774908065,0.010700351300112487,0.029062712586728354,332.6152866908482,334.26792689732144,5.860756652310042
2023-07-06,1,339.2649917602539,324.7975082397461,346.7675018310547,332.6599941253662,337.71937370300293,0.08722323341603888,5.178012165669456,0.056625192246292144,2.995612823012958,335.064998626709,3.8326251983642576,0.015458962007985386,327.8589973449707,339.9150077819824,0.7305913126724074,0.009778913952781607,1.012876071059436,1.0104773567110532,1.0062313646227634,0.010996013208020461,53.48534504969071,345.30814873624615,334.95212440490724,324.5961000735683,336.86499786376953,2.5292527590329676,337.53464072091236,3.9851197496490243,336.8526650024937,335.78317166624413,0.6585682496549562,1.0096292545923058,28161200,3.850435697254834,1.0998539709246309,-70123900.0,-44.38645487636934,89.02914134005623,91.58768807638091,72.00294970939896,26.936396815460284,17.405052791504133,-0.003210571557878081,6.495121556943611,346.0467186279297,342.6916370239258,339.97999572753906,337.2683544311523,333.91327282714843,0.02,0.0,277.37070449844344,0.016137975678312433,0.020025653583425073,334.4080025809152,334.54595947265625,6.011259355204851
2023-07-07,1,338.83250427246094,324.7975082397461,346.7675018310547,332.6599941253662,338.70312118530273,-0.03529841073880535,5.257655592256495,-0.10919353584003888,2.995609230880226,335.3862495422363,3.9830001831054687,0.01568473235511324,327.8589973449707,339.9150077819824,0.7138051005549818,0.03432872852890232,1.010811197019739,1.0078886411244394,1.0027537774390207,0.012581384903783688,59.23494990470714,345.72381033002074,335.2084991455078,324.69318796099486,337.70249938964844,1.9223630709477646,337.2258905683245,3.6712678441724242,337.4106142561827,336.28743399924355,2.2714243902452487,1.0070462344727542,21185300,3.56468177565627,0.860215446708814,-91309200.0,-62.010414218156754,89.02914134005623,91.58768807638091,46.49823415280381,25.490352842781856,16.470686110773517,0.028132496910394912,6.373327770370614,346.0467186279297,342.6916370239258,339.97999572753906,337.2683544311523,333.91327282714843,0.02,0.0,277.47653527100925,0.006476673931635757,0.0040790578699248245,334.782958984375,333.7762342180525,5.326679453069053
2023-07-10,1,332.3125,324.7975082397461,346.7675018310547,333.7668800354004,338.826868057251,-0.19899431100972545,5.041032011276011,0.24168196949072662,2.995619433711823,335.72875213623047,3.767374801635742,0.01501424838605312,329.13475036621094,339.9150077819824,0.6384964478500114,0.043211526186817444,0.9897620974494328,0.9879036213939961,0.981013685144223,-0.021329409860937454,60.01972477572965,345.83193851901194,335.74987449645994,325.66781047390793,337.2364273071289,2.7440291422713647,336.1933904375349,2.6802836918480053,337.7402231812105,336.77936798880717,1.760672371080999,-1.2596354578847224,32791400,3.4613415771542955,1.3062437098127617,-124100600.0,-72.46758496869965,89.02914134005623,91.58768807638091,-88.1438080340625,22.836118912371738,24.93046065427886,0.02731120935265377,6.605947564116492,339.3555916748047,337.10719256591796,335.2899932861328,333.47279400634767,331.2243948974609,0.04,0.0,277.62064953692607,-0.025577075499353952,-0.009610450520043038,334.21415056501115,333.0333949497768,4.81166333016401
2023-07-11,1,330.84749603271484,326.5449981689453,346.7675018310547,333.7668800354004,338.826868057251,0.1775891475859918,4.456890937212083,0.39716475824483055,2.9956444253542216,335.72875213623047,3.415937652587888,0.013259598845971974,331.49924621582034,339.9150077819824,0.5169758425940265,0.017662196216126826,0.9842971565582536,0.9843927053069764,0.9808832236119923,-0.023076078622869534,46.74757701623474,345.0394059588968,336.12562408447263,327.2118422100485,336.697142464774,3.585344075234126,335.6235694885254,2.9154561618877786,336.404451218594,336.48899858401086,-0.9722132259948831,-4.168499572401445,26698200,3.809339254354667,1.0547332865848238,-150798800.0,-65.79109092297122,89.02914134005623,91.58768807638091,-111.63218625580103,21.377395830947428,23.98109221903789,0.07933826095194553,6.552664548934057,339.2163525390625,336.88181396484373,334.9949951171875,333.10817626953127,330.7736376953125,0.06,0.0,277.7357443749974,-0.016331892036469453,-0.023697734766039223,333.8490992954799,332.6386260986328,4.3697554980078195
2023-07-12,1,337.7800064086914,329.42250061035156,346.7675018310547,333.7668800354004,338.826868057251,0.6139494495198314,4.076899587481616,0.3213652420034503,2.9956589864729493,335.72875213623047,3.2223252487182608,0.012121337066274992,331.64174575805663,339.9150077819824,0.4745158626765536,0.004325737980019763,1.004279164613283,1.005283430907672,1.0060986298642909,0.0011114465723722766,43.13527771340726,344.49454815262436,336.3407489776611,328.1869498026979,336.4435708182199,3.407913879118416,335.8269626072475,2.9624831646777467,335.05225042433136,335.89937782856236,-1.1281351403735904,-2.3544583598070083,29995300,3.77819455954241,1.1717142912947518,-120803500.0,-36.21001603175815,89.02914134005623,91.58768807638091,27.347130610232465,28.612696856629075,21.648160412905334,0.005872095842604753,6.740330843708877,339.2163525390625,336.88181396484373,334.9949951171875,333.10817626953127,330.7736376953125,0.06,0.0,277.8824094348729,-0.0028093675715590294,-0.0023372948257804195,333.3765127999442,332.8961443219866,4.221977325323333
2023-07-13,0,341.2449951171875,330.84749603271484,346.7675018310547,334.4749946594238,338.826868057251,0.7600919642192525,3.7625729976352984,0.5959695610336646,2.9956700286979974,336.3524971008301,2.948375701904297,0.011172907615413208,332.2542495727539,339.9150077819824,0.45855298423014956,0.011218960608039197,1.0133222151603893,1.0141439728216806,1.0161922989430099,0.005836155822209976,53.12431755360352,344.2837702628487,336.7586242675781,329.23347827230754,336.8124989100865,3.8048333700426995,336.1428555079869,3.294038210071345,335.76376723406173,336.3015291024335,-0.5227434390309259,0.8501723895885568,20567200,3.9563112991409293,0.8071806076028555,-100236300.0,-6.451536453395948,89.02914134005623,91.58768807638091,94.32896534031508,28.844984782337022,20.144633863952468,0.019520122080341328,6.726019928254224,339.7893525390625,337.34531396484374,335.3699951171875,333.39467626953126,330.9506376953125,0.06,0.0,277.98859978525877,0.004073141758857979,0.013337297598333332,334.0372881208147,333.1048496791295,4.353880584744171
2023-07-14,0,347.14249420166016,330.84749603271484,346.7675018310547,334.8549995422363,338.9406261444092,0.5362699485343606,3.8290594894427903,0.17870050002126758,2.995667896081051,337.1137466430664,3.0300014495849608,0.011358175202278737,332.2542495727539,341.4359962463379,0.4453749977031965,0.01596539095438295,1.0297320478226009,1.0299352115198939,1.0325368231548269,0.024525362308561283,57.31488534247768,344.7773675598182,337.1192485809326,329.46112960204704,338.2035696847098,5.472244255811714,336.9960697719029,4.393751160009382,337.1584211448875,337.0428000788823,0.762557606673934,1.3130063111808603,28302200,4.007919233505816,1.1057613698497941,-71934100.0,-25.337717139566436,89.02914134005623,91.58768807638091,172.78710793031286,34.20866258328513,18.30832334801185,-0.044487562844212854,6.872017720069783,345.6645144042969,342.09773547363284,339.2149963378906,336.3322572021484,332.76547827148437,0.02,1.0,278.1459805428142,0.023782661070445466,0.011633020707620127,335.0404706682478,333.827878679548,4.689189319598798
2023-07-17,0,345.1500015258789,330.84749603271484,347.14249420166016,334.8549995422363,339.337495803833,0.5639955526130339,4.392211644634639,-0.19625611307969315,2.9956478835748954,337.59250259399414,3.4407512664794924,0.013006936747977782,332.2542495727539,343.51625595092776,0.4711966494739988,0.011620077569900654,1.0221147343606625,1.0202339820590327,1.0215603641370856,0.03863081143766456,62.279722740111616,346.4666715955437,337.6822483062744,328.8978250170051,339.0442853655134,6.080726679182062,337.95464161464145,4.614831173253225,339.6823223791269,338.3803910840155,2.8859961937709064,3.5635706980442885,20363900,3.891777458129844,0.8255036644978374,-92298000.0,-23.33190093464015,89.02914134005623,91.58768807638091,134.97441674341982,32.46782180233193,19.61828866705651,-0.08373507531609652,6.723300599160768,345.6645144042969,342.09773547363284,339.2149963378906,336.3322572021484,332.76547827148437,0.02,0.0,278.2554658232198,0.041888947541667054,0.025235807336780536,335.6715349469866,335.0397687639509,4.442524705903773
2023-07-18,0,353.56749725341797,330.84749603271484,347.14249420166016,334.8549995422363,339.337495803833,0.5814885483614756,4.535679217331978,-0.3271342941506008,2.9956423477141794,337.59250259399414,3.540700187683103,0.013427829912053681,332.2542495727539,345.3117515563965,0.49622250093137776,-0.004664509495944139,1.0467328018717579,1.0433897900249263,1.0385817433914983,0.06867212686553481,57.64799736416394,346.8533564967977,337.78199806213377,328.71063962746985,341.14928436279297,8.182431469733027,339.4258918762207,5.983741629032322,341.04576340545833,339.07884230278523,1.7346351402456874,4.045460456148241,64872700,3.834687612332137,2.535534900554652,-27425300.0,-18.32581389800316,89.02914134005623,91.58768807638091,291.8129305098376,43.0020398057726,15.308018811667923,0.054613144778379516,8.000920938618135,357.3919190673828,351.5840392456055,346.88999938964844,342.1959595336914,336.3880797119141,0.04,0.0,278.65988347423445,0.08127045922260656,0.08335587364241645,338.8225882393973,336.80277361188615,6.516811793471761
2023-07-19,0,357.9324951171875,330.84749603271484,353.56749725341797,334.8549995422363,339.337495803833,1.19310791916942,5.373911187860655,1.3621473245940772,2.99560674896133,337.59250259399414,3.914699935913086,0.015893408953861824,332.2542495727539,345.34925079345703,0.5443408157712194,0.04351068663562188,1.0585897912909685,1.0516453690089052,1.0375546667084445,0.05966157950779638,69.96556904096153,348.8698202089733,338.12199783325195,327.3741754575306,344.8092836652483,9.233375598297147,341.02285548618863,7.633066034893041,344.14518511173816,340.8507465507586,4.34875426505964,6.18599395097175,39732900,3.8103816210671035,1.5134448888967609,12307600.0,-29.411796294776188,89.02914134005623,91.58768807638091,223.62660714345117,39.223450348696765,13.96290312060431,0.032286321866104896,8.14514008683627,357.3919190673828,351.5840392456055,346.88999938964844,342.1959595336914,336.3880797119141,0.04,0.0,278.90713918433653,0.05302488696878993,0.06800621962220744,342.11230904715404,338.1632298060826,7.475653936684753
2023-07-20,0,350.9449996948242,330.84749603271484,357.9324951171875,334.8549995422363,339.9775047302246,1.331209986315989,6.896684695622225,1.1589139647890132,2.9955272338794154,337.59250259399414,5.03158710479737,0.020339560354907617,332.2542495727539,347.784994506836,0.6510523260007463,0.0686705296798496,1.0349997596782854,1.0249337458190428,1.0055514654280888,0.02842533873443509,75.07048824423566,352.87074251441345,339.07737312316897,325.2840037319245,347.68035561697826,7.0302378796991025,342.18874904087613,7.824429297012371,347.58088492098176,343.1888948303331,7.709609213372202,6.662442146932395,33778400,3.7230424043008816,1.265757374144763,-21470800.0,-50.050287262631464,89.02914134005623,91.58768807638091,118.26940788007904,35.05238994191202,18.444988431555537,0.005826659918537826,8.463344802313388,357.3919190673828,351.5840392456055,346.88999938964844,342.1959595336914,336.3880797119141,0.04,0.0,279.0983993411469,0.012286121363158431,0.028677215027942557,344.1498107910156,338.9994550432478,7.5233723332867966
2023-07-21,0,345.76248931884766,330.84749603271484,357.9324951171875,335.05374336242676,342.22124671936035,1.0225888267888006,7.287406270053405,0.16066607306556469,2.9955040357300584,338.22125244140625,5.671449508667001,0.021441241603065413,332.2542495727539,351.2072494506836,0.7795602047985306,0.04192862833780141,1.0173135401038107,1.0063653850843557,0.9852256868169279,-0.00397532686393276,62.453834904204484,354.45281051068787,339.8779979705811,325.3031854304743,348.8207103184291,5.6730929636687835,342.6321405683245,7.8395677982225385,348.40787556659575,344.18739105985276,6.074552143541717,4.877887845816515,69368900,4.141941110228911,2.39393627756159,-90839700.0,-57.84316357898015,89.02914134005623,91.58768807638091,48.38294413079847,32.00659398381635,21.440020130895416,-0.05997510708800058,8.60667740362695,357.3919190673828,351.5840392456055,346.88999938964844,342.1959595336914,336.3880797119141,0.04,0.0,279.45813141683186,-0.004257811237987075,0.0032393422044701575,345.0794198172433,339.22796630859375,7.568140538933611
2023-07-24,0,345.04750061035156,330.84749603271484,357.9324951171875,335.05374336242676,345.3031234741211,0.8392965959701886,7.360097705007726,-0.16945154119332972,2.995499781461448,338.747501373291,5.946998825073246,0.021626673780966,332.2542495727539,351.2072494506836,0.8077707355821664,0.03151871653323548,1.0138764502488227,1.0022627778871493,0.9839622095707911,-0.0002969749821069012,55.69880680323795,355.04519312119714,340.32499771118165,325.60480230116616,349.3639253888811,4.964607655663141,343.0882121494838,7.776337827887457,347.7322704100937,344.22514381117276,2.363219479751556,1.8281224659403281,26678100,4.321294024454903,0.9149938315831858,-117517800.0,-54.47464578357989,89.02914134005623,91.58768807638091,44.248171644572615,30.740028050925467,20.59159498725103,-0.03775545257495247,8.321201579735053,357.3919190673828,351.5840392456055,346.88999938964844,342.1959595336914,336.3880797119141,0.04,0.0,279.59573799999635,-0.001793289237537521,-0.0003764452041969803,345.4260777064732,339.73168291364397,7.539364350425731
2023-07-25,0,348.7625045776367,330.84749603271484,357.9324951171875,335.33687591552734,345.3031234741211,0.6782890640834484,7.330008110688992,-0.3354475545521347,2.995502073119832,339.0487480163574,6.0252488708496115,0.02150713550023535,332.2542495727539,351.2072494506836,0.7907852966615291,0.04014561557390973,1.023311615769499,1.009320161000976,0.9946143263795533,-0.013590029380832203,55.880035043738374,355.4775142377355,340.81749801635743,326.1574817949794,349.59535544259205,4.880847030866844,343.89946256365096,7.730128316384226,347.05709650605456,344.0748596377964,1.1143036667419073,1.8853584807880281,41637700,4.229133837277748,1.3804484351318336,-75880100.0,-39.71842201561782,89.02914134005623,91.58768807638091,84.57127775446104,33.23884397081615,19.3703761353445,0.048750881310532464,8.21397341862674,357.3919190673828,351.5840392456055,346.88999938964844,342.1959595336914,336.3880797119141,0.04,0.0,279.8242080983684,-0.02367230681569621,0.01518529734539364,346.2382550920759,340.63936288016185,7.30522134136682
2023-07-26,0,339.24749755859375,330.84749603271484,357.9324951171875,336.94750022888184,346.1074905395508,0.522721522905553,7.213236068431379,-0.541726576498164,2.995510200056072,339.4099998474121,6.095699462890627,0.02111175863773909,332.90424423217775,351.2072494506836,0.7658044733669407,0.04742923173345177,0.9929123654026638,0.9767197783639391,0.9701378353142263,-0.05220257398668504,59.51290885386487,356.0955955957251,341.6691234588623,327.2426513219995,348.7521405901228,6.127477985312604,343.8982129778181,7.730936485024002,347.4883739400176,344.6453762799177,0.4666701435392334,3.3661344198901473,58383700,4.281524415491964,1.8322821184144766,-134263800.0,-72.92612030124793,89.02914134005623,91.58768807638091,-40.5755918138715,28.47373375760452,26.188199037110646,0.007808850121551319,8.903691434065268,357.3919190673828,351.5840392456055,346.88999938964844,342.1959595336914,336.3880797119141,0.02,1.0,280.09267021792243,-0.048749594114217976,-0.06041884226210271,345.1119689941406,340.39175197056363,7.173684737915989
2023-07-27,0,335.3949966430664,330.84749603271484,357.9324951171875,337.6862545013428,346.1074905395508,0.5420152395365708,6.960009160639481,-0.3952329826956258,2.995525898113686,339.4099998474121,5.844599304199221,0.0203519157033171,334.3914909362793,351.2072494506836,0.7451996831915447,0.010943881191566472,0.9807358785669829,0.9652203227621533,0.9694813984579481,-0.04430894603222679,47.00936634419919,355.90301697850555,341.9829986572266,328.0629803359476,346.15606907435824,7.453460518285389,343.6526767185756,7.955526268647356,345.43636594722534,343.66697337525756,-1.7101271740375739,-0.005156500695632857,39635300,4.8366119799729725,1.207189231837818,-173899100.0,-90.64856376355857,89.02914134005623,91.58768807638091,-93.7728068578986,25.742632356842023,26.847497877553682,-0.03569805083393749,9.144856244438966,357.3919190673828,351.5840392456055,346.88999938964844,342.1959595336914,336.3880797119141,0.04,0.0,280.25861702485247,-0.046559161180061315,-0.06860428570263319,341.0412118094308,339.93190002441406,7.4844941391923205
2023-07-28,0,336.3050079345703,330.84749603271484,357.9324951171875,337.6862545013428,346.1074905395508,0.5405646138313422,6.968401224798283,-0.40078530710892535,2.99552538813126,339.4099998474121,5.851799621582029,0.020376991409417382,334.3914909362793,351.2072494506836,0.7135236686169687,0.002308591732822972,0.9834227445514457,0.9694713612039543,0.9809300763025801,-0.0273525372949176,43.43395839653602,355.91080071009463,341.97399826049804,328.03719581090144,343.0664280482701,6.121852466544643,343.9378558567592,7.580466929619663,342.946963933309,342.19513097142635,-5.139754290628842,-1.0145153094965096,28484900,4.915477257490703,0.8526598080468499,-145414200.0,-71.41780928584416,89.02914134005623,91.58768807638091,-56.444308720797075,23.876802471724254,24.9015871724559,-0.022881511310524138,9.155224265902032,357.3919190673828,351.5840392456055,346.88999938964844,342.1959595336914,336.3880797119141,0.04,0.0,280.3849780518776,-0.015708100036658235,-0.024504695444548273,338.67686244419644,340.3945857456752,7.366063590972877
2023-07-31,0,335.9750061035156,330.84749603271484,357.9324951171875,337.6862545013428,346.1074905395508,0.5557742187822877,6.888844408983958,-0.34857959613668443,2.9955301966908694,339.4099998474121,5.784498901367192,0.020139397144522182,335.0867469787598,351.2072494506836,0.7497848665750025,-0.009571350514807458,0.982216127530443,0.9715553330421347,0.9854040960666035,-0.02629346536574728,43.05175207955281,355.8358129787345,342.0581241607666,328.28043534279874,340.927857535226,5.493396837213684,344.30410657610213,7.001080833818853,341.31160888301343,341.34322704269937,-6.042336886885982,1.2014317651518713,25446000,4.7851210791677286,0.7632681048958223,-170860200.0,-81.79161506935407,89.02914134005623,91.58768807638091,-69.37529044564745,22.912317954702882,23.895707289438324,-0.024435727938209018,8.859137515882232,357.87571618652345,352.36713458251955,347.9149932861328,343.46285198974607,337.9542703857422,0.04,0.0,280.4943700763584,-0.026629109154866715,-0.022834945608674648,337.1275198800223,340.63866533551897,7.48101630769087
2023-08-01,0,335.9425048828125,330.84749603271484,357.9324951171875,337.13000106811523,346.1074905395508,0.5765459541947281,6.997218946213126,-0.4262547662805267,2.9955236125363407,339.2562446594238,5.9276989746093705,0.02046693832290424,335.0867469787598,351.2072494506836,0.7548441036088182,-0.007935606637033164,0.982635327025117,0.9740456644306549,0.9905805097747593,-0.03675853776296756,42.93411296794671,355.8735619616401,341.87912406921384,327.88468617678757,339.5250026157924,5.303591801435484,344.17285646711076,7.148469736991729,339.96500254843147,340.61343499284925,-4.265623845424852,1.5498107533791832,18311900,4.782305117956533,0.5445370844506932,-189172100.0,-80.67848814684022,89.02914134005623,91.58768807638091,-61.0024891714759,22.68820185004887,22.931985036161908,-0.01534984366976178,8.572056003168536,357.87571618652345,352.36713458251955,347.9149932861328,343.46285198974607,337.9542703857422,0.04,0.0,280.5735836610066,-0.04171181882857444,-0.02541221006017535,336.0762241908482,340.57782200404574,7.531925604607962
2023-08-02,0,330.2799987792969,330.84749603271484,357.9324951171875,336.22250747680664,346.1074905395508,0.5883993127494278,7.084307688523217,-0.4849951911672412,2.9955182442628074,339.2562446594238,6.036498718261714,0.02072992017374382,335.0867469787598,351.2072494506836,0.7580046673909732,-0.004334535355953693,0.9664568946900552,0.96254642475057,0.9813027075964394,-0.02643350015499535,43.24762064598899,355.91173976669484,341.7431243896484,327.574509012602,337.4153594970703,5.665487169341299,343.38964244297574,8.039131403004133,338.93962567792556,340.0474371741243,-2.8400953658624255,-0.5439935730404515,27761300,4.775076290385732,0.8139275957936338,-216933400.0,-97.17957874884011,89.02914134005623,91.58768807638091,-125.49074437109739,20.82331480451386,27.092376980415942,-0.04275918447623096,8.672624216251366,357.24087561035157,351.33955364990237,346.5699920654297,341.80043048095706,335.8991085205078,0.06,0.0,280.6781202155332,-0.030405261485668356,-0.06689838533762112,333.5845293317522,339.5053035191127,8.130056339020642
2023-08-03,0,327.1225051879883,330.2799987792969,357.9324951171875,335.96688079833984,346.1074905395508,0.47530883510074523,7.462552988793088,-0.6076719367334351,2.9954941368372534,339.2562446594238,6.321498718261717,0.021859519356551362,332.1659996032715,351.2072494506836,0.7352258160500807,-0.026483702118332314,0.9582164099684183,0.9610897220314459,0.9771282363016466,-0.024664922070623096,36.51211594586976,356.3119803672346,341.3868743896484,326.46176841206227,334.3239310128348,4.140714653140369,341.95964322771346,9.03866280044871,336.74641388256714,338.7682820475852,-4.279846051611034,-3.2132328663531364,18253700,4.908069295535376,0.5430636564725273,-235187100.0,-98.26110289352778,89.02914134005623,91.58768807638091,-125.42536428727283,20.12191261314665,26.53119395481033,-0.08338288837100571,8.33386482050349,357.1441219482422,351.1829439086914,346.36500549316406,341.5470670776367,335.58588903808595,0.08,0.0,280.74425633799615,-0.012276157885959704,-0.032892130439934615,330.14341517857144,338.19083513532365,8.733635958619496
2023-08-04,0,330.51000213623047,327.1225051879883,357.9324951171875,335.805627822876,346.1074905395508,0.32617204098738356,8.078959667034349,-0.7085940105090103,2.9954519207260457,339.04000091552734,6.853722686767577,0.023707276226323223,330.79074630737307,351.2072494506836,0.7464219080901289,-0.03455984575510633,0.9698639724837954,0.9778865301381331,0.9921500865877007,-0.01723139906220872,33.75222541357365,356.93766939510385,340.77975006103514,324.62183072696644,333.0757173810686,3.7029580986912225,340.9139289855957,9.477394834550541,334.3191527595069,337.4778200307561,-6.2047952705968825,-5.767081054053259,23727700,4.94447249138707,0.703260296441241,-211459400.0,-95.51803288245833,89.02914134005623,91.58768807638091,-91.7784436608422,23.16391025846123,24.605288050807303,-0.08491317849359507,8.344303832348107,357.1441219482422,351.1829439086914,346.36500549316406,341.5470670776367,335.58588903808595,0.08,0.0,280.8346328603858,-0.031297268320746974,-0.00888977292736713,328.72989327566967,336.9209311349051,9.148505427806448
2023-08-07,0,329.2774887084961,327.1225051879883,357.9324951171875,334.6243724822998,346.1074905395508,0.35019763480379784,8.377363965529035,-0.8504959255065381,2.9954301794334226,338.5137519836426,7.228235282897947,0.02461298256138778,330.4870018005371,351.2072494506836,0.7853367628943838,-0.0054241049126034415,0.9674285516050121,0.9786563325198063,0.991901234819857,-0.019934570350021774,40.835629798957775,357.11835288528164,340.3636249542236,323.6088970231656,332.20178767613004,3.78533584889937,339.17892837524414,9.202106530625429,333.3306161758211,336.92516584639156,-2.575551915708433,-4.241633876554032,17741500,4.8151028455302125,0.5378318629341947,-229200900.0,-88.60592848802074,89.02914134005623,91.58768807638091,-94.03965314366678,22.42186188560804,23.817065606584343,-0.0804045527627926,8.00471043988685,353.8436363525391,348.5131793823242,344.2050018310547,339.89682427978516,334.5663673095703,0.08,0.0,280.9013445421861,-0.017296014854795372,-0.02441136300039711,328.6435764857701,334.84239414760043,9.23412677527028
2023-08-08,0,326.1899948120117,327.1225051879883,357.9324951171875,334.2581214904785,346.1074905395508,0.31565055935929004,8.547589658413127,-0.8940239368439977,2.995417423221062,338.5137519836426,7.364810791015623,0.02512431311737073,330.1797477722168,351.2072494506836,0.778502635639669,-0.00474541093115453,0.9587848613373874,0.9740452968645382,0.9865815198486143,-0.029030295151852736,39.879900415081295,357.3070537064747,340.2118743896484,323.11669507282215,330.75678580147877,3.8871932668131155,336.91160692487443,8.066405250019153,332.30460508648343,336.44146702269853,-1.8239711372560152,-6.86997779309791,22327600,4.811899792823196,0.6813729446943708,-251528500.0,-91.27827370173759,89.02914134005623,91.58768807638091,-120.95421509653158,20.987865676634815,26.359629330058826,-0.11418250968446157,7.9408015050065375,349.7170809326172,344.61146075439456,340.48500061035156,336.35854046630857,331.25292028808593,0.1,0.0,280.9787718390055,-0.030593988549618367,-0.02938204630969981,326.90037754603793,332.7886199951172,9.599088453520622
2023-08-09,0,324.2149963378906,326.1899948120117,357.9324951171875,334.1737480163574,346.1074905395508,0.2232869844527164,8.857377400701399,-0.9026536792868365,2.995393479733428,338.5137519836426,7.574398345947264,0.02605271919204671,329.06199035644534,351.2072494506836,0.8099157911959592,-0.034312307942396515,0.9536324213499857,0.9747177254537065,0.9864273582035806,-0.018363214435697883,33.64036947953966,357.69375413001603,339.97899932861327,322.2642445272105,329.0767844063895,3.796269713243729,335.0023209708078,7.641497061079139,330.80771937582404,335.67970778317897,-3.0076903060945543,-8.868292412172092,22373300,4.556464175077272,0.6908016362513314,-273901800.0,-96.17372838587485,89.02914134005623,91.58768807638091,-125.22236964772493,19.82411849634386,26.68227364092854,-0.11400326342645348,7.806458365977049,344.6117683105469,340.10912438964846,336.4700012207031,332.8308780517578,328.32823413085936,0.12000000000000001,0.0,281.0518427453214,-0.01609163176629369,-0.04195157039668859,324.9633309500558,331.04542541503906,10.326655170858755
2023-08-10,0,324.59749603271484,324.2149963378906,357.9324951171875,330.45250129699707,346.1074905395508,0.16771542990907926,9.49613193328662,-1.0156914106772301,2.9953411395131884,337.77625274658203,8.184823799133301,0.027987359197318946,327.0292541503906,351.2072494506836,0.8267868547775629,-0.049905490257662465,0.9566660172626419,0.9802979901867768,0.9912493887057757,-0.00771884879587359,30.09700917781839,358.2930126916465,339.30074882507324,320.3084849585,327.45606885637557,2.6143468537383487,333.490535736084,7.439936104561496,329.1980211380563,334.5678955861148,-3.5002632791088275,-7.616579059447363,20113700,4.4613314065407765,0.621468961466434,-253788100.0,-93.90401022793168,89.02914134005623,91.58768807638091,-106.88237930628407,19.590591157822704,24.94218488774074,-0.14702902289476902,7.754569703396098,344.6117683105469,340.10912438964846,336.4700012207031,332.8308780517578,328.32823413085936,0.12000000000000001,0.0,281.11833854499895,-0.011418623794462124,-0.013954190702568852,323.065909249442,329.5710667201451,10.849158992154576
2023-08-11,0,320.7225036621094,324.2149963378906,357.9324951171875,330.0293712615967,346.1074905395508,0.23450339024593014,10.005196204050515,-1.1201619024735574,2.995296261711019,336.14000701904297,8.734211502075198,0.029560209982478974,326.030744934082,351.2072494506836,0.8435531875919825,-0.06494450706990829,0.9475700786877311,0.9717641677581205,0.9809287675262006,-0.0296133200534332,27.71345037248187,358.47876627895073,338.46837387084963,318.45798146274853,326.09071241106307,3.2996411240839105,331.75303595406666,7.373439700194702,328.0832054503758,333.691571467004,-3.3770686010855218,-6.121251998106522,24342600,4.180435187049854,0.756761865265387,-278130700.0,-94.49199194291685,89.02914134005623,91.58768807638091,-118.9597057937406,18.893399574529536,25.939178618673896,-0.11070347735150941,7.466386240346594,344.1775291748047,339.4062457885742,335.5500030517578,331.6937603149414,326.9224769287109,0.14,0.0,281.1924860867727,-0.020653965148642817,-0.01729630327973459,322.14761788504467,327.86607360839844,11.301188697163989
2023-08-14,0,322.3925018310547,320.7225036621094,357.9324951171875,328.73874282836914,345.3031234741211,0.3126665988447223,10.504412816948676,-1.0066846370032472,2.9952483239037377,335.95875549316406,8.92359909057617,0.031156739207569045,324.5592460632324,351.2072494506836,0.8405739172635368,-0.07077357020361476,0.9562361340006515,0.9814579652403086,0.9919754150765762,-0.020909376175231253,24.803089795997245,358.1561999777694,337.14737434387206,316.1385487099747,325.41499764578685,3.5294433304691175,329.8694643293108,5.918723591964194,326.25210017644656,332.27549556745004,-2.893755344711052,-7.049753122458186,18836100,4.220478164546444,0.586969934933812,-259294600.0,-81.02901444849054,89.02914134005623,91.58768807638091,-95.69283302805361,19.78216399397233,24.917453382188416,-0.09694998111449844,7.2173594364881275,338.6614482421875,334.9442850341797,331.94000244140625,328.9357198486328,325.218556640625,0.14,0.0,281.25233716776347,-0.018387643342386184,-0.01140997152606689,321.7769034249442,325.9601593017578,11.409058166771482
2023-08-15,0,322.7124938964844,320.7225036621094,357.9324951171875,326.88937759399414,345.2262477874756,0.45680726115360865,10.804218629810338,-0.9342628703605769,2.995217667910386,335.66875076293945,8.949399719238283,0.03215450351974324,324.03274688720705,351.2072494506836,0.8296336659887409,-0.08817268460629665,0.9604266977927475,0.9865112560921139,0.9971849861249401,-0.01066096744485212,23.813459534517566,357.6179366187515,336.00949935913087,314.4010620995102,324.3010678972517,2.810705744785081,328.68839263916016,5.541122145863444,325.32862731016746,331.16154771734114,-1.4459425083625448,-7.5610200065849975,16966300,3.6319108228859562,0.5713505402241719,-242328300.0,-88.01991644914379,89.02914134005623,91.58768807638091,-89.53997433858663,19.98736140219191,23.8522748749578,-0.16476538744035957,7.001119651125133,336.1096677246094,332.8801484375,330.2699890136719,327.65982958984375,324.43031030273437,0.14,0.0,281.3059569570089,-0.012850872778835343,-0.024991573928544862,320.9392656598772,324.83457946777344,10.30317967626282
2023-08-16,0,321.35499572753906,320.7225036621094,357.9324951171875,325.7918701171875,340.6974983215332,0.6170507222160967,10.381590212064951,-0.6175022254885252,2.99525345232078,332.95249938964844,8.664751052856445,0.031039229571151294,322.6804946899414,348.98075408935546,0.7746213155877423,-0.0983984457995971,0.9607980359917738,0.9863505981046832,0.9951289369997678,-0.008821308831041597,21.68015094603576,355.22992961541405,334.4667491912842,313.7035687671543,323.16928318568637,1.929957745990094,327.6855354309082,5.504351475361452,324.69225069915626,329.9572590650081,-2.3592351787683863,-4.874023767633983,20698900,3.3836975357366015,0.7201275563277527,-263027200.0,-94.27883945273814,89.02914134005623,91.58768807638091,-91.92939811687202,19.021788897059245,23.850209607185956,-0.16417877579496595,6.83104150709945,335.10120544433596,332.0644027709961,329.61000061035156,327.15559844970704,324.11879577636716,0.14,0.0,281.3694851794351,-0.0035739058212324037,-0.0152480555433493,319.66135951450894,324.1524680001395,9.342698864264195
2023-08-17,0,318.875,320.7225036621094,350.9449996948242,324.5018711090088,337.0406303405762,0.5146566025577829,9.246430339811829,-0.9148258836471288,2.995347669420539,330.3950004577637,7.964163932800295,0.02779728664826165,322.28875122070315,346.06249084472654,0.7958110434356603,-0.08431521746432095,0.9586250535841726,0.9814271424089025,0.9892013852725117,-0.017629513790636597,21.992132427124236,351.1307349014254,332.6378742218018,314.14501354217816,322.12428392682756,2.0008509273216952,326.44053486415316,5.374457866877195,323.84304410376313,328.5833864136072,-2.406023263852903,-4.186109231220576,21257200,3.1602856194964635,0.7560179988704471,-284284400.0,-96.99949433518744,89.02914134005623,91.58768807638091,-112.93904343826063,17.88205402042777,26.22157269979235,-0.15092051835087744,6.747395946743016,333.27012451171873,330.00994201660154,327.375,324.74005798339846,321.47987548828127,0.16,0.0,281.42930548610525,-0.016657212822180134,-0.014521000425892994,318.4587925502232,322.6795850481306,9.164635133890926
2023-08-18,0,315.2249984741211,318.875,348.7625045776367,323.83937072753906,336.0575065612793,0.5133668954812178,8.697042889162672,-0.8305085525878955,2.9953886229170115,329.7787437438965,7.416251373291016,0.026272325673751755,321.29174652099607,345.1189994812012,0.8083308957767245,-0.07776288680653598,0.9522424950599903,0.9726622467927021,0.9813627452083227,-0.017141002346938716,20.877205132959855,348.42846001538595,331.03437423706055,313.64028845873514,320.8399985177176,3.046959273548182,324.95839146205356,5.403915912895416,322.592344689374,327.1972328655012,-2.2425564635198154,-5.182797616252388,24744800,3.0529182552208187,0.9559101471966728,-309029200.0,-81.73390365769684,89.02914134005623,91.58768807638091,-130.26492239679365,16.59025402685491,29.256138706537268,-0.10957992817981331,6.753297456964497,332.17036364746093,328.2298206176758,325.0449981689453,321.86017572021484,317.9196326904297,0.18,0.0,281.4933359746697,-0.012024363361431312,-0.017898441379882824,317.7400163922991,321.3516736711775,9.053497975437006
2023-08-21,0,319.9049987792969,315.2249984741211,348.7625045776367,322.63249588012695,335.9506301879883,0.504360626199585,8.657837983918284,-0.48555723027627273,2.995388510158524,328.1999969482422,7.189752197265625,0.02627508627857273,320.5377532958984,339.82749786376957,0.775398704917112,-0.08643013522334664,0.9708580201530442,0.9917805089995025,0.9993533538016526,-0.007715759633458719,18.051924014775985,346.82317566266073,329.5074996948242,312.1918237269877,320.16964176722934,2.5597380924984794,323.8128553118025,4.524671517885774,320.7467897256574,325.54818821650326,-2.7728507210691538,-6.176056924603894,24040000,3.0876404745854686,0.9334396201630724,-284989200.0,-56.210235990261296,89.02914134005623,91.58768807638091,-76.0988201503336,20.14718387844703,27.300197964185532,-0.0890896509015399,6.720203211991586,329.57276831054685,326.12862438964845,323.3450012207031,320.5613780517578,317.1172341308594,0.18,0.0,281.56460312260845,-0.004562712696008386,0.004833165377780973,317.6878749302455,320.37689208984375,8.338379375541711
2023-08-22,0,323.87499237060547,315.2249984741211,348.7625045776367,322.1331253051758,335.53187370300293,0.6465276372319505,8.118720024047656,-0.06545844375391408,2.995427946049286,326.65625,6.74416358947754,0.02473331533546631,319.8019989013672,336.59925689697263,0.724472541080314,-0.08274256956976286,0.98667059485323,1.0070144936388261,1.013330105580636,0.0036022729088820427,29.24273354163579,344.48781465136676,328.2503746032715,312.01293455517623,320.6199972970145,2.924544999078212,323.3553548540388,4.126780301163578,320.5411316397598,324.7808911402231,-1.4456356905923364,-4.773884182684778,16102000,3.180685246376413,0.6578306337370046,-268887200.0,-53.751626782992965,89.02914134005623,91.58768807638091,-41.48979053016282,22.733757527603956,25.928995902791854,-0.17474518186197532,6.570188348077006,329.57276831054685,326.12862438964845,323.3450012207031,320.5613780517578,317.1172341308594,0.02,1.0,281.61557284023434,0.003985346759439512,-0.0027691011593863894,317.98963710239957,320.0686274937221,6.425030496863373
2023-08-23,0,325.87000274658203,315.2249984741211,339.24749755859375,322.1331253051758,331.73125076293945,0.2630372846138268,6.654695248399313,-1.017330424596264,2.9955255458984977,325.3937454223633,5.7001016998291,0.02035037665637258,319.8019989013672,336.0080062866211,0.8188264286746297,-0.045313540405211655,0.9965260690940337,1.0139473534823953,1.0188308964331014,0.014049904557485116,42.03212670201318,340.31538948971854,327.0059989929199,313.69660849612126,321.11678314208984,3.5121454121383384,323.2658903939383,4.051724053109833,321.36228545410836,324.3908095734166,0.9829334307695894,-1.9392656026293091,21166400,2.7988303419836833,0.9358806113750279,-247720800.0,-34.50616948556141,89.02914134005623,91.58768807638091,4.385190320627002,24.456734320482475,24.03255219560373,-0.15318820851742562,6.582319234068158,329.57276831054685,326.12862438964845,323.3450012207031,320.5613780517578,317.1172341308594,0.04,0.0,281.687541528314,0.02059919486788253,0.018120782303915454,318.5064174107143,320.14166041782926,5.880020163554115
2023-08-24,0,326.44000244140625,315.2249984741211,336.3050079345703,322.1331253051758,330.3374996185303,0.2689262081174351,6.0340190128445785,-0.8684054531277701,2.995561593563764,325.23374938964844,5.011051635742183,0.018490139688119453,319.8019989013672,335.9457550048828,0.840237136743905,-0.028399332106379186,1.0003152512584115,1.0151981294355867,1.0177396850954132,0.023724037448549673,47.91542770294051,338.4051622780085,326.3371242523193,314.2690862266301,321.64928436279297,4.037665588402107,322.9751761300223,3.6143805387196646,322.4822127652428,324.491924400256,1.0786544028712182,-0.3828848280207659,23281400,2.7685871868757785,1.0680097335342917,-224439400.0,-60.7092659127708,89.02914134005623,91.58768807638091,-21.078322731129,25.060980359045352,20.85876417673582,-0.1460683428357613,7.042154969581151,327.9225255126953,324.79374212646485,322.26499938964844,319.736256652832,316.6074732666016,0.06,0.0,281.76247924561625,0.009751250828994085,-0.0013422387279104471,318.3348475864955,319.63705662318637,5.888794149614917
2023-08-25,0,322.1524963378906,315.2249984741211,336.3050079345703,322.1331253051758,329.5281162261963,0.35806057558214843,5.666319989925298,-0.5097059756964613,2.99558141015105,325.23374938964844,4.503814010620118,0.017387249884671906,319.8019989013672,335.9457550048828,0.7985677789319271,-0.029333507561336538,0.9885332922879282,1.001290641187088,0.9996571042134298,0.021976359417250624,48.643492657040184,337.2220145220869,325.88937454223634,314.55673456238577,321.76321302141463,4.039228860786304,322.4662481035505,3.1275482744915344,323.47345688589405,324.74104425291,1.1550555418277477,-1.2314301136177523,21684100,2.7604939827348822,1.010498011890213,-246123500.0,-46.66350525975515,89.02914134005623,91.58768807638091,-43.422831606710176,23.385276547027267,20.64641581288264,-0.16906274591310164,7.007715154510622,327.9225255126953,324.79374212646485,322.26499938964844,319.736256652832,316.6074732666016,0.06,0.0,281.8288940412821,0.0205384043533392,0.019250225471841367,318.70067051478793,319.18101501464844,5.078275548570618
2023-08-28,0,324.30750274658203,315.2249984741211,335.9750061035156,321.95312118530273,327.66125106811523,0.45530507916381635,5.184630194577257,-0.11155275805569254,2.995605463425119,324.40624618530273,4.097176513671878,0.015943792082798305,319.8019989013672,331.05325241088866,0.7267033636174886,-0.04114148229635336,0.9973115151185148,1.007540861855306,1.0020361726206315,0.013761910517448461,41.143285343244614,335.5510093515569,325.18174896240237,314.81248857324783,322.5392848423549,3.9116885141111783,322.33178438459123,2.9926969949715785,323.1445933954242,324.3661305973212,0.24816810721925844,-2.163826139026803,14808500,2.884862082921755,0.7076282019118887,-231315000.0,-43.30372718482411,89.02914134005623,91.58768807638091,-11.19538422497039,23.127811093781876,19.68898680126391,-0.18804019437488723,6.8235921203156655,327.9225255126953,324.79374212646485,322.26499938964844,319.736256652832,316.6074732666016,0.06,0.0,281.8757724503989,0.00565433333476606,0.022813508315622535,319.6677028111049,319.06324768066406,4.366333314423366
2023-08-29,0,325.2875061035156,315.2249984741211,335.9425048828125,321.95312118530273,326.61062812805176,0.3921124692683697,4.555607424333909,0.3724752605138262,2.995633958430138,324.2612495422363,3.484550933837886,0.014034597188762373,319.8019989013672,330.30299911499026,0.6366900843250056,-0.03463390897882699,1.0021230306883673,1.0099846005367406,1.0023372542252666,0.00436129298706045,45.77048037973092,333.70958864322347,324.59837379455564,315.4871589458878,323.9767859322684,2.2875354834342803,322.408392224993,3.0576348314188135,323.4342622513791,324.36393312680866,1.703646490500049,-0.5771152075080036,19284600,2.9531439586346724,0.919383178109216,-212030400.0,-21.32525608108012,89.02914134005623,91.58768807638091,58.77604107161848,24.367746343716984,18.22988299005262,-0.1529840665200399,6.84333597625852,327.9225255126953,324.79374212646485,322.26499938964844,319.736256652832,316.6074732666016,0.06,0.0,281.9403868987352,0.01845199228654515,0.020287072473071134,321.35929216657365,319.54965427943637,3.546406165351099
2023-08-30,0,328.4300079345703,315.2249984741211,330.51000213623047,321.95312118530273,326.25249671936035,-0.2519925232401057,3.7495354601289006,-0.10510029390838893,2.995665268267373,324.2612495422363,2.9375633621215798,0.011570296829137783,319.8019989013672,329.3777397155762,0.6766613756363965,-0.015115940093960655,1.0134675934678103,1.0189271013099275,1.011140325500349,0.007855909308654985,50.41116079175348,331.5646947758486,324.06562385559084,316.5665529353331,325.19464438302174,2.0110690634589483,322.68214307512557,3.418920508801459,323.88567335631996,324.2871706222114,3.1921667628212007,0.33080202265142944,15222100,2.718451811270364,0.748065286966564,-196808300.0,-19.552020096294743,89.02914134005623,91.58768807638091,107.01598479957235,24.379914299321456,17.566430702105514,-0.09618255974648289,6.59452521735166,327.9225255126953,324.79374212646485,322.26499938964844,319.736256652832,316.6074732666016,0.06,0.0,281.99346075526086,0.005474030980017863,0.019630426192793655,322.3390808105469,320.01347787039623,3.676623253301158
2023-08-31,0,328.6625061035156,315.2249984741211,330.51000213623047,321.95312118530273,326.25249671936035,-0.37024397360030875,3.6155123615157607,-0.023442024278403917,2.9956699120666457,324.2612495422363,2.8543137741088858,0.011159914481112178,319.8019989013672,328.5147560119629,0.6721803241266303,0.0039969819436013595,1.0144746012500268,1.0174152176067905,1.0102636389894184,0.006808306719420232,57.99271645641997,331.204149036386,323.9731243133545,316.742099590323,325.87857491629467,2.2831502113747417,323.24928610665455,3.714614226360764,325.02931263885824,324.6421710732389,2.6648565004621445,1.1806966931960576,26411000,2.7293438668505496,1.2724213005185365,-170397300.0,-24.358355441820855,89.02914134005623,91.58768807638091,106.94259702557223,24.483537337504394,16.75905937992591,-0.09963682346206541,6.418488050598861,327.9225255126953,324.79374212646485,322.26499938964844,319.736256652832,316.6074732666016,0.06,0.0,282.08552276282455,0.024346228949664317,0.002324239441325013,323.09058925083707,320.5401131766183,3.765129575028115
2023-09-01,0,329.68499755859375,315.2249984741211,330.51000213623047,321.95312118530273,326.25249671936035,-0.33760217914977664,3.697240283406394,-0.14943858874543858,2.9956670979228983,324.2612495422363,2.9236138153076183,0.01140947034264644,319.8019989013672,328.7240043640137,0.6466425024176757,-0.005589833955927718,1.0173888938034106,1.0174976077694489,1.0120238748653783,0.023381787527117615,56.91602227971921,331.4446049259436,324.05012435913085,316.6556437923181,326.4235741751535,2.698340843025005,323.77017865862166,4.078690975403013,325.94352271222897,324.99822639260015,1.4781980225975193,2.4756611559041946,14931200,2.6160063322743277,0.7349237682464125,-155466100.0,-20.15866844958624,89.02914134005623,91.58768807638091,125.80299618888073,24.262891100280665,15.774127342517742,-0.06160906180003607,6.332166865204522,327.9225255126953,324.79374212646485,322.26499938964844,319.736256652832,316.6074732666016,0.06,0.0,282.1381460144632,0.01758626562309451,0.027158946148251366,323.32596697126115,320.9161921909877,3.86077502159379
2023-09-05,0,331.51499938964844,315.2249984741211,329.68499755859375,321.95312118530273,326.25249671936035,-0.4177795367101175,3.6289079467255956,-0.15976184785350567,2.9956694516768243,324.2612495422363,2.886488609313966,0.011200026408124869,319.8019989013672,328.7240043640137,0.6398560928159517,0.0012375849065661975,1.023166418757969,1.018599736229892,1.012956998627474,0.02222426734511429,59.658729453968576,331.2666900237002,324.008874130249,316.7510582367978,327.14857373918807,3.314846152355923,324.3989290509905,4.553893796807891,326.86847852445715,325.32059973060024,1.1707106453055485,2.261992970097237,18553900,2.612959574461696,0.9114132852195173,-136912200.0,-5.579473342981945,89.02914134005623,91.58768807638091,189.13475119983707,25.797373500898725,14.670931051171213,-0.054356225478105896,6.322012263504646,329.35120178222655,325.9493991088867,323.1999969482422,320.45059478759765,317.0487921142578,0.08,0.0,282.20782767510264,0.030429392003916478,0.03272654611649169,325.2515215192522,321.79318455287387,4.279163460594014
2023-09-06,0,332.7249984741211,315.2249984741211,331.51499938964844,321.95312118530273,326.25249671936035,-0.19799047017180346,3.8191147655538344,-0.10166709391843431,2.9956627953487707,324.2612495422363,2.9871765899658214,0.011782999914412482,319.8019989013672,328.76475524902344,0.6871831473500929,0.016324855643428303,1.0265464300533858,1.018683639599758,1.0121959229683588,0.02286436531084801,65.11230017972039,331.75897919541427,324.12074966430663,316.482520133199,328.65893118722096,3.0576869297328395,325.2110721043178,4.964622276112114,328.02071828613873,325.9773417326377,1.5546492189336123,2.7276618227206346,17535800,2.5345634053501938,0.8716604958967715,-119376400.0,-8.454934216988978,89.02914134005623,91.58768807638091,163.26243525055818,24.520426202843446,13.944732868046263,-0.04697597353918047,6.176154157489804,329.35120178222655,325.9493991088867,323.1999969482422,320.45059478759765,317.0487921142578,0.08,0.0,282.2737090269387,0.013610967192158707,0.028359479060511044,326.65526907784596,322.677969796317,4.736270299160584
2023-09-07,0,330.82749938964844,315.2249984741211,332.7249984741211,321.95312118530273,326.93750381469727,0.03586881719108359,4.238683523843988,-0.2904258332571379,2.995646942165674,324.2612495422363,3.3185018157959005,0.01306431248765191,319.8019989013672,329.86799774169924,0.7360590544048079,0.026248021320276958,1.0196641969663407,1.0101371644493558,1.00188973615962,0.0072998550593943445,68.62567463072071,332.9248668951,324.44749984741213,315.97013279972424,329.59035927908764,2.442387721878795,326.06482206072127,4.816726995869213,329.1974671146956,326.71601835395074,3.281831510360692,3.5381440767213377,18381000,2.484695449179025,0.9228299113167534,-137757400.0,-21.201710554751504,89.02914134005623,91.58768807638091,108.11858564119211,23.34296074863868,14.63863134348637,-0.03924578639477781,6.024285131452585,329.35120178222655,325.9493991088867,323.1999969482422,320.45059478759765,317.0487921142578,0.08,0.0,282.3400671716811,0.0034063603909841866,0.004567385246142603,327.5357971191406,323.6017499651228,4.871396233132216
2023-09-08,0,332.4949951171875,315.2249984741211,332.7249984741211,321.95312118530273,328.48813247680664,-0.04562736970495812,4.459780469668043,-0.5991554088369235,2.995637965888868,324.45249938964844,3.643939514160155,0.013731776022994293,319.8019989013672,330.89624938964846,0.7973896921356457,0.01919301113864938,1.0237604368126318,1.0136942040869135,1.005479552722936,0.01166086469402372,62.36702159408638,333.6976859393361,324.778125,315.85856406066387,330.62000056675504,1.746080483848813,327.2983932495117,3.962834516272144,329.615441112404,327.12967923828046,2.0104365726503755,3.748333795264112,19530100,2.5394105667038147,0.9819597866146443,-118227300.0,-9.885016376068595,89.02914134005623,91.58768807638091,131.56137050252218,25.12620258854113,13.484973996983252,0.007662708372311965,6.0725513511367755,331.6476848144531,328.85616552734376,326.6000061035156,324.3438466796875,321.55232739257815,0.1,0.0,282.41419065175444,0.019861959060887946,0.016667095274944418,328.36669921875,324.86299569266185,5.302382942689083
2023-09-11,0,337.2574996948242,315.2249984741211,332.7249984741211,321.95312118530273,328.91812896728516,-0.07423575299671444,4.76545784655004,-0.8312128053054564,2.9956248395827023,324.7975044250488,4.020751571655273,0.014655146175177212,319.8019989013672,331.61299896240234,0.7955161015385137,0.036706159750738265,1.0371632938229858,1.026319289292208,1.0175230366746022,0.02296890120056072,68.31919711037598,334.7039156473237,325.17299995422366,315.6420842611236,331.8810708182199,2.7815170329833063,328.53785760062084,4.180232413055962,330.3249570302029,327.62083385341913,2.215728817871735,5.4786253395712885,16583300,2.3512257124737794,0.8503848661615456,-101644000.0,-2.4465359794309927,89.02914134005623,91.58768807638091,166.8655739640726,26.591143572134246,12.811477529008721,0.02888033003235693,5.935227998488612,333.7896873779297,330.9251636352539,328.61000061035156,326.2948375854492,323.43031384277344,0.12000000000000001,0.0,282.481854341113,0.028235813823865197,0.031059211300235104,329.66410173688615,326.00159127371654,5.897980405759955
2023-09-12,0,333.96500396728516,315.2249984741211,337.2574996948242,322.3325004577637,329.9706230163574,0.09123420313631916,5.323296355592393,-0.5056426857635223,2.995599004555352,325.5787544250488,4.403975830078127,0.016329142459707405,319.8019989013672,332.5179954528809,0.7600589704533258,0.04610838583199844,1.0244333138825747,1.0116495863282382,1.003006347710173,0.007390327985603795,74.22244731387809,336.6463424670442,325.9997497558594,315.3531570446746,332.6385705130441,2.4626543965838144,329.25857271466936,4.184274967306726,332.04678466344035,328.80815834091175,2.6877847781840067,5.42426688602602,17565500,2.519335018485222,0.9036957351045575,-119209500.0,-33.89406587868579,89.02914134005623,91.58768807638091,97.43226112184178,24.536817328898234,16.54555751165194,-0.059241525564122925,5.97271110253072,333.7896873779297,330.9251636352539,328.61000061035156,326.2948375854492,323.43031384277344,0.12000000000000001,0.0,282.54823257851274,-0.005336761692273817,0.009462455762993581,330.23267909458707,326.66163417271207,6.002797159199275
2023-09-13,0,333.8475036621094,315.2249984741211,337.2574996948242,322.57249450683594,330.99937438964844,-0.0699866320728363,5.524882707199495,-0.6799323083134841,2.9955891006551347,326.15500259399414,4.635713386535644,0.016917478720147216,319.8019989013672,332.8489990234375,0.825983650717564,0.03486852936784722,1.0222584511374804,1.0083437856663997,1.0011800858118012,0.003373672531778782,64.33168855774458,337.62814027707,326.5783748626709,315.5286094482718,333.23321424211775,2.1075545889349594,329.8283942086356,4.230258860494799,332.506960320493,329.35284734248745,1.6133564873686734,3.115403113659925,16544400,2.6783519010155006,0.8520877550883768,-135753900.0,-12.028607470108522,89.02914134005623,91.58768807638091,103.39844515344501,22.86422751435494,15.789737403789962,-0.004882455972140565,5.951802643477187,333.7896873779297,330.9251636352539,328.61000061035156,326.2948375854492,323.43031384277344,0.12000000000000001,0.0,282.61224714829507,0.009553092043104838,0.007525115135137278,331.28194754464283,327.303957257952,6.2427834936038
2023-09-14,0,338.8199996948242,315.2249984741211,337.2574996948242,323.44436836242676,331.7599983215332,-0.23914646332752426,5.666490776046119,-0.7427528163502255,2.9955820311376824,327.4350051879883,4.805875778198242,0.017321560226732244,319.8019989013672,333.85925369262696,0.8290213902404503,0.03887447869384327,1.0357188006984468,1.0207235579282878,1.0154085424232322,0.02415911712273422,64.93400425730793,338.4681069030444,327.13512535095214,315.8021437988599,334.2767857142857,2.807351586006347,330.7126797267369,4.731697439072504,332.8231306464073,329.7809843367563,1.262570676354734,2.4480623709728735,20267000,2.6449469406801276,1.0449753966480044,-115486900.0,-9.791357133173413,89.02914134005623,91.58768807638091,140.51605027025232,26.408559783729217,14.867413070668142,0.03424895350466433,5.8695301541551546,335.6538259277344,332.4330662841797,329.8299865722656,327.22690686035156,324.0061472167969,0.14,0.0,282.69648292292675,0.026643737702064074,0.017483875514510767,332.0121808733259,328.63185119628906,6.540436802593738
2023-09-15,0,333.54750061035156,315.2249984741211,338.8199996948242,324.1993751525879,332.5524959564209,-0.22843730395735923,6.0417606129756285,-0.5895037124268061,2.9955623727778278,328.54625701904297,5.013787994384768,0.018419531522198107,319.8019989013672,334.29425354003905,0.753431674033731,0.06254801942712417,1.016887145188774,1.0017043074798957,0.9948415793069891,0.003165477702282704,73.26878409910024,340.0918967752677,328.0083755493164,315.9248543233651,334.3942860194615,2.74816625033197,331.52660860334123,4.0813010301122565,334.3220658067963,330.859908252754,2.2035202988175504,3.7924265288657732,37666900,2.7025456669483554,1.8632959357315289,-153153800.0,-55.5903498044418,89.02914134005623,91.58768807638091,52.33732514088122,23.60847776385318,21.398466893498227,-0.006472101195639674,6.0967078796117065,336.34294909667966,333.5485114135742,331.2899932861328,329.0314751586914,326.23703747558596,0.02,1.0,282.83487209407076,-0.012115891132572387,0.0009397060620314109,331.63501412527904,329.1451416015625,6.01302870389949
2023-09-18,0,328.40499114990234,315.2249984741211,338.8199996948242,325.0425052642822,332.9306240081787,-0.40297290011982306,5.7730263722720485,-0.2715302786978855,2.995577694236551,329.1737518310547,4.72649917602539,0.01756096380167306,321.92774658203126,334.29425354003905,0.7149625543349841,0.05812515576151136,0.9989748513139872,0.9848156314324616,0.9788888994559751,-0.026248515015773632,61.88736417780626,340.2880533243781,328.742000579834,317.19594783528987,334.04821341378346,3.3572267540806777,331.81928634643555,3.6476651939754534,334.13175051014736,331.26270259435177,0.24720178525883799,3.5371460417023286,16834200,2.8701355400326753,0.8493683295433274,-169988000.0,-62.170705667464176,89.02914134005623,91.58768807638091,-12.301483061023374,22.46344000356598,24.310339482519623,-0.01999862729221682,5.949800784276718,336.3807099609375,333.6096328125,331.3699951171875,329.130357421875,326.3592802734375,0.04,0.0,282.89173143562783,-0.026276853728619765,-0.015586168010592587,331.51449148995533,329.525144304548,5.296227810689857
2023-09-19,0,327.1800079345703,319.9049987792969,338.8199996948242,325.72437858581543,332.9306240081787,-0.011376420802674635,4.874809170533269,-0.6928908626111139,2.9956227528157284,329.1737518310547,4.0674995422363285,0.014799011440074132,323.702742767334,334.29425354003905,0.7160654793805575,0.02657036433641236,0.9932574816785245,0.9815189237528118,0.9804115706244783,-0.020316488111369546,49.89559782421945,339.1506185546896,329.40100021362304,319.6513818725565,333.2889295305525,4.2495098578220665,331.95446504865373,3.41460576477614,332.7178892084851,331.0410964608752,-0.7322572168926215,1.263457788863473,16505900,3.034238139272727,0.848939449307243,-186493900.0,-74.6789583317779,89.02914134005623,91.58768807638091,-38.627038604674716,21.130287346418296,25.117405874585373,-0.033430167249576585,5.873386791314988,337.0013911132813,334.6142946777344,332.68499755859375,330.7557004394531,328.3686040039062,0.06,0.0,282.94601891679883,-0.009404061593758284,-0.027490197084591394,330.71761213030135,329.54215567452565,5.009938884153179
2023-09-20,0,325.0950012207031,322.1524963378906,338.8199996948242,326.2975025177002,332.9306240081787,0.23184635038935628,4.401066714642751,-0.7254235773232596,2.995643300501525,329.1737518310547,3.711724395751952,0.01334607991206571,324.2642517089844,334.29425354003905,0.7343257236707516,0.010204602522021714,0.9858391491474569,0.976533990725652,0.9781411740994498,-0.02621706721001804,46.01321673056079,338.56688410067227,329.7647506713867,320.96261724210115,331.55142974853516,4.806394659565344,331.7162502833775,3.776546255828541,331.3359027820476,330.4888179162676,-1.5985164470652937,0.5817935812303963,21436500,2.936995230348665,1.0876122354029922,-207930400.0,-98.72245916488211,89.02914134005623,91.58768807638091,-107.7940058781705,18.88454569785557,27.129886409553258,-0.06107949128865091,6.102429632811462,336.05739111328126,333.0862946777344,330.68499755859375,328.2837004394531,325.31260400390624,0.08,0.0,283.0101846772448,-0.045498003929378084,-0.033155447542288344,328.2830243791853,328.9735630580357,5.147619954369232
2023-09-21,0,319.7850036621094,322.1524963378906,338.8199996948242,326.2975025177002,332.9306240081787,0.26494251698514987,4.326838629678423,-0.6852374090295026,2.995646319264364,329.1737518310547,3.65682399749756,0.013118559163636464,325.016251373291,334.29425354003905,0.729104834040148,-0.0023782536574303787,0.9695574180673507,0.9627902458784539,0.9672589672832625,-0.05618026105265239,41.62296070036451,338.4794283732485,329.8257511138916,321.17207385453474,329.52571541922435,6.357507245651482,331.0821429661342,4.905334021841822,329.7713289833425,329.76841160864876,-3.606294444193719,-1.0154390991372464,35529500,2.945141894321127,1.7392681411083744,-243459900.0,-82.48259340555595,89.02914134005623,91.58768807638091,-154.53486491949351,16.705111096661092,30.142840156565498,-0.08186558992528117,6.405827952147474,334.75702880859376,330.9814709472656,327.92999267578125,324.8785144042969,321.10295654296874,0.1,0.0,283.1065375403751,-0.05659887668998731,-0.049187765679954955,326.5474853515625,328.3900822230748,5.587836096195249
2023-09-22,0,318.98250579833984,319.7850036621094,338.8199996948242,326.1518783569336,332.9306240081787,-0.046928355008855845,4.784077518694938,-0.5406336880545526,2.9956268506231813,329.1737518310547,3.9469985961914062,0.014518256022318972,324.0920021057129,334.29425354003905,0.6755843948894655,-0.020386590888141543,0.9680172755822039,0.9635776523858739,0.9760711894943276,-0.043666928354610834,34.23902827549365,339.0896561970578,329.521501159668,319.95334612227816,327.4021442958287,7.111281243580484,330.3176792689732,5.877450141387755,327.2650877973972,328.4194776918238,-4.245953958267088,-2.7010998445348036,21447900,3.165397960364585,1.0546676193206488,-264907800.0,-92.2273360239798,89.02914134005623,91.58768807638091,-166.84287176467794,15.70554447693399,28.33921390889003,-0.06070094336881198,6.326841549176003,334.75702880859376,330.9814709472656,327.92999267578125,324.8785144042969,321.10295654296874,0.1,0.0,283.16169857932715,-0.04000359775397355,-0.06403898314762646,323.84633091517856,327.5641392299107,5.872152120378644
2023-09-25,0,316.7000045776367,318.98250579833984,338.8199996948242,325.2393798828125,332.9306240081787,-0.2113468654883226,5.275139951527476,-0.6352797438634123,2.995603689226149,329.1737518310547,4.319873428344726,0.01602661998132881,321.9157470703125,334.29425354003905,0.7059851196275104,-0.009840030965415606,0.9621793294756421,0.9606037302079529,0.9778026230176218,-0.0356419265470993,34.5341960828904,339.6989062305696,329.14862632751465,318.5983464244597,324.2421449933733,6.023442109050517,329.2594653538295,6.89150824735289,325.1814267204264,327.0279041767112,-4.452631126699858,-3.2462780652770804,17836000,3.0300125853444086,0.8854352699209904,-282743800.0,-90.1778422903538,89.02914134005623,91.58768807638091,-173.72666969847873,15.21173228446277,28.802400351116034,-0.03608922817061806,6.0656395405016,334.75702880859376,330.9814709472656,327.92999267578125,324.8785144042969,321.10295654296874,0.1,0.0,283.2055239945192,-0.035008903688606874,-0.038398761121240396,320.84598650251115,326.42908368791853,6.273235280558331
2023-09-26,0,313.2925033569336,316.7000045776367,338.8199996948242,325.2393798828125,332.9306240081787,-0.4383676494776602,5.749251670800564,-0.43126449293392133,2.995579061317218,329.1737518310547,4.592498016357422,0.01748151777688682,319.7047538757324,334.29425354003905,0.7393202171136343,-0.023457669355524926,0.9526158847099102,0.9562307224374207,0.974324242959812,-0.04244606712160104,30.527450763552025,340.3745050811031,328.87600173950193,317.37749839790075,321.34857395717074,5.662550433383499,327.87142998831615,8.006576537893888,323.06383299670733,325.83558708994934,-6.528538792606994,-4.4688761713007175,26297600,3.0130173118026256,1.269298231218705,-309041400.0,-93.12572669744154,89.02914134005623,91.58768807638091,-197.31797559984614,13.887335978665506,32.06042541341515,-0.04884168482373203,6.169523825555057,333.5817462158203,329.0791067504883,325.4399871826172,321.8008676147461,317.29822814941406,0.12000000000000001,0.0,283.2621401147211,-0.0502357102695582,-0.05141919881565711,318.2823704310826,324.9586922781808,7.211144879279289
2023-09-27,1,312.2699966430664,313.2925033569336,338.8199996948242,325.2393798828125,332.9306240081787,-0.6720508615879698,6.621878976912686,-0.2832672539867822,2.9955279292178774,329.1737518310547,5.195422973632816,0.0201686557497901,318.7542556762695,334.29425354003905,0.7597478996316045,-0.036875079803295255,0.9510995421753327,0.959161810956027,0.9796060275114473,-0.03945002085384264,26.42745544772618,341.5690097238449,328.3252517700195,315.08149381619415,319.04357474190846,5.594986702954768,326.54589407784596,8.959035928407793,320.6302489580247,324.4635714754236,-6.07259752099889,-5.840407305223546,19410100,3.066038213655282,0.9365777067185473,-328451500.0,-90.0545145871558,89.02914134005623,91.58768807638091,-164.82102570196997,13.132501044435337,30.70687869167318,-0.07173080354324547,6.058128220269874,333.5038693847656,328.9530518798828,325.2749938964844,321.59693591308593,317.04611840820314,0.14,0.0,283.3031941900521,-0.024877591399795396,-0.0482579705995994,315.9753984723772,323.74494498116627,7.977958716365711
2023-09-28,1,312.39000701904297,312.2699966430664,338.8199996948242,323.7675018310547,332.9306240081787,-0.6979439771355922,7.473473638566979,-0.5505862986570422,2.995470743402431,329.1737518310547,6.041561088562008,0.022807622991531024,316.35925445556643,334.29425354003905,0.81414544779018,-0.04920382090884733,0.9533550061171073,0.9659323426977339,0.9879319312261888,-0.02312490128799194,23.397573344850617,342.6213235741311,327.6743762969971,312.72742901986305,316.9307174682617,4.737131948235087,325.10982349940707,9.525517855182489,318.5473957890796,323.15716479789285,-4.913139246251902,-5.6094196464378605,19683600,2.9344553008232865,0.9396603042739563,-308767900.0,-86.66028008961935,89.02914134005623,91.58768807638091,-130.52388679729705,13.590283073680645,28.52299018147524,-0.06693088351536342,6.056118974486089,333.44723168945313,328.86137561035156,325.1549987792969,321.4486219482422,316.8627658691406,0.16,0.0,283.3455636296737,-0.01843326530574929,-0.022227649611097126,313.8470938546317,322.28235299246654,8.530521659207249
2023-09-29,0,316.9875030517578,312.2699966430664,338.8199996948242,319.584379196167,332.9306240081787,-0.5642716077398504,8.176897480437708,-0.9595856929561539,2.9954178444517208,329.1737518310547,6.959161148071286,0.025015565934985218,313.2022537231445,334.29425354003905,0.8540800401557825,-0.04951127306060116,0.969759227399914,0.9882242387306169,1.0071824137991539,-0.006254270094182779,23.585925493031443,343.22617121209606,326.8723762512207,310.51858129034537,315.7725034441267,3.125166446290742,323.6619665963309,9.06650375012249,316.9985859706785,322.00816183996864,-4.5204476303103025,-6.046703978524113,24140300,2.9323770101729334,1.1586953751397653,-284627600.0,-79.94271512433421,89.02914134005623,91.58768807638091,-82.4459716911194,17.37185380083763,26.55646265481839,-0.0720566143905876,6.039966660041769,333.44723168945313,328.86137561035156,325.1549987792969,321.4486219482422,316.8627658691406,0.16,0.0,283.4041648528946,-0.003974629873504387,-0.011829755975379204,313.1353018624442,320.7091631208147,8.859059039701474
2023-10-02,0,318.7874984741211,312.2699966430664,338.8199996948242,318.48375511169434,332.9306240081787,-0.38596793902423027,8.440746165417561,-1.2445448205135103,2.995396492228617,329.04499435424805,7.48064834594727,0.025868956164184633,313.2022537231445,334.29425354003905,0.896327057015157,-0.03851401974874291,0.9770107597245997,0.9989932774803971,1.0141873950232527,0.006591392062871515,35.3699066859663,343.17011842946783,326.2886260986328,309.40713376779775,315.6300027029855,2.9282498671028834,322.5778590611049,8.63700974607306,317.0014342236873,321.7441557855103,-2.493885829835085,-6.0102434079029265,20570000,3.153279701529784,0.9741439834059284,-264057600.0,-60.68135579387549,89.02914134005623,91.58768807638091,-51.53419500461203,18.84359412240154,24.465704609933194,-0.013854666894364372,6.087827753799947,333.44723168945313,328.86137561035156,325.1549987792969,321.4486219482422,316.8627658691406,0.02,1.0,283.4582527709994,0.013415662644769455,0.015109800847571877,313.45717075892856,320.0023280552455,8.884738077842675
2023-10-03,1,316.7050018310547,312.2699966430664,338.8199996948242,318.3374996185303,332.9306240081787,-0.21622701372513473,8.55487498099942,-1.38749510534053,2.9953866945549077,327.7924995422363,7.740373649597165,0.026262591226828662,313.2022537231445,334.29425354003905,0.9046968846348956,-0.038391930799390434,0.972251964061937,0.9954674998400486,1.006225665216598,0.010892371944927204,38.54474521413474,342.85350110640815,325.7437511444092,308.63400118241026,315.3046449933733,2.6020256965067508,321.353394644601,8.11583620369895,317.4548971583634,321.70962517796806,-0.31192994560878884,-4.54463950200328,21033500,3.1520353337497165,0.9902798758283622,-285091100.0,-87.45620563482642,89.02914134005623,91.58768807638091,-78.84380827517708,16.619703728239166,26.00260084652651,-0.06741215476309549,6.409411224092138,333.44723168945313,328.86137561035156,325.1549987792969,321.4486219482422,316.8627658691406,0.02,0.0,283.50684673954396,0.004004628840695634,-0.013069116534964944,312.9438781738281,318.39510454450334,9.085418221716088
2023-10-04,1,316.7574996948242,312.2699966430664,338.8199996948242,316.91687774658203,332.9306240081787,-0.022710144948158633,8.663551812818483,-1.4691524691671902,2.995376844486588,326.1375045776367,7.912923698425294,0.02665681582894378,313.2022537231445,334.29425354003905,0.8905313932963418,-0.048147859994091845,0.9746287105143624,0.998921465136692,1.0042149025612777,0.014370586671786922,34.94472518765791,342.3303548921164,325.0032512664795,307.67614764084254,315.31285858154297,2.6072499088952754,319.77750178745816,6.430337872189585,317.2590340452692,321.3633246437039,-0.7139902426890427,-5.134830017601328,20720100,3.134378729555958,0.9682665262250826,-264371000.0,-65.97500723359883,89.02914134005623,91.58768807638091,-54.00741523170205,15.391315886065081,24.08070865957337,-0.04653306727119731,6.426595700691584,330.8037982177734,326.7231008911133,323.4250030517578,320.12690521240233,316.0462078857422,0.02,0.0,283.5580762816784,0.019725764173939675,0.02184918797297321,313.14522879464283,316.995607648577,8.959263435553723
2023-10-05,0,318.3324966430664,312.2699966430664,338.8199996948242,316.74437522888184,332.7581214904785,0.17598379709190334,8.650900497772474,-1.4368555197283366,2.995376762242404,322.44000244140625,7.939123916625976,0.026683437324469043,313.2022537231445,334.29425354003905,0.9011551122554706,-0.04252971630466723,0.9818868249269764,1.0065348341273848,1.006344713328919,0.019022662346754204,35.73062907755671,341.50667732305953,324.2048763275146,306.9030753319697,316.0328576224191,2.6518578701721514,318.6907157897949,5.06481001219729,317.14077339811985,321.0631700762604,0.018154441539771273,-6.511569570825729,16965600,3.130097548819135,0.7954464469908666,-247405400.0,-52.696984219703445,89.02914134005623,91.58768807638091,-46.066334728046876,14.509087663946044,22.70040557532985,0.007740833644243701,6.330411514202452,325.45579821777346,322.39710089111327,319.9250030517578,317.45290521240236,314.39420788574216,0.02,0.0,283.6004156387518,0.018237316568092687,0.02100442518152209,314.1689671107701,316.22566877092635,8.9039137782223
2023-10-06,0,322.3249969482422,312.2699966430664,338.8199996948242,316.74437522888184,332.7581214904785,0.35861198779918346,8.601107605130167,-1.334543822682477,2.995380050776608,319.3837547302246,7.839136734008787,0.02658107500729149,313.2022537231445,334.29425354003905,0.8975100125168007,-0.0425946215194293,0.9961211176448901,1.01962699415481,1.015152078365685,0.016838183982328392,38.808915227551104,340.7823414004459,323.5801261901855,306.37791097992516,317.4692862374442,2.9772108134057005,318.25643048967635,4.382485312060765,317.4660547859685,321.01886752441237,1.608718125116054,-4.561570372868494,25645500,3.1264182478421993,1.1854164037723656,-221759900.0,-11.568959325521595,89.02914134005623,91.58768807638091,11.130857709564081,22.220113388612898,19.626313644898318,0.029481709739805923,6.798954595219241,324.8369600830078,321.8965223999023,319.52000427246094,317.14348614501955,314.2030484619141,0.04,0.0,283.6756373078375,0.03645281025772262,0.043425566730727075,316.220711844308,316.0980551583426,8.593453396154924
2023-10-09,0,327.0124969482422,312.2699966430664,338.8199996948242,316.74437522888184,329.69061851501465,0.5129821032025091,8.356165564991812,-1.0926269956362848,2.9953991902978103,319.3837547302246,7.354449768066411,0.02586474603531021,313.2022537231445,334.29425354003905,0.859891073822483,-0.044276265939509354,1.0121981330018353,1.0333625774199238,1.026464180324032,0.02580088150724258,45.6061971229706,339.78395741172193,323.0716262817383,306.3592951517547,319.55821337018693,3.827775304612465,318.24446541922435,4.35639908434104,318.7035442615834,321.3842920799206,3.2199700301879903,-1.8513708273346272,19891200,3.0590230572704997,0.9124585742880649,-201868700.0,-2.30206729389999,89.02914134005623,91.58768807638091,51.14365812941435,21.725816029753236,18.163173476108938,0.042906321920765336,6.8218860610741165,325.3793935546875,322.33529711914065,319.875,317.41470288085935,314.3706064453125,0.06,0.0,283.73882958132805,0.024922364239414074,0.04456047832914322,318.5149187360491,316.1810062953404,8.038254092937285
2023-10-10,0,329.5300064086914,312.2699966430664,338.8199996948242,316.74437522888184,327.4862537384033,0.5393305174273493,7.763869885711756,-0.8782973652713597,2.9954437961745253,319.3837547302246,6.73974960327148,0.024069583648487367,313.2022537231445,333.85925369262696,0.854597350831894,-0.020818070565633364,1.0216103786769526,1.0379355510017476,1.0290528986255352,0.040495112181645254,56.20665966999919,338.08711591583267,322.55937614440916,307.03163637298564,321.3499995640346,5.135916068983451,318.56125150408064,5.00573068127072,320.7881705217459,321.9801001242521,4.680844329411551,-0.0511984174661503,20557100,3.22913257496935,0.9365786229941986,-181311600.0,-12.517285076547694,89.02914134005623,91.58768807638091,68.2434431183807,21.785333700853993,17.486846250376864,0.05108878829660853,6.5796079621246255,325.9906075439453,322.8297084350586,320.27500915527344,317.7203098754883,314.55941076660156,0.08,0.0,283.8058503156408,0.04786367283820114,0.02047862343689418,320.3071768624442,316.7212393624442,7.874075563920783
2023-10-11,0,331.3975067138672,312.2699966430664,338.8199996948242,316.74437522888184,327.4862537384033,0.5525677937058536,7.493568549514196,-0.7259585659274888,2.9954631513179106,319.3837547302246,6.473649749755862,0.023247576264395498,313.2022537231445,333.57750091552737,0.8258372629379231,-0.012932543170332506,1.0281068038885965,1.0385063644515868,1.0266611958591036,0.0462183437902739,60.19600542870162,337.3247633655079,322.3376262664795,307.3504891674511,323.15142931256975,6.190527001309251,319.3907160077776,6.072543092163541,322.99538858610674,322.8027699697166,3.956781651068954,1.3642182043203455,20063200,3.2927805523062967,0.9068078156535896,-161248400.0,-1.7115703040528187,89.02914134005623,91.58768807638091,96.97531534225081,22.624452696580764,16.62577038525543,0.059178512190020266,6.426064013100099,327.3046884765625,323.8926691894531,321.135009765625,318.3773503417969,314.9653310546875,0.1,0.0,283.8745389034885,0.042199615088566844,0.06072302835266604,321.8130187988281,317.63509477887834,7.586239186236427
2023-10-12,0,331.02000427246094,312.2699966430664,338.8199996948242,316.74437522888184,327.4862537384033,0.5429249376615012,7.3224839499024235,-0.659268196091177,2.995475061364591,319.3837547302246,6.337636985778806,0.0227254506369106,313.2022537231445,331.6125061035156,0.7455245065480022,-0.021906891528370474,1.02732608475352,1.0311426858129944,1.0162732152300376,0.03985614966485973,61.167091523467825,336.8600943188722,322.21512641906736,307.5701585192625,325.19642966134205,6.069316366819745,320.2505373273577,6.816883717460584,325.10808733184746,323.76168327917776,3.955615668777477,3.6313469733645776,19313100,3.102197465801624,0.8747909059902461,-180561500.0,-10.215061906024005,89.02914134005623,91.58768807638091,104.68690998464312,22.284296837536296,15.7028346257428,0.05935976251716488,6.317773988029333,327.9235266113281,324.39324768066405,321.5400085449219,318.6867694091797,315.15649047851565,0.12000000000000001,0.0,283.94007081962593,0.03694893038997593,0.03824918797954272,324.3326721191406,318.6382751464844,6.897466411163972
2023-10-13,0,330.0749969482422,312.2699966430664,333.54750061035156,316.74437522888184,327.4862537384033,0.24141866272992948,6.59976319655245,-1.261957297440994,2.9955223204883126,319.3837547302246,5.908637237548828,0.020507296199317772,313.2022537231445,331.05775451660156,0.7818646885020728,-0.007577620378703521,1.0256346370037093,1.0222663942021144,1.005538327217498,0.02404405514116692,63.50468338483371,335.0246530410541,321.8251266479492,308.62560025484436,327.0989292689732,4.971048740072177,321.20589392525807,7.207072295019835,326.5745570189863,324.3213402014457,4.519979905161884,3.7737174469784804,21072400,2.881480288597566,0.9917513289107297,-201633900.0,-25.02043478206446,89.02914134005623,91.58768807638091,88.14175152602691,20.42646481094537,17.027611241451503,0.10587853497753161,6.400075933220318,328.0763126220703,324.5168363647461,321.63999938964844,318.7631624145508,315.20368615722657,0.14,0.0,284.008552664445,0.0014362401718264195,0.026208880232194195,325.5761980329241,319.36071341378346,6.76413614209956
2023-10-16,0,332.60750579833984,312.2699966430664,331.3975067138672,316.74437522888184,327.4862537384033,0.14910298368289412,6.329221435470732,-1.3773534513932184,2.995538845301575,319.3837547302246,5.7176495361328135,0.01967726376729664,313.2022537231445,330.16949768066405,0.844539224423925,0.005085202245228849,1.0340617229628992,1.0259512785849443,1.008491340453244,0.017109464935779473,64.41412943954506,334.3099443357852,321.65150146484376,308.99305859390233,329.1382162911551,3.4797314776786865,322.5855369567871,7.421236566817243,327.44595705205325,324.70960917361083,4.204319476649656,4.223237188910961,22158000,2.6397041054174486,1.0299409380606126,-179475900.0,-13.113524465513654,89.02914134005623,91.58768807638091,124.15802491044226,21.072851922797064,15.464455209009573,0.07782656930281458,6.543642199569536,329.84117407226563,325.9444337158203,322.7950134277344,319.64559313964844,315.7488527832031,0.16,0.0,284.08639374440685,0.008550181299118886,0.01643958062576177,327.45921543666293,320.81409127371654,7.004170775820709
2023-10-17,0,330.62999725341797,312.2699966430664,332.60750579833984,316.74437522888184,327.7675075531006,0.20943722973113052,6.613328326740324,-1.3491642300680178,2.995521459930201,319.3837547302246,5.948787841796877,0.020547116424932146,313.2022537231445,331.05775451660156,0.8392566288417397,0.01658872098583397,1.0272426698780661,1.0155224652098134,0.9991055197497353,0.0033380597315386673,69.2720810777064,335.08828385074634,321.86162719726565,308.63497054378496,330.32464490618025,1.7608402139964163,323.89696557181225,7.0721388217123815,328.73550430324633,325.37329422189197,4.4843078560337615,6.165165854415834,18338500,2.674461214245508,0.848789092214315,-197814400.0,-15.286686836394239,89.02914134005623,91.58768807638091,95.52777617445015,19.673661582619072,17.938632877491628,0.07368127544232966,6.508381170526623,329.84117407226563,325.9444337158203,322.7950134277344,319.64559313964844,315.7488527832031,0.16,0.0,284.14781430968225,0.011175678326372784,0.00679153882754434,328.1398184640067,322.1802651541574,7.208987119410724
2023-10-18,0,331.6224899291992,312.2699966430664,332.60750579833984,316.74437522888184,329.6662540435791,0.20066448200053477,6.792371638849743,-1.4206561243925087,2.9955101233538497,319.3837547302246,6.138537254333494,0.021092086448196185,313.2022537231445,331.05775451660156,0.880639706874163,0.017025780193270952,1.0297743700810287,1.0142329783974795,1.0014389052827815,0.0006788922993505864,64.73050158635077,335.6188699409075,322.034126663208,308.4493833855085,330.98321533203125,1.0231831151871846,325.2707143511091,6.510641875582694,329.1984494739703,325.5743967280739,2.5765920681942545,5.8795275907783004,23153600,2.669549305662362,1.0674121561876768,-174660800.0,-24.18782064543455,89.02914134005623,91.58768807638091,89.15531842676918,20.430790111450236,16.51562676721452,0.09310424833538067,6.564211697269141,330.2565291748047,326.61674578857424,323.6750030517578,320.7332603149414,317.0934769287109,0.16,0.0,284.22572136384343,-0.006949119213406796,0.005237575154381601,328.1809343610491,323.3479265485491,7.407678880805052
2023-10-19,0,332.81500244140625,312.2699966430664,332.60750579833984,316.74437522888184,330.21374702453613,0.15871209287043803,7.082243998998194,-1.5395415812748645,2.995491186417347,319.3837547302246,6.501099548339846,0.021969949714252476,313.2022537231445,331.4200050354004,0.8992076673584881,0.03701701496796125,1.0324310866472275,1.0132735057754894,1.004903525780473,0.00542262747198774,70.54577922535574,336.52498909662927,322.3605010986328,308.1960131006364,331.45250047956193,0.9986198905299815,326.40125002179826,6.3334344185263936,329.7766063238919,325.87741089094544,1.4097299106237755,6.156561502616778,25052100,2.3218608432521766,1.1835188617250905,-149608700.0,-21.659503896428127,89.02914134005623,91.58768807638091,93.92277119665788,20.329644498255643,15.301671031287823,0.05482086741384625,6.578912256839202,330.8218817138672,327.07405975341794,324.0449981689453,321.0159365844727,317.26811462402344,0.18,0.0,284.31276476608804,0.0004832597611741374,-0.0033090427250913974,328.5963875906808,324.4517822265625,7.607599553405642
2023-10-20,1,328.9400100708008,312.2699966430664,332.81500244140625,316.74437522888184,330.7274990081787,0.01685995736417409,7.407219347022226,-1.6341892721757296,2.995469344123411,320.653751373291,6.9601997375488285,0.022931715611891605,313.2022537231445,331.72099151611326,0.898427589043378,0.04336443658076749,1.0183522872653674,0.9970794784100786,0.9921279191213025,-0.003438572712065713,72.99303392954137,337.8264397316422,323.01200103759766,308.1975623435531,331.1014295305525,1.380234169489325,327.1264294215611,5.965121622526692,330.5149129173052,326.4286578104518,0.9968731128663012,4.993098856349589,25012600,2.300027903486283,1.1717860806190286,-174621300.0,-39.774001224506776,89.02914134005623,91.58768807638091,42.17430927380786,18.89987555082629,20.16055612174177,0.05180436916218692,6.571132897115197,330.8218817138672,327.07405975341794,324.0449981689453,321.0159365844727,317.26811462402344,0.02,1.0,284.3904338087407,-0.0032343407714571226,-0.013558198448462273,327.7810843331473,324.7970515659877,7.49711212612799
2023-10-23,1,327.9775085449219,312.2699966430664,332.81500244140625,316.74437522888184,330.7274990081787,-0.15108343489254086,7.454142585655777,-1.6389490597367324,2.9954664787275322,324.6687469482422,7.055125427246094,0.023041468384313816,313.2022537231445,331.72099151611326,0.9117016126269518,0.038648580095500165,1.0138098791464154,0.9921725133622533,0.9899026251041503,-0.01392030297784419,61.937945971151215,338.41816142253225,323.5098762512207,308.60159107990916,330.66678728376115,1.819346643197896,327.9316084725516,5.156150800607409,330.1070728371453,326.47079735601693,-0.7415555619095952,3.184727018868295,24374700,2.4333588226424525,1.1246760892996885,-198996000.0,-33.04194032000768,89.02914134005623,91.58768807638091,45.33284418641689,17.21880738195047,19.49784198240796,0.024130129734251986,6.697480285742013,331.48032373046874,328.13984301757813,325.44000244140625,322.74016186523437,319.39968115234376,0.04,0.0,284.4672400743919,-0.009980735283270481,0.004851558065681275,327.5201939174107,325.92643301827565,7.447084901593834
2023-10-24,1,330.31749725341797,312.2699966430664,332.81500244140625,316.9300022125244,330.7274990081787,-0.3377011004880131,7.343402191968561,-1.516788762948109,2.9954748555942476,327.49500274658203,6.881625938415527,0.022659663607809806,313.2022537231445,331.72099151611326,0.8881891048225395,0.04687314580029284,1.019266434803512,0.9989596442834617,0.9997593670822232,-0.000945165298357642,61.54761443383515,338.7605558335222,324.07375144958496,309.38694706564775,330.70143018450057,1.808476341139816,328.9001797267369,4.050778828039038,329.5662479332916,326.52144158557775,-0.9191274509907864,3.559308078083488,31153600,2.2751979594923046,1.421536597029309,-167842400.0,-28.889913237374714,89.02914134005623,91.58768807638091,51.912361138679735,16.419225881235903,18.5924300449162,0.06760552533477114,6.52194528207294,331.69272229003906,328.48364068603513,325.88999938964844,323.29635809326174,320.0872764892578,0.04,0.0,284.56761576159835,-0.004607552474903187,-0.006343251368782063,327.9172101702009,326.7467041015625,6.989870303480235
2023-10-25,1,342.37750244140625,312.2699966430664,332.81500244140625,317.99624824523926,330.7274990081787,-0.5353049273724878,7.024128577371681,-1.303304436069844,2.9954976785905485,328.4587593078613,6.484500885009766,0.021617691937007605,316.2735023498535,331.72099151611326,0.846284919064443,0.05779453935493001,1.053712398970618,1.0351854679046504,1.0364569874880698,0.03243149315507288,66.54355656140267,338.9732582991525,324.9250011444092,310.87674398966584,332.0971439906529,4.807718446428874,330.61768014090404,4.3143723392250335,329.7532308859634,326.96801461440083,0.0734682443135209,4.280876560668003,55053800,2.2593808217981617,2.323177955596816,-112788600.0,-18.49496409339392,89.02914134005623,91.58768807638091,163.88158368613597,28.152923080922946,15.692198574969025,0.014821196365313875,7.175378721048756,339.1436064453125,334.7782028808594,331.25,327.7217971191406,323.3563935546875,0.02,1.0,284.7885810443025,0.031989516092602255,0.025929184193486648,329.0558079310826,328.2575116838728,7.148758354388092
2023-10-26,1,334.25000762939453,312.39000701904297,342.37750244140625,318.6737480163574,331.1143798828125,-0.16746977306374464,7.368463926599001,-0.5756542364595245,2.995477133398105,329.2350082397461,6.27276313781739,0.022572850011957902,316.75224990844725,332.6282554626465,0.6726145179773675,0.09599377300354961,1.023954974045259,1.0072678665680197,1.005307008747683,0.004311720257385021,79.27463139301257,341.167304287524,326.43037643432615,311.6934485811283,332.6142883300781,4.8182841756624395,331.46946661812916,3.682047491336314,332.90605338487387,329.12381952394736,2.9373951196970167,7.553424815846104,37828500,3.342189364774783,1.5374395394082554,-150617100.0,-79.53945275214764,89.02914134005623,91.58768807638091,58.77755666852169,24.322536927838538,23.448810667446153,-0.06824308507242315,7.712137558217149,340.76728759765626,337.40636474609374,334.69000244140625,331.97364013671876,328.61271728515624,0.02,0.0,284.91456652193165,-0.01035253962347149,-0.006724938538838006,328.4645342145647,328.3021763392857,6.471618989084692
2023-10-27,1,331.3399963378906,316.7050018310547,342.37750244140625,321.4406223297119,331.4537525177002,-0.18354660511199447,6.804435649364513,-0.5229740091109116,2.9955161518668816,329.8025016784668,5.575614166259766,0.020775419827460465,316.96450271606443,332.95850296020507,0.7512250130889933,0.05445799727574147,1.0116529693673837,0.9975275397457203,0.9956952307424305,0.007296121461701333,60.91362675311369,341.13224776357276,327.52337646484375,313.91450516611474,332.5739321027483,4.829146405291029,331.7785737173898,3.453667856304422,333.234988995302,329.9529461455099,1.094882619861601,3.6996853467952473,29856500,3.8987083584483297,1.199505196322479,-180473600.0,-75.14908978969315,89.02914134005623,91.58768807638091,48.87345502634076,22.353776681213898,21.550773204920727,-0.07524592090024225,7.791983916363469,341.05285278320315,337.86859313964845,335.2950134277344,332.7214337158203,329.5371740722656,0.02,0.0,285.01246105526934,0.009611960949026166,-0.004557615622398687,328.4219970703125,328.3014657156808,5.889648508192426
2023-10-30,1,335.5,316.7050018310547,342.37750244140625,325.8406219482422,331.4537525177002,-0.3246978660431273,6.400270094414743,-0.12629850174828228,2.995541738240714,330.1962471008301,4.978950881958008,0.019498691730764246,318.1749969482422,332.95850296020507,0.7505806384446048,0.0393757532019046,1.022114845025084,1.0096670678135728,1.0067441280774445,0.022935997923918094,55.54641369416323,341.0415413179798,328.2410011291504,315.440460940321,332.95750318254744,4.956440272358613,332.2050018310547,3.522552255780289,332.744583138633,330.19069873088046,-0.08518529348504246,1.3233437345770218,22828100,3.9829755165034006,0.912993076792788,-157645500.0,-40.76119047952202,89.02914134005623,91.58768807638091,109.92990557644319,22.87218788025912,19.678070624093014,-0.09492739479123655,7.923986111511614,341.05285278320315,337.86859313964845,335.2950134277344,332.7214337158203,329.5371740722656,0.02,0.0,285.0943161810527,0.02426195033911216,0.03257090283611344,329.2713317871094,328.9338596888951,6.038209467015182
2023-10-31,1,337.6624984741211,316.7050018310547,342.37750244140625,327.73625564575195,331.8687438964844,-0.5065614513714519,6.1993068661944735,0.25224071751724386,2.9955542304056837,330.47374725341797,4.548637275695808,0.018838490407775764,318.1749969482422,334.37500686645507,0.6636888885886589,0.05934544153164795,1.0260907994824178,1.0152911875016497,1.0086794233887333,0.02223618573577424,61.263565261100865,341.4752399378332,329.0766262054443,316.67801247305545,334.20357295445035,4.873836642324626,332.6525012425014,3.7991649715178197,333.4165590761002,331.0624614692801,0.8067537637719493,1.81166918799633,20265300,4.0005744371617356,0.8117427576614223,-137380200.0,-37.093203856325296,89.02914134005623,91.58768807638091,123.98504362559058,21.95365074893156,18.887807854490813,-0.047165307621029405,7.665844072017481,341.05285278320315,337.86859313964845,335.2950134277344,332.7214337158203,329.5371740722656,0.02,0.0,285.16827967824725,0.02293286881741552,0.02669128240443748,330.89343697684154,329.3372606549944,5.191536259195362
2023-11-01,1,343.23250579833984,316.7574996948242,342.37750244140625,328.69938468933105,332.65937995910645,-0.5209433432789022,5.776363008419538,0.6859963537182923,2.995578697620716,330.82500076293945,4.004599609374997,0.017497528933066595,321.9257469177246,335.7162498474121,0.5782794850954408,0.0659968550056037,1.0397062463390117,1.029861518787561,1.020838676370736,0.002497253326625648,63.527500143153205,341.67722705443674,330.12450103759767,318.5717750207586,336.3828582763672,5.033859691529123,333.5248227800642,4.692512285843776,334.4798935856162,332.23557697798907,2.6516957914128145,1.890476431877075,28158800,4.0023162631350475,1.1113658976891998,-109221400.0,-5.861946048947388,89.02914134005623,91.58768807638091,229.44299850459805,27.805129485440023,17.274038240217827,-0.03648026581859965,7.783285786599938,341.9849337158203,338.622553894043,335.90501403808594,333.1874741821289,329.82509436035156,0.04,0.0,285.2846899293082,0.01585094245810148,0.047015306625528504,333.2684587751116,330.39432634626115,5.64806544614338
2023-11-02,1,347.2899932861328,318.3324966430664,343.23250579833984,329.38250732421875,333.1737537384033,0.029274307015792308,5.592066516957867,0.7065047157450945,2.9955899462514046,331.1800003051758,3.8481501770019575,0.01687161267046398,326.5437469482422,338.1339988708496,0.46693039914326745,0.0782201296375746,1.0477955212591432,1.0384185272468067,1.0323813576958796,0.0390126712313994,68.33448551478581,342.63238437668923,331.44825134277346,320.2641183088577,338.80750056675504,5.67249531353106,334.7544653756278,5.835343627071323,336.6842694715037,333.97746531458336,4.651232738823171,3.68935453092039,24348100,4.124799258323228,0.9471670977877547,-84873300.0,-2.086660531510934,89.02914134005623,91.58768807638091,226.73480580995067,28.07221264856069,16.60764955422854,-0.02543933123226309,7.517336627456639,343.0621531982422,339.4939172973633,336.61000061035156,333.72608392333984,330.15784802246094,0.06,0.0,285.38994483807704,0.06230759904139549,0.022455780097110904,335.7909589494978,331.85408455984935,6.079185085271605
2023-11-03,1,351.0374984741211,322.3249969482422,347.2899932861328,329.9387493133545,334.5625057220459,0.8908210042565524,5.755150278086013,0.5454773141718707,2.9955835750560413,331.3687515258789,4.293575057983389,0.017288126311995167,327.8810073852539,342.46300277709963,0.49024978146738796,0.07745287078029327,1.0544955944896206,1.0451004875900585,1.0354935760184991,0.059448006138514975,70.79743936930791,344.40642673109875,332.89612617492674,321.3858256187547,340.04464285714283,7.293576015859121,336.07089342389787,7.226724070954826,339.3514311286126,335.71879089037225,5.138237051879098,5.215480268743301,23624000,4.127048125446019,0.9226265330894242,-61249300.0,-5.300089518229167,89.02914134005623,91.58768807638091,219.10740175589453,31.486926756663802,15.488691499047126,-0.03526980363411044,7.484671730936299,347.3100146484375,342.9300146484375,339.3900146484375,335.8500146484375,331.4700146484375,0.08,0.0,285.49863291997826,0.0697069126025549,0.07597062822871888,337.51090349469865,333.2833557128906,7.362130909082756
2023-11-06,1,355.2175064086914,327.0124969482422,351.0374984741211,330.256872177124,336.0406246185303,1.2665185054916874,6.475242555472733,0.5172934954367059,2.9955462126272847,331.5099983215332,5.110949096679678,0.01936771644104829,328.84375991821287,343.6382545471192,0.5938675520329566,0.07346814494885025,1.0624701515165902,1.0506331898632981,1.0357871528207743,0.05877051090519059,72.72606536178787,347.28223636216615,334.3317512512207,321.3812661402752,343.03999982561385,8.689172898363841,337.82714407784596,8.650209597233635,342.29227410429104,337.91700427276766,2.529370642335618,5.54106337183965,23828300,4.091794353247989,0.9235053928927643,-37421000.0,-3.0467871842718908,89.02914134005623,91.58768807638091,209.27119503097745,33.11128465407988,14.769207206891382,-0.044435600359798544,7.2886252324375,349.71660998535157,344.87671087646487,340.9650115966797,337.0533123168945,332.2134132080078,0.1,0.0,285.6150175780524,0.056980334852328784,0.08101645072882634,341.5718514578683,335.01819283621654,8.793660844303119
2023-11-07,0,360.00499725341797,327.9775085449219,355.2175064086914,330.55187225341797,338.8412494659424,1.2472458936687134,7.685839186637475,0.3388434386351684,2.995472668971108,332.11499786376953,6.236549453735347,0.022892099133161564,329.4710067749023,347.6647438049316,0.670948599797818,0.07795193002285114,1.0722667864150726,1.0562829525888522,1.0378133482469072,0.06616813794916943,75.14827594364907,351.11368009751806,335.74200172424315,320.37032335096825,347.1349999564035,9.005074750388033,339.8544660295759,10.260299130510951,345.53151970015597,340.3620380020665,6.272998743666433,7.436563336516574,25833900,4.1351994295105134,0.9911011934962425,-11587100.0,-5.069592465432229,89.02914134005623,91.58768807638091,198.2814951952271,36.04774063537166,13.899327927857051,-0.011155751692025562,7.191580049819197,353.4754769287109,347.9172603149414,343.4250030517578,338.9327457885742,333.3745291748047,0.12000000000000001,0.0,285.7486460944751,0.06630984881118773,0.06883890957189594,345.927734375,337.17486572265625,10.224331080075702
2023-11-08,0,362.3249969482422,327.9775085449219,360.00499725341797,330.9225025177002,342.59125328063965,1.1685475356469521,9.179080272434856,0.12960204478038362,2.9953657014733714,332.71125411987305,7.596224327087396,0.02721616481355175,329.96149826049805,351.45549926757815,0.7238849725742093,0.08632379532128119,1.0743011870836627,1.0539098837011898,1.031217571601721,0.05562553320960739,77.73562284701929,355.62391181134916,337.26575126647947,318.9075907216098,350.9671423775809,8.936011446517014,341.9623227800642,11.641194983095396,349.15015845712554,342.95153736989886,8.651234753529614,8.558679880329697,26767800,4.205171425199889,1.0138901488328984,15180700.0,-1.6970193556364896,89.02914134005623,91.58768807638091,172.77845253806024,36.26049422675825,13.419895448977831,-0.010516894378542772,6.916466927538584,354.5527197265625,348.788642578125,344.1300048828125,339.4713671875,333.7072900390625,0.14,0.0,285.8909243608173,0.04949875332458631,0.07420661952684304,349.5987548828125,339.43504333496094,11.673304942856914
2023-11-09,0,362.03499603271484,327.9775085449219,362.3249969482422,330.9225025177002,344.2468776702881,1.0012734712790932,10.561283800646269,-0.3497340882677542,2.995251294841567,333.5325050354004,8.980012016296394,0.031171504787169756,329.96149826049805,355.6962554931641,0.7763437545195963,0.09457130164862866,1.0685420281259925,1.0469914801895148,1.0193144156769627,0.042457321062037146,79.17571028541661,359.93469337949074,338.81212577819826,317.6895581769058,354.4489277430943,7.524823732672666,344.3262503487723,12.142816495475332,352.450450069176,345.4159438503198,7.995528151487984,8.86678613955551,24847300,4.184682314379427,0.931385071367405,-9666600.0,-10.148531492407995,89.02914134005623,91.58768807638091,140.62747035226175,35.533013731811785,12.789750560807295,-0.0498175041901632,6.73886380366864,355.25560998535155,349.3572108764648,344.5900115966797,339.82281231689456,333.9244132080078,0.16,0.0,286.0215049106377,0.03551311238510069,0.0422457890943621,352.80043247767856,341.84693472726,12.502678370502785
2023-11-10,0,365.58250427246094,327.9775085449219,362.3249969482422,331.16249656677246,348.2268695831299,0.786076813592736,11.53538549412063,-0.8583615672063978,2.995162830301153,334.87500381469727,10.061699371337886,0.0338914327295808,329.96149826049805,360.20799713134767,0.8198229620848617,0.09682647695209759,1.074096297603301,1.048823117169799,1.0208265999189161,0.041434336393016746,79.05310570361942,363.43364635445215,340.3628753662109,317.2921043779697,357.64178466796875,6.664906737784897,347.01232147216797,12.404593382900961,354.85481460335706,347.4036919726332,7.218005454775633,10.061100793056681,28042100,4.165837366855623,1.0375863788875124,18375500.0,-0.9962758093061636,89.02914134005623,91.58768807638091,146.09893587854125,37.559849726677584,11.549207238312274,0.02244839964214468,6.929659507842979,359.9142452392578,353.6128847045898,348.52000427246094,343.42712384033206,337.12576330566407,0.18,0.0,286.1780072175025,0.04781739351948233,0.061294054746005217,356.14674595424106,344.70760236467635,13.75109208449743
2023-11-13,0,367.31749725341797,327.9775085449219,365.58250427246094,331.55186653137207,352.0825004577637,0.6258232782996785,12.506903005873305,-1.1230887747071647,2.9950689581453007,336.58124923706055,10.985824432373045,0.03655511472072924,330.17974853515625,362.0639961242676,0.8353612128220119,0.09914087294865155,1.0735937781498983,1.0435489701641993,1.0174069879128091,0.03406361067915675,80.65834176778338,367.1520567441685,342.13825073242185,317.1244447206752,360.5028566632952,5.710890027341026,349.65517861502514,12.515093885333359,357.53963458503966,349.5708608455192,6.511620576884533,11.465723943807703,19986500,4.182873214063776,0.7425038650211822,38362000.0,-7.92403414631029,89.02914134005623,91.58768807638091,125.8564454430313,36.05113445107952,11.08529522832589,0.018795610796094632,6.703970938086338,359.9142452392578,353.6128847045898,348.52000427246094,343.42712384033206,337.12576330566407,0.18,0.0,286.28927878645214,0.028468824361918443,0.03934237041810294,358.7500566755022,347.2705078125,14.573193676186033
2023-11-14,0,370.14500427246094,327.9775085449219,367.31749725341797,331.55186653137207,356.41437911987305,0.4617698367813549,13.437582812754007,-1.326673340174255,2.9949730384101514,340.0200004577637,11.9819987487793,0.039077082216449,330.17974853515625,362.65074768066404,0.8457972699632702,0.1109624060271825,1.076397962752232,1.0421614545035174,1.0184123007672319,0.02816629518035585,82.63424916089679,370.7489159306838,343.8737503051758,316.99858467966783,363.2325003487723,4.948179997841224,351.6385716029576,13.439187793175662,359.94791071069534,351.5749216734478,5.766795575588169,11.201344254438263,27683900,4.090554637600952,1.0109156572171418,66045900.0,-3.7325546075364224,89.02914134005623,91.58768807638091,122.7317366507588,37.76080886283389,10.453195199894129,0.014113173579682642,6.601545837598028,361.3276499023438,354.75618847656256,349.44500732421875,344.133826171875,337.56236474609375,0.19999999999999998,0.0,286.44830373529317,0.027015735257358786,0.038538128279384055,361.22717721121654,349.3690403529576,15.405267132052051
