date,buy?,todays_price,Minimum,Maximum,25th Percentile,75th Percentile,Skewness,Standard Deviation,Kurtosis,Shannon Entropy,Median,Mean Absolute Deviation (MAD),Coefficient of Variation (CV),10th Percentile,90th Percentile,Autocorrelation,Cumulative Return,curr_to_avg_one_month,curr_to_avg_one_two_week,curr_to_avg_one_one_week,momentum,rsi,upper_band_current,middle_band_current,lower_band_current,rolling_mean_7,rolling_std_7,rolling_mean_14,rolling_std_14,ema_7,ema_14,roc_7,roc_14,Volume,Volatility,Relative Volume (RVOL),On-Balance Volume (OBV),Williams %R,Stochastic Oscillator %K,Stochastic Oscillator %D,Commodity Channel Index (CCI),ADX1,ADX2,Chaikin Money Flow (CMF),Average True Range (ATR),Fib_23.6,Fib_38.2,Fib_50,Fib_61.8,Fib_76.4,Parabolic SAR 2,Parabolic SAR 3,VWAP,Adj Close Momentum,Adj Close Return,Adj Close 7d MA,Adj Close 14d MA,Adj Close Volatility
2021-12-30,0,218.03499603271484,193.2750015258789,218.04999923706055,207.67000198364258,214.82625007629395,-0.9280022679987123,7.307387018289193,-0.18971676520171732,2.995117050316747,211.02624893188477,5.684061889648436,0.03487981674457433,196.6370014190674,217.36324882507324,0.7784647553619435,0.12818521544734976,1.0407305219349903,1.0168440010265405,1.0036872480114691,0.008720752466180093,76.40538717511977,224.1166493417542,209.5018753051758,194.88710126859738,216.76178577968054,1.72824728528494,214.0853568485805,3.2554918706980605,215.8047053316098,212.46140501316071,3.1359366148955607,4.851892766506063,3812800,2.3451357576723186,0.4456170799622497,65903200.0,-14.452224677751136,89.0859394939463,92.09290994229893,98.52765320079946,33.256520365999634,11.753235205229261,0.3591480158679996,4.229112664946911,216.69267687988278,214.8136575927734,213.2949981689453,211.7763387451172,209.89731945800781,0.06,0.0,207.8252016583685,-0.00041300995664295126,0.011560905705465245,212.83115713936942,210.03523690359933,6.26230211054137
2021-12-31,0,216.74750137329102,195.39500045776367,218.04999923706055,208.45125198364258,216.38187885284424,-1.0037959289330405,6.506949942191907,0.22935523615368458,2.995250410344327,211.5562515258789,4.929387359619142,0.030876690712897243,200.4447509765625,217.59849891662597,0.7514261303190798,0.11586783449889243,1.0285073071335147,1.007306840016993,0.9960319231671292,-0.003688797364209906,75.69855781197333,223.7537749149014,210.73987503051757,197.72597514613372,217.27892848423548,0.6881333080461186,214.38142858232771,3.2984597454425693,216.36225256018366,213.42994145540342,4.515492308058868,3.915258959984295,4723300,2.3544734085756125,0.5835863632572751,61179900.0,-23.465347004201632,89.0859394939463,92.09290994229893,73.73365849913793,31.415526729331187,14.793087261870854,0.3189145725377654,4.071684612140353,216.69267687988278,214.8136575927734,213.2949981689453,211.7763387451172,209.89731945800781,0.06,0.0,208.04759627196643,0.0004155648908963361,-0.0057350894360333315,213.01717703683036,210.26671491350447,5.5743148511239635
2022-01-03,0,219.50499725341797,196.7750015258789,218.04999923706055,209.51875019073486,216.83000087738037,-1.0673766458465586,5.588550280964114,0.755199591827644,2.9953807634380234,212.14749908447266,4.299249649047852,0.026385044339558773,206.20524940490722,217.59849891662597,0.6938725886399573,0.10149917262120017,1.0363419481102008,1.0190031483633084,1.009448119460838,0.011182632334511222,69.99632389386441,222.98460063822216,211.80750007629393,200.6303995143657,217.7582130432129,0.9049938838997065,214.93946402413505,3.465198984077486,216.47005945839473,214.03433780427486,1.6985132798053542,1.9496498531224231,7694500,2.417732252502663,0.9684372158295339,68874400.0,-4.144769798031817,89.0859394939463,92.09290994229893,120.91992521046554,36.50764621097083,13.11339163843706,0.3592384556574548,4.185230932708066,218.4727982788086,216.25359872436525,214.45999908447266,212.66639944458007,210.44719989013672,0.08,0.0,208.52155548468087,0.01746073338360099,0.022204878239702804,213.50250898088728,210.99471609933036,4.549554220570877
2022-01-04,0,223.26499938964844,200.85250091552734,219.50499725341797,210.34124946594238,217.14374923706055,-0.6848945979497486,4.648014090405634,0.06120732927978212,2.9954928093803392,212.86499977111816,3.8529998779296877,0.021827401069779713,207.844002532959,218.0364963531494,0.6386245115739361,0.09286663722317959,1.0484681396688031,1.0325825516181142,1.0244521368214097,0.027249620500432448,72.78055406478614,222.24002804348217,212.9439998626709,203.64797168185962,218.57464163643974,2.255716328232275,215.8417857033866,3.877596745203079,217.25213118405932,214.9310808798161,1.552159070065954,3.6904926465907013,10629300,2.3477241592373947,1.3385957168412854,79503700.0,-21.725981753758425,89.0859394939463,92.09290994229893,167.4915762748904,42.15431745021022,11.682214379087377,0.2745666006143334,4.287796224942653,222.08651501464843,219.17673608398437,216.8249969482422,214.4732578125,211.56347888183595,0.1,0.0,209.29885912147935,0.02022455864382211,0.02219355954947154,214.31932939801897,211.8674795968192,4.202474984295244
2022-01-05,0,221.95750045776367,206.79999923706055,223.26499938964844,210.60312175750732,217.3943738937378,0.1454074397626206,4.285343508673833,-0.8172938272485943,2.9955320602998,213.75625038146973,3.7461246490478515,0.020018924252198776,208.54950180053712,218.19549903869628,0.6743355615649634,0.07961798942616825,1.036871461967447,1.0196269867622776,1.012947222272322,0.01792020744955347,75.93080084351656,222.63531180372462,214.06462478637695,205.4939377690293,219.2717846461705,2.46068341409753,216.65910720825195,3.8743728730405924,218.776903705912,216.18241112137338,2.626982382270823,5.99741433853149,9594600,2.1463846147987713,1.2260678384334303,69909100.0,-34.06922118132012,89.0859394939463,92.09290994229893,119.35273543511623,37.72823951056135,14.16485189986027,0.18539308190151982,4.379084795968478,222.08651501464843,219.17673608398437,216.8249969482422,214.4732578125,211.56347888183595,0.1,0.0,209.8485721112792,0.008387976861699453,0.008942734322303825,214.65080915178572,212.40526362827845,4.013670675654506
2022-01-06,0,219.25250244140625,207.96000289916992,223.26499938964844,211.22312545776367,217.67124843597412,0.16950606327280485,4.273865870474096,-0.9394276488049398,2.995534566345691,215.2675018310547,3.7454998016357424,0.01989487075846251,209.6994998931885,219.75024757385253,0.7260382543377563,0.06730860436360199,1.0206216881245715,1.0031317612525963,0.9970464276668433,0.005583995371590378,70.49441296532113,223.3702315883603,214.8224998474121,206.2747681064639,219.5446423121861,2.312532734631936,217.00678607395716,3.8730006888623603,219.57177077921298,216.9710732697445,2.248045551398102,5.435480180172801,7877500,2.1987129845125657,1.0321780102516798,62031600.0,-35.32361200858718,89.0859394939463,92.09290994229893,77.34844695110262,34.54493401558434,17.556105974797003,0.13360376563633172,4.377468124206438,222.08651501464843,219.17673608398437,216.8249969482422,214.4732578125,211.56347888183595,0.1,0.0,210.19499847323814,0.008629007953798062,0.0072420772122485325,214.8885759626116,212.78150285993303,3.8596403819984655
2022-01-07,0,217.5275001525879,208.6150016784668,223.26499938964844,211.62437629699707,218.03874683380127,0.0812911002451234,4.071078609525104,-0.9916348018043708,2.995553715784568,216.4487533569336,3.567412586212157,0.018901216183844858,210.44549942016602,219.75024757385253,0.7707872030971576,0.04495521285054463,1.0099373411006238,0.9938287645734654,0.9881078648968974,0.0035986517692470077,60.47624399599892,223.52928204357414,215.38712482452394,207.24496760547373,219.46999958583288,2.376368016753414,217.44303594316756,3.5235071882075673,219.5017174863569,217.28279042766522,0.8787989798759569,2.270449965240943,10702100,2.3094681847475265,1.3974721164348993,51329500.0,-49.32257995363409,89.0859394939463,92.09290994229893,33.48199835128871,31.546933695261078,19.6675945321297,0.058680769400427324,4.392727961882813,222.08651501464843,219.17673608398437,216.8249969482422,214.4732578125,211.56347888183595,0.02,1.0,210.5314401723131,0.0011536916153978005,-0.004176729419424872,214.71934073311942,213.13676234654017,3.7322936173405634
2022-01-10,0,211.6624984741211,208.6150016784668,223.26499938964844,212.37499809265137,218.03874683380127,-0.04970324350807998,3.8864615466294445,-0.8272511302580199,2.9955699927663,216.91250038146973,3.319000091552732,0.018011848355920398,210.6207462310791,219.75024757385253,0.8106795681638369,0.023165311409404813,0.9809521538833841,0.9670429786972243,0.9607855531295193,-0.03572811041856483,53.9029798707477,223.545422940671,215.77249984741212,207.99957675415325,218.55964279174805,3.807434430830846,217.66071428571428,2.9898982253128996,219.0216899363112,217.30776068436865,-0.2396235204314784,2.88879865274897,11978600,2.293912915549329,1.533166602243958,39350900.0,-73.04089191374158,89.0859394939463,92.09290994229893,-93.21688141846168,25.977651435504956,31.62159063177773,0.06143561350796117,4.893864414266187,222.00155487060547,219.0392158508301,216.6449966430664,214.25077743530272,211.28843841552734,0.04,0.0,210.54879180478963,-0.04272215043840066,-0.021872387841750086,213.8941367013114,213.3626469203404,3.795805523397071
2022-01-11,0,212.37250137329102,208.6150016784668,223.26499938964844,211.6850004196167,218.03874683380127,-0.04314173708509937,3.9299534416630966,-0.8861244874589973,2.9955662742361353,216.91250038146973,3.375400009155271,0.018217380157616786,210.6207462310791,219.75024757385253,0.7287090079986668,-0.00014172724042070268,0.9844571061645931,0.9726932848297457,0.9709211741964405,-0.04878730677058574,41.32456711403201,223.58540679940285,215.72549991607667,207.8655930327505,217.93464279174805,4.457985888304965,217.60678563799178,3.0833031509130326,217.17346672651547,216.53010812422616,-2.9226948308965937,1.4608234168851046,8803100,2.6638457634227994,1.1270247294812903,48154000.0,-61.16309763296922,89.0859394939463,92.09290994229893,-61.53370183623968,24.567823690179114,28.41440322462034,0.12881608677367137,5.001371363680665,222.00155487060547,219.0392158508301,216.6449966430664,214.25077743530272,211.28843841552734,0.04,0.0,210.62232636911003,-0.03632105124111029,-0.031838396732157194,213.56825256347656,213.29271480015345,3.6432694109060133
2022-01-12,0,215.39500045776367,208.6150016784668,223.26499938964844,212.19500064849854,218.03874683380127,-0.04683191994684469,3.8977242114617656,-0.8440881248149914,2.9955690338951215,216.91250038146973,3.3345999908447252,0.01806513369145831,210.6207462310791,219.75024757385253,0.7170204620079922,0.008260859683086683,0.9983106214387418,0.9887875174612093,0.9946456891038251,-0.029566470997670957,43.61136250021781,223.55494835425898,215.75949993133545,207.96405150841193,217.34750039236886,4.48724944985225,217.5528567177909,3.1171600291593697,215.9606403852609,215.92274609829286,-2.018477708984153,-0.3542485411158055,6923300,2.6561408778343294,0.9031801050685737,55077300.0,-54.60813326063659,89.0859394939463,92.09290994229893,-8.858800829444661,27.378228126242153,26.647424236279562,0.15586554306418898,4.901809060052706,222.00155487060547,219.0392158508301,216.6449966430664,214.25077743530272,211.28843841552734,0.04,0.0,210.75586297224618,-0.019499890479106274,-0.030342434788712628,212.76822335379464,213.13536616734095,3.360169262376431
2022-01-13,0,216.747501373291,208.6150016784668,223.26499938964844,212.93875217437744,218.03874683380127,-0.1153034716088545,3.7185864075265895,-0.5734236760417732,2.9955839646739753,216.91250038146973,3.0488497161865213,0.01721586709468824,211.32950172424316,219.75024757385253,0.6858702721663449,0.023181251133002147,1.003471687304513,0.9962104573736851,1.0069944564230093,-0.011425188037635814,50.68804907640145,223.43479797527047,215.9976251602173,208.56045234516412,216.41642924717493,3.653477700524939,217.49553544180733,3.1245863145290382,215.8104614477396,215.76434549895282,-1.8723932698941317,-0.3492967217941441,8867700,2.7345186869634315,1.172320249384273,63945000.0,-58.10742822764106,89.0859394939463,92.09290994229893,7.262817899177046,29.481743193368082,24.150610248111764,0.039782643350920244,4.975355546823113,222.00155487060547,219.0392158508301,216.6449966430664,214.25077743530272,211.28843841552734,0.04,0.0,210.9499993754988,-0.02161548092207466,-0.022727285607537756,211.72482299804688,213.02207619803292,3.243867364296263
2022-01-14,0,215.20000076293945,208.6150016784668,223.26499938964844,214.07062435150146,218.03874683380127,-0.21338922736187596,3.5008471999706927,-0.18332415196854868,2.9956011383347145,216.91250038146973,2.7346492004394505,0.016184454413172136,211.63824882507325,219.75024757385253,0.7265103282910444,0.011019908436944443,0.9948719275984279,0.9896835173826494,1.002137460456763,-0.010699793764079368,51.56063952767733,223.3109446593408,216.30925025939942,209.30755585945803,215.45107214791435,2.7184622994808936,217.3614283970424,3.183641538684066,216.04342327508934,215.89623505818955,-2.919175882549744,-0.36887973642100147,8838100,2.6145972274214078,1.166173949013784,55106900.0,-59.73385474440204,89.0859394939463,92.09290994229893,-23.000060734732905,27.330470051552147,23.915243914449718,-0.004351010577876551,4.940782812498619,222.00155487060547,219.0392158508301,216.6449966430664,214.25077743530272,211.28843841552734,0.04,0.0,211.0944902016001,-0.010554939019699172,-0.023117113512232317,210.97933959960938,212.81507437569755,3.2343370657867982
2022-01-18,0,215.70750427246094,208.6150016784668,223.26499938964844,214.68187618255615,218.03874683380127,-0.24498824622991658,3.4829089840741796,-0.11834680173468737,2.99560250626132,216.91250038146973,2.685749053955077,0.016098493080347085,211.63824882507325,219.75024757385253,0.6920797932162335,0.017879097265306673,0.9970302930072755,0.992723977846928,1.0066830028674136,0.01911063994566997,49.6439501692315,223.3158183496181,216.35000038146973,209.38418241332135,214.94464383806502,2.166403370000537,217.24464307512557,3.214230594959786,215.8230286972362,215.8042059127527,-3.0445016189529963,-0.8648978507620099,9099300,2.5446698456327184,1.2206026753376367,64206200.0,-54.60813326063659,89.0859394939463,92.09290994229893,-29.442323069264482,26.162141027653078,22.892909738485173,-0.039710581079188456,4.754794563532697,222.00155487060547,219.0392158508301,216.6449966430664,214.25077743530272,211.28843841552734,0.04,0.0,211.23739812757194,0.017643968606247062,-0.005761379719848431,210.4142848423549,212.65143040248327,3.058216802603322
2022-01-19,1,214.50499725341797,208.6150016784668,223.26499938964844,215.34625053405762,218.03874683380127,-0.31683931258350634,3.3000142657310945,0.38359315732810106,2.9956159726432396,216.91250038146973,2.4284989166259763,0.015238029145718882,212.30150108337403,219.75024757385253,0.5865511552403614,0.033998046817963944,0.9904906878715537,0.9889181342294231,0.9973056896703799,0.010041299444783602,52.57228261552398,223.16440402737283,216.56437549591064,209.96434696444845,214.51285770961218,1.842864116990627,216.99142864772253,3.2847670935100597,215.79538000183211,215.9467539168004,-1.6168564232888012,-0.7522663611667652,9399800,2.4443871687098104,1.2612051742714037,54806400.0,-59.68459643911335,89.0859394939463,92.09290994229893,-65.2913048672749,23.58643596790134,24.210354701409102,-0.06830537870112972,4.861563317710743,222.00155487060547,219.0392158508301,216.6449966430664,214.25077743530272,211.28843841552734,0.04,0.0,211.35571197584008,0.0013993020501215092,0.012784693835911798,210.09538922991072,212.40736498151506,2.4975706685431094
2022-01-20,1,215.65250396728516,211.6624984741211,223.26499938964844,215.34625053405762,218.03874683380127,0.2873891782549524,2.8028180046438798,0.09428805201401724,2.9956488469427596,216.91250038146973,2.097373962402345,0.012924617454987847,213.05200233459473,219.75024757385253,0.6285530647407498,0.0064632428768334315,0.994437067397656,0.9982398653288277,1.0006565935974012,0.0011954943660448247,46.490835275738526,222.46451128394594,216.8588752746582,211.25323926537047,215.0828584943499,1.3709381508791936,216.82125064304896,3.2882573339887933,215.48920016950876,216.1733640066291,-1.38948082290733,-1.6257748204752376,8532700,2.2613060211769622,1.1331637003019928,63339100.0,-61.31094775235495,89.0859394939463,92.09290994229893,-39.51532678786863,23.641683632599623,22.048383417469513,-0.1500056047113142,4.923586797517568,222.00155487060547,219.0392158508301,216.6449966430664,214.25077743530272,211.28843841552734,0.04,0.0,211.48336245531695,-0.0063047806526908,-0.00013994474472588242,210.4282684326172,212.16120256696428,2.542210640432433
2022-01-21,1,210.7025032043457,211.6624984741211,223.26499938964844,215.58812808990479,218.03874683380127,0.31478658442773033,2.6863467964724483,0.41031948939557505,2.995655730216364,216.91250038146973,1.9711238861084,0.012380326956179811,214.29174766540527,219.75024757385253,0.6815924085528317,-0.0023016486745264194,0.9710458394950118,0.9781815286259126,0.9774543425357785,-0.02788958641112249,47.70046404395454,222.35781894389706,216.98512535095216,211.61243175800726,214.8442873273577,1.945931302837186,216.38946505955286,3.6730595089436875,215.54239685432344,216.37984957615154,1.8850790867197007,-1.0927108532027623,16200200,2.169461280094806,2.0149953605926503,47138900.0,-99.47551060948608,89.0859394939463,92.09290994229893,-216.42106838388634,20.272911304508195,30.737339228413756,-0.2619355749364153,5.298492740251511,221.8410765991211,218.77945864868164,216.30500030517578,213.83054196166992,210.76892401123047,0.06,0.0,211.365096937483,-0.04218602269817007,-0.045338744594140036,209.24639892578125,211.4073257446289,3.4983710538168173
2022-01-24,1,200.5999984741211,210.7025032043457,223.26499938964844,215.34625053405762,218.03874683380127,0.042859792320680996,3.0134642344604265,0.06443360621882421,2.995635604003862,216.91250038146973,2.2504492187499965,0.013905338892453574,212.30150108337403,219.75024757385253,0.5903401740509497,-0.03147550474249022,0.9256492672818396,0.9349921633503777,0.9358372814226634,-0.06784387656625279,35.814755195779206,222.7396787130615,216.71275024414064,210.68582177521978,212.73071561540877,5.686915891233097,215.0391080038888,5.473432165706343,214.33058860576847,215.72498421236622,-0.7863532981654373,-2.7889586411122593,16054000,2.4007941003079223,1.866177822777041,31084900.0,-80.08987691537268,89.0859394939463,92.09290994229893,-324.7658385436693,17.45709577327734,40.2090052238967,-0.1465667185671223,5.680849678511286,219.4409534301758,214.89451351928713,211.2199935913086,207.54547366333009,202.99903375244142,0.08,0.0,210.8323142825961,-0.059719605785842345,-0.06116275585241224,207.30785478864397,210.03803907121932,4.72970503667674
2022-01-25,1,200.99750137329102,200.5999984741211,223.26499938964844,215.02624988555908,218.03874683380127,-1.5577945767815695,4.616134699509878,3.63133734874462,2.995500969708151,216.74750137329102,3.098974361419677,0.021384334417442554,211.56649894714354,219.75024757385253,0.47402346524883415,-0.07590607484357768,0.9311248622994447,0.9442952837057073,0.9506416911689054,-0.06819421025144157,23.825326758211805,225.09751960501342,215.86525020599365,206.63298080697388,210.48071561540877,6.8330364498572935,213.44857243129186,6.09882810757078,210.88463063821698,213.72953227265575,-6.868776876064818,-8.612559630007468,12125500,3.2405951621577294,1.3520904686849247,43210400.0,-78.56176948315388,89.0859394939463,92.09290994229893,-219.5304363058188,19.007170110780724,35.83437397380346,-0.14620050215500438,5.8876894716679855,218.2796818237305,213.95516030883792,210.45999908447268,206.96483786010745,202.64031634521487,0.08,0.0,210.5096891858123,-0.06355760486395023,-0.059020827301453256,205.4896000453404,208.60721152169364,5.565809093595055
2022-01-26,1,206.1699981689453,200.5999984741211,223.26499938964844,213.97187328338623,218.03874683380127,-1.352967706478657,5.625060362961179,1.5511676456106738,2.995385996497791,216.22750282287598,3.9527501678466805,0.02615562010812788,209.73200302124025,219.75024757385253,0.6706057917989658,-0.07520387175912424,0.9586571168743155,0.973473459076601,0.9888652406643326,-0.03885689933193315,24.72926943314656,226.31137103109816,215.06125030517578,203.8111295792534,209.19071524483817,6.643345651320413,212.32089369637626,5.859356175175172,208.4093186649875,212.1047984797917,-7.266519752342939,-9.973573142781573,10817600,3.243165824787555,1.163826654638507,54028000.0,-61.081502589228464,89.0859394939463,92.09290994229893,-111.65382901012853,23.72454737648346,31.888778860536625,-0.1680219871776952,6.113510226900192,215.71264135742186,211.87867993164062,208.77999877929688,205.68131762695313,201.8473562011719,0.08,0.0,210.39919635988315,-0.041037913266496084,-0.0456169806196434,204.258775983538,207.61905779157365,5.847709116233609
2022-01-27,1,208.1150016784668,200.5999984741211,223.26499938964844,212.19500064849854,218.03874683380127,-1.0502897376832832,5.917918186296878,0.5185252212385882,2.9953478452522084,215.68000411987305,4.451075057983393,0.0275890245106293,205.6527484893799,219.75024757385253,0.7700171934033745,-0.05448292185132953,0.9702212334790195,0.9855434873986989,1.0062395926710566,-0.03495207405503542,36.855963578147865,226.33846164725196,214.50262527465821,202.66678890206447,208.10607201712472,5.989681580071227,211.52535792759485,5.596006542297781,207.8560854156952,211.35745099285856,-4.196097844786457,-7.1128491969220775,12009800,3.4998601639652462,1.2337749725452247,66037800.0,-57.712447741877504,89.0859394939463,92.09290994229893,-85.85287455912041,22.331187012533068,29.84754310577204,-0.2156040918835895,6.037613823470568,214.62011529541013,210.99493502807616,208.06499481201172,205.13505459594728,201.5098743286133,0.08,0.0,210.31130402581618,-0.03825512393059982,-0.03973341806853257,202.9216591971261,206.66797201974052,6.032789721052541
2022-01-28,0,223.2150001525879,200.5999984741211,223.26499938964844,211.42249965667725,217.65437412261963,-0.8218366963953043,6.015470794323145,0.04087434055009265,2.995334013754578,215.5237522125244,4.742112503051753,0.02810890487549251,205.6527484893799,219.75024757385253,0.796275178806865,-0.045497257480444156,1.043032111799675,1.0607073950421213,1.0871725162661072,0.05938466206121529,40.85352840404208,226.03681698537483,214.00587539672853,201.97493380808223,209.35035814557756,8.080361398895516,211.93160792759485,6.2351993186512065,207.931021619143,210.97261510438477,-3.5198138421758487,-5.079759929269621,26425300,3.544922722571995,2.4321905158992583,92463100.0,-0.36955686072161364,89.0859394939463,92.09290994229893,125.24672071946618,35.08260152263933,23.023758475988775,-0.0690731972568829,7.237553080331746,220.45707482910157,215.71645465087892,211.88499450683594,208.053534362793,203.31291418457033,0.02,1.0,211.21678832080133,0.10717239460650241,0.06368086270960477,204.78467450823103,207.44003186907088,6.753012471922973
2022-01-31,0,225.03750228881836,200.5999984741211,223.26499938964844,211.42249965667725,217.95875072479248,-0.6990674474163033,6.288681583140661,-0.12762191840477088,2.9952984333567576,215.5237522125244,4.923412647247316,0.02935003492966705,205.6527484893799,222.0832504272461,0.648168285575947,0.029838861986041056,1.0502771471795975,1.0660913952171989,1.0828507542452193,0.12182205384139078,61.75530897704157,226.84223876900347,214.26487560272216,201.68751243644084,210.69107219151087,9.878767571265909,212.88696534293038,7.148557547334013,211.77675988210456,212.6084694489689,4.060512813545249,2.614611943782013,12380600,4.963515056878022,1.10072477168625,104843700.0,-6.005533954211422,89.0859394939463,92.09290994229893,123.42892712494017,32.889563420767914,21.584527136387432,-0.016602779809837882,7.140956840011243,220.45707482910157,215.71645465087892,211.88499450683594,208.053534362793,203.31291418457033,0.02,0.0,211.62497947402102,0.12048560408960962,0.09828593190286958,206.4378901890346,208.4330793108259,7.232444867454356
2022-02-01,0,230.0724983215332,200.5999984741211,225.03750228881836,211.42249965667725,219.31562614440918,-0.558897963504021,6.698507932088226,-0.3197851730730741,2.995242432805646,215.5237522125244,5.231000518798827,0.03120238221232723,205.6527484893799,223.22000007629396,0.667601023259725,0.025204460511726427,1.071702848149877,1.0848881309197946,1.0816404609595174,0.14465352429553002,62.81587182669579,228.07639151267497,214.67937564849854,201.2823597843221,213.4582143511091,12.298918044608925,214.1512508392334,8.48992342202674,215.11384458182056,214.42841498422092,4.351907883692796,6.319023875801296,12247200,4.943903240287489,1.0672648201814068,117090900.0,-5.775153008890911,89.0859394939463,92.09290994229893,179.6000527593399,38.522536179477065,19.703052319577157,-0.01739191599779595,7.238066008362586,225.41543902587892,219.72727804565432,215.12999725341797,210.53271646118165,204.84455548095704,0.04,0.0,212.18540158174346,0.1502971087056706,0.1511519631460742,210.1345498221261,209.6904743739537,8.093771380445347
2022-02-02,0,233.14500045776367,200.5999984741211,230.0724983215332,211.42249965667725,219.9287519454956,-0.1922342817128762,7.43464245319496,-0.29951742308968576,2.995133904065398,215.5237522125244,5.6544755554199195,0.03454635081193278,205.6527484893799,223.44224967956544,0.6548525540776512,0.03049066781848831,1.0833485304193584,1.0919795272260504,1.0669177489109778,0.13083864058006056,66.41173081579036,230.0770356082942,215.2077507019043,200.3384657955144,218.10750034877233,12.770441913924413,215.41910798209054,9.898467416052645,218.85464285811042,216.8341859202628,9.193054103586936,8.334410921275811,10590500,4.998878292454345,0.9230501051347141,127681400.0,-1.069671154216897,89.0859394939463,92.09290994229893,189.05848129411856,37.46798994497664,18.501302681894416,0.05619053577128593,7.133901926863702,226.36280322265623,220.49360144042967,215.75,211.00639855957033,205.13719677734377,0.06,0.0,212.70843905104434,0.14353732983794143,0.1654455365258498,214.82984924316406,211.068852015904,9.11344751142954
2022-02-03,0,232.15499877929688,200.5999984741211,233.14500045776367,211.42249965667725,219.9287519454956,0.1479116623456255,8.238395230472983,-0.18811517342545692,2.9950037814041,215.5237522125244,6.134675312042235,0.038193455554371175,205.6527484893799,225.54100189208984,0.6948784712517638,0.05040379341507709,1.0762777676415396,1.0779318821499961,1.0367904097416925,0.11551304282221508,69.35583967056493,232.17854121625604,215.70175075531006,199.22496029436408,222.55857140677315,11.138529468564705,216.51964351109095,10.866690306735418,222.40867613878447,219.12832330049747,16.22382962671913,8.240674092842076,9968000,5.017701788745913,0.8673826111888702,117713400.0,-10.72142166322263,89.0859394939463,92.09290994229893,149.70949153888773,35.522268431978894,17.540525690667778,0.0824336542398888,6.965743822014993,226.36280322265623,220.49360144042967,215.75,211.00639855957033,205.13719677734377,0.06,0.0,213.13569428506483,0.12316272889484692,0.12469058949188641,218.96149117606026,212.22554561070032,9.709477369002416
2022-02-04,0,228.01499938964844,200.5999984741211,233.14500045776367,211.42249965667725,220.24312686920166,0.24393739773055276,8.898872504614824,-0.4380114386024285,2.9948875031699367,215.5237522125244,6.745949859619138,0.04115815917382695,205.6527484893799,230.28074836730957,0.7657347911863321,0.058847658267155836,1.054591762499401,1.0506586878000037,0.996895832941954,0.021503927754762397,68.7805064710075,234.00937068061637,216.2116256713867,198.41388066215706,225.6792858668736,8.538308719166785,217.43500055585588,11.278897611887682,224.8295473085985,220.79859850935117,15.501435188560079,7.108500586343782,10848100,4.972862927031289,0.9319213183197566,106865300.0,-18.557224996469937,89.0859394939463,92.09290994229893,100.16042618068168,33.023185969434564,22.28488078325981,0.0953066784742646,6.937913407285919,226.36280322265623,220.49360144042967,215.75,211.00639855957033,205.13719677734377,0.06,0.0,213.48455233786717,0.0017105352470128121,0.10788250899914889,222.11127580915178,213.18502589634485,10.037517783342196
2022-02-07,0,227.77249908447266,200.5999984741211,233.14500045776367,211.42249965667725,223.6706256866455,0.17739988866830678,9.246708249512102,-0.7172280524171093,2.994823132720821,215.5237522125244,7.2716996765136726,0.0426804472535488,205.6527484893799,230.28074836730957,0.8179206735107791,0.04821229145604089,1.0513397709392178,1.0412350006905098,0.991673375430655,0.012153515604452991,62.461260497496326,235.1431670178231,216.64975051879884,198.1563340197746,228.4874997820173,3.6076608181655097,218.296785899571,11.59329416294614,225.61235594637628,221.66130925797574,10.59562565587371,5.954924991299494,5984500,5.062737444222137,0.5247400303120776,100880800.0,-21.616914931897266,89.0859394939463,92.09290994229893,86.54460239884186,31.60256286609708,21.326208396981794,0.10623001883653953,6.714235926837987,226.36280322265623,220.49360144042967,215.75,211.00639855957033,205.13719677734377,0.06,0.0,213.66799541235872,0.004377298110794348,-0.003684103567495428,225.04985918317522,213.98575919015067,10.288137383733256
2022-02-08,0,226.86249923706055,200.5999984741211,233.14500045776367,211.42249965667725,225.72125148773193,0.07835247034973888,9.559626980462602,-0.9441614411389283,2.9947638306370647,215.5237522125244,7.9278495216369675,0.04402071706825165,205.6527484893799,230.28074836730957,0.8355140812273544,0.07611173791526066,1.044669411549344,1.0243509795629704,0.9853647625825478,-0.013952119909553806,64.50785073268888,236.28125442631824,217.16200046539308,198.0427465044679,229.0085710797991,2.9163923724564045,219.17946461268835,11.75174024437526,226.14474487384393,221.98781501735758,9.44549756022695,5.593219787463852,7542000,4.838359322769606,0.6744246666663686,93338800.0,-19.676620050194526,89.0859394939463,92.09290994229893,71.63521602833738,30.258125098645777,21.848354404940522,0.10945106015597228,6.4957958763658725,226.36280322265623,220.49360144042967,215.75,211.00639855957033,205.13719677734377,0.06,0.0,213.88240652833207,-0.019022215568565204,0.00782598029757606,225.04146902901786,214.91307176862443,10.458257035955247
2022-02-09,0,231.06749725341797,200.5999984741211,233.14500045776367,211.9550018310547,227.08999919891357,-0.1013347118818864,9.695443551532904,-1.0171619487737231,2.994740431505131,215.68000411987305,8.289899368286132,0.044490430195804884,205.6527484893799,230.28074836730957,0.8485404553283581,0.06822916229771292,1.0603220267779452,1.031293504772015,1.006435375528975,-0.008910777414341653,62.62890134602414,237.31288760660584,217.92200050354003,198.53111340047423,229.86999893188477,2.3912148535838105,220.28053556169783,12.112476248806727,226.3309564045239,222.30212038530638,1.634074359688756,5.760938971992025,7772800,4.854285953880454,0.6982800828291268,101111600.0,-12.388083268932606,89.0859394939463,92.09290994229893,93.00370468176448,33.788432075510926,20.540895068212972,0.060044642771408994,6.40125653018477,226.36280322265623,220.49360144042967,215.75,211.00639855957033,205.13719677734377,0.06,0.0,214.16636640764688,-0.019327084544541906,-0.006412462085221399,225.69883946010046,216.0683648245675,10.775514457123274
2022-02-10,0,227.1099967956543,200.5999984741211,233.14500045776367,213.5543737411499,227.8331241607666,-0.2512510930979942,10.011404781237593,-1.0705137882880882,2.99468128479323,216.22750282287598,8.763174228668216,0.0457440986747112,205.6527484893799,231.17624740600587,0.8432575167660922,0.07276165538822468,1.0377107239639043,1.0024906542373173,0.9909915720798059,-0.021731179643642795,66.27489580749109,238.87955986002157,218.8567502975464,198.83394073507122,229.44678442818778,2.602251686271337,221.45249938964844,11.906465274489374,227.53544013282547,223.03559281230494,2.679551142929312,7.14807062405883,6794600,4.890307498666301,0.6107552282421933,94317000.0,-25.522404602231475,89.0859394939463,92.09290994229893,53.185494016717406,31.453984877559733,25.167108398739835,0.037950273389240084,6.371815697812701,226.36280322265623,220.49360144042967,215.75,211.00639855957033,205.13719677734377,0.06,0.0,214.34312894425662,-0.024112575791843005,-0.040196263146096846,224.80327497209822,217.46891239711218,10.851472187813176
2022-02-11,0,226.14500045776367,200.5999984741211,233.14500045776367,213.5543737411499,227.8331241607666,-0.3868599729409815,10.133693361063363,-1.0712723296064868,2.994658910146522,219.98125076293945,9.002749061584474,0.0461792649818452,205.6527484893799,231.17624740600587,0.8667855723094964,0.04780906518740724,1.0305433101601893,0.9899308533376884,0.9911445950028362,-0.008201210169902828,58.80623823795809,239.70988683656765,219.44250011444092,199.1751133923142,228.44678442818778,2.267717597723584,223.27714238848006,10.31620518386067,227.46346795010976,223.04295077295882,-1.2876382651083842,7.787042556108651,7535200,5.002608211411501,0.6814073423648683,86781800.0,-28.718485555392785,89.0859394939463,92.09290994229893,41.79351815880443,29.425162127283105,25.08672254418962,0.05361312267649902,6.312367932655969,226.67904595947263,221.00548587036133,216.42000579833984,211.83452572631836,206.16096563720706,0.06,0.0,214.5177810510634,-0.014599747529114748,-0.028005759103098445,223.35364423479353,219.0917467389788,10.864345787515415
2022-02-14,0,224.67499542236328,200.5999984741211,233.14500045776367,213.5543737411499,227.8331241607666,-0.500700518729257,10.215379743079799,-1.043780156587013,2.994644228389601,224.12625122070312,9.156136646270753,0.04645204591096881,205.6527484893799,231.17624740600587,0.8704563374239034,0.050859663829095604,1.0216569001731335,0.9822362294094911,0.9863186152120069,-0.013599111721387502,57.80902345129282,240.34313455482416,219.91237506866455,199.48161558250493,227.3782125200544,1.9722185388067273,224.96839196341378,8.08150880683482,227.1500845001152,222.977328354985,-3.0024233786939445,12.734298194393094,8280800,4.991460610409439,0.7507235668616576,78501000.0,-32.660059584181354,89.0859394939463,92.09290994229893,33.94441567962911,27.875423322494473,24.629450050898782,0.08201379839708067,6.176232933267598,228.255524230957,223.55724307250975,219.76000213623047,215.96276119995116,211.2644800415039,0.06,0.0,214.69309623338245,-0.006398227484406327,-0.011749197150363898,222.5377480643136,220.74961962018693,10.859668407535665
2022-02-15,0,227.32250213623047,200.5999984741211,233.14500045776367,213.5543737411499,227.8331241607666,-0.6315063414646083,10.205554788331952,-0.9318116308673146,2.994648801763322,224.85624885559082,9.063899002075198,0.04630761032491373,205.6527484893799,231.17624740600587,0.8747349315317972,0.04157245794553106,1.031473747908758,0.9939681489772947,1.0006625125649904,0.0020276727124002303,55.11264642740025,240.7972343782996,220.38612480163573,199.97501522497186,227.2792843409947,1.9522198657840668,226.47928510393416,6.0079642785426755,226.5262680644109,222.94207718882177,-3.2219867744672683,11.779994222464788,9461700,5.012378028514365,0.8563752059660344,87962700.0,-26.766662597656154,89.0859394939463,92.09290994229893,46.04217658623235,28.852102491316483,23.327183172840385,0.093083841003732,6.045150504442928,228.77000610351558,224.3900061035156,220.8500061035156,217.3100061035156,212.9300061035156,0.06,0.0,214.9272523979482,0.0010995187169797749,0.004536946149767112,222.5098637172154,222.3105697631836,10.922272521842496
2022-02-16,0,227.95000457763672,200.5999984741211,233.14500045776367,213.5543737411499,227.8331241607666,-0.7726245272936744,10.253159031381498,-0.805859629218896,2.994641982235313,225.59125137329102,9.00256187438965,0.04640133977340297,205.6527484893799,231.17624740600587,0.8646164119883201,0.059753875419833666,1.031602609633036,0.9979118303614519,1.0030185430571537,-0.013491697070498021,59.15341631047642,241.47319275758719,220.9668746948242,200.46055663206124,227.30464226858956,1.9608279759404992,227.89607102530343,2.856267187738281,226.70594742964064,223.30724528544516,-0.3037068856310543,10.259739125550075,9561300,5.018406442884602,0.8647579459183729,97524000.0,-35.5949305280853,89.0859394939463,92.09290994229893,47.918358707437925,28.05794899052522,22.0976329240075,0.12164374582032746,5.916536016972762,231.1890061035156,228.3055061035156,225.9750061035156,223.6445061035156,220.7610061035156,0.06,0.0,215.16918544354243,-0.0072670923597344395,0.005493764653355077,222.79410443987166,223.92198181152344,10.94864002123857
2022-02-17,0,226.49749755859375,200.5999984741211,233.14500045776367,214.4150037765503,227.96625328063965,-0.9424645177333152,10.248207731723284,-0.5772859587883961,2.9946467898638027,226.5037498474121,8.75972434997559,0.046238261087256705,205.6527484893799,231.17624740600587,0.8662484728202088,0.057024613135107,1.0219201934505955,0.9938132717922454,0.9993690345749635,-0.002696927681310579,59.604813268074196,242.13554052448168,221.63912506103514,201.1427095975886,227.25249917166573,1.9793112401385344,228.13053512573242,2.5620209067437,226.9567858520213,223.81635143789575,0.07793104693391105,9.530789582297665,8131200,5.017170583642183,0.7367523079007062,89392800.0,-81.44929715600556,89.0859394939463,92.09290994229893,28.523626313181726,26.428109182731493,22.600397149988954,0.125069982929016,5.824385096269985,232.59320538330076,230.57840493774412,228.95000457763672,227.32160421752928,225.30680377197265,0.06,0.0,215.33364972453373,-0.004344109896834314,-0.02553213321101227,222.37945774623327,223.71046338762557,10.825147400616332
2022-02-18,0,223.71750259399414,200.5999984741211,233.14500045776367,220.08687591552734,227.96625328063965,-1.0988698290982275,10.203917608340884,-0.3216731090627314,2.994658886630086,226.67999839782715,8.432187080383306,0.04592607107708322,205.6527484893799,231.17624740600587,0.8525190953779654,0.07496348697352485,1.006913846199696,0.9840581564530824,0.9876367554183502,-0.010734253947050743,59.11461354823072,242.58920995728235,222.18137474060057,201.7735395239188,226.20249993460519,1.5127535361946343,228.036249433245,2.704908807738193,226.78064456995128,223.96874121265512,-0.16089114758688586,1.4705541311121437,8121200,4.870448234409193,0.7638022514729471,81271600.0,-93.9328657314631,89.0859394939463,92.09290994229893,4.564109661643961,25.11063187729631,24.452031333766516,0.18274684621814255,5.684555892832605,232.5436437988281,230.49818237304686,228.84500122070312,227.1918200683594,225.14635864257815,0.06,0.0,215.45602750795072,-0.008901199709454244,-0.01285506694186306,221.28602600097656,223.4924327305385,10.134969514433493
2022-02-22,0,221.6500015258789,200.5999984741211,233.14500045776367,223.59187698364258,227.96625328063965,-1.3369927879725525,9.860335637635984,0.3065917617512377,2.994732816886745,226.67999839782715,7.544599914550782,0.044250063362564214,205.6527484893799,231.17624740600587,0.7776953098064499,0.1152417960903194,0.9946950055529825,0.9768104022829868,0.9806112000574728,-0.013463865397205121,58.45317794779107,242.552795985355,222.832124710083,203.111453434811,225.42250061035156,2.212594184639592,227.43464251926966,3.1217072751253436,225.96548638841873,224.04599856892605,-3.1808864279007145,-0.5865687636054991,9928800,4.238763052853997,0.9615027984275156,71342800.0,-91.21149743914924,89.0859394939463,92.09290994229893,-24.21234771170284,23.670426962844292,25.541011019854775,0.11194423895634696,5.592783672813975,232.09052423095702,229.76474307250976,227.88500213623047,226.00526119995115,223.6794800415039,0.06,0.0,215.57231640406016,-0.017839572009364035,-0.014998393744001772,220.68783351353235,222.7455542428153,8.869081965102135
2022-02-23,0,219.62249755859375,200.99750137329102,233.14500045776367,223.59187698364258,227.96625328063965,-1.5874570967653219,8.454286559384006,1.4246844877362257,2.995004258404302,226.67999839782715,5.9442743682861305,0.03776180059068281,207.92050132751464,231.17624740600587,0.6843534618821472,0.10275003426153156,0.9809628405403386,0.9704937711841516,0.9742489089545389,-0.03387260172344153,53.92666913907937,240.7931979814389,223.8846248626709,206.9760517439029,224.49071448189872,3.066319449602304,226.46874945504325,3.305541517256895,224.88014344392502,224.23460178906026,-2.4041193020173854,-3.660801207054137,8669900,4.299144808049421,0.8538782721913655,62672900.0,-97.06696975940608,89.0859394939463,92.09290994229893,-89.85745871605074,21.062620294249488,28.322737324058746,0.06466264492974795,5.8296230972960075,229.22548376464846,226.58726269531252,224.4550018310547,222.32274096679689,219.68451989746094,0.02,1.0,215.61879489103927,-0.05210253735750081,-0.041670366614542986,219.46341378348214,221.40852900913782,7.503797077042341
2022-02-24,0,209.99499893188477,206.1699981689453,233.14500045776367,223.59187698364258,227.96625328063965,-1.6094651981573853,6.732384451130704,2.108264235016663,2.9952763235820306,226.67999839782715,4.654612560272218,0.029946214701052486,218.47174797058105,231.17624740600587,0.5997711422231273,0.06524954896019755,0.934075492837511,0.9309289642854592,0.9379487386133065,-0.07876729671061145,47.57276009333845,238.28064357419743,224.81587467193603,211.35110576967463,222.39357212611608,6.2679031212072,224.88589232308524,5.159164903421414,223.58804471062845,224.25734705155162,-2.884212733408673,-5.800039834703488,13463400,4.239229857832911,1.3089250324110464,49209500.0,-49.99997593250709,89.0859394939463,92.09290994229893,-199.29078516776258,17.26798120136314,38.557308072307734,0.1452155303650425,6.595778267137583,225.66879461669924,221.04059506225587,217.29999542236328,213.55939578247072,208.93119622802735,0.04,0.0,215.53796677329274,-0.050345172417568085,-0.046176738821264336,218.3370644705636,220.4374062674386,6.341756177567063
2022-02-25,0,217.87249755859375,208.1150016784668,233.14500045776367,223.59187698364258,227.96625328063965,-1.451870534952849,6.236016851933467,1.7106792960720894,2.9953428274961893,226.67999839782715,4.405987510681149,0.027714752854908237,218.65974769592285,231.17624740600587,0.3888919624382478,0.009033453803212726,0.968291550053439,0.974958429472703,0.9889966382615027,-0.038079890916979164,33.22052475623183,237.47915841394996,225.00712471008302,212.53509100621608,221.04357147216797,6.043011239742215,224.16142790658134,5.392796376982148,220.23151545324993,222.86293770580212,-6.533880845477175,-9.545346843243719,8463600,4.810595322379556,0.8372726611719701,57673100.0,-43.78546044242787,89.0859394939463,92.09290994229893,-136.6742593465641,19.146531614285315,35.833166061429175,0.22369584517406452,6.583785069581684,225.66879461669924,221.04059506225587,217.29999542236328,213.55939578247072,208.93119622802735,0.04,0.0,215.57503460680215,-0.02377454664859069,-0.041735871037347695,217.13926478794642,219.82456425258093,4.742388519293838
2022-02-28,0,216.00249862670898,209.99499893188477,233.14500045776367,223.59187698364258,227.96625328063965,-1.2077992043655699,5.1892040398067705,1.7898468516979555,2.9954649168134067,226.67999839782715,3.8175000000000012,0.023012501612979956,219.44749755859374,231.17624740600587,0.6869162901073751,-0.02393433501486034,0.9579037189371988,0.970602536297178,0.9882464044425536,-0.03448547332162233,41.10615561142664,235.8734075837029,225.49499950408935,215.11659142447579,219.33678490774972,5.422632565145608,223.32071358816964,5.695493292313859,219.696044204223,222.71481646257035,-4.157091572031656,-4.448173084316462,8409400,3.786565885220679,0.9132968567748437,49263700.0,-53.722398797395556,89.0859394939463,92.09290994229893,-147.31881147141868,17.87135058751064,34.56217179958274,0.10790424353343452,6.54375981936147,225.66879461669924,221.04059506225587,217.29999542236328,213.55939578247072,208.93119622802735,0.04,0.0,215.5811831896123,-0.029502910729522824,-0.037798808058318395,215.3600790841239,219.07709176199776,5.1805858493018
2022-03-01,0,211.46999740600586,209.99499893188477,233.14500045776367,223.20062732696533,227.96625328063965,-1.0251589534998324,5.57164669683083,0.7333445020572751,2.995423329236367,226.67999839782715,4.250250091552732,0.024748094159285104,217.68549766540528,231.17624740600587,0.712093830120219,-0.04014887994319116,0.9393056832990558,0.954586378584529,0.9743881496484222,-0.0459282835542163,38.10167018472969,236.2776678214571,225.13437442779542,213.99108103413374,217.18999917166573,5.079031741262783,222.22124917166573,6.401166302140623,218.79468842998213,221.99821548440485,-5.241283488045982,-5.16743702820708,9317800,3.7683220416729806,1.0290680979833455,39945900.0,-76.27758676210874,89.0859394939463,92.09290994229893,-183.50221172234455,16.171001152505266,37.68848007006982,0.018639254576663,6.7095812891156665,225.66879461669924,221.04059506225587,217.29999542236328,213.55939578247072,208.93119622802735,0.04,0.0,215.50110219960675,-0.05580149650269994,-0.061610162077983345,213.16902378627233,217.7742407662528,6.295911382625942
2022-03-02,0,208.02749633789062,209.99499893188477,233.14500045776367,221.14312553405762,227.96625328063965,-0.8854986708676612,6.318096604323018,-0.09788137066453428,2.995332657093182,226.67999839782715,5.08620000839233,0.02814848623918229,215.54924850463868,231.17624740600587,0.705978013716201,-0.0808549524660257,0.9268074682542924,0.9446777915718496,0.967603512947057,-0.05279514325534729,31.02420343794307,237.09219239230083,224.4559991836548,211.81980597500876,214.9485697065081,5.179357995801256,220.57553482055664,6.894609625730076,216.97175222972749,220.80383722303293,-6.63473120655576,-6.784947658965113,8865700,3.635209523292406,0.9977688431465783,31080200.0,-75.33333761650229,89.0859394939463,92.09290994229893,-171.82498526350614,15.394797420597056,37.08219351482604,-0.009418677672982725,6.53931855686486,223.2239969482422,219.0629969482422,215.6999969482422,212.3369969482422,208.1759969482422,0.04,0.0,215.396912687169,-0.03459126022393444,-0.05801559776797095,211.1782967703683,216.23216138567244,6.952902868469377
2022-03-03,0,208.95999908447266,208.02749633789062,233.14500045776367,219.18499755859375,227.81687545776367,-0.7917534036191554,7.114838127447851,-0.42860898305548334,2.9952204242645,226.3212490081787,5.883625564575192,0.03185457220490626,211.32249755859374,231.17624740600587,0.7024616071133766,-0.10773340226278329,0.9355562641818191,0.9573003533784299,0.9825389682934473,-0.004928688076747179,26.53659290975768,237.58342533936838,223.35374908447267,209.12407282957696,213.13571221487862,4.6350677658252994,219.2791064126151,7.267708606628048,214.74202636292787,219.20621787647255,-7.0133119108601765,-9.971112852041996,8610000,3.542964819399855,0.9799123655608035,39690200.0,-79.66937331639473,89.0859394939463,92.09290994229893,-144.96838127973646,15.618726804631347,35.02604972538919,-0.09662103095861471,6.423999595781208,223.1705230102539,219.01974185180663,215.66500091552734,212.31025997924806,208.15947882080079,0.04,0.0,215.2989895995007,-0.046341437392265705,-0.040379623232940705,209.20437840053015,214.94610595703125,7.245011427103295
2022-03-04,0,202.12999725341797,208.02749633789062,232.15499877929688,217.40499782562256,227.43500137329102,-0.6938824196307112,7.397581201419608,-0.8513070528137332,2.99517330652861,225.40999794006348,6.355600509643557,0.03330076249555559,209.89149894714356,228.32024917602538,0.7507343162001985,-0.09991169613743722,0.9099032303250243,0.934137153364485,0.9513499744373186,-0.07225556452320037,28.772247538383148,236.93966141864735,222.1444990158081,207.34933661296884,210.63678359985352,5.231921051253604,217.5637490408761,8.285352135950328,213.292372617675,217.8721445856394,-5.725243561491525,-7.991721177959586,10912300,3.578277491935144,1.235301342640101,28777900.0,-89.61237967300355,89.0859394939463,92.09290994229893,-181.34896421639348,13.878995518539762,41.54367005131872,-0.0948924301178137,6.708333895081417,222.0872838745117,217.2663632507324,213.37000274658203,209.47364224243165,204.65272161865235,0.06,0.0,215.05176133027433,-0.0865599097592279,-0.0782789209186,207.01051548549108,213.2369646344866,8.331156565362559
2022-03-07,1,195.19249725341797,202.12999725341797,231.06749725341797,214.8693733215332,227.16312313079834,-0.7658159193879002,8.215166742319942,-0.6972412438953057,2.9950321623780902,224.1962490081787,7.106600875854491,0.03723280354964316,208.86674880981445,227.95650405883788,0.7413702875993601,-0.11352324279332306,0.8846520262531435,0.9123500270544364,0.9325165506995137,-0.096341484499466,24.24118737155368,237.07358242415404,220.64324893951417,204.2129154548743,208.5221405029297,7.8639480385532226,215.45785631452287,9.9236620226142,210.4987942784749,216.03322450830663,-7.964803469420934,-10.619294326973593,13412400,3.7405175207646955,1.4965972731320152,15365500.0,-98.36807967209886,89.0859394939463,92.09290994229893,-202.90437082041026,12.409111990639948,44.18713932629213,-0.1772517534138689,6.962652724455375,220.4801244506836,214.6649441833496,209.96500396728516,205.2650637512207,199.4498834838867,0.08,0.0,214.60092286505014,-0.11761994592514102,-0.1302960429256778,203.28402491978235,210.81054469517298,10.366888812118324
2022-03-08,1,191.20249938964844,195.19249725341797,231.06749725341797,211.1012477874756,226.92437362670898,-0.8706580761852437,9.719340297691309,-0.2502709130550498,2.994733855623628,222.68375205993652,8.236700820922852,0.044380118912070395,207.43774642944337,227.79024963378907,0.7372083008415425,-0.14303746923798705,0.8730623066272611,0.9057769816845322,0.9319859119417933,-0.09584100943381302,20.192186899622822,238.44080442808522,219.00212383270264,199.56344323732006,204.71214076450892,8.962683542476638,212.87785611833846,11.213284662927883,206.67020064091616,213.3437264674631,-7.048978191746474,-13.122287201351263,11070900,3.9290204671612305,1.2012369456123695,4294600.0,-88.33601536260718,89.0859394939463,92.09290994229893,-179.46908281620966,11.193536426886528,43.25453487780521,-0.1569588942664378,7.163256082808434,219.68244329833985,213.37378231811525,208.2750015258789,203.17622073364257,196.86755975341796,0.1,0.0,214.2079400681955,-0.08259569405155665,-0.11294646064827901,199.42305210658483,208.28115844726562,11.713800570482421
2022-03-09,1,198.0,191.20249938964844,231.06749725341797,209.73624897003174,226.58874797821045,-0.8567111623126402,11.221280919931885,-0.30599139110358875,2.994376007312661,220.63624954223633,9.440900650024412,0.05166963059836245,201.43624725341797,227.3852523803711,0.7751222523742103,-0.15718772369755613,0.9117129257769144,0.9517057496987632,0.9845725543107314,-0.048202744898700134,18.381182086893755,239.61618568782518,217.17362384796144,194.7310620080977,202.14035524640764,7.673116114327626,210.7385700770787,10.970941004743601,202.79989414364402,210.4962903558208,-12.241103612342256,-15.889321297781569,8457600,3.9559200255412454,0.9131475497272197,12752200.0,-68.9368853168372,89.0859394939463,92.09290994229893,-113.48153030681439,14.252530784423724,39.49801936650895,-0.15192694851542024,7.280267908937794,218.86495770263673,212.71251779174804,207.73999786376953,202.76747793579102,196.61503802490233,0.1,0.0,214.00555437497505,-0.041826676854776035,-0.044073548417553114,197.13112095424108,206.2456000191825,11.997337044626457
2022-03-10,1,197.7775001525879,191.20249938964844,231.06749725341797,208.72687339782715,226.2331247329712,-0.6262803181834272,11.726986530493898,-0.8068489355525972,2.994236362136827,218.74749755859375,10.086650543212892,0.05435942804121072,197.7192497253418,227.3852523803711,0.8286853001105083,-0.1431075233274888,0.9167804328724122,0.9606200633453725,0.9933725849565431,-0.05351502192227808,28.897336589674488,239.18447194709623,215.7304988861084,192.27652582512056,200.18428421020508,6.563396603849667,208.68714169093542,10.471311082320915,201.60347571790672,209.03378706192237,-8.334393695056523,-13.138847982534761,7061600,4.200491596868603,0.7653631345465818,5690600.0,-71.07755072072088,89.0859394939463,92.09290994229893,-102.6716979119893,13.721107996366062,38.025288109724336,-0.13439683573168576,7.018553339717353,216.51948376464847,210.81526269531253,206.2050018310547,201.59474096679688,195.89051989746093,0.1,0.0,213.83595016316204,-0.04468478725986691,-0.050412631862401414,195.59008571079798,204.37955474853516,12.040089831812688
2022-03-11,1,198.69000244140625,191.20249938964844,227.95000457763672,206.55312156677246,225.04249668121338,-0.4757114962721543,11.794320054555868,-1.1194870013839404,2.994199693357865,216.93749809265137,10.383900547027588,0.0550966529385369,197.5189998626709,227.13124732971193,0.853953493922474,-0.12915546236152153,0.9281717009741974,0.9708130862889436,1.0092934013814485,-0.017018724873868463,29.42501844943305,237.65463914017863,214.0659990310669,190.47735892195516,198.85035651070731,5.578685771888597,206.8994631086077,9.824296974189386,200.64303217923307,207.6375250720255,-6.474912479962557,-12.680050647613069,5432100,4.179477975973477,0.5931311825444444,11122700.0,-73.34746739329887,89.0859394939463,92.09290994229893,-92.40128035554801,14.035756430261555,36.27268204931733,-0.1350876941653093,6.828943946666985,215.44987677001956,209.95005703735353,205.50499725341797,201.05993746948243,195.5601177368164,0.1,0.0,213.70737839899874,-0.017874004963693624,-0.05076484663084776,193.9411860874721,202.5597414289202,12.263769715758677
2022-03-14,1,200.33499908447266,191.20249938964844,227.95000457763672,201.26999855041504,223.95687580108643,-0.2836076642063542,11.849072327557746,-1.308203542461729,2.994170214040649,213.73624801635742,10.50050048828125,0.05572231825727962,197.5189998626709,226.57999801635742,0.8657287574543632,-0.12140439965855047,0.9421100883226424,0.988111929998787,1.021218566518234,0.02634579660292058,31.27382708989689,236.34314396847003,212.6449993133545,188.94685465823898,197.61821365356445,3.5614245302623484,205.37696293422155,8.977665676009329,200.16328282155564,206.55143898703952,-4.488586394039883,-11.187099740697612,7994700,4.214046851016916,0.8707571460312896,19117400.0,-63.67986322672466,89.0859394939463,92.09290994229893,-66.3643421803389,16.64765655049072,33.354611455636594,-0.12409095001873291,6.892947303971549,215.4040386352539,209.91297854614257,205.4749984741211,201.03701840209962,195.5459583129883,0.1,0.0,213.55698317252435,0.05049822388106473,0.0001996540003941807,192.9745374407087,201.08945792061942,12.179885179796111
2022-03-15,1,204.0099983215332,191.20249938964844,227.95000457763672,199.92374992370605,222.16687679290771,-0.09631747345290195,11.71321596886494,-1.3709943066129118,2.9941925712005077,210.7324981689453,10.32350025177002,0.05541976163613287,197.5189998626709,226.57999801635742,0.8767326866397741,-0.10833424650631111,0.9652503213823055,1.0140745631244044,1.034528212841386,0.06698395142724878,34.622509358425816,234.7809311824198,211.35449924468995,187.9280673069601,197.88678523472376,4.002005189877823,204.26178441728865,7.987022477098988,200.2185232491744,205.96462390200801,-4.127584244730648,-9.616513555005593,8277700,4.270106513756536,0.9015958214453177,27395100.0,-42.75211889025829,89.0859394939463,92.09290994229893,-37.73735305735972,17.664418346308366,31.224127263138442,-0.09005402256870182,6.83457702360188,212.65363397216797,207.6881747741699,203.67499542236328,199.66181607055665,194.6963568725586,0.1,0.0,213.44937945977978,0.07526989414446983,0.08096501156664003,193.79408482142858,200.40230015345983,11.761761832220769
2022-03-16,1,210.6349983215332,191.20249938964844,227.95000457763672,199.92374992370605,220.12937355041504,0.07503618533692889,11.399873983508385,-1.2911184145955807,2.994264097735251,209.4774990081787,9.92137550354004,0.0542021979072052,197.5189998626709,226.57999801635742,0.8628405335021535,-0.10255255681079246,1.0014917604987383,1.0509024207352504,1.054427123817199,0.06381312283602636,39.90110793713977,233.12099735666524,210.32124938964844,187.52150142263164,200.0928568158831,6.017845124723477,204.30749865940638,8.024106537168173,201.20266428799744,206.07561327829364,0.9300950347108581,-7.1087886763036385,9232300,4.325662036496874,1.0068273808452735,36627400.0,-25.904142844900957,89.0859394939463,92.09290994229893,10.297831207098868,23.84659761259405,28.772908491359743,-0.08395818311757725,6.884490397995373,212.65363397216797,207.6881747741699,203.67499542236328,199.66181607055665,194.6963568725586,0.02,1.0,213.414776694586,0.06062280041307955,0.10515874352489815,196.7598658970424,200.0219454084124,11.044281091063814
2022-03-17,1,211.40999603271484,191.20249938964844,227.95000457763672,199.92374992370605,218.30999755859375,0.12472095268643223,10.715117220679963,-1.125062032283079,2.9944258632308203,209.4774990081787,9.054375267028808,0.05114934891102372,197.5189998626709,223.9955020904541,0.8323759464179001,-0.075959666191655,1.009180154323059,1.0533986417027446,1.0450863558590209,0.06892844671213516,49.320945720479216,230.91710864027348,209.48687419891357,188.05663975755365,202.97964205060686,5.887716614811357,203.8458914075579,7.340482328478648,203.55552756495746,206.96068568487667,7.91142143545931,0.3047688720701542,6668500,4.6557092499919905,0.7388874638437106,43295900.0,-16.260155231241374,89.0859394939463,92.09290994229893,26.319655487659237,22.622359846812614,27.295763542686114,-0.07647199139050062,6.736363784275399,211.1027149047852,206.43363552856448,202.65999603271484,198.88635653686524,194.21727716064453,0.02,0.0,213.40040048025406,0.07819366657638516,0.0685322388501945,199.8054940359933,199.61427307128906,10.148048044974892
2022-03-18,1,215.08999633789062,191.20249938964844,226.49749755859375,199.92374992370605,216.46999835968018,0.08442707594121233,9.862574109051996,-1.0156918104195154,2.994615886462777,209.4774990081787,8.257387371063231,0.04726627084920229,197.5189998626709,221.85675163269045,0.8067625211216392,-0.06661222171770727,1.0308162870512396,1.0704283410230035,1.0491376163545378,0.08254060946685393,50.78642666994722,228.38502198977147,208.6598737716675,188.9347255535635,205.42107009887695,6.92977983326491,203.7807126726423,7.227416665033325,205.5085366274944,207.48800304293317,10.568636240411209,-2.9661850845313356,14620800,4.668633093970865,1.563799696990278,57916700.0,-0.46024520815903536,89.0859394939463,92.09290994229893,68.46715836440323,26.460876132808647,24.74932302767641,0.036994452314318846,6.896574627417818,211.56875537109372,206.8106159057617,202.96499633789062,199.11937677001953,194.3612373046875,0.04,0.0,213.45799987372865,0.11387315014249899,0.10678395613167352,202.51630510602678,199.82371303013392,9.772011104218674
2022-03-21,0,216.49749755859375,191.20249938964844,223.71750259399414,199.92374992370605,215.31812191009521,-0.06218055528844696,9.116102403929467,-1.041124695438557,2.994771202518179,209.4774990081787,7.744049816131593,0.04380856535488247,197.5189998626709,219.82524795532228,0.781849055780579,-0.038564288247758795,1.040405685534634,1.0705283546896531,1.0393742560235923,0.08067735816499066,56.31709383649025,226.32170351849123,208.0894987106323,189.8572939027734,208.09535544259208,7.098492331408989,204.13981982639856,7.745213302443598,207.89962313648434,208.36460892257364,8.631311281762942,-0.4224498765615331,6101500,4.746210074425471,0.6597250379789265,64018200.0,-6.811910003567638,89.0859394939463,92.09290994229893,76.87179551980933,25.175097397435948,23.54671155313041,0.07598001754329058,6.729030196596092,211.56875537109372,206.8106159057617,202.96499633789062,199.11937677001953,194.3612373046875,0.04,0.0,213.48413647350236,0.08341246053639972,0.10335005248299543,205.1878901890346,200.3889879499163,9.422251140390276
2022-03-22,0,218.26499938964844,191.20249938964844,221.6500015258789,199.92374992370605,215.31812191009521,-0.1994423220590314,8.619512678777033,-1.088164928388944,2.994868538963695,209.4774990081787,7.449049377441407,0.04149412691433865,197.5189998626709,218.04749755859376,0.7643441887371656,-0.023246126468821935,1.0507224622955273,1.068016870373568,1.0318467826355378,0.069874031593532,58.74159385370498,224.96752381641636,207.7284984588623,190.48947310130825,210.89178357805525,6.615039442937866,204.87107004438127,8.578904228945252,210.05026051015213,209.25630237862657,9.46518051424613,2.3774058799156665,6259900,4.7474673767016755,0.6905490890618476,70278100.0,-3.343482666901655,89.0859394939463,92.09290994229893,96.46933842201967,26.148751287294974,22.882348281883356,0.10033403269768705,6.428022662922963,211.80560516357423,207.0022038269043,203.12000274658203,199.23780166625977,194.43440032958983,0.06,0.0,213.52645971531555,0.059813765422994436,0.0905507245566333,208.236323765346,201.08875492640905,9.237014522065316
2022-03-23,1,215.36749649047852,191.20249938964844,219.62249755859375,199.92374992370605,215.31812191009521,-0.28696956463981166,8.374236289472464,-1.1363743790696876,2.9949148034698907,209.4774990081787,7.313649291992187,0.040346245016596595,197.5189998626709,217.91174774169923,0.7544569304594128,-0.0061810524151021526,1.0376193698928018,1.0400659569710893,1.0046086448274885,0.022467767496649138,61.59811605601175,224.3077209309957,207.5592483520508,190.81077577310586,213.03928320748466,4.810691315729788,205.32874843052454,8.975572942388702,212.09644470931008,210.18319294979167,9.852029144755212,4.921225910987003,6008000,4.749205268723754,0.6726369540562539,64270100.0,-14.863262272538593,89.0859394939463,92.09290994229893,72.09588135694803,24.8732023755728,25.17048055087152,0.12137226299357678,6.273364267538569,211.80560516357423,207.0022038269043,203.12000274658203,199.23780166625977,194.43440032958983,0.06,0.0,213.5417115274101,0.013262811998448587,0.04142807519007447,210.24666486467635,201.6106011526925,9.18465035217142
2022-03-24,1,215.9900016784668,191.20249938964844,218.26499938964844,199.92374992370605,215.1593713760376,-0.35638053516426693,8.115103740883317,-1.1294776477129396,2.994962451951574,209.4774990081787,7.143449249267576,0.039137886617187916,197.5189998626709,216.63499755859374,0.8421914093294577,0.02558393097892967,1.0416862761162833,1.0343964882527834,1.0030837173650815,0.021664092198569573,60.607188993294116,223.57670578041166,207.34649829864503,191.1162908168784,214.75071225847518,2.754763564528653,206.31874874659948,9.3520903806251,212.92020636674448,210.47910743323519,7.503680073229392,3.066375112021134,5487000,4.2477777602206865,0.6430186132032687,69757100.0,-6.869328683037009,89.0859394939463,92.09290994229893,76.98763104625556,24.237067073532177,24.08593555224169,0.07954240472901658,6.08611754494137,211.80560516357423,207.0022038269043,203.12000274658203,199.23780166625977,194.43440032958983,0.06,0.0,213.56234883591807,0.018084001377165038,0.025676212981109527,211.81151035853796,202.80279758998327,9.185175488898448
2022-03-25,0,217.86749649047852,191.20249938964844,218.26499938964844,199.92374992370605,215.5231227874756,-0.3848661322964567,8.315638179605072,-1.1979439358115584,2.9949258716007936,209.79749870300293,7.38324935913086,0.04004713902726312,197.5189998626709,216.63499755859374,0.8348243559996819,-0.008640355718236912,1.0492243328810058,1.0343661033100706,1.0075170328257665,0.012913200055220786,58.89459840569808,224.27752479518426,207.64624843597412,191.01497207676397,215.78392628261022,2.266967797858561,207.93839154924666,9.239777849410109,213.72914555739317,210.87317592253842,5.8722628574567795,6.856975517430013,5051400,3.8559172475739576,0.6040480330233015,74808500.0,-3.4650891525808913,89.0859394939463,92.09290994229893,89.45701119601853,24.827347739687976,23.135585867081463,0.07363504036643903,5.882238238867532,211.80560516357423,207.0022038269043,203.12000274658203,199.23780166625977,194.43440032958983,0.06,0.0,213.59030490082995,-0.0031035813897601905,0.02333096200279967,212.73052106584822,204.7451934814453,9.133694686927175
2022-03-28,0,219.43999862670898,191.20249938964844,218.26499938964844,199.92374992370605,215.5231227874756,-0.38495498369587894,8.315330739379547,-1.1979472891398413,2.9949259285088647,209.79749870300293,7.3830493164062485,0.040045706655320784,197.5189998626709,216.63449745178224,0.8347601416698219,0.008634149491912043,1.0567985915260032,1.032431691954572,1.0121887951919846,0.013591386049710996,62.45017521491925,224.27665986132746,207.64599838256837,191.01533690380927,216.93106951032365,1.6257764319075074,209.95535578046525,8.344036489660756,214.77608494262665,211.20885090897187,3.4336640285699067,11.616737096007153,4316800,3.8561325088762786,0.5291525444505053,79125300.0,-0.8158179283130853,89.0859394939463,92.09290994229893,104.16923096274368,26.318185314959695,22.128553230815356,0.0954030858931543,5.709475682489823,214.90535803222656,211.14731945800781,208.11000061035156,205.0726817626953,201.31464318847657,0.08,0.0,213.62582786794965,0.01718582747241859,0.007576164290407274,213.7560097830636,206.78075190952845,9.402628660156719
2022-03-29,0,226.3874969482422,191.20249938964844,219.43999862670898,199.92374992370605,215.5231227874756,-0.33302145144083894,8.51930464070095,-1.2026314478652833,2.9948877600031567,209.79749870300293,7.520549316406249,0.040994090171531626,197.5189998626709,217.9072467803955,0.8577233023771379,0.03768856725997564,1.0893552766344083,1.0556299641951044,1.0414079033320547,0.03721392610499774,67.08912283671485,224.85648266397027,207.81787338256837,190.77926410116646,218.5449981689453,3.734077384838963,211.98303413391113,8.6585764626759,215.9208303011631,211.64342150617122,3.7983079062881826,14.768373492605768,8032500,3.708414713182752,0.9924404026101831,87157800.0,-2.1224317379111275,89.0859394939463,92.09290994229893,145.97278384746025,33.28093510440109,19.960611398953485,0.16500894360391322,5.876353740739742,221.13763885498048,216.39117965698242,212.55500030517578,208.71882095336915,203.97236175537108,0.1,0.0,213.76672018599004,0.044170842335459204,0.051050555673009236,215.01825387137276,208.76727948869978,10.391323505158296
2022-03-30,0,224.6699981689453,191.20249938964844,226.3874969482422,199.92374992370605,216.11687564849854,-0.10413575174924958,9.412590905484004,-1.042211794444117,2.994711616355342,209.79749870300293,8.170874500274659,0.045130522343947564,197.5189998626709,218.3824993133545,0.8253244790999832,0.08825756658884246,1.077224589296741,1.0368028817596022,1.025841227578319,0.0431936194182303,76.06025719294365,227.38893017064817,208.56374835968018,189.73856654871219,219.7124982561384,4.231665837689894,213.90392684936523,8.237468617294308,218.51693844197183,213.0429678278949,5.252452834953801,14.337119670829388,7084000,3.8615038013619984,0.8849911301001924,80073800.0,-15.0231900641907,89.0859394939463,92.09290994229893,109.5652299452986,31.082430926093405,19.928900908886913,0.1511455608620385,5.841534219949413,221.17539971923827,216.4523010559082,212.63500213623047,208.81770321655273,204.09460455322267,0.1,0.0,213.86419480245138,0.04318049165015769,0.025083356094600932,215.98629542759485,210.58709280831474,10.898841466042898
2022-03-31,0,223.01000213623047,191.20249938964844,226.3874969482422,199.92374992370605,216.83999729156494,-0.1286247868914241,10.042938873675748,-1.1572220617779565,2.9945789372184377,211.02249717712402,8.826536808013916,0.047961493739821434,197.5189998626709,219.96299858093263,0.8669887994510699,0.07518184893426347,1.065016222433668,1.0225196615941081,1.0096844029742518,0.03250150656609563,71.67064266152971,229.48175119858445,209.39587345123292,189.30999570388138,220.39035579136439,4.3398121613637075,215.64106968470983,7.2924426523171215,220.0323879128019,214.10502997270376,3.7748707040550085,13.59734954461934,10759500,3.907786642009325,1.3263560802877192,69314300.0,-22.968987562964184,89.0859394939463,92.09290994229893,88.10263246517597,28.985929357210242,21.40330683377429,0.15368993052336474,5.815654881896435,221.57659899902342,217.1016998901367,213.48500061035156,209.8683013305664,205.39340222167965,0.1,0.0,213.98703237931352,0.020523676092003784,0.03302602933503268,216.4486040387835,212.34246390206474,11.194276404422302
2022-04-01,0,224.57500076293945,191.20249938964844,226.3874969482422,199.92374992370605,217.966872215271,-0.20517691623858964,10.47018817526243,-1.269133734266361,2.994485390991496,213.24999618530273,9.344949493408205,0.049834694080049854,197.5189998626709,223.17600173950194,0.8883814441035345,0.10329988208842873,1.068904042000901,1.024247645676633,1.0103475528269372,0.03078708104930228,71.69742820533645,231.03874995434566,210.0983736038208,189.15799725329592,221.70571354457311,3.9407019980511686,217.3724983760289,6.17006327602976,220.7387013640946,214.89325009890257,2.1739641077822167,12.240172830032652,6559600,3.526556769647853,0.8309139090296462,75873900.0,-8.938331342249981,89.0859394939463,92.09290994229893,96.43227796086983,28.115830969936532,20.107951743319166,0.21363263774703103,5.747258493329865,222.34123669433595,218.33937615966798,215.10499572753906,211.87061529541018,207.8687547607422,0.1,0.0,214.08010125546159,0.03630450633889559,0.041645371074587975,218.08489336286272,214.16577911376953,11.455762463753164
2022-04-04,0,226.9250030517578,191.20249938964844,226.3874969482422,199.92374992370605,218.55874919891357,-0.3612088118219516,10.75496539190958,-1.2109190581372191,2.994426970503587,215.22874641418457,9.392249526977537,0.050918159408275286,197.5189998626709,224.58450050354003,0.859772184570411,0.15053090627440585,1.0743505960330386,1.0305076780598657,1.014795436531195,0.034109571964505925,77.93897847551213,232.73055456311607,211.2206237792969,189.7106929954777,223.2678565979004,3.431821134973661,219.00928442818778,5.335604850282041,221.66619391079126,216.0013008136655,4.275252497476101,12.09973384043885,8521200,2.9746587236394544,1.1138998258796216,84395100.0,-6.744602650665059,89.0859394939463,92.09290994229893,105.69780244440001,29.899858980421982,19.016438173863857,0.3135328517535164,5.642261262502005,223.99136419677737,220.74432339477542,218.12000274658203,215.49568209838867,212.24864129638672,0.12000000000000001,0.0,214.2228580546232,0.03157138304154028,0.042622601419053247,219.5460706438337,215.67879050118583,10.878495731224987
2022-04-05,0,226.80500030517578,191.20249938964844,226.9250030517578,203.09124851226807,220.33249950408936,-0.49349940515736007,10.613116186622783,-0.9732117592526333,2.994477385289561,215.67874908447266,9.039799880981445,0.049871967393229875,197.97775001525878,224.841748046875,0.8070725253422188,0.1868307358750111,1.0657766654904188,1.025108507225406,1.0075139877881494,0.001844197946271997,82.8464214232006,234.03348144245945,212.80724906921387,191.5810166959683,224.54464285714286,2.6646010354353713,220.16428456987654,5.129559826632293,222.9575907550138,217.491614057307,5.062734982320797,11.232294945715871,4658000,2.675436120697232,0.6355369966988369,79737100.0,-15.350918613116141,89.0859394939463,92.09290994229893,98.86758814806282,28.468916939309928,18.106352916505035,0.30638686478557337,5.501860710931537,224.3972844848633,221.401363861084,218.9800033569336,216.5586428527832,213.56272222900392,0.12000000000000001,0.0,214.29657082613198,-0.008898936507991673,0.024097362917329706,220.6191885811942,216.6748548235212,9.95223696308558
2022-04-06,0,220.81999588012695,197.7775001525879,226.9250030517578,208.9787483215332,223.40125179290771,-0.49654995237472854,9.794283105950825,-1.019087948265871,2.9946820542117982,216.24374961853027,8.125412445068358,0.0456424015921011,198.62100219726562,226.42924728393555,0.8484842558980915,0.1454797995210898,1.0290446807079938,0.9942200274020485,0.9805636620928277,-0.01713625459650059,81.14900332632081,234.17594032689186,214.58737411499024,194.99880790308862,224.74178532191686,2.2414332614211645,220.83642741612024,4.468079243537684,223.92080919546322,218.93824802694553,4.102265807735052,7.676787861701481,7430000,2.4419870416014793,1.0209051980288149,72307100.0,-53.9841920657571,89.0859394939463,92.09290994229893,39.791790906126714,25.772617997947798,24.873581803932378,0.2251169688531931,5.6426653014943895,224.7678026123047,222.00110083007814,219.76499938964844,217.52889794921876,214.7621961669922,0.12000000000000001,0.0,214.3509544023494,-0.022058380090339336,-0.039935193402457554,220.37262180873327,217.06431579589844,9.304621388686824
2022-04-07,0,216.70499420166016,197.7775001525879,226.9250030517578,211.21624660491943,223.40125179290771,-0.6783287541137014,9.100073116817336,-0.6371874635495454,2.9948334391892124,217.18249702453613,7.251200408935546,0.04218301446362422,200.170499420166,226.42924728393555,0.836706565267905,0.11650716441335077,1.0045270831785695,0.9733032476268292,0.9655923475745547,-0.0282723100944986,63.306511623516315,233.92852014263124,215.7283739089966,197.52822767536193,223.3585706438337,3.6201474009215984,220.95178440638952,4.326923641757193,223.1316802963142,219.11996001323402,0.6288722484753075,4.45106665909778,6995100,2.9450967062714657,0.9615878964001798,65312000.0,-84.12596924120913,89.0859394939463,92.09290994229893,-6.945831173370017,24.02422953043089,29.473700474753528,0.22864323455012017,5.620299285810818,225.56784246826174,223.29608059692384,221.45999908447266,219.6239175720215,217.3521557006836,0.02,1.0,214.3666833040653,-0.025341705986564045,-0.03482916380992454,218.69569832938058,216.85697610037667,8.294406771030763
2022-04-08,0,216.06999969482422,198.69000244140625,226.9250030517578,214.16999626159668,223.40125179290771,-0.7667280046433947,8.1149061351844,-0.18475740882344738,2.9950237555023924,217.28624534606934,6.2047751235961925,0.03745201592335235,203.64249839782715,226.42924728393555,0.7979186727646852,0.09066883858721847,0.9972089552635853,0.9701397087268664,0.968203045345699,-0.03787153974940016,54.02120760336376,232.904560881819,216.67474861145018,200.44493634108136,222.129999433245,4.462258714580772,220.9212488446917,4.362141176611784,221.5227560727366,218.89513002913714,-4.276960025224225,0.7508475016348449,5438600,3.176914357124008,0.7475887835565107,59873400.0,-75.86637987200015,89.0859394939463,92.09290994229893,-15.951129441068526,23.02692941169293,27.120603095011287,0.2703862631105475,5.671061684154435,225.42624462890626,223.0668840942383,221.16000366210938,219.25312322998047,216.89376269531252,0.04,0.0,214.38086259823058,-0.041438332199823624,-0.021599059830559014,217.71924918038505,216.85277230398995,6.8235617245509435
2022-04-11,0,215.1775016784668,200.33499908447266,226.9250030517578,215.29812145233154,223.40125179290771,-0.7217558098371968,6.99587536653519,0.1785826784147022,2.995210896319029,217.28624534606934,5.332750701904297,0.03215847578064242,209.9724983215332,226.42924728393555,0.7421175327394461,0.0785434431440349,0.9891228922354632,0.966912813347575,0.9716095230071091,-0.051768210709736584,52.0729355477094,231.5354992071915,217.5437484741211,203.55199774105068,221.0110707964216,5.135973264272395,220.700713293893,4.579399110017425,220.16560173072526,218.7400684608252,-3.827835734281773,-0.19746087995951617,6942700,3.1913542682941984,0.961292560287611,52930700.0,-89.66585525682163,89.0859394939463,92.09290994229893,-48.161657505504714,21.871321162547478,25.75955351266966,0.2744415271412259,5.543681334104967,225.42624462890626,223.0668840942383,221.16000366210938,219.25312322998047,216.89376269531252,0.04,0.0,214.38739206586894,-0.05703876463881363,-0.05128976064870004,216.7357940673828,216.59219905308314,5.5218441098452935
2022-04-12,0,213.89749908447266,204.0099983215332,226.9250030517578,215.3199977874756,223.40125179290771,-0.34901761729705255,5.819314895507289,-0.10292635307505948,2.9953756918460264,217.28624534606934,4.634550704956053,0.02665914563976361,211.33249626159667,226.42924728393555,0.6993196555880359,0.05473998063238485,0.9798962047021291,0.9630055659360587,0.9761860785438626,-0.05691012633467307,48.51345262022247,229.9245033948354,218.2858736038208,206.64724381280618,219.4857134137835,5.475454743814207,220.5957134791783,4.725608006193026,218.9430127600033,218.49398685993907,-3.512174513580346,-1.4145638191260408,7446600,3.13946231600676,1.0370298160346485,45484100.0,-96.2243979200649,89.0859394939463,92.09290994229893,-92.22218326861929,20.11359695989493,27.151885585063017,0.18429313828713084,5.597053299792432,224.86456347656252,222.15772222900392,219.97000122070312,217.78228021240236,215.07543896484376,0.06,0.0,214.3751962697559,-0.06497404370578697,-0.07174856549738338,214.64000156947546,216.36244746616907,5.002176891854803
2022-04-13,0,211.18000030517578,210.6349983215332,226.9250030517578,215.3199977874756,223.40125179290771,0.3002086047940099,4.938914857239583,-1.0558070947775204,2.9954779970895435,217.28624534606934,4.239050674438476,0.022574774861519056,213.64874877929688,226.42924728393555,0.7522163987588706,0.015488882611802542,0.9652608113210908,0.9561475232059075,0.9752741008362752,-0.043655446765718975,42.1921542207653,228.65807835644694,218.78024864196777,208.9024189274886,217.2364273071289,5.133394781673089,220.25214195251465,5.233753743621499,217.70476796349368,218.03499440779518,-4.754537077676749,-0.6825530453574495,8052900,2.8192913801481434,1.130750533929256,37431200.0,-72.36065211078684,89.0859394939463,92.09290994229893,-118.65845949970051,18.420479557728008,29.314609442174117,0.20270513319576783,5.674491918527428,224.03148376464847,220.80926269531253,218.2050018310547,215.60074096679688,212.37851989746093,0.08,0.0,214.3468553974052,-0.02620897540945466,-0.056703169709106854,212.6128409249442,216.07945578438895,4.907250624787472
2022-04-14,0,213.8849983215332,211.18000030517578,226.9250030517578,215.3199977874756,223.40125179290771,0.3348331822381175,4.895208984208432,-1.0858146542219924,2.995482600676504,217.28624534606934,4.217250595092776,0.02237221764506107,213.64874877929688,226.42924728393555,0.7169959595566898,-0.0010879132106103044,0.9775030542923027,0.9743458856350782,0.9966403517386738,-0.013013063637576927,36.93769794250045,228.59791670956676,218.8074987411499,209.01708077273307,215.3907127380371,2.9982857057461625,219.96767779758997,5.4759574034497875,216.079610820801,217.1699688782935,-6.938416893175433,-2.2269555701246846,8191600,2.8870060411176297,1.1380565263268307,45622800.0,-74.535599220122,89.0859394939463,92.09290994229893,-84.6089730052657,20.326918128069714,28.01440309434123,0.10771654970118562,5.513292898613243,224.03148376464847,220.80926269531253,218.2050018310547,215.60074096679688,212.37851989746093,0.08,0.0,214.34113430432515,-0.015544689326131178,-0.028400534295051162,210.74959891183036,215.68439374651228,4.948641393099434
2022-04-18,0,213.04750061035156,211.18000030517578,226.9250030517578,215.3199977874756,223.40125179290771,0.42595068137416225,4.735309399737459,-1.1019043066488206,2.995499046260841,217.28624534606934,4.118250503540037,0.021629207454349816,213.8962490081787,226.42924728393555,0.7855358286111445,-0.005602296884437426,0.9731251327711549,0.9745818981568174,0.995353719328946,-0.013988518020741525,41.679226571137065,228.40186765506573,218.9312488555908,209.4606300561159,214.28035627092635,1.8850990376132288,219.5110707964216,5.78134247746957,215.5364961115244,216.9797472711349,-5.6965243121880755,-1.8279450735412293,4744400,2.8290062209027687,0.7076900358215501,40878400.0,-72.81378337642947,89.0859394939463,92.09290994229893,-84.23944148803409,19.17280179761885,27.754324593935397,0.001961411609682909,5.427262080480172,224.03148376464847,220.80926269531253,218.2050018310547,215.60074096679688,212.37851989746093,0.08,0.0,214.33647549141995,-0.017559246015605323,-0.013786715546222498,209.93145098005022,215.15203639439179,5.123033395204496
2022-04-19,0,214.4375,211.18000030517578,226.9250030517578,215.3199977874756,223.40125179290771,0.39783274086745846,4.837963338501058,-1.1375207931518725,2.9954885624653973,217.28624534606934,4.199950332641601,0.022108407000572965,213.80124855041504,226.42924728393555,0.7973558465706568,-0.0159355049695596,0.9799312633183834,0.9861405748512782,1.0046852122986822,-0.0034390290466916884,39.26569155218585,228.50505074621594,218.82912406921386,209.15319739221178,213.95642852783203,1.5669987804118608,218.65749958583288,5.566152390092582,214.8964250546528,216.7377580691178,-3.5198330834109433,-2.91309608838986,5028800,2.811934774519033,0.756161631653893,45907200.0,-61.35026756454048,89.0859394939463,92.09290994229893,-60.2468397653855,19.03822329171163,26.239260976833794,0.005524806006967665,5.330229231081194,224.03148376464847,220.80926269531253,218.2050018310547,215.60074096679688,212.37851989746093,0.08,0.0,214.3396925574677,0.0044236938532000725,-0.0058990725214028,209.868412562779,214.2820554460798,5.156142868782092
2022-04-20,0,218.66500091552734,211.18000030517578,226.9250030517578,214.9925012588501,223.40125179290771,0.41356741300101524,4.907929734505209,-1.179894522247353,2.9954812665801906,217.28624534606934,4.282350234985353,0.022438699321591052,213.80124855041504,226.42924728393555,0.8253554066720065,-0.01753601997732836,0.9997205488096914,1.011389793913786,1.0252028405508997,0.02228872170764329,41.89590316735777,228.5419836602946,218.72612419128419,208.91026472227378,214.3271429879325,2.2903557744960894,218.22857121058874,5.291799787837893,214.7730520882745,216.69394010926783,-1.0463506898000163,-5.278558714297837,7178300,2.7993985127514684,1.0719720444719885,53085500.0,-51.88041870047988,89.0859394939463,92.09290994229893,-1.6716611170664122,23.523967462087377,24.432386211209497,-0.039326617775753525,5.315201375866791,224.03148376464847,220.80926269531253,218.2050018310547,215.60074096679688,212.37851989746093,0.08,0.0,214.37572527131937,0.030226944237679243,0.014155834821326223,209.9818878173828,213.85056849888392,5.1608035324269155
2022-04-21,0,218.80749893188477,211.18000030517578,226.9250030517578,214.9925012588501,223.40125179290771,0.40166028986993285,4.906824764997869,-1.184906690894585,2.995481402941352,217.28624534606934,4.266350173950196,0.02243159636051729,213.80124855041504,226.42924728393555,0.8228958167400778,0.015311058905281987,1.000280574865096,1.0158736417099605,1.0213052417148611,0.03611847057338058,53.343201196050664,228.55977379757388,218.74612426757812,208.93247473758237,214.84571402413505,2.8560592164562446,217.92839241027832,5.115981432041499,215.74255841794871,217.18781950747285,1.201000242684448,-2.672807808055611,8850300,2.888917096230166,1.2941939455711187,61935800.0,-57.95199048659418,89.0859394939463,92.09290994229893,-5.776076483831846,24.920654747225395,21.73451800978012,-0.05632701044938095,5.547862140132007,224.03148376464847,220.80926269531253,218.2050018310547,215.60074096679688,212.37851989746093,0.02,1.0,214.41838467380956,0.01491084355210992,0.023888348024982988,210.2200448172433,213.47791944231307,5.103357737575588
2022-04-22,0,212.22999954223633,211.18000030517578,226.9250030517578,214.9925012588501,223.40125179290771,0.3275726289087996,4.84528402594375,-1.1568164607943443,2.9954878971568206,218.26624870300293,4.128750076293943,0.022132859211417853,213.80124855041504,226.42924728393555,0.8217789641390457,0.01304457257985595,0.9694491953735725,0.9862573184947023,0.9836004782086967,-0.007737797378425393,53.3227637105249,228.6086924415359,218.91812438964843,209.22755633776094,214.60749980381556,3.0135271157208066,217.04660660879952,4.943224500870952,216.51518891900105,217.7436669245511,1.686978064668751,-1.8844460625485817,6201100,2.8869787278452104,0.9020870883321186,55734700.0,-95.46896389607159,89.0859394939463,92.09290994229893,-118.48746215820657,22.26110013067006,28.587296863836734,-0.13111083576611654,5.766739814496366,224.03148376464847,220.80926269531253,218.2050018310547,215.60074096679688,212.37851989746093,0.02,0.0,214.39346124428252,-0.021711482059937337,-0.023913162749148932,209.76754324776786,212.20377240862166,5.615363594120651
2022-04-25,1,208.04000091552734,211.18000030517578,226.9250030517578,214.30249977111816,223.40125179290771,0.2979808826994797,5.024867045011858,-1.2191653751545304,2.9954689573897606,218.26624870300293,4.2868876266479505,0.022972908105306385,212.96575050354005,226.42924728393555,0.7608741144873548,-0.025875805427858136,0.9511264239328721,0.9688006109917875,0.9656628995208696,-0.023504146636212253,39.460651733262665,228.77985837286064,218.73012428283693,208.6803901928132,214.15892846243722,3.751973906258276,215.69767788478308,4.6053714295482635,215.4500048100595,217.3949131676699,-0.7795787932881801,-5.497050508188337,6839400,3.218710838483711,0.9821686290221826,48895300.0,-80.47339644082031,89.0859394939463,92.09290994229893,-132.9503428263524,20.816207228926285,30.0020830905656,-0.11634982289588841,5.726231802256218,223.40624462890628,219.9518840942383,217.16000366210938,214.36812322998048,210.9137626953125,0.02,1.0,214.34865835850687,-0.015105282158989097,-0.013346523715449558,209.30243573869978,210.95763833182198,5.916183172796253
2022-04-26,1,204.43500137329102,208.04000091552734,226.9250030517578,213.8943738937378,223.40125179290771,0.13006203312629577,5.539365504447638,-1.1018137243426533,2.995410435990075,217.68499755859375,4.77175006866455,0.025382135468769454,212.12499961853027,226.42924728393555,0.7400522564675984,-0.05195040914384192,0.9367493253963147,0.9555861783640671,0.9533613820212207,-0.04664528651336164,32.89638397564771,229.31748051298464,218.23874950408936,207.16001849519407,212.80892889840263,5.262858502628621,214.09982081821985,4.327497127341328,213.60682857045103,216.38679503234945,-1.4868829364100913,-8.322133692743904,8155300,3.2987870324581086,1.1397254837016866,40740000.0,-100.0,89.0859394939463,92.09290994229893,-170.87688794664194,18.60311678497062,31.893921502189695,-0.19672873535739407,5.949492451279506,218.5344800415039,215.20276119995117,212.51000213623047,209.81724307250974,206.485524230957,0.04,0.0,214.2502700357332,-0.0676867367706675,-0.05662150524794025,207.66474042619978,209.20716966901506,6.937410685202083
2022-04-27,0,216.58250045776367,204.43500137329102,226.9250030517578,213.6756238937378,223.40125179290771,-0.08029146414939409,6.291002979304886,-0.8238814794459621,2.99531347392149,216.3874969482422,5.326850032806396,0.02892568108050357,210.86600036621093,226.42924728393555,0.7296945058062938,-0.09696867482027975,0.9958342662478773,1.0174760723836451,1.0195212199256583,-0.009523702691534797,24.75905795042992,230.0705056000282,217.48849964141846,204.9064936828087,213.31392887660436,5.455636667981275,213.79714257376534,3.9533272810820397,211.3406771921476,214.99072663412403,-4.4182607580715,-9.863097772000167,15955800,2.837367340880649,2.112886438213585,56695800.0,-42.988610734247516,89.0859394939463,92.09290994229893,-7.543937207698374,28.184222657307277,25.156913538508917,-0.30504895811548627,7.003691844517001,218.5344800415039,215.20276119995117,212.51000213623047,209.81724307250974,206.485524230957,0.04,0.0,214.28664012818666,-0.016896953560133432,-0.007371394284004449,207.79643031529017,208.8639406476702,6.468789929780156
2022-04-28,0,221.31499862670898,204.43500137329102,226.9250030517578,213.6756238937378,221.36749744415283,-0.014498040346017973,5.9512862196229115,-0.5783019428576655,2.995356029614279,216.32625007629395,4.829150161743167,0.02742550331463351,210.86600036621093,224.88349838256838,0.7303851259731856,-0.03599723050293559,1.0198930121024339,1.038398911862219,1.0438451194084681,0.011459843502003686,48.91113136221005,228.90082225614037,216.99824981689454,205.0956773776487,214.29642868041992,6.2527512976736315,214.12642860412598,4.382824029649769,212.66600465437622,215.1279186012797,1.6592543152512114,-1.9189817504858677,10799100,4.100677951171116,1.3956986926512278,67494900.0,-17.918554006410968,89.0859394939463,92.09290994229893,69.22665963673006,28.263245882429306,22.483509575125616,-0.32002161248809763,7.276426918648257,219.30611584472655,215.82693780517576,213.01499938964844,210.2030609741211,206.7238829345703,0.02,1.0,214.37283224634368,0.01945015122376126,0.013177860537012418,208.49129159109933,209.17985207693917,6.311068237542667
2022-04-29,0,216.32500076293945,204.43500137329102,226.9250030517578,213.6756238937378,220.94374656677246,-0.024931014211925805,5.777421352865358,-0.42119250250879814,2.995377111296948,216.32625007629395,4.627850189208982,0.026644874024338492,210.86600036621093,224.7980007171631,0.6997506635575818,-0.007600571693129957,0.9976686901648211,1.0101823805597052,1.0179018051272986,0.019295110161314355,55.47403470887764,228.38534254551342,216.8304998397827,205.27565713405198,213.96214294433594,6.039175514788675,214.1446429661342,4.392042721213388,214.84235478293198,215.77067918569713,3.207227572933365,2.127318035300504,7965000,4.245293861396085,1.0483449574804973,59529900.0,-49.517391699675045,89.0859394939463,92.09290994229893,-12.515100012464435,25.84406359541001,27.251870511078486,-0.332647090826341,7.388878785219498,219.30611584472655,215.82693780517576,213.01499938964844,210.2030609741211,206.7238829345703,0.02,0.0,214.38303523021912,0.023826674379422208,-0.015338394660913208,207.83845955984933,208.91017368861608,6.206574459343786
2022-05-02,0,210.60000228881836,204.43500137329102,226.9250030517578,213.6756238937378,219.3106231689453,0.08469495831371612,5.600922996648556,-0.15569277005786386,2.995397763385003,216.19750022888184,4.273374519348144,0.02587076220752047,210.86600036621093,224.7980007171631,0.6570602076427186,-0.036736056871747136,0.9727651287792127,0.9823288193115316,0.9871589736877537,0.012305332445804451,48.41446830171863,227.69809576441529,216.49624977111816,205.29440377782103,212.78964342389787,5.730518805104797,213.81767872401647,4.478766246991152,215.22772667607776,215.68467749767933,-1.0701301730000485,0.11801780370962935,8803700,4.3616010642371315,1.141870284874178,50726200.0,-56.23164686160527,89.0859394939463,92.09290994229893,-87.40821831077007,24.283488976576542,30.881346701245143,-0.32147843735600784,7.301776725980425,219.30611584472655,215.82693780517576,213.01499938964844,210.2030609741211,206.7238829345703,0.02,0.0,214.34376717104328,0.007525624765667205,0.016140578051549684,207.1491982596261,208.6846215384347,5.757716294670342
2022-05-03,0,210.51250076293945,204.43500137329102,226.9250030517578,212.84312534332275,218.7006254196167,0.25241085179574396,5.418215831594482,0.10093754932266208,2.995417634649244,215.6237506866455,4.104499435424804,0.025107871200665623,210.34400215148926,221.86399879455567,0.5374891905765004,-0.07194007069911107,0.9755094517396652,0.9830429344210996,0.9843863619006388,0.029728272305734604,41.40973431879879,226.63393151060106,215.7974998474121,204.96106818422314,212.54428645542689,5.794880668661977,213.57589312962122,4.564671177563948,214.07680701151972,214.95502292777581,-3.751012503287841,-2.127313196752538,6616900,4.461864334721419,0.8689662599084925,44109300.0,-68.69494058481591,89.0859394939463,92.09290994229893,-91.86546600575008,23.97786904073678,28.663893745018104,-0.35856925817169455,7.304507838372516,219.30611584472655,215.82693780517576,213.01499938964844,210.2030609741211,206.7238829345703,0.02,0.0,214.3096094544203,0.037096018554160226,-0.006620643634201592,207.2038312639509,208.48568725585938,5.108663584085437
2022-05-04,0,211.00000381469727,204.43500137329102,226.80500030517578,211.9674997329712,217.19499588012695,0.19905462280072528,4.887650929362444,0.3717703215609407,2.9954741326852616,214.8075008392334,3.750374412536621,0.022735705574999786,210.26525077819824,220.86949615478517,0.4222147742007064,-0.07183483397770805,0.9815009362136569,0.987128745973769,0.9810896290264344,-0.025775381811860898,41.35062057505856,224.75217659169607,214.9768747329712,205.20157287424632,212.96714401245117,5.512537419963323,213.5630362374442,4.572185873566379,213.18162382028157,214.29995090255144,-0.8092629614104447,-1.582532912269533,7191100,4.462153625264648,0.9289224662154525,51300400.0,-43.68440734010261,89.0859394939463,92.09290994229893,-48.00902522595699,22.942604367560772,26.063550732128963,-0.2916713987855982,7.459245919086377,219.30611584472655,215.82693780517576,213.01499938964844,210.2030609741211,206.7238829345703,0.02,0.0,214.28870677614657,0.0019148349382343,0.06673300153006057,207.84405735560827,208.573246547154,4.291804151340904
2022-05-05,0,208.7900047302246,204.43500137329102,221.31499862670898,211.13500118255615,216.6131238937378,-0.3080145273396802,4.1303975849276435,-0.16488965469349015,2.9955459339917474,214.16749954223633,3.303874206542969,0.019284106029931403,210.26525077819824,219.00874862670898,0.39794048652654584,-0.044470574443631956,0.9748041214967115,0.9803049467028487,0.9758799512465893,-0.05659351591263018,43.76962384461913,222.44742007830257,214.18662490844727,205.92582973859197,213.58928734915597,4.551007417544598,213.1991081237793,4.744125487948372,212.61227488637775,213.81920698118526,1.4228046943586599,-0.0852336822702922,7749600,4.301886382338831,0.9990054548513242,43550800.0,-82.62693360277927,89.0859394939463,92.09290994229893,-112.97344362211587,20.507498196275815,25.38123701538037,-0.2830853969515096,7.748689288275045,219.30611584472655,215.82693780517576,213.01499938964844,210.2030609741211,206.7238829345703,0.02,1.0,214.23479325985886,-0.0698811281895716,-0.04142719117936144,208.4240504673549,208.04439544677734,4.449708138108446
2022-05-06,0,203.12750244140625,204.43500137329102,221.31499862670898,210.90000343322754,216.3893756866455,-0.23772113471043246,3.9943056263777748,-0.2517815183867489,2.9955571180863974,213.89124870300293,3.243111381530761,0.0187012350219358,208.7150043487549,218.6792507171631,0.40867492244565157,-0.03652425963044515,0.9510376816158781,0.9582254292530437,0.9606612581810671,-0.061007735005145,42.282461020113814,221.5737366037077,213.58512535095215,205.59651409819662,211.66714477539062,5.757563218824883,212.49053682599748,5.455926041377345,211.64424539288808,212.88011361418216,2.1302630800395637,-2.3821182557410094,8825300,4.238590426690756,1.1244103416753464,34725500.0,-89.47791581295226,89.0859394939463,92.09290994229893,-171.75209275685253,19.445400807660757,26.750430255502692,-0.28231661776910494,7.58801492154916,219.09843469238282,215.49077593994141,212.5749969482422,209.65921795654296,206.05155920410155,0.04,0.0,214.13141750923913,-0.04837425122137484,-0.08084830204836459,206.84239632742745,207.31941332135878,4.876916906338646
2022-05-09,0,196.47000122070312,203.12750244140625,221.31499862670898,210.57812690734863,216.13374996185303,-0.3436456446085397,4.524933313795442,-0.2579898650671826,2.9955058279364777,213.46624946594238,3.624124069213866,0.021253172687887546,207.67950096130372,218.6792507171631,0.411553143891396,-0.05989955695699478,0.9228005308282974,0.9308165062291133,0.9409212310898946,-0.06709402143660592,36.21770207084236,221.95611739053035,212.90625076293946,203.85638413534858,208.1178594316755,6.436708636668865,211.20714405604772,6.888006377023307,209.50643069183707,211.29453967555506,-6.212412354608177,-4.656237759432001,10314100,4.397900408988283,1.2745100462150607,24411400.0,-97.19939596545429,89.0859394939463,92.09290994229893,-243.68959516980922,17.53555751207463,31.567021491754105,-0.33181695349714585,7.8132270026640835,217.17739483642578,212.3812961730957,208.50499725341797,204.62869833374023,199.83259967041016,0.06,0.0,213.93222079176326,-0.0875997994209925,-0.09444939223461132,202.96741376604353,205.7293526785714,6.292805045465565
2022-05-10,0,194.75250244140625,196.47000122070312,221.31499862670898,210.08187675476074,215.46437644958496,-0.8566599343596442,5.702777501302767,0.7653347770041465,2.9953672677166634,212.63875007629395,4.3181239700317375,0.026909254888054786,204.30425148010255,218.6792507171631,0.4854989889609754,-0.0869398534318784,0.9189635624193857,0.927765071999107,0.9454922807496108,-0.07486490476535035,30.677129233602596,223.33180584183893,211.9262508392334,200.52069583662788,205.03607395717077,6.992628202973621,209.49910845075334,7.800751526780208,206.22816478601686,209.20143279310182,-11.226079371110227,-8.378897711126493,11016500,4.596403176029056,1.3278827041966952,13394900.0,-92.3144839014343,89.0859394939463,92.09290994229893,-207.9526995186883,16.437970812325183,30.615914574401174,-0.32593145332552775,7.739403711284826,216.9154346923828,211.9572759399414,207.9499969482422,203.94271795654296,198.98455920410157,0.08,0.0,213.71092570756443,-0.0718258584937993,-0.08485798413389745,200.22858319963728,204.0335213797433,7.273948341623434
2022-05-11,0,194.98250198364258,194.75250244140625,221.31499862670898,208.6025037765503,214.90937519073486,-0.8830637354979691,6.759960787267405,0.3161606084862272,2.9952134550881646,211.70499992370605,5.0512490844726585,0.032052159783530355,202.46175231933594,218.6792507171631,0.6219666414962352,-0.08950547213039477,0.9245039291268627,0.9331650311497444,0.9613194389693585,-0.07591232958043659,29.613089265587867,224.42492245191517,210.90500087738036,197.38507930284555,202.8050024850028,7.401062386125009,207.79732295445032,8.202312585199014,203.34495877911954,207.33663025167567,-9.972263143626892,-10.935677119796026,9427300,4.598920470810516,1.1229225789353003,22822200.0,-83.06831140518386,89.0859394939463,92.09290994229893,-156.61122178498164,15.91007758151762,28.64516012046713,-0.2574254824016235,7.6808601671295955,216.9154346923828,211.9572759399414,207.9499969482422,203.94271795654296,198.98455920410157,0.08,0.0,213.53849065323794,-0.0829759384408455,-0.0567702390507265,198.15379769461495,202.65149797712053,7.807992140356114
2022-05-12,1,193.62749862670898,194.75250244140625,221.31499862670898,207.13875102996826,214.90937519073486,-0.7274503233523472,7.551898657434662,-0.34284876314837165,2.995079387040663,211.09000205993652,5.911724205017092,0.03596840158584472,196.32125129699708,218.6792507171631,0.7196253716883128,-0.076699963529341,0.9222146568150396,0.9363597743613344,0.9699585779312805,-0.0726208427606817,30.578421644993593,225.0630483372082,209.95925102233886,194.85545370746954,200.39285932268416,7.21972242744195,206.46857288905554,8.905617665825442,201.26422081701088,205.77369961123333,-7.41571706336348,-10.888565092396107,9308600,4.588327034526329,1.1005531968725875,13513600.0,-88.50770507871712,89.0859394939463,92.09290994229893,-148.49639940874323,14.899600228939837,28.186147906364912,-0.2774705560105984,7.6157828604924385,216.67471368408204,211.56763430786134,207.43999481201172,203.3123553161621,198.2052759399414,0.1,0.0,213.35147314943455,-0.053106358125054265,-0.09406821189305367,196.16173662458147,201.6827839442662,8.380263649124268
2022-05-13,0,198.31749725341797,193.62749862670898,221.31499862670898,204.10812664031982,214.90937519073486,-0.5994378721370294,8.338029918347786,-0.7949662764655385,2.994930280449568,210.8000030517578,6.842799377441406,0.03987930494095034,194.95950202941896,218.6792507171631,0.7589882284088557,-0.0947121109652166,0.9485170988283393,0.9720552419783463,1.0087770402603309,-0.023679733813375514,28.096432768826737,225.75768577511113,209.08162593841553,192.40556610171993,198.58107267107283,5.500969140725113,205.774108341762,9.149397004088229,199.3833898929042,204.29429670363626,-8.020902357359226,-8.765255126820666,6684500,4.511571754724713,0.7974108750643434,20198100.0,-73.47055485203823,89.0859394939463,92.09290994229893,-84.49677365231415,18.216582099737003,26.431701926443576,-0.2245199050008322,7.541066277570373,216.67471368408204,211.56763430786134,207.43999481201172,203.3123553161621,198.2052759399414,0.1,0.0,213.2551382588424,-0.015824325954048812,-0.027428891834802863,194.07301766531808,200.95853751046317,8.50955545629666
2022-05-16,1,197.7375030517578,193.62749862670898,221.31499862670898,201.92500114440918,214.90937519073486,-0.3854263947274678,8.576513230929738,-1.1004471956152604,2.9948797101239477,210.5562515258789,7.267350082397462,0.041173208744899784,194.95950202941896,218.6792507171631,0.8124411806511247,-0.06913952670054413,0.9492770862271152,0.9778432262698972,1.0107729016167992,0.006451375900542011,37.32330551830631,225.45627734686923,208.30325088500976,191.1502244231503,197.00214385986328,3.1781066559993705,205.29571560450964,9.396557612555515,199.1425979127529,203.61285260951803,-6.010666508052401,-4.673381858932554,5161300,4.69156350012305,0.6141772573658908,15036800.0,-77.53001266331334,89.0859394939463,92.09290994229893,-81.49960557985094,17.49199719223828,25.98776557108754,-0.21886076143663213,7.292365224628696,216.67471368408204,211.56763430786134,207.43999481201172,203.3123553161621,198.2052759399414,0.1,0.0,213.17715871588376,0.026879763426478576,-0.022838973129608985,193.08504813058036,200.75454929896765,8.638164167477754
2022-05-17,0,202.95000076293945,193.62749862670898,221.31499862670898,198.17249870300293,214.90937519073486,-0.1896444547138915,8.799258220337416,-1.2973524391547477,2.9948305919959575,209.65125274658203,7.685199966430662,0.04239835007192128,194.95950202941896,218.6792507171631,0.8154131244633378,-0.07787815539838969,0.9778943820009685,1.0100444509832296,1.0360750143188806,0.0420918767090015,36.0873357722938,225.13626744775496,207.5377510070801,189.93923456640522,196.97678647722518,3.121288583006865,204.3219656263079,8.825988957760435,198.7809091813587,203.09826306494324,-5.293597120584206,-3.2761015856104847,7265600,4.664254350300396,0.8532266095468937,22302400.0,-59.834177336115225,89.0859394939463,92.09290994229893,-32.460649757558905,21.066030088117902,24.202820728499063,-0.2057787305093855,7.270763803176985,216.67471368408204,211.56763430786134,207.43999481201172,203.3123553161621,198.2052759399414,0.1,0.0,213.10491032734132,0.05584079902072414,0.05901366158876888,193.30494471958704,200.07367052350725,8.398297457223988
2022-05-18,0,201.85000610351562,193.62749862670898,221.31499862670898,198.17249870300293,213.2537498474121,-0.02988058661836366,8.704543896048637,-1.27193881404886,2.9948469984869126,208.41500282287598,7.627037525177002,0.042058377971890354,194.95950202941896,218.6792507171631,0.8052101003771484,-0.07186792621951771,0.97529335847037,1.0083651818387735,1.0219063388084855,0.035221130357887986,43.41326792112746,224.37246383732432,206.96337604522705,189.55428825312978,197.74535860334123,3.6011843179012715,202.93160901750838,7.3534878506595085,199.79900270237079,203.43981970316372,-0.08738436515655906,-6.294368042667754,8748200,4.725791099827353,1.017950449939405,13554200.0,-67.87197265624991,89.0859394939463,92.09290994229893,-39.5278721159062,19.743541541009005,23.694991446947082,-0.2089436286482356,7.2035541026824665,213.8249969482422,209.2624969482422,205.5749969482422,201.8874969482422,197.3249969482422,0.1,0.0,213.00694098329896,0.01856427567528196,0.03508608492111062,194.33770533970423,198.6525595528739,8.041848537154218
2022-05-19,1,196.86249923706055,193.62749862670898,221.31499862670898,198.17249870300293,211.30750274658203,0.11979350442327491,8.338054370756765,-1.147165815734696,2.9949150063136023,206.23750114440918,7.297624778747559,0.040451912146869516,194.95950202941896,216.80500030517578,0.777887710165936,-0.0774995962713693,0.9550746697071457,0.9879654893864634,0.9897735660972006,0.01670734081313663,41.989007532586,222.79873504614,206.12262630462646,189.44651756311293,198.04678671700614,3.3911013758962274,201.54143033708846,6.4052501470337395,200.29176350753136,203.43375307046261,2.7383340201484048,-8.795152901509795,9012400,4.720515220237218,1.0477049630087747,4541800.0,-70.14085977268401,89.0859394939463,92.09290994229893,-74.17396332394617,18.350072006756072,27.799953045477327,-0.16306807871235404,7.196870563808529,208.93540161132813,205.30730072021484,202.375,199.44269927978516,195.81459838867187,0.1,0.0,212.86890153358266,0.017528477400626796,0.005220507970089928,194.9214717320033,197.5750274658203,7.773202043592734
2022-05-20,1,198.59500122070312,193.62749862670898,221.31499862670898,197.5187520980835,210.7000026702881,0.2728232555950878,8.03501033898317,-1.0370127568234118,2.9949666906126122,203.78125190734863,7.016662502288819,0.03919032113589083,194.95950202941896,216.3507507324219,0.7914126980976095,-0.07240965150224893,0.9686361990178751,1.0026619674578727,0.9952466502043784,0.0013992913944982366,38.02628363225301,221.0953969978516,205.02537631988525,188.9553556419189,198.56285803658622,3.110300152083862,200.6839302607945,5.881414090822161,199.4265608750503,202.65664320366872,1.0834247412503035,-8.996880368537227,6966600,4.632259993371924,0.8062900484530946,11508400.0,-63.460766193654564,89.0859394939463,92.09290994229893,-57.40079827263523,18.19002588288327,25.70087449720687,-0.11573621607696533,7.2285276656757205,208.93540161132813,205.30730072021484,202.375,199.44269927978516,195.81459838867187,0.1,0.0,212.7718059067969,-0.0010039287217623594,0.02608642948736836,195.29834202357702,196.726069859096,7.794721963408091
2022-05-23,1,204.2925033569336,193.62749862670898,221.31499862670898,197.5187520980835,210.53437614440918,0.4732620246526361,7.973002232942304,-0.8694643956519346,2.9949753703377415,203.03875160217285,6.850737609863282,0.03901762131394621,194.95950202941896,216.3507507324219,0.8221281902857528,-0.04539992142501129,0.9997498182459874,1.0337930775653001,1.0235146530440573,0.03315001051398947,42.336971161735256,220.28963086969318,204.3436264038086,188.39762193792401,200.086430140904,2.8944188106665147,200.23964473179407,5.286710181323424,199.22636662103565,202.35262973145927,1.8527299631038716,-5.700380312271549,12187400,4.593351105218743,1.3681847701683316,23695800.0,-29.134823802477023,89.0859394939463,92.09290994229893,14.944288691584385,22.734509017544475,23.47016050304318,-0.08129076186364331,7.350079950436043,208.93540161132813,205.30730072021484,202.375,199.44269927978516,195.81459838867187,0.02,1.0,212.68755598881293,0.04928969672607675,0.041810953650437306,197.20584760393416,196.6837921142578,7.729017730095483
2022-05-24,1,202.56000137329102,193.62749862670898,221.31499862670898,197.5187520980835,210.53437614440918,0.5472468446580757,7.9278387164078765,-0.7744769191442717,2.9949832338962943,203.03875160217285,6.644625244140625,0.03883221139276718,194.95950202941896,216.3507507324219,0.8308944678793327,-0.0006970333621943024,0.9921812330474458,1.0209844664291339,1.0082126286372828,-0.0019216525655695316,52.404946550332205,220.01192895869465,204.1562515258789,188.30057409306315,200.69250215802873,2.906433368721618,199.63678741455078,4.366406453810207,200.512118726238,202.777537060074,5.508001087585954,-2.954692658850825,7458500,4.729739128336168,0.8405956355747151,16237300.0,-48.518045388538376,89.0859394939463,92.09290994229893,-17.570465618187743,20.871041132577062,23.21840043306764,-0.02402824474168176,7.4343714444687174,208.76732067871095,205.17133996582032,202.26499938964844,199.35865881347655,195.76267810058593,0.02,0.0,212.61379050231608,-0.006715720599347663,0.02436688226932774,197.6830771309989,195.8780473981585,7.705900924602993
2022-05-25,1,202.46249771118164,193.62749862670898,221.31499862670898,197.5187520980835,210.53437614440918,0.5807882262012684,7.935071096372476,-0.7558881179052404,2.994981508849787,202.75500106811523,6.691750259399413,0.03888549359651049,194.95950202941896,216.3507507324219,0.8255044373791802,-0.06474437710726874,0.9921592462959474,1.016492808639497,1.0081187033667263,0.003034389839710494,45.26084156441565,219.93264371862386,204.0625015258789,188.19235933313394,201.36750139508928,2.642461803911971,199.18482262747628,3.6076309107686964,201.06367916170043,202.99988322677623,2.1392485174678293,-4.000001084748018,5457200,3.770593541122118,0.653717771259873,10780100.0,-22.876225108107583,89.0859394939463,92.09290994229893,-1.3895723561892248,20.223231839786337,22.18967248346712,0.06336237658923609,7.223317689321608,203.70964440917967,201.08018298339843,198.9550018310547,196.82982067871095,194.20035925292967,0.02,0.0,212.56542476602002,0.019251043056684125,-0.0007844244247719162,198.52945382254464,195.8072509765625,7.342212290859272
2022-05-26,0,207.0175018310547,193.62749862670898,221.31499862670898,197.5187520980835,209.22062873840332,0.7605704197705853,7.399824258603018,-0.20676095172429765,2.9950759282701385,202.51124954223633,5.933950462341312,0.03638843217736275,194.95950202941896,211.5325035095215,0.7345569029348921,-0.08518401840141784,1.0180028689395568,1.035473218426118,1.0301710149995473,0.05158424094659875,42.933410457414496,218.15614990575588,203.35650138854982,188.55685287134375,201.9485729762486,3.3899438960683685,199.4626797267369,4.056526419457204,201.42985479700383,202.64813632299823,2.3895288382331095,-3.0305603121273332,9212300,3.549543567536097,1.1141298925272158,19992400.0,-6.013147688668543,89.0859394939463,92.09290994229893,66.70558975346943,23.827595116069055,20.87773996862713,0.1267543818219328,7.12878445542656,205.06956347656254,202.18022222900393,199.84500122070312,197.50978021240235,194.62043896484374,0.04,0.0,212.52368650341936,0.056644776117524165,0.04280213233339049,199.1680908203125,196.23651776994978,6.332534843878667
2022-05-27,0,211.4375,193.62749862670898,216.32500076293945,197.5187520980835,207.46062755584717,0.4329576755967146,6.228251607073035,-0.7647448881631376,2.995261876176874,202.51124954223633,5.084038181304931,0.030735302085498035,194.95950202941896,210.64000244140624,0.703332167841178,-0.04302553518575702,1.043406054328705,1.0505454203282547,1.0416384365170015,0.06466677761453177,53.21556003052372,215.09812976291315,202.64162654876708,190.185123334621,203.31821496146065,4.930329674085933,200.53178678240096,5.056287959474869,202.83270588446774,202.7812175427818,2.004188742460945,1.915053029695247,4897200,3.622884955904694,0.6034590580779438,24889600.0,-1.5033971781724693,89.0859394939463,92.09290994229893,128.94654357162528,26.267272630028877,19.873995946783673,0.19386410132601778,6.953851519074883,207.73591601562498,204.33703619384764,201.58999633789062,198.84295648193358,195.44407666015624,0.06,0.0,212.52095693808553,0.06958757919277425,0.07858337583002326,200.97734723772322,197.65752628871374,6.34546090048854
2022-05-31,0,211.50250244140625,193.62749862670898,211.4375,197.5187520980835,207.46062755584717,0.18218213314919351,5.765243439438603,-1.2510720850540795,2.9953271882047843,202.51124954223633,4.838025245666503,0.028484791154074,194.95950202941896,210.64000244140624,0.7068779130019391,0.003976722232097083,1.0449870285432623,1.0440623710648471,1.0289388752453663,0.03529252892787538,62.22414865054135,213.92773838949734,202.39725151062012,190.8667646317429,205.4096439906529,4.839708540158873,201.7282153538295,5.54197215025031,204.99007070086435,203.689203409259,4.749811051067087,7.618210763119631,9586400,3.5590057919926936,1.1756179217227614,34476000.0,-8.934455395887152,89.0859394939463,92.09290994229893,125.18324403739534,25.999160328226502,18.785010248677708,0.1615373982550807,6.831421443568558,208.59160394287107,205.02920260620115,202.1500015258789,199.27080044555663,195.7083991088867,0.08,0.0,212.51533517279412,0.022210440183356717,0.06602024185763705,203.05468967982702,198.98808070591517,6.421320882940624
2022-06-01,0,211.22750091552734,193.62749862670898,211.50250244140625,197.5187520980835,207.46062755584717,0.20389603222756475,5.832411110239383,-1.2355536397874476,2.995317970869704,202.51124954223633,4.878637752532958,0.028810228424252918,194.95950202941896,211.04375343322755,0.7149146211088786,0.0047028165780123865,1.0433956790488768,1.035667528605357,1.0204424251213349,0.04278978812931222,62.35456778528113,214.1071987387283,202.44237651824952,190.77755429777073,207.21428680419922,4.186239877005912,202.8885724203927,5.718772710502149,206.6248858229173,204.5340829099795,7.436664301775579,8.600659703995047,5246100,3.558871957981796,0.648803273883507,29229900.0,-18.114802333092893,89.0859394939463,92.09290994229893,110.38249181242377,24.537408218582787,18.037070022574785,0.15946583601250647,6.721308991108737,208.59160394287107,205.02920260620115,202.1500015258789,199.27080044555663,195.7083991088867,0.08,0.0,212.50791206245648,0.036025975797717935,0.01141820232224884,204.5846208844866,199.94148145403182,6.511087037808927
2022-06-02,0,213.31750106811523,193.62749862670898,211.50250244140625,197.5187520980835,207.46062755584717,0.2177988774045719,5.8837332165338685,-1.2302790115784548,2.995310858325943,202.51124954223633,4.912375640869141,0.02905861150281763,194.95950202941896,211.2485008239746,0.7185671076214029,0.0010781852924982352,1.0535335580599168,1.0416872659656282,1.0219806039660715,0.0536148841373012,61.556796008394834,214.24559295894665,202.4781265258789,190.71066009281117,208.50357219151087,4.513391814293865,204.29500116620744,5.687091838780948,207.77274176966029,205.0343856993023,6.360935379629941,8.331516298445893,5337200,3.5580350114275934,0.6677246605359738,34567100.0,-0.911563017261764,89.0859394939463,92.09290994229893,142.81157940650863,24.358969578870976,17.001805697829546,0.1491758367008207,6.621207200928827,210.0721594238281,206.86891906738282,204.27999877929688,201.69107849121093,198.48783813476564,0.1,0.0,212.51409696264366,0.054994033724730995,0.06129382342864894,205.63592311314173,201.42088535853796,6.597917495403692
2022-06-03,0,212.77000045776367,193.62749862670898,213.31750106811523,197.5187520980835,207.46062755584717,0.28739451885145434,6.070285988040854,-1.148009969497022,2.9952845537879624,202.51124954223633,5.031650505065917,0.029962812059764834,194.95950202941896,211.44400024414062,0.7330931734419769,0.021684449615969673,1.0502285309509118,1.0332277112664188,1.0088643658760965,0.027787499007709826,65.80700944333813,214.7345733646315,202.5940013885498,190.4534294124681,209.96214348929269,3.877469073182109,205.32732282366072,5.828541211326352,209.12821473160045,205.7522376081379,4.417684233578283,10.169011416795843,4352500,3.5462398506594877,0.5563537451139294,30214600.0,-11.850527867803413,89.0859394939463,92.09290994229893,119.92295611362749,23.33416369512918,16.286522957442873,0.18156490401593245,6.418247148061496,210.0721594238281,206.86891906738282,204.27999877929688,201.69107849121093,198.48783813476564,0.1,0.0,212.51486265792934,0.01965957743409974,0.04322010641622583,207.0423366001674,202.36270686558314,6.942194537807296
2022-06-06,0,214.51499938964844,193.62749862670898,213.31750106811523,197.5187520980835,208.07000160217285,0.3199720027683092,6.329833808557446,-1.1916892216874055,2.9952466194497402,202.51124954223633,5.250550270080566,0.031213275467516795,194.95950202941896,211.629252243042,0.807878568245643,0.04747017464628591,1.0578027749814227,1.0337163035880788,1.0116198386319255,0.014555125697421012,68.10511484403486,215.4526687920416,202.79300117492676,190.1333335578119,211.68392944335938,2.378395132290386,206.52571541922433,5.87260008989268,210.00616036104856,206.33676430798494,5.040481346392268,7.287558286336036,3965100,3.2715812718444535,0.5230830117740181,34179700.0,-19.11824710683477,89.0859394939463,92.09290994229893,117.49465677057377,25.683397763142462,15.280982001748425,0.1725052983970736,6.351939138557416,211.8522808227539,208.3088601989746,205.44499969482422,202.58113919067384,199.03771856689454,0.12000000000000001,0.0,212.5208533434318,0.00028174283109683174,0.021050104395638085,208.31961931501118,203.4245365687779,7.269728399043057
2022-06-07,0,212.82749938964844,193.62749862670898,214.51499938964844,197.5187520980835,211.2800006866455,0.2573522255654806,6.826952166195716,-1.356662332598865,2.995170238667952,202.51124954223633,5.918100128173831,0.033570379633279815,194.95950202941896,212.82475051879882,0.8182345278515005,0.09184607348108374,1.0465431391609519,1.0177765007691701,1.0007570469938112,0.006264686861609414,75.5446638418136,217.01628035473033,203.36237602233888,189.70847168994743,212.51392909458704,1.2007282544164477,207.23125103541784,6.001887090626504,211.09744149446738,207.1023890927978,5.952955147110762,8.484731565311165,4493300,2.808257598160083,0.6164316846407224,29686400.0,-12.690569793387105,89.0859394939463,92.09290994229893,95.97594880823088,24.426132459512605,16.110931532568696,0.259131880990604,6.201790043472739,211.8522808227539,208.3088601989746,205.44499969482422,202.58113919067384,199.03771856689454,0.12000000000000001,0.0,212.52436056764785,0.010981847364677444,0.007609974542470788,209.15477207728796,204.16143144880022,7.18207756899775
2022-06-08,0,213.91500091552734,193.62749862670898,214.51499938964844,198.17249870300293,211.45375061035156,0.06675670285230734,6.931272827646094,-1.44364573959779,2.9951563428439645,202.75500106811523,6.128525047302247,0.03394683274238743,194.95950202941896,212.87649955749512,0.8279997878877304,0.09281008830004779,1.0476772358754771,1.0188187267999793,1.0046188594466252,0.012723248574884938,71.20412793271869,218.04279658607834,204.18025093078614,190.31770527549395,212.86785779680525,1.1956820935980275,208.09303637913294,6.0358653205009,211.51927154785977,207.64219243567572,2.806524814184668,4.866961611025875,3646300,2.806765594597881,0.526868669354256,33332700.0,-16.810882211851304,89.0859394939463,92.09290994229893,91.92014547696895,24.34303112976166,15.581357204835074,0.2777827309704488,5.9545035305104586,211.8522808227539,208.3088601989746,205.44499969482422,202.58113919067384,199.03771856689454,0.12000000000000001,0.0,212.52903240696608,0.017005854598234338,0.006268565428115195,209.2417951311384,205.1095711844308,6.9137516425175995
2022-06-09,0,209.60750198364258,193.62749862670898,214.51499938964844,198.52562522888184,211.8193769454956,-0.0824577545215086,6.886122669990643,-1.4490399546961368,2.995168176924753,203.62125205993652,6.228462371826171,0.03356818362876713,196.67449951171875,213.37725105285645,0.8164350011822572,0.09709845108805223,1.021785909684302,0.9929334262180781,0.9819107305693955,-0.01739191142731422,72.58444393491214,218.91062119447344,205.13837585449218,191.36613051451093,212.59714344569616,1.6748460116449562,209.00339371817452,5.100360824002492,212.13060857781934,208.36570733188435,1.1717414912337423,5.977208049141388,5138600,2.801693831192366,0.7662387334827956,28194100.0,-48.684220752473465,89.0859394939463,92.09290994229893,29.659817942508745,22.143121493627767,22.176211174068055,0.21146529829538988,6.078475274228538,212.01984240722658,208.5800827636719,205.8000030517578,203.01992333984376,199.58016369628908,0.12000000000000001,0.0,212.5112392554946,-0.04157168098851027,-0.018196378345828174,208.39120701381142,205.7229483468192,6.566766767079051
2022-06-10,0,200.93999481201172,193.62749862670898,214.51499938964844,201.0362548828125,211.8193769454956,-0.22990753951822165,6.53647646500326,-1.3424221692654201,2.995226855680215,205.65500259399414,5.944124984741211,0.03175056270624019,197.65000267028807,213.37725105285645,0.7960437997891263,0.08252961728200166,0.9760545975540621,0.948663597220962,0.9445909283186382,-0.05559997001598116,60.535839413761906,218.94257878449872,205.8696258544922,192.79667292448568,211.12749971662248,4.756134280254371,209.17089326041085,4.759353779184165,211.50883635269085,208.48627132965348,-0.8959707028944751,6.474063265464583,5162500,3.002490212759502,0.7943578664894075,23031600.0,-97.41242237966344,89.0859394939463,92.09290994229893,-67.516971795197,20.357661914199596,28.346639658486367,0.1620534297533175,6.139302469043422,213.20220111083984,210.4939006652832,208.30500030517578,206.11609994506836,203.40779949951173,0.02,1.0,212.45757882092244,-0.06179157180181438,-0.07226215028919432,206.9286520821708,205.7566364833287,6.142234477031163
2022-06-13,1,193.05500030517578,196.86249923706055,214.51499938964844,201.62250328063965,211.8193769454956,-0.08381535690372982,6.026061917544422,-1.536382833075861,2.995304950210642,205.65500259399414,5.578500175476075,0.029219359436128686,198.25949783325194,213.37725105285645,0.7737860027953228,0.013223732625279244,0.9360911855943075,0.9140602074735031,0.9177319034865576,-0.10003962028544389,41.38500546070698,218.28737449884616,206.2352506637573,194.18312682866846,208.23285675048828,8.15364237113632,208.3682144709996,6.3328936240097535,208.86879169810257,207.4868408839461,-4.870344088211191,1.1807918512020095,7119200,3.5354717461487213,1.0917854615190559,15912400.0,-95.54719744988218,89.0859394939463,92.09290994229893,-147.90254990157865,18.41271739968557,34.818311112549,0.1156920248245652,6.302931774361245,211.3260018310547,207.4570018310547,204.3300018310547,201.20300183105468,197.33400183105468,0.04,0.0,212.3368771418458,-0.09711657410863583,-0.09588529675429835,203.72982352120536,204.68287331717355,6.722687762730558
2022-06-14,1,193.08250045776367,193.05500030517578,214.51499938964844,201.62250328063965,211.8193769454956,-0.2775467387416413,6.464951397431455,-1.1989929171745757,2.9952381072392145,205.65500259399414,5.841625022888183,0.031387506303624406,197.65000267028807,213.37725105285645,0.6803781051651655,-0.023680397872508713,0.9374205353880041,0.9222170095584091,0.9369798511365985,-0.09277466017554092,32.32751332250694,218.90202861120815,205.97212581634523,193.0422230214823,205.42035675048828,9.595726761814092,207.6912501198905,7.415544094037202,204.91505114158684,205.52120404435382,-9.49875217058227,-5.500692814030475,6441200,3.963892134135531,0.9782085413284453,22353600.0,-90.7924436173348,89.0859394939463,92.09290994229893,-138.27470380825181,17.848511078094326,33.75140117142504,0.13443875926174342,6.037709192209622,211.3260018310547,207.4570018310547,204.3300018310547,201.20300183105468,197.33400183105468,0.04,0.0,212.22966849971175,-0.09780891046456497,-0.09119930732081453,201.04471915108817,204.0435278756278,7.05002628038467
2022-06-15,0,195.79999923706055,193.05500030517578,214.51499938964844,201.62250328063965,211.8193769454956,-0.3814168074014852,6.830673132184855,-1.0853961176974296,2.995178608913692,205.65500259399414,6.074375152587891,0.03320061174185935,196.48449935913087,213.37725105285645,0.7639755276773893,-0.0486203511607854,0.9516894789030406,0.9434973696799255,0.9687314443533244,-0.08468317603224196,29.656183217230186,219.4007219510152,205.7393756866455,192.0780294222758,202.74678530011857,9.240045962862638,207.21535737173897,7.96996856395861,201.96243704280113,203.85142529518887,-9.252949174058072,-4.678861004775358,6490000,3.7514655568136934,0.9914587887703925,28843600.0,-80.83018176960506,89.0859394939463,92.09290994229893,-100.52996879721778,21.741027927006716,31.133363045791974,0.10829781912600508,6.077875072505215,211.3260018310547,207.4570018310547,204.3300018310547,201.20300183105468,197.33400183105468,0.04,0.0,212.13709658605876,-0.08121777858859436,-0.08550121815687266,198.68946402413505,203.50454166957311,7.36090853862468
2022-06-16,1,189.9650001525879,193.05500030517578,214.51499938964844,200.35374641418457,211.8193769454956,-0.31429098120563626,7.147084630902316,-1.294628077419021,2.9951243687847984,205.65500259399414,6.431875228881836,0.03479900361053131,195.52824935913085,213.37725105285645,0.8125606298047571,-0.029972785154895792,0.9249355601026236,0.9222363026828748,0.9570169864829723,-0.09371087220240593,35.9192691978237,219.6760448721562,205.38187561035156,191.0877063485469,199.4807139805385,9.122804560784223,205.99732153756278,9.209235770109201,200.40207512431812,202.72082136944712,-8.724331727775207,-3.290732135304056,9887200,3.816648783666133,1.4974117276452932,18956400.0,-94.94175002297705,89.0859394939463,92.09290994229893,-144.25231662117315,19.600136499267396,33.43050308696916,0.13318242494388624,6.260177709212497,210.48820111083984,206.1009006652832,202.55500030517578,199.00909994506836,194.62179949951172,0.06,0.0,211.94499197366548,-0.0827713504820704,-0.11451993524912024,195.11727251325334,202.13602229527064,8.129796920268378
2022-06-17,1,188.53999710083008,189.9650001525879,214.51499938964844,198.16187572479248,211.8193769454956,-0.37913058307753966,7.873244733811469,-1.2575809906202293,2.9949893148259803,205.65500259399414,7.026125526428222,0.03844590082914137,193.0797504425049,213.37725105285645,0.7699612054578863,-0.03503714070076258,0.9206610839538889,0.9258142914382278,0.969016043587255,-0.061709953375794546,31.06372675386364,220.53411478042813,204.78762531280518,189.04113584518223,195.85571343558175,7.288342543511806,204.3617856161935,10.153602056518935,197.76898759150063,201.00759479671729,-10.742267471368194,-8.237227059373563,15089300,3.875454600057554,2.184732082809386,3867100.0,-87.05402247624096,89.0859394939463,92.09290994229893,-135.96216566448692,18.380477907659394,33.217029497557164,0.1746963200204628,6.198733614003535,210.1058822631836,205.48206253051757,201.74500274658203,198.00794296264647,193.38412322998045,0.08,0.0,211.65281693932516,-0.047616845818709064,-0.07811373888426038,191.82018824986048,200.53099169049943,8.624687097856091
2022-06-21,0,195.13999938964844,188.53999710083008,214.51499938964844,197.89625072479248,211.8193769454956,-0.46740388271726246,8.477836545598011,-1.173831708083973,2.994865851729962,205.65500259399414,7.4422506332397464,0.04148247939195477,192.746000289917,213.37725105285645,0.8014220797860664,-0.05063070096461639,0.9548298035340523,0.9697614234647637,1.0158859064842052,0.010800026319840228,28.816740808346786,221.32717329718966,204.37150020599364,187.41582711479762,193.78892735072546,4.08694970751346,203.1930353982108,10.20999162513642,195.46281753083935,199.6454470218587,-11.862189984851774,-10.829442695439514,6241600,3.8496455510454863,0.9084696719504021,10108700.0,-73.22388311391087,89.0859394939463,92.09290994229893,-80.67170427489444,23.174075555036254,30.660128456491574,0.1343871978308443,6.235968361775257,210.1058822631836,205.48206253051757,201.74500274658203,198.00794296264647,193.38412322998045,0.08,0.0,211.56500851118707,0.011078940408862925,-0.025662839203744625,190.17515999930245,199.28318350655692,8.83442821673248
2022-06-22,1,193.12250137329102,188.53999710083008,214.51499938964844,195.63499927520752,211.8193769454956,-0.429641405445215,8.627659198154603,-1.2787406544634192,2.994833818319623,205.65500259399414,7.624376049041748,0.04225128309218018,192.746000289917,213.37725105285645,0.8723525756344103,-0.044800978092153394,0.9457575096079562,0.9690660189226794,1.0032051141814669,0.0002071700720287506,39.23487613775346,221.45406851075015,204.1987501144409,186.94343171813168,192.67214257376534,2.607516300736859,201.89982114519393,10.260530998213339,195.39043228057545,199.57128409354328,-6.9021874012520605,-7.736316527172444,5138500,3.930893181704536,0.788354114215842,4970200.0,-75.02366871032623,89.0859394939463,92.09290994229893,-81.07321374079838,21.73683455354013,31.882712294192228,0.06018414962385893,6.173397134330019,210.1058822631836,205.48206253051757,201.74500274658203,198.00794296264647,193.38412322998045,0.08,0.0,211.48822313731506,0.0015502858214089255,0.008114189945325272,189.37650626046317,198.15257917131697,9.093531166309429
2022-06-23,0,195.92250061035156,188.53999710083008,214.51499938964844,194.63562488555908,211.8193769454956,-0.2909802715949218,8.958700000780395,-1.498461242476918,2.9947599846089754,204.78875160217285,8.17350082397461,0.04399277647768119,192.746000289917,213.37725105285645,0.8720213230672192,-0.04659113317543846,0.9621010610410813,0.9929339553513765,1.0177078551342904,0.0006256454227189234,37.4290223054559,221.5576500168196,203.6402500152588,185.722850013698,193.08178547450476,2.887860907669284,200.6573211124965,9.815106528146693,194.81783052893866,199.28186295349985,-3.890461650521249,-8.571326869732154,4752800,3.936177626623525,0.744634932571903,9723000.0,-66.11936738897381,89.0859394939463,92.09290994229893,-59.15767372158642,21.97224241157456,30.36541170002721,0.06730362102382535,6.018864643837069,210.1058822631836,205.48206253051757,201.74500274658203,198.00794296264647,193.38412322998045,0.08,0.0,211.42613849100738,0.002446931814942932,0.016122314485726905,189.99128941127233,196.86055646623885,9.222761798722955
2022-06-24,0,201.59749603271484,188.53999710083008,214.51499938964844,194.63562488555908,211.8193769454956,-0.19733106054629776,9.114164832855572,-1.6093206216218943,2.994724004200149,204.73999977111816,8.505375862121582,0.04482926408654652,192.746000289917,213.37725105285645,0.8910045889793594,-0.03230226424530021,0.9915848083258273,1.0310969427530199,1.0470530301566265,0.06123494259881168,42.4705338475012,221.53670464282294,203.3083749771118,185.08004531140068,194.2982134137835,4.324309020180176,199.85928508213587,9.188717902297672,195.1033100470186,199.41073095516495,1.4853281710615729,-8.154511641409679,7754800,4.004230995016493,1.1934859074997635,17477800.0,-38.11180303778568,89.0859394939463,92.09290994229893,-3.9392468819028488,29.08170120624319,27.23290439992735,0.10269508154098886,6.231809052720893,210.1058822631836,205.48206253051757,201.74500274658203,198.00794296264647,193.38412322998045,0.02,1.0,211.3711787136552,0.08706681124775129,0.047665015691651914,191.67421395438058,196.35946655273438,9.23433945583431
2022-06-27,0,204.75249862670898,188.53999710083008,214.51499938964844,194.63562488555908,211.8193769454956,-0.18300761058114837,9.120126641191447,-1.6165015925133035,2.994722469997296,204.30749893188477,8.548625946044922,0.044868132917458815,192.746000289917,213.37725105285645,0.8992466113345599,-0.026181389256465216,1.0073174074219673,1.0515415988569605,1.0507429510305348,0.08598971982167036,49.562939225568165,221.50537817557134,203.26512489318847,185.0248716108056,195.57714189801897,5.884796841462796,199.16196359906877,8.320359424387785,196.74072061702077,200.17249883878705,4.410029678900811,-5.25097729990683,6121200,4.0833807400866915,0.9650247120864568,23599000.0,-40.49227337408513,89.0859394939463,92.09290994229893,9.506699000038102,29.25381018886462,25.80581783051393,0.038881094639515314,6.106676163243095,208.57024645996094,204.23988592529295,200.74000549316406,197.24012506103514,192.90976452636716,0.04,0.0,211.33604390580345,0.07131206643544852,0.07675210094388446,192.71288190569197,195.7011729649135,9.159293897770237
2022-06-28,0,201.60249710083008,188.53999710083008,214.51499938964844,194.63562488555908,211.8193769454956,-0.1509370996819869,9.086830126592417,-1.6059864968017183,2.9947291988195714,203.1749973297119,8.435375785827636,0.044729245735666556,192.746000289917,213.37725105285645,0.8849518226296568,-0.03161691456478163,0.9923733037946234,1.0333409677692413,1.0176444946836167,0.03311723752892681,52.43443230899352,221.325534986156,203.15187473297118,184.97821447978637,197.23964146205358,5.675186339643649,198.36017772129603,7.391149798027398,198.75659161700764,201.24167098239906,4.572267326114438,-4.55096417067167,4354200,4.015874348266198,0.6894029354486296,19244800.0,-58.83347961053561,89.0859394939463,92.09290994229893,-15.559653128250421,26.189036806448737,28.864912999208336,-0.02203061234287306,6.3340616377961725,208.57024645996094,204.23988592529295,200.74000549316406,197.24012506103514,192.90976452636716,0.04,0.0,211.29830993988986,0.019188062522264904,0.0426820327466135,193.98595537458147,194.5516139439174,8.938764892792987
2022-06-29,0,198.69500350952148,188.53999710083008,214.51499938964844,194.63562488555908,211.8193769454956,-0.035861198591258955,8.889100786555888,-1.54175656250245,2.9947693742307906,201.59999656677246,8.049388389587403,0.043862110539142914,192.746000289917,213.37725105285645,0.8740781321337637,-0.04680798206309085,0.9804346262662578,1.0139957618056625,0.9964669156959848,0.028854753312558046,47.94485506150665,220.4383261611245,202.6601245880127,184.8819230149009,198.6903566632952,4.182277777513773,197.27303504943848,5.895183917261997,199.46815495729584,201.58306353898814,6.126126885949759,-5.274225521142558,4324600,4.062211038842668,0.7144780688638831,14920200.0,-51.11512645308384,89.0859394939463,92.09290994229893,-25.087952318736228,25.174016413112707,27.95630518447615,-0.02509647190842125,6.118765960143477,207.14920599365234,203.0904055480957,199.81000518798828,196.52960482788083,192.4708043823242,0.04,0.0,211.2552489752536,0.029305431960235495,0.026287236610135437,195.31798444475447,193.5690863473075,8.669562505223993
2022-06-30,0,195.9900016784668,188.53999710083008,214.51499938964844,194.63562488555908,211.61312580108643,0.12564934812827092,8.688081472601905,-1.449099798342702,2.994808735811215,201.26874542236328,7.677450561523438,0.043006099591862176,192.746000289917,213.37725105285645,0.8599340584820816,-0.0593317506086377,0.9701526807470341,0.997334804120741,0.9774379967675618,0.00034452943334706276,44.280141377146286,219.39591258662227,202.01974964141846,184.64358669621464,198.81178556169783,4.072925850083969,196.30035645621163,4.707221648933323,199.28779994650102,201.22376205435367,5.386128442157856,-7.11497433133082,7045200,4.096207695325594,1.1469102269092175,7875000.0,-48.1586424716077,89.0859394939463,92.09290994229893,-46.21331062411371,23.23176134281869,30.985478903592536,0.019932278318649244,6.156711630042337,202.09151806640625,198.9992391357422,196.5,194.0007608642578,190.90848193359375,0.04,0.0,211.16876867285185,0.001271380504566988,0.01583935124355737,195.66888427734375,192.92202213832311,8.523165139147268
2022-07-01,1,197.61999893188477,188.53999710083008,214.51499938964844,194.63562488555908,210.39812660217285,0.3217012866118283,8.513581212722013,-1.3067736979639477,2.994841162321821,199.8174991607666,7.358412284851073,0.042301853908956306,192.746000289917,213.37725105285645,0.8264374495187357,-0.08122868167350004,0.9819243060502715,1.0055321536834836,0.9855007394665903,-0.019729893372210427,40.23997990786869,218.28503710500948,201.25787467956542,184.23071225412136,199.4542852129255,3.3089552747920346,196.06321389334542,4.536018784197434,198.49767115485542,200.54691310789437,0.43558588268779574,-6.496666472480774,4131800,4.066633439464412,0.6792936122430022,12006800.0,-37.34658355738837,89.0859394939463,92.09290994229893,-25.876742897210963,22.958636616607933,29.132732894735337,0.0061549934166570995,6.080516156671593,202.09151806640625,198.9992391357422,196.5,194.0007608642578,190.90848193359375,0.04,0.0,211.12421755525148,-0.03080139285404726,0.012916935289038462,196.4212145124163,192.89886038643974,7.901940486616182
2022-07-05,1,197.86999893188477,188.53999710083008,214.51499938964844,194.63562488555908,205.96624946594238,0.49806406829889505,8.078057544888415,-1.0204719159753595,2.9949254350386236,198.15750122070312,6.827049255371094,0.04029499015879591,192.746000289917,212.93624954223634,0.8116130027147728,-0.07120365414900813,0.9870157046264753,1.0028978944217501,0.9906775026641592,-0.03361375192481497,43.129790597821334,216.62911466253072,200.4729995727539,184.3168844829771,199.7324992588588,3.0328685326292795,196.40714236668177,4.472481426149992,198.31682258692427,199.96786586761178,2.3288314549636198,-1.6522324902182648,4110200,4.105784533684625,0.67709105525519,16117000.0,-30.925426424946668,89.0859394939463,92.09290994229893,-15.079103131820688,22.132387126610595,26.941175089600993,0.041900974875674624,6.105480318719735,202.09151806640625,198.9992391357422,196.5,194.0007608642578,190.90848193359375,0.04,0.0,211.0819257075835,-0.014835729191676417,-0.024183530035162923,196.96862574986048,193.4799575805664,7.3779129265875145
2022-07-06,1,200.5749969482422,188.53999710083008,214.51499938964844,194.63562488555908,202.3899974822998,0.6828593734258778,7.581421876097673,-0.5835492230954329,2.9950176581878236,197.74499893188477,6.1933492279052755,0.03795873335341772,192.746000289917,212.93624954223634,0.7601267367514546,-0.07759364382501491,1.0042407546959746,1.011823298971389,1.011189490169837,-0.005096663817978353,42.823652583999944,214.89084324865533,199.72799949645997,184.56515574426462,199.58642796107702,2.9516091893279373,196.94232068743025,4.492284990744166,198.2282821217171,199.29686005907752,0.994014631023093,2.4941071814237255,4111200,4.070481556854731,0.6764417701805868,20228200.0,-28.186984349289567,89.0859394939463,92.09290994229893,20.88261474220201,23.442454891889305,25.697883368807144,0.07370603638322934,5.943657243712335,202.09151806640625,198.9992391357422,196.5,194.0007608642578,190.90848193359375,0.04,0.0,211.04770118170225,0.015142361621446776,-0.011986577669686398,196.3524431501116,194.0133285522461,6.736263159285739
2022-07-07,1,202.20249557495117,188.53999710083008,213.91500091552734,194.63562488555908,201.59874629974365,0.7434168946698361,6.789348307114226,-0.12588699942083315,2.9951550613677203,197.74499893188477,5.356949081420896,0.0341120143518098,192.746000289917,209.92950172424318,0.7144032340270996,-0.0575701094855893,1.015934684599537,1.0172443744054502,1.0204516556898873,0.01765264351633089,48.077861693054444,212.60969598861809,199.03099937438964,185.4523027601612,199.2221418108259,2.291235972219494,197.39964185442244,4.68864965101298,198.80858242887945,198.89531801609112,-0.5071983058295164,3.880463777253331,4650700,4.1419394350235175,0.7642195329760392,24878900.0,-20.254932812315467,89.0859394939463,92.09290994229893,50.794617825448135,23.597804479395023,24.617795328690754,0.0688672245033938,5.761250190331334,202.09151806640625,198.9992391357422,196.5,194.0007608642578,190.90848193359375,0.04,0.0,211.01420643963385,0.016541277294034096,0.02362201514839761,196.24576895577567,194.4793254307338,5.8127137080333675
2022-07-08,1,202.61250686645508,188.53999710083008,213.91500091552734,194.63562488555908,201.59874629974365,0.7245783271248761,6.066199176099974,0.38343809139376983,2.9952685171247584,197.74499893188477,4.738974285125733,0.030560235975348463,192.746000289917,205.23799896240234,0.6014369455124379,-0.05475308085196564,1.02071920846104,1.014672064009464,1.0189136540754455,0.03379001546646698,50.29952264507481,210.63214753585476,198.49974918365479,186.36735083145481,199.3664289202009,2.4893548761547812,198.30303519112724,4.352356154624366,199.6553828578493,198.85862498275293,-1.245407537813156,3.2699164263728844,3621800,4.155559261155467,0.5952668576490756,28500700.0,-16.619406189393573,89.0859394939463,92.09290994229893,77.3813230846881,23.357215716526287,23.476791953880216,0.10528759404668163,5.609730022961853,202.09151806640625,198.9992391357422,196.5,194.0007608642578,190.90848193359375,0.04,0.0,210.99009511880428,0.03392755517957391,0.0204010046718879,197.010737827846,195.49834660121374,4.849923654887767
2022-07-11,1,203.95000076293945,188.53999710083008,209.60750198364258,194.63562488555908,201.59874629974365,0.19779689822473315,5.044169505955798,-0.24873155294179572,2.995408005783068,197.74499893188477,4.117337112426759,0.025484017862851822,192.746000289917,202.82650604248047,0.5332064987935723,-0.033371873864196794,1.0303907226818194,1.017959670195978,1.0188534156073272,0.032031180372774415,52.838354178785096,208.0229634931128,197.93462448120118,187.84628546928957,200.1171428135463,2.9942902749627627,199.40374973842077,3.5719887314509933,200.37352413985312,198.87954505760933,0.5009907020744147,6.6578089141200625,5353600,4.0676077956544265,0.8783477821455994,33854300.0,-12.640093947029534,89.0859394939463,92.09290994229893,117.11712148978333,25.33089493078348,22.04397751556997,0.15905488084496508,5.547605984488778,203.29983691406252,200.95507727050784,199.05999755859375,197.16491784667969,194.820158203125,0.04,0.0,210.96278698729543,0.0295210769210017,0.041495197360766845,197.79114423479353,196.554564339774,4.766729218723338
2022-07-12,1,204.73749923706055,188.53999710083008,204.75249862670898,194.63562488555908,201.59874629974365,-0.28252661772658844,4.512212521131242,-0.8791879361748705,2.99547108076481,197.74499893188477,3.827999496459961,0.022829104899745805,192.746000289917,202.74625625610352,0.638898164035498,0.01497962590147237,1.035849669115914,1.0206917663960386,1.0163595447978153,0.034707132674215435,59.5590327729387,206.6761744624285,197.65174942016603,188.62732437790356,201.36678532191686,2.8040981986126314,200.08928544180733,3.6115012150063968,201.2227929648256,199.215922422113,2.644755610659404,8.173333986988553,6779500,3.57715596663806,1.0977294107931923,40633800.0,-19.309470451156685,89.0859394939463,92.09290994229893,117.57200937050521,25.359617322735605,20.518952193200594,0.1795647326488411,5.534205428810848,204.08675598144532,201.59161651611328,199.5749969482422,197.5583773803711,195.06323791503905,0.06,0.0,210.931947594689,0.02134229095389717,0.02831620024640193,198.90420750209265,197.28654588971818,4.9864624374574165
2022-07-13,1,202.4124984741211,188.53999710083008,204.75249862670898,194.63562488555908,201.75249671936035,-0.21518568258754703,4.721628307240969,-0.9643961158116254,2.9954469447153165,197.74499893188477,4.017874717712402,0.023865697199963693,192.746000289917,204.02875061035155,0.7168339728625971,0.060513837576946505,1.0231037014631637,1.0091083279714357,0.9980129654585022,0.009161169407137404,65.92382380824455,207.28488125590036,197.84162464141846,188.39836802693657,202.0514281136649,2.2712609465115157,200.7528566632952,3.0414431942528357,202.07889589656034,199.77708255516345,4.463236636399717,4.91826374778662,7597300,3.033718554546739,1.2254035792888036,33036500.0,-25.99871694176451,89.0859394939463,92.09290994229893,74.87375297462785,23.386464486603938,23.10117963935519,0.2407200638384441,5.572477448411684,204.51627770996092,202.28685931396484,200.48500061035156,198.68314190673826,196.45372351074218,0.06,0.0,210.8848294331638,0.015065599262657825,0.01800122713991123,199.60180228097096,198.01150839669364,4.93552982613095
2022-07-14,1,202.49250030517578,188.53999710083008,204.75249862670898,195.63499927520752,202.25499629974365,-0.4207357565930936,4.687635085487503,-0.8057589619472187,2.9954519124569243,198.28250122070312,4.00424976348877,0.0236379754682845,192.7707504272461,204.02875061035155,0.7364948087560234,0.04832130304008745,1.0210932948991596,1.009099676392372,0.996601586366441,0.0014342292334226237,59.45360399413054,207.68476972084073,198.30949954986573,188.93422937889073,202.71178545270647,1.3297524639438798,201.22214235578264,2.7296901866521974,202.15272363198943,200.17212796657518,2.425108576125535,4.810416722426987,5605500,3.1023935521503683,0.9102719204943123,38642000.0,-14.472776981695596,89.0859394939463,92.09290994229893,72.0129074572887,21.034498646063494,22.665139411303727,0.2667733100841049,5.753017205357616,204.51627770996092,202.28685931396484,200.48500061035156,198.68314190673826,196.45372351074218,0.06,0.0,210.8515260638472,0.0153354059593791,0.023816672017895026,200.35553850446425,198.6620821271624,4.996977166908718
2022-07-15,0,209.5749969482422,188.53999710083008,204.75249862670898,195.8918752670288,202.43249893188477,-0.6390771095825015,4.6110032793717615,-0.5066537370842381,2.995461843526704,199.63500022888184,3.913499450683594,0.023196515192626437,192.8067512512207,204.02875061035155,0.761611749765435,0.03418029159444702,1.054306255311728,1.0424218168050068,1.0311649508903316,0.03436357503032217,58.34800882459548,208.00200610097988,198.77999954223634,189.5579929834928,203.99749973842077,2.6323572465378473,201.7919638497489,3.529537436097227,202.2159893039902,200.4728089175427,2.336130488827807,3.3533665987096395,7245700,3.0583607860884605,1.1694468945670762,45887700.0,-8.854789892306595,89.0859394939463,92.09290994229893,155.087924156654,26.506754359590836,21.033913603694288,0.2705077571647922,5.756373371695593,207.25904656982422,204.50548648071288,202.2800064086914,200.0545263366699,197.30096624755856,0.08,0.0,210.84468666241716,0.03178266861234036,0.035700266355777714,201.60755920410156,198.98000117710657,5.431531356839532
2022-07-18,0,209.56500244140625,188.53999710083008,209.5749969482422,195.973126411438,202.5225019454956,-0.3946333425789065,5.115618554618861,-0.2650976553489768,2.995402200183558,201.08624649047852,4.235374317169189,0.02564621560667394,192.8067512512207,204.7389991760254,0.628721954311128,0.10322952533310199,1.0506157132010572,1.0353759146864936,1.0240991984034433,0.027531265787997583,73.14295756978932,209.69998653703314,199.46874942779542,189.2375123185577,205.04928643362862,3.2043482872435582,202.13571412222726,4.037805115413316,204.02403375323252,201.58302327345953,4.487099656953965,3.9571428576834955,4648900,3.0431126366306778,0.7834450076846334,41238800.0,-28.41474397787385,89.0859394939463,92.09290994229893,136.465942040167,25.937129479320674,19.407781301872557,0.27535231178499175,5.793061642895747,208.17584423828123,205.24708459472654,202.88000488281247,200.5129251708984,197.5841655273437,0.1,0.0,210.8377214295792,0.010484778928321559,0.017880836029385287,202.22655378069194,199.2361613682338,4.9780621026358185
2022-07-19,0,210.9724998474121,188.53999710083008,209.5749969482422,197.21249961853027,202.94688034057617,-0.26889267401302797,5.078366538907808,-0.03338704856809782,2.995410510958022,201.59999656677246,4.068999481201172,0.025334987374604455,194.9382495880127,205.2337490081787,0.5937506859741132,0.11151482796158166,1.0525009526335725,1.0362145254025927,1.02535035529552,0.030453632742344805,74.20114926107124,210.60548262005196,200.44874954223633,190.2920164644207,206.24357114519393,3.669001643409344,202.8050000326974,4.669735313634976,205.4129858777597,202.7355737947889,3.641155291145252,2.3504005308726903,4927100,2.9990644634792245,0.9080856130236775,46165900.0,-2.116637180209634,89.0859394939463,92.09290994229893,173.43002508744405,25.21985661668932,17.778842299330467,0.2678618375433525,5.872128932282304,209.09264190673827,205.9886827087402,203.4800033569336,200.97132400512695,197.8673648071289,0.12000000000000001,0.0,210.84174197941903,0.04315987851578784,0.04193903997864875,203.64279828752788,200.32676805768693,5.002561806323881
2022-07-20,0,212.6775016784668,193.12250137329102,210.9724998474121,197.80749893188477,204.14687538146973,0.26121013400098103,4.7935697078022494,-0.5820761368753575,2.9954500242386075,201.90249633789062,3.7627996063232443,0.02378112217840813,195.84425048828126,209.56600189208984,0.6928300038690103,0.08113406019926192,1.055102973423343,1.0379094280533596,1.027410174639896,0.05071328737962344,73.95305697902913,211.15751409516992,201.57037467956542,191.98323526396092,207.49035699026925,4.203631579961664,203.8037499019078,5.189432767283764,206.8286855391228,203.98120580296234,4.126099178303552,4.647761253619636,4460300,2.7085358448551284,0.8357716173435306,50626200.0,-3.571474667397095,89.0859394939463,92.09290994229893,171.1959245209535,24.315942651272707,17.12383153846373,0.3251148238017488,5.661260716056757,209.10792517089843,206.00104534912109,203.49000549316406,200.978965637207,197.87208581542967,0.14,0.0,210.8488480770754,0.045162939862926965,0.041743952801465214,204.80919974190846,201.300171988351,5.206780152489764
2022-07-21,0,214.74249649047852,193.12250137329102,212.6775016784668,198.4887523651123,204.74124908447266,0.301530010425122,5.129359391508944,-0.5622912005157916,2.995412031915449,202.30749702453613,3.9309758567810063,0.02533676993255358,195.98325157165527,209.7147472381592,0.6740577111478299,0.10125697506049522,1.0607330882932853,1.0418336732308227,1.0271983709652541,0.06049604882571358,77.76965134123368,212.70596857702427,202.44724979400635,192.18853101098844,208.9196423121861,4.77385966420725,205.14321381705147,5.431928311170868,208.30981265393683,205.1298507561011,4.2792355395338895,7.037166472218447,4801300,2.6286952829057646,0.9025195093502961,55427500.0,-3.119471117907816,89.0859394939463,92.09290994229893,180.08997754857418,26.57402402321308,16.205608333027882,0.3539222910802463,5.554741149739977,211.52863519287112,208.20567599487308,205.5199966430664,202.83431729125977,199.51135809326172,0.16,0.0,210.86520407131573,0.04992468736261402,0.05897628691766155,206.4051034109933,202.65465545654297,5.456675029990897
2022-07-22,0,215.45499801635742,195.92250061035156,214.74249649047852,200.104998588562,205.9556245803833,0.5362378101786691,5.324741797117191,-0.6341277149968882,2.9953915533328694,202.45249938964844,4.274649963378908,0.02616217556478613,197.45699920654297,211.14300003051758,0.7077475315980989,0.09605836910767052,1.058599965817372,1.0389694823924875,1.0186684501178045,0.02805678708690329,79.22608029921747,214.1777331441001,203.52824954986573,192.87876595563137,210.78285653250558,4.336000445811009,206.41714232308524,5.619948020126191,209.9403260443224,206.5614646060873,4.886743899237251,9.568087479674752,5071500,2.6076755341022846,0.950463096581219,60499000.0,-18.261633627222743,89.0859394939463,92.09290994229893,145.51702095868112,26.04800242629884,14.971956653467815,0.30425924971342055,5.582974996777203,212.42252545166016,208.9287442932129,206.1050033569336,203.2812624206543,199.78748126220702,0.18,0.0,210.87984743860102,0.01742512661126905,0.03783190110727792,207.74554879324776,203.67367553710938,5.512226061660587
2022-07-25,0,213.81750106811523,195.9900016784668,215.45499801635742,201.34187126159668,209.56750106811523,0.5298825781359765,5.623084088939077,-0.8030915672140662,2.995355988952754,202.55250358581543,4.6438497924804665,0.027496088320057132,197.84499893188476,212.88400115966797,0.8066821190882784,0.06873846281004309,1.045537431194994,1.0247270733079337,1.0053365997433714,0.020292026708505162,78.48275587222949,215.75104259804414,204.504874420166,193.25870624228787,212.40071378435408,2.413925767513919,207.55624961853027,5.36466600948968,211.33501321873865,207.84783966679976,6.44352480235001,9.02489585106211,4357200,2.362384873238032,0.8434476590901172,56141800.0,-18.914887298451397,89.0859394939463,92.09290994229893,110.73700975097275,24.954617303743902,15.00349198611804,0.2697231183021657,5.4113333628276585,213.32876458740233,210.3956228942871,208.0250015258789,205.65438015747068,202.72123846435545,0.18,0.0,210.88878504406674,0.034071656613906987,0.020138983109748005,208.91896493094308,204.6372517177037,5.858710871745299
2022-07-26,0,213.31000137329102,195.9900016784668,215.45499801635742,201.3456220626831,209.92437267303467,0.34126674688473635,5.929533005509842,-1.1264015264303948,2.995315697297671,203.28125381469727,5.0993873786926285,0.028908211102595466,197.84499893188476,213.91000061035157,0.8686545098866119,0.04427297592071369,1.0399487690285343,1.017483156302322,0.9989556740762292,0.011079650322054047,70.59621735040666,216.97494068295572,205.11587467193604,193.25680866091636,212.93428584507532,2.0741046236885583,208.46589279174805,5.165855344223312,211.94716106668562,208.41331858234426,5.592800101668744,8.059585698850826,6141000,2.345719931696615,1.1885200689771296,50000800.0,-27.77500552551631,89.0859394939463,92.09290994229893,91.144550979162,24.278704337653163,14.311777410907283,0.27022618803171733,5.267665380196458,213.32876458740233,210.3956228942871,208.0250015258789,205.65438015747068,202.72123846435545,0.18,0.0,210.89925640066105,-0.005476036398655126,0.0254813981161915,209.26285008021765,205.4352046421596,6.020558766551559
2022-07-27,0,209.82250213623047,195.9900016784668,215.45499801635742,201.3456220626831,211.39875030517578,0.20812304988101568,6.190869732328961,-1.3560580427269908,2.99527951780135,203.28125381469727,5.576499938964844,0.030119474506394843,197.84499893188476,213.91000061035157,0.8858152315621177,0.05807221855295528,1.020816747436669,0.9967720139040969,0.9804766923700011,-0.013424078803373485,71.7000408368992,217.92548927392306,205.54374980926514,193.1620103446072,212.97107151576452,2.005538782033961,209.01017897469657,4.8467402099809895,212.26367904883935,208.77269519367977,1.7821803552125284,6.3492482207715355,17432200,2.2003787224090874,2.994796274758067,32568600.0,-37.82977459690308,89.0859394939463,92.09290994229893,41.377852543176935,19.76229669824805,24.189684916794196,0.2999307809706565,6.00926557204054,213.32876458740233,210.3956228942871,208.0250015258789,205.65438015747068,202.72123846435545,0.02,1.0,210.88102864238863,-0.013591514487097833,-0.014930409097817454,209.72042410714286,205.9734889439174,5.792875506230666
2022-07-28,0,210.65750122070312,195.9900016784668,215.45499801635742,201.79562091827393,211.39875030517578,0.03827606272637592,6.188429466666004,-1.3869157759090676,2.995280910239909,204.34375,5.6344749450683596,0.030047519976266868,197.84499893188476,213.91000061035157,0.8886468120459862,0.05600291114605584,1.0228339048178023,0.9972283161585006,0.9870121112659237,-0.0190227613841516,60.880662714374175,218.33160899436717,205.95475006103516,193.57789112770314,212.92607171194894,2.0606333475293086,209.58482142857142,4.493945033213615,211.6366762382029,208.6969995493211,0.12287342439070421,3.7685027277295693,7477100,2.2524591375280267,1.2506742962855788,40045700.0,-33.449464119840385,89.0859394939463,92.09290994229893,49.66873278379271,18.618313696853036,22.789413036635292,0.3075307357587124,5.922889222634698,213.32876458740233,210.3956228942871,208.0250015258789,205.65438015747068,202.72123846435545,0.02,0.0,210.87981328080411,-0.022387645306414683,-0.009467077397501014,209.3961900983538,206.51949419294084,5.622169002189356
2022-07-29,0,212.0250015258789,195.9900016784668,215.45499801635742,202.3599977493286,211.39875030517578,-0.14631065527440748,6.034028779269469,-1.3027239860046194,2.995304862167606,207.1512508392334,5.506625175476074,0.02921299827382994,197.84499893188476,213.91000061035157,0.845701537755267,0.07483799896231048,1.0264926188061991,0.9998373164316073,0.9972367606093134,-0.015919781495243424,65.10776344879555,218.62093250513314,206.55287494659424,194.48481738805535,212.8328574044364,2.0883237626743787,210.16160719735282,4.225269904447531,211.38249411039078,208.8238228036514,-0.14930790834673247,3.970630677577383,6059700,2.1147606935939516,1.0220131620224044,46105400.0,-29.66651704099663,89.0859394939463,92.09290994229893,60.863145954391,19.39767098448082,21.5760643228512,0.2922050332226732,5.809110995152176,213.32876458740233,210.3956228942871,208.0250015258789,205.65438015747068,202.72123846435545,0.02,0.0,210.88500897246,-0.007440081032916823,-0.018872153342630302,209.2193385532924,207.01426914760046,5.160302853283982
2022-08-01,0,210.3400001525879,197.61999893188477,215.45499801635742,202.4724998474121,212.18812656402588,-0.2340834011032703,5.628960307183339,-1.3229634800657641,2.9953629491498037,209.56999969482422,5.1719128417968765,0.02714653849095593,200.30449714660645,213.91000061035157,0.8326635680355984,0.07289243331571531,1.0143974373106064,0.9907467791691614,0.9925139078817897,-0.016263874089612163,67.09690325032601,218.6125455533315,207.35462493896483,196.09670432459816,212.2039293561663,2.0802779956996007,210.5617858341762,3.926797977732234,211.54536729440963,209.20020495425183,-0.3068026224863046,3.959304110189929,8028400,2.109962134483526,1.3109710794071205,38077000.0,-33.39971548337062,89.0859394939463,92.09290994229893,41.41304770365657,17.87564415712119,22.653162907037114,0.26931986230590366,5.853460978021078,213.32876458740233,210.3956228942871,208.0250015258789,205.65438015747068,202.72123846435545,0.02,0.0,210.88551315834528,-0.013580885984368574,-0.010949734214300321,208.54139709472656,207.47325025285994,4.769543994420198
2022-08-02,0,206.7074966430664,197.86999893188477,215.45499801635742,202.58250522613525,212.18812656402588,-0.3284224982330035,5.195014354708617,-1.2287473754732572,2.9954194333379673,209.69874954223633,4.707250289916994,0.024977156324755584,202.03974571228028,213.91000061035157,0.8089612356596397,0.0630211820286906,0.9938308356112994,0.973281616622365,0.9785850343404922,-0.030952626167163544,60.485018557988205,218.38065370941723,207.990625,197.60059629058276,210.954286302839,2.4040039533941084,210.86857141767229,3.369360448621614,211.2540799276548,209.30938876390675,-2.0501281347848295,2.736431252899277,9939400,2.1776448227633485,1.5492863344384744,28137600.0,-58.785495272360556,89.0859394939463,92.09290994229893,-36.66400013802995,16.285500767682766,24.984059194567024,0.2214057800144901,5.966071949966644,213.32876458740233,210.3956228942871,208.0250015258789,205.65438015747068,202.72123846435545,0.02,0.0,210.85239779644778,-0.02931907601453343,-0.03738273388824471,207.49711390904017,207.62133135114397,4.424852055851934
2022-08-03,0,208.42000198364258,200.5749969482422,215.45499801635742,203.61562728881836,212.18812656402588,-0.22909188880507517,4.664106350591547,-1.3491309389086057,2.9954814446615883,209.69874954223633,4.177000427246094,0.022377059015040352,202.3914981842041,213.91000061035157,0.8059209947957444,0.03057459697435116,0.9999400386123883,0.9833196211168572,0.9928993625870685,-0.006684221846126381,47.63387622082137,217.76071258674216,208.43249988555908,199.104287184376,210.1832150050572,2.1885364836726264,211.29196439470564,2.4947780884080806,210.13050272303138,209.02704668533445,-4.060013206389811,2.1219036380277863,9520100,2.3190695118439724,1.423903833656276,37657700.0,-56.84650680675455,89.0859394939463,92.09290994229893,-7.275341638927524,17.29885180169519,23.738352608729727,0.19880358026366846,5.830638231895382,214.08868487548827,211.6256633605957,209.63500213623047,207.64434091186524,205.18131939697267,0.02,0.0,210.8365239673402,-0.009454890191754162,-0.018871438194828505,206.6844264439174,207.80169568743025,4.037806985642104
2022-08-04,0,211.85750198364258,202.20249557495117,215.45499801635742,204.54062461853027,212.18812656402588,-0.261545407789304,4.302675676715036,-1.2312014229958317,2.995519598156499,209.69874954223633,3.7063001251220724,0.020604241948741584,202.4845001220703,213.91000061035157,0.7995127955769168,0.030748910348570548,1.0145229521132866,1.0015494365332198,1.010625872609951,0.005696453988041084,51.24144563290366,217.43010149075914,208.8247501373291,200.21939878389904,209.97571509225028,1.8913488149810274,211.4550004686628,2.448086460384622,209.6926598100439,209.00648210824542,-2.5243485951850078,2.9272697356857558,6789700,2.321662890719787,0.9995340699395616,44447400.0,-27.26735787943665,89.0859394939463,92.09290994229893,57.39943832684063,21.487365591645332,21.89006363671263,0.20187671290305462,5.871307731495614,214.08868487548827,211.6256633605957,209.63500213623047,207.64434091186524,205.18131939697267,0.02,0.0,210.84372636018261,0.010030701700886935,0.014253909579680202,206.82198006766183,208.04241507393974,3.8317943899414115
2022-08-05,0,213.25749969482422,202.4124984741211,215.45499801635742,206.21499729156494,212.18812656402588,-0.4307640668021951,4.067817169039759,-1.0019151360035559,2.9955428698441104,210.08125114440918,3.3819998931884783,0.019434645964159353,202.60050621032715,213.91000061035157,0.7470550327611493,0.0456289459133982,1.0188717519841466,1.0095447696822804,1.016140940723647,0.005812985072870758,58.97017135287882,217.44313479584318,209.30750045776367,201.17186611968415,210.46642902919226,2.255520517604729,211.7187502724784,2.4276242045202197,210.22579076974327,209.54061194364954,-0.6809335616226329,1.089111329422608,5553700,2.4235329976040503,0.8061154284951215,50001100.0,-13.040965346198826,89.0859394939463,92.09290994229893,87.32776514779336,21.363774545457815,20.431203703609583,0.21953806734327405,5.841214002476818,214.08868487548827,211.6256633605957,209.63500213623047,207.64434091186524,205.18131939697267,0.02,1.0,210.85680872153358,0.017726517789338425,0.021386260198935875,207.5799320765904,208.65017809186662,3.751943105315992
2022-08-08,0,214.30750274658203,202.4124984741211,215.45499801635742,207.99187564849854,212.82250118255615,-0.6092082595875437,3.8474439020212303,-0.6842510458257265,2.995563536701104,210.4987506866455,3.0875251960754384,0.018335152897402472,203.8042507171631,213.91000061035157,0.725328751320375,0.04563617993168484,1.0212912598556192,1.015571882278658,1.0199460901604738,0.018862330470267086,61.10461319065686,217.53463790322462,209.83975009918214,202.14486229513966,210.98785781860352,2.6875751051545853,211.95696476527624,2.5109601943664037,210.97691110199224,210.18662899666626,1.6370968431038562,1.7619818244462742,4063400,2.424727913345915,0.5953743250866307,54064500.0,-28.156473494314817,89.0859394939463,92.09290994229893,79.22831635909213,20.99309656508964,19.2690061323813,0.19693516543313008,5.7511271362633645,214.08868487548827,211.6256633605957,209.63500213623047,207.64434091186524,205.18131939697267,0.04,0.0,210.86600228554448,0.009273264831999528,0.005704513911159181,207.85644313267298,208.6263166155134,3.5768871443290084
2022-08-09,0,211.36499786376953,202.4124984741211,215.45499801635742,209.27875232696533,213.27062511444092,-0.8115905694793103,3.714594632604793,-0.2105536597447606,2.995575594911023,210.81500053405762,2.9146128463745127,0.01765847389226791,204.51299934387208,214.35100212097169,0.7029761198938458,0.046742797705273384,1.0047888573777886,1.0013952537962654,1.002157305258647,0.02253184473877834,62.771417909776005,217.78681446357385,210.35762519836425,202.92843593315465,210.8935715811593,2.656523353219624,211.86321449279785,2.5064866316290306,211.80096608704693,210.8426223227688,1.7326710441015092,1.5807761208602993,4596800,2.4271311203898462,0.6844738873837353,49467700.0,-46.295246080610305,89.0859394939463,92.09290994229893,8.948890553736046,20.003165103892933,21.291643283452917,0.18702291865688853,5.6046174104403415,214.08868487548827,211.6256633605957,209.63500213623047,207.64434091186524,205.18131939697267,0.04,0.0,210.86694987894398,0.019393104588590893,-0.0052043908217558965,207.5967734200614,208.40805598667689,3.293589350222562
2022-08-10,0,213.27000045776367,202.4124984741211,215.45499801635742,209.5724983215332,213.27062511444092,-1.0564389618352839,3.487098096234612,0.6020473819716674,2.995594485713998,211.16874885559082,2.620850086212158,0.01655092621868233,206.28599700927734,214.35100212097169,0.6115110058654881,0.04422898515228315,1.0122502851429125,1.0113526425762773,1.0067432471801296,0.023270312004419536,55.659566175800705,217.66319632216894,210.6890001296997,203.71480393723047,211.31214305332728,2.782602387904922,211.7580362047468,2.405220050162198,211.68285719177692,211.07176993633752,-0.3112857716587813,-0.61713336123421,5746400,2.4685712449234645,0.8676076922728502,55214100.0,-35.388248659316936,89.0859394939463,92.09290994229893,43.52770866183576,20.61506488134073,20.032397455015964,0.1351538795402386,5.531430385424018,214.08868487548827,211.6256633605957,209.63500213623047,207.64434091186524,205.18131939697267,0.04,0.0,210.8746812960795,0.017363770070445872,0.028313864934723612,207.70063999720983,208.12101854596818,2.8645129440285815
2022-08-11,0,212.11499786376953,202.49250030517578,215.45499801635742,209.7606258392334,213.2800006866455,-1.155903280351797,2.961957783525043,1.5451369392322123,2.9956334149173904,211.61124992370605,2.2534375381469713,0.014022305015829604,208.24875144958497,214.35100212097169,0.41824329582384345,0.053224194161982076,1.0041808208819374,1.0042337101573335,0.9967271379425029,0.0012154201655167896,59.57704688960941,217.15579079593192,211.23187522888185,205.30795966183177,212.08464322771346,1.902707191616679,211.51946476527624,2.16384898718426,212.08509233769897,211.712637350321,1.3929829338453257,-0.685703135979018,6639600,2.4869189483206915,0.9947003546829764,48574500.0,-36.86901531630514,89.0859394939463,92.09290994229893,0.7463773789955557,19.813257960560257,20.215584630145468,0.060894919783730315,5.344185149280283,213.15660394287107,210.87170260620115,209.0250015258789,207.17830044555663,204.8933991088867,0.04,0.0,210.87868827649265,-0.00944452762302439,0.014264520177565538,208.4296591622489,207.96338653564453,2.546873044704855
2022-08-12,0,211.91250228881836,206.7074966430664,215.45499801635742,210.21062564849854,213.2800006866455,-0.3476960378028189,2.1821719317641244,-0.42096217380697,2.995679088291399,211.94125175476074,1.7992001724243152,0.010307217462617764,209.45050239562988,214.35100212097169,0.5824707204834809,0.012119770738465699,1.000942323720821,1.0025832012027882,0.9955346986665138,-0.0063069172616699865,52.36005703826996,216.07734397033977,211.71300010681153,207.3486562432833,212.58357184273856,1.047162567531927,211.38339342389787,2.065903483074306,212.11298086823393,212.08404444981915,2.6160160170874525,-1.5502077850773814,6443700,1.9795887484562373,0.9711863448821568,42130800.0,-35.271572161354904,89.0859394939463,92.09290994229893,-9.870755337694339,18.961712732571023,20.021719327560465,0.03664704954071545,5.185314062255916,213.15660394287107,210.87170260620115,209.0250015258789,207.17830044555663,204.8933991088867,0.04,0.0,210.8817503947888,-0.019297177336737414,-0.008271345891019242,208.8822261265346,207.783326285226,2.512067013263849
2022-08-15,0,213.4749984741211,206.7074966430664,215.45499801635742,210.57812595367432,213.2800006866455,-0.4899624363247534,2.12641757245955,-0.10115842019615906,2.995681804474236,211.96875190734863,1.6789000701904286,0.010038327071225522,209.45050239562988,214.35100212097169,0.5578297190884383,0.01120177424695931,1.007766246840194,1.0100293146472161,1.0041440408900004,-0.003884624951490223,51.78020897386962,216.08271051875943,211.82987537384034,207.57704022892125,212.81464276994978,1.0386693604539203,211.39517893110002,2.0781739865500906,212.07013688936956,212.09830606778993,1.6757030380653595,-0.8909461432205238,5290600,1.9807904268854215,0.7935550835763227,47421400.0,-2.7476529266143532,89.0859394939463,92.09290994229893,98.945471035441,22.09558986490676,18.293061166195155,0.10068790031059988,5.269935410742856,213.15660394287107,210.87170260620115,209.0250015258789,207.17830044555663,204.8933991088867,0.06,0.0,210.89528791243995,0.0163290008319823,0.0043235052730691125,209.350093296596,208.0860366821289,2.4753031118408284
2022-08-16,0,215.35750198364258,206.7074966430664,215.45499801635742,210.89375019073486,213.35125064849854,-0.7104958135298219,2.088604929318944,0.2780167541258245,2.9956836393144153,212.06999969482422,1.6173746109008789,0.009850730968358748,209.68225212097167,214.35100212097169,0.5500770643046088,0.011861729033494604,1.0157156982055038,1.0174270032002484,1.013792953371916,0.018889145129158624,55.04498636620703,216.20258503411395,212.02537517547609,207.84816531683822,213.11464309692383,1.4208573464364982,211.79053606305803,2.2733046522524605,212.44070807923265,212.29178789346767,0.7634832259106887,0.07735085076547084,6564400,1.9863728317201785,0.9726730208591866,53985800.0,-3.435679445151489,89.0859394939463,92.09290994229893,125.35349926601792,21.634923782427578,16.938185623093656,0.1085447978341005,5.284939749252148,214.38151873779296,212.3842375793457,210.7699966430664,209.15575570678712,207.15847454833985,0.08,0.0,210.91709079847524,0.03455046934624795,0.019710221443595702,209.58233424595423,208.58113316127233,2.707257717074584
2022-08-17,0,214.61249923706055,206.7074966430664,215.45499801635742,211.18812370300293,213.56062412261963,-0.7330068329798819,2.1940661047245893,0.1880804944880552,2.9956787041971173,212.39624977111816,1.7223749160766602,0.010337440120363275,209.68225212097167,214.80399703979492,0.5543573010591931,0.012601240300572547,1.0111563435428514,1.0097807933929526,1.0065024857289844,0.006294831792635236,58.67012325376585,216.63275749173678,212.2446252822876,207.8564930728384,213.15821402413505,1.4674458244634672,212.07303592136927,2.365542779925989,213.18257850819614,212.65522835145688,0.9847261136529806,2.637943876876669,4902500,1.9941524491215754,0.724050666562299,49083300.0,-22.587679427304757,89.0859394939463,92.09290994229893,76.54140627999728,20.33553941639592,15.920885363156227,0.09356000496540755,5.221015318509906,214.38151873779296,212.3842375793457,210.7699966430664,209.15575570678712,207.15847454833985,0.08,0.0,210.9293219508201,0.013201134542517146,0.022067708647245197,209.8040989467076,208.8302710396903,2.749112508780454
2022-08-18,0,214.3874969482422,206.7074966430664,215.45499801635742,211.18812370300293,213.94000148773193,-0.7482859443885496,2.252895423136208,0.04631792932390644,2.995675837630099,212.68624877929688,1.8191247940063477,0.010609780695996423,209.68225212097167,214.80399703979492,0.5904450219427788,-0.0006053634261615875,1.0096360013986019,1.0057915989328812,1.0041827633915037,0.010713523830748528,54.89631346338849,216.84716600648972,212.3413751602173,207.83558431394488,213.58999960763114,1.2852252892852956,212.24178559439522,2.444791269669751,213.54319591407574,212.90991721365236,0.14231722481465012,1.8774541582612916,4516400,1.9496854407262307,0.6684338041259847,44566900.0,-17.25145644387881,89.0859394939463,92.09290994229893,82.13256279640827,19.31937347125923,15.573238746867219,0.08970507141490709,5.1030859716216215,214.38151873779296,212.3842375793457,210.7699966430664,209.15575570678712,207.15847454833985,0.08,0.0,210.94075728435666,0.019755420688431613,0.016648884981823882,210.5580095563616,209.0773914882115,2.7156535531450903
2022-08-19,0,213.63750076293945,206.7074966430664,215.45499801635742,211.18812370300293,213.94000148773193,-0.7659635119900476,2.2352369588793803,0.08754989046564399,2.995676707283432,212.68624877929688,1.8013748168945312,0.010527499975340651,209.68225212097167,214.68699951171874,0.570515266664082,-0.004954635900505725,1.0061880800061742,1.0010847914648366,0.9985440501065743,0.008140144897020196,53.628460923376686,216.79409910086423,212.32362518310546,207.8531512653467,213.64249965122767,1.2774575914100497,212.47732135227747,2.406011865162781,213.7541354298991,212.9828743247535,1.4299903555558138,1.1142532273840944,4178800,1.9427066484235354,0.6225813107908085,40388100.0,-35.01455049618921,89.0859394939463,92.09290994229893,46.163732546666154,18.52091368317394,14.987398547270946,0.0863140315390312,4.94286533075944,214.38151873779296,212.3842375793457,210.7699966430664,209.15575570678712,207.15847454833985,0.08,0.0,210.9481356665341,0.007050556374227579,0.008243274348021459,210.71197727748327,209.20630863734655,2.708258762702941
2022-08-22,0,209.5,206.7074966430664,215.35750198364258,211.18812370300293,213.6825008392334,-0.8890292496809636,2.1410428960199916,0.2843769076086762,2.9956812328384745,212.68624877929688,1.7104999542236328,0.010088183340164932,209.68225212097167,214.409997177124,0.5956977487610466,-0.0008418408421976603,0.98712380480247,0.9815220860496972,0.9776288673840271,-0.0186204403444602,52.391803407045295,216.51483611247457,212.23275032043458,207.95066452839458,213.26892852783203,1.985008033031419,212.67678587777274,1.9664918029053995,213.7279337139936,212.94889407333548,0.1723169242682876,1.5677002034607976,5139500,1.9145900046613857,0.7612754529955549,35248600.0,-83.87701382677216,89.0859394939463,92.09290994229893,-96.60258140397337,17.278603197923154,20.06540011479123,0.03647043210703255,4.919804228089783,215.07772161865233,213.51114224243165,212.24500274658203,210.97886325073242,209.41228387451173,0.02,1.0,210.942456509722,-0.03608711962562594,-0.012870830567747607,210.3646719796317,209.3971655709403,2.7956023407810657
2022-08-23,0,207.65750122070312,206.7074966430664,215.35750198364258,210.57812595367432,213.51562404632568,-0.6530215692950765,2.1875299113367053,-0.19433007262383084,2.995678923703027,212.06999969482422,1.756937313079834,0.010317716024168255,209.39200019836426,214.409997177124,0.5062086206650803,-0.017861334905828162,0.9794385515736179,0.975086084676235,0.9726392227995507,-0.035754504449649005,40.76478584665829,216.39193508970223,212.0168752670288,207.6418154443554,212.661071232387,2.906983894781769,212.62232153756278,2.0995173509098355,212.66768365651404,212.40917415543095,-1.2328208236595362,1.3509444032189932,3525500,2.1243760559048432,0.5325210957956437,31723100.0,-97.56313873790005,89.0859394939463,92.09290994229893,-138.92176349391335,16.561329173113677,21.73515846842633,0.04194604195041303,4.766246875265304,214.99512017822266,213.37743991088868,212.06999969482422,210.76255947875975,209.14487921142577,0.04,0.0,210.93417358438654,-0.04761903402002132,-0.04445056185240258,209.7277090890067,209.30496760777064,3.0211775108313565
2022-08-24,0,206.83250045776367,206.7074966430664,215.35750198364258,210.21062564849854,213.51562404632568,-0.4819729368769045,2.3605102341462776,-0.6705968603166195,2.995670015178522,211.96875190734863,1.940400085449221,0.011148457234738236,208.34375190734863,214.409997177124,0.5602244773727358,-0.010318249441719477,0.9768495186979409,0.9729059140467821,0.9758137225365157,-0.03625137774805509,38.49663670259114,216.45527072769195,211.7342502593994,207.01322979110685,211.71214294433594,3.5988386468423617,212.26339285714286,2.608228287661708,211.40026429790097,211.6624354451758,-2.0079046880943516,-0.3658481698888461,4230800,2.0195877547943657,0.7098270647993188,27492300.0,-91.70155209792222,89.0859394939463,92.09290994229893,-145.76530292063887,15.877154741721979,22.15241007067726,0.010414948636585946,4.616515721746129,214.79451873779297,213.05273757934572,211.6449966430664,210.2372557067871,208.49547454833984,0.06,0.0,210.92241092898092,-0.03659340421892421,-0.04821775155364188,208.3567657470703,208.85342952183314,3.2050939540112693
2022-08-25,0,208.40500259399414,206.7074966430664,215.35750198364258,210.13000011444092,213.51562404632568,-0.5304551675939605,2.5628649597639805,-0.814258830569552,2.9956587536007633,211.96875190734863,2.1198001861572267,0.012112711136499628,207.57500114440919,214.409997177124,0.6149304856142699,-0.01815743916440008,0.9849717544442838,0.9832801687625544,0.9905039505848551,-0.027905052483971793,35.90962350000001,216.71048009500404,211.58475017547607,206.4590202559481,210.71892874581474,3.3776977193159783,211.91678592136927,2.7825573499422527,210.2504898026105,210.96210507622425,-3.1116046674489946,-2.371878021230933,4495000,2.0125399653975777,0.7735036704857156,31987300.0,-65.29746944726897,89.0859394939463,92.09290994229893,-81.95089180638001,17.48313334862063,20.96139329000245,0.019706075038249456,4.530336185776051,214.79451873779297,213.05273757934572,211.6449966430664,210.2372557067871,208.49547454833984,0.06,0.0,210.91568137071602,-0.02522641845082607,-0.021909430412189162,207.32750374930245,208.45491899762834,3.2261246058385296
2022-08-26,0,206.40499877929688,206.7074966430664,215.35750198364258,209.23000049591064,213.51562404632568,-0.43697740965751347,2.6491777270916255,-1.0676229927425709,2.9956536595836876,211.96875190734863,2.254950103759768,0.01252731405632397,207.57500114440919,214.409997177124,0.6863782826919952,-0.01707345315803676,0.9760387972694092,0.9755515331468823,0.9866089140906362,-0.03385408440846749,40.53689007240986,216.77048069832387,211.4721252441406,206.17376978995736,209.54642868041992,3.221797041525656,211.35232135227747,3.049056819346543,209.77869237126885,210.58142621364348,-3.228352541986911,-2.2754168588556554,5060200,2.0214515285555428,0.8783170998629637,26927100.0,-98.72567139678777,89.0859394939463,92.09290994229893,-152.09796387416827,15.494210879714148,24.29499595300323,-0.024624824482317138,4.746740810040453,214.09123974609375,211.91437921142577,210.15499877929688,208.39561834716798,206.2187578125,0.08,0.0,210.89616787603063,-0.04665913555591428,-0.05742151967382779,205.6922127859933,207.74815586635046,3.7416781358716316
2022-08-29,0,202.04000091552734,206.40499877929688,215.35750198364258,208.41625213623047,213.51562404632568,-0.3273213362478563,2.864906014851087,-1.284157592948806,2.995640121568597,211.88500213623047,2.5261499023437524,0.013565465941819947,206.82000007629395,214.409997177124,0.6859012308498075,-0.018707812924010792,0.9566689926640813,0.9574130365863158,0.9724682341258174,-0.03560858751538265,36.8609476973757,216.9209371365137,211.1911251068115,205.46131307710934,207.78250067574638,3.497863129512955,210.68625014168876,3.935692262003889,208.9307890363334,209.96530945967314,-3.8243347833611887,-3.6874602456778396,4476200,2.03488768694716,0.8016641488922539,22450900.0,-89.93521977049855,89.0859394939463,92.09290994229893,-181.49343385401087,14.698626337595218,26.245178072884812,-0.03752946391217463,4.646260048254465,213.60035931396484,211.11981851196288,209.11499786376953,207.1101772155762,204.62963641357422,0.1,0.0,210.86991393049547,-0.030104012379556178,-0.04929041085831935,203.87554059709822,207.2167750767299,4.207989605180865
2022-08-30,0,202.4800033569336,202.04000091552734,215.35750198364258,208.2181272506714,213.51562404632568,-0.722577112197451,3.4909016771347394,-0.2893185148871096,2.995594557043895,211.88500213623047,3.024149856567385,0.01656213043452582,206.67724685668946,214.409997177124,0.6343847259148305,-0.022580195703297074,0.9606401257148107,0.9647256839019897,0.9816355546088,-0.02493287183623949,30.367902739135154,217.75792849922794,210.77612514495848,203.79432179068903,206.1885724748884,2.8711635523306827,209.91553606305803,4.417765485279564,207.2039217570462,208.92955216156918,-5.759429168435041,-4.411798094522917,3918200,2.105144929754133,0.7417216035740146,26369100.0,-93.27587023359986,89.0859394939463,92.09290994229893,-169.15710864388703,14.439583764338359,24.538871206021977,-0.05130208468129141,4.614384081995184,213.50360205078124,210.96320294189454,208.91000366210938,206.8568043823242,204.3164052734375,0.12000000000000001,0.0,210.84625503229526,-0.026208984601065355,-0.03465813500050808,202.2669634137835,206.48947034563338,4.569469275819775
2022-08-31,0,200.38000106811523,202.04000091552734,215.35750198364258,208.2181272506714,213.51562404632568,-0.8213815373152784,3.841264142502834,-0.32506002908771725,2.9955650197015506,211.88500213623047,3.277799453735349,0.01824267420702876,206.01249923706055,214.409997177124,0.7414969898387999,-0.028500137079814313,0.9516312707170211,0.9606140137452305,0.9763560833507087,-0.03119673830451064,30.44794648755658,218.24727876565754,210.56475048065187,202.8822221956462,204.88571548461914,3.1715762652887256,209.0773220062256,5.038076789915001,206.03652623918998,208.3223557276313,-5.222630561657176,-5.059313113738632,6559000,2.0615728709351626,1.2774319702718073,19810100.0,-99.63095772422858,89.0859394939463,92.09290994229893,-171.39323262468693,13.425721319227124,25.24937731212736,-0.10796052502310674,4.608356555010742,213.1330803222656,210.36346014404296,208.125,205.88653985595704,203.1169196777344,0.14,0.0,210.79881173940896,-0.03851555271910989,-0.03911999318721427,200.8749237060547,205.61979784284318,5.231668125064769
2022-09-01,0,198.98500061035156,200.38000106811523,215.35750198364258,207.45125102996826,213.51562404632568,-0.8704331069263711,4.421556841171547,-0.4376777064928916,2.9955095658294404,211.88500213623047,3.7601995086669944,0.021038727519611923,202.43600311279297,214.409997177124,0.7777811922546382,-0.05417556993763439,0.9468138392679266,0.9604797935253049,0.9756940664513218,-0.04520046000044553,23.756415558305132,219.00586411721855,210.16275043487548,201.3196367525324,203.64678682599748,3.5764136214888094,208.15392902919226,5.62855610871489,204.63527052468802,207.52388713387077,-4.353221447200365,-5.532374850358803,5608300,1.8955472505202122,1.1049857648090318,14201800.0,-83.4367459371191,89.0859394939463,92.09290994229893,-158.11195405879968,12.630872736102306,26.863887440005993,-0.09984968011291222,4.548473109724023,212.6658013305664,209.60710177612305,207.13500213623047,204.66290249633786,201.6042029418945,0.16,0.0,210.75441325499153,-0.046182369422456016,-0.03164454794070916,199.9370596749442,204.83238438197546,5.599036760256788
2022-09-02,0,199.88249969482422,198.98500061035156,215.35750198364258,206.72562503814697,213.51562404632568,-0.7595695966452848,5.02388366575872,-0.7260123323682901,2.9954429881128566,211.63875007629395,4.298711929321288,0.02397816264733663,201.87400093078614,214.409997177124,0.8017668715306089,-0.06692612970187163,0.9540059855894147,0.9720386697396334,0.9892332833095699,-0.03160048992537712,20.4722260622078,219.56689269772838,209.51912536621094,199.4713580346935,202.653929574149,3.5086828952444167,207.18303625924247,5.80950331983783,203.22289819466994,206.56039894133625,-4.176348342521098,-6.1003959364548175,4508100,1.8420092410939144,0.8974611649615681,18709900.0,-94.74944627703702,89.0859394939463,92.09290994229893,-136.2050784924073,14.69832848325219,24.528445893292062,-0.18491394316699328,4.625724348584203,212.6658013305664,209.60710177612305,207.13500213623047,204.66290249633786,201.6042029418945,0.16,0.0,210.7188361006533,-0.02528475840521538,-0.05747793275948324,198.6842258998326,203.52049582345145,5.948154819912085
2022-09-06,0,198.2449951171875,198.98500061035156,215.35750198364258,205.42374992370605,213.51562404632568,-0.556444069040567,5.360656313368449,-1.106779611926611,2.995401226641217,210.43249893188477,4.6585869598388685,0.025667448784656235,200.33025093078612,214.409997177124,0.8389736111573736,-0.06730983687871785,0.9492202002010899,0.9705676520997976,0.9875045466312984,-0.018783437839750006,23.40147508170777,219.5716879929478,208.85037536621093,198.12906273947405,201.20249993460519,2.7532544419484797,205.96071434020996,5.757296187293382,202.37982291225683,205.7411372024351,-3.360207292160393,-6.367255592670563,4547800,1.8344599066422387,0.9010201311965194,14162100.0,-88.67540125680603,89.0859394939463,92.09290994229893,-125.83004983726876,13.859403584621917,23.834086897254725,-0.1557011094412632,4.555315372786397,211.5119129638672,208.62403314208984,206.2899932861328,203.9559534301758,201.06807360839846,0.18,0.0,210.68111901124405,-0.018237663593049347,-0.02094738378334612,197.1122087751116,202.21985626220703,6.219288403958747
2022-09-07,0,199.37250137329102,198.2449951171875,215.35750198364258,202.37000274658203,213.32124996185303,-0.4117267755135083,5.676822903767135,-1.2817337465946255,2.9953585300875076,208.95250129699707,4.9517748641967785,0.027286219376528604,199.79274978637696,214.409997177124,0.8634609975386659,-0.06207273143227919,0.9583039496456386,0.981495958888059,0.9968899214914093,-0.015347204326960795,22.14327325032135,219.40089579227543,208.0472499847412,196.69360417720696,200.19785744803292,1.5652590284713561,204.87214306422644,5.426893971568836,201.33825484856519,204.81387617712252,-4.8751264846554285,-7.946092756849889,4098300,1.774892339337077,0.8159937401256157,18260400.0,-79.48978050705887,89.0859394939463,92.09290994229893,-96.76923213973411,14.741136340167385,22.354343879696312,-0.09751485587740073,4.509935542492519,211.37439855957032,208.51279766845704,206.1999969482422,203.88719622802736,201.02559533691408,0.18,0.0,210.65070911662323,-0.004767126358524831,-0.009440217701118706,196.76489911760603,201.22855595179968,6.395700032773328
2022-09-08,0,199.04500198364258,198.2449951171875,215.35750198364258,201.62500095367432,213.32124996185303,-0.22366554636652294,5.922749275016021,-1.4768412677170861,2.995323753263819,208.03125190734863,5.240612506866455,0.028550576418706772,199.33375129699706,214.409997177124,0.8819347543648587,-0.06516387234324097,0.9594952067053786,0.9838966677086827,0.9983548545198486,-0.006662336946584024,25.262576651939344,219.29312371024932,207.44762516021729,195.60212661018525,199.77000045776367,1.3756432977189077,203.776250566755,4.879038404891069,200.84977342410772,204.33225956540036,-3.4071352184282673,-7.101169744514954,4377600,1.722777280042174,0.8836451168494305,13882800.0,-77.11092725294021,89.0859394939463,92.09290994229893,-86.32570851299923,13.766678134926511,21.290758678237268,-0.03115884402012455,4.484225409127661,210.78611529541013,208.03693502807616,205.81499481201172,203.59305459594728,200.8438743286133,0.18,0.0,210.61841050457696,0.01006492700996997,-0.0033270192484898117,196.53710719517298,200.20632389613561,6.459433063461955
2022-09-09,0,203.75500106811523,198.2449951171875,215.35750198364258,200.25562572479248,212.45499801635742,-0.03621351497081314,6.033927711518637,-1.541988941352964,2.995306107004894,207.2450008392334,5.379237422943115,0.029186579790884324,199.03900184631348,214.409997177124,0.8946554386173557,-0.0616174999964931,0.9855788602030715,1.0110706442543693,1.0233493783108314,0.023971658381951144,25.188705237506653,218.8042306595485,206.73637523651124,194.66851981347398,199.9521429879325,1.8100759531610935,203.07035773141044,3.973425331187548,200.39954569701615,203.76435563927348,-1.4823791914042659,-7.156431780302758,4885600,1.7219787325985105,1.0039608945148546,18768400.0,-40.740744546398076,89.0859394939463,92.09290994229893,-25.00598654110284,20.81001547581053,19.397434180597976,0.039866412463356024,4.570351299216493,207.74539855957033,205.57729766845705,203.8249969482422,202.07269622802735,199.9045953369141,0.02,1.0,210.59793374946995,0.025333523066217722,0.032660809073148105,197.0742405482701,199.67060198102678,6.3840090862672305
2022-09-12,0,206.31750106811523,198.2449951171875,215.35750198364258,200.25562572479248,212.30312633514404,0.1300335145716568,5.9356137248013665,-1.46664520795176,2.9953188691503447,206.61874961853027,5.268037338256835,0.028769195731537755,199.03900184631348,214.409997177124,0.9110611407112951,-0.03849466705643048,0.9999957622358571,1.0261540177809034,1.0312781226905718,0.03219392084407491,43.85993898077208,218.18960284633124,206.31837539672853,194.4471479471258,200.80035727364677,3.026458281226108,202.84303637913294,3.6556132327722226,201.25413812646013,203.94667408765207,0.6296906805824489,-4.625826299002734,3812300,2.102260819906121,0.8051736573486907,22580700.0,-26.190400174386053,89.0859394939463,92.09290994229893,2.588566039488902,21.33530211820317,18.692695159278728,0.07549832523946953,4.403897939194037,206.98903436279295,204.96547427368162,203.32999420166016,201.6945141296387,199.67095404052736,0.04,0.0,210.5869541607871,0.04485243520596316,0.03247879429038302,198.1878705705915,199.53139713832311,6.281074050223838
2022-09-13,0,201.01499938964844,198.2449951171875,215.35750198364258,200.25562572479248,210.49374961853027,0.2396460657256185,5.795561875037102,-1.3240866559519728,2.99533746889356,206.36124992370605,5.0162622833251955,0.028128521366295005,199.03900184631348,214.409997177124,0.8906060593629358,-0.033528504308074934,0.9756180379389542,0.9998246645510154,0.9983511016691553,0.013972631545242864,50.05238484782004,217.62974908576757,206.03862533569335,194.44750158561914,201.09035709926061,2.9188625210005763,202.36857196262903,3.4051614913456327,202.53886587563412,204.44171391005835,2.963120056068701,-1.5190925689187424,5217900,2.1631066608541003,1.1028889565261502,17362800.0,-76.40689662005738,89.0859394939463,92.09290994229893,-64.37718388022003,18.788609445006493,25.81375405093905,-0.0107024271049496,4.64362033040968,206.98903436279295,204.96547427368162,203.32999420166016,201.6945141296387,199.67095404052736,0.04,0.0,210.552743929237,0.005185174143385707,0.009658136582626214,198.12318420410153,199.03012193952287,5.957092289920084
2022-09-14,0,199.5875015258789,198.2449951171875,215.35750198364258,200.25562572479248,208.6787519454956,0.4439963754844218,5.63003260328155,-1.1157120024173295,2.9953581104365483,205.03625106811523,4.8956249237060545,0.027408005563482454,199.03900184631348,214.409997177124,0.8151441534591932,-0.06659857428641386,0.9716276507944922,0.9932308326719678,0.9885414166373937,0.001078384185918102,37.61923879588059,216.6756905880328,205.41562538146974,194.15556017490667,201.04821450369698,2.9412518274672843,201.85107203892298,3.2200696473338626,202.16997303794943,204.04073895354492,1.0201767837124458,-3.1987776950060116,4632800,2.3546581166266356,0.9996245582085816,12730000.0,-78.28275878013396,89.0859394939463,92.09290994229893,-74.7187172395799,17.950082832138314,25.94360314846797,-0.0717245639154458,4.513362199051879,206.98903436279295,204.96547427368162,203.32999420166016,201.6945141296387,199.67095404052736,0.04,0.0,210.51884175693024,-0.005039185630102749,0.0038765301235134256,198.35519627162384,198.51971108572823,5.414387721790576
2022-09-15,0,197.0749969482422,198.2449951171875,214.61249923706055,199.8087501525879,207.84437656402588,0.5893177960433005,5.2755891323227875,-0.8943117262192204,2.9954015384040096,203.1175022125244,4.611087284088134,0.02578147507608303,199.03900184631348,213.71250038146974,0.7819414731433305,-0.0700098911507715,0.9630932194492531,0.9821412831427662,0.9758893354862906,-0.009897284612864987,35.56323074523959,215.17830362322712,204.62712535858154,194.07594709393595,200.88107190813338,3.152740505200397,201.04178592136927,2.8485178630306818,201.520401259603,203.43401428953055,-0.14758579135027258,-3.5028338949875213,6099300,2.359434579450269,1.2992770078263796,6630700.0,-94.65990739959315,89.0859394939463,92.09290994229893,-106.52395610357861,16.340377134371447,29.09386363942073,-0.11856681492113418,4.603836278864864,206.5477155151367,204.251136138916,202.3949966430664,200.5388571472168,198.24227777099608,0.02,1.0,210.46365826429764,-0.026605517909152443,-0.025197011064519305,197.89540318080358,197.5038059779576,5.229958781686677
2022-09-16,0,191.3900032043457,197.0749969482422,214.3874969482422,199.53375148773193,207.03875064849854,0.6544985129231781,4.992922824200144,-0.639793641067782,2.9954335590111008,202.26000213623047,4.31452507019043,0.024505112598475095,198.91100006103517,209.91375007629395,0.7175756745718597,-0.0807533099944705,0.9393362853543274,0.955383188176239,0.9495906881882694,-0.0606856165441354,31.86234277448799,213.7360958925409,203.75025024414063,193.76440459574036,199.74071502685547,4.801741689627967,199.9692862374442,3.43927521050791,200.40681658144052,202.49709668110648,-0.5901779100419144,-5.4365324750983035,9398200,2.385708368372196,1.903059044602883,-2767500.0,-73.22086713673708,89.0859394939463,92.09290994229893,-172.22208806803232,14.596587947258412,35.40699524569335,-0.061738787166496924,4.785704751738637,202.7130821533203,199.94346197509765,197.7050018310547,195.46654168701173,192.69692150878907,0.04,0.0,210.34909466253862,-0.05799227993497014,-0.03691888675399643,196.89426531110487,196.82958221435547,4.929716679775726
2022-09-19,0,192.3550033569336,191.3900032043457,213.63750076293945,199.2906265258789,206.51187419891357,0.12869288206177676,5.05848801562377,-0.15082623640893456,2.9954208192701,201.5275001525879,4.170700149536134,0.024967811642589766,198.12799530029298,208.51450233459474,0.6061065159964978,-0.10413666832435213,0.9494306356942932,0.9638545322762275,0.9662341854865896,-0.06767481012951948,25.471711550588577,212.71735158819334,202.6003755569458,192.48339952569827,198.7850009373256,5.56793399460565,199.27750069754464,3.9297825825394304,198.1552901804117,200.8809990230716,-4.003811014037209,-7.274530977326905,8133600,2.6119357591981096,1.5835801106263179,5366100.0,-74.11700924536163,89.0859394939463,92.09290994229893,-150.59718829893782,14.12514156114013,33.63378457093104,0.006657396049709335,4.678154285810032,202.7130821533203,199.94346197509765,197.7050018310547,195.46654168701173,192.69692150878907,0.04,0.0,210.25545589165193,-0.06533418443177086,-0.05882075186963333,195.82844543457028,196.18277631487166,4.699558635768548
2022-09-20,0,191.62250137329102,191.3900032043457,209.5,199.03000164031982,206.33937549591064,-0.24185666796327474,4.859363662025906,-0.4988707954195548,2.995440952287843,200.69750022888184,3.9566253280639643,0.024111610916000357,196.60299758911134,207.73225135803222,0.6959345607670784,-0.08183769280699955,0.950809101193568,0.9638195207772488,0.976248763958954,-0.046725359027318,29.31467428199519,211.25497801069733,201.5362506866455,191.81752336259368,197.05178669520788,5.650716934615503,198.50196484157019,4.302808511932758,196.6988443086381,199.4462761547081,-3.3610482855825565,-4.793603996588296,5292500,2.554801798935277,1.0288965873876816,73600.0,-79.70476617938286,89.0859394939463,92.09290994229893,-152.54151208596136,13.494948508763127,32.79303115273035,0.05857007011597701,4.5468583348646145,202.7130821533203,199.94346197509765,197.7050018310547,195.46654168701173,192.69692150878907,0.04,0.0,210.19227052611868,-0.03806268188503115,-0.07046410823955435,193.98223876953125,195.52823965890067,4.810495448835882
2022-09-21,0,189.9099998474121,191.3900032043457,208.40500259399414,198.79999923706055,204.39562606811523,-0.2888759489903208,4.95554829691448,-0.6248040858300161,2.9954264678874294,200.13125038146973,3.912612705230714,0.024698413175479605,192.28175315856933,206.9150005340576,0.7279887443467276,-0.07721849561490074,0.9465099241000493,0.9583984071199155,0.9768731345499441,-0.048487513519036574,28.968882453625927,210.55347234913904,200.64237575531007,190.7312791614811,194.70785794939314,4.439918430777694,197.75410761151994,4.828989944202979,195.43330519842533,198.12331332730147,-5.954454924406163,-5.362258891562183,6705900,2.5453093549428525,1.264576984581963,-6632300.0,-99.90091991063885,89.0859394939463,92.09290994229893,-179.8214598244473,12.23443811280241,34.77603122987614,0.020761248314670803,4.657082512689184,202.42516186523437,199.47742150878906,197.09500122070312,194.7125809326172,191.76484057617188,0.06,0.0,210.1009106786669,-0.06213333598695281,-0.06335433847770688,191.22488621303015,194.70637839181083,5.430440616465306
2022-09-22,0,186.00250244140625,189.9099998474121,208.40500259399414,197.95249557495117,202.798752784729,-0.29444736166989227,5.202751173871924,-0.6812321497741278,2.995392128455533,199.73500061035156,3.9962501525878906,0.026045661715540475,191.5992515563965,206.44774894714357,0.7359551646567328,-0.08181741541053036,0.9311531716454362,0.9431828775074406,0.9663948580543683,-0.05618416683139116,27.121819863042987,210.16050303438934,199.7550006866455,189.34949833890167,192.5632155282157,4.510801806069055,196.82678631373815,5.735818967110015,194.05809151572043,196.9304340155061,-7.952549413288128,-5.225072943853341,6604700,2.552665956626579,1.2182253311998819,-13237000.0,-94.98451093986819,89.0859394939463,92.09290994229893,-192.12103217376261,11.739956617174816,37.07934254653055,0.023462331966747088,4.50657679284657,201.8729227294922,198.58354290771484,195.9250030517578,193.26646319580075,189.9770833740234,0.08,0.0,209.9983564453989,-0.049035051607908775,-0.06830152436450333,189.27323041643416,193.69820731026786,5.956095590323015
2022-09-23,0,183.56000137329102,186.00250244140625,208.40500259399414,195.89499855041504,202.1500015258789,-0.45078489371237046,5.738981441212247,-0.42660278985461053,2.9953132650896612,199.48000144958496,4.439450321197507,0.02888068208006506,191.24200286865235,206.3262508392334,0.6909386975291216,-0.10749502110672218,0.923741973481364,0.9369943309462606,0.9648053117934524,-0.040911237264020794,21.871334549221146,210.19146366825214,198.71350078582765,187.23553790340316,190.27357264927454,4.417842938069186,195.66089357648576,6.6525585942367975,192.04296396608123,195.4112159516238,-7.468346637726218,-6.524360192539024,10755800,2.5676077549103984,1.8755923457808414,-23992800.0,-93.06886810504342,89.0859394939463,92.09290994229893,-183.0857864156328,11.067434371633155,38.865448741441014,0.02935486734745817,4.4389639720195975,201.2994408569336,197.65527987670896,194.70999908447266,191.7647182922363,188.1205573120117,0.1,0.0,209.81746062120718,-0.048318656307696495,-0.05840196877847687,187.1008082798549,192.72800227573939,6.169768701742192
2022-09-26,0,182.00749588012695,183.56000137329102,206.40499877929688,192.17187786102295,201.27124977111816,-0.6804220874942621,6.178825909979939,-0.3699159115283104,2.9952390596239904,199.2087516784668,5.038374652862553,0.031289749202992156,189.5192501068115,204.01125106811523,0.7204046558288152,-0.11068044640931095,0.9216911080073286,0.9387466952668042,0.9645847382537681,-0.05379380466441952,20.20607332728474,209.8289025447524,197.47125072479247,185.11359890483254,188.12107249668665,4.2178168061867565,194.50107220241003,7.525546518627758,189.9139273757165,193.7579667788193,-8.030312534630198,-8.166046725678337,9914600,2.5769381507656446,1.658699069066733,-33907400.0,-97.47159316469076,89.0859394939463,92.09290994229893,-169.94692827070463,10.250340687332528,39.73564466785378,0.010309040753299014,4.450466984315869,200.74956042480468,196.76521917724608,193.5449981689453,190.32477716064454,186.34043591308594,0.12000000000000001,0.0,209.64080470690158,-0.06493035189644836,-0.06575272197251911,185.02259826660156,191.45900072370256,7.019536514106422
2022-09-27,0,180.5625,182.00749588012695,206.31750106811523,191.5643768310547,200.53875064849854,-0.723203774686178,6.68248361287027,-0.5326919280068307,2.9951475075175824,199.01500129699707,5.691212158203124,0.03405063324079413,185.75825233459472,202.60750312805175,0.7909594985716455,-0.09915118265999194,0.9200572452881899,0.9431190477863705,0.9675383991728584,-0.057717654732757806,19.803100898470202,209.61634280557453,196.251375579834,182.88640835409345,186.57428632463728,4.768615271494812,193.15750067574638,8.2346381260251,187.9243208847653,192.28209190397158,-7.645567069105378,-8.190622531207994,9799600,2.469558269465991,1.569567094124214,-43707000.0,-97.18266192802929,89.0859394939463,92.09290994229893,-157.1263769569431,9.028465166607152,39.383496756996735,-0.05242889201967777,4.691862387094269,200.06988287353516,195.66506314086914,192.1050033569336,188.54494357299805,184.14012384033202,0.14,0.0,209.45757661567964,-0.0739314349787148,-0.07901417268048305,182.85299028669084,189.87362779889787,7.920996816716348
2022-09-28,0,177.84249877929688,180.5625,206.31750106811523,191.0200023651123,200.00687503814697,-0.609988083527339,7.357581892609996,-0.7909076880426054,2.9950159182362843,198.61499786376953,6.400999679565428,0.03769687526727052,183.4047508239746,202.60750312805175,0.8125873406749856,-0.10824527357547115,0.9111834012254099,0.9389424017324525,0.9643942598502229,-0.06354326300779933,18.24512222850654,209.89266431927769,195.17750053405763,180.46233674883757,184.5010713849749,4.986281725434485,191.64303616115026,8.984159643847512,186.08054812500473,190.85654340924705,-5.6572981990001106,-9.434601684648825,9751000,2.445276597409502,1.492086250572864,-53458000.0,-86.55750691384395,89.0859394939463,92.09290994229893,-149.60848506102948,8.310429647002232,39.55627553939641,0.011742915028491981,4.73315824503732,199.55304229736328,194.82848220825196,191.01000213623047,187.19152206420898,182.46696197509766,0.16,0.0,209.26604597047483,-0.04192074465937823,-0.06711096345879623,180.89148603166853,188.35996573311942,8.480433644012503
2022-09-29,0,179.9650001525879,177.84249877929688,206.31750106811523,188.93312549591064,199.66125106811523,-0.5363134068700615,8.060724635223693,-0.8993230904860146,2.9948616288641805,197.65999603271484,7.025812149047852,0.0415617760005674,181.86299629211425,201.28899955749512,0.8297077619917322,-0.11247381060327064,0.9279147176916767,0.9611833391572335,0.9888458499099408,-0.032459253018492396,16.595768095256346,210.06707457562314,193.94562530517578,177.82417603472842,182.83571406773157,4.07482729410186,189.94375038146973,8.764207978763043,184.00169481885285,189.22521228269312,-7.544646265689976,-10.65211534730629,9105200,2.461770197698901,1.3666433769533903,-44352800.0,-83.83808520119109,89.0859394939463,92.09290994229893,-112.68221027511368,11.152177122403435,37.42157897716843,0.04267295405051618,4.64579047885005,199.55304229736328,194.82848220825196,191.01000213623047,187.19152206420898,182.46696197509766,0.16,0.0,209.10235153687526,-0.030841322067999166,-0.037215312660268805,179.20276532854353,186.5925020490374,8.90987819679883
2022-09-30,0,179.55749893188477,177.84249877929688,206.31750106811523,185.39187717437744,199.426251411438,-0.34703422809769957,8.463816243212822,-1.1711752522245478,2.994764480480185,194.7150001525879,7.403124618530273,0.04387104686128576,180.50275001525878,201.28899955749512,0.87816142232941,-0.09558509636114862,0.9307120125927701,0.9678514692299885,0.993196430558714,-0.02180487258368824,24.069533339595235,209.85250774582505,192.9248752593994,175.99724277297378,181.3567853655134,2.739095632416529,188.03232165745325,7.781497336249836,182.9748665298961,188.15905995832222,-6.083576373942474,-11.67578748537041,9472300,2.5690314940120245,1.3816768784310178,-53825100.0,-90.15365877958455,89.0859394939463,92.09290994229893,-107.51100032495759,10.249350330895936,36.11163139479963,-0.06070846482879857,4.693947744072115,196.71096136474608,192.52952145385743,189.1500015258789,185.77048159790039,181.58904168701173,0.16,0.0,208.92843203431536,-0.034300998345655476,-0.04381304458404843,177.885249546596,184.55506787981307,9.336237967642884
2022-10-03,0,180.62499618530273,177.84249877929688,206.31750106811523,183.171875,199.426251411438,-0.16522280676867632,8.819903478826367,-1.3421482527593538,2.994673366231696,191.9887523651123,7.711499977111816,0.04594812530515761,179.92425003051758,201.28899955749512,0.8841992036005233,-0.101684743756813,0.9409830819452769,0.9798549731932458,1.0035446862326647,-0.007595839325951426,22.91255466682118,209.5933071331288,191.95350017547608,174.31369321782336,180.58857018607003,1.818314953589457,186.57589285714286,7.037231054950748,182.12613940546078,187.2832002244048,-5.451266875807128,-12.970301597146486,8842300,2.5345684277768084,1.2502606978005235,-44982800.0,-73.81961126116062,89.0859394939463,92.09290994229893,-82.7954613718519,10.031707162046017,33.02166299203995,-0.01580235969218387,4.766523397419343,194.73220416259767,190.928903717041,187.8550033569336,184.78110299682618,180.97780255126952,0.16,0.0,208.77694657630104,0.005869628238564628,-0.012557124860245345,177.3031223842076,183.28817640032088,9.477157046482317
2022-10-04,0,184.99500274658203,177.84249877929688,206.31750106811523,181.6618709564209,199.1268768310547,0.02983231575009263,8.951919751435604,-1.397057690841836,2.99463369840319,191.50625228881836,7.888313140869141,0.0468709904029876,179.92425003051758,201.28899955749512,0.9056834281688144,-0.08887991811076568,0.9686077667245816,1.0099882524555746,1.0294056494849537,0.02454830181561518,27.085738203456696,208.8944645028712,190.990625,173.0867854971288,180.79357038225447,2.2409330151220073,185.53357151576452,5.960002919859648,181.7587783418115,186.6509676634427,-2.8910934990229586,-10.143523252621375,7081400,2.5743369885432266,0.9836582491149868,-37901400.0,-57.535345840991056,89.0859394939463,92.09290994229893,-44.95530049560494,13.62819861886714,30.758158366782013,0.008826059086823906,4.75177263931548,194.29671856689453,190.57663919067383,187.56999969482422,184.5633601989746,180.8432808227539,0.02,1.0,208.67381198905608,0.043739767176435684,0.0280191800994234,177.5407496861049,182.3207789829799,9.367939709384157
2022-10-05,0,185.54750061035156,177.84249877929688,206.31750106811523,181.6618709564209,199.1268768310547,0.21213409174470876,8.880542861335504,-1.326895955344462,2.9946466763692765,190.6500015258789,7.825375747680664,0.04665912010395974,179.92425003051758,201.28899955749512,0.914306364090536,-0.0721137495275217,0.9748821948330733,1.016683315635913,1.027411868795097,0.0433248626393663,39.296961834415896,208.08921110414073,190.32812538146973,172.56703965879873,181.29928534371513,2.8713147050638645,184.7101789202009,4.954293323338448,182.5874617868492,186.71011683976846,0.7817614744798189,-7.311328949826441,6119900,2.8022859160754607,0.8383281108200202,-31781500.0,-32.985418143302084,89.0859394939463,92.09290994229893,-29.627184687770164,16.163067413388468,27.84611008988416,0.017937763387186247,4.873789377260709,189.46824462890626,186.6708840942383,184.41000366210938,182.1491232299805,179.35176269531252,0.04,0.0,208.5902733343731,0.04738260444262088,0.055096550789449944,178.53626796177454,181.77943311418807,9.079153891162631
2022-10-06,0,186.3849983215332,177.84249877929688,206.31750106811523,181.6618709564209,197.56749820709229,0.4012129009210379,8.68555678715064,-1.1360390024531024,2.994689164859589,187.95625114440918,7.570375633239746,0.045800990822202264,179.92425003051758,201.28899955749512,0.9120093325532133,-0.06781130517610401,0.9828520849866237,1.023719347701674,1.023317476872458,0.03567359299587114,40.88011945958799,207.00798891762403,189.63687534332274,172.26576176902145,182.13107081821985,3.4143140632233453,184.35267857142858,4.603351345291836,183.35675018947381,186.77329366852265,1.9449774379381128,-5.8492941856637914,5163000,2.816234583853586,0.7034639776166837,-26618500.0,-43.84137552063832,89.0859394939463,92.09290994229893,-25.206007663191638,15.479011376403014,26.667602370627332,-0.03286321339184742,4.72566176191393,189.46824462890626,186.6708840942383,184.41000366210938,182.1491232299805,179.35176269531252,0.04,0.0,208.52032177015738,0.030711950877684746,0.035774105149880206,179.6217760358538,181.23738316127233,8.741807921581888
2022-10-07,0,183.45499801635742,177.84249877929688,206.31750106811523,181.6618709564209,193.53500175476074,0.5914252977737859,8.434530237970243,-0.8366134464509081,2.9947445904629237,186.19375038146973,7.1992631340026865,0.04462622912265873,179.92425003051758,201.28899955749512,0.8723482481055745,-0.08524945476442683,0.9706414636252504,1.0074146815141622,1.0001799056674874,0.021706133732410482,40.002764839054876,205.87293563615782,189.0038751602173,172.13481468427676,182.93285642351424,2.8520798004521213,183.71696390424455,3.9864359576697015,184.13497314606383,186.9450656907807,3.2246442763769902,-2.6150816651947557,5610300,2.543499366111036,0.7606536661952945,-32228800.0,-50.71192383639171,89.0859394939463,92.09290994229893,-46.45472589243887,14.608676350098396,30.268528073071437,-0.034187149449936935,4.649543316351545,188.78063763427735,186.11467843627932,183.95999908447266,181.80531973266602,179.139360534668,0.04,0.0,208.43515557565655,0.034787540325311284,0.020937407068694132,180.2756107875279,180.58354840959822,7.934707602440557
2022-10-10,0,182.99749755859375,177.84249877929688,206.31750106811523,181.6618709564209,191.80562686920166,0.7851143923472013,7.795562271307346,-0.3565579584188261,2.9948811715785943,185.7750015258789,6.536150665283202,0.04146821066401386,179.92425003051758,199.73025131225586,0.7954151601826004,-0.1108122332492279,0.9734485487567651,1.0049603356577061,0.9934636709102944,0.013134955977283758,32.96301072839073,203.57999955024408,187.9888750076294,172.3977504650147,183.36607033865792,2.5393057675419155,183.10089220319475,3.2734152919468498,183.9663432835804,186.41945962430023,3.155881904260509,-4.626864487668843,4743800,2.442028017735302,0.6391362135645674,-36972600.0,-59.74812127147706,89.0859394939463,92.09290994229893,-50.76575058027541,13.727486085908264,30.044006195059865,-0.057685521441625726,4.594576278771516,188.78063763427735,186.11467843627932,183.95999908447266,181.80531973266602,179.139360534668,0.04,0.0,208.3611964267234,0.0029176457013564416,0.025499541682461692,180.57369995117188,179.8882326398577,6.7065825166272015
2022-10-11,1,179.83499908447266,177.84249877929688,201.01499938964844,181.6618709564209,191.44812774658203,0.7328346055818726,6.622688313313661,-0.5131508350940823,2.995109080126986,185.2712516784668,5.5194881820678745,0.0354490226063787,179.92425003051758,197.32624740600588,0.8124946314811626,-0.08963262386270726,0.9625962519099507,0.9870563258680871,0.9737865213638457,-0.02789266512878663,34.376375779045794,200.06825145878065,186.82287483215333,173.577498205526,183.40571321759904,2.471190327997083,182.38124929155623,2.7224130674083264,183.71086384720581,185.74005183715218,1.6850484279913758,-4.501039154005871,6294500,2.2457410269095144,0.8419569999337885,-43267100.0,-69.19230974784288,89.0859394939463,92.09290994229893,-83.78202594682574,12.867897463955336,32.415712097608115,-0.0534245318899726,4.551391556490275,185.51836602783203,183.47582522583008,181.82500457763672,180.17418392944336,178.1316431274414,0.04,0.0,208.25249016904695,-0.03506580145554061,-0.013817660073238565,180.78321184430803,179.33423069545202,6.163889495780616
2022-10-12,1,179.0349998474121,177.84249877929688,199.5875015258789,180.60937213897705,190.2800006866455,0.7960743194418523,5.925303356239376,-0.2914115342790602,2.9952276445737938,184.27750205993652,4.821650848388674,0.03189696253956742,179.80724906921387,192.82700271606447,0.7528303233870497,-0.09896663012661192,0.9637772684483729,0.9830579247939103,0.9749025347791489,-0.035098833137158,29.77019540284087,197.6144815293733,185.76387481689454,173.91326810441578,183.17857088361467,2.8181046377110586,181.88357053484236,2.645260795104197,182.74265067759188,184.75406235234848,0.15454667960883128,-5.305144948151472,4884300,2.2980352009903005,0.652230520750847,-48151400.0,-75.62543014171364,89.0859394939463,92.09290994229893,-88.14516551281848,12.372320501176263,31.167296791793607,-0.08407961083878682,4.395577508948197,185.51836602783203,183.47582522583008,181.82500457763672,180.17418392944336,178.1316431274414,0.04,0.0,208.16682857263584,-0.05024779761838383,-0.03991367929920656,180.3037349155971,178.80342864990234,5.458254386414857
2022-10-13,1,179.90750122070312,177.84249877929688,197.0749969482422,180.41312503814697,187.26624870300293,0.7359182513725789,5.173244793998465,-0.3980859844612974,2.9953427416590364,183.50749969482422,4.265626125335695,0.0280034091927068,179.5052490234375,191.69575157165528,0.7198039795854512,-0.09153874098786831,0.9738613914743434,0.987202309398799,0.9866514350045552,-0.034753317912720294,29.489774415431384,195.08273932096813,184.7362497329712,174.38976014497428,182.45178495134627,2.9255549325996095,181.62267766680037,2.6473176424644644,181.81481525358726,183.63915499689838,-0.8802748077345018,-3.7459187390175113,8426400,2.271933766181634,1.1080129888829207,-39725000.0,-29.25459426861925,89.0859394939463,92.09290994229893,-43.21705178112981,17.448708047753147,26.22459125173762,-0.006251687483513474,4.850892660286692,185.4640870361328,183.38796685791016,181.7100067138672,180.03204656982422,177.95592639160157,0.02,1.0,208.0329269448381,-0.00501107883624019,-0.0160388810344265,180.16453334263392,178.85264151436942,4.844945505438734
2022-10-14,1,184.6525001525879,177.84249877929688,192.3550033569336,179.9506254196167,186.098126411438,0.6161868494652321,4.424845860859246,-0.8400245288855408,2.9954441061080055,183.2262477874756,3.718451232910155,0.024064047195152784,179.5052490234375,191.41325302124022,0.8010158279246032,-0.05999530691988544,1.0042127156745673,1.0132714033066899,1.0199203573903972,0.006527498019561762,35.26365091206666,192.7275666683127,183.87787494659423,175.02818322487576,182.32392774309432,2.783836970729404,181.8116065434047,2.7685014087549153,181.33594407299182,182.7918992603655,-2.750075110325056,-1.9898126635770168,6449400,2.009231610593658,0.8648177511976158,-33275600.0,-43.600644689147806,89.0859394939463,92.09290994229893,7.907374302620602,18.73626678834422,24.276657331096306,-0.09152548476170141,4.865828725787433,185.4640870361328,183.38796685791016,181.7100067138672,180.03204656982422,177.95592639160157,0.02,0.0,207.94053821611368,-0.006582084838477442,-0.016002958365862047,179.45445469447546,178.995361328125,4.3391100090651324
2022-10-17,1,185.6675033569336,177.84249877929688,192.3550033569336,179.9506254196167,185.66125106811523,0.7211330202811369,4.08340234196616,-0.39736366221253316,2.995486060358928,183.2262477874756,3.316101207733155,0.022247902902071397,179.5052490234375,190.08125,0.7239016815770208,-0.04004316534492712,1.011585986593262,1.0160005909515473,1.0241718383130862,0.01459039513633198,49.16448333280422,191.70780447793865,183.54099979400635,175.37419511007406,182.22142846243722,2.6176373126113663,182.17624964032854,2.9231959525299978,182.17322843602284,182.79385969620418,-0.4823565150808291,1.453239197468537,13952100,2.3181641587002364,1.8006310939607277,-19323500.0,-25.105534583366417,89.0859394939463,92.09290994229893,54.502732360139326,19.206158581242494,22.18945583580871,-0.1275323648111508,4.94327040945111,185.4640870361328,183.38796685791016,181.7100067138672,180.03204656982422,177.95592639160157,0.02,1.0,207.75637751116489,0.016851535091955583,0.007724525623959452,179.40664672851562,179.5142113821847,3.7468583174751946
2022-10-18,1,188.14750289916992,177.84249877929688,191.62250137329102,179.9506254196167,185.57750129699707,0.6110749889857001,3.592232728477113,-0.28504887100976006,2.9955407804466434,183.2262477874756,2.973126029968262,0.01960754821238666,179.5052490234375,186.7374984741211,0.6462317461245427,-0.031076715801537123,1.026968883416301,1.0267384063660765,1.0348037594496575,0.046222948019104315,52.13523623369937,190.39109025096056,183.20662479400636,176.02215933705216,182.891786302839,3.453576830578961,182.91232136317663,3.042964348217576,183.04940409707885,182.9583456113361,-0.3849531727665427,2.8272777331580996,5209200,2.3379435751300184,0.6726508644761912,-14114300.0,-19.371423873403895,89.0859394939463,92.09290994229893,117.21300544796729,20.17608061273344,20.605467593789886,-0.14984449771418848,4.943036983144189,186.51076330566406,184.23462384033203,182.39500427246094,180.55538470458984,178.27924523925782,0.04,0.0,207.69495695685848,0.04482520666928713,0.02739060534428296,179.87628391810827,180.07594735281808,3.26902801552832
2022-10-19,1,186.07500076293945,177.84249877929688,189.9099998474121,179.9506254196167,185.57750129699707,0.2934302362375063,3.2485707368273347,-0.8796976481304455,2.995575023839138,183.2262477874756,2.799376106262207,0.01774856423541027,179.5052490234375,186.56124877929688,0.5679228960035896,-0.009280695854132532,1.0166206529553494,1.0136846785826459,1.0141321723463088,0.039321925442105776,58.84611919313363,189.53001634395497,183.0328748703003,176.53573339664564,183.33142961774553,3.6590489034555436,183.34874997820174,3.0258435045444814,184.31130562459958,183.4298212693686,2.5578506628607096,5.794455313328448,4927000,2.392689369155,0.6436030274292194,-19041300.0,-24.246309603741377,89.0859394939463,92.09290994229893,89.65117730425901,19.310610548501195,21.181242844693518,-0.10338131349234994,4.795677536853157,186.51076330566406,184.23462384033203,182.39500427246094,180.55538470458984,178.27924523925782,0.04,0.0,207.63307889939566,0.04583703236994441,0.040582694628614906,180.4710649762835,180.52238246372767,3.231305770755701
2022-10-20,1,187.77249908447266,177.84249877929688,188.14750289916992,179.9506254196167,185.57750129699707,0.00661171572919713,2.9350345631727484,-1.291199409401866,2.9956034292694653,183.2262477874756,2.623263416290283,0.016052376425270395,179.5052490234375,186.10600051879882,0.6563417444603225,0.00038977067825225227,1.0269708150759818,1.022638302866932,1.015590336848061,0.04371689790811484,55.65062471746411,188.71119404242216,182.84112491607667,176.97105578973117,184.4653581891741,3.6246688760458157,183.9355357033866,3.0306130722629887,184.73656446516466,183.66208535610446,1.681718736815142,3.3951049399444577,5706700,2.2706854161417516,0.7498515197544425,-13334600.0,-22.954803959835132,89.0859394939463,92.09290994229893,131.56944613448465,22.98325076677582,19.73463365300988,-0.12352906816825657,4.779557144965204,187.1143181762695,184.72283969116208,182.79000091552734,180.85716213989258,178.46568365478515,0.06,0.0,207.56832186360705,0.01386334397964184,0.0503814657326206,181.60718863351005,181.19520023890905,3.3139905418093027
2022-10-21,1,188.04249954223633,177.84249877929688,188.14750289916992,179.9506254196167,185.57750129699707,0.07404230448920872,3.0533265192705303,-1.2718901526236683,2.9955930206489487,183.2262477874756,2.702913265228273,0.016691263230178766,179.5052490234375,186.52374839782715,0.6816112941365039,0.022948886901646003,1.0279499550772233,1.0233354793446863,1.0084708402225468,0.018358805793840416,61.02496506712199,189.03627778677102,182.92962474822997,176.82297170968891,185.75214385986328,2.902463716961133,184.46535737173897,3.0556068110464216,185.4816437563409,184.18831209716353,4.4137681988540916,4.575136210659882,7582500,2.223631975195137,1.0175428002053202,-5752100.0,-3.724059809274164,89.0859394939463,92.09290994229893,127.14848787267314,20.99012122058674,20.051602676698806,-0.11937405970820504,4.859588346444146,187.1143181762695,184.72283969116208,182.79000091552734,180.85716213989258,178.46568365478515,0.06,0.0,207.4855022195078,0.04243772970811732,0.03092167189243606,183.31278119768416,181.80825805664062,3.7029415181363436
2022-10-24,1,191.08750534057617,177.84249877929688,188.14750289916992,179.9506254196167,185.76937770843506,0.04856946268743675,3.2495809817855443,-1.3886508997486204,2.9955749096858972,183.2262477874756,2.92025089263916,0.017742366661217163,179.5052490234375,187.79949913024902,0.7212142745035298,0.03315799513050894,1.0433174625077062,1.0373168324022708,1.021088399589688,0.029191979671439716,62.83260733078626,189.65291162024835,183.15374965667723,176.65458769310612,187.34928730555944,2.121160767800095,184.90053612845284,3.53334141900384,186.1005567511698,184.70329832710132,5.031138996565548,4.106576339702173,7299200,2.1839837655294336,0.9970215837852863,1547100.0,-13.059893839006179,89.0859394939463,92.09290994229893,151.6952195105301,22.97526129196945,18.849186738701622,-0.0841267021346633,4.800331945393099,188.75692517089843,186.05154534912108,183.86500549316406,181.67846563720704,178.9730858154297,0.08,0.0,207.41572268992414,0.02947368192019395,0.044299545963694925,184.16346958705358,182.16400146484375,4.003835152609984
2022-10-25,1,192.79999923706055,177.84249877929688,191.08750534057617,179.9506254196167,186.1525001525879,0.16892824238314416,3.66540437117855,-1.0835425948009294,2.9955332070299647,184.05374908447266,3.229501152038574,0.019963233407028432,179.5052490234375,188.0529998779297,0.6930687825513666,0.05829009534413941,1.050064602942237,1.0420368256274273,1.0243060043782368,0.024727919670472387,69.60102781284515,190.9385588720568,183.6077501296997,176.2769413873426,188.51321574619837,2.580388592324852,185.41857174464636,4.118666908587439,187.3310732084906,185.46339897226304,6.21430682101347,3.2933336055244906,11907200,2.2230440347473253,1.6033642209500316,13454300.0,-4.120170975446001,89.0859394939463,92.09290994229893,174.03723973615686,24.561398983298147,17.57613470749865,0.018670574739564048,4.78030744920399,190.36131817626952,187.3493396911621,184.91500091552734,182.48066213989256,179.46868365478514,0.1,0.0,207.32002099527688,0.03852115461835415,0.04928481777795317,185.8170383998326,182.635746547154,4.415052477843657
2022-10-26,0,200.69499969482422,177.84249877929688,192.79999923706055,179.9506254196167,186.73187351226807,0.25304933807462776,4.101462300238682,-0.8162353942454379,2.99548485232167,184.82375144958496,3.4756636047363285,0.02226398136572232,179.5052490234375,188.44150314331054,0.688574858552322,0.08410532105897803,1.0894333304341686,1.077159429537355,1.0610053572482008,0.07857046283455738,74.61449562908886,192.4225496920301,184.21962509155273,176.01670049107537,190.6600009373256,4.966343495555463,186.44071469988143,5.806712467520558,188.68786000627375,186.37827126784234,4.412341602599454,3.908701870330865,15450000,2.096187086315236,2.0035441334088064,28904300.0,-9.568757750670244,89.0859394939463,92.09290994229893,276.0046236036171,35.61582993910612,14.73347506886198,0.01529799480791809,5.295284816462307,198.87227770996094,194.23385931396484,190.48500061035156,186.73614190673828,182.09772351074218,0.12000000000000001,0.0,207.27374434188664,0.09076776426004285,0.08633870249553745,188.35926382882255,183.88295527866907,5.889588675619741
2022-10-27,0,203.88000106811523,179.0349998474121,200.69499969482422,180.45999717712402,187.83999919891357,1.135522834396427,5.201433688977164,1.4745229616170512,2.9953425257674886,185.2712516784668,3.859750747680664,0.028060911459175664,179.80724906921387,191.2587547302246,0.6143855212406201,0.11518906189903522,1.0999003352466152,1.0816790209644915,1.061435501720167,0.08578200781359535,81.92989331767576,195.76511751528344,185.3622501373291,174.9593827593748,192.90750067574638,6.844515783238454,187.89964348929269,7.357614610252091,191.70082993872552,188.26170280785817,8.093767657876699,7.677657269714808,7946700,2.620462008251599,1.0383214802290743,36851000.0,-6.547064999486091,89.0859394939463,92.09290994229893,240.81193023234724,33.32595335369177,13.786204160401999,0.03717260074452827,5.254908112456233,198.87227770996094,194.23385931396484,190.48500061035156,186.73614190673828,182.09772351074218,0.12000000000000001,0.0,207.25927896275672,0.0911761961151869,0.09591763991255091,190.7665012904576,185.32139260428292,7.015469402195031
2022-10-28,0,207.29249954223633,179.0349998474121,203.88000106811523,182.404372215271,188.06875038146973,1.2624300777574307,6.427591606169023,1.1902738943179099,2.995146883441008,185.60750198364258,4.651900558471678,0.03445358333526508,179.80724906921387,193.58949928283693,0.6901021139918162,0.13545801362190515,1.111142375769359,1.085971953000185,1.0614000875864067,0.10237047500890206,84.37737743336515,199.4131833954435,186.55800018310546,173.70281697076743,195.93857192993164,7.926934722164743,189.63500077383858,8.830191775436798,194.7555307743032,190.35038785638196,8.361789514355932,11.13352226573661,8455600,2.6350800682490445,1.1122021157305255,45306600.0,-5.904680505656121,89.0859394939463,92.09290994229893,227.38788873435746,36.54577992971616,12.307124248723232,0.12462484492021145,5.465986592983703,202.80688470458986,197.41656497192383,193.06000518798828,188.70344540405276,183.31312567138673,0.14,0.0,207.26308758320585,0.09964822737034851,0.11814989247402646,193.99068341936385,187.23087419782365,8.244253316803547
2022-10-31,0,207.9749984741211,179.0349998474121,207.29249954223633,183.3406229019165,188.88250350952148,1.2364204519260773,7.644375743239388,0.669851405209982,2.9949181739109187,185.87125205993652,5.633175582885744,0.04067352631318824,179.90025100708007,201.01349983215331,0.742675683265077,0.14764016011148018,1.1065751942404942,1.0767761037786465,1.0443080750500324,0.08837570569277275,86.13033009475713,203.2335017001018,187.94475021362305,172.6559987271443,198.82464327130998,8.133292980710065,191.64500073024206,9.59725046070408,197.911686920641,192.60804469923588,11.402659514873834,13.276138913245845,8674100,2.6768170845414807,1.1422058909702384,53980700.0,-11.809319681979192,89.0859394939463,92.09290994229893,174.92966942001982,34.86760918011281,11.741984964087314,0.07971295880416013,5.3198445569103185,202.80688470458986,197.41656497192383,193.06000518798828,188.70344540405276,183.31312567138673,0.14,0.0,207.26502288569023,0.08625674792807758,0.0881968258947392,196.79444231305806,189.20081547328405,9.039312502516491
2022-11-01,0,207.7849998474121,179.0349998474121,207.9749984741211,184.35312461853027,191.51562881469727,1.0501934065866037,8.599303824027531,-0.08307161881853631,2.994716022711759,186.22999954223633,6.785650138854976,0.04542391635578565,179.90025100708007,204.22125091552735,0.8235664416949054,0.12421954856271727,1.0975782047243972,1.0635093441107046,1.0259543731101424,0.07772303251892909,85.92169362978866,206.510857976119,189.31225032806395,172.1136426800089,201.64500045776367,7.13273197102186,193.69857215881348,9.765878919589824,200.44807757648357,194.64944029489465,10.75902993683862,15.647676777550085,5919500,2.5868701483266476,0.7854889882923062,48061200.0,-12.432318050710332,89.0859394939463,92.09290994229893,141.2010232954664,32.67533109444851,12.18260285718168,0.037914099729113776,5.271284186035259,202.80688470458986,197.41656497192383,193.06000518798828,188.70344540405276,183.31312567138673,0.14,0.0,207.26550369049838,0.06456416184012204,0.0850505769956589,199.1229378836496,191.21785954066686,9.732633166104721
2022-11-02,0,203.5724983215332,179.0349998474121,207.9749984741211,184.35312461853027,194.77374935150146,0.8153572257780017,9.4223011384976,-0.7221741555991485,2.9945238248004555,187.07874870300293,7.8352751922607435,0.04947342898891055,179.90025100708007,207.3417495727539,0.8650695267671873,0.119848012847983,1.0688927674637438,1.0315799243132655,0.9904975226606015,0.014337669753030635,85.15942915433267,209.2963524601007,190.45175018310547,171.60714790611024,203.42857088361467,5.404348138925184,195.38892909458704,9.228465878838648,202.284469615339,196.21110262871676,10.49895654080125,16.058312634123517,6985600,2.6020633054326585,0.92166153980121,41075600.0,-35.891369845624624,89.0859394939463,92.09290994229893,88.92932253724658,29.87633402594437,17.476868842788644,-0.029071890611028304,5.35333518761506,204.5698049926758,200.27010543823243,196.79500579833984,193.31990615844728,189.0202066040039,0.14,0.0,207.24826392254943,-0.01170527775179142,0.03379965008498244,200.56277901785717,192.36312430245536,9.949611990153628
2022-11-03,1,196.51499938964844,179.0349998474121,207.9749984741211,184.35312461853027,201.41437435150146,0.5822379760368241,9.765890936331555,-1.1325770106018305,2.994441811429975,187.9074993133545,8.452899570465089,0.05103599594899056,179.90025100708007,207.3417495727539,0.9093787317349047,0.09221503959428003,1.0269763176910294,0.9870649083749055,0.9534888230208272,-0.03612419874378059,71.35765144050757,210.8847819413277,191.35300006866456,171.8212181960014,203.95928519112724,4.2446280689651585,196.2362504686628,8.696088205132874,202.59036851141838,196.96581849367783,6.5336521918086525,13.153980206638984,8236200,2.866929866852074,1.0650697043779174,32839400.0,-58.49321710325681,89.0859394939463,92.09290994229893,30.820160262236545,27.22764346597597,24.30844937208473,-0.04347211404221469,5.454525839739698,204.75388470458986,200.56806497192383,197.18500518798828,193.80194540405273,189.6161256713867,0.02,1.0,207.19646327715043,-0.0466983013825536,-0.04219744852636831,200.61480494907929,193.21592167445593,9.876702117830575
2022-11-04,1,197.69249725341797,179.0349998474121,207.9749984741211,184.35312461853027,201.41437435150146,0.4418298323175235,9.757783726735271,-1.2337170028921203,2.9944476791540304,188.09500122070312,8.563899459838865,0.050859007349268064,179.90025100708007,207.3417495727539,0.9198526552448255,0.07118912820312776,1.030402440992687,0.9886379692803559,0.9661067796608084,-0.04631138275633717,56.61017449395916,211.37506757554084,191.8595001220703,172.34393266859976,203.53035627092635,4.750972107331189,197.09517860412598,8.148520321217493,201.0492325763481,196.47572135786083,1.9268673066850215,6.424228877084227,9680100,3.2763965222273828,1.219693051286429,42519500.0,-54.33484020472781,89.0859394939463,92.09290994229893,40.976766148057536,28.227194106354844,22.209892605882043,-0.0853751867016853,5.543488064393711,205.20464196777345,201.2976805419922,198.13999938964844,194.9823182373047,191.07535681152342,0.02,0.0,207.14686372344556,-0.05904290660739897,-0.035782601796654157,199.721928187779,194.04059600830078,9.748908936833542
2022-11-07,1,199.00750350952148,179.0349998474121,207.9749984741211,185.41375255584717,201.41437435150146,0.2808578777066711,9.637270738694399,-1.2816595467717908,2.9944849943591483,189.61750411987305,8.506511707305908,0.050045188359352163,179.90025100708007,207.3417495727539,0.9106344935132695,0.08030164286874494,1.0334220411667792,0.9904344742353685,0.9817447008888756,-0.04311813934555919,58.553241938756145,211.84591656131212,192.57137508392333,173.29683360653453,202.83428519112724,5.039390782757593,197.8708929334368,7.73777354412351,200.1907777850705,196.2708571310396,-1.4960524407542988,6.476628208527754,7821300,3.266653811561827,0.96674074641735,50340800.0,-42.67561286025795,89.0859394939463,92.09290994229893,45.65243084644003,26.934035162257924,21.19240141768554,-0.035491923487199616,5.394667963860656,205.20464196777345,201.2976805419922,198.13999938964844,194.9823182373047,191.07535681152342,0.02,0.0,207.1128256709358,-0.03408001303913755,-0.044138809378449904,199.13277326311385,194.94963727678572,9.568027999614289
2022-11-08,1,201.82500076293945,179.0349998474121,207.9749984741211,185.973126411438,201.41437435150146,0.10896778138735587,9.472297370572914,-1.280046262104658,2.9945338266109682,191.94375228881836,8.406811866760254,0.04898487617129775,179.90025100708007,207.3417495727539,0.8827381335448083,0.10661164135265494,1.0437143476257549,1.0005130892311345,1.0045317839188017,-0.028683490573667036,62.119427792979224,212.31647012261553,193.37187538146972,174.42728064032391,202.05321393694197,4.641214469220326,198.9958929334368,7.000681060775587,199.8864978219006,196.27540223390335,-2.3898849975804515,5.772067363642632,6943700,3.132984175792038,0.8548364857611377,57284500.0,-36.79639230823336,89.0859394939463,92.09290994229893,59.844082720316514,30.289641397996505,19.946640283398317,-0.02087012040361758,5.322190937747426,205.27308398437503,201.40846380615235,198.28500366210938,195.16154351806642,191.29692333984377,0.02,0.0,207.09291114976799,-0.024887606833348896,-0.02597036395013755,198.06976100376673,196.0302222115653,9.1225973453251
2022-11-09,1,197.3224983215332,179.0349998474121,207.9749984741211,187.34812450408936,202.2618751525879,-0.037102919816868536,9.10636768880696,-1.2632646351382915,2.9946345886977,194.6574993133545,8.152624320983886,0.04682626256442288,184.17800025939943,207.3417495727539,0.84760540032297,0.12729355117686933,1.014660886977927,0.9738357673798118,0.9879833192168509,-0.03070159305177078,66.27508568642371,212.68411084300703,194.47137546539307,176.2586400877791,200.531428200858,4.089550624030769,199.67803573608398,6.247739134983534,200.37168568264846,196.83087510604582,-2.637576753317531,8.46432886493204,7320200,3.127173489646696,0.8878743570819084,49964300.0,-66.45262858137659,89.0859394939463,92.09290994229893,6.505317255825468,26.992985074960636,26.031913109606148,-0.02917553629735014,5.545605658047081,205.27308398437503,201.40846380615235,198.28500366210938,195.16154351806642,191.29692333984377,0.04,0.0,207.04936963352256,-0.032776900402236686,-0.06072838278727562,196.27044241768974,196.5324423653739,8.298325088880683
2022-11-10,0,203.61000061035156,179.90750122070312,207.9749984741211,187.9749994277954,202.2618751525879,-0.06295215587361391,8.401322006012824,-1.215686276782094,2.9948064859408183,196.91874885559082,7.431924190521241,0.04299864237428825,185.566003036499,207.3417495727539,0.8314095280511469,0.0967997275414663,1.04209237472474,1.006541461383899,1.0258852020652192,0.036104120513646976,56.37019240510467,212.18839440112475,195.38575038909912,178.58310637707348,199.93499973842077,3.0199272593951925,200.7900000980922,5.336444471349318,199.6187135763942,196.85471553730045,-5.1220099679016995,5.085941383122519,8048900,3.3770909830393023,0.978499251133026,58013200.0,-26.538793194389015,89.0859394939463,92.09290994229893,69.47683033262958,28.46662628006329,22.362382191238613,-0.02802271454313613,5.994491108797763,206.22888470458986,202.95556497192382,200.31000518798828,197.66444540405274,194.3911256713867,0.04,0.0,207.03508210997074,0.057917792385813405,0.025277518928206164,196.1438249860491,197.63338143484933,8.215497088923536
2022-11-11,0,204.8949966430664,184.6525001525879,207.9749984741211,188.12125205993652,203.5818738937378,-0.08728505427389265,7.783366557895473,-1.3840200259104063,2.9949471274771255,197.5074977874756,6.83778684616089,0.03959572619136572,186.03425102233888,207.3417495727539,0.8179014628666192,0.10266582062034423,1.042346666408745,1.01302902354504,1.0250310620972978,0.036432841355712675,62.99255313825342,212.1376084743725,196.57087535858153,181.00414224279055,200.12392807006836,3.3126042087428185,201.7762494768415,4.635185475840788,200.6227906955654,197.9138331759867,-2.009288081491194,8.278714176854796,9601000,3.4849670986108827,1.1452475982126455,67614200.0,-31.346169787748902,89.0859394939463,92.09290994229893,70.16416482030343,27.799573750359386,21.198133890182586,0.02160614987628561,5.872027368488167,206.6112035522461,203.57440310668946,201.12000274658203,198.66560238647463,195.62880194091798,0.04,0.0,207.0220607578906,0.043041167985604645,0.054984421692137124,196.77772739955358,198.67025320870536,7.7728909971644145
2022-11-14,0,205.68500137329102,185.6675033569336,207.9749984741211,190.3525047302246,203.67750072479248,-0.23554884948003393,7.47787166876689,-1.331919918379232,2.9950136693274745,198.35000038146973,6.481699371337891,0.03784673611513615,187.60274925231934,207.3417495727539,0.8007212110826047,0.10355874312140245,1.0410055580828168,1.018141778400126,1.0216210110884927,0.033554000457324706,64.17666069474092,212.53874352063926,197.58300018310547,182.62725684557168,201.43392835344588,3.457565249540836,202.69660677228654,3.9433560915673525,201.68612043709226,199.14008636975473,0.6496448844697966,7.225742613511583,5796100,3.485558829645618,0.7267344907053316,73410300.0,-25.618488381847275,89.0859394939463,92.09290994229893,82.49557435377623,29.11573580342969,19.662941825663708,0.04494904825685766,5.878310517648845,207.2271636962891,204.57142333984376,202.4250030517578,200.2785827636719,197.62284240722656,0.02,1.0,207.0201590757562,0.03609375398268311,0.05250474886873982,198.54552132742745,199.58016313825334,7.490609372499167
2022-11-15,0,210.30500030517578,186.07500076293945,207.9749984741211,192.37187576293945,204.13374996185303,-0.3880608637528288,7.148425145514369,-1.206651607318522,2.9950811091432934,199.85125160217285,6.179987392425536,0.03599700702030001,188.01549949645997,207.3417495727539,0.802295152772221,0.09321143360334476,1.0590235497031115,1.0421921726868053,1.037684881790076,0.04201659611138475,64.39364877510704,212.88072537495208,198.58387508392335,184.2870247928946,203.23571450369698,4.353181256407877,203.38303538731165,4.3803353076178695,202.66449094934802,200.29443640509612,4.666311483664598,6.683092420756441,7316100,3.468483179144179,0.9053587571163307,80726400.0,-18.333290947795224,89.0859394939463,92.09290994229893,115.40330409409987,32.18910411112028,18.041048335385533,0.04670975621667835,5.949145133142504,208.91559716796874,205.93719805908202,203.52999877929688,201.1227994995117,198.14440039062498,0.04,0.0,207.03347373563747,0.04301399936031647,0.051770912607696444,200.44085257393974,200.08139038085938,7.407758038947611
2022-11-16,0,209.45750045776367,186.07500076293945,210.30500030517578,195.58624935150146,205.09249782562256,-0.47973922202758656,7.162118467077915,-0.9343970599364511,2.9950851132667835,201.26000022888184,6.091074714660644,0.03586587061668659,188.01549949645997,207.80399971008302,0.727136902419722,0.13021630763342293,1.0489041260131111,1.036697637738476,1.024926178210749,0.06149831995567334,70.51232377451191,214.01598688837947,199.69174995422364,185.3675130200678,204.72857121058874,4.452220916250947,203.781428200858,4.67288003453462,204.54949497461465,201.84984229553856,6.379859239468305,4.788360758845252,6125300,3.4861697182929086,0.752419909591195,74601100.0,-17.598026529357355,89.0859394939463,92.09290994229893,102.36840216967677,31.114912780998893,17.438995614648984,0.05843835154599606,5.714920346175434,208.91559716796874,205.93719805908202,203.52999877929688,201.1227994995117,198.14440039062498,0.04,0.0,207.04237776827932,0.08358674832736535,0.043758939609516545,201.91861397879464,200.52569362095423,7.064710252623162
2022-11-17,0,209.38750457763672,187.77249908447266,210.30500030517578,197.120623588562,206.08687591552734,-0.536855371369113,6.739939830923201,-0.7877191813679394,2.995165675829623,202.69874954223633,5.6812873077392565,0.033555264722267344,190.7830047607422,208.12324867248535,0.7221583606555922,0.11548550229144923,1.0424504256553837,1.033341334982688,1.0125586267320794,0.028375344776613298,68.13998634075142,214.34075460081127,200.86087493896486,187.38099527711844,205.80892889840263,4.54676361385056,203.93107141767229,4.825034624891853,205.76306925145246,203.1175100361373,5.2510567511049695,2.7356775360154253,5385600,3.5161368704922005,0.6628638806510235,69215500.0,-13.431328696853887,89.0859394939463,92.09290994229893,99.80688973533495,29.540362470578167,17.70660018616277,0.10976669327449778,5.589568280632179,208.91559716796874,205.93719805908202,203.52999877929688,201.1227994995117,198.14440039062498,0.04,0.0,207.05048414179274,0.02636561551184302,0.08796987191768377,203.27993992396765,200.6748504638672,6.633039309926428
2022-11-18,0,211.97000122070312,188.04249954223633,210.30500030517578,197.59999752044678,207.41562461853027,-0.6083577828201121,6.271256595979985,-0.5859481984995334,2.9952468445534004,203.59124946594238,5.248712387084962,0.031054799075455414,192.6287498474121,209.3945041656494,0.6769471616707675,0.1135116002359141,1.049659776663041,1.0394826411213878,1.0193511802887494,0.03452990406574741,67.896125666987,214.484138405583,201.94162521362304,189.3991120216631,207.90142931256975,3.1445126411727684,204.21642875671387,5.187140250326313,206.66625510101954,204.3371166323902,3.7470599708209917,1.0106516347802195,8028500,3.521386934239223,0.9854493254916353,77244000.0,-16.17080474750507,89.0859394939463,92.09290994229893,115.50823618199192,31.591567126054613,16.689144569750916,0.04638742926403524,5.506741450552514,209.25175903320311,206.20911956787108,203.75,201.29088043212892,198.24824096679689,0.06,0.0,207.0697623095982,0.028292608061541547,0.025441381413571773,205.6573268345424,200.96388462611608,6.29663936374263
2022-11-21,0,208.2650032043457,191.08750534057617,211.97000122070312,198.6787519454956,207.83249950408936,-0.45068164115390974,5.767709900533208,-0.7412530667330994,2.9953273466252077,203.7450008392334,4.815899887084958,0.028393062312737916,196.14349937438965,209.5422504425049,0.6391273435729737,0.1092823721933466,1.0252390143611216,1.0142125744294996,0.9947650308593248,0.012543461184961746,70.00221735194354,214.6734200986128,203.1380002975464,191.60258049648,208.56642968314034,2.5148891864757466,204.25071471078056,5.214058730237981,208.00597721202564,205.60387509381627,7.423128646639218,1.920905289526491,10450900,3.509598178314878,1.2584425796212475,66793100.0,-37.66790894513717,89.0859394939463,92.09290994229893,55.16262089465618,29.56386134051232,20.650794149972473,0.0030304257964342495,5.464117322251429,209.25175903320311,206.20911956787108,203.75,201.29088043212892,198.24824096679689,0.06,0.0,207.07261661908456,-0.0026104215415784227,0.006438959477548952,205.76301792689733,200.95342145647322,5.602473152954192
2022-11-22,0,208.42499923706055,192.79999923706055,211.97000122070312,200.27312564849854,208.04749965667725,-0.4477480382795917,5.155812052381029,-0.7746692409004026,2.9954116049234694,204.38749885559082,4.304875373840332,0.025273975631050234,197.24174842834472,209.5422504425049,0.6131263823357668,0.0802126764962789,1.0217068229216033,1.0104364425247543,0.9930816492395449,-0.008939402607580194,60.720527021143425,214.30849929549694,203.99687519073487,193.6852510859728,209.07071576799666,1.945441532454271,204.5973219190325,5.325599076385305,208.10165844469645,206.14468426448875,2.2862347527332014,0.23100962884042953,5273100,3.6648148341135993,0.661375843871603,72066200.0,-18.42608931225609,89.0859394939463,92.09290994229893,66.261560074202,27.572588955868255,19.968853041265163,-0.012234321292743147,5.44025105780365,209.25175903320311,206.20911956787108,203.75,201.29088043212892,198.24824096679689,0.06,0.0,207.07719368466115,0.0016192201475713208,0.016774743801445252,206.51414271763392,201.64593505859375,5.293936309487266
2022-11-23,0,211.11999893188477,196.51499938964844,211.97000122070312,201.54250049591064,208.3050022125244,-0.38047709830388265,4.547962063315982,-1.0329799757456501,2.995484913906807,205.2899990081787,3.8883127784729,0.022209218192030568,197.6554973602295,209.5422504425049,0.7154312170835198,0.03851615413433581,1.0309694882460856,1.020237291793565,1.0077278732747823,0.007937163722892437,57.984913551660476,213.87404931736685,204.77812519073487,195.68220106410288,209.8471439906529,1.367788395300008,205.6405361720494,5.043589274807452,208.23616384853167,206.61788429203685,1.722834940739679,2.3836721342698493,3807300,3.2632230395454487,0.515141141880638,75873500.0,-11.708267131361932,89.0859394939463,92.09290994229893,101.23748942131155,29.674414431636816,19.17967936753919,-0.04704937555685116,5.259519098938708,209.25175903320311,206.20911956787108,203.75,201.29088043212892,198.24824096679689,0.06,0.0,207.08603497261493,0.007566449989904633,0.00828607293149635,207.20044163295202,202.87298148018974,5.506443716188002
2022-11-25,0,212.7224998474121,196.51499938964844,211.97000122070312,203.13562393188477,208.6656255722046,-0.5336850428682988,4.646464230282649,-0.8870325477507461,2.995475077583203,206.48875045776367,3.9374380493164067,0.02263262723926551,197.6554973602295,210.3865001678467,0.7238467820872907,0.035511074288010654,1.036157561070544,1.021172564122049,1.0137680513041916,0.015927384379992082,61.137643037370275,214.59230361315318,205.29937515258788,196.0064466920226,210.19250106811523,1.753482672069168,206.71410778590612,4.81614599154488,208.98415287566309,207.0791652233979,2.642388857868129,7.4320024362505,1993500,3.2430389159295063,0.28104659015131545,77867000.0,-1.8234402571443216,89.0859394939463,92.09290994229893,112.7996316012107,30.23157826362299,18.474461959677676,-0.045167334731787495,5.070267776351838,209.25175903320311,206.20911956787108,203.75,201.29088043212892,198.24824096679689,0.06,0.0,207.09229072425475,0.013270729718950935,0.017369424028073736,207.73595101492745,204.0884017944336,5.82761111062325
2022-11-28,0,212.15999603271484,196.51499938964844,212.7224998474121,203.13562393188477,209.40500354766846,-0.5505347469793497,4.903933447122147,-0.8851805944787032,2.9954469098469976,207.53874969482422,4.154850463867189,0.023835412130950487,197.6554973602295,211.2049991607666,0.7456704961199127,0.026194871098408488,1.0311968948331083,1.0140364201623964,1.0078835705406124,0.0008963287772683071,62.35662590754261,215.549366985797,205.74150009155272,195.93363319730844,210.57857186453683,1.8590169806934809,207.65357153756278,4.467386674631917,209.9290655259741,207.65722037447313,1.1495207145470956,7.602717757532036,10229400,3.17853468847452,1.4243464748489938,67637600.0,-15.184516587257097,89.0859394939463,92.09290994229893,91.89322343699335,28.575489429549688,18.523620110675868,-0.12068762829872635,4.980963457477588,209.4809613647461,206.3945214538574,203.9000015258789,201.4054815979004,198.31904168701172,0.08,0.0,207.11919794652857,0.0021820457340995247,0.001279588748651058,207.89378574916296,204.9061998639788,5.921571010163158
2022-11-29,0,208.97750091552734,196.51499938964844,212.7224998474121,203.13562393188477,209.6693754196167,-0.5365182118917337,5.092043449453857,-0.9661367966517744,2.995425307518361,207.8799991607666,4.373887805938722,0.024720472566388582,197.6554973602295,211.9890007019043,0.7729814329241375,0.020122599299427335,1.0145283773901845,0.9953691318952798,0.9925856860420823,0.00342111108548826,60.567944980639446,216.16896181498436,205.98487491607665,195.80078801716894,210.51999991280692,1.908596211624867,208.16446440560478,4.14705139471448,210.47423649581413,208.0042567986067,1.2902357609753488,6.609043524112185,8986900,3.1825115460712277,1.2486210413117962,58650700.0,-25.59131418309537,89.0859394939463,92.09290994229893,42.10792335534481,26.948257511332084,22.274890334557142,-0.08017268495036622,4.904465238635669,209.4809613647461,206.3945214538574,203.9000015258789,201.4054815979004,198.31904168701172,0.08,0.0,207.1273025468481,0.013280219552421757,-0.008254380289692628,207.6218000139509,205.45086996895927,5.966528685710525
2022-11-30,0,212.55749893188477,196.51499938964844,212.7224998474121,203.13562393188477,209.6693754196167,-0.5512637470361541,5.116263763048051,-0.9786416215245741,2.9954224871723465,208.0250015258789,4.419000415802003,0.02483201282355321,197.6554973602295,211.9890007019043,0.794494261442862,0.005739110469913387,1.0316572373263289,1.0108355967725586,1.0089068304590103,0.019827274606938783,52.84916811803651,216.26752756424307,206.03500003814696,195.80247251205085,210.60392815726144,1.9939921348262843,209.2526787349156,2.8922447540452576,210.09199635019877,207.8007411336094,-0.1958109501024947,3.543911866988722,13918100,3.2717156758612447,1.8319580803407487,72568800.0,-0.0,89.0859394939463,92.09290994229893,106.54202524025702,33.03413347503208,19.52222028844166,0.027735940692760242,5.196289544967054,212.99272100830078,210.5136416320801,208.51000213623047,206.50636264038087,204.0272832641602,0.1,0.0,207.1767136376926,0.0317119432302031,0.05176419466519583,208.49552699497767,207.07642691476005,6.464807791016492
2022-12-01,0,216.98749923706055,196.51499938964844,212.7224998474121,203.13562393188477,210.50874996185303,-0.539586957111579,5.3003054297483185,-1.046029688908362,2.995400546050514,208.34500122070312,4.633762874603272,0.025695507265867654,197.6554973602295,212.19974632263182,0.7817023016809761,0.0441366131694281,1.0519401074426564,1.0307986603169688,1.025909248290722,0.027792252438713083,61.6390097421434,216.87423585186724,206.2736249923706,195.67301413287396,211.84999901907784,2.8362707160780545,210.2082143511091,3.0878296051346625,210.67591787278752,208.22075831853064,0.277160781147488,7.720863429129315,11261500,3.197659077261911,1.4417146694131555,83830300.0,-9.999963008996385,89.0859394939463,92.09290994229893,132.28228033942744,33.80048044951826,18.599827608310374,0.06761409827000608,5.064411065356019,214.7559938964844,212.3469938964844,210.3999938964844,208.4529938964844,206.0439938964844,0.12000000000000001,0.0,207.2334033801429,0.02489019707542872,0.03171194323020304,210.00059291294642,207.88180541992188,6.73154537679387
2022-12-02,0,216.5275001525879,196.51499938964844,216.98749923706055,203.16375064849854,211.33249950408936,-0.4459719112255646,5.746118936000766,-0.8572761301684371,2.995345085937828,208.70125007629395,4.900250244140625,0.02776649007706326,197.6554973602295,212.5739990234375,0.7138086947396307,0.10417779767955215,1.0463077342047804,1.0249470725082124,1.0180857771868752,0.0178871548985422,72.15112843523818,218.43661291014854,206.94437503814697,195.4521371661454,213.00749914986747,2.8587974431863183,211.03910745893205,3.1131077145295616,212.2288426451131,209.3006842529084,4.188171751619976,6.570157942442868,5132800,2.7747157351836083,0.6704271086198238,78697500.0,-6.411859172328954,89.0859394939463,92.09290994229893,124.10020334429802,31.75540111052392,18.987066492201215,0.13019854972579537,5.005523862719154,215.00615692138675,212.75191879272464,210.93000030517578,209.10808181762695,206.85384368896484,0.12000000000000001,0.0,207.25852544415275,0.018101866700739544,0.028007343572839592,211.03356061662947,208.7738516671317,6.4269221435129875
2022-12-05,0,214.8224983215332,197.3224983215332,216.98749923706055,204.5737476348877,212.01749992370605,-0.45084562701357017,5.582996765785974,-0.6410585366409705,2.99537029670108,209.18250274658203,4.557750205993651,0.02684842993934743,198.87600288391113,213.1029998779297,0.7225369974319266,0.0952742423756513,1.0330736408315464,1.0134511097778296,1.0064677958119628,0.01254950197306659,70.47473625634966,219.1109936078659,207.94500007629395,196.779006544722,213.53642763410295,2.79313278289282,211.69178581237793,2.8510789230306606,213.30160007290561,210.33779097693787,3.8874899581079707,5.67729993416368,9006300,2.79562325719685,1.1815686158750776,69691200.0,-37.36846452844568,89.0859394939463,92.09290994229893,88.08831924068451,29.65453120271086,19.438688742849624,0.12039080188228764,4.977272201646895,215.51119677734377,213.56939855957032,212.0,210.43060144042968,208.48880322265623,0.12000000000000001,0.0,207.29197662477904,0.01145516099475663,-0.0005144943647636983,211.30836268833704,209.25440216064453,5.9198778645502514
2022-12-06,0,210.2125015258789,197.3224983215332,216.98749923706055,205.48750019073486,212.25937175750732,-0.5513882487665598,5.248387270800625,-0.3607008846409454,2.9954148211985503,209.4225025177002,4.137699737548826,0.025135773773370985,201.54325103759766,214.99299850463868,0.7272531413398714,0.07946933926164776,1.0067576209716056,0.9903701513955134,0.9824184751247248,0.005909730018499815,65.11933676510382,219.298274671301,208.80150012969972,198.30472558809845,213.1778564453125,3.0631013071231163,211.68517875671387,2.854644799974233,213.671942044718,210.9905473393023,1.75374166747841,4.442471199763779,5986000,2.8578608950911866,0.7948944036034504,63705200.0,-71.95489360139867,89.0859394939463,92.09290994229893,3.713601082025378,27.122700605584413,25.42630090001784,0.06647486134871859,5.0531808510099365,215.51119677734377,213.56939855957032,212.0,210.43060144042968,208.48880322265623,0.02,1.0,207.29904675772897,9.581558895233044e-05,-0.010318885054035892,210.64461408342635,209.19028254917689,5.499340849485433
2022-12-07,0,207.69000244140625,197.3224983215332,216.98749923706055,207.62000274658203,212.25937175750732,-0.660444051380459,4.747116677535265,0.2658994115760449,2.995473856539531,209.8350009918213,3.588899917602538,0.022674230975062555,203.43150062561034,214.99299850463868,0.7346540768740883,0.04155828431181964,0.9920150285863217,0.9775889909457504,0.9695105430428395,-0.02289966957147127,52.838441488545406,218.8559833855881,209.36175003051758,199.86751667544706,212.53928593226843,3.7085853851558217,211.55892889840263,2.9963143636411536,212.80559495304135,210.9772135692509,-1.1799402147556788,-0.043983157396471344,7923800,3.060401127536856,1.0454161947288532,55781400.0,-80.17755285842951,89.0859394939463,92.09290994229893,-46.14040614988782,25.584324507092564,27.588315922766284,0.08893500643771034,4.974382000358046,215.45927648925783,213.48535809326174,211.88999938964844,210.29464068603517,208.32072229003907,0.04,0.0,207.29913078333547,-0.04235019507285731,-0.005979040728358155,210.15842982700892,209.02610778808594,5.178067794350262
2022-12-08,0,209.16500091552734,197.3224983215332,216.98749923706055,208.12125301361084,212.25937175750732,-0.7620530452029919,4.44395416969847,1.0148555788032843,2.9955063487948075,209.8350009918213,3.283499336242676,0.02119650934760784,204.76649703979493,214.99299850463868,0.5902268167477092,0.05254091250648671,0.9976628308476014,0.9848724797027864,0.9808532815607247,-0.03605045612782998,49.943427702118115,218.54290845383784,209.65500011444092,200.767091775044,212.56607164655412,3.6791325495113116,211.54303577968054,3.009280111769277,211.52469229044502,210.68060852444404,-2.1068974711987294,-0.8438456548438719,4896500,2.9208060109632656,0.6565098587092639,60677900.0,-70.63606178460287,89.0859394939463,92.09290994229893,-30.240194531193794,26.51801392493564,26.54170089127054,0.13402378695486714,4.801212074531181,215.45927648925783,213.48535809326174,211.88999938964844,210.29464068603517,208.32072229003907,0.04,0.0,207.30345837217172,-0.03640552144611031,-0.03640552144611027,210.16406903948103,208.89293452671595,3.6322835775161257
2022-12-09,0,208.66250228881836,203.61000061035156,216.98749923706055,208.38500022888184,212.25937175750732,0.14097996602300494,3.4359265752198085,-0.33973933845242144,2.99559882455659,209.8350009918213,2.69483657836914,0.01634232368804084,205.60600090026855,214.99299850463868,0.6281136929685935,0.02728255139002914,0.9924630457920308,0.9834116777151752,0.9857287017033127,-0.036323320863294595,49.812049087673046,217.11897839458024,210.24712524414062,203.375272093701,212.0096435546875,3.9641432994307704,211.30678585597448,3.10159692885414,210.94788897606406,210.6914532776895,0.08972257739640166,-0.10626405933734936,4928400,2.603307498963577,0.674905561288105,55749500.0,-73.59471178697274,89.0859394939463,92.09290994229893,-42.839370672752764,25.301884266466846,25.67607565305769,0.07822482983709447,4.672554068568101,215.45927648925783,213.48535809326174,211.88999938964844,210.29464068603517,208.32072229003907,0.04,0.0,207.30745345024292,-0.041165036152077006,-0.038248792970434306,208.99440220424108,208.74496459960938,3.469684648577866
2022-12-12,0,212.22000122070312,204.8949966430664,216.98749923706055,208.6031265258789,212.25937175750732,0.42593344320704835,3.1088184769424347,-0.24413954875360133,2.9956234333695395,209.8350009918213,2.486949005126951,0.014768751374276405,207.48950233459473,214.99299850463868,0.5763442136619266,0.018387494606884266,1.008172222959686,1.002095377287346,1.0100399556949322,-0.012114639393751125,47.99794109617598,216.71738728194885,210.49975032806395,204.28211337417906,211.32857240949357,3.3242741165037377,211.58928571428572,2.981003700890425,210.39018151339414,210.38881712757748,-1.8324437682222539,-1.560361802536859,5941700,2.598028885835659,0.8345799288984028,61691200.0,-30.029592143071515,89.0859394939463,92.09290994229893,53.24094825599651,29.417039652064805,23.32593657894202,0.09600472126806173,4.775943805288701,215.45927648925783,213.48535809326174,211.88999938964844,210.29464068603517,208.32072229003907,0.04,0.0,207.32431448710935,0.0042586533621209455,-0.014104579537873958,208.65477425711495,209.32768358503068,3.2865212027106434
2022-12-13,0,216.29499435424805,205.68500137329102,216.98749923706055,208.8987512588501,212.30437564849854,0.5586566097196433,2.847439736961835,-0.21505293936183545,2.995641322225327,210.25875091552734,2.3293488883972175,0.013503550735733068,208.20750312805177,214.99299850463868,0.47674529215185923,0.031771883237864056,1.0257461790092428,1.0213084134599326,1.0319909949047446,0.028934971917549568,55.211863358080926,216.56088003086947,210.8660005569458,205.17112108302214,211.29535729544503,3.264290759076528,212.15142822265625,3.0788347688397906,210.86045689799187,210.62802628086146,-2.1971302647019737,1.8990218978254605,14585000,2.7025950570078607,1.929530145849195,76276200.0,-46.734051986777665,89.0859394939463,92.09290994229893,103.333235440138,33.72951171083127,20.853860887978144,-0.0036623518025513725,4.960519292155581,216.47539788818358,214.3072992248535,212.55500030517578,210.80270138549804,208.63460272216795,0.02,1.0,207.38165876104875,0.018940002327466843,-0.0029951732366330186,208.00370570591517,209.51863316127233,3.13883666110709
2022-12-14,0,213.52000427246094,207.69000244140625,216.98749923706055,209.11812591552734,212.5987491607666,0.669827334939614,2.8210005731114496,-0.7094699641206348,2.995643493756261,210.71249961853027,2.3693987464904778,0.013344594495947416,208.40899963378905,216.31824493408203,0.49274008829037813,0.028482413829343682,1.0100451240413066,1.004733826165735,1.0128720130791875,0.028070690753154937,60.39150045105491,217.03850135221657,211.39650020599365,205.75449905977072,211.10928671700614,3.0604885092651046,212.32285717555456,3.0837992247247707,212.22536573203956,211.4464333044583,-0.10737933896433288,3.7759362581243168,7001700,2.659608529692188,0.9282239499198939,69274500.0,-44.848434406175755,89.0859394939463,92.09290994229893,57.03610957687564,31.460934778163843,20.883204149760864,-0.006522011365186324,4.938338906662235,216.47539788818358,214.3072992248535,212.55500030517578,210.80270138549804,208.63460272216795,0.02,0.0,207.40378070479608,0.026514625966598926,0.020279294548186222,207.9529745919364,209.63066864013672,3.1371114452972284
2022-12-15,0,209.03750610351562,207.69000244140625,216.98749923706055,209.11812591552734,212.92187595367432,0.5064773169506873,2.8457158118058565,-0.9071885488355704,2.9956420048735235,211.54500007629395,2.420998954772949,0.013451280002773363,208.40899963378905,216.31824493408203,0.5322083247405867,0.019395360900510958,0.9880895393751516,0.9831958037697709,0.9861538902528161,-0.0006095418040956702,54.47585967700903,217.2486820279696,211.55725040435792,205.86581878074622,210.9414302280971,3.1488188292699717,212.0596433367048,3.2020607020056984,212.54015245935597,211.8036897856665,-0.6063117500489972,1.136796775633986,10831800,2.737641525716528,1.3925414350435306,58442700.0,-81.27945795815714,89.0859394939463,92.09290994229893,-71.30957840070806,28.56842150970033,25.76675033856152,-0.06284804258225013,5.049886128027098,216.47539788818358,214.3072992248535,212.55500030517578,210.80270138549804,208.63460272216795,0.02,0.0,207.41151916655113,-0.0056910965441751005,0.00048114082777659344,207.788090297154,209.21635219029017,3.2335375412926304
2022-12-16,0,207.02000045776367,207.69000244140625,216.98749923706055,209.02250480651855,212.92187595367432,0.5051921017407953,2.862632628995222,-0.9261798005771289,2.9956409110228357,211.54500007629395,2.4419986724853517,0.013532586588365505,208.40899963378905,216.31824493408203,0.4685070034123223,-0.001671534673604753,0.9786502303306308,0.977361164148234,0.9767536169331169,-0.00787157161942409,46.03122062695645,217.26151594463596,211.5362506866455,205.81098542865504,210.8457156590053,3.2719020960757113,211.69250079563685,3.4728875622287405,211.6619772819041,211.60709550862697,-0.5589560153817158,-1.7323008833291098,12472900,2.9321180840585837,1.53365290327261,45969800.0,-88.14817783230527,89.0859394939463,92.09290994229893,-112.56813257472835,27.280221303106106,26.815845610860578,-0.08639160485406319,4.910607893027762,216.47539788818358,214.3072992248535,212.55500030517578,210.80270138549804,208.63460272216795,0.02,1.0,207.4081622035881,-0.00867281527191055,-0.010569137025061216,207.65843854631697,208.90843418666296,3.3991805881637047
2022-12-19,0,205.71750259399414,207.02000045776367,216.98749923706055,208.8987512588501,212.92187595367432,0.4068067141612109,2.9949329197227104,-0.9688117610987113,2.995632122602182,211.54500007629395,2.560373878479004,0.014165939908883415,208.20750312805177,216.31824493408203,0.4971844307029759,-0.023352364647983907,0.9730374128786504,0.975590966866684,0.9721149207087152,-0.03064036655030722,41.5184780136788,217.40774132009727,211.41787548065184,205.42800964120642,210.35321589878626,3.7861135537717536,211.4596437726702,3.765864799189716,210.5096008328595,211.12400590006098,-0.3225971283001934,-2.4226978087606064,4893600,2.8970665243993476,0.6135360064994496,41076200.0,-94.57261109027529,89.0859394939463,92.09290994229893,-127.05023312215383,25.85460550982819,27.418725380194523,-0.07735823775852892,4.811279062670814,216.196916015625,213.85653619384763,211.96499633789062,210.0734564819336,207.73307666015626,0.04,0.0,207.40338094899067,-0.045528613162089115,-0.018591306402464106,207.05528477260046,208.60967690604073,3.7006328120318783
2022-12-20,0,204.8300018310547,205.71750259399414,216.98749923706055,208.6031265258789,212.92187595367432,0.3394625660904642,3.237492742331953,-0.9568753243811332,2.9956148730716285,210.66625022888184,2.787998580932617,0.015335917670961199,207.62300224304198,216.31824493408203,0.556782619996371,-0.012232014842416913,0.9702743124487293,0.9755946552725694,0.9739061816642918,-0.05300627764143251,40.898248166360595,217.5802360339803,211.1052505493164,204.6302650646525,209.80571583339147,4.311941208785438,210.90767969403947,4.140272709534622,209.30146882807205,210.4657784404659,-1.6482194948692672,-1.5599757424848124,5024900,2.7945852178022736,0.6521812489941283,36051300.0,-88.98357659488313,89.0859394939463,92.09290994229893,-125.16668336820156,24.678799249322303,26.782216237631285,-0.017774377043498678,4.680473109774425,216.10251745605467,213.7037385253906,211.76499938964844,209.82626025390624,207.42748132324218,0.06,0.0,207.39784050644067,-0.036049619359827534,-0.043012296641778136,206.5845947265625,207.78949846540178,3.77027138299931
2022-12-21,0,206.7300033569336,204.8300018310547,216.98749923706055,208.6031265258789,212.92187595367432,0.15617399338690113,3.4666191376234856,-0.9152488544199069,2.9955973275204846,210.66625022888184,2.959748649597168,0.016434654190653163,206.8897506713867,216.31824493408203,0.5984311317149348,-0.017248398316734283,0.9800719320821976,0.9871750416581335,0.9937747882426325,-0.031800303389199036,39.38261380974796,217.86673875589884,210.93350048065184,204.00026220540485,209.02143042428153,4.298886096304218,210.17500141688757,3.8810930747534806,208.17529126738688,209.78245465277772,-1.8366982163661347,-3.635485522581538,4086900,2.7985695457629247,0.5345532310066772,40138200.0,-80.15827169758047,89.0859394939463,92.09290994229893,-85.33499973701284,25.92136096331716,25.684688354322628,-0.04948262193838596,4.531868323204851,216.10251745605467,213.7037385253906,211.76499938964844,209.82626025390624,207.42748132324218,0.06,0.0,207.39661590770334,-0.030517615425126765,-0.0292433301749455,205.4882071358817,207.07149069649833,3.8855882079209607
2022-12-22,1,204.89749908447266,204.8300018310547,216.98749923706055,208.41937732696533,212.92187595367432,0.1519829036722701,3.546703567646119,-1.0000190153481348,2.9955909064525086,210.66625022888184,3.0444984436035156,0.016821079357103138,206.62875328063964,216.31824493408203,0.6763031401442646,-0.020793840456429468,0.971774783664631,0.9788732185172244,0.9914378988439471,-0.019805091900555127,42.403645684565085,217.94215782193774,210.8487506866455,203.75534355135326,207.3932168143136,3.066677098216237,209.34428705487932,3.6548604801089497,207.81368716863827,209.34779631499165,-2.5869370616297758,-4.72722894922189,5690300,2.760822844951266,0.7352188743604321,34447900.0,-83.58546678668542,89.0859394939463,92.09290994229893,-114.42399509647822,24.01377150575064,29.21952731966245,-0.04398359036680054,4.542448634130154,215.76739788818358,213.1612992248535,211.05500030517578,208.94870138549803,206.34260272216795,0.08,0.0,207.38891461585462,-0.013707779067345216,-0.03872118192267061,204.36363656180245,206.1836711338588,4.08854417458837
2022-12-23,1,204.93000411987305,204.8300018310547,216.98749923706055,207.5225019454956,212.92187595367432,0.17793308029261087,3.7748507834041702,-1.114684922557818,2.9955716934251324,209.68875122070312,3.297386112213135,0.01792957800752295,205.635502243042,216.31824493408203,0.6785679885066034,-0.036785016951908715,0.9733652283960645,0.981028577276422,0.9955839401741076,-0.01009562522108598,38.32014965725363,218.08732726108326,210.5376256942749,202.98792412746656,206.16607393537248,1.550042217260353,208.63768032618933,3.4656452264120405,207.08642618761507,208.74974179219552,-5.26942165434886,-5.371142723173509,3246000,2.747270697992365,0.416035169454867,37693900.0,-79.27171514860868,89.0859394939463,92.09290994229893,-93.87297096254855,22.95637229472906,27.932902887226433,-0.03981932375987854,4.412273818577025,215.76739788818358,213.1612992248535,211.05500030517578,208.94870138549803,206.34260272216795,0.08,0.0,207.38545981199906,-0.005123489954361737,-0.010004315090914363,203.30811418805803,205.6305443899972,4.146761818400482
2022-12-27,1,205.92250061035156,204.8300018310547,216.98749923706055,206.94750118255615,212.7981252670288,0.30237055731613105,3.9282665637199696,-1.1287147124198214,2.995557872357029,209.10125350952148,3.397048587799071,0.018692857161375618,204.926753616333,216.31824493408203,0.7122964260940458,-0.034078016817680086,0.9798927409288166,0.9875443400086383,1.0024413200584248,0.0009965025521527782,38.64077120284358,218.00453403533785,210.14800090789794,202.29146778045802,205.72107315063477,0.8984997339297928,208.33125168936593,3.5051239285165674,206.5585438478106,208.31452939313044,-4.023042328917656,-4.60496190061698,2904900,2.748765670378503,0.39065357719203875,40598800.0,-76.69473088525808,89.0859394939463,92.09290994229893,-73.81438131008954,23.15187069362849,26.865038095525158,0.014458659653998484,4.259968458293452,215.76739788818358,213.1612992248535,211.05500030517578,208.94870138549803,206.34260272216795,0.08,0.0,207.3834006542568,0.007176941169895867,-0.00290013097317436,203.07981654575892,205.43395342145647,4.22579403902757
2022-12-28,1,206.25,204.8300018310547,216.98749923706055,206.5281276702881,212.7981252670288,0.45478539959037473,4.003042435684909,-1.1005092254508644,2.995550813200926,209.00750350952148,3.4453488922119164,0.019076993601547725,204.926753616333,216.31824493408203,0.7609571858065973,-0.014618800070782118,0.9829098725619715,0.9921112046504126,1.0038352502777028,0.006932569234249897,42.91387271567632,217.8422110081496,209.8361261367798,201.83004126541,205.61107308523995,0.7474023897582344,208.22839437212264,3.5462755328535587,206.41695644928916,208.12475624008803,-1.490165832547537,-2.0407924763690657,3139200,2.682058349214481,0.43944137527008387,43738000.0,-83.97757939917079,89.0859394939463,92.09290994229893,-65.97667720411685,24.48233190608478,25.16977198325048,-0.018611318167427796,4.222113263162252,215.76739788818358,213.1612992248535,211.05500030517578,208.94870138549803,206.34260272216795,0.08,0.0,207.38146051891994,-0.0018015501858039684,0.000830045988218185,202.81206403459822,205.2352512904576,4.36286136869692
2022-12-29,1,207.0099983215332,204.8300018310547,216.98749923706055,206.1681251525879,212.7981252670288,0.49769859820476137,4.075770327030202,-1.142740050708549,2.995543977456953,208.850004196167,3.5544489288330054,0.019436219193514636,204.926753616333,216.31824493408203,0.7824980023544518,-0.029674318542419614,0.9871733144389717,1.0006017631837003,1.0061434821498123,0.0013543992649978076,41.285734050245246,217.8512917450638,209.6997510910034,201.548210436943,205.79571533203125,0.9182117815443465,208.07446561540877,3.54926267817416,206.3958946372568,208.11370454323094,-0.37194495993674187,-0.693342204477322,3675500,2.537751402869807,0.5542499153658645,47413500.0,-66.77873547742932,89.0859394939463,92.09290994229893,-39.040261974653426,22.99900057049418,23.644790145913873,-0.10587296343818396,4.173390407567745,215.76739788818358,213.1612992248535,211.05500030517578,208.94870138549803,206.34260272216795,0.08,0.0,207.38142832176595,0.006044239356425729,0.013147746096365084,203.26865713936942,205.16197095598494,4.035014406587985
2022-12-30,1,206.95249557495117,204.8300018310547,216.98749923706055,206.1681251525879,212.54500198364258,0.6765867648784148,4.060587299035176,-0.9605960404282077,2.995545096243107,208.1762523651123,3.4628366661071794,0.019389462460603486,204.926753616333,216.31824493408203,0.7445764156895934,-0.04598191578136419,0.9882062245114566,1.003481444284369,1.005590301091907,0.010029387863007999,40.201396201557785,217.5435506585562,209.42237606048585,201.3012014624155,206.09892872401647,0.8963487687546347,207.95232227870397,3.556885153953912,206.55938588120148,208.10722462769755,0.6282867093180415,-1.0302883295778784,4159400,2.296113171506592,0.6627068469404338,43254100.0,-68.45942570504629,89.0859394939463,92.09290994229893,-38.306813372671336,22.04026982003577,22.659139168101124,-0.08799659493808183,4.043862564681344,215.76739788818358,213.1612992248535,211.05500030517578,208.94870138549803,206.34260272216795,0.08,0.0,207.38099753025273,0.013166828481149029,0.004593612935623321,203.60687691824776,205.09573582240515,3.625952183634866
2023-01-03,1,208.79000091552734,204.8300018310547,216.5275001525879,206.1681251525879,210.71437644958496,0.8620123553940614,3.6986588128189486,-0.5455005081294906,2.995576341244164,207.35500144958496,3.0434999847412088,0.017703655621775536,204.926753616333,214.9697479248047,0.6949215638748609,-0.044220732105109836,0.9993747627296039,1.0134157839906175,1.012496793090726,0.018835683980157558,40.337778126442146,216.31794350301828,208.92062587738036,201.52330825174244,206.39321408952986,1.3575734421270074,207.70732225690568,3.3525752188716753,206.64023353697502,207.87882655893054,1.0362220987759074,-0.8195083903960362,4202800,2.2984718752293634,0.6746197358536601,47456900.0,-70.53222854514847,89.0859394939463,92.09290994229893,4.109137706072552,27.02854655568234,20.27905159599436,-0.1341969858619595,4.195729393805682,215.76739788818358,213.1612992248535,211.05500030517578,208.94870138549803,206.34260272216795,0.02,1.0,207.38351713308202,0.007579097193675777,0.011362492023995703,203.68861389160156,204.58841051374162,2.999790583075416
2023-01-04,1,211.2624969482422,204.8300018310547,216.29499435424805,206.1681251525879,209.42687606811523,0.9802632655596561,3.261599471061208,-0.03988842631140965,2.9956105694721407,207.35500144958496,2.5921251678466803,0.015640631105237317,204.926753616333,213.65025367736817,0.6585712429673347,-0.028081311097019203,1.0130853927516998,1.024536482454903,1.020665738496459,0.025932068239570505,48.01055742437756,215.05694985764976,208.53375091552735,202.01055197340494,207.30249949863978,2.1112076480798376,207.3478581564767,2.5298075429685656,207.1473891320376,207.94647979094023,0.9964676269254552,-1.6162474250523977,6606200,2.3368429496981835,1.0812332494527301,54063100.0,-25.936394006905815,89.0859394939463,92.09290994229893,97.45965513036231,25.868130986545165,18.326897570876355,-0.05094540995612444,4.311034262894198,212.94060021972658,210.87470111083985,209.2050018310547,207.53530255126952,205.46940344238283,0.04,0.0,207.39754597311148,0.030636597335966353,0.0329398732821661,204.7525896344866,204.55811309814453,2.909891800806112
2023-01-05,1,212.38250350952148,204.8300018310547,216.29499435424805,206.1681251525879,209.42687606811523,1.0147890505820665,3.00020543195091,0.4232325185014041,2.995629094581051,207.35500144958496,2.396325092315675,0.014399436635449526,204.926753616333,212.3500015258789,0.715513841586958,0.004994923778279752,1.01932633318875,1.0272058011494234,1.0208096263536883,0.029733350349194998,58.98367610543991,214.35616171076464,208.3557508468628,202.35533998296097,208.36714226858956,2.549073139885786,207.26660810198103,2.3264182574686822,208.1585326768358,208.33859746842052,3.106430235707976,-2.3266823261585206,5246000,2.1821563686595664,0.8638412613465616,59309100.0,-25.353311398557405,89.0859394939463,92.09290994229893,92.15973491309117,25.872962741608994,17.19188655553656,-0.061600169002433446,4.2673887403575135,211.3209239501953,209.56454412841796,208.14500427246094,206.72546441650388,204.96908459472655,0.06,0.0,207.40887418306636,0.02985506200902366,0.02336525682811971,205.49666922433036,204.4023917061942,2.9725746179375396
2023-01-06,0,215.74499893188477,204.8300018310547,216.29499435424805,206.1681251525879,209.68937492370605,0.9109747637987816,3.1028730329317895,-0.007191817416881463,2.9956219889505924,207.35500144958496,2.515675201416016,0.014884437110202077,204.926753616333,212.49625358581542,0.7367630638164807,0.02259377443764578,1.0349256428994353,1.0396710499863686,1.0308940909508906,0.04219603246788184,64.14177596369613,214.66999701190852,208.46425094604493,202.25850488018133,209.77035631452287,3.50380915887565,207.74571473257882,3.2331493560028863,209.22284253383862,208.90134361416594,3.636607251171051,-0.5327373267977047,6829700,2.105941922820716,1.1348466394269354,66138800.0,-2.435974537542257,89.0859394939463,92.09290994229893,172.32761568278355,29.330430750265535,15.258330731703282,-0.03905919360383725,4.4647180291115385,214.36164068603514,212.0241814880371,210.13500213623047,208.24582278442384,205.9083635864258,0.08,0.0,207.4379252235705,0.04657317303275965,0.062246942559799845,207.11166163853235,205.09573909214564,3.615364819977479
2023-01-09,0,219.5575065612793,204.8300018310547,216.29499435424805,206.1681251525879,211.50187301635742,0.7584133933998807,3.4765076098953176,-0.5712754830848352,2.9955943197746233,207.84125137329102,2.869150009155271,0.016644599659446,204.926753616333,213.74250373840331,0.706377330277484,0.03145840837404149,1.0511833164227484,1.0534668659664561,1.0404262375510378,0.0609077505990403,70.1806396288244,215.82001599035948,208.86700077056884,201.9139855507782,211.67142868041992,4.686095391682059,208.64125088282995,4.50347119883076,210.8743983276574,209.8878364074879,4.769997592501766,3.208750885617427,6294500,2.203773787826166,1.033907297386528,72433300.0,-17.978089049616276,89.0859394939463,92.09290994229893,192.3482465487422,33.74932496699813,14.169517973461389,-0.08597547645122482,4.464381506593676,217.4711262817383,214.5394460144043,212.17000579833984,209.8005655822754,206.8688853149414,0.1,0.0,207.47469017623655,0.052175694708179954,0.050658550826866725,209.0296369280134,205.9208504813058,4.205517853746931
2023-01-10,0,220.1624984741211,204.8300018310547,219.5575065612793,206.1681251525879,212.26062679290771,0.8926330512474515,4.186406600702863,-0.25468192233295195,2.995533553448839,207.84125137329102,3.527612342834476,0.01999366759769112,204.926753616333,215.79999847412108,0.6964390218553241,0.05221352256851935,1.0514639956925635,1.0489910217750031,1.0309767010069892,0.054468592886279366,76.22372872593546,217.7594392542622,209.38662605285646,201.01381285145072,213.55035727364677,5.122070947727021,209.673036302839,5.356110764388878,213.06393301716207,211.18073785121715,6.452124393347538,6.056181081920891,10857000,2.3236744728211756,1.7005247082778605,83290300.0,-6.416601205489711,89.0859394939463,92.09290994229893,166.803779467005,31.755884569198326,13.211177841975323,-0.04123360475107351,4.446211878521272,217.60864068603516,214.65068148803712,212.26000213623047,209.86932278442382,206.91136358642578,0.12000000000000001,0.0,207.54186966204207,0.06605910998276121,0.06416057830609143,210.86587524414062,207.067266191755,4.9333235801828295
2023-01-11,0,221.31749725341797,204.8300018310547,220.1624984741211,206.1681251525879,212.66687870025635,0.8014014765250465,4.793237841630638,-0.5964028391184519,2.995473225240765,207.9050006866455,4.145199737548831,0.02282911375804586,204.926753616333,216.6212455749512,0.7761650183351441,0.0374257714057686,1.054085461305932,1.0468960886143905,1.0254630961897913,0.04759481900679785,75.88337663232066,219.54810154538285,209.9616258621216,200.37515017886034,215.6025003705706,4.911403570599275,210.85071454729353,5.9850102244976435,214.8583713915072,212.38993907892325,6.353557924366094,7.021763193691751,5408200,2.215106866529852,0.8506368136902164,88698500.0,-1.4313591547865134,89.0859394939463,92.09290994229893,154.06135602947305,30.44942341953918,12.667659976674862,-0.044327880966860495,4.305767867589605,217.60864068603516,214.65068148803712,212.26000213623047,209.86932278442382,206.91136358642578,0.12000000000000001,0.0,207.57705061064652,0.044635698722711226,0.07092918984726762,212.88672528948103,208.24680110386439,5.535391384707726
2023-01-12,0,222.5349998474121,204.8300018310547,221.31749725341797,206.1681251525879,214.0762529373169,0.7781851896531609,5.381542131308418,-0.8035354342941226,2.9954073093802025,207.9050006866455,4.691049499511718,0.025575665949829896,204.926753616333,219.61800575256348,0.797430730550786,0.023220615503214394,1.0575929128439407,1.045044919129405,1.0215853377630868,0.04780288474862737,76.10306692562783,221.17958492637416,210.41650066375732,199.65341640114048,217.56607164655412,4.460781420336912,211.979642868042,6.606314404522476,216.47278800979186,213.42913157534213,6.941207274915069,8.049355697395487,4264400,2.0512927281541833,0.7299811102580628,92962900.0,-0.8763953210118102,89.0859394939463,92.09290994229893,153.34725307983436,31.557365106795228,11.982632726365452,0.0945071875829098,4.226784230416479,218.69351928710938,215.5282403564453,212.97000122070312,210.41176208496094,207.24648315429687,0.14,0.0,207.607382608502,0.059258160746150645,0.05178488957335351,215.17391967773438,209.43126678466797,6.24608471327409
2023-01-13,0,222.21749877929688,204.8300018310547,222.5349998474121,206.1681251525879,214.0762529373169,0.8288756477888606,5.871858160703124,-0.7865216029734028,2.995346936815506,207.9050006866455,5.065449829101562,0.02786456570684356,204.926753616333,220.2779983520508,0.8388545483885461,0.0422208476703084,1.0545203794917088,1.0356338057876153,1.010706636451192,0.030000694706511455,80.94961826399756,222.4722172598218,210.72850093841552,198.98478461700924,219.13107190813338,3.7449424771494644,213.2167857033866,6.797022479937356,217.97415239999515,214.29005474594805,6.58316915159445,7.645235927941287,4283200,1.930097646558487,0.750665542677979,88679700.0,-3.6964033916787353,89.0859394939463,92.09290994229893,130.18201040690744,29.60686078896338,12.044493099823496,0.13653333622008013,4.183442150860946,219.0215591430664,216.05922012329103,213.66500091552734,211.2707817077637,208.3084426879883,0.14,0.0,207.6370012006921,0.024385770360598524,0.05660562608156255,216.64657592773438,210.69958278111048,6.787880924715712
2023-01-17,0,223.0374984741211,204.8300018310547,222.5349998474121,206.1681251525879,216.6981258392334,0.7357373645430122,6.3639477731094125,-1.0956281440568008,2.995281366083366,207.9050006866455,5.587299499511721,0.030137554645095956,204.926753616333,221.40749740600586,0.8877905115108844,0.06305085111977227,1.056231923613834,1.032140203107027,1.0084984413381362,0.015850024749076486,85.24143688370268,223.8912712099761,211.16337566375734,198.43548011753856,220.6532140459333,2.504866636968762,214.51017815726144,6.82162423396308,219.02046523603633,215.028158019278,5.185492924349268,8.453006880129728,6101100,1.5546688089359544,1.1155103865460791,94780800.0,-7.070680604063588,89.0859394939463,92.09290994229893,120.5552493134946,29.675957043631833,11.61109035100555,0.1771312389193303,4.029624767048701,219.72719677734378,216.8363985595703,214.5,212.1636014404297,209.27280322265622,0.16,0.0,207.6816636341717,0.02012800321759345,0.024110150284687833,218.32216099330358,211.90941510881697,7.199228005041089
2023-01-18,0,221.99250411987305,204.8300018310547,223.0374984741211,206.1681251525879,219.70875453948975,0.546399489091901,6.843508263262613,-1.4096298981350444,2.9952135072747614,207.9050006866455,6.204799957275389,0.0323015162679453,204.926753616333,222.2492488861084,0.8932459755598255,0.07737174176861873,1.0478097208830426,1.0197140071910282,1.0006243094787324,0.008312067942702228,89.1190421076518,225.5503918088128,211.8633752822876,198.17635875576238,221.5457147870745,1.2762810884107103,215.6580355507987,6.614321101743479,220.01559820337383,215.82006062256355,5.0168892392409,8.835941048269406,6558000,1.4172722974576495,1.2675917496361326,88222800.0,-27.3897875710793,89.0859394939463,92.09290994229893,86.98304789800308,26.833093543907165,15.55615270785698,0.12122324169280731,4.138223216041133,220.2251649169922,217.2774245605469,214.89500427246094,212.512583984375,209.5648436279297,0.18,0.0,207.72338121957515,-0.007372487594866306,0.003934108111623153,218.56314086914062,212.8374012538365,7.266054338384307
2023-01-19,0,219.38250350952148,204.8300018310547,223.0374984741211,206.1681251525879,220.4512481689453,0.33577984338378636,7.087327722805163,-1.6286815039161686,2.9951786106786558,210.02624893188477,6.5668998718261715,0.03333456111269115,204.926753616333,222.2492488861084,0.9071319970378249,0.07911335360705497,1.031844406850546,1.0016505413596228,0.9872311394599969,-0.008743067167802043,84.39344096531681,226.7866559110034,212.61200046539307,198.43734501978273,221.5207143511091,1.3225919268260475,216.59607151576452,6.087704729326825,220.5040699182014,216.35516840614957,2.895782158992594,7.803908490762402,4853100,1.3977879656066834,0.9384199947211337,83369700.0,-23.499233146245803,89.0859394939463,92.09290994229893,64.0818707370687,24.967390965201886,17.829958983536095,0.16620497738004467,4.129779005779296,220.39036419677737,217.54482339477542,215.24500274658203,212.94518209838867,210.09964129638672,0.18,0.0,207.75072574313734,-0.0076092525078399476,-0.00307571196414314,218.8182089669364,213.9239229474749,7.209431959785533
2023-01-20,0,222.5724983215332,204.8300018310547,223.0374984741211,206.6100025177002,220.4512481689453,0.1407772056481332,7.048309311741406,-1.7123251010750293,2.995187011863554,211.82250022888184,6.6290251350402825,0.03304484884145282,204.926753616333,222.2492488861084,0.9165623862833591,0.0710467292309542,1.0434948635196073,1.0124617203226947,1.003333576935508,0.00016850596151973818,71.03112072378057,227.39186913465224,213.29525051116943,199.19863188768662,221.86500004359655,1.2197859863523666,217.70767865862166,5.604307596345465,220.2197562515923,216.54508026767004,-0.0797071594129115,6.367274428858901,5211000,1.55498543932674,1.0058156255609578,88580700.0,-3.525182132432767,89.0859394939463,92.09290994229893,86.6013889301198,28.270799903310305,16.587889649036786,0.20277994367309946,4.1219368634806415,220.43756347656253,217.62122222900393,215.34500122070312,213.06878021240234,210.25243896484375,0.18,0.0,207.78780101360977,0.0030855294913034736,0.009950362751950543,219.27198137555803,215.06892830984933,7.322070177091059
2023-01-23,0,224.53249740600586,204.89749908447266,223.0374984741211,206.89687252044678,221.48624897003174,-0.03773550597264494,7.043579933927757,-1.739120444931523,2.9951911855153748,214.06375122070312,6.669625091552734,0.03288589886487242,205.8232509613037,222.53874969482422,0.9044658115189157,0.07663374791924349,1.0483238737738831,1.0166649927174747,1.0121348300123731,0.010417715253865811,75.74188533068659,228.26953520354888,214.18237533569337,200.09521546783785,222.32428577968054,1.5419925570845252,218.96339307512557,4.939138458646669,220.80827480627426,217.1898640786159,1.094645938393269,7.5177528265219,5501500,1.6294013456382437,1.0475854977530656,94082200.0,-10.07986501601639,89.0859394939463,92.09290994229893,91.63736798856226,29.873591625231413,15.694573656223398,0.18173926209924107,4.045370162595518,221.47055853271485,218.54471951293945,216.18000030517578,213.81528109741208,210.8894420776367,0.19999999999999998,0.0,207.83047440422013,0.005020929728758228,0.002504212885279616,219.56510053362166,216.22591291155135,7.394038064108561
2023-01-24,0,223.13500213623047,204.89749908447266,224.53249740600586,206.9956226348877,222.048752784729,-0.20356862410327511,7.16931344256477,-1.6580880255062753,2.9951752863139056,217.56375122070312,6.7255001258850085,0.03333440324213074,205.8232509613037,222.618998336792,0.8749201408829453,0.09582839424232467,1.037487368662444,1.0063331398997786,1.003740389911314,0.0004371626420509589,80.51529311325964,229.41112692327653,215.07250003814698,200.73387315301744,222.41000039236886,1.5720410249769605,219.9880360194615,4.0794236311999725,221.73033874319594,217.98710191987215,1.4526642459301708,8.494703957163836,5274900,1.519107251835118,1.0084250491795756,88807300.0,-29.98036872652782,89.0859394939463,92.09290994229893,75.86922562878668,23.81824078161008,22.39808822061694,0.17067273755008713,4.7114148025951526,225.19031884765624,222.2148381347656,219.80999755859375,217.4051569824219,214.42967626953126,0.02,1.0,207.86873716571608,0.003991050413837849,0.0037209177181920503,219.60315159388952,217.38853563581193,7.218514859646679
2023-01-25,0,223.16499710083008,204.93000411987305,224.53249740600586,208.3450002670288,222.29687404632568,-0.38309397326699834,6.974324607268371,-1.5413329588654316,2.9952086392463957,219.4700050354004,6.461437778472901,0.03229087567611951,206.21725006103514,223.04724884033203,0.8769459981978457,0.08883520055808165,1.0332460248745032,1.0048471544879196,1.0037872644667285,0.005281678251279676,73.98094197438556,229.93302440527162,215.98437519073485,202.03572597619808,222.54535729544503,1.5933502766991063,220.8382146017892,3.2837696682035538,222.0741865153733,218.61928867741193,0.2696215378388879,6.870540331338402,4729600,1.6000977714797961,0.8915346059668126,93536900.0,-26.100347266418872,89.0859394939463,92.09290994229893,72.31924503961639,22.426824636269753,21.089634676097155,0.18984994215848744,4.6463139632146016,225.38856158447265,222.53572256469727,220.2300033569336,217.92428414916992,215.07144512939453,0.02,0.0,207.9032644924579,0.024788025344696818,0.008520155297072379,219.8624485560826,218.2545122419085,7.0283056949044616
2023-01-26,0,225.3650016784668,205.92250061035156,224.53249740600586,210.64437294006348,222.54437446594238,-0.5626516822858576,6.6541736426983835,-1.357342048326342,2.995258839045348,219.8600025177002,6.085400390625,0.03067908035523319,206.88224601745605,223.13800163269042,0.8730610531704782,0.08373294049640999,1.0390457729244351,1.0133831049804758,1.012614726475146,0.027269714189790184,73.63050343580804,230.20447212517948,216.89612483978271,203.58777755438595,222.8778577532087,1.922103285969483,221.765535899571,2.435864499054079,222.3420104119833,219.21858787008446,0.426383307677423,5.633986308276911,7043400,1.6133895896864956,1.27784525760917,100580300.0,-31.28321786225409,89.0859394939463,92.09290994229893,83.93051970211671,24.53495989899966,19.96264233119238,0.14509023128948292,4.558006084520109,226.0092391357422,223.54037860107422,221.5449981689453,219.54961773681643,217.08075720214845,0.02,0.0,207.95918038233083,0.019509149703627937,0.023922287577604118,220.10342843191964,219.2127947126116,6.7279906366063935
2023-01-27,0,229.88249969482422,206.25,225.3650016784668,212.10250186920166,222.68874835968018,-0.724628307243316,6.395160049343939,-1.0528939607566237,2.9952982865779485,220.73999786376953,5.668525505065918,0.02935333648881475,207.004248046875,223.30174713134767,0.8404430668429173,0.09267879601680871,1.055144564696902,1.0318187000658703,1.0273894562090504,0.03284323727512284,76.9598219167073,230.65856999187633,217.86824989318848,205.07792979450062,224.00499997820174,3.202990705529449,222.7753573826381,2.66741808377798,223.08727533300794,220.10176328229292,1.043547932643157,6.112790815823152,11382600,1.6320332916464468,1.9214041614724924,111962900.0,-8.636610946798637,89.0859394939463,92.09290994229893,144.15997209157436,30.122786347909226,17.554119394418326,0.20674078741981142,4.813147766031571,229.0144383544922,226.6477796020508,224.73500061035156,222.82222161865235,220.45556286621095,0.02,1.0,208.07669630135018,0.031786418525877824,0.05004311084730101,221.79169355119978,220.1774172101702,6.606845096550717
2023-01-30,0,229.4124984741211,206.95249557495117,229.88249969482422,214.90437507629395,223.06187438964844,-0.6638113612488403,6.322164015425147,-0.5941295763706744,2.9953129714642346,221.6550006866455,5.215675506591799,0.028861755885267276,208.61200065612792,224.61574783325196,0.7798508060214313,0.11048983893891379,1.0473071422750924,1.0263244057466443,1.0186332182360132,0.021734052417771377,81.9692250104041,231.69420290877997,219.04987487792968,206.4055468470794,225.43785640171595,3.0292166321182616,223.47928537641252,3.028790356555374,224.7731167234769,221.5929229979453,3.554172068211221,6.552875307854974,5677400,1.8083684270872196,0.9424321901663292,106285500.0,-23.07212958587599,89.0859394939463,92.09290994229893,125.65611997274992,28.52275933350483,16.621700164644817,0.17942529804319135,4.720066480248147,229.0144383544922,226.6477796020508,224.73500061035156,222.82222161865235,220.45556286621095,0.02,0.0,208.1313283694895,0.021946808816727836,0.021354561562658067,223.01632690429688,220.91726793561662,6.371284651108522
2023-01-31,0,229.56750106811523,206.95249557495117,229.88249969482422,218.4731273651123,223.14250087738037,-0.6710550014452307,6.069295249069182,-0.22694021787127294,2.995349841257904,222.10500144958496,4.712499465942381,0.027566404379451813,211.0152473449707,225.76975135803224,0.7624548475197326,0.10852733540019416,1.042682932222559,1.023722650391768,1.0149231681666602,0.028827834585797296,79.99762999119622,232.30859038369746,220.1699998855591,208.03140938742072,226.43714250837053,3.0797889405009067,224.15107127598353,3.2699514244442525,225.92716921707714,222.76890934843314,4.571921098604974,4.488569790753765,11294200,1.8257732963203217,1.7699900014731371,117579700.0,-16.224497288057243,89.0859394939463,92.09290994229893,133.87193693851282,28.06713582537108,16.008600757254197,0.1886634767786331,4.550776453270963,229.0144383544922,226.6477796020508,224.73500061035156,222.82222161865235,220.45556286621095,0.02,0.0,208.24260910596584,0.02822811254213864,0.02689808163793907,223.84778050013952,221.55988093784876,5.980159355855591
2023-02-01,0,230.18249893188477,208.79000091552734,229.88249969482422,219.51375579833984,223.50687217712402,-0.5755590535721158,5.589121491835225,-0.08970327577001713,2.995411700786052,222.3762493133545,4.182274227142332,0.025255772914410883,212.27050285339357,229.4279987335205,0.7507935518892982,0.09951386590104998,1.0401342912992264,1.023484797505969,1.0118868347264869,0.03144535174521135,79.65728152808055,232.47899314388772,221.3007501602173,210.12250717654686,227.2442855834961,3.233941394937029,224.7842856815883,3.52724670567918,226.83987398640195,223.82189593001632,3.142797425258216,4.271845868019002,5792700,1.8326270375652356,0.8966424087542093,123372400.0,-11.967942406277455,89.0859394939463,92.09290994229893,139.50402820559552,28.841795160013827,14.79332905101834,0.2182614840480722,4.572863893070637,229.0144383544922,226.6477796020508,224.73500061035156,222.82222161865235,220.45556286621095,0.02,0.0,208.3009044555481,0.02667853953780952,0.03130998997256805,224.79479108537947,222.17994580950057,5.321797603308183
2023-02-02,0,231.54750061035156,211.2624969482422,230.18249893188477,220.01125049591064,224.7406234741211,-0.39406983151832253,5.119815655960683,-0.1310888703222659,2.995466355685703,222.55374908447266,3.7313367462158196,0.02302382075200179,215.40874938964845,229.59900093078613,0.7470555061785812,0.08955684163989525,1.041269551066762,1.0258185239994808,1.011645741653885,0.02743326996578399,79.6701558197032,232.61000637295652,222.37037506103516,212.1307437491138,228.4460710797991,3.007537534784718,225.42803573608398,3.8890288756860123,227.6810049989004,224.8684741678079,2.5163402140681743,4.005558434594076,7190000,1.8058071588162603,1.1079222605312324,130562400.0,-26.825161201739867,89.0859394939463,92.09290994229893,133.86969720796975,28.734232721767423,13.451507942725717,0.1499950493681682,4.669802753211191,230.12988348388672,227.5500637512207,225.46500396728516,223.3799441833496,220.8001244506836,0.04,0.0,208.37377908219753,0.02158342365749011,0.020720393128031336,225.59383065359933,222.59849112374442,4.956720472102446
2023-02-03,0,229.3300018310547,212.38250350952148,231.54750061035156,221.02874755859375,226.37687587738037,-0.15568916056494458,4.8192886172186435,-0.2360256218750929,2.9954992449266102,222.80499839782715,3.679762115478519,0.02157394946922406,219.0187530517578,229.91249961853026,0.7103552911748107,0.09023811653096403,1.0266149766592765,1.010548126593468,0.9965735135348038,-0.0024033924483289892,81.05440453551,233.0232024785779,223.38462524414064,213.74604800970337,229.32678604125977,1.9032284604989018,225.9360716683524,3.9019075954411506,228.6571827305525,225.9397770855179,3.7701384334964247,4.0499250765583605,5243600,1.807521988413395,0.8080123214328365,125318800.0,-23.599312965827043,89.0859394939463,92.09290994229893,98.7578075578107,27.28690010850551,13.91587351336441,0.198298182529243,4.56624550085602,230.12988348388672,227.5500637512207,225.46500396728516,223.3799441833496,220.8001244506836,0.04,0.0,208.42379309147927,-0.005660257309090921,0.024119888436300446,226.3308606828962,223.09665461948939,4.20718310873826
2023-02-06,0,229.1099967956543,215.74499893188477,231.54750061035156,221.82375240325928,229.3506259918213,0.16374510437927037,4.268786658114881,-0.8961094323738967,2.9955512281375425,223.08625030517578,3.596399841308596,0.01903736600960062,219.5400062561035,229.91249961853026,0.7626061641584818,0.06296786931992335,1.0217542395017285,1.0065813617171713,0.996095773248164,-0.0013185928424946924,69.05224454104301,232.76957347644705,224.2320001602173,215.69442684398754,229.86178534371513,0.8247589447288945,226.3698215484619,3.8924147756706398,228.83834793649496,226.528996881441,2.762532122113732,3.2006944056290747,3402400,1.853938230736758,0.5385129167761398,121916400.0,-27.504250786471058,89.0859394939463,92.09290994229893,81.77072980601024,26.303207703706157,13.414206448699263,0.16501109525096477,4.3986566236524,230.12988348388672,227.5500637512207,225.46500396728516,223.3799441833496,220.8001244506836,0.04,0.0,208.45566522080475,0.0014839528983532357,-0.008641531562395574,226.99742998395647,223.55042920793807,4.015203973466812
2023-02-07,0,229.8550033569336,219.38250350952148,231.54750061035156,222.16125011444092,229.3506259918213,0.2989960867640186,3.9197276281693427,-1.398623187329273,2.9955806446611355,223.14999961853027,3.519549865722655,0.01742873841731411,220.1019992828369,229.91249961853026,0.8262233873062431,0.04350791910505171,1.022030892817377,1.0078276646775564,0.9995977495274361,0.0012523649361546596,65.99268017979858,232.73970530974444,224.90025005340576,217.06079479706708,229.85785729544503,0.82470932308726,226.93142863682337,3.777784813677414,228.91950906005755,226.8424334010314,1.6617465397446969,2.7226355940491285,4042600,1.7126231649198465,0.6514496309349138,125959000.0,-16.86472006984329,89.0859394939463,92.09290994229893,92.25290461302376,27.558915430883612,12.500432577644618,0.23210107113081063,4.383038860142223,230.12988348388672,227.5500637512207,225.46500396728516,223.3799441833496,220.8001244506836,0.04,0.0,208.49562256756423,0.004821715910285018,0.009690018652880805,226.98052106584822,224.386107308524,3.9227114520314807
2023-02-08,0,230.5974998474121,219.38250350952148,231.54750061035156,222.4556245803833,229.45124912261963,0.14890025699867432,3.8599743771430397,-1.5314339389311693,2.9955857745667522,223.84874725341797,3.556650161743164,0.01712384818442003,221.20199737548828,229.91249961853026,0.8187465133148332,0.04402432271612235,1.0229903603703578,1.0081128604356655,1.0025760289621974,0.0018029212362062896,67.4462725274684,233.13507364747457,225.41512489318848,217.69517613890238,230.02714320591517,0.8395430695806311,227.73249980381556,3.198573631854835,229.1656366876807,227.16739990775167,-0.011961040064871052,3.5417859122012967,4978600,1.7133482684747927,0.8421711458355359,130937600.0,-23.20320615947379,89.0859394939463,92.09290994229893,85.43629619075331,26.683206426683995,12.103220234797258,0.17587261676341231,4.203535735599425,230.12988348388672,227.5500637512207,225.46500396728516,223.3799441833496,220.8001244506836,0.04,0.0,208.54511581078833,-0.0030315892483958606,-4.34055890811603e-05,227.13553510393416,225.07593100411552,3.8719207110048335
2023-02-09,0,230.84250259399414,219.38250350952148,231.54750061035156,222.56312370300293,229.63937664031982,-0.003790108427988086,3.8197546192711544,-1.5881946532496432,2.995589349527115,224.94874954223633,3.605312595367431,0.01690629128120887,221.92500343322754,230.2239990234375,0.8235199043254219,0.04193072264579308,1.0217123815356364,1.0059154296087256,1.0032791892845856,-0.00304472306761705,68.5612277792516,233.5763842003953,225.93687496185302,218.29736572331075,230.20928628104073,0.8612300053081592,228.32321439470564,2.9242045925273836,229.5255348863388,227.56543126572026,0.5165374080195068,5.112074189363911,5238400,1.7076433092234962,0.8873928853058587,136176000.0,-28.01356797501961,89.0859394939463,92.09290994229893,70.87716071228387,25.14191795870666,12.886971166193568,0.09473061078382863,4.142568243379702,230.12988348388672,227.5500637512207,225.46500396728516,223.3799441833496,220.8001244506836,0.04,0.0,208.59610317911654,0.0010419884838173132,-0.004767380758873909,227.07764543805803,225.46271296909876,3.816542441135137
2023-02-10,0,228.05750274658203,219.38250350952148,231.54750061035156,222.92124843597412,229.86187744140625,-0.1848223475357672,3.8078914949352605,-1.5427153270213663,2.9955906890643185,227.23749923706055,3.6196250915527344,0.016818333703427526,222.1949993133545,230.62200012207032,0.8393549484332006,0.03733121869493933,1.0072627305331256,0.9914131897692784,0.9917828972278154,-0.005548768474741839,68.42749288290959,234.02890821875235,226.41312522888182,218.7973422390113,229.90571539742606,1.1856552745002813,228.57500049046106,2.7171274784760864,229.84984507596795,227.929922576139,0.5553928669984516,3.7156451649807627,4509700,1.6995786470610343,0.7623660276566251,131666300.0,-40.18113661151222,89.0859394939463,92.09290994229893,19.30204711134084,23.50517059005252,17.203973906756964,0.0457942006486738,4.114527654560666,230.12988348388672,227.5500637512207,225.46500396728516,223.3799441833496,220.8001244506836,0.04,0.0,208.63465007543718,-0.010798172271620166,-0.008342106974294945,226.61893790108817,225.7068644932338,3.7539072936512055
2023-02-13,0,227.96500396728516,219.38250350952148,231.54750061035156,223.11062622070312,229.86187744140625,-0.3610785908275081,3.715776983194478,-1.3759922422830377,2.9955976580096735,228.58374977111816,3.4803251838684077,0.0163915005985801,222.1949993133545,230.62200012207032,0.8405894934819594,0.026280576459396483,1.0056277639603155,0.9917979351634645,0.9924790879423713,-0.004997568174165634,55.416048904263555,234.12080434022934,226.68925037384034,219.25769640745133,229.39393016270228,1.1307890949858406,228.9200006212507,2.237586697015585,229.39898073767372,227.8375999905951,-0.9231788668397244,1.5699310261543833,4946700,1.8407023065441295,0.8315773105323544,126719600.0,-41.27948326995845,89.0859394939463,92.09290994229893,26.098255440972963,22.03838660465744,16.13040103839985,0.04284820704637888,4.074918361983467,231.20132189941407,229.28434118652345,227.73500061035156,226.18566003417968,224.26867932128906,0.04,0.0,208.6780093478969,-0.0004867493610234419,-0.003483535059141858,226.58628627232142,226.09005846296037,3.680866318383281
2023-02-14,0,229.1624984741211,219.38250350952148,231.54750061035156,223.15749835968018,229.86187744140625,-0.545838406129214,3.5785420627005693,-1.0966808492279425,2.995607621747515,228.58374977111816,3.263050231933596,0.015766125929120814,222.51449890136718,230.62200012207032,0.8399177051181128,0.022092722196379002,1.0096303874232997,0.9976360918740377,0.9986882269945431,-0.0030127901185476036,54.34313768778146,234.13370975864086,226.97662563323973,219.8195415078386,229.3700011117118,1.1341347261647388,229.34839357648576,1.505318195288257,229.0392180907257,227.84940629544153,-1.5471972850594644,2.1646096689509204,4829400,1.8386035048739626,0.8206301115210052,131549000.0,-46.19004145565623,89.0859394939463,92.09290994229893,42.72577156751691,23.180155105906746,14.932402334069169,0.06480724304080555,4.087424193272746,231.79132189941407,230.23934118652343,228.98500061035156,227.7306600341797,226.17867932128905,0.04,0.0,208.72230167740202,-0.006401225252073983,0.001740230090872465,226.54531860351562,226.43808964320593,3.589520473874381
2023-02-15,0,228.09500122070312,219.38250350952148,231.54750061035156,224.1906223297119,229.86187744140625,-0.7685491767646844,3.4893036693668646,-0.7443475817530598,2.9956139536710453,229.1362476348877,3.08351251602173,0.01535225062444854,222.51449890136718,230.62200012207032,0.8000661648596623,0.032298362427482435,1.0035731930318141,0.9931639575531072,0.9946364317148517,-0.010852236595647824,59.56992041655098,234.26148297197346,227.28287563323974,220.30426829450602,229.2250017438616,1.2334516760917933,229.54339354378837,1.0608055306705344,229.06119072872465,228.02896002395008,-0.0730403155261787,2.6874740444090492,4407300,1.8229957669937393,0.7628445396805341,127141700.0,-66.09343103457948,89.0859394939463,92.09290994229893,13.724910328470944,22.10281299475107,14.90233844495902,0.1554605583193841,3.9804650607265164,232.37896319580076,231.1905232849121,230.2300033569336,229.26948342895506,228.0810435180664,0.04,0.0,208.76047978467193,-0.00361269782821505,-0.008436981786986748,226.53522382463728,226.76632690429688,3.0760604014699773
2023-02-16,0,226.48250198364258,219.38250350952148,231.54750061035156,225.15687561035156,229.86187744140625,-0.9994234073127247,3.2734866397942595,-0.10852257555497946,2.9956283264731045,229.1362476348877,2.7375502777099654,0.0143833885475997,223.07875175476073,230.62200012207032,0.7019252441291183,0.03971373091201645,0.9951425448518074,0.9870400167965132,0.989765082854038,-0.01888733903574047,57.54314307410574,234.13497376786975,227.58800048828124,221.04102720869273,228.74321583339147,1.5614094851105225,229.30053656441825,1.3317819135398448,228.8048183851546,228.07883401770957,-0.4430167121238527,1.2113680127366353,3865900,1.7195622848398868,0.6749015161235978,123275800.0,-98.14596093186415,89.0859394939463,92.09290994229893,-43.29642579142278,20.796643774514273,16.076384458977728,0.10810130154302748,3.92828898495176,232.26332189941405,231.00334118652344,229.98500061035156,228.96666003417968,227.70667932128907,0.04,0.0,208.7910339909724,-0.015347745292760728,-0.01706209351689889,225.82388305664062,226.40220206124442,2.5604861439360693
2023-02-17,0,223.5625,222.5724983215332,231.54750061035156,226.20312690734863,229.86187744140625,-0.7784233476313802,2.698941857255606,-0.7076741902393646,2.995661956576752,229.1362476348877,2.2405503845214865,0.01184042437090633,223.16199760437013,230.62200012207032,0.7131649061025793,0.017567326114392157,0.9807824745481549,0.9764697220609386,0.980741594647384,-0.019709953377753497,47.50301522798783,233.3408841264985,227.9430004119873,222.5451166974761,227.73821585518974,2.27153656253367,228.88267953055245,2.0291230577020367,228.22616319076877,227.99831149793718,-1.4672299162676825,-1.479015460374425,4520200,1.6510854614701242,0.7939152251976138,118755600.0,-85.50961449682451,89.0859394939463,92.09290994229893,-143.40850197566252,19.25455418519143,22.009311299201762,0.07371816853217132,3.93983951016344,231.3358436279297,229.50208398437502,228.02000427246094,226.53792456054688,224.7041649169922,0.02,1.0,208.82011234351978,-0.016021008556673433,-0.025245149892110005,224.9498574393136,226.0426962716239,2.586358033453231
2023-02-21,0,220.8025016784668,223.13500213623047,231.54750061035156,226.20312690734863,229.86187744140625,-0.7203721596934992,2.607520172180913,-0.8178421204069064,2.995666689829905,229.1362476348877,2.1739999198913607,0.011436868171142684,223.52274971008302,230.62200012207032,0.6731892572542038,-0.004320075789527622,0.9684638801635811,0.9668502871015985,0.9724690461957336,-0.031419306315307205,35.86908586422947,233.20754084027246,227.99250049591063,222.7774601515488,226.30393001011439,3.0283816887451596,228.25660814557756,2.9464216009713726,227.05946043228187,227.48147060438598,-3.0507702173992413,-2.54999117878532,7276100,1.7356253772875552,1.2583433711759278,111479500.0,-95.59755603420717,89.0859394939463,92.09290994229893,-189.62250634031506,17.999923171299695,23.769315301587678,0.057468173620658286,3.9134218355358543,230.9228436279297,228.83358398437503,227.14500427246094,225.4564245605469,223.3671649169922,0.04,0.0,208.85918070458402,-0.03608879502297202,-0.028961168918963453,223.7171848842076,225.3974151611328,2.913589069327126
2023-02-22,0,220.40750122070312,220.8025016784668,231.54750061035156,226.20312690734863,229.86187744140625,-0.9419414372606268,2.9581417069921434,-0.2925258923083254,2.9956476135895387,229.1362476348877,2.432349967956543,0.012985354634112345,223.16199760437013,230.62200012207032,0.6176924372905248,-0.010453314968216469,0.9675228068365763,0.9686442833519836,0.9768926676365691,-0.038204319256916475,30.272547773527254,233.72228412351797,227.8060007095337,221.88971729554942,225.21107264927454,3.6138407215612833,227.5583940233503,3.551084189905534,225.4921513996154,226.71264927867028,-4.349286116164535,-3.818048874020615,4621800,1.8160582947810386,0.8038430298993152,106857700.0,-96.16156841791577,89.0859394939463,92.09290994229893,-186.51394570351027,17.2213565948477,23.756740789287626,0.03357840944616528,3.798177636679398,230.79540161132812,228.62730072021483,226.875,225.12269927978517,222.95459838867188,0.06,0.0,208.88262867124513,-0.04084741349449006,-0.03871036018377599,222.703369140625,224.66115352085657,3.2506868182939668
2023-02-23,0,220.92749786376953,220.40750122070312,231.54750061035156,226.20312690734863,229.86187744140625,-1.0554820230267472,3.2214876309334413,-0.09457722491144871,2.9956316564071765,229.1362476348877,2.6232750320434546,0.014149834970481391,222.92874755859376,230.62200012207032,0.6720584013050828,-0.012356309976698834,0.9703863535580053,0.9749776432875098,0.986856196270653,-0.03142332501183731,29.42882593405057,234.1126009256242,227.66962566375733,221.22665040189045,224.2057146344866,3.6979438124065704,226.79982239859444,3.7614682667979205,224.2239818363362,226.052622664766,-3.3544178260952036,-4.246629416458912,5533800,1.8166562485081594,0.9557777071559835,112391500.0,-83.76375120634492,89.0859394939463,92.09290994229893,-162.04462810166888,16.185510208440842,23.3175976640838,0.01275907523031939,3.7525937813473993,229.2821950073242,227.30389456176755,225.70499420166016,224.10609384155273,222.1277933959961,0.08,0.0,208.91133041792835,-0.034029348283858396,-0.03600849833591429,221.60906546456474,224.09767586844308,3.487491635701539
2023-02-24,0,218.93250274658203,220.40750122070312,231.54750061035156,226.20312690734863,229.86187744140625,-1.0633073173637093,3.4093543359760883,-0.21769910660626213,2.995619429980462,229.1362476348877,2.7798999786376952,0.014982369642255201,220.91499824523925,230.62200012207032,0.769213841418394,-0.019690296992202674,0.9620964439632682,0.9703143041678044,0.984247199564455,-0.03333590529481978,29.33527770435668,234.37645937385648,227.5577507019043,220.73904202995212,222.7442866734096,3.4238230684001048,226.05714389256067,4.22176847056386,223.4155342770008,225.53710417810322,-3.0870993271079294,-4.5865330951912915,4414400,1.7396119121866511,0.7801512444352545,107977100.0,-86.08523391070247,89.0859394939463,92.09290994229893,-168.1296114237403,15.053068203130211,24.488592945213483,0.056974089534079383,3.7466940947465806,228.93527832031248,226.7423599243164,224.97000122070312,223.19764251708983,221.00472412109374,0.1,0.0,208.93097265382792,-0.027808479285505894,-0.04093127643353522,220.21966116768974,223.38248988560267,3.8413802297470596
2023-02-27,0,220.4650001525879,218.93250274658203,231.54750061035156,225.75250148773193,229.86187744140625,-1.0188719788823282,3.8729306839288316,-0.48419549640537296,2.995586171998612,229.1362476348877,3.2301749038696244,0.01704363983083939,220.76300163269042,230.62200012207032,0.803226646566376,-0.04763301670539789,0.9702022485191752,0.9822914370397314,0.99791106749145,-0.013855185227451439,19.302072539313002,234.98198712316773,227.23612575531007,219.4902643874524,221.6542865208217,2.535865564626287,225.43964413234167,4.370505644518757,222.30877409391005,224.80993956452932,-4.464079330455684,-4.533859068353559,4255300,1.372602155963045,0.8025801462648705,112232400.0,-80.75897800579077,89.0859394939463,92.09290994229893,-118.94804817169877,16.792751882477866,23.47640633777092,0.005699836177190259,3.629073523931973,228.93527832031248,226.7423599243164,224.97000122070312,223.19764251708983,221.00472412109374,0.1,0.0,208.9522382358191,-0.01435868638307869,-0.024266032681291645,219.00957815987724,222.77240099225725,4.008635115051017
2023-02-28,0,220.3025016784668,218.93250274658203,231.54750061035156,222.90374946594238,229.63937664031982,-0.7593200153684486,4.089023255430616,-1.0376342349311312,2.99556893812029,228.6024990081787,3.577674980163576,0.01803196583867313,220.45925025939943,230.62200012207032,0.8640318899004377,-0.039001791014200246,0.9715002670049622,0.9848992066207735,0.9999795782524381,-0.002264467097062628,28.25507619570143,234.94329728905944,226.76525077819824,218.58720426733703,220.77142933436804,1.3930353545426069,224.75732258387976,4.3738217088130105,221.84777756926232,224.30064449703147,-3.345097887845643,-3.773295257289438,5385400,1.451341192503647,1.0185298136616594,106847000.0,-83.48869812566664,89.0859394939463,92.09290994229893,-101.42224373330345,16.68922010066135,22.398676485941756,-0.022234680610745752,3.531997148817402,228.93527832031248,226.7423599243164,224.97000122070312,223.19764251708983,221.00472412109374,0.1,0.0,208.97910095523494,-0.0030822566754005187,-0.01619257262605922,218.17791312081474,222.00089808872767,4.235668124126556
2023-03-01,0,218.63000106811523,218.93250274658203,231.54750061035156,220.89624881744385,229.63937664031982,-0.5297578724941314,4.272071085262493,-1.3927380346839433,2.9955534900397494,228.07625198364258,3.8768251228332504,0.01887709684424967,220.3970012664795,230.62200012207032,0.8754323131661407,-0.0403584973767668,0.96606531606148,0.9807818278784656,0.9928385579974232,-0.008064608249462424,27.70036954903066,234.8538931089405,226.30975093841553,217.76560876789057,220.06678662981307,0.9095122470691585,223.9025012425014,4.3136673452830685,221.46108739578648,223.91469190063955,-2.7286877577951363,-4.155881550958915,4792700,1.4458556451917381,0.9658125686418733,102054300.0,-87.97503073148052,89.0859394939463,92.09290994229893,-116.46630703077867,15.401197921705856,26.84014421051606,-0.08009750020903912,3.5539981808095664,228.6921950073242,226.34889456176757,224.45499420166016,222.56109384155272,220.2177933959961,0.12000000000000001,0.0,208.9986306340399,-0.007544786292917771,-0.010243983063822343,217.44366891043526,221.19676317487443,4.480782784559229
2023-03-02,0,218.4099998474121,218.63000106811523,231.54750061035156,220.71812629699707,229.4612522125244,-0.349128262609565,4.513291503997032,-1.5617020760038132,2.9955319634853206,228.0112533569336,4.20730010986328,0.01999129168264221,220.1655017852783,230.62200012207032,0.8563223688243781,-0.050188428387807744,0.9674309779212364,0.9844463200501224,0.9934432976354949,-0.011395132071381098,23.543525489573568,234.78945894640958,225.76287593841553,216.73629293042148,219.72500065394811,1.0286898951134134,223.01446533203125,4.046497835025436,220.75280035793045,223.40130000975302,-2.206317665925531,-5.189778201071499,5539300,1.444266210980389,1.119122852386417,96515000.0,-82.45494383566523,89.0859394939463,92.09290994229893,-99.22209487915627,14.607611778513887,25.457137081134235,-0.06455720687927936,3.479427579718659,227.8823568725586,225.69381607055664,223.92499542236328,222.15617477416993,219.96763397216796,0.12000000000000001,0.0,209.02165396947794,-0.009361092699720186,-0.0043633293692006215,217.22339085170202,220.4702878679548,4.553179220844946
2023-03-03,0,221.9724998474121,218.4099998474121,231.54750061035156,220.4506254196167,229.2043743133545,-0.1742848829957207,4.663679538044977,-1.653644747706206,2.9955175131943577,227.22375297546387,4.412825260162353,0.020711424675161395,218.90225257873536,230.62200012207032,0.8491775269562462,-0.05673782151959937,0.9857810068301079,1.0048903889539262,1.011964999615379,0.013885544917690673,21.118804711896185,234.50161006028185,225.1742509841919,215.84689190810195,219.9485718863351,1.3282052007121812,222.57982226780481,3.781254806744903,220.1726683390551,222.88340059647328,-1.0835483352170778,-5.385707834076085,6055400,1.3718541887379614,1.2375765131464658,102570400.0,-51.03396326287536,89.0859394939463,92.09290994229893,-34.34469601081071,21.970175588222645,22.941474249031096,0.03304827358291506,3.585183232166127,227.8823568725586,225.69381607055664,223.92499542236328,222.15617477416993,219.96763397216796,0.12000000000000001,0.0,209.05711988536024,0.019221085908064373,0.01193867966614032,217.75289045061385,220.22812979561942,4.458945926611375
2023-03-06,0,225.4474983215332,218.4099998474121,230.84250259399414,220.4506254196167,229.123122215271,-0.038286267186760724,4.472398708945793,-1.6864391349609409,2.9955341161567444,225.0225009918213,4.254250335693359,0.019904264616405154,218.90225257873536,229.92925300598145,0.8981256911902505,-0.03208259680328605,1.0033467397981808,1.0227101220725272,1.0249663468592896,0.022599950856130535,40.90658668162275,233.64029836393652,224.69550094604492,215.7507035281533,220.5942862374442,2.4814659994654646,222.4000004359654,3.5587727401854594,220.62199409765964,222.81514841920742,0.7100478060144998,-2.6681879902594523,5737600,1.6184234378171976,1.1667361442965645,108308000.0,-31.154079103406506,89.0859394939463,92.09290994229893,22.121161885772683,27.096599334279823,21.241512813398852,0.04112089540008344,3.595526981836375,227.8823568725586,225.69381607055664,223.92499542236328,222.15617477416993,219.96763397216796,0.02,1.0,209.0989451844279,0.029044714631203616,0.03279432144967376,218.5464346749442,220.07775006975447,4.338126467768509
2023-03-07,0,225.09500122070312,218.4099998474121,230.84250259399414,220.4506254196167,228.34875011444092,0.03213492459396227,4.349598913463818,-1.6023161468537583,2.9955446107373436,224.5049991607666,4.060125160217285,0.019374486675346386,218.90225257873536,229.92925300598145,0.8853303697895807,-0.015985764590567893,1.0026441951551377,1.0202386612378547,1.0187483783403875,0.02175417666945534,53.01166780084403,233.20057359749651,224.50137577056884,215.80217794364117,221.47464316231864,2.8581973871313164,222.10946491786413,3.1007830463078525,221.82917621077792,223.29592280083753,2.0459202686262437,-1.1043386493276117,4386800,1.8344210094960929,0.883212163797321,103921200.0,-46.67723352680425,89.0859394939463,92.09290994229893,3.227108860479907,24.81385583796615,20.64712787984963,-0.010547404173627704,3.645846701119877,226.0869638671875,224.24152172851564,222.75,221.25847827148436,219.4130361328125,0.02,0.0,209.12812058303138,0.014685774610122326,0.012797848183644791,219.05757795061385,219.63861955915178,4.2254494905400275
2023-03-08,0,222.06499862670898,218.4099998474121,230.84250259399414,220.4506254196167,228.0668773651123,0.11298358670591316,4.223074757264878,-1.4901132926074538,2.9955551414938357,224.32875061035156,3.8593753814697265,0.018827743964561494,218.90225257873536,229.92925300598145,0.8658568908393515,-0.020708716654902797,0.9900328973437916,1.0045508132587908,1.0006939654439457,0.015711464766098304,51.31822445681029,232.746775506351,224.30062599182128,215.85447647729154,221.70321437290735,2.8278136667129905,221.67875044686454,2.580567089503331,222.64976030225316,223.5900908774649,2.814793782015221,-1.7749401758583567,4194900,1.8212144001545858,0.8432832745500288,99726300.0,-51.71830733713204,89.0859394939463,92.09290994229893,-33.699265305949034,23.813983468848956,23.66241520059094,-0.02891103461421518,3.527572329115614,225.54451873779297,223.80273757934572,222.3949966430664,220.9872557067871,219.24547454833984,0.02,0.0,209.1515110437686,0.017539974914512202,0.010230101117585868,219.31738935198103,219.16348375592912,3.9613949328076212
2023-03-09,0,221.3599967956543,218.4099998474121,230.84250259399414,220.4506254196167,227.98812866210938,0.28021815469203953,4.048456009552759,-1.3325610968618882,2.995569080114547,222.8137493133545,3.654487857818603,0.01808063800267303,218.90225257873536,229.3059986114502,0.8155009916227917,-0.03700170741811658,0.9886065109491539,1.000611354101389,0.9944383921711974,0.013506693605160658,42.0808224296239,232.00803777441558,223.91112575531005,215.81421373620452,221.85428510393416,2.768128925659895,221.31285721915108,2.178964638580771,222.50841254101016,223.38786004382533,0.7257380867773594,-2.643636450480365,5066700,1.9058078786371493,1.0176364611389286,94659600.0,-67.42493137713652,89.0859394939463,92.09290994229893,-42.470646195312796,21.59592657424396,24.46428163342466,-0.03343718588367342,3.612030838117858,224.8263568725586,223.22181607055663,221.92499542236328,220.62817477416993,219.02363397216797,0.02,0.0,209.17801325003694,0.004336784762267509,0.007556329758852828,219.3272705078125,218.7525918143136,3.8021909199752804
2023-03-10,0,217.44249725341797,218.4099998474121,230.84250259399414,220.4506254196167,226.85312747955322,0.42094855486181837,3.7771285956621607,-1.163944086358352,2.995589731783395,222.01874923706055,3.3666755104064947,0.01690374250741007,218.90225257873536,228.2017509460449,0.7681596117320092,-0.041077815791217956,0.9731180420918761,0.9827109985331273,0.9742571207426245,-0.020407945115309967,40.150210265980036,231.0035077940465,223.44925060272217,215.89499341139785,221.68464170183455,3.023288463512437,220.8757141658238,2.3032753699280346,222.228202463315,223.10144129445686,0.4800195681531217,-2.2617664248332296,6638900,1.8993934804773127,1.3149161750593938,88020700.0,-94.47233226837038,89.0859394939463,92.09290994229893,-123.64365726563882,19.69582243718708,30.430471335512824,-0.029814413732662245,3.6775999767770484,224.60215759277344,222.85891723632812,221.4499969482422,220.04107666015622,218.2978363037109,0.02,1.0,209.19997712203863,-0.034097442750435025,-0.013329527776162635,219.01380920410156,218.22873905726843,3.8602077410327653
2023-03-13,0,214.8625030517578,217.44249725341797,229.1624984741211,220.38125133514404,225.70624923706055,0.3857328706425547,3.590103843901544,-1.1800623112121549,2.995602684656419,221.6662483215332,3.1633505249023415,0.016115072828783744,218.6080009460449,228.06125259399414,0.7338586347734282,-0.04654530267727906,0.9644637134203197,0.9717052969481473,0.9666212493868317,-0.046951043363005374,33.37385836917389,229.95945802349644,222.77925033569335,215.59904264789026,221.1778564453125,3.8484221055341656,220.4514285496303,2.8093127881664586,221.03889485155446,222.2809361013589,-0.5431568443926839,-2.7374907449066956,6810800,1.9859887855026839,1.3189077395879527,81209900.0,-86.79623684670744,89.0859394939463,92.09290994229893,-151.94812860529115,17.713596375693605,32.97372570972068,-0.027084505089560854,3.797057557264373,223.89887860107422,221.7205588684082,219.95999908447266,218.1994393005371,216.0211195678711,0.04,0.0,209.21664895566062,-0.05415661133904626,-0.041560565910559955,218.36570303780692,217.79454694475447,4.1208052087031515
2023-03-14,0,218.14249801635742,214.8625030517578,229.1624984741211,219.9600019454956,225.18312549591064,0.26307031495865923,3.767535337573233,-0.71788713576928,2.995588621339812,221.1437473297119,3.097350273132321,0.016961749561026702,218.3132495880127,227.97800369262694,0.6929211435754394,-0.05747593133816127,0.9820952130348258,0.989044861030142,0.9908137016378721,-0.0308869729076251,29.182384937262338,229.65457102609858,222.11950035095214,214.5844296758057,220.6307133265904,3.9864039710696413,220.28964260646276,2.8764545933704215,219.50385435462817,221.16650192432613,-1.6242373509146497,-2.690186289355918,7985600,2.032390044057927,1.5022061112715308,89195500.0,-58.71310711732618,89.0859394939463,92.09290994229893,-78.24557351987023,19.65556507319791,29.722223645986176,-0.02035377688164389,3.9115530100711413,223.89887860107422,221.7205588684082,219.95999908447266,218.1994393005371,216.0211195678711,0.04,0.0,209.24710384626894,-0.020208764454633266,-0.03567800220889274,217.64417375837053,217.6985321044922,3.8682221843344142
2023-03-15,0,215.3400001525879,214.8625030517578,229.1624984741211,218.85687732696533,223.94562530517578,0.4304946842027195,3.610463988743484,-0.44116193345325616,2.995599876653319,220.86499977111816,2.8855499267578124,0.016290621577103884,218.07249794006347,226.64375190734864,0.6821056113438698,-0.04808814937496477,0.9716264900678779,0.9772956030283249,0.9843011931654096,-0.030283919193523245,38.843727839769336,228.84930303089274,221.62837505340576,214.40744707591878,219.18678501674108,3.7758933860639567,219.89053562709265,3.1552639182381568,219.1650722185506,220.52507664260753,-1.7254397881212762,-1.0276434294664327,8372200,2.181861881135031,1.5241427584468024,80823300.0,-74.0616917417419,89.0859394939463,92.09290994229893,-131.12776593091726,17.89909953164776,31.310424637351225,0.029141733686641993,3.9885853302953977,223.89887860107422,221.7205588684082,219.95999908447266,218.1994393005371,216.0211195678711,0.04,0.0,209.26980606827144,-0.026193873125537337,-0.0304700365004023,216.17851911272322,217.3624768938337,3.5785704457881877
2023-03-16,0,214.73999786376953,214.8625030517578,228.09500122070312,218.57500076293945,222.43937397003174,0.27563805487904014,3.420062678245061,-0.4518947885768161,2.995612619842667,220.63375091552734,2.658199691772461,0.015479792004830491,217.23224754333495,225.55099868774414,0.6022029541321222,-0.05591968697189284,0.9719501701514457,0.9760299005582882,0.9876304677981245,-0.029906031025090485,34.527813733903265,227.77737549381925,220.9372501373291,214.09712478083895,217.70749882289343,3.0302120097843384,219.59107099260603,3.4393501222841287,218.20540394390628,219.55834933438882,-4.483304647066875,-2.5291092169192346,13674600,2.235989292310458,2.295774978930297,67148700.0,-53.42979241182033,89.0859394939463,92.09290994229893,-146.010361391597,15.297055976986545,34.85149051903906,0.10617299485043852,4.3336869013038015,223.01623730468748,220.2918767700195,218.08999633789062,215.8881159057617,213.1637553710937,0.06,0.0,209.3004772380975,-0.01163584015030783,-0.021333225314305624,215.370853969029,217.21421595982142,3.1343353821559643
2023-03-17,0,216.4474983215332,214.73999786376953,226.48250198364258,218.34312438964844,221.99562454223633,0.06775871754444128,3.257232751124085,-0.6119998876925363,2.995622965656439,220.4362506866455,2.5655999755859398,0.014787488742542038,215.2922504425049,225.13025093078613,0.5982573698624183,-0.05184729070469707,0.9826485207962122,0.9854345634235536,1.0015825559974836,-0.0045759175159083565,34.19685007966411,226.7839654717306,220.2694999694824,213.75503446723422,216.90499877929688,2.3517674711025762,219.30410657610213,3.5273011836292874,217.32669440537933,218.73589837946096,-4.600281348220891,-1.9149759995505982,18801200,2.2249614824763446,2.8048159195964306,85949900.0,-53.7513226734439,89.0859394939463,92.09290994229893,-75.62801350136247,16.12901881636675,32.6547172603232,0.16600417845139068,4.294852732989354,223.01623730468748,220.2918767700195,218.08999633789062,215.8881159057617,213.1637553710937,0.06,0.0,209.36074188512507,0.005783238928071199,-0.011908516780173427,214.6930912562779,217.00524030412947,2.9265506756498745
2023-03-20,0,218.1349983215332,214.73999786376953,225.4474983215332,217.96749782562256,221.51312255859375,0.053045080425160235,3.0262397587100436,-0.6866976902113184,2.995637480898178,220.35500144958496,2.4962249755859376,0.013770172200660333,215.2922504425049,223.71575012207032,0.6693397523903276,-0.03182555964648274,0.9925705592998479,0.9956217443159189,1.0103215921970246,0.015230648546373349,40.73976770805856,225.82022930379705,219.76774978637695,213.71527026895686,216.4442847115653,1.4924784091978633,219.14928490774972,3.527676748720467,217.09394979049785,218.2937397990303,-2.529664890872241,-1.8222855456757765,9817400,2.212887636998642,1.4089174223185987,95767300.0,-49.678469738376194,89.0859394939463,92.09290994229893,-29.3326385062357,18.2982237737786,30.620069483119977,0.13246732565826788,4.25307801733632,223.01623730468748,220.2918767700195,218.08999633789062,215.8881159057617,213.1637553710937,0.06,0.0,209.39812564491407,0.017158666340830298,0.009299508765032759,214.43046133858817,216.87886592320032,2.8257469273712488
2023-03-21,0,221.1199951171875,214.73999786376953,225.4474983215332,217.9618730545044,221.03562259674072,0.22035068842746483,2.9150934889177886,-0.4218766398070892,2.9956441627416512,219.6175022125244,2.3881250381469727,0.01328082749826484,215.2922504425049,222.3679988861084,0.7220025900833706,-0.01208094716616037,1.0073970261100433,1.0126257478047362,1.0210517896244884,0.013649321557722471,46.98248224693827,225.3265616802892,219.4963747024536,213.66618772461803,216.96964154924666,2.320157741827472,219.3271416255406,3.5620836924864077,217.35019015966043,218.3060104572025,-1.4569021145668928,-0.9838759616525289,8971400,2.1831954528060105,1.2720319985934685,104738700.0,-29.314041517635875,89.0859394939463,92.09290994229893,41.51616603187917,20.246569956249612,28.381955678666312,0.20093303775257962,4.260715345409079,223.01623730468748,220.2918767700195,218.08999633789062,215.8881159057617,213.1637553710937,0.06,0.0,209.44144241640285,0.015046173477906821,0.03487677303975431,215.2508326939174,217.13232094900948,2.8635916272792064
2023-03-22,0,221.83999633789062,214.73999786376953,225.4474983215332,217.9618730545044,221.1799955368042,0.2063787339817125,2.92301673320653,-0.4516105423544765,2.99564369070329,219.6175022125244,2.4039997100830077,0.01331596182690093,215.2922504425049,222.3679988861084,0.6983989103985621,0.00323262090690337,1.0106041779906818,1.0177757398080585,1.0215673876981197,0.03018480626310449,54.43164062374091,225.3582828408027,219.51224937438965,213.6662159079766,217.9664263044085,2.7271491789222124,219.57214137486048,3.6117613911248796,218.2943616796287,218.84116485901177,1.6912507491502906,1.1389077605577544,6700600,2.2902823479950554,0.9362629685262165,111439300.0,-39.54985763372692,89.0859394939463,92.09290994229893,54.471775277754816,22.53535114196429,26.04066583068862,0.1697427377343758,4.3120925155627585,223.01623730468748,220.2918767700195,218.08999633789062,215.8881159057617,213.1637553710937,0.02,1.0,209.4751734274699,0.016961755994957084,0.0063112001828315575,216.03732081821985,217.2015119280134,2.863694272028545
2023-03-23,0,222.1349983215332,214.73999786376953,225.4474983215332,217.9618730545044,221.47999668121338,0.14879072120186718,2.9613752244255496,-0.5803392438697665,2.9956413875183285,219.6175022125244,2.4756244659423827,0.013486305568454319,215.2922504425049,222.3679988861084,0.6954511538893913,0.004130307376602652,1.0116179942693375,1.0192343880485446,1.0168385979653922,0.03443699604791384,55.72498129016193,225.50662457910013,219.58387413024903,213.66112368139792,218.53678349086218,3.154174377915895,219.58374840872628,3.620319719312202,219.17273317705894,219.3029072438627,3.2474225083620185,1.5704393081245436,6427700,2.292933895251553,0.8925569798838983,117867000.0,-25.88424910581532,89.0859394939463,92.09290994229893,78.0624845356847,21.190280570202365,23.82623424309073,0.1506608851049001,4.376229244014856,223.01623730468748,220.2918767700195,218.08999633789062,215.8881159057617,213.1637553710937,0.04,0.0,209.51021738315484,0.023637734357356832,0.028747111240174157,216.5922372000558,217.11820547921317,2.9176728008542776
2023-03-24,0,220.3224983215332,214.73999786376953,225.4474983215332,217.9618730545044,221.873122215271,0.10895817251597548,3.0002072547669965,-0.6902724530785229,2.9956390236380748,219.6175022125244,2.5359994888305666,0.013659393616425783,215.2922504425049,222.4309986114502,0.714609905893922,0.014627775843124184,1.0030879441233316,1.0105586404213458,1.0017596115332763,0.017902724818023463,57.82149924539836,225.64466366267118,219.6442491531372,213.6438346436032,219.24856894356864,2.8611122565540867,219.21767698015486,3.2186161100796014,219.89598000771286,219.7910533286162,1.8302258117885877,0.07320657929824556,4791500,2.241996611578908,0.6636150852457654,113075500.0,-34.04945254412708,89.0859394939463,92.09290994229893,11.280365784392188,19.688332613178027,25.4200955023391,0.16180511633325498,4.373641179291631,222.98568243408204,220.26716091918945,218.06999969482422,215.87283847045896,213.15431695556637,0.04,0.0,209.531304716992,0.016790065277378696,0.016509546315296154,217.25163922991072,216.71507917131697,2.929196794788962
2023-03-27,0,222.46749877929688,214.73999786376953,225.4474983215332,217.9618730545044,221.873122215271,0.04079992832238435,2.9990140549303597,-0.6936268232674325,2.9956391278237615,220.3125,2.5273746490478515,0.013649642179926156,215.2922504425049,222.4309986114502,0.7278328631716674,-0.000646369405375272,1.0125333524224096,1.0190510237922126,1.0079606612145005,0.019861555876409698,51.561525687107675,225.71177704174548,219.71374893188477,213.71572082202405,220.35249764578683,2.2590361556902496,219.02999823434013,2.9114976422089254,219.99679328953047,220.02602098206077,2.3137820030717755,-2.273256540061813,7210900,2.259247135946181,0.978667441178706,120286400.0,-20.861135812430735,89.0859394939463,92.09290994229893,64.72860964798652,23.28026652384307,24.129932991926584,0.12600655537379757,4.278381705405797,221.35835870361328,218.95081790161132,217.00499725341797,215.0591766052246,212.65163580322263,0.04,0.0,209.569450542175,0.016777428022457075,0.020332134108898822,217.86727251325334,216.6190632411412,2.9585477045132937
2023-03-28,0,221.28250122070312,214.73999786376953,225.4474983215332,217.9618730545044,221.99562454223633,-0.023897320022886383,3.0553229438261713,-0.8295082833723395,2.9956356567978117,220.3125,2.6174870872497564,0.013899591004557585,215.2922504425049,222.7302490234375,0.7085271905387426,0.009827383186006249,1.0066812314057882,1.010104137445465,0.9986709082699315,0.000734922698553353,56.85998917130352,225.92451975087255,219.8138738632202,213.70322797556787,221.04321234566825,1.4660460126250707,218.97410556248255,2.8557290220887235,220.61639358091094,220.40756240679178,3.5985382287419267,-1.1672860024243779,6418400,2.30912092409295,0.865044954465998,113868000.0,-29.836243359560378,89.0859394939463,92.09290994229893,21.99720256624729,21.47340594457512,26.8011605630945,0.13515238290009193,4.307069293203899,221.35835870361328,218.95081790161132,217.00499725341797,215.0591766052246,212.65163580322263,0.04,0.0,209.5988641365995,-0.0072989603726901775,0.009993113639247667,218.28240094866072,216.48774610246932,2.959630302834844
2023-03-29,0,222.51499938964844,214.73999786376953,225.4474983215332,217.9618730545044,221.99562454223633,-0.06615115006635007,3.070586711359801,-0.8670662287885578,2.9956347133376258,220.72124671936035,2.6615870666503896,0.013965917290746005,215.2922504425049,222.7302490234375,0.72504191382993,0.012132370395778809,1.0120626347822708,1.0142764076455677,1.0040860197743915,0.0030427473084235768,54.579377173088545,226.00404726305163,219.86287384033204,213.72170041761245,221.66892678397042,0.8024508137943738,219.05660574776786,2.9452388098228,220.788547995751,220.52466985267645,2.2337993909208946,-0.35237313887599037,4483000,2.2917713524998,0.6054634874994007,118351000.0,-11.82532625019777,89.0859394939463,92.09290994229893,62.2843912130956,20.677210084170163,25.343687204375442,0.15978426414031513,4.229421573737955,221.35835870361328,218.95081790161132,217.00499725341797,215.0591766052246,212.65163580322263,0.04,0.0,209.62264907738188,0.014815489904132617,0.006082501755062729,219.00958251953125,216.7200219290597,3.020917320825006
2023-03-30,0,222.93250274658203,214.73999786376953,225.4474983215332,217.9618730545044,222.08249855041504,-0.21724891489010809,3.109093027705471,-0.914691329547971,2.9956323562150233,221.2012481689453,2.6936997222900403,0.014128572502597409,215.2922504425049,222.77299957275392,0.7145096732989716,0.0187949248894474,1.0130665117360902,1.0128668702264938,1.0053575333065308,0.0035901790851275983,57.65750075084567,226.27530981181962,220.05712375640869,213.83893770099775,221.9278564453125,0.8840767409364361,219.44874899727958,3.076361163771254,221.24233358332185,220.75406854564065,2.0079313736070303,0.5217756643990047,5383900,2.3027004862515583,0.7279007905792962,123734900.0,-17.525763656334032,89.0859394939463,92.09290994229893,57.60202401872548,20.786640381062295,24.019983368537886,0.12985021769610566,4.143748516990524,221.35835870361328,218.95081790161132,217.00499725341797,215.0591766052246,212.65163580322263,0.04,0.0,209.65112822616393,-0.0010333298285610804,0.010543484163410216,219.06747436523438,217.1591535295759,3.0430501150435743
2023-03-31,0,224.54750061035156,214.73999786376953,225.4474983215332,217.9618730545044,222.21812343597412,-0.38049640698530485,3.1453245034529225,-0.899585436484406,2.995630143194927,221.3212490081787,2.687274932861328,0.014278546004472885,215.2922504425049,223.14875259399415,0.7498549183597393,0.004324873125408982,1.0193580389351062,1.016421130044535,1.0119128114757199,0.019176445079396753,56.54769725336402,226.57389790827304,220.2832489013672,213.99259989446134,222.31464276994978,1.3226955198665398,220.14053453717912,3.0545759998285313,221.69335488026667,221.00636854137045,0.8196941341437495,2.524807966478487,9509000,2.1651237251632787,1.2562829007993628,133243900.0,-2.2247633681898757,89.0859394939463,92.09290994229893,107.79286831372141,22.31521250789228,22.562419361867857,0.13583537688683303,4.096337603457434,221.80911590576173,219.31543563842774,217.29999542236328,215.28455520629882,212.79087493896483,0.06,0.0,209.70984736183055,0.019996393359087428,0.012893562103407055,219.83277457101005,217.93504769461495,3.1600413669313827
2023-04-03,0,226.87749862670898,214.73999786376953,225.4474983215332,217.9618730545044,222.47937393188477,-0.35473475934059595,3.2623616221445544,-0.9961495326342038,2.995622536055736,221.3212490081787,2.786350021362307,0.014801197928611034,215.2922504425049,224.6022506713867,0.7131749670194613,-0.003992050113140151,1.0293337010612071,1.0232163240847698,1.0185343057307166,0.019823119653928023,58.52060109486677,226.93672218380325,220.41199893951415,213.88727569522504,222.9921428135463,2.1630024621595814,220.76446315220423,3.4778437990257673,222.41192064215727,221.33863562959758,1.220476161718405,4.50753268766526,6421500,2.0468966505019304,0.8445619365148257,139665400.0,-0.7843313250081819,89.0859394939463,92.09290994229893,164.75170447642563,26.081258862713668,20.611654056759015,0.15059535072536526,4.163742670706006,224.3456015014648,221.3672001647949,218.95999908447263,216.55279800415036,213.57439666748044,0.08,0.0,209.75590952234833,0.03241508333501497,0.03601158315612077,220.73786272321428,218.66504996163505,3.418119366954391
2023-04-04,0,228.38500213623047,214.73999786376953,226.87749862670898,217.9618730545044,222.47937393188477,-0.197074794840015,3.3852935929398726,-0.8372757633351298,2.9956142726746946,221.3212490081787,2.843550033569335,0.015353954418304503,215.2922504425049,224.6022506713867,0.6791019751513004,0.0079188671287202,1.0358371634109378,1.0259698981888443,1.0212582406124504,0.03209698406492367,64.20560258995046,227.25408614065273,220.48349895477295,213.71291176889318,224.14392907278878,2.6057988781278913,221.6962490081787,3.655689292141591,223.52543456964463,221.88028726683493,2.134963126481837,4.004263584483463,5254700,2.112444005026936,0.6871812777855153,144920100.0,-11.225920293106359,89.0859394939463,92.09290994229893,169.54635939515381,26.168763155661235,19.454354898883633,0.16057817399741967,4.096332567133338,225.02556103515624,221.91721978759765,219.40499877929688,216.89277777099608,213.78443652343748,0.1,0.0,209.79502360436322,0.033268259720648174,0.026373912420108288,221.672607421875,219.46212332589286,3.7225941672783853
2023-04-05,0,227.49250030517578,214.73999786376953,228.38500213623047,217.9618730545044,222.47937393188477,0.110065255393355,3.6730835022137103,-0.5247403430646398,2.9955937844149623,221.3212490081787,2.975150070190432,0.01664680177863098,215.2922504425049,224.7805004119873,0.7407376557679599,0.02846015152592959,1.0310200017023923,1.0186360602903244,1.0108464044703471,0.022369282651418798,70.0496428907068,227.99416600497673,220.6479990005493,213.30183199612188,224.86178643362862,2.7548866641951846,222.60714203970772,3.3663923638293745,224.7315935427319,222.48443705674444,3.659410126573205,6.057862902572217,4813600,1.9992448201763529,0.6269602275687447,140106500.0,-12.384742425141003,89.0859394939463,92.09290994229893,141.27959456937387,25.258089543617896,19.284841498088007,0.17726761394677576,3.9408801101176927,226.46752117919922,224.25124002075196,222.45999908447266,220.66875814819335,218.4524769897461,0.1,0.0,209.82983537665558,0.02180915980978715,0.03558299506125319,222.57063947405135,220.21895599365234,4.055600202603068
2023-04-06,0,225.88999938964844,214.73999786376953,228.38500213623047,217.9618730545044,222.61937522888184,0.13837804575737622,3.9572545390061746,-0.7823022835747646,2.9955719553964095,221.3212490081787,3.192250137329103,0.01791266409026238,215.2922504425049,226.93899879455566,0.8056424313478845,0.02770375676858465,1.0224997256387083,1.0089070442090318,0.9993054475629111,0.01326633221548823,67.0571981983915,228.833883162485,220.91937408447265,213.0048650064603,225.52000045776367,2.263832389696913,223.28160640171595,2.9585739717325925,225.41023856907606,223.00122689476635,2.258757595357358,5.938578079662832,4285200,2.004797347523499,0.5609924848843474,135821300.0,-30.734258100957305,89.0859394939463,92.09290994229893,90.26510068917577,23.64718785498852,21.472225815627166,0.21421009427630208,3.9086747803348647,226.93244146728517,225.00378048706057,223.44499969482422,221.8862189025879,219.9575579223633,0.1,0.0,209.85738311549028,0.016324809663070816,0.012046450232698468,223.36982945033483,220.82611519949776,4.184925525201313
2023-04-10,0,225.6974983215332,214.73999786376953,228.38500213623047,217.9618730545044,223.3362522125244,0.04721356422155765,4.102951322557121,-1.0019443744097127,2.9955601945311585,221.56124877929688,3.3760381507873545,0.01855314433125508,215.2922504425049,226.93899879455566,0.8488385899556855,0.03884936129290928,1.0205819987532427,1.0063594783904533,0.9958480051218002,0.00512140063040456,64.40627447929955,229.35177685928656,221.14587421417235,212.93997156905814,225.97464316231864,1.839574075815638,223.82178497314453,2.6173230289389258,225.51192811250849,223.22129443022098,2.0821791797941933,4.362490276551212,4952200,1.8036481259139532,0.6555497751602736,130869100.0,-30.67804609963469,89.0859394939463,92.09290994229893,81.21244609477536,22.682963015458178,21.276252951615895,0.275867921400015,3.7837686105465744,227.26520233154298,225.54240188598632,224.1500015258789,222.7576011657715,221.03480072021483,0.1,0.0,209.88898783774155,0.00430228245149844,0.018303559743693378,223.81178065708704,221.41068158830916,4.135484682385007
2023-04-11,0,227.6974983215332,214.73999786376953,228.38500213623047,218.14062309265137,224.83500003814697,-0.15136066625987157,4.124798298553502,-1.0018898401943663,2.995558790882547,221.9874973297119,3.3635128021240233,0.018617186815404443,215.2922504425049,226.93899879455566,0.8223303293899815,0.05042757631453902,1.0277076736428057,1.0128498030747672,1.0036540928624553,0.003614283918800698,66.32892379374866,229.80822086468513,221.55862426757812,213.30902767047112,226.6553568158831,1.3400379799348379,224.29160663059778,2.6845164292710058,225.54303118421655,223.49863712420864,1.4302401818368464,3.466889796772913,4513300,1.6665040654017564,0.6066756772560135,135382400.0,-13.55937025183461,89.0859394939463,92.09290994229893,114.40594690741297,26.506409102337525,20.076302015132118,0.30828730200707555,3.7234995984644352,227.26520233154298,225.54240188598632,224.1500015258789,222.7576011657715,221.03480072021483,0.1,0.0,209.92163977560514,-0.0024017020224357255,0.013261810306949146,224.67168753487724,221.8695809500558,3.9903185052021004
2023-04-12,0,229.16499710083008,214.73999786376953,228.38500213623047,219.77749824523926,225.745623588562,-0.23799150098960975,4.030447246954136,-0.9211347613090486,2.995567509998765,222.30124855041504,3.2498758316040037,0.018138795960760262,216.33674850463868,227.51300010681152,0.8478367880325401,0.04380164521843561,1.031343885446338,1.017011570682789,1.0093929169122144,0.00341526351250665,69.04609791127412,230.26126852497518,222.2003740310669,214.13947953715862,227.31499917166573,1.2638269290689677,224.81482097080774,2.876872850511881,226.0764022709994,224.06354997346213,2.1374162655715434,2.9746306754664174,4373000,1.5791861600802042,0.6024440796747105,139755400.0,-28.335830712039044,89.0859394939463,92.09290994229893,119.27914024996419,29.014361452960085,18.452374516099923,0.27237395822882193,3.761820663348522,228.44175720214847,226.49411773681643,224.9199981689453,223.34587860107422,221.3982391357422,0.12000000000000001,0.0,209.95487969054852,0.0006588526578696907,-0.005196496856100064,225.00350734165735,222.4181409563337,4.034435646103423
2023-04-13,0,230.94750213623047,214.73999786376953,229.16499710083008,220.92062091827393,226.13687419891357,-0.3337388833169925,4.188406276015773,-0.807753995164628,2.995555103496684,222.49124908447266,3.3921506690979015,0.018803044177459635,216.33674850463868,227.76624870300293,0.7968523123993125,0.06420078451957799,1.0367943793342604,1.021349294392011,1.0165457471227575,0.01518732189597416,75.41556753370699,231.12831153732213,222.75149898529054,214.37468643325894,227.8964282444545,1.8357924598468935,225.4442855290004,3.1922301849603425,226.837342638223,224.62749344092316,2.0563562176944803,3.3019297168498607,7615500,1.3846520635738129,1.0546425460432383,147370900.0,-1.0280598638319383,89.0859394939463,92.09290994229893,146.83637133206844,28.62606590957985,16.731456474336326,0.28397005998732155,3.852404814488583,229.39675720214845,227.2666177368164,225.5449981689453,223.82337860107424,221.6932391357422,0.14,0.0,210.02018893310796,0.0198097630536207,0.02209434856858903,225.5245361328125,223.1311994280134,4.244153576909613
2023-04-14,0,233.5600051879883,214.73999786376953,230.94750213623047,221.24187469482422,227.03124904632568,-0.2475018341388777,4.188790932082676,-0.5907569004971296,2.995556399821458,222.72375106811523,3.4913130187988286,0.01873912143061858,217.96624832153321,228.46300163269044,0.7412604983679457,0.07547501366160456,1.04486219759302,1.0290653011859536,1.0249276751862977,0.03395460542327733,79.03666926054,231.909455948638,223.53187408447266,215.15429222030733,228.63571439470564,2.8352658604827337,226.3898217337472,3.503734223114657,227.8711866629757,225.43444483659243,1.7939211839681073,3.9671838662458097,9781300,1.3665045245423715,1.3921051938690043,157152200.0,-5.936355766725591,89.0859394939463,92.09290994229893,169.39202923806081,31.205584694491822,15.860542113205787,0.21789747614519167,3.7736616134529655,231.1337627563477,228.74812106323245,226.81999969482425,224.89187832641605,222.5062366333008,0.16,0.0,210.11246094297314,0.035532594759962066,0.025638766853650668,226.42256818498885,224.04758780343192,4.51971193317429
2023-04-17,0,233.12250137329102,216.4474983215332,233.5600051879883,221.70062255859375,227.54374980926514,0.2001638590908372,4.221824733565521,-0.49299223224304356,2.9955556041687386,223.7400016784668,3.5531257629394544,0.018807727855300622,220.1037483215332,229.3432476043701,0.7191999396948209,0.07906077454882127,1.0385330608153625,1.022350526496511,1.0161673186460878,0.03289802991604285,81.86450021029104,232.91652391781463,224.4728744506836,216.02922498355258,229.44000026157923,3.2282240640132938,227.15089334760393,3.735743498553305,229.30049937837381,226.57635599096338,2.265911948399737,6.008241086271914,4865000,1.4105221651338344,0.768628578605899,152287200.0,-9.241179277570971,89.0859394939463,92.09290994229893,137.56617392055517,29.345246390678774,17.406981034536717,0.21724512016003178,3.7262572560881773,231.1337627563477,228.74812106323245,226.81999969482425,224.89187832641605,222.5062366333008,0.16,0.0,210.15629953247398,0.031135447846698305,0.03314303373967256,227.1723371233259,224.8714882986886,4.574429665515311
2023-04-18,0,233.34250259399414,218.1349983215332,233.5600051879883,222.06124782562256,227.86937427520752,0.38489938792323336,4.2010872352646,-0.7539181764272818,2.9955588286949886,225.12249946594238,3.576875686645509,0.018646088381387076,221.04024543762208,231.16500205993654,0.768999557835404,0.06870746632627049,1.0356664079667988,1.0194815366700927,1.0105847450775902,0.024791683325785074,79.00308429154262,233.70879907380066,225.30662460327147,216.90445013274228,230.50464357648576,3.088185664561335,228.01232201712472,3.6683081543475042,230.2668857834726,227.54949886636686,2.4748073279614586,4.789464821809607,4796200,1.4278392814479748,0.7890569796796687,157083400.0,-9.879166070197284,89.0859394939463,92.09290994229893,129.64458086642298,28.376760618191486,16.507348879984367,0.2675790080399926,3.648667408484728,231.66948376464845,229.6152626953125,227.9550018310547,226.2947409667969,224.24051989746096,0.16,0.0,210.20008091039003,0.022543352249601467,0.031665611362189566,228.2468741280692,225.80835178920202,4.5661326624945415
2023-04-19,0,233.12000274658203,220.3224983215332,233.5600051879883,222.38437366485596,228.58000087738037,0.429338745703542,4.210477297249557,-1.0382041793790087,2.9955592727738085,225.79374885559082,3.5987009429931662,0.018624908990077634,221.26625061035156,233.14450149536134,0.8320434516072479,0.05527545109762258,1.03119872840972,1.0156406659225239,1.0047084981746224,0.01725833218766737,78.21203972944066,234.48795441139364,226.06699981689454,217.64604522239543,231.56500135149275,2.3481301781800714,228.76982225690568,3.5384574548374457,231.0419138408681,228.41430274557737,3.2991735908992257,5.4500474763083915,3833900,1.334437318320319,0.6585737058362764,153249500.0,-17.561671867352782,89.0859394939463,92.09290994229893,109.45962925089913,27.1134844625694,15.772474998035669,0.21339200432868408,3.545904840383507,231.73792578125003,229.72604595947269,228.10000610351562,226.4739662475586,224.46208642578125,0.16,0.0,210.2343825769387,0.020894633737230217,0.018034573677115213,229.1138436453683,226.46281215122767,4.64738740838093
2023-04-20,0,233.30750274658203,220.3224983215332,233.5600051879883,222.50312423706055,229.61062335968018,0.27218979592482206,4.316447422852846,-1.2213679446990116,2.9955512472089203,226.3837490081787,3.7040008544921887,0.01904312237368197,221.78424682617188,233.14450149536134,0.8575431128417833,0.05084748735530322,1.029296291663129,1.014365007437543,1.0021003482672892,0.010218775213076237,76.52917841476251,235.29989504406998,226.66700019836426,218.03410535265854,232.36643055507116,1.666583433694107,229.51089368547713,3.3003086588213457,231.56008275068552,229.0218384050862,3.2886959227499184,4.765972355132364,4925700,1.3481115506255485,0.8592173947172181,158175200.0,-3.3333246388761797,89.0859394939463,92.09290994229893,111.4149994947265,26.607065235668774,14.757618008177449,0.31338395918939543,3.5190543638520246,232.22880261230472,230.52060083007814,229.13999938964844,227.75939794921877,226.05119616699218,0.16,0.0,210.27978401669313,0.008208432878846317,0.029805651234257515,229.9822256905692,227.32695661272322,4.666038928396966
2023-04-21,0,234.50000381469727,220.3224983215332,233.5600051879883,222.82812690734863,231.49062728881836,0.10220114443216277,4.398042119780402,-1.3179890503197838,2.9955450860295674,227.18499946594238,3.7736259460449233,0.019354140344731856,222.04974861145018,233.31100273132324,0.8655176186306892,0.05029601147711533,1.0319469120719609,1.0169785667152516,1.0051845268873816,0.004024655787930653,76.7579118287855,236.03645975835963,227.24037551879883,218.44429127923803,233.1285743713379,1.0725295927791831,230.22178677150183,3.219857468322499,231.99056783997707,229.53962548062165,2.4637971283843014,4.653874994528615,6771500,1.3495780368280597,1.1776593422742574,164946700.0,-13.275132331540481,89.0859394939463,92.09290994229893,112.37603754221588,27.26899460716356,14.08342601973998,0.29328918589482816,3.424122083676728,232.86780444335938,231.1961026611328,229.84500122070312,228.49389978027344,226.82219799804687,0.18,0.0,210.34389248324908,0.00012811021859082672,0.005844618106811865,230.86331176757812,227.93340955461775,4.724457956876579
2023-04-24,0,233.41249465942383,220.3224983215332,234.50000381469727,224.14375114440918,233.12062740325928,-0.03714983068549704,4.504709471060261,-1.3099468928701388,2.9955367825138195,227.5949993133545,3.872238769531252,0.019769756160750152,222.3489990234375,233.36425285339357,0.8272585346352824,0.06434887767328129,1.0243741874885224,1.0084965530314234,0.9997172844829187,0.0012439523616318837,82.0181576931284,236.86804473557754,227.85862579345704,218.84920685133653,233.48071616036552,0.4756444965333992,230.68857220241003,3.1710612177045596,232.60692213824876,230.12124785607722,2.3280198901928477,4.432248489648473,9124100,1.229750800481804,1.529197138401383,155822600.0,-24.977891710069695,89.0859394939463,92.09290994229893,82.4461683721873,25.207691784507293,16.90226850712175,0.22610321153457433,3.43954189124623,232.91500732421875,231.27250732421874,229.94500732421875,228.61750732421876,226.97500732421875,0.18,0.0,210.4254652173205,-0.003083740229499865,-0.005384191462898757,230.8731951032366,228.19886561802454,4.524563419969217
2023-04-25,0,231.76499938964844,221.28250122070312,234.50000381469727,225.4099988937378,233.16875171661377,-0.12707528192582102,4.308903516407458,-1.3727594132815615,2.995554335012544,228.04125022888184,3.785938186645508,0.01885626265405328,222.51024932861327,233.42724571228027,0.8701333290853696,0.04919817924048827,1.01423057765549,0.9980513885629401,0.9924144537892224,-0.006760462353875063,73.41392352795656,237.13093264316643,228.51312561035155,219.89531857753667,233.22428676060267,0.7994301252011664,230.93000057765417,3.110273465567763,232.8036486631104,230.50221318969875,1.0673388975384193,2.8804073000942,6076500,1.2479297873695976,1.0281943357516021,149746100.0,-53.1556532118053,89.0859394939463,92.09290994229893,44.49141906044129,22.4065003877465,19.15887194538849,0.2217632674597106,3.5931468702065996,232.91500732421875,231.27250732421874,229.94500732421875,228.61750732421876,226.97500732421875,0.02,1.0,210.47520463791702,-0.017166240913562558,-0.01666091195610216,230.24767848423548,228.33512333461218,4.23016435110988
2023-04-26,0,229.7150001525879,221.28250122070312,234.50000381469727,225.84187412261963,233.16875171661377,-0.30221459215654206,4.129381876808604,-1.221395003890791,2.9955693503215826,228.77499961853027,3.646250534057619,0.0180339677403558,222.89075241088867,233.42724571228027,0.8472415450026857,0.04737156400130465,1.003218647685175,0.98749377587399,0.9849670462406649,-0.014606222348476972,65.10952829148374,237.23676439448636,228.97800064086914,220.71923688725192,232.7375008719308,1.5535196529562074,231.088750566755,2.9751071018996993,232.54115244888095,230.61269200007834,-0.7685415989330467,1.479955873548044,8400400,1.2859740423500676,1.3979755282722928,141345700.0,-65.9556749131942,89.0859394939463,92.09290994229893,-3.3048861730754666,19.83718553607446,22.098319062971637,0.1963133782599505,3.7686365974611458,232.91500732421875,231.27250732421874,229.94500732421875,228.61750732421876,226.97500732421875,0.04,0.0,210.53658956820232,-0.019005041986015492,-0.023330618047587508,229.49508449009485,228.33371080671037,3.7169802828193714
2023-04-27,0,228.47999954223633,222.51499938964844,234.50000381469727,226.63062381744385,233.16875171661377,-0.3108839663165395,3.733651019665558,-1.1772933694026628,2.9955995893903253,229.43999862670898,3.2796258926391615,0.016275750276854857,224.3860008239746,233.42724571228027,0.8432851446745074,0.03235737268358909,0.9959911615249065,0.9819526154087472,0.9825406355565173,-0.02069159005824739,53.94125750374173,236.8669276267945,229.3996255874634,221.93232354813227,232.04285757882255,2.19328996520284,231.27375057765417,2.6942364057524544,231.8441448574937,230.5082043297527,-1.4616783882422448,0.9769552158557661,7128200,1.3984800506768678,1.1607111598888498,134217500.0,-58.31122504340303,89.0859394939463,92.09290994229893,-28.198423223472357,18.685373213534778,21.02670757223893,0.19673134143429505,3.71516285996088,232.91500732421875,231.27250732421874,229.94500732421875,228.61750732421876,226.97500732421875,0.06,0.0,210.58615504284094,-0.02382789126340701,-0.015307240401311616,228.8469717843192,228.5469229561942,3.429851085066523
2023-04-28,0,230.75249862670898,222.93250274658203,234.50000381469727,227.33874988555908,233.16875171661377,-0.26179545015757705,3.394639683172536,-1.1326655947789181,2.9956229200136644,229.43999862670898,2.981375885009767,0.01477871606072903,225.58249855041504,233.42724571228027,0.8080196769341368,0.024884199151347618,1.0045913486525895,0.9927720840021468,0.9964503825475474,-0.0159808320981929,48.498967676832194,236.48715496143785,229.69787559509277,222.90859622874768,231.70464270455497,2.1820168282806067,231.63482202802385,2.17887983944688,231.0128553795423,230.27018400268202,-2.083847990701616,1.146575837613898,11627900,1.4440221520036982,1.8018156222228936,145845400.0,-30.309588599401348,89.0859394939463,92.09290994229893,33.44505112292524,24.094390044293856,18.87351020526856,0.25988568704071036,3.8433662103660184,233.35868487548828,231.9906633605957,230.88500213623047,229.77934091186523,228.41131939697266,0.06,0.0,210.68009180114794,-0.00563975535797534,-0.007971102089818287,228.86956351143974,228.991703578404,3.0150765058989255
2023-05-01,0,232.8699951171875,224.54750061035156,234.50000381469727,227.64624881744385,233.16875171661377,-0.19832157127551664,3.0228787169896805,-1.2820564086131043,2.9956458924451166,230.23374938964844,2.694125938415529,0.013137874275224063,225.87074928283693,233.42724571228027,0.7949675500065193,0.027633342608986373,1.012087154250223,1.003093858008245,1.0088595111300118,-0.0023242095202653523,55.38258235006513,236.13463282307848,230.08887538909912,224.04311795511975,231.64214161464147,2.1341948466583163,232.00428608485632,1.8775968386815256,230.95370550410183,230.39214306750534,-1.0155731348573687,2.239723675613952,4571100,1.4826742303266385,0.7364973076786744,150416500.0,-34.151903174881916,89.0859394939463,92.09290994229893,62.497098710587785,24.6182619298573,17.777614228455608,0.20353713090943876,3.7888401832721352,233.4554457397461,232.14728475952148,231.09000396728516,230.03272317504883,228.72456219482422,0.02,1.0,210.71929114568675,-0.0010740718239270475,-0.006579747564172888,228.57445199148995,229.27833884102958,2.828704732717985
2023-05-02,0,229.37749862670898,225.6974983215332,234.50000381469727,228.21312618255615,233.16875171661377,-0.26195401213566416,2.7957155749037725,-1.3521100192503783,2.9956586405391037,230.85000038146973,2.51450071334839,0.0121286547949752,226.77874870300292,233.42724571228027,0.8029643579547289,0.026412916779985397,0.9951085595229078,0.988157313736352,0.9941963407589437,-0.010301386185260553,60.11486411063415,236.09643126424845,230.50500011444092,224.91356896463338,230.91035515921456,1.8502872504415262,232.01946476527624,1.853583503853807,231.43354365826713,230.74187969064542,-0.1875240291220942,2.2716528876176665,5244000,1.468250938490924,0.8530067920096492,145172500.0,-91.77362218523481,89.0859394939463,92.09290994229893,-55.301216627345056,21.8265240051123,25.30170211466524,0.12458741309521801,3.9682078696797074,233.36104718017577,231.99448709106446,230.89000701904297,229.78552694702148,228.41896685791016,0.02,1.0,210.75529287713013,-0.011368177427646176,-0.02483252199811065,227.576167515346,229.21973964146204,2.923430384942699
2023-05-03,0,226.8874969482422,225.6974983215332,234.50000381469727,228.45625019073486,233.16875171661377,-0.31603092743953837,2.6844040686577992,-1.180631329409595,2.9956644494155054,230.85000038146973,2.37700071334839,0.011639440087264323,227.33225021362304,233.42724571228027,0.7939807472913117,0.0043457165803142215,0.9837726958143275,0.979102823960816,0.9854433806264628,-0.012308744324347698,46.639762890553975,235.9988082517565,230.63000011444092,225.26119197712535,229.97821262904577,2.015847038100609,231.72946439470564,2.298421201655183,230.9117709813737,230.57748766107292,-2.18443714484376,0.09272861412836443,4093300,1.665794839544609,0.6721793485445255,141079200.0,-99.37826423137707,89.0859394939463,92.09290994229893,-95.73806576488747,20.721875793735187,24.55489885643866,0.11453547705677324,3.881193021845139,233.29260516357422,231.8837038269043,230.74500274658203,229.60630166625975,228.19740032958984,0.04,0.0,210.78067189363145,-0.009511260480365213,-0.015723649992788396,226.61883326939173,228.74601418631417,3.030800637399546
2023-05-04,0,224.99499893188477,225.6974983215332,234.50000381469727,228.28437423706055,233.16875171661377,-0.30490964262797315,2.765634574685951,-1.2766107169292902,2.9956602362878377,230.85000038146973,2.459363498687746,0.011995545865331806,226.78774719238282,233.42724571228027,0.7352204715343976,-0.0026594430854731304,0.9758837461251292,0.97355442860082,0.9796297836462959,-0.01525297889239241,40.67172012867981,236.0863940044134,230.5551248550415,225.0238557056696,229.0110697065081,2.5649590471558614,231.11767823355538,2.847911696978665,229.8896281161637,230.12697630938482,-2.7954791883366727,-1.757977527547962,5648700,1.7495669442166486,0.9212816100858702,135430500.0,-82.46477797789059,89.0859394939463,92.09290994229893,-132.13649217999267,19.713825218434145,27.961080042067273,0.11640694002801237,3.788250793931237,232.71676458740234,230.95162289428708,229.5250015258789,228.09838015747067,226.33323846435545,0.06,0.0,210.81163505468191,-0.014890158244796892,-0.011176845852932635,226.0554460797991,228.1515622820173,3.180956655682136
2023-05-05,0,229.93749618530273,224.99499893188477,234.50000381469727,228.28437423706055,233.16875171661377,-0.40238164684471395,2.951255220295313,-1.1778873054918073,2.9956501114181724,230.85000038146973,2.596726074218752,0.012807585909537955,225.87074928283693,233.42724571228027,0.686140935824346,-0.003962107486749969,0.9978615932520534,0.9985321825478055,1.004196930886001,-0.003531933332278636,37.27854002852422,236.33276022696757,230.43024978637695,224.52773934578633,229.04285485403878,2.5764887398676612,230.89017786298479,2.8022894132655924,228.6584300060685,229.57863138236155,-2.9210624881204765,-3.667154506701489,6237000,1.7644046311356079,1.0012939601280475,141667500.0,-31.348262279274625,89.0859394939463,92.09290994229893,-3.423648022398766,28.557425923312906,24.595002862765615,0.14397991623896883,3.999089325392143,232.71676458740234,230.95162289428708,229.5250015258789,228.09838015747067,226.33323846435545,0.06,0.0,210.8586329331723,-0.004081919377714294,0.01209562031764907,226.56800406319755,228.0315442766462,3.0265515865012236
2023-05-08,0,232.0449981689453,224.99499893188477,234.50000381469727,228.99374771118164,233.16875171661377,-0.48782818953607565,2.7659353611142405,-0.8905878003909611,2.9956602157886825,230.85000038146973,2.374113750457765,0.011992819166835741,226.76849708557128,233.42724571228027,0.6457001281148059,0.018786197876810955,1.0061239104618223,1.0096847865097656,1.0141228600898229,-0.0035427361426577653,51.71427089417605,236.16449534838816,230.63262462615967,225.10075390393118,229.55214037214006,2.790167903208466,230.79749897548132,2.735608489619254,228.9803113686338,229.85226969108146,0.09685742444640143,-1.3662367078363844,2938400,2.0854955679810434,0.4794843552400767,144605900.0,-27.626206724210128,89.0859394939463,92.09290994229893,41.998365448276274,29.446435861532347,23.596464933829758,0.10519616875358945,3.8705827270239306,232.71676458740234,230.95162289428708,229.5250015258789,228.09838015747067,226.33323846435545,0.02,1.0,210.8827670915482,-0.0012041689103189368,-0.00214835418106538,227.02267020089286,227.93482099260603,2.8796672415169198
2023-05-09,0,232.3125,224.99499893188477,234.50000381469727,229.32437324523926,233.16875171661377,-0.6331680617620115,2.5360674094288504,-0.5048518477291308,2.995671839327102,231.35625076293945,2.1545009613037123,0.010981023657145608,227.6164981842041,233.42724571228027,0.6276139741790231,0.019093314065633585,1.0058995470176237,1.0114505974639834,1.0160246066056964,0.012795506930117329,55.319828883745885,236.022134437388,230.94999961853028,225.87786479967258,229.77499771118164,2.9592028529493817,230.7398202078683,2.6910225120467195,229.7561408237496,230.3270894470757,1.560311026720729,-0.5560514739599025,4352100,2.0904484544521162,0.7111053741795598,148958000.0,-19.106787441107507,89.0859394939463,92.09290994229893,50.25823856090303,28.84387847500767,22.15657525297404,0.10327560649608944,3.827683176070103,232.71676458740234,230.95162289428708,229.5250015258789,228.09838015747067,226.33323846435545,0.04,0.0,210.91910048676135,0.027667793050833556,0.0032257464804817206,227.0975080217634,227.98353576660156,2.86289293378636
2023-05-10,0,232.31999969482422,224.99499893188477,234.50000381469727,229.63062477111816,233.16875171661377,-0.8703022233064229,2.4376780825333375,0.045137392563732615,2.99567650741621,231.90499877929688,2.03692590713501,0.010544468281510488,228.3207492828369,233.42724571228027,0.6327735302934674,0.013734658167647894,1.0049279621847274,1.0112421972698926,1.013455602095791,0.02394359680305036,55.115798719306085,236.0561058675203,231.18074970245362,226.30539353738695,229.6964269365583,2.8692653454792763,230.6692842755999,2.6308107441134605,230.40392111656968,230.6785845377757,0.6760496127128175,-0.3463893003895697,5245000,2.0700990572124516,0.8509374913811145,154203000.0,-35.56657508036382,89.0859394939463,92.09290994229893,12.450240853340869,25.78176639112053,23.253324454852503,0.12160160348601877,3.9764203536446927,232.71676458740234,230.95162289428708,229.5250015258789,228.09838015747067,226.33323846435545,0.06,0.0,210.96060032923896,0.023409100612958422,0.01890041481217297,226.92241995675224,227.7484359741211,2.7541616877646
2023-05-11,0,230.38750076293945,224.99499893188477,234.50000381469727,229.88187217712402,233.16875171661377,-1.0697609448485712,2.4039802266972483,0.4522449578134182,2.995678077269788,232.17874908447266,1.961550750732421,0.010391613278556946,228.3207492828369,233.42724571228027,0.6544402885986618,0.005942898476486428,0.9958891448249908,1.0016945930202028,1.0002843938796437,0.023967207523075684,54.05738522537743,236.14646028554782,231.33849983215333,226.53053937875885,229.84071295601981,2.875941594081582,230.3755340576172,2.3886283209009997,230.88837524718838,231.05228636481064,-0.2361813174284245,-0.4232624498280433,3818000,2.0347751530007465,0.6391118721977129,150385000.0,-35.475578742294104,89.0859394939463,92.09290994229893,-32.6495238315543,24.256730767951524,23.02446480488142,0.08838619854704087,3.924533185527099,232.3958743286133,230.69205459594727,229.31499481201172,227.93793502807617,226.23411529541013,0.06,0.0,210.98867864483944,0.02597682539530477,0.024251563991727027,227.55505153111048,227.56560952322823,2.736591953731888
2023-05-12,0,231.48250198364258,224.99499893188477,234.50000381469727,229.88187217712402,233.16875171661377,-1.0276458928241707,2.4116203946885104,0.36134452635869074,2.995677726390126,232.17874908447266,1.9951508331298853,0.010425901103297745,228.3207492828369,233.42724571228027,0.649295751155985,-0.013583252074752113,1.0007435988436741,1.005621495804045,1.000354377028606,0.006719242507080114,46.6914605533623,236.13374055286576,231.31049976348876,226.48725897411177,230.4971422467913,2.600766901049226,230.23767743791853,2.2516365731196784,230.76983625926883,231.13071790490733,0.44032311027776766,-1.7537326161442313,3430300,1.9887140474845502,0.6064495484290706,153815300.0,-31.54243236024476,89.0859394939463,92.09290994229893,6.680481054568217,25.191523091689643,21.782071561986307,0.07006938465347075,3.8520657010836046,232.29656225585939,230.61172100830078,229.25,227.88827899169922,226.20343774414061,0.06,0.0,211.01519771514936,0.00022046494124539073,0.02762017899997331,228.38122776576452,227.50003051757812,2.6658119375111826
2023-05-15,0,231.84500122070312,224.99499893188477,234.50000381469727,229.88187217712402,233.12062740325928,-1.0124586871219758,2.3566052670338427,0.4547100949309075,2.9956801467952223,231.90499877929688,1.9120507049560558,0.010192637304737927,228.3207492828369,233.3495018005371,0.6379425435241841,-0.007034925328904065,1.0027610654259023,1.0068769750395725,1.0005847887055188,-0.0008618886415150406,50.239897732134494,235.91983513733916,231.20662460327148,226.4934140692038,231.4757140023368,0.9507764223764775,230.24339185442244,2.2559083891147305,230.95210081348563,231.29887615683361,2.025235016122818,-0.826859195604475,2843200,2.007098894550007,0.5118018459932226,156658500.0,-17.65224780915873,89.0859394939463,92.09290994229893,34.869133050192815,24.285509285955253,20.83352149017211,0.06874910221520765,3.7397752066700507,232.13611712646482,230.48193685913085,229.1449966430664,227.80805642700193,226.15387615966796,0.06,0.0,211.0379395633651,0.0044518753530742305,0.006402008828588508,229.46336582728796,227.75940595354353,2.656603702040216
2023-05-16,0,231.44000244140625,224.99499893188477,234.50000381469727,229.88187217712402,232.93249702453613,-1.0044736882957281,2.3208523032285235,0.5345006685496587,2.9956816924746534,231.80500030517578,1.8609506988525368,0.010040774834116969,228.3207492828369,233.3495018005371,0.6189579932791541,-0.006417610836619007,1.001286014146168,1.005565731486704,0.9990093720136225,-0.0037557064669088147,51.14922925396815,235.78445420209914,231.1427495956421,226.50104498918506,231.6903577532087,0.675340965303975,230.36660630362374,2.2718804221045064,231.18460397652797,231.34196964077597,3.0445131319972747,0.03451851283212382,4289700,2.0084952414745447,0.7757212994692538,152368800.0,-38.305345423643345,89.0859394939463,92.09290994229893,3.4205445139509676,22.667627296112702,21.21187774100268,0.029672784173150085,3.7205056362438054,232.13611712646482,230.48193685913085,229.1449966430664,227.80805642700193,226.15387615966796,0.06,0.0,211.0705365653578,-0.010034684587467035,-0.0056439347959703805,229.34183611188615,227.95492008754186,2.595432378752167
2023-05-17,0,232.45499801635742,224.99499893188477,234.50000381469727,229.88187217712402,232.45749855041504,-0.9972287796135263,2.2671080579347014,0.6595255671969769,2.995683973080306,231.6237506866455,1.7848506927490235,0.009812297624687738,228.3207492828369,233.3180019378662,0.6044174918967009,-0.007206590105449083,1.0060912698447095,1.0090714566797312,1.004146943953831,0.0005810878172802791,50.03100569133213,235.5818407038821,231.0476245880127,226.51340847214328,231.74892915998186,0.7270262668593568,230.65053476606096,2.2663458923527786,231.2572374144215,231.25051996950273,0.6534411659821986,0.7509314967122429,4990100,2.009595492596869,0.8930412186636506,157358900.0,-19.064459956122274,89.0859394939463,92.09290994229893,52.69798829082721,22.696130530159646,19.81104001382988,0.05281557499293008,3.6990408171510203,232.13611712646482,230.48193685913085,229.1449966430664,227.80805642700193,226.15387615966796,0.06,0.0,211.11077284201153,0.007928274055236884,-0.0006706997336063255,229.4651816231864,228.24392591203963,2.614349950134163
2023-05-18,0,232.81999969482422,224.99499893188477,234.50000381469727,229.88187217712402,232.35374927520752,-1.0148545404907723,2.2411985197342914,0.7413833297064372,2.9956850562342012,231.6237506866455,1.7582505035400402,0.009701554399053026,228.3207492828369,233.3180019378662,0.5759061135660755,-0.0036539962075313012,1.0078160735598876,1.0082192253503595,1.005606373497347,0.010558293847667155,53.08449520633364,235.49677139097005,231.01437435150146,226.53197731203286,231.82142911638533,0.8128334648376392,230.7982134137835,2.3396755829609357,231.55630635441852,231.30107738506885,0.17668980182610972,1.7397577390078225,6621900,2.0240184530777134,1.1673544795392565,163980800.0,-10.679534506002058,89.0859394939463,92.09290994229893,77.08806569030038,21.86371654347265,18.640387952907183,0.04763470386522755,3.650537116902437,232.13611712646482,230.48193685913085,229.1449966430664,227.80805642700193,226.15387615966796,0.06,0.0,211.16542494886156,0.01121168383687876,0.01204410638550112,229.57749502999442,228.3375015258789,2.5788991873214235
2023-05-19,0,233.39749908447266,224.99499893188477,234.50000381469727,229.88187217712402,232.35374927520752,-1.0413865296750386,2.218663766549976,0.8141054339388947,2.995685988803581,231.6237506866455,1.7387503814697254,0.009605020885079129,228.3207492828369,232.92424507141112,0.5314606482329226,-0.007164196556690003,1.0104225286545236,1.007306717258042,1.005986842762513,0.008272751004589463,53.31683295405231,235.42732673201354,230.98999919891358,226.55267166581362,231.9753576006208,1.0028090150645232,230.83589226858956,2.379515055013133,231.86382343839023,231.3844298358206,0.21845561251513318,0.8959820935503087,5399100,2.005744819706969,0.9634454268863927,169379900.0,-13.239185856869046,89.0859394939463,92.09290994229893,90.20985330968834,21.19234526257531,17.743084896627302,0.07849207928001017,3.561212601158164,232.13611712646482,230.48193685913085,229.1449966430664,227.80805642700193,226.15387615966796,0.06,0.0,211.21026475109406,0.00834119385084997,0.009956299664777343,229.92977033342635,228.42609514508928,2.5624299184252535
2023-05-22,0,232.40999603271484,224.99499893188477,233.41249465942383,229.88187217712402,232.35374927520752,-1.2269265731747263,2.143181346062091,0.9701861585771434,2.9956890441728685,231.6237506866455,1.694650192260741,0.009280457772744253,228.3207492828369,232.92274551391603,0.521361825859864,-6.424495386612518e-05,1.0063876106930159,1.001549214182852,1.000079589576877,0.0024369505878363285,56.2442981312546,235.22123665452654,230.93487396240235,226.64851127027816,232.26428549630302,0.7207659642729285,231.05249922616142,2.37456433688435,232.24330753622715,231.54428247060937,0.4637996690185269,0.2265229434215858,3987800,1.9965311891793975,0.7457825545829683,165392100.0,-31.156206609088127,89.0859394939463,92.09290994229893,51.27178050475361,20.028589648402214,18.320232852719606,0.07446575632204985,3.4989833040329446,232.13611712646482,230.48193685913085,229.1449966430664,227.80805642700193,226.15387615966796,0.06,0.0,211.2416355121726,-0.006571808853341521,-0.0004322424499909603,229.9679696219308,228.76151057652064,2.5363039843237343
2023-05-23,0,226.75000381469727,224.99499893188477,233.39749908447266,229.88187217712402,232.34249877929688,-1.3053514323071187,2.0958489481753744,1.1274800997967436,2.9956909082428003,231.6237506866455,1.6545502471923839,0.009077468117625066,228.3207492828369,232.82499923706055,0.561199214514237,0.002782976915258993,0.9820917352327447,0.977004329923919,0.9752499617741917,-0.020264425238659234,53.83323252478422,235.07644692741766,230.8847490310669,226.69305113471611,231.58821432931083,2.2253701151001493,231.04267828805106,2.393325619125015,232.28672753031373,231.53874972182425,0.8778667519191792,1.3220553123830918,8537200,1.9731838634640038,1.560682757574262,156854900.0,-90.29120983457729,89.0859394939463,92.09290994229893,-157.34244421347455,17.154799129137608,29.851695290181986,0.07174751721267375,3.793341290687207,232.13611712646482,230.48193685913085,229.1449966430664,227.80805642700193,226.15387615966796,0.02,1.0,211.2886200459633,-0.025556604494472612,-0.035350797490086426,229.0059313092913,228.6935795375279,2.8458005910590147
2023-05-24,0,221.98250198364258,224.99499893188477,233.39749908447266,229.63062477111816,232.34249877929688,-1.0022559905748767,2.268429242350597,0.04178210910701052,2.995683742467064,231.4612522125244,1.8541999053955067,0.009835623757574784,226.8737476348877,232.82499923706055,0.4278771724405867,-0.012907282223281588,0.9624881964639922,0.9587603448799401,0.9586123322123112,-0.04505171376000228,38.24911684821159,235.17085773702053,230.63399925231934,226.09714076761816,230.1792858668736,4.243069784353476,230.82749993460519,3.0297022281705943,230.90916681252114,230.81185737808906,-2.0444301959721036,-0.06059969605830107,6730800,2.3097943924534197,1.24952429042696,150124100.0,-84.97969280070038,89.0859394939463,92.09290994229893,-228.20161739310308,15.705682833644703,34.069309024564895,0.1418531187016263,3.8473885593351693,231.3219178466797,229.16403802490234,227.4199981689453,225.67595831298829,223.51807849121093,0.04,0.0,211.31508147238424,-0.04470233006361357,-0.03566626306920062,227.51195417131697,228.48765999930245,3.318144702677486
2023-05-25,0,222.75250244140625,221.98250198364258,233.39749908447266,229.15312385559082,232.34249877929688,-1.321592938625413,2.948980279681463,0.9718159626895999,2.9956497808250497,231.4612522125244,2.3321624374389613,0.012807877996806997,226.57450332641602,232.82499923706055,0.4409634167209609,-0.028437927046619398,0.9674486107656006,0.9664008727002291,0.9707175704352184,-0.04324154826309701,30.120549758774644,236.145334903235,230.24737434387208,224.34941378450915,228.93821443830217,5.0134443399912945,230.31428609575545,3.7216030696869846,228.67275339383073,229.61921351587074,-4.253919293119464,-1.338917292625777,6827600,2.521616256341001,1.2710409817449355,156951700.0,-77.33419228553554,89.0859394939463,92.09290994229893,-165.41096621487836,17.4217026630679,31.430035255431815,0.12705117128146448,3.8725748728285523,231.3219178466797,229.16403802490234,227.4199981689453,225.67595831298829,223.51807849121093,0.04,0.0,211.3444892517936,-0.04374994269881305,-0.03984513617342184,226.50889805385046,227.9253670828683,3.619686263541184
2023-05-26,0,224.59500122070312,221.98250198364258,233.39749908447266,228.75499820709229,232.34249877929688,-1.1889420583660395,3.3566275768389686,0.15579186037308856,2.995625116128325,231.4612522125244,2.70444974899292,0.014596508035276666,224.7707492828369,232.82499923706055,0.6204563707076398,-0.03466916385700517,0.9766656159955155,0.9776327813067466,0.9874108927904147,-0.03771461947235211,30.879039351222985,236.67425464250852,229.96099948883057,223.24774433515262,227.8153577532087,4.974565798019988,229.7821434565953,3.978835125935278,227.18695920840065,228.70597260868303,-3.7536726185437272,-3.124759494687295,5067300,2.4612216207206967,1.0046930484591454,162019000.0,-66.30584479807415,89.0859394939463,92.09290994229893,-100.93627049864484,19.338509319956835,29.734891074109818,0.06341478435477801,3.8009631230533376,231.3219178466797,229.16403802490234,227.4199981689453,225.67595831298829,223.51807849121093,0.04,0.0,211.36999441039757,-0.03557499044893786,-0.03677229059046243,225.4280286516462,227.4466051374163,3.7144233926970105
2023-05-30,0,222.96749877929688,221.98250198364258,233.39749908447266,226.85312366485596,232.34249877929688,-0.9203062268976224,3.546905000172354,-0.5718196279529857,2.9956124286459302,231.4612522125244,3.0231868362426724,0.015444618948964916,224.41075134277344,232.82499923706055,0.6953489640953043,-0.03553482230426525,0.9708881564301,0.973466967481218,0.9879019649884153,-0.040628619313296754,35.54034926896232,236.746934618875,229.65312461853028,222.55931461818557,226.40785762241907,4.709312204079196,229.11464336940222,4.293139116735139,226.52786954400227,228.09784675530173,-3.381298256749551,-3.2105828641124416,6916000,2.4470183652533684,1.340082834790612,155103000.0,-87.45020122151388,89.0859394939463,92.09290994229893,-131.74586203547153,17.332138247775863,33.161471508127974,0.05477782713918736,3.938037272885591,231.2558381347656,229.05707849121094,227.27999877929688,225.5029190673828,223.30415942382814,0.06,0.0,211.39805267739908,-0.04168110096476185,-0.05001930024477796,223.7359837123326,226.6567393711635,4.03084714193573
2023-05-31,0,219.66500091552734,221.98250198364258,233.39749908447266,226.31125259399414,232.31437492370605,-0.6962163230445558,3.7487135591823373,-1.0480386297670163,2.9955979512085817,230.91375160217285,3.3175994491577114,0.016358641471942097,222.9459991455078,232.4914981842041,0.7399179989670741,-0.02794519900944513,0.9585744381853317,0.9627800180473868,0.9814820161704254,-0.031245877750722628,34.094943055256216,236.65542692000042,229.15799980163575,221.66057268327108,224.4460721697126,4.137965326852502,228.2107148851667,4.861036488492495,225.62079465517613,227.2829062743726,-4.231810380741261,-4.022599395513855,20460600,2.3582191613847585,3.455187315139812,134642400.0,-73.13186698022649,89.0859394939463,92.09290994229893,-152.1800648938568,15.650726711474515,36.31190085176043,0.22165589551952303,4.049606039108144,230.0447970581055,227.38759750366214,225.23999786376953,223.09239822387696,220.4351986694336,0.08,0.0,211.45969690886562,-0.015807133215850144,-0.04431858032593622,221.99866812569755,225.96421922956193,4.365765231543498
2023-06-01,0,224.59249877929688,219.66500091552734,233.39749908447266,224.89499950408936,232.31437492370605,-0.6713704210924738,4.280241141010116,-1.023806769881242,2.995556341412052,230.91375160217285,3.8783994293212913,0.018717788462996352,222.67550239562988,232.4914981842041,0.7313792881652825,-0.03183293980435796,0.9821584214609347,0.9894836255389525,1.0098924095939181,0.011757669060990406,29.58158753333012,237.23285719809692,228.67237491607665,220.11189263405637,223.32928684779577,2.2584446545856602,227.7967861720494,4.907922621556559,224.13116955548506,226.27003591415172,-5.883738353158258,-5.447227443147596,7003600,2.40379275525356,1.1543342750056862,141646000.0,-43.07691017853634,89.0859394939463,92.09290994229893,-54.139442290570344,23.00786990924013,32.775642188674304,0.300653496651232,4.166063317355534,230.0447970581055,227.38759750366214,225.23999786376953,223.09239822387696,220.4351986694336,0.08,0.0,211.49513287109792,0.01912263306859363,0.00854943619166643,221.3224160330636,225.6451928274972,4.3362131525697585
2023-06-02,0,228.8224983215332,219.66500091552734,233.39749908447266,224.59437561035156,232.31437492370605,-0.5952578499446771,4.356635936164179,-1.1886464915366628,2.995549897100948,230.91375160217285,4.01609931945801,0.01906143335195556,222.67550239562988,232.4914981842041,0.7870883422204802,-0.0017889293295347598,1.0011588907344262,1.0116239014368573,1.0265034256764975,0.02724995595379953,45.02318018695887,237.27089687995777,228.55762500762938,219.844353135301,223.62535749162947,2.8420619419572426,227.60678591047014,4.8046639276339915,224.25234572156026,226.28529523140443,-3.363666531932452,-2.515328290142541,5895500,2.647956806285126,0.9697247827145385,147541500.0,-30.49452737569755,89.0859394939463,92.09290994229893,2.3725775907160163,27.65598726454546,30.64260555330587,0.2682806525100341,4.13777338557733,230.0447970581055,227.38759750366214,225.23999786376953,223.09239822387696,220.4351986694336,0.02,1.0,211.532640713039,0.024218677305876124,0.02942629882343056,221.91802978515625,225.46198054722376,4.259727153681905
2023-06-05,0,227.0800018310547,219.66500091552734,233.39749908447266,224.59437561035156,232.31437492370605,-0.733499826494123,4.279315946173509,-0.9589539493565673,2.995556467203348,230.91375160217285,3.7937991905212387,0.018707473897598192,222.67550239562988,232.4914981842041,0.825102274338823,-0.004849134579037833,0.9927038013445998,1.0056976914434788,1.0131687948342476,0.011064362950400808,51.74438870319728,237.30763186945885,228.74899997711182,220.1903680847648,224.3535717555455,2.9996504708641596,227.26642881120955,4.647543371153522,225.41012669873504,227.0443098699465,0.9139997671310313,-1.1491165160714139,4858900,2.5816104800721504,0.8083811165338886,142682600.0,-41.593369971201064,89.0859394939463,92.09290994229893,-29.288872065850665,25.975509641760315,32.46488618379494,0.22964168866539958,4.090789267145993,230.0447970581055,227.38759750366214,225.23999786376953,223.09239822387696,220.4351986694336,0.02,0.0,211.55982933996722,0.007821902642141554,0.015175868866896463,222.5574994768415,225.03472682407923,4.240773343192734
2023-06-06,0,227.5800018310547,219.66500091552734,233.39749908447266,224.59437561035156,232.31437492370605,-0.6345653669008633,4.284948466545003,-1.0601158116099454,2.9955558917229466,230.91375160217285,3.8463992309570303,0.01874380426894892,222.67550239562988,232.4914981842041,0.8101325530846027,-0.021396696231632425,0.99551139136285,1.0107400631530117,1.0131530129452153,0.020686885205289274,46.98513514684032,237.1760221924894,228.60612525939942,220.03622832630944,225.04321452549524,3.1226216473927773,226.99071448189872,4.492822701397193,225.83290693231962,227.2878333581661,2.2963521006659047,-2.0552521575017404,6020100,2.554585884835646,0.9765375344296758,148702700.0,-33.6263524361668,89.0859394939463,92.09290994229893,-7.279707309251585,26.184067197595137,30.682125892592666,0.24277747149526635,4.019304057913424,230.0447970581055,227.38759750366214,225.23999786376953,223.09239822387696,220.4351986694336,0.02,0.0,211.59574412763504,0.029687891904337294,0.014266132040794303,223.24223981584822,224.87556893484933,4.175532248213034
2023-06-07,0,225.21000289916992,219.66500091552734,233.39749908447266,224.59437561035156,232.31437492370605,-0.5351855613380923,4.215720223201771,-1.0816831566963876,2.9955613263150354,229.60499954223633,3.7480867385864256,0.018459003176282688,222.67550239562988,232.4914981842041,0.8008773137701918,-0.020371259269067795,0.9861072221934882,1.002364495551998,0.9985014390018072,0.025242992559269428,47.99204540475903,236.81431588890845,228.38287544250488,219.9514349961013,225.13107190813338,3.1165548947999167,226.47321483067103,4.22423577512584,226.2665307132254,227.42443394704333,2.167203212865491,-1.667819119267768,8517200,2.5576446850255343,1.3364516997110463,140185500.0,-49.835129594929306,89.0859394939463,92.09290994229893,-58.81042185014741,23.01296219652875,35.612050942507345,0.2381921263188615,4.246496407222753,230.0447970581055,227.38759750366214,225.23999786376953,223.09239822387696,220.4351986694336,0.02,0.0,211.63615616809778,0.019182940640201318,0.016377951639248076,223.2790243966239,224.35352652413505,4.099265579773792
2023-06-08,0,223.92250061035156,219.66500091552734,233.39749908447266,224.59437561035156,231.9637508392334,-0.3612723930075869,4.16862589929981,-1.182920954344779,2.9955647870467352,228.20125007629395,3.710249137878418,0.018281221862515688,222.67550239562988,232.4914981842041,0.7734878215873378,-0.030604325090366716,0.9819967088806711,0.9973176663708471,0.9879355143973757,-0.0029831725128259823,43.17134408459165,236.365002386063,228.02775058746337,219.69049878886375,225.2675007411412,3.025634715407528,225.83767918178015,3.848515893350532,225.99775973394753,227.23135140641918,0.2738269663724404,-3.116730196817572,6248200,2.599841592502586,0.9727618281047242,133937300.0,-62.032940545208426,89.0859394939463,92.09290994229893,-70.40742463631327,21.879444501922595,33.85795733474759,0.2185813654676696,4.147460993160475,230.0447970581055,227.38759750366214,225.23999786376953,223.09239822387696,220.4351986694336,0.02,0.0,211.66318916738015,-0.015231785556660271,0.00913902241696199,223.47850472586495,223.60724421909876,4.187282518833537
2023-06-09,0,223.78499603271484,219.66500091552734,233.39749908447266,224.42499923706055,231.57312679290771,-0.16854253250651202,4.137950055265975,-1.268173584292065,2.995566829585525,227.3300018310547,3.658911685943605,0.018180170803640112,222.67550239562988,232.4914981842041,0.78052963620372,-0.02806141883209257,0.9832040978815471,0.9958447849720843,0.9879129048589385,-0.022014890693745737,41.62465880959723,235.88377574377174,227.60787563323976,219.33197552270778,225.85607147216797,1.9711122056268664,225.1510718209403,3.198636552750762,225.47324109510274,226.94103739316944,0.4283143670190204,-3.821621465567958,6385000,2.5834319570992794,0.9745852288901558,127552300.0,-58.150028443491266,89.0859394939463,92.09290994229893,-59.13725641624972,21.01058576309854,32.40356310488956,0.17779452409366603,4.02407079143076,229.68571612548828,227.09713674926758,225.00499725341797,222.91285775756836,220.32427838134765,0.02,0.0,211.69138237575987,-0.022859346766707977,-0.012980132666571975,223.83643668038505,222.9175524030413,4.203666908699591
2023-06-12,0,225.16500091552734,219.66500091552734,233.39749908447266,223.88812446594238,231.57312679290771,0.019607990523834516,4.166299631209529,-1.3207905676657314,2.995564259320591,226.91500282287598,3.675274505615235,0.01833131322330045,222.67550239562988,232.4914981842041,0.7728615551639975,-0.033253079109502925,0.9907041077381608,1.0015256549326614,0.9984457843281471,-0.008433155276051485,40.606907105537516,235.61034965914754,227.27775039672852,218.9451511343095,225.93785749162947,1.9211905968373557,224.6335721697126,2.4268611607591026,225.05546251080975,226.5492589866124,1.875581043869548,-4.118511590511429,8621100,2.5619633606676593,1.2657529057582206,136173400.0,-29.0163105923822,89.0859394939463,92.09290994229893,-26.96699133866708,22.2112441268396,30.707162295993395,0.21992211991905355,3.943065691303413,226.9353231201172,224.87234240722657,223.2050018310547,221.53766125488283,219.4746805419922,0.02,0.0,211.73417961817876,-0.0026459052811840245,-0.011451526799527805,223.7897491455078,222.55608258928572,4.0982074308877605
2023-06-13,0,224.6999969482422,219.66500091552734,233.39749908447266,223.88812446594238,231.54125213623047,0.1920966065182816,4.073998562933661,-1.1930102115528245,2.9955713392578405,225.9800033569336,3.5193120384216314,0.017950144960562065,222.67550239562988,232.4914981842041,0.7640081412500177,-0.028812354245312387,0.9900341042227508,0.9992040024046813,0.998078893502084,-0.012654911941474056,44.297841726132724,235.1098724691901,226.96187534332276,218.81387821745543,225.34892872401647,1.4679422224285743,224.48714310782296,2.3499666933450145,225.09953657222488,226.22622498839087,0.2549070602723275,-3.117333695134038,6868700,2.587952190989938,0.9795189038720423,129304700.0,-48.62001416809922,89.0859394939463,92.09290994229893,-41.50129816260833,20.4114079488813,30.01164158220224,0.1614028850921197,3.984274500044038,226.9353231201172,224.87234240722657,223.2050018310547,221.53766125488283,219.4746805419922,0.02,0.0,211.76555097538997,-0.02112011623051535,-0.014860948307889829,223.0271977015904,222.47261374337333,3.938253145240374
2023-06-14,0,223.80750274658203,219.66500091552734,233.39749908447266,223.88812446594238,229.47687435150146,0.38029886491132187,3.9412428690251184,-0.9608429682289152,2.995581340349119,225.18750190734863,3.3313374900817876,0.017392596760852978,222.67550239562988,232.4914981842041,0.7478631276756906,-0.029122042093265327,0.9876563755858173,0.994469074793202,0.9966645510757891,-0.006227521577786277,43.473375122136304,234.48711086774995,226.6046251296997,218.72213939164948,224.88142885480607,1.3403117335374575,224.61750030517578,2.2487816676330077,225.0232307418339,225.90826414534465,-1.8016154021263346,-0.9040823955753349,9160700,2.588052065311133,1.2625226196169446,120144000.0,-48.33686815892471,89.0859394939463,92.09290994229893,-48.5125269545218,19.33271463380822,28.517036628236305,0.14567773167984957,3.906111992158606,226.9353231201172,224.87234240722657,223.2050018310547,221.53766125488283,219.4746805419922,0.02,0.0,211.8052936760259,-0.008123603030077753,-0.020944784766619103,222.55608476911272,222.55679212297713,3.884046419880345
2023-06-15,0,224.16749954223633,219.66500091552734,233.39749908447266,223.80187606811523,227.89062595367432,0.596621790468091,3.8222910299506494,-0.6302612088703805,2.995589997796092,224.93249893188477,3.1530997467041004,0.016896120321547383,222.67550239562988,232.4914981842041,0.702099539131946,-0.0372007285004338,0.9909138301525263,0.9942386095105528,0.9995162214917646,0.0010941237759356515,40.678056119980155,233.8675822048598,226.2230001449585,218.5784180850572,224.39392852783203,0.6248221389535293,224.71857152666365,2.1895295424125996,224.73392429508806,225.49361092039607,-1.44112165672227,0.8221372165063414,12534000,2.5699044671486058,1.6420664569213022,132678000.0,-29.0163105923822,89.0859394939463,92.09290994229893,-20.69636343435833,20.270976419460393,25.620902396491704,0.18527484575914246,4.037104385087616,226.9353231201172,224.87234240722657,223.2050018310547,221.53766125488283,219.4746805419922,0.02,0.0,211.86397506117626,0.01398786991240919,0.003995148450294015,222.26605660574776,222.75414821079798,3.581438618533654
2023-06-16,0,227.81000137329102,219.66500091552734,233.39749908447266,223.80187606811523,227.2050018310547,0.8090483045887317,3.5647673701348754,-0.03423458559035675,2.9956081793475806,224.64749908447266,2.819962406158447,0.01578667496266821,222.67550239562988,232.45099639892578,0.6433846031613566,-0.0371639041488249,1.0088631519282205,1.0105845038845365,1.0155355049507773,0.01798603754466077,41.5791504463263,232.9381599615222,225.80862522125244,218.6790904809827,224.7653568812779,1.4364469699969853,224.94821439470564,2.3390642777791837,224.59143781992722,225.19811501883083,-1.4994737065481043,0.6352328639730029,13628500,2.5698206452512573,1.7071058114999946,146306500.0,-9.624912529265284,89.0859394939463,92.09290994229893,75.21754071870481,23.7155327196442,23.92506985142639,0.19529064400195711,4.014454159060144,226.9353231201172,224.87234240722657,223.2050018310547,221.53766125488283,219.4746805419922,0.02,0.0,211.94359638104407,0.023930941796753702,0.026272139482191575,222.78102547781808,223.030024937221,3.187962711408306
2023-06-20,0,227.30500030517578,219.66500091552734,233.39749908447266,223.80187606811523,227.2050018310547,0.8255953690948695,3.222905974410151,0.5467514879337143,2.9956305809933013,224.64749908447266,2.4943125152587924,0.014288582909835864,222.67550239562988,229.18124809265137,0.497269526271181,-0.023939835401404104,1.007744677774904,1.0087973798828211,1.009661084693518,0.009504138658082528,51.78090827325777,232.0039372539961,225.5581253051758,219.1123133563555,225.24857112339564,1.6575679667457555,225.25803593226843,2.343784515714029,225.39143332244691,225.42117283391627,1.1544773503178516,1.4314655869961244,12312300,2.7213293693948803,1.4782349258109113,133994200.0,-26.893147477819294,89.0859394939463,92.09290994229893,69.94047466994928,22.268986948011033,22.465743213533003,0.12132866802360585,3.969851336872798,226.9353231201172,224.87234240722657,223.2050018310547,221.53766125488283,219.4746805419922,0.02,0.0,212.01112510691203,0.001326394209264059,0.013016575347186326,223.2648686000279,223.37168666294642,2.6530732147901066
2023-06-21,0,226.74499893188477,219.66500091552734,232.40999603271484,223.80187606811523,227.13625144958496,0.5285138918765655,2.7155323819012342,0.734509230243793,2.9956597544277717,224.64749908447266,2.098300094604494,0.012055450314807079,222.67550239562988,227.91125106811523,0.331939771271185,-0.021965474010078576,1.0066214223674614,1.0062115736163058,1.0052624989927899,0.009101032538570308,51.05844192605546,230.6845651300134,225.25350036621094,219.8224356024085,225.67142868041992,1.5984770841606042,225.76375007629395,1.7267532730198183,225.8632663699378,225.49737541129446,1.5105671317551603,1.9453514748229552,7032100,2.7169878365266418,0.8291329010867476,126962100.0,-32.648694837415846,89.0859394939463,92.09290994229893,73.70512204549577,20.798034440498284,23.15341692202714,0.1510211643355883,3.947005466758553,228.08700427246097,226.73650427246096,225.64500427246097,224.55350427246097,223.20300427246096,0.02,0.0,212.048301869355,0.017233810477398137,0.004775291653444735,223.7869153703962,223.81167602539062,2.31192225981097
2023-06-22,0,227.2949981689453,219.66500091552734,228.8224983215332,223.80187606811523,226.83250331878662,-0.3224194496024638,2.2009867160228507,-0.19031807887640584,2.9956843630607928,224.64749908447266,1.7735255622863775,0.009783456750489661,222.67550239562988,227.6030017852783,0.40020029239475297,-2.2072250179938467e-05,1.010333578117523,1.0090261579613595,1.005876953651213,0.015582567070203002,53.57817424463384,229.37222394321515,224.97025051116944,220.56827707912373,225.9757140023368,1.6863251878269288,225.95678574698312,1.7367744549288224,226.0562980727745,225.44364629961757,1.322699444397605,3.2230887883136425,6275500,2.405127790492644,0.749923669230544,133237600.0,-20.324377111486793,89.0859394939463,92.09290994229893,90.02930879772352,20.042873256596497,21.702658660664184,0.2136626778418196,3.9100759816887356,228.08700427246097,226.73650427246096,225.64500427246097,224.55350427246097,223.20300427246096,0.02,0.0,212.08277023844062,0.022153591244950865,0.022336673652150366,224.10099138532365,223.94537026541573,2.4197179179448063
2023-06-23,0,228.2849998474121,219.66500091552734,228.8224983215332,223.80187606811523,227.13375091552734,-0.3169670642145891,2.226083212626935,-0.26123153798845644,2.995683276420657,224.64749908447266,1.8035002517700207,0.009893813088422854,222.67550239562988,227.6030017852783,0.4861699511695264,0.023932049318437724,1.0146112717482905,1.0124839099412946,1.0071493338635096,0.018367962856274733,59.48592350272298,229.44966665413574,224.99750022888185,220.54533380362795,226.48785727364677,1.776300830110952,225.91839299883162,1.673334944832448,226.34038100644858,225.6246904690031,0.9459717295127302,1.2032901385117658,5422500,2.127466741976554,0.6530952922940175,138660100.0,-4.799029976055653,89.0859394939463,92.09290994229893,112.22893145751318,20.650110779592612,20.27099647367853,0.22209024695883378,3.8872131499888627,227.86543774414062,226.5572789916992,225.5,224.4427210083008,223.13456225585938,0.02,0.0,212.11440504426022,0.014944586424562978,0.027345185175377915,224.97106715611048,223.99913242885046,2.486384959039562
2023-06-26,0,228.01000213623047,219.66500091552734,228.8224983215332,223.89375114440918,227.29749870300293,-0.4599343537686924,2.223064267488561,-0.036543095091409405,2.9956835228971133,224.93249893188477,1.842149963378904,0.009866576567931535,222.9459991455078,227.8575012207031,0.4776521894065634,0.02483697083251018,1.0119717082551356,1.0093113861702077,1.0022946371303934,0.0008779279300021869,61.7049818107323,229.75875365704744,225.3126251220703,220.86649658709317,227.08821432931083,1.3869085686188491,225.98482159205847,1.7401229616443443,226.82331787080398,226.07303754303777,1.5954619260612175,-0.23489756386009739,5165400,2.1307005067243474,0.6284201536316587,133494700.0,-41.85024543454766,89.0859394939463,92.09290994229893,66.0009758477149,19.17059528494386,19.16769577368558,0.1789022277703244,3.8881271503663304,227.9571256713867,226.63144540405273,225.56000518798828,224.48856497192384,223.16288470458986,0.02,0.0,212.14241719407283,-0.01140183914006343,0.0005748389490379862,225.3756866455078,223.96588570731026,2.432362268599307
2023-06-27,1,227.48749923706055,219.66500091552734,228.8224983215332,224.10624980926514,227.3737506866455,-0.6548332908848571,2.2156245644524732,0.2502819357776529,2.9956839307868575,225.18750190734863,1.8753001785278314,0.009822097538976352,223.70324630737304,228.03750190734863,0.534335257954576,0.01520515103616006,1.0084760939434632,1.0051186509242704,0.999821997112923,0.0008028812900717774,59.15340939272156,230.00674923571646,225.57550010681152,221.14425097790658,227.5625,0.5156415994375366,225.97821426391602,1.7337640664674097,227.1172101747395,226.39955390964965,1.877729449672177,0.40954742719602955,4628500,2.101826321338766,0.5646082081359207,128866200.0,-30.396577192147678,89.0859394939463,92.09290994229893,58.297766956824965,18.332765689150136,18.329992897814186,0.16824132286317997,3.775403608096835,227.9571256713867,226.63144540405273,225.56000518798828,224.48856497192384,223.16288470458986,0.02,0.0,212.16736096368643,0.003841652036920662,-0.006858577051229063,225.5412139892578,223.9036352975028,2.448244420291287
2023-06-28,1,227.38500213623047,219.66500091552734,228.8224983215332,224.10624980926514,227.51062488555908,-0.7913339683648228,2.241159070456466,0.30858198159076267,2.99568284992904,225.97750091552734,1.9218751907348632,0.009928928890947205,223.70324630737304,228.03750190734863,0.5377353035454745,0.02027201490131873,1.0073758470962426,1.003635891895908,0.999211223506562,0.0028225681155507054,58.568576807466066,230.20244314854233,225.7201250076294,221.23780686671648,227.50178582327706,0.5065837603494822,226.13357135227747,1.7569246243707537,227.2108790824979,226.46725815830857,1.4810352533725273,-0.04064618738460616,5324500,2.0659974794375797,0.6558764348259363,123541700.0,-24.513135126631813,89.0859394939463,92.09290994229893,47.878875525071024,17.60118229317819,18.576606323463213,0.2139163579231348,3.65144572795652,228.03972351074216,226.76514190673825,225.73500061035156,224.70485931396485,223.43027770996093,0.02,0.0,212.19568801837306,0.0031242817304777404,0.006579371690618085,225.4068145751953,224.0939200265067,2.272869662614586
2023-06-29,1,231.60250091552734,219.66500091552734,228.8224983215332,224.48624897003174,227.51062488555908,-1.046853474171094,2.1757185880393024,0.9771614686801455,2.995685750390559,226.91250038146973,1.8454002189636243,0.009629587309738119,223.8052520751953,228.03750190734863,0.404535834706391,0.0351444298751619,1.0250574297522552,1.021041113274214,1.01717228545126,0.018951155024451216,62.33208516494607,230.29243735155467,225.94100017547606,221.58956299939746,228.11571448189872,1.6165056748036188,226.68214280264718,2.165028363646129,227.264829108588,226.5877524823578,-0.18655863855781302,0.9657649345328273,7118900,1.8937724141162924,0.955421107869216,130660600.0,-2.850634447312542,89.0859394939463,92.09290994229893,224.5714174563389,27.661694537377297,16.266904198503884,0.1630606136128303,3.8720560498435965,231.55411651611328,229.6079362487793,228.03499603271484,226.46205581665038,224.5158755493164,0.04,0.0,212.24632226196084,0.02596435250489848,0.031111011669273752,226.51739719935827,224.89113289969308,2.587809423815508
2023-06-30,0,236.99499893188477,223.78499603271484,231.60250091552734,224.67312240600586,227.63750171661377,0.4055072423049864,2.002676410369618,-0.1128293558233846,2.9956932428057956,227.1875,1.69530029296875,0.008840360177380257,223.9110008239746,228.33874969482423,0.4126988604378112,0.031212093789112143,1.046160597861654,1.041236235617791,1.036932182529443,0.03815405782374892,70.92434509529677,230.5432279962153,226.53787517547607,222.53252235473684,229.58000019618444,3.597046154678323,227.62571443830217,3.3561938113714205,228.37203495451467,227.3866694202891,1.8906317963009227,3.4297581905535166,6879100,1.8093122011966207,0.9240097329222206,137539700.0,-4.730945467211375,89.0859394939463,92.09290994229893,316.96437761290895,32.237663557844606,15.080519431534341,0.1352509316134963,3.878337150217493,234.28923791503905,231.8203773803711,229.8249969482422,227.82961651611328,225.36075598144532,0.06,0.0,212.30628050963966,0.034545702774497755,0.03980023715883806,227.96468244280135,225.87579890659876,3.487823473963525
2023-07-03,0,237.19499969482422,223.78499603271484,236.99499893188477,225.04874992370605,227.86000156402588,1.6557678943956629,2.984041751763097,3.4798336777924908,2.9956466007195024,227.29999923706055,1.9839501190185558,0.01313641495944562,223.9110008239746,229.10049858093262,0.5072489753592653,0.035715459232806106,1.0441851024556839,1.0362747474322578,1.02995709436258,0.040283309822110036,78.54817424149522,233.12608368663163,227.15800018310546,221.18991667957928,230.99428612845284,4.404505201980221,228.48500006539481,4.128804855271443,230.53382344733183,228.66306333912095,4.5204966143836085,5.902988642383678,3087400,1.9528092138818367,0.4226750068109353,140627100.0,-2.524913133311634,89.0859394939463,92.09290994229893,247.9310668566738,30.432884766339743,15.247323291155165,0.1544637490692341,3.8148837990858797,234.38091418457034,231.894534362793,229.88499450683594,227.8754546508789,225.38907482910156,0.08,0.0,212.33312195504612,0.051568726028661915,0.036680448138118646,229.32001604352678,226.71050371442522,4.192415880847552
2023-07-05,0,236.9625015258789,223.78499603271484,237.19499969482422,225.04874992370605,227.86000156402588,1.5332376952902682,3.6915848202935315,1.7239807234269948,2.995601772624659,227.29999923706055,2.444112796783449,0.0162212829028882,223.9110008239746,232.1417507171631,0.6959623893826891,0.04454376335303622,1.0412427078735578,1.031031571068306,1.0208048891754467,0.04165065034604232,81.03212377661302,234.95979489235708,227.57662525177003,220.19345561118297,232.23392922537667,4.724410973317278,229.36089324951172,4.543909890118915,232.19247821792163,229.65284086008475,4.3555738602397085,5.342748087128353,7601200,1.8860968542140502,1.0214545500967878,133025900.0,-2.952243197022612,89.0859394939463,92.09290994229893,197.24659190393356,30.021024603681933,13.59929113912438,0.19442350360785213,3.971677421068049,235.60331884765625,232.88333813476564,230.68499755859375,228.48665698242186,225.76667626953125,0.1,0.0,212.4004218389131,0.053268116271078636,0.058108579556858934,230.72061593191964,227.84584154401506,4.897152687818684
2023-07-06,0,238.36000442504883,223.78499603271484,237.19499969482422,225.04874992370605,228.07875156402588,1.2276909487617111,4.2161642419882055,0.34630909507877794,2.995562664292625,227.34500122070312,3.068624973297119,0.018486212009282247,223.9110008239746,236.9657512664795,0.7861125250806859,0.04122725907080962,1.045114308511142,1.0327724313868196,1.0185106216876476,0.048266166131058386,79.54516415439556,236.50307872048762,228.07075023651123,219.63842175253484,233.71250098092216,4.801117413553134,230.4003576551165,4.831225123555336,233.38303254306726,230.53743489186985,3.801170328434598,5.457278479830726,6441800,1.8938348575491812,0.8632077431146928,139467700.0,-6.011781125300589,89.0859394939463,92.09290994229893,162.7385743763871,28.419293907190998,12.873719565348674,0.20223184577583508,3.8958435811424166,235.60331884765625,232.88333813476564,230.68499755859375,228.48665698242186,225.76667626953125,0.1,0.0,212.45846681300932,0.047903051489448956,0.05076093726596646,232.50037275041853,228.93802969796317,5.404579576952203
2023-07-07,0,236.9375,223.78499603271484,238.36000442504883,225.04874992370605,229.11437511444092,1.0081053420554502,4.771468920945383,-0.4110808840478555,2.9955159476194093,227.34500122070312,3.806625366210935,0.020871677228560665,223.9110008239746,237.0149990081787,0.8070218598187151,0.05838995318412375,1.0364277972415823,1.021468346209717,1.0030246796376483,0.02303515317573579,84.86901570644817,238.1526882081017,228.60975036621093,219.06681252432017,235.0625010899135,4.024856941854638,231.31250054495675,4.769028406042334,234.61993409137807,231.49274244553254,4.539275554514702,6.5022403180757715,5729200,1.777250364769945,0.7823323861192397,133738500.0,-23.635166724064845,89.0859394939463,92.09290994229893,115.63627181201194,26.955642937140617,13.25946081854821,0.16025846757749376,3.8139976110608047,236.4552789916992,234.26235836791992,232.48999786376953,230.71763735961912,228.52471673583983,0.1,0.0,212.5071310524519,0.009090176215619028,0.03724335200847309,233.7892129080636,229.66521344866072,5.563894841233081
2023-07-10,0,237.69250106811523,223.78499603271484,238.36000442504883,225.04874992370605,232.9362506866455,0.7508593604773461,5.031176477633622,-0.9724881447401978,2.995492626618619,227.4362506866455,4.287575416564937,0.02195140285542271,223.9110008239746,237.0149990081787,0.8447216485313318,0.05812278513402228,1.0370703293463661,1.0204811059710095,1.0016962373089255,0.002943109092487406,78.21992054504823,239.25847817651967,229.19612522125243,219.1337722659852,236.5350009373256,2.2357683061051703,232.01839338030135,4.939076024516608,235.18786055386653,232.2050590813397,4.1540747490005066,5.696633313857178,4858900,1.7854017265301478,0.6698452458826554,138597400.0,-12.25030502330994,89.0859394939463,92.09290994229893,109.80606138472143,26.85163894272044,12.586737061149943,0.1939432297994107,3.730855578504552,236.4552789916992,234.26235836791992,232.48999786376953,230.71763735961912,228.52471673583983,0.1,0.0,212.5497849230705,0.002863568814116091,0.016387922392164956,235.23226056780135,230.31953757149833,5.6476200770028555
2023-07-11,0,239.5449981689453,223.78499603271484,238.36000442504883,226.3499994277954,236.94375038146973,0.5500054855851558,5.201689030238113,-1.3190931824397107,2.995477299878364,227.64875030517578,4.655262985229496,0.022627389825282347,224.1314998626709,237.24474983215333,0.8445903221288243,0.06214672691178666,1.0420227012334784,1.0242973587601953,1.00890999987031,0.009907453686395673,79.59733353931117,240.28800330461686,229.88462524414064,219.4812471836644,237.6696434020996,0.9755845872043003,232.89267894199915,5.120551259714285,235.81041678592265,232.86018014271266,4.53306015570427,4.338044701834968,3857100,1.7748534270086396,0.5411673590679311,142454500.0,-0.9541595727539378,89.0859394939463,92.09290994229893,116.69262158426119,28.627672810126207,11.951007032162266,0.23647210621016612,3.6486517394009805,236.99007666015623,234.6949564819336,232.83999633789062,230.98503619384763,228.689916015625,0.12000000000000001,0.0,212.5860309058013,0.010841685314332494,0.012927518347413918,236.1136518205915,231.3155245099749,5.838388882011886
2023-07-12,0,242.23500061035156,223.80750274658203,239.5449981689453,227.15749835968018,236.97062587738037,0.40608709061793324,5.4076326636926435,-1.49715699904215,2.995458323544984,227.91000175476074,4.990900192260744,0.023442888619598062,224.6467472076416,237.7592514038086,0.8455909769599548,0.06386426484999218,1.0501246094624712,1.030715961050576,1.0182240801424327,0.02225035206212511,81.74760771073268,241.48789067833746,230.67262535095216,219.85736002356686,238.41821507045202,1.9224730687263845,233.99910763331823,5.358006302622609,236.74522031267003,233.56865012304797,3.4293659274063044,5.38483440634228,6116000,1.7870273340532088,0.8734503789212259,148570500.0,-9.430842938653042,89.0859394939463,92.09290994229893,130.53398557405916,33.10642630787535,11.151648792104295,0.17916399424158813,3.6308904649069356,239.59579766845704,236.90209811401368,234.7249984741211,232.5478988342285,229.85419927978515,0.14,0.0,212.64893544583492,0.011526632619495825,0.01781745874760331,236.7828369140625,232.37375967843192,6.190594874707995
2023-07-13,0,243.62999725341797,223.80750274658203,242.23500061035156,227.30249977111816,237.04499912261963,0.3222552642280125,5.803598757439776,-1.4398441875921637,2.9954188986530466,228.1475009918213,5.378987731933594,0.02506671222966759,224.6467472076416,238.47850379943847,0.821969527610955,0.07803740053520526,1.0522786441494454,1.0301871804134912,1.019568604761605,0.022109383833420093,85.41495048433079,243.1333228505729,231.52612533569337,219.91892782081382,239.3375004359654,2.643426904122988,235.1658932822091,5.560551429933107,238.1152514815724,234.54762003099546,2.2110178282592523,6.8314634287127385,5819600,1.812183488906052,0.8373934839977784,154390100.0,-5.260310760916251,89.0859394939463,92.09290994229893,126.84299373904311,32.371605588620824,10.685314332887572,0.18319033050837458,3.5186838287416986,239.96300427246098,237.29850427246097,235.14500427246097,232.99150427246096,230.32700427246095,0.16,0.0,212.71077197704886,0.018544874066027228,0.01612034959350849,237.53831263950892,233.42916434151786,6.326030818036994
2023-07-14,0,243.64750289916992,223.80750274658203,243.62999725341797,227.3650016784668,237.31937503814697,0.25591950253077017,6.146647914953923,-1.3847481890518496,2.9953834518620717,229.94375038146973,5.7298873519897455,0.026440308426313164,226.48724899291992,239.81399841308595,0.8151863172647434,0.08856939228387269,1.0480696491956747,1.023232433981593,1.0151640923960725,0.02831971679945111,87.8577290710439,244.76592118085995,232.47262535095214,220.17932952104434,240.29250063214982,2.842462505515733,236.26321492876326,5.613787414473009,239.4923894690667,235.65078385777622,2.712956667245531,7.186695358923416,4940600,1.7628925471897128,0.7331730144962162,159330700.0,-8.440180171074793,89.0859394939463,92.09290994229893,110.45644024894962,30.516954583619924,12.525550149897489,0.21143328699736788,3.4659206109242082,240.32208520507817,237.5889650268555,235.38000488281253,233.17104473876955,230.4379245605469,0.18,0.0,212.7625834977435,0.028378046574475624,0.01791696344876504,238.06318882533483,234.39190237862724,6.290369295226737
2023-07-17,0,243.86750030517578,224.16749954223633,243.64750289916992,227.46187496185303,237.85937690734863,0.1780456071884279,6.2679257732295675,-1.4472619202717392,2.9953723887611234,234.27000045776367,5.855375099182129,0.026847432511895853,227.23999824523926,242.3745002746582,0.8283607872488488,0.08689932035961032,1.0445586774896467,1.0190017542984864,1.0104309107320315,0.025978940056215594,87.79965523838017,246.00047690504067,233.46462535858154,220.92877381212242,241.07928575788225,2.9774268478205195,237.39589336940222,5.416769596087667,240.53639016832548,236.6490358779295,2.821122046840369,6.72952802944839,4328100,1.7715170752697145,0.6839212687015277,163658800.0,-7.131732697431733,89.0859394939463,92.09290994229893,109.2259794825529,30.32031388915609,11.899629981695046,0.1529191396708247,3.387640218514437,240.80339727783203,237.97829861450197,235.69499969482422,233.4117007751465,230.58660211181643,0.19999999999999998,0.0,212.80906292319165,0.02447928200627425,0.03188832228773874,238.786128452846,235.64325060163225,6.3804590393456815
2023-07-18,0,241.18249893188477,226.74499893188477,243.86750030517578,227.7293758392334,238.65625286102295,0.09263091301458155,6.277406419775782,-1.526561031470917,2.9953740548065553,236.95000076293945,5.812162551879882,0.026775075495016662,227.30400009155272,243.63174781799316,0.8736475904864882,0.0704863651072669,1.028717783292522,1.0048967201360708,0.9942185175653502,0.006835879586116755,87.17122890107527,247.00443823628007,234.44962539672852,221.89481255717698,241.68571417672294,2.3619342183043397,238.37410763331823,4.675661783686078,241.37806395319365,237.62866992126825,2.3105788630150657,6.954737959026394,7674700,1.6671626725257813,1.272611500878012,155984100.0,-23.772573752820005,89.0859394939463,92.09290994229893,62.55580209527201,26.520431194239276,20.97450472916475,0.10940831669635626,3.5963811184336256,240.80339727783203,237.97829861450197,235.69499969482422,233.4117007751465,230.58660211181643,0.02,1.0,212.88176742495043,0.0009144779597169972,0.010958867951114655,239.39729745047433,236.59325517926897,6.345677996265613
2023-07-19,0,241.34499740600586,226.74499893188477,243.86750030517578,227.879376411438,239.95437335968018,-0.10568396332162629,6.246688808884725,-1.517327204187839,2.995378944675818,236.97875022888184,5.683100051879881,0.02656828553967005,227.30400009155272,243.63174781799316,0.8903439450720454,0.061052324445468834,1.0264834700159335,1.0039058795753044,0.9935470484475104,-0.0036741313274430976,71.93855720000147,247.61162789242763,235.1182502746582,222.62487265688878,242.20749936785018,1.6195121691893442,239.3712501525879,3.4900871937920663,241.32878451104344,238.04116544642096,1.7916112611489383,6.020110881149082,4835500,1.8237908759027193,0.8548073744482334,160819600.0,-23.553962647333353,89.0859394939463,92.09290994229893,67.6850556785459,25.189639566400285,19.922006936530632,0.20909534428326165,3.5159254114528715,241.41227770996093,238.96385931396483,236.98500061035156,235.00614190673826,232.55772351074216,0.02,0.0,212.9287541246792,-0.003261784009783608,0.003616662010048031,239.85850306919642,237.5453818184989,6.106872224938879
2023-07-20,0,240.3650016784668,226.74499893188477,243.86750030517578,228.2162504196167,241.22312355041504,-0.30142069089367785,6.11674688998767,-1.4075119636268516,2.995394941872056,237.0949993133545,5.393174953460695,0.025938174887964443,227.37600173950196,243.63174781799316,0.8757637665824812,0.06438950602172708,1.0192721004505232,0.9980101313270623,0.9902383151677243,-0.013401451429460032,72.99558927818377,248.05374390967503,235.8202501296997,223.58675634972437,242.32464272635323,1.411071999877968,239.99714306422644,2.681832070900454,241.3230675572378,238.42690135133896,1.5366476945959409,6.139365014677487,4695000,1.8039132924743762,0.8474767485412841,156124600.0,-50.52728684270171,89.0859394939463,92.09290994229893,48.12680821514343,23.86351599320798,21.0494757694954,0.174007042719437,3.446215973930005,242.68431756591798,241.02283908081057,239.68000030517578,238.33716152954102,236.6756830444336,0.02,0.0,212.97218682986727,-0.015165804747736322,-0.010693308015146383,239.72693089076452,237.92029135567802,5.771470908819613
2023-07-21,0,239.5175018310547,227.2949981689453,243.86750030517578,230.77312564849854,241.22312355041504,-0.4892461079742689,5.8194123797820465,-1.186712234822078,2.995428268492295,237.44375038146973,4.89424991607666,0.024606264758479986,227.47724952697754,243.63174781799316,0.8720023764284842,0.0575023806718647,1.012753638979161,0.9936640478493637,0.9894085322071281,-0.01695072191987279,67.43095315538027,248.14007502659288,236.5012502670288,224.86242550746474,241.9364286150251,1.768416337503456,240.17732184273856,2.5459105544242098,241.0656016336148,238.6263223250768,0.3423171077624237,3.7834223414260153,5426800,1.8455352756296295,0.9871324265034906,150697800.0,-53.77856500209855,89.0859394939463,92.09290994229893,35.19821526217061,23.030718443509198,21.047338592864886,0.11857494516542363,3.3157727169333224,242.68431756591798,241.02283908081057,239.68000030517578,238.33716152954102,236.6756830444336,0.02,0.0,213.02100557553385,-0.016079948902454677,-0.016686514074350362,239.30815996442522,238.04549843924386,5.43991807453988
2023-07-24,0,239.9724998474121,227.38500213623047,243.86750030517578,235.60375022888184,241.22312355041504,-0.6837988314138851,5.450616593261348,-0.8150152461252667,2.9954666253152573,238.02625274658203,4.323399887084963,0.022987482550895517,227.95775184631347,243.63174781799316,0.8677597925238794,0.04920385479181939,1.0120623159877176,0.994487215053444,0.9946819857663632,-0.01597178981573788,62.484834103088374,248.01360863665695,237.11237545013427,226.21114226361158,241.4139289855957,1.724411904028398,240.37571471078056,2.399651538793485,240.66694835886804,238.6954260883032,-1.1218439830947975,1.0643696746929752,6010000,1.8750785434079131,1.0874059036551131,156707800.0,-40.685358923784946,89.0859394939463,92.09290994229893,40.49244994280834,23.503375922429406,19.63947755756687,0.11600787844726021,3.299645832715986,242.68431756591798,241.02283908081057,239.68000030517578,238.33716152954102,236.6756830444336,0.02,0.0,213.07613831403867,-0.013320178038526032,-0.00995223545424464,238.94457135881697,238.24144199916296,5.16298842928284
2023-07-25,0,239.5175018310547,227.38500213623047,243.86750030517578,236.95625114440918,241.22312355041504,-0.9170351596179885,5.087299350630884,-0.2269855493474786,2.9955016926474594,238.93875312805176,3.900324840545653,0.021402477488635815,227.95775184631347,243.63174781799316,0.8332859554251056,0.05246479364547498,1.0076599759040559,0.9916646304330853,0.9960120922079556,-0.006903473959361861,64.17351027313208,247.87134915139606,237.6967504501343,227.52215174887252,240.8239288330078,1.5282048702773017,240.55821473257882,2.2097419809212067,240.48733964211752,238.85148160061954,-1.5012508505680522,1.1709775316349125,4997500,1.864385036193621,0.9055870052115422,151710300.0,-72.2943694348297,89.0859394939463,92.09290994229893,20.553289839752967,22.336936949112946,18.66479834066091,0.12056124781380957,3.2239572370337015,243.189357421875,241.84031884765625,240.75,239.65968115234375,238.310642578125,0.02,0.0,213.12059378456965,-0.008638871125218883,-0.02172221324447447,238.31217738560267,238.18768310546875,4.388810419771912
2023-07-26,0,233.76250076293945,227.38500213623047,243.86750030517578,236.9868745803833,241.22312355041504,-1.1563701107442912,4.585156534358856,0.6932120246894673,2.995545703509996,239.5175018310547,3.3919499969482443,0.019243361035162592,231.19100074768068,243.63174781799316,0.7724379529513726,0.05288203806512417,0.9810736372804607,0.9678484503323843,0.9734283886839575,-0.03141766651293232,62.42738337419589,247.4424385035932,238.27212543487548,229.10181236615776,239.38035746983118,2.582815384798427,240.22982161385673,2.8191417996409633,240.24362231243967,238.9906149935543,-1.6950721919872813,1.0782297995350743,7551400,1.8622492192258917,1.3330708876870918,144158900.0,-46.74950747499438,89.0859394939463,92.09290994229893,-98.04810692039817,17.636540664535726,35.233944733036665,0.1720158328228162,3.7915326792266337,241.19515454101563,238.6124141845703,236.52499389648438,234.43757360839845,231.85483325195312,0.04,0.0,213.17522515121092,-0.017894075111767882,-0.015242668798435182,237.33741324288505,238.06177084786552,3.5498593240080067
2023-07-27,0,235.87000274658203,227.38500213623047,243.86750030517578,236.9868745803833,241.22312355041504,-1.058485381686831,4.015799914955445,1.0495924745996943,2.995589751980164,239.5175018310547,3.0380370140075685,0.01683167499480683,233.54650077819824,243.63174781799316,0.6041607832828638,0.02804713840751955,0.9886167915063343,0.9800119140289105,0.9884464103816726,-0.018700721404930953,41.255994052931094,246.6174753410803,238.58587551116943,230.55427568125856,238.62142944335938,2.740702040838714,240.15357181004114,2.9273974896918946,238.6362599457898,238.49410949165775,-4.143643384047047,-1.9288066692224946,8160100,2.344952451888033,1.4053521560955111,152319000.0,-61.78627002446236,89.0859394939463,92.09290994229893,-104.68121794543826,15.808419715920714,31.581759551487426,0.09268253408916118,3.9278515555848923,241.19515454101563,238.6124141845703,236.52499389648438,234.43757360839845,231.85483325195312,0.04,0.0,213.23617385345528,-0.0216175244233362,-0.02891219090349212,236.44187927246094,237.91958836146765,2.688056790517103
2023-07-28,0,234.9800033569336,231.60250091552734,243.86750030517578,236.9868745803833,241.22312355041504,-0.38164606430867537,3.168987360997602,-0.23730722776449742,2.9956442202322275,239.5175018310547,2.571361980438232,0.01325879961702661,235.65925254821778,243.63174781799316,0.6066573603032012,0.018425974737687218,0.9831382784490003,0.9794720719363559,0.9884405790203603,-0.018944329493389755,45.025711707931,245.34810026368223,239.01012554168702,232.6721508196918,237.71214457920618,2.742360747192365,239.9598219735282,3.1815444262260493,237.96405781266697,238.39891413303323,-2.202687263308894,-0.450539595217291,6794800,2.2042263257457537,1.1734919450661803,145524200.0,-54.38097111095009,89.0859394939463,92.09290994229893,-122.18654934358155,15.163991594414268,30.29433333511891,0.0907716087425692,3.8022905993963456,241.19515454101563,238.6124141845703,236.52499389648438,234.43757360839845,231.85483325195312,0.04,0.0,213.28612200364148,-0.014629040161676321,-0.016150578321119442,235.63971601213728,237.74910954066686,2.564423747073423
2023-07-31,0,237.0374984741211,233.76250076293945,243.86750030517578,236.9868745803833,241.22312355041504,0.03506796916300468,2.8429581773930486,-0.8671145053213141,2.995661637515966,239.5175018310547,2.3855993461608875,0.011886320159810922,235.7810028076172,243.63174781799316,0.7297011131650825,-0.008502270444661602,0.9910464456173274,0.9916310277514413,1.0009162921435044,-0.012230573816405022,37.588164989551444,244.86491701854345,239.17900066375734,233.49308430897122,237.23678697858537,2.4819010672326463,239.78071485246932,3.2758757955650144,237.22712287460405,238.1521358941934,-2.637301007886511,-1.1411793384278133,4799600,1.8463553420505978,0.8440689978395308,150323800.0,-43.188232533907616,89.0859394939463,92.09290994229893,-55.35456707172866,19.26211859944646,28.741815823439275,0.09161702856752886,3.72141256864984,241.19515454101563,238.6124141845703,236.52499389648438,234.43757360839845,231.85483325195312,0.04,0.0,213.32492128556862,-0.012503169697778871,-0.006353180579905112,235.37232753208704,237.54962921142578,2.5549915799127265
2023-08-01,0,238.6624984741211,233.76250076293945,243.86750030517578,237.01874923706055,241.22312355041504,0.03418423830149525,2.8413403678630273,-0.8636776832308488,2.995661718884573,239.5175018310547,2.383261871337891,0.01187945060568577,235.7810028076172,243.63174781799316,0.7593327231635636,-0.000664015771436019,0.9978316551301512,1.0012900832228808,1.010282187010085,-0.0035696905253156386,45.391213952360275,244.86380637659516,239.18112564086914,233.49844490514312,237.11464364188058,2.3694428850295366,239.52553612845284,3.2084380541410713,237.17038569011152,238.1069687370622,-1.3843542866514575,-1.0467760604442844,4627300,1.9081157457864306,0.8028962774540798,154951100.0,-31.59974882087271,89.0859394939463,92.09290994229893,-5.323602430412856,22.316372052594392,26.684432861594573,0.091007621695024,3.7220256514276393,241.19515454101563,238.6124141845703,236.52499389648438,234.43757360839845,231.85483325195312,0.04,0.0,213.36497877624586,0.004566578196462778,-0.003987771014760382,235.44730922154017,237.3777345929827,2.5310283860747322
2023-08-02,0,237.94249725341797,233.76250076293945,243.86750030517578,237.01874923706055,241.22312355041504,-0.025611445562835664,2.807854180260564,-0.7738092397478407,2.9956633980793,239.5175018310547,2.3025494384765635,0.011735846863719267,235.7810028076172,243.63174781799316,0.7546665173160606,0.007174118003039942,0.9945162856989676,0.9993259077499268,1.0079639776940534,0.017881381645200145,50.93053086869487,244.8702089403551,239.25450057983397,233.63879221931285,236.82464327130998,2.0661903558088945,239.11928612845284,3.0022022146944285,237.534299169919,238.2766814164997,-0.3569690525315667,-1.4748083997890282,4868200,1.9414180761789082,0.8652101354101315,150082900.0,-44.149216962871726,89.0859394939463,92.09290994229893,-50.47491626797987,21.017601521777372,25.54021101473982,0.028084318225872557,3.6697384972659535,241.19515454101563,238.6124141845703,236.52499389648438,234.43757360839845,231.85483325195312,0.04,0.0,213.40461649093692,0.001939983652487376,-0.004734283413295749,234.9974125453404,236.9709919520787,2.5700540901231093
2023-08-03,0,237.26499938964844,233.76250076293945,243.86750030517578,237.5287504196167,241.22312355041504,-0.05660367023764062,2.775796961559242,-0.6877939891851939,2.9956649813286447,239.5175018310547,2.248649673461915,0.01159948332269016,235.7810028076172,243.63174781799316,0.7629055080193012,-0.0017515823287465265,0.9914815246185579,0.9979065213762366,1.001547073233975,0.005914260511393543,47.52348011117509,244.8550942893294,239.30350036621093,233.75190644309245,236.50285720825195,1.7239710899618714,238.66339302062988,2.7343362099752913,237.6334384159826,238.35794776523878,-0.845931344335259,-2.334482643401256,5033800,1.9238297410321281,0.9059772758769017,145049100.0,-37.365741651226905,89.0859394939463,92.09290994229893,-49.319934185993844,19.466985785714662,26.645825536512852,0.037541305044463506,3.6790431083010864,241.19515454101563,238.6124141845703,236.52499389648438,234.43757360839845,231.85483325195312,0.04,0.0,213.44542225597715,0.018426835291461607,0.007001240035107251,235.00731549944197,236.65974644252233,2.5716322091411796
2023-08-04,0,239.18500137329102,233.76250076293945,243.86750030517578,237.2081241607666,241.22312355041504,-0.013605925839943342,2.8045171177504846,-0.7710963350075608,2.995663561627602,239.5175018310547,2.308874950408935,0.011722180853229066,235.7810028076172,243.63174781799316,0.7519390929935308,0.0013822184738525455,0.9997335461893974,1.0072951396590197,1.0084641333550133,0.01789513131451459,46.47214766588141,244.85778434994188,239.24875011444092,233.63971587893997,237.2775001525879,1.4897594856421885,238.32892881120955,2.300818298587652,237.53878746858243,238.45702417590664,-0.9404333396041631,-2.619564507567637,5167700,1.9023574070199596,0.934799891826086,150216800.0,-27.032175371723604,89.0859394939463,92.09290994229893,4.874487516580628,23.451166458189935,24.556157179544417,0.05486763808359801,3.7069691237237734,239.52199267578126,237.25899267578126,235.42999267578125,233.60099267578124,231.33799267578124,0.02,1.0,213.49043178268948,0.013743397668701363,0.01940793138110897,235.2747039794922,236.3060586111886,2.4773439050321704
2023-08-07,0,240.52999877929688,233.76250076293945,243.86750030517578,237.58562564849854,241.22312355041504,-0.10728926189145443,2.754232642356646,-0.6210858531104004,2.9956660419089816,239.5175018310547,2.1852623748779307,0.011506599662955816,235.7810028076172,243.63174781799316,0.7538239619193728,0.006279122389090758,1.0048833059056572,1.0131012761114686,1.0105516999603112,0.014733956980047536,52.4391359120988,244.86959046781874,239.36112518310546,233.85265989839218,237.94321387154716,1.7706766611439944,238.28232165745325,2.2444868928173096,237.9641350091578,238.76810811749428,2.319662303685982,-1.9200996139399824,5649800,1.943478928640716,1.0147494108856832,155866600.0,-7.243471266203233,89.0859394939463,92.09290994229893,45.0936719914929,22.520658985069442,23.03157692318692,0.070240211834128,3.670041842216157,239.07123547363284,236.89437493896486,235.13499450683594,233.37561407470704,231.19875354003906,0.04,0.0,213.54206925054245,0.01590028026149426,0.024432547205819027,236.2749285016741,236.3584038870675,2.487947942294533
2023-08-08,0,239.61499786376953,233.76250076293945,243.86750030517578,237.7731227874756,241.22312355041504,-0.24964616940964238,2.7376571950132464,-0.5325570523524643,2.9956668788557312,239.53125,2.1318998718261697,0.011430575793323553,235.7810028076172,243.63174781799316,0.7621136857307784,0.004111964841181386,1.0004676258546776,1.0090104026311335,1.0037617715260048,0.003990988930972383,55.20300859581654,244.97831445869105,239.50300006866456,234.02768567863808,238.60535594395228,1.2752120950591286,238.15875026157923,2.1062661645704703,238.6200207648082,239.21323337540244,1.9756628560018836,-0.2705420814020884,5080600,1.9222868015728958,0.9025991964618026,150786000.0,-19.9310302734375,89.0859394939463,92.09290994229893,-6.919435812885424,20.730498073638703,24.71226073483508,0.03726608332094117,3.702181361856966,238.75799267578125,236.64099267578126,234.92999267578125,233.21899267578124,231.10199267578125,0.04,0.0,213.58560573790248,-0.0020435399571435697,0.006562054374696313,236.77575029645647,236.20773315429688,2.4831069682536397
2023-08-09,0,240.43000030517578,233.76250076293945,243.86750030517578,237.7731227874756,241.22312355041504,-0.2534518581948412,2.7377533948109107,-0.5316174426214086,2.9956668752209037,239.5662498474121,2.1346998596191384,0.011430810413080394,235.7810028076172,243.63174781799316,0.7621266995434992,-0.010815954506906502,1.0038558462988023,1.012400785142876,1.0063727651082444,0.010454219319672609,49.68945852912279,244.9820068430276,239.50650005340577,234.03099326378396,239.0899990626744,1.2236552248540653,238.16339302062988,2.1115683690135985,238.8824912212593,239.35601719413026,1.9725059326837275,-0.7168159940460722,4055000,1.8281344749589161,0.733829731595668,154841000.0,-16.689642544450628,89.0859394939463,92.09290994229893,32.54832744625761,20.837609602257995,23.408753841472816,0.024720847511430284,3.629168974193632,238.75799267578125,236.64099267578126,234.92999267578125,233.21899267578124,231.10199267578125,0.04,0.0,213.62167387658667,0.0092609173604552,-8.340717138446056e-05,237.06294468470983,236.21763610839844,2.413750431706674
2023-08-10,0,241.20499801635742,233.76250076293945,243.86750030517578,237.7731227874756,240.69312381744385,-0.22134374150037633,2.675360808719591,-0.3832527711716742,2.995669783757629,239.5662498474121,2.062499847412107,0.011174516384302722,235.7810028076172,243.63174781799316,0.7158167634387499,-0.01313465904986088,1.0074712889284894,1.0128205995432107,1.0075186336023176,0.016605899044715544,51.39866524776356,244.7669716555862,239.41625003814698,234.06552842070778,239.45321328299386,1.4347464635401688,238.28392846243722,2.239122765771735,239.27681808394644,239.45426188852323,1.4312089238593904,0.02704163511954715,4778000,1.8070037643774126,0.8728973413900041,159619000.0,-23.294359501477754,89.0859394939463,92.09290994229893,74.07269013620606,22.992401570478755,21.499385242133652,0.02086512920560893,3.6692285075659643,240.1102759399414,237.7348553161621,235.81499481201172,233.89513430786133,231.51971368408203,0.06,0.0,213.6656200942827,0.007755028052057966,0.012845658879317955,237.18059430803572,236.31395176478796,2.2681380056995035
2023-08-11,0,239.7949981689453,233.76250076293945,243.86750030517578,237.7731227874756,240.69312381744385,-0.3297629743172614,2.5327952128726823,-0.18995371645337666,2.9956761906173495,239.5662498474121,1.9654998779296875,0.010584405073508248,235.7810028076172,241.57524795532228,0.665740709266559,-0.01002474826849876,1.0020894631834847,1.0046494236382584,0.9983429945924883,0.002550313741045418,54.12887605599715,244.36059050203932,239.29500007629395,234.22940965054858,239.71785627092635,1.2711731521616898,238.27124977111816,2.229307028054734,239.7581142989647,239.60498608874468,1.0653117094188214,0.7045398237716346,3606800,1.8189826504792184,0.6670568990213676,156012200.0,-24.031976861417032,89.0859394939463,92.09290994229893,21.55815538323405,21.934749137511492,23.850409785652406,0.040998475106366186,3.5714266892939515,240.1102759399414,237.7348553161621,235.81499481201172,233.89513430786133,231.51971368408203,0.06,0.0,213.69670609348228,0.006282147070528765,0.007251543639198501,237.5953151157924,236.2963638305664,2.1143531320755367
2023-08-14,0,241.80249786376953,233.76250076293945,243.86750030517578,237.7731227874756,240.45499992370605,-0.49780331993211285,2.333073717670608,0.09213441194109873,2.9956845884062284,239.5662498474121,1.8196623420715299,0.0097576350683842,235.7810028076172,241.21899795532227,0.5944271549136299,-0.016699650962650373,1.0112927486638144,1.0110205497506304,1.0061897894245508,0.005290396586416168,48.5393063276796,243.76852227512396,239.10237483978273,234.4362274044415,240.36607033865792,0.9204383415889974,238.43446377345495,2.404341478314711,239.7645819572145,239.54190294919084,0.7785498332205695,-0.07396750818517218,4351100,1.838850361700189,0.8045397855287865,160363300.0,-6.453612636937339,89.0859394939463,92.09290994229893,123.87547167911686,25.73281903357305,22.27216497953325,0.07653215237118996,3.5513253932673745,240.1102759399414,237.7348553161621,235.81499481201172,233.89513430786133,231.51971368408203,0.06,0.0,213.73760969070378,0.007646755971007835,0.01827162107980697,238.24564034598214,236.62647792271204,2.0455728746050807
2023-08-15,0,240.9650001525879,233.76250076293945,241.80249786376953,237.7731227874756,240.45499992370605,-0.9242023524567419,2.1591166171756746,-0.0387490852589778,2.9956913518041435,239.5662498474121,1.7473872566223179,0.009033993826236222,235.7810028076172,241.21899795532227,0.6001220290115469,0.002570663023355882,1.0082254503534163,1.0055154960997637,1.001644022669304,0.005634047538150666,57.901499347217374,243.31735795206373,238.9991247177124,234.68089148336105,240.6203558785575,0.7739945644134629,238.94892801557268,2.075907602825986,240.28170568060062,239.67211440099103,1.912417965478923,0.9539996097348166,3770100,1.8052488191547382,0.7232174457673239,156593200.0,-37.488614906142395,89.0859394939463,92.09290994229893,61.67267367687581,23.895403399786005,22.51218095457023,0.044592162266857235,3.5512298503889053,241.35635925292968,239.75182067871094,238.4550018310547,237.15818298339843,235.5536444091797,0.06,0.0,213.77103327580085,0.004141294669058659,-0.005088841806017175,238.42827933175224,236.8514916556222,2.0300059563397426
2023-08-16,0,238.22750091552734,233.76250076293945,241.80249786376953,237.7731227874756,240.45499992370605,-0.936806132899914,2.148614312896418,-0.017820555652254377,2.9956917442680164,239.5662498474121,1.739774799346924,0.0089904600535197,235.7810028076172,241.21899795532227,0.6096832358997861,-0.0015744981561756314,0.9968167938636125,0.9931380581492634,0.9891546112753309,-0.009160667915205312,54.37021978530852,243.28547840454038,238.98824977874756,234.69102115295473,240.2914276123047,1.1940574632166796,239.1173207419259,1.8946441026813603,240.45534835109117,239.70038798812752,0.7441933102313837,3.0811183856013558,3218600,1.8152449590152684,0.6271494570459324,153374600.0,-45.50789166249434,89.0859394939463,92.09290994229893,-6.359960279505113,21.539267015736787,26.794312293701665,0.05206687975583461,3.6582850790581127,241.5333592529297,240.03832067871093,238.8300018310547,237.62168298339844,236.12664440917968,0.06,0.0,213.79756830498948,-8.367118304697385e-05,0.0018803110722969368,238.17786298479353,237.2263957432338,1.9708118391535017
2023-08-17,0,238.56000137329102,233.76250076293945,241.80249786376953,237.7731227874756,240.38125133514404,-0.8764644989336067,2.08409944037662,-0.0077353551573464685,2.9956941017339873,239.5175018310547,1.6911498260498035,0.008726201549417553,235.7810028076172,240.98899993896484,0.5863728155097429,-0.008892728758402026,0.9988595617282421,0.9944060578337918,0.9923502275066993,-0.010965762172502891,45.714285117486895,243.00057383497688,238.83237495422364,234.6641760734704,240.1407138279506,1.3500565701519294,239.37303488595145,1.492121494121645,239.89841195184925,239.37634262320478,-0.9572601652412739,0.9994904572406356,4177600,1.9043967462961582,0.8181362411480855,157552200.0,-75.6322314846807,89.0859394939463,92.09290994229893,-31.69863140847117,19.91066696710668,24.768374351029287,0.05599552211957717,3.674836101243134,241.89679766845703,240.62659811401366,239.5999984741211,238.57339883422853,237.30319927978516,0.06,0.0,213.83094528261407,-0.011617243471083838,-0.008106658009077092,237.96937779017858,237.3725640433175,1.9900516539287907
2023-08-18,0,237.0250015258789,233.76250076293945,241.80249786376953,237.7731227874756,240.08687496185303,-0.8037039527047878,2.054650224906959,-0.0007140480600678067,2.9956951538905527,239.35125160217285,1.6371621704101558,0.008606148686295879,235.7810028076172,240.98899993896484,0.5903498422332705,-0.00399762209627191,0.9928076228125852,0.9874745691218842,0.9881394164648981,-0.011551519690643497,47.587691393554174,242.85142538877875,238.74212493896485,234.63282448915095,239.6542854309082,1.774993185005415,239.3721422467913,1.4936291467846488,239.5565230475981,239.1411380361846,-0.44028817055864017,1.5235330518399137,4344800,1.8986467321532943,0.859992003388663,153207400.0,-66.43679088260726,89.0859394939463,92.09290994229893,-49.84875958605204,18.461504641373555,25.27531118647598,0.09864218727814521,3.680204951154339,241.89679766845703,240.62659811401366,239.5999984741211,238.57339883422853,237.30319927978516,0.06,0.0,213.86474247166427,-0.007790430026022643,-0.008286147773755076,237.80779157366072,237.43536812918526,1.9922250301556381
2023-08-21,0,239.28250122070312,233.76250076293945,241.80249786376953,237.2081241607666,240.08687496185303,-0.6262041644582674,2.079283849509492,-0.28974912086787574,2.9956942373491473,238.92374992370605,1.6887493515014653,0.008713878278727705,235.7810028076172,240.98899993896484,0.5659579909860082,-0.012282650401222586,1.0027868923998018,0.9977774652727787,0.9998600212879349,-0.010421714685867944,42.35266173367587,242.77606762272504,238.61749992370605,234.45893222468706,239.379643031529,1.6385521904222007,239.41642815726144,1.4801000020518964,238.9122731245669,238.73821192059376,-1.4162121095432927,-0.005272139776463205,3573600,1.9226151788365364,0.7248211069464051,156781000.0,-51.60910125700896,89.0859394939463,92.09290994229893,22.215406516476808,20.375276995782485,23.892006929673943,0.06967534216812574,3.615190616961954,241.89679766845703,240.62659811401366,239.5999984741211,238.57339883422853,237.30319927978516,0.06,0.0,213.89451292456982,-0.01416215381843211,-0.0024162659791556857,237.70857456752233,237.444584437779,1.9641843345372572
2023-08-22,0,240.16749954223633,233.76250076293945,241.80249786376953,237.2081241607666,239.95374870300293,-0.6042386539721384,2.0621690469399154,-0.2495432769232524,2.9956948530271457,238.92374992370605,1.6576994132995595,0.008643403121789312,235.7810028076172,240.98899993896484,0.5476724544871405,-0.000981141705950665,1.006641292757306,1.0019890204446842,1.0056760066443446,-0.003309611810207058,50.70900227088232,242.70733808625045,238.58299999237062,234.4586618984908,239.43285751342773,1.6601955310607162,239.57535689217704,1.428206711122479,238.99302364902758,238.72003519824304,-0.7970385404385036,0.25978222408044555,3848700,1.9944153381952114,0.789820393689153,160629700.0,-38.85046907638693,89.0859394939463,92.09290994229893,59.01887085002212,21.05384315579523,22.56674251141089,0.13070420565610932,3.5541051805243806,241.89679766845703,240.62659811401366,239.5999984741211,238.57339883422853,237.30319927978516,0.06,0.0,213.9277249377718,0.0030855946481902485,-0.009592354835264182,237.78369794573103,237.68950653076172,2.011942029871933
2023-08-23,0,241.72000122070312,233.76250076293945,241.80249786376953,237.2081241607666,240.2331247329712,-0.6167298131192713,2.0816705292737283,-0.29936603722001154,2.995694150311268,238.92374992370605,1.6869493103027338,0.008723953516593282,235.7810028076172,240.98899993896484,0.6007562395850261,0.027399598987830127,1.0130104764542187,1.0082337194906679,1.0128534178079347,0.014660357396832024,58.6613961629448,242.77884093647717,238.6154998779297,234.45215881938222,239.42107227870397,1.6407495194566242,239.89357130868095,1.3689178495392589,239.27638245173102,238.7826760054448,0.15534159433491324,0.9351008392790994,4947700,1.470465218632977,1.0432254235197498,165577400.0,-19.075087407344686,89.0859394939463,92.09290994229893,119.21879085990484,22.49705357812843,21.64390523934679,0.11803125909314169,3.4409538077664994,241.90859838867186,240.64569927978516,239.625,238.60430072021484,237.34140161132814,0.06,0.0,213.9729367632766,0.012578977713517459,0.010298995333357914,237.6986541748047,237.97214726039343,2.1056076689733056
2023-08-24,0,241.1599998474121,234.9800033569336,241.80249786376953,237.7731227874756,240.45499992370605,-0.39575477886974864,1.865305355020404,-0.6556356737168572,2.995701788797839,239.23375129699707,1.555037059783936,0.007804188178985549,236.9095016479492,241.256498336792,0.5802569099853252,0.024801790842417182,1.0089811917324083,1.0053569561121922,1.0075579331754152,0.010898719228512599,61.624621154598195,242.74398561085866,239.01337490081787,235.28276419077707,239.44892937796456,1.6726763782027982,240.03464262826103,1.3918533099569153,239.88976043915653,239.2493487767302,-0.034117365947511635,1.8776481328956829,4570700,1.4402076457045552,1.0016380958642188,161006700.0,-51.79189466665255,89.0859394939463,92.09290994229893,67.79023678647562,20.566071994778788,22.565497647531163,0.11819523164480267,3.495171174943335,241.90859838867186,240.64569927978516,239.625,238.60430072021484,237.34140161132814,0.06,0.0,214.0129956493831,0.008846975717027306,0.000752332432989488,237.6476287841797,238.03795405796595,1.7593358011739884
2023-08-25,0,241.89250564575195,234.9800033569336,241.80249786376953,238.15625,240.63874912261963,-0.5440730828825391,1.7736302890446451,-0.3274296365197209,2.995704763893732,239.44874954223633,1.4615870666503894,0.0074124291301664235,237.03624877929687,241.256498336792,0.5013410535024925,0.026300095336585422,1.0109271736576577,1.0084295712107283,1.0084274671331972,0.020535825708418276,60.093357206724974,242.82513533394868,239.2778747558594,235.7306141777701,239.97250148228235,1.7957060285529618,240.13196454729353,1.4743446723139517,240.2038182106539,239.61622003708158,0.08092448890948385,0.8257200337736709,3541500,1.4275913659550141,0.8047839365898886,164548200.0,-15.953648528981134,89.0859394939463,92.09290994229893,120.60460701360502,18.92502453994465,20.764908186843286,0.07372473411334984,3.5269448368335414,241.90859838867186,240.64569927978516,239.625,238.60430072021484,237.34140161132814,0.06,0.0,214.0454161839956,0.01847433150263278,0.02190684329130743,238.11254664829798,238.14520481654577,1.6544898693557295
2023-08-28,0,243.6674995422363,237.0250015258789,241.89250564575195,238.4768762588501,241.01375007629395,-0.19581518462198763,1.5635016753806514,-1.1605382036651022,2.9957109775318758,239.70499801635742,1.3432500839233399,0.0065248261386171204,237.24224929809571,241.72825088500977,0.5001966800819543,0.020482021633218137,1.016876473610163,1.0149418729676536,1.0117212476487836,0.018325612191292917,60.795842723832905,242.7505032210616,239.6234998703003,236.496496519539,240.702144077846,2.132235397035423,240.4214289528983,1.7390912066400834,240.6317915000389,240.05957311494737,1.5384473732628277,0.5664602641541081,3741500,1.3725723784328698,0.8605788637782896,168289700.0,-14.09863976938135,89.0859394939463,92.09290994229893,185.30541624340165,21.639065448278917,19.626295404165834,0.04811940805594797,3.46501937729688,242.88651745605466,241.4367385253906,240.26499938964844,239.09326025390624,237.64348132324218,0.08,0.0,214.0818099958629,0.018249314560513152,0.023764519233656432,239.0281938825335,238.49878583635603,1.810576719985778
2023-08-29,0,244.51749801635742,237.0250015258789,243.6674995422363,238.63687419891357,241.17124938964844,0.12348246595087783,1.678681539121989,-0.5463933798616978,2.9957078093761207,239.98124885559082,1.3990001678466784,0.006995818131131785,237.874747467041,241.81149864196777,0.5298132408661234,0.02097104111502425,1.019013973845521,1.0176917817312958,1.0115670175937,0.01811235276385137,64.80560582792172,243.31236300195005,239.95499992370605,236.59763684546206,241.7725007193429,1.8391334770698924,240.71339307512557,2.0550501125905924,241.39139516565712,240.67291646850987,2.1409700450802878,1.6912554366779553,3975600,1.3808327593454417,0.9213292020755167,172265300.0,-4.6534240262918,89.0859394939463,92.09290994229893,193.36964197477204,21.79530492207326,18.621728947454546,0.04966495792497168,3.3910899885306938,243.34492211914062,241.80754229736328,240.56500244140625,239.32246258544922,237.78508276367188,0.1,0.0,214.121639143395,0.019827852275455804,0.02455521012683657,240.0444793701172,238.92613547188895,2.164859567813922
2023-08-30,0,246.7324981689453,237.0250015258789,244.51749801635742,239.02875137329102,241.33374881744385,0.3069541833205659,1.9208228973810701,-0.31440503808399356,2.9957003373745454,240.29874992370605,1.5412500381469711,0.007995175389463788,237.874747467041,242.07000503540038,0.5846745250461961,0.027632729919350316,1.0269919209266458,1.0253945909412319,1.017069836741465,0.02073679018256125,67.94139833053346,244.08939569558,240.24774990081787,236.40610410605572,242.8367859976632,2.2644729629711504,241.1082145145961,2.6122135867091867,242.1689882073243,241.20935837038584,3.1610574590210345,1.7000780709534642,4573300,1.3664110708257213,1.0634777604018302,176838600.0,-15.467912860818084,89.0859394939463,92.09290994229893,228.44738899396023,25.563566811283014,17.476061314318674,0.018460421723956448,3.3552978028962426,245.17851745605466,243.2907385253906,241.76499938964844,240.23926025390625,238.35148132324218,0.12000000000000001,0.0,214.17027238234058,0.0162195218318113,0.023527371365462818,241.00406537737166,239.35631997244698,2.4164954921629156
2023-08-31,0,246.18499755859375,237.0250015258789,246.7324981689453,239.2581262588501,241.74062538146973,0.7555537473663964,2.309391441375381,0.5503767643599007,2.9956863504027265,240.47999954223633,1.7477248954772946,0.009594988691290496,238.13125076293946,243.75249938964842,0.5759940450800791,0.03990263546520351,1.0228418730664768,1.0195156671518735,1.0106365399470278,0.020836779376186332,73.6994886512872,245.306032829345,240.68724994659425,236.06846706384349,243.69642857142858,2.2240938152191627,241.56464304242814,2.9067585513329686,243.31412292262115,241.97068769173796,3.113473367352782,2.2916192442301884,5532600,1.4044940951079072,1.2791354980561884,171306000.0,-19.721612499704797,89.0859394939463,92.09290994229893,175.51065669680585,24.141177792556935,17.80269848715522,-0.0834641955517919,3.299205625847852,245.17851745605466,243.2907385253906,241.76499938964844,240.23926025390625,238.35148132324218,0.12000000000000001,0.0,214.22810024545865,0.025932295900211955,0.013949687518545306,241.72836303710938,239.7560304914202,2.5891908325207886
2023-09-01,0,247.80500030517578,237.0250015258789,246.7324981689453,239.53187370300293,241.82499980926514,0.7656070378295413,2.4617157446990943,0.054087466873410595,2.995680295316186,240.74749946594238,1.8683247184753398,0.01020894358691291,238.52675132751466,244.68424797058105,0.7189533784693826,0.02926603317562537,1.02766831390588,1.0229942001404875,1.0131071693735412,0.024442653333305753,69.75019914687165,246.05668134443968,241.1332498550415,236.20981836564332,244.56571415492468,2.4954643666830005,241.99339321681433,3.3529791399348694,244.03486002918558,242.54626671807767,2.5055421852777267,2.664775928789984,4111800,1.380911764394063,0.9623941186245896,175417800.0,-5.600552330255711,89.0859394939463,92.09290994229893,183.6872557253615,24.314544212260806,16.570253793784524,-0.0449047810775819,3.2914053983877376,245.6674769897461,243.68625814819336,242.08499908447266,240.48374002075195,238.50252117919922,0.14,0.0,214.27298629511677,0.022838613055956136,0.03607960713920345,242.55187770298548,240.1252659388951,2.9538483228935224
2023-09-05,0,246.89500045776367,237.0250015258789,247.80500030517578,239.74999809265137,242.33625411987305,0.7341193401845384,2.81249223107307,-0.22713045003538035,2.9956646846694808,241.0625,2.1808499908447274,0.011642833049106363,238.52675132751466,246.2397476196289,0.7482892763000238,0.030245713893484988,1.0220676307048968,1.0147217795571124,1.004530453859663,0.013245512518455183,72.60432232192947,247.18923426378188,241.56424980163575,235.93926533948962,245.38499995640345,2.1012747954900632,242.416964667184,3.5799493001020943,244.97987899346106,243.23565687837024,2.5173750842888385,2.482398856271548,4459600,1.3924647548243216,1.0585431620523338,170958200.0,-26.013270768888034,89.0859394939463,92.09290994229893,119.05391960578771,22.480899988659402,18.71316975636026,-0.13101982180847677,3.3055911194431897,245.6674769897461,243.68625814819336,242.08499908447266,240.48374002075195,238.50252117919922,0.14,0.0,214.31935993016995,0.006192879755627656,0.011419274828022989,243.38389805385046,240.51576341901506,3.069170333398798
2023-09-06,0,245.6125030517578,237.0250015258789,247.80500030517578,239.74999809265137,243.87999916076657,0.5456876868580032,3.0292228051035024,-0.7563484978734532,2.9956540282192075,241.18249893188477,2.45175004959106,0.012523530253477234,238.52675132751466,246.74874839782714,0.8096068234989485,0.030382082335819002,1.0154207235660435,1.006302397819712,0.9966947783593494,0.004478227710832838,68.88413632431659,247.94094549576607,241.88249988555907,235.82405427535207,245.91642815726144,1.4358194069800174,242.9444648197719,3.457130314782353,245.46505684565074,243.65983984035944,2.3780894899569742,2.460938435632016,4520300,1.3922198431117991,1.0801336696181192,166437900.0,-19.9704719207759,89.0859394939463,92.09290994229893,87.15377971548607,21.268330969264632,19.88332996896915,-0.09733429925623933,3.244477250071687,245.6674769897461,243.68625814819336,242.08499908447266,240.48374002075195,238.50252117919922,0.14,0.0,214.36515735520814,0.003342379067320822,0.009555957774610007,243.8927481515067,241.00264739990234,3.1396457998108893
2023-09-07,0,246.2874984741211,237.0250015258789,247.80500030517578,240.07437419891357,244.79124927520752,0.3316885082786756,3.086232904660779,-1.0111315437588397,2.995651186164359,241.46249961853027,2.6138371086120555,0.012743424878930647,238.52675132751466,246.74874839782714,0.8545019117375698,0.021555141787646816,1.016950545334711,1.0068218323004636,0.998546494026016,-0.0018035714716410078,61.89004986893877,248.35484095428006,242.18237514495848,236.0099093356369,246.29071371895927,1.0383359852402754,243.49642889840263,3.3173182363658813,245.50862133758346,243.84309724423412,1.537872120541734,3.0999788470471774,4007900,1.4360694026225451,0.9582340128963155,170445800.0,-12.74868636029879,89.0859394939463,92.09290994229893,94.84124480617623,21.837157450022154,18.85939163423113,-0.02243654281511212,3.1762998240760547,245.6674769897461,243.68625814819336,242.08499908447266,240.48374002075195,238.50252117919922,0.14,0.0,214.40678110459692,0.003695799587267956,0.007336798176243628,244.3619144984654,241.69505419049943,3.256698528714658
2023-09-08,0,247.41499710083008,237.0250015258789,247.80500030517578,240.07437419891357,245.7556266784668,0.14129789179020505,3.182470554182629,-1.210080261236085,2.99564619048956,241.76124954223633,2.7900495147705087,0.0131249294659215,238.52675132751466,246.74874839782714,0.8602924580454089,0.02107128997973334,1.020372170134215,1.0095460255839483,1.0034799139000468,0.004996240853155864,63.30891703814281,248.84019116177106,242.47525005340577,236.1103089450405,246.70464215959822,0.751577410792042,244.23857143947058,2.893291317975984,245.7102896138046,244.06130859652757,1.0752352844785746,3.2392257949136827,3309100,1.4344013273638159,0.8053013461437841,173754900.0,-14.221437842069445,89.0859394939463,92.09290994229893,98.11102496791199,22.69493421430923,18.113648547620688,0.03319181562631584,3.0708496186593495,246.2480349731445,244.62597488403318,243.31499481201172,242.00401473999023,240.3819546508789,0.14,0.0,214.44185578053703,0.006553191441414752,0.004304947904484078,244.6383100237165,242.34139469691686,3.3735661691651804
2023-09-11,0,247.29500198364258,237.0250015258789,247.80500030517578,240.07437419891357,246.2106227874756,0.006637279288576366,3.3423175551422704,-1.3455090082950047,2.9956375127935475,241.84750175476074,3.004574260711668,0.01376653100537095,238.52675132751466,246.9470001220703,0.8430996772227638,0.031777138764654995,1.0185729680422821,1.0064875688441568,1.0019935013186883,-0.0020580630774404973,68.21261929409843,249.47038511791396,242.7857500076294,236.10111489734481,246.7849998474121,0.7844062388340273,244.81089292253768,2.616782519358272,246.13214987747824,244.3356920778115,1.1849863948300432,4.383501954673237,2995800,1.3894212837963515,0.7345176463953886,170759100.0,-16.176415589700017,89.0859394939463,92.09290994229893,87.70723065846009,22.089564614066727,17.21251737147301,0.01203096667673941,3.0007886700330095,246.46279583740235,244.973596282959,243.7699966430664,242.56639700317382,241.07719744873046,0.14,0.0,214.47353874632628,-0.0035870300135300015,0.006268310898755743,244.7786363874163,242.89135088239397,3.438661891979146
2023-09-12,0,247.00249862670898,237.0250015258789,247.80500030517578,240.765625,246.39874839782715,-0.17548103678853677,3.4058624953879675,-1.3372687613945484,2.9956340949960323,242.78000259399414,3.0804992675781238,0.01400662932899143,238.52675132751466,247.30700149536133,0.8822046032230614,0.0227148361509793,1.0157992127644397,1.0030914770064627,1.0012221207568062,0.00043540034729749877,66.16088200073102,249.9724751891402,243.16075019836427,236.34902520758834,246.90178571428572,0.7397735336606627,245.29910714285714,2.302561274996317,246.4194478057321,244.63683946586983,0.2279812423866847,3.3485527450037362,3499600,1.340305033475215,0.8670918379988206,167259500.0,-16.508864061920875,89.0859394939463,92.09290994229893,74.13499119259606,21.141171620793504,17.11141572063565,-0.006082380983832065,2.9114466221735085,246.62563641357423,245.23717721557617,244.11499786376953,242.9928185119629,241.60435931396484,0.14,0.0,214.5101797840243,0.007988963586052167,-0.003264587813246833,245.00825718470983,243.3683101109096,3.554489445264715
2023-09-13,0,247.9124984741211,237.0250015258789,247.80500030517578,240.765625,246.7731237411499,-0.31740514113010077,3.489700330510742,-1.3578377022833144,2.9956293502132407,244.09249877929688,3.1786740684509267,0.014336084031949196,238.52675132751466,247.30700149536133,0.8892193891283903,0.02505549963811312,1.0184526102776597,1.00542532884298,1.004823227015959,0.009364325487447145,65.62683666413272,250.40015089753268,243.42075023651122,236.44134957548977,246.9171425955636,0.7624174420560732,245.74142837524414,2.151993558006244,246.55134645681824,244.78136226754202,0.3320677848863083,2.8459300685980784,5657000,1.3215892401576608,1.3696126129288815,172916500.0,-20.84108750989326,89.0859394939463,92.09290994229893,89.60865075978582,24.94426798324687,15.681971579987678,0.006450831468189852,2.9499145026069855,247.53479827880858,245.97259872436524,244.70999908447266,243.44739944458007,241.88519989013673,0.16,0.0,214.5713114956086,0.006784128952991075,0.010149183150914351,244.96857125418526,243.76022447858537,3.5773299316386
2023-09-14,0,242.6974983215332,237.0250015258789,247.9124984741211,240.91187477111816,246.921875,-0.4727890342401425,3.572757163902496,-1.2644779988137782,2.995624614065069,245.06500053405762,3.22106155395508,0.014656375445584244,238.52675132751466,247.45399742126466,0.8505389112539656,0.040654406067198494,0.9956080113821915,0.9829222043339536,0.9818555090682716,-0.014576461147357445,72.91503673668319,250.91363948039285,243.76812515258788,236.62261082478292,246.317499433245,1.768972687088546,245.85124969482422,1.927756054290053,246.88196822926633,245.1013940489282,0.043380145200026955,2.561847270455659,12000000,1.1121637798952186,2.626145245528167,160916500.0,-75.68522905727376,89.0859394939463,92.09290994229893,-45.372789036174545,20.168824214281916,29.25192283590005,-0.029506467446343883,3.3877778832103944,247.39083813476563,245.73957849121095,244.40499877929688,243.0704190673828,241.41915942382812,0.02,1.0,214.67631843074176,-0.02282102136321651,-0.018930761700574818,244.4242880684989,243.90409306117468,3.463692297828305
2023-09-15,0,241.7750015258789,237.0250015258789,247.9124984741211,241.58000087738037,246.921875,-0.548575079846982,3.352167627662127,-1.0135870000538223,2.9956376523054233,245.06500053405762,2.9752116966247586,0.013738863484956376,239.21025123596192,247.45399742126466,0.8071086345973038,0.017343632312308573,0.9909151656463564,0.9807888786984259,0.9809729295846175,-0.022795689998746038,46.9296192628412,250.69596027821245,243.99162502288817,237.2872897675639,245.76928492954798,2.4768622472818786,245.8428565434047,1.9464824827200862,245.83377622141228,244.82385517142419,-1.7001162957726783,0.6375429072374801,13051300,1.6955473005579162,2.603428603344823,147865200.0,-79.48711030042686,89.0859394939463,92.09290994229893,-57.49028109049266,18.462622766381944,26.777327759548047,-0.06772592153280556,3.4365085575681324,247.39083813476563,245.73957849121095,244.40499877929688,243.0704190673828,241.41915942382812,0.02,0.0,214.78879603716445,-0.025152606017299295,-0.024560965950825797,243.70282418387276,243.79778616768974,3.185976958890373
2023-09-18,0,242.9000015258789,237.0250015258789,247.9124984741211,241.76125144958496,246.921875,-0.5712178086937256,3.159387828650449,-0.8065150109540498,2.9956483373075518,245.06500053405762,2.798386688232422,0.012940229757156956,240.078999710083,247.45399742126466,0.7233198963235679,0.02004008003131005,0.9948705249970141,0.9871184966521219,0.990068749400845,-0.01777229795390034,45.12356980455365,250.4711506878185,244.1523750305176,237.83359937321669,245.28535679408483,2.681231571585588,245.78803525652205,2.0218130679907866,244.81447109819644,244.46235502408587,-1.5624210812550658,-0.04857699892742024,4771600,1.6675068351988351,0.9477878461642361,152636800.0,-47.745314430959276,89.0859394939463,92.09290994229893,-24.755359563673736,19.086537908445145,24.34672597533966,-0.05506076768373935,3.5096144788188424,247.39083813476563,245.73957849121095,244.40499877929688,243.0704190673828,241.41915942382812,0.02,0.0,214.83244704074352,-0.010355108541364122,-0.010635203598551102,243.35130746023995,243.85661097935267,2.866371645227063
2023-09-19,0,243.7849998474121,239.28250122070312,247.9124984741211,241.8631296157837,246.921875,-0.3249041366649628,2.72651640474606,-1.3076637926905854,2.9956699919872145,245.06500053405762,2.475261688232423,0.011153854062549248,241.06074981689454,247.45399742126466,0.7335133000559191,0.015118114725151448,0.9972954155725605,0.9926938041094842,0.9972490111849641,-0.01302617907586201,47.40597700864748,249.89915784000968,244.44612503051758,238.99309222102548,244.76678575788225,2.548440965799881,245.73571395874023,2.0662121750711537,244.33862185773268,244.34712563315213,-1.375423831590921,-0.3149775894607391,4709000,1.61406758018036,0.9249238396222523,157345800.0,-57.47127677371656,89.0859394939463,92.09290994229893,-38.330331910536806,17.669138283164507,22.538695601272305,-0.055605949413845474,3.5203554734260902,247.39083813476563,245.73957849121095,244.40499877929688,243.0704190673828,241.41915942382812,0.02,0.0,214.8751364795461,-0.015123327348428472,-0.014804618328270158,242.82261439732142,243.73046221051897,2.630960681857644
2023-09-20,0,242.92250061035156,240.16749954223633,247.9124984741211,242.4962501525879,246.921875,-0.255858816706469,2.4641254541040047,-1.3838302631415513,2.995681514382477,245.06500053405762,2.2429994583129895,0.010071168780509314,241.66400108337402,247.45399742126466,0.7066121731838615,0.015062405663009372,0.9928526569763546,0.9904359847478894,0.9963435269146297,-0.0201280608863309,50.01888798724673,249.59950087006104,244.67124996185302,239.742999053645,244.14214270455497,2.3539175130590695,245.46357127598353,2.172976572607386,244.19604186926534,244.34200888908742,-1.467169450499648,-0.2995688140471283,5756600,1.6140675801803601,1.1098932350034945,151589200.0,-72.50219910093199,89.0859394939463,92.09290994229893,-66.13969361452443,16.629875777050277,21.213015712432313,-0.1166852415301965,3.473187268920767,247.39083813476563,245.73957849121095,244.40499877929688,243.0704190673828,241.41915942382812,0.02,0.0,214.92588467538118,-0.024089045938676334,-0.02199757270564964,242.06288146972656,243.42075892857142,2.5411275925741195
2023-09-21,0,238.60750198364258,241.1599998474121,247.9124984741211,242.84937572479248,246.921875,-0.14167865936626614,2.2785207918645236,-1.5228807416735504,2.9956889402937845,245.06500053405762,2.105249404907228,0.009307340791075919,241.76950149536134,247.45399742126466,0.7032630476490611,0.004974761639813546,0.9746680145287564,0.9739111541175689,0.9826679527863849,-0.01685223937690561,45.23200859786835,249.36604159898783,244.8090000152588,240.25195843152974,242.94285746983118,2.7576615195461556,244.92232159205847,2.825266040319368,243.8781932236127,244.23579671687767,-1.768131720502882,-1.5441814867796329,6881500,1.5967954743068613,1.3024966332690744,144707700.0,-97.53447060606986,89.0859394939463,92.09290994229893,-189.89635179081296,14.797823681442981,29.518234989361012,-0.20433057478023026,3.6243879167043267,246.8055591430664,244.79222012329103,243.16500091552734,241.53778170776368,239.5244426879883,0.04,0.0,214.97585972169713,-0.020248460882500208,-0.04527289558656158,240.54766845703125,242.77796282087053,3.0788957801201735
2023-09-22,0,236.125,238.60750198364258,247.9124984741211,242.84937572479248,246.921875,-0.5313093843559319,2.5716280999351073,-0.6534430334929557,2.995676924456682,245.06500053405762,2.2608743667602553,0.010511312584074275,241.71350135803223,247.45399742126466,0.5630629415281317,-0.010584250561388953,0.9651409875234949,0.9668091204544873,0.9757311999604529,-0.02336884082399293,33.58723968427492,249.79663125327596,244.65337505340577,239.51011885353557,241.25892911638533,2.8155736007948424,244.08803585597448,3.542122783353155,242.55677015488044,243.5251346919967,-3.3987496846149856,-3.077968052520209,5935500,1.8706060012187686,1.109116882849938,138772200.0,-98.68249641146882,89.0859394939463,92.09290994229893,-214.262109301758,13.93705912734576,30.57970547956752,-0.20909070209180572,3.5733593800340397,246.47751928710937,244.2612403564453,242.47000122070312,240.67876208496094,238.46248315429688,0.06,0.0,215.0150988693758,-0.024847537752890503,-0.026583873967518972,238.74046979631697,241.8545205252511,3.5620838438499987
2023-09-25,0,234.1050033569336,236.125,247.9124984741211,242.84937572479248,246.921875,-1.0349537517291676,3.094570820291947,0.5456016741362997,2.99565175475999,245.06500053405762,2.5242116546630866,0.01266182587582685,241.45825157165527,247.45399742126466,0.6155861950205405,-0.023843258931710687,0.9578700767577542,0.9629898656953874,0.971922391458205,-0.03620830841373335,28.102788625366244,250.59076670161906,244.40162506103516,238.21248342045126,240.03142983572823,3.788724922596212,243.1744646344866,4.32527059080191,240.95445723783473,242.756970331752,-4.754701173467282,-4.713383624540133,5921600,1.9290382823111856,1.0824485975841596,132850600.0,-93.55745385816756,89.0859394939463,92.09290994229893,-221.49866718550922,13.023130635574214,33.945181353046166,-0.23585543216895435,3.5509761748056037,245.84739971923827,243.2413010559082,241.13500213623047,239.02870321655274,236.42260455322267,0.08,0.0,215.0499263892,-0.04618659630557764,-0.03198243153137957,237.5866938999721,241.00549098423548,4.293883450265675
2023-09-26,0,230.96249771118164,234.1050033569336,247.9124984741211,242.84937572479248,246.921875,-1.235140179075572,3.796181304405482,0.6923600287435132,2.995610464628604,245.06500053405762,2.952524280548097,0.015557339048495858,238.35925178527833,247.45399742126466,0.702214300278529,-0.039244036251314604,0.9465200938138608,0.9552460615160748,0.9659297499927809,-0.05259758452840091,23.136850937996233,251.6046125554052,244.01224994659424,236.41988733778328,238.48678643362862,4.977125077090206,242.1280356815883,5.342582701212564,239.25336783490857,241.8301276458822,-3.5404134875819793,-5.180338636714542,6193200,1.8997286479521156,1.107284005689107,126657400.0,-99.75568028423393,89.0859394939463,92.09290994229893,-218.72572336381168,12.042275942601826,36.616639552935105,-0.28208545759315656,3.5659060556649154,245.2314395751953,242.2442808227539,239.8300018310547,237.41572283935545,234.42856408691404,0.1,0.0,215.08029145776402,-0.0571112463476966,-0.06135053740406327,235.96800667898995,239.83541543143136,5.313149691435207
2023-09-27,0,229.58999633789062,230.96249771118164,247.9124984741211,242.46687412261963,246.921875,-1.268382308299389,4.74513528208812,0.5855603677970378,2.995540594839749,245.06500053405762,3.692099380493164,0.019497057178428465,235.92300033569336,247.45399742126466,0.7357953328056392,-0.05543570670868306,0.9433512471377221,0.9559110373481374,0.9705995938481015,-0.054883776673476214,18.562103236816174,252.86727041921776,243.3769998550415,233.88672929086525,236.58535712105888,5.522665671881396,240.93535695757186,6.145968117206835,237.1873384010125,240.52415204755712,-4.472134731240991,-5.964682236673018,6006700,1.9583227659507307,1.0547877851335452,120650700.0,-92.86358683553796,89.0859394939463,92.09290994229893,-188.69572653660265,11.365590296021963,37.97949515254922,-0.29024003293193934,3.5083409450342744,244.83495770263673,241.60251779174806,238.98999786376953,236.377477935791,233.14503802490233,0.12000000000000001,0.0,215.10722846089325,-0.05110396474790524,-0.0577270723368541,233.81920732770647,238.58525739397322,6.06794404222302
2023-09-28,0,231.1349983215332,229.58999633789062,247.9124984741211,240.98312664031982,246.921875,-1.113486523036878,5.603415884593452,-0.02373327008685333,2.9954632388206157,244.69875144958496,4.461874771118164,0.023094429608295934,233.7907527923584,247.45399742126466,0.7878889114671837,-0.0694780864226353,0.9526208760315019,0.9697415876984252,0.9882716563429302,-0.031317136301194926,14.866280448436953,253.83745654030503,242.63062477111816,231.4237930019313,234.7782140459333,4.796008926508258,239.7724999019078,6.362014647243027,235.29115921819732,239.15726556710388,-5.47962334474099,-6.779679130966924,4203900,1.8359981056474275,0.7406148094774172,124854600.0,-83.1074724649149,89.0859394939463,92.09290994229893,-134.84857744595323,14.478717618497813,35.60619305863898,-0.24322983171823165,3.4748875408270274,244.83495770263673,241.60251779174806,238.98999786376953,236.377477935791,233.14503802490233,0.12000000000000001,0.0,215.1285551723175,-0.020920552403458692,-0.042173179730681375,232.13248552594865,237.47754996163505,6.424272339280196
2023-09-29,0,231.38249588012695,229.58999633789062,247.9124984741211,237.98687648773193,246.921875,-0.8565050274568016,6.046177939559746,-0.7035751539946218,2.9954174760302017,243.35375022888184,5.065524921417233,0.024999624541544623,231.11774826049805,247.45399742126466,0.8528201788620735,-0.06113288537608203,0.9567160577000596,0.9755123071243118,0.9956924511892555,-0.020084718347794794,21.93152255221396,253.94310565786708,241.85074977874757,229.75839389962806,233.12964194161552,3.270758782381728,238.63589232308524,6.336074067852325,234.2505217392852,238.1312563128471,-5.1889991319386715,-6.580037172387824,6044200,1.9150316943098258,1.0600493527493902,130898800.0,-90.56008854784443,89.0859394939463,92.09290994229893,-117.59991382165478,14.480003066794175,33.12750460101578,-0.24401809896598742,3.468110208111702,244.83495770263673,241.60251779174806,238.98999786376953,236.377477935791,233.14503802490233,0.12000000000000001,0.0,215.15837567334714,-0.02156724952770095,-0.02789413486817881,230.45284816196985,236.25786481584822,6.827684223209886
2023-10-02,0,230.16250228881836,229.58999633789062,247.9124984741211,235.6200008392334,246.921875,-0.6208316726095477,6.367763683618496,-1.148916781690908,2.9953815434612268,242.91125106811523,5.586687927246092,0.026410133073472928,231.11774826049805,247.45399742126466,0.8652914243292562,-0.06627188476755616,0.9545929491084725,0.9746391732430281,0.9945017130427829,-0.016840738179799586,21.26395708401283,253.84615206206124,241.11062469482422,228.3750973275872,231.9232134137835,2.337942706917078,237.43303544180733,6.223021661974796,233.5349979931877,237.38943598626355,-4.750488201475751,-6.434625033209593,5175200,1.8473728812511447,0.8992559487608992,125723600.0,-84.8689873718698,89.0859394939463,92.09290994229893,-105.87268805226456,13.690498169859358,33.166672832982954,-0.21012586087580232,3.4061016821556183,244.83495770263673,241.60251779174806,238.98999786376953,236.377477935791,233.14503802490233,0.12000000000000001,0.0,215.1831294976695,-0.008956163231628844,-0.016207329360948163,229.6959468296596,235.12180764334542,6.908294304995934
2023-10-03,0,229.70249938964844,229.58999633789062,247.9124984741211,233.42437648773193,246.43937397003174,-0.4355234320578667,6.597166509948687,-1.4075866444514444,2.9953536116281563,242.79874992370605,5.975800247192382,0.02746204765715015,230.88249816894532,247.30700149536133,0.8704900435645989,-0.06777171728030897,0.9561833820159396,0.9779661962352346,0.9959071621463766,-0.005455423863266473,20.02762994839017,253.4228328139037,240.22849979400635,227.034166774109,231.0057133265904,1.5373013148505605,236.13232122148787,5.749207432448855,232.6862359621079,236.5693658571614,-3.539285070510128,-6.817743314953526,5585700,1.8490721741682599,0.961181563113838,120137900.0,-94.20045552998104,89.0859394939463,92.09290994229893,-102.69581319923812,12.564030667995581,32.48954038374393,-0.1959198498937922,3.4463802206232974,241.34863458251954,238.75567538452148,236.65999603271484,234.5643166809082,231.97135748291015,0.14,0.0,215.20797464249085,-0.0036576578507149238,-0.019497733626290075,228.8072291782924,233.7738494873047,7.201504356589662
2023-10-04,0,230.31999969482422,229.58999633789062,247.9124984741211,231.32062149047852,245.78125190734863,-0.2512662969573489,6.789799216337622,-1.56209726439854,2.995328940976527,242.23624992370605,6.254737739562989,0.02836542229517349,230.11650199890136,247.30700149536133,0.88574830332954,-0.06477684753188916,0.9621969437104868,0.9865100156605202,0.999676647015087,0.0031795956643478895,19.845386980472718,252.94847317327583,239.36887474060057,225.78927630792532,230.46499851771765,0.7068438013113097,235.24821417672294,5.61202360842085,231.95111773883934,235.83070035287764,-2.7199579080366596,-7.345333210932707,5430900,1.848785669138382,0.9272787342608568,125568800.0,-80.28651551281342,89.0859394939463,92.09290994229893,-81.2910384648487,11.80270122923297,30.5208056520611,-0.1866552448593781,3.4066387326965217,241.11179644775387,238.56409689331053,236.50499725341797,234.44589761352537,231.89819805908203,0.14,0.0,215.23399836592407,0.007494525071890523,0.006836503316863973,228.503901890346,233.04529789515905,7.202955225390587
2023-10-05,0,232.07500076293945,229.58999633789062,247.9124984741211,231.0918731689453,244.41062450408936,-0.05498026749936324,6.9037442019663455,-1.6386849444659357,2.995313387586287,240.19125175476074,6.395325317382813,0.028933869427423143,230.11650199890136,247.30700149536133,0.8920246419691418,-0.06483276202902631,0.9726356558128962,0.999421863109193,1.0066561044755258,0.004066897909154488,22.203108549369528,252.41173797668654,238.6042495727539,224.79676116882126,230.6239275251116,0.9278614958689019,234.55535697937012,5.33624855035053,231.55729348165437,235.342493744515,-1.6167974233077291,-5.099969596848044,6126200,1.8463532359724752,1.0274152946720714,131695000.0,-67.33525532899102,89.0859394939463,92.09290994229893,-54.64165375623328,15.991662901573353,28.009887413834893,-0.1763201234997273,3.446878910411279,241.11179644775387,238.56409689331053,236.50499725341797,234.44589761352537,231.89819805908203,0.14,0.0,215.26711261751515,0.007856286054503059,0.017341991004908054,229.04677036830358,232.50738852364677,6.971114810660903
2023-10-06,0,234.3874969482422,229.58999633789062,247.9124984741211,231.0918731689453,243.1381254196167,0.14094423533061468,6.807101813195778,-1.6051974621436271,2.9953233643049924,237.3662509918213,6.337625312805176,0.028614057321403222,230.11650199890136,247.30700149536133,0.889659619077223,-0.06200107720890925,0.9852617835237795,1.0122281330714928,1.0158584542059703,0.012987158154228018,29.504846137372027,251.5078283135864,237.89362468719483,224.27942106080326,231.30928475516183,1.579715222565761,233.94732093811035,4.76688340760759,231.6922650743366,235.10983095863415,0.48168125249017546,-4.011994913337305,6401000,1.886435457999611,1.046372393162044,138096000.0,-58.1315107260334,89.0859394939463,92.09290994229893,-26.783062293271527,19.662651264675898,25.799010895901144,-0.16178186673689893,3.474958726659806,241.02775598144532,238.4961165161133,236.4499969482422,234.40387738037109,231.87223791503905,0.02,1.0,215.30587204504764,0.021868607161129594,0.014590255013466677,229.83201381138392,231.8256105695452,6.613767627035965
2023-10-09,0,233.5275001525879,229.58999633789062,247.9124984741211,231.0918731689453,242.90562629699707,0.2994139624963523,6.480290552805868,-1.470892915365147,2.9953601636717253,235.2562484741211,5.971725578308105,0.027315077991203352,230.11650199890136,247.03174896240233,0.8841863860789572,-0.05219476710756234,0.9843419562409524,1.009271459206589,1.0095015998280943,0.014620095933554733,39.1921527705921,250.20283078517716,237.24224967956542,224.28166857395368,231.65107073102678,1.7816369496327802,233.21464238848006,3.83588501123698,232.36266430781967,235.07447974264844,2.0895947937082666,-3.5045304751592536,5372200,2.0074045351366587,0.8614616882705581,132723800.0,-60.2387841068097,89.0859394939463,92.09290994229893,-33.36028758395751,18.26003692083714,26.1171911036583,-0.13156550226726205,3.4746046190914717,240.57699877929687,238.13149877929686,236.15499877929688,234.1784987792969,231.73299877929688,0.02,0.0,215.3365813120596,0.013706966941809506,0.019260121629923223,230.22605460030692,231.1792700631278,6.188077593018761
2023-10-10,0,236.0,229.58999633789062,247.9124984741211,231.0918731689453,242.74812412261963,0.4643853706741676,6.095685534881808,-1.2767543985657301,2.995401522643619,234.2462501525879,5.517150421142577,0.025768698760475536,230.11650199890136,244.1067497253418,0.8625312707171818,-0.05455409782913025,0.9976585689455422,1.0202118723979094,1.0172304204517975,0.027415899378913533,37.3191051559086,248.74524565777628,236.5538745880127,224.3625035182491,232.31071417672294,2.409720880435005,232.72017805916923,2.7925030927504153,232.6499872513704,234.8606135131526,1.0351101513957937,-4.207600837313414,4644000,2.0056476582025415,0.7379200157626326,137367800.0,-32.15378981370215,89.0859394939463,92.09290994229893,5.643277627418489,23.005635937264667,24.021852377493296,-0.13700131348786462,3.5078473206853844,237.71199877929686,235.81399877929687,234.27999877929688,232.74599877929688,230.8479987792969,0.04,0.0,215.3667737255004,0.03404567271452397,0.02304669885907926,231.1601322719029,230.8064902169364,5.6424223951302555
2023-10-11,0,236.65749740600586,229.58999633789062,247.9124984741211,231.0918731689453,242.00562572479248,0.5688562624217518,5.60458708005788,-1.0271770921748502,2.995451511210804,234.2462501525879,4.869500503540041,0.02374787302409841,230.11650199890136,243.0087505340576,0.8144861951946916,-0.048051221892568705,1.0027700735699312,1.0208311474103835,1.0145565840188064,0.027516054704666892,45.34599926789744,247.21292381679302,236.00374965667726,224.7945754965615,233.23857062203544,2.679981821297509,232.58089201790946,2.5106733394803955,233.49187068278644,234.98156744181676,1.9956151403368263,-2.849674522927489,4760900,2.100160036500436,0.7619195462634591,142128700.0,-26.374678079240304,89.0859394939463,92.09290994229893,15.912040765884935,21.902857711996937,22.255183608646096,-0.1462003941666375,3.515857877578391,235.9777155151367,234.411136138916,233.1449966430664,231.8788571472168,230.31227777099608,0.06,0.0,215.39762648141763,0.019289028676540365,0.03002488009102725,231.78521292550224,230.74057987758093,4.9023527649983665
2023-10-12,0,236.5275001525879,229.58999633789062,243.7849998474121,231.0918731689453,239.39937686920166,0.479402829260279,4.9015470110448405,-1.2289713440658143,2.9955162604720704,234.2462501525879,4.250100479125976,0.020818578834205445,230.11650199890136,242.90225143432616,0.8765416182633264,-0.02488695168800365,1.004614746586819,1.0171694630220585,1.0085191888725826,0.019185605407781914,51.32092034247283,245.24409362536116,235.44099960327148,225.6379055811818,234.21357073102678,2.4066815529411225,232.6096420288086,2.5562696758652574,234.28376524309806,235.090621656158,2.821917146624208,-0.817243616158556,4472800,1.814960996448345,0.7616906781104186,137655900.0,-16.122986173227634,89.0859394939463,92.09290994229893,23.73524324951669,20.621519494698898,20.95323398792954,-0.12355322949075914,3.4675820533149766,235.9777155151367,234.411136138916,233.1449966430664,231.8788571472168,230.31227777099608,0.06,0.0,215.42667679156958,0.014134074289634091,0.02404643658993215,232.9148908342634,230.8610600062779,4.698315285922385
2023-10-13,0,237.2349967956543,229.58999633789062,243.7849998474121,231.0918731689453,237.14499855041504,0.5796589538287217,4.621274326173159,-0.9344340078010851,2.9955398434540204,234.2462501525879,3.9107505798339846,0.019653915695070048,230.11650199890136,242.90225143432616,0.8715331533331482,-0.021704069238644336,1.0089417545577872,1.017851596824407,1.0077096163112917,0.012148684910615826,51.65999562006353,244.37504834717052,235.13249969482422,225.88995104247792,235.2014274597168,1.9100955568910483,232.8332129887172,2.820347988685277,234.8580263717362,235.23596095842842,2.9712348716598345,0.17046062576512044,4966800,1.8096858013298136,0.9083435824048208,142622700.0,-9.01560411917326,89.0859394939463,92.09290994229893,48.502386668484576,21.507773165704783,19.885690409896146,-0.06570223120000206,3.3927546330028617,236.08467504882816,234.49765576171876,233.21499633789062,231.93233691406252,230.34531762695312,0.08,0.0,215.4604470399299,0.011189694554021523,0.017945935606411403,233.8291233607701,231.16651262555803,4.528856803401727
2023-10-16,0,239.52750396728516,229.58999633789062,243.7849998474121,231.0918731689453,236.80187225341797,0.6616675675617,4.395398783334993,-0.6134821855883152,2.9955579146912474,234.2462501525879,3.661050319671631,0.018711349004049235,230.11650199890136,242.90225143432616,0.8288686200343746,-0.023322374206000373,1.0196760166093617,1.0251134861807407,1.0149922139857448,0.02569292186477745,53.16586715812959,243.69629702498298,234.905499458313,226.114701891643,236.26607077462333,1.9534979976917837,233.44499914986747,3.2755589054874075,235.46943573030947,235.3881866408499,3.0023433093055325,1.3370040767340996,6227300,1.7950139700382426,1.1239071896274158,148850000.0,-4.949721553822896,89.0859394939463,92.09290994229893,97.82301934982182,24.490380556754367,18.603441626444194,-0.07091948782018276,3.3675584838542196,237.6585248413086,235.77074368286134,234.24500274658203,232.71926181030273,230.83148065185546,0.1,0.0,215.50682532893904,0.024014700366289166,0.021400736583735185,234.76320103236608,231.90498570033483,4.1085396026504535
2023-10-17,0,240.14999771118164,229.58999633789062,243.7849998474121,231.0918731689453,236.80187225341797,0.6224962768709937,4.142902271803922,-0.5007265824022622,2.9955770780716002,234.2462501525879,3.4755629539489745,0.017649132796923334,230.11650199890136,239.8670036315918,0.749179703787007,-0.01746414210386927,1.0230603868287624,1.023674735270008,1.0124815729661936,0.017584736064329087,59.66421375003501,243.02267912399114,234.7368745803833,226.45107003677546,237.08928516932897,2.225196688374564,234.1992849622454,3.525854175563909,236.4916208791674,235.69192280936088,3.211247734502134,3.7083969653004214,4527600,1.8697994266935023,0.8184840437551635,153377600.0,-2.04378716546191,89.0859394939463,92.09290994229893,118.20389223255631,24.466418154605005,17.339928335647077,-0.04357557095032415,3.3548759093936487,238.2467964477539,236.24659689331054,234.62999725341797,233.01339761352537,231.01319805908201,0.12000000000000001,0.0,215.5412948707757,0.019442110595866202,0.028834682935449878,235.6363307407924,232.73417227608817,3.868760175838185
2023-10-18,0,238.81250381469727,229.58999633789062,242.92250061035156,231.0918731689453,236.80187225341797,0.41773290112380057,3.808184960247997,-0.8224860147618998,2.9956007588044065,234.2462501525879,3.2756378364562977,0.016235778130172893,230.11650199890136,239.5897533416748,0.7098040262976343,-0.011413116908495129,1.018150869015037,1.0134601271817059,1.0033316791724958,0.009106013679314406,62.29947414165505,242.1714943940678,234.55512447357177,226.93875455307574,237.84428569248743,1.6330947755817473,234.74767821175712,3.608676116230328,237.39565371526518,235.99957825458924,2.458535902284898,4.599504134208758,9528300,1.8725143363938688,1.6657066312371345,143849300.0,-29.270039416690746,89.0859394939463,92.09290994229893,89.70778317537471,22.31258847803505,18.531768628521384,-0.06097126042363697,3.415955591228252,238.2467964477539,236.24659689331054,234.62999725341797,233.01339761352537,231.01319805908201,0.12000000000000001,0.0,215.60800563889373,0.007595036984312298,0.0036770952539986078,236.06580679757255,233.14593069893974,3.545069092933222
2023-10-19,0,235.6525001525879,229.58999633789062,240.14999771118164,231.0918731689453,236.80187225341797,0.12138021244184495,3.4446563368938317,-1.363770454615044,2.995624304213822,234.2462501525879,3.053375244140625,0.014698791782904239,230.11650199890136,238.88400382995604,0.8140833233426054,0.0008591592022481386,1.0055595374681516,0.9964586256529205,0.9882659070542363,-0.0036993584231664878,61.004523687108126,241.23893730757675,234.34962463378906,227.46031196000138,237.79464285714286,1.7023158018752944,235.0526785169329,3.480549924137258,237.7308689206371,236.00773062502694,2.2631183302421043,3.321654249212333,5927400,1.625324594585843,1.0449232005951448,137921900.0,-55.985400565577635,89.0859394939463,92.09290994229893,19.74772017876343,20.255455104197928,24.141672506056054,-0.05295213890989995,3.4941012280573744,238.2467964477539,236.24659689331054,234.62999725341797,233.01339761352537,231.01319805908201,0.02,1.0,215.64318622810174,-0.012543319371414063,-0.007934485081640996,235.67034912109375,233.41524069649833,3.503906552701463
2023-10-20,0,233.9800033569336,229.58999633789062,240.14999771118164,231.0918731689453,236.55999946594238,0.1667217964626219,3.3199737113874077,-1.2200710830846184,2.9956318716180754,234.2462501525879,2.9056251525878904,0.01417569230765776,230.11650199890136,238.88400382995604,0.8643203540544011,-0.0020010581150327555,0.9990526498315335,0.9878920261785906,0.9819725606596348,-0.013720544956208336,50.724627769383105,240.84182196501118,234.20187454223634,227.5619271194615,237.4121437072754,2.221917718168111,235.3253571646554,3.20673352248866,237.20023806759767,235.6788837128717,-0.14724569805597854,1.8454309848369481,5748300,1.6859354630147112,1.0150250476319966,132173600.0,-59.12403393466332,89.0859394939463,92.09290994229893,-3.69185777000773,18.94968091052776,24.171266247489026,-0.034592567115064136,3.468094346254171,238.2467964477539,236.24659689331054,234.62999725341797,233.01339761352537,231.01319805908201,0.04,0.0,215.67522593146396,-0.018050281753772435,-0.014359392904953189,235.34434291294642,233.56477791922433,3.500574064939899
2023-10-23,1,232.15750122070312,229.58999633789062,240.14999771118164,231.0918731689453,236.55999946594238,0.2590375526910893,3.290632717675281,-1.1341697575864775,2.995633589935151,234.0425033569336,2.8108753204345702,0.014056848685656924,230.11650199890136,238.88400382995604,0.878219061579809,-0.0005339484342819272,0.9917250407104438,0.980365871264961,0.9769931108180797,-0.030768920581198178,46.8038897281434,240.67589014543358,234.094624710083,227.5133592747324,236.78785814557756,2.9922693807790406,235.50071443830217,2.930858338322223,236.3865716204686,235.24156440706116,-1.1313793471240843,1.658611211710264,5071700,1.6659591258329138,0.9023229251082825,127101900.0,-78.9682871270222,89.0859394939463,92.09290994229893,-37.04706636446758,17.701160389341524,25.396480281372916,-0.05736427785673416,3.44751674541961,238.50639788818359,236.6667992248535,235.18000030517578,233.69320138549804,231.85360272216795,0.06,0.0,215.7010758661609,-0.03557297820443539,-0.025834147886856413,234.60020010811942,233.7575454711914,3.5426900608573577
2023-10-24,0,234.23999786376953,229.58999633789062,240.14999771118164,231.0918731689453,236.55999946594238,0.330899721609304,3.317589298880784,-1.1545855011338837,2.9956319181499973,233.75375175476074,2.8974750518798826,0.014177898691140861,230.11650199890136,238.88400382995604,0.8664995574352057,0.0051740153547171755,1.0010373979220253,0.9897325280377992,0.9919098059189858,-0.024609618587295712,43.561204155162,240.63242820103304,233.99724960327148,227.36207100550993,236.3600011553083,3.128692061582438,235.78071430751257,2.5618668049876296,235.32053078600205,234.6637605395447,-1.8475648409024765,1.0687745399279371,6844100,1.5577448508963594,1.210646600368637,133946000.0,-60.65723945875957,89.0859394939463,92.09290994229893,11.274406889659096,20.079699794388667,22.84753971777912,-0.006038095956384066,3.5584084064610666,238.82263702392575,237.1786778259277,235.8499984741211,234.52131912231445,232.8773599243164,0.06,0.0,215.74054459494033,-0.027155967023061667,-0.02257684205563341,234.17213875906808,234.00063105991907,3.397979174096072
2023-10-25,0,234.71749877929688,229.58999633789062,240.14999771118164,231.32062149047852,236.55999946594238,0.24328695731493996,3.243763881896208,-1.0835500839723602,2.9956364268380433,234.11000061035156,2.757874870300293,0.013852700303204818,230.11650199890136,238.88400382995604,0.8347880376078731,0.020253502330456235,1.0023760313302241,0.9924881753321022,0.9989317610612819,-0.017147364438580004,51.88863115239615,240.64865237469328,234.16112461090088,227.67359684710848,235.6728575570243,2.8311322769031655,235.9694641658238,2.356993572382769,235.04461096173034,234.48827501459348,-1.2624608393948513,1.7019790613665076,10365300,1.5810552143793428,1.7654512969261769,144311300.0,-45.39206871842602,89.0859394939463,92.09290994229893,26.433166854575546,21.026888872144347,19.774088235467673,0.03502160744290752,3.8178079803857203,239.0727964477539,237.58359689331053,236.37999725341797,235.17639761352538,233.68719805908202,0.06,0.0,215.8026753481515,-0.002610925306721912,-0.018034904658683244,233.71572875976562,234.23946489606584,3.258119194532735
2023-10-26,0,232.9550018310547,229.70249938964844,240.14999771118164,231.90187454223633,236.55999946594238,0.20109666271632282,3.0703408352534765,-0.9671200600766081,2.9956465684237275,234.31374740600586,2.552250118255614,0.013097745854089187,230.30424995422362,238.88400382995604,0.8479398595769471,0.015499601894041313,0.9937611402579482,0.9858442719212228,0.9948985650526592,-0.011446932749648475,52.2114970359635,240.55818140347813,234.41749973297118,228.27681806246423,234.64500100272042,2.161727392988389,235.8671430860247,2.459803487246957,234.95676210067407,234.45963398921543,-2.0081222858838106,1.1386396672068473,6414500,1.5525613694063674,1.0723504276361984,137896800.0,-91.72663153850374,89.0859394939463,92.09290994229893,-58.60183533485732,18.595296669140435,19.144478052633655,-0.014042193045950661,4.008679231298457,238.8556768798828,237.23215759277343,235.9199981689453,234.60783874511716,232.9843194580078,0.08,0.0,215.8348760819495,-0.010820756388045583,-0.02606644570468917,232.30965532575334,233.97299303327287,3.276807779001052
2023-10-27,1,229.9650001525879,229.70249938964844,240.14999771118164,232.1368761062622,236.55999946594238,0.1847873390566556,2.9978185473005587,-0.8601587310459617,2.995650625346059,234.31374740600586,2.4703499603271495,0.012783411042546069,230.30424995422362,238.88400382995604,0.8283494112288956,0.006796131854945533,0.9806254367853056,0.9746644031960666,0.9843970701243937,-0.01715959973819159,46.07938859552074,240.5041370030484,234.50849990844728,228.51286281384614,233.38107190813338,1.8881253006611536,235.61267880031042,2.8704470930129085,234.45126725072413,234.2307509570679,-2.9960424520928264,-0.6111653291403277,5540900,1.6122715861915198,0.93021889330326,132355900.0,-90.78062621176912,89.0859394939463,92.09290994229893,-129.85722448716066,17.4689757754204,22.185150815983906,0.013645284254226784,3.9623450440879644,238.3057964477539,236.34209689331053,234.75499725341797,233.16789761352538,231.20419805908202,0.1,0.0,215.85782195373497,-0.017610699477836333,-0.019417453377333607,231.14737810407365,233.60659245082311,3.333686888838693
2023-10-30,1,232.17000198364258,229.70249938964844,240.14999771118164,232.1368761062622,236.55999946594238,0.1306779320328268,3.086335569816773,-0.9042316389683007,2.9956456614121105,234.31374740600586,2.534137268066405,0.013164847443791226,230.14275207519532,238.88400382995604,0.7500072902663546,-0.0008580986662311921,0.9903273924684787,0.9870512544763376,0.9972638366289529,5.384604362856926e-05,38.811313816025354,240.61029626170387,234.4376251220703,228.26495398243674,232.8835721697126,1.6311992045823545,235.33910751342773,3.0098210162147394,233.31954213447753,233.74010613515523,-3.704790796454466,-1.525516265824045,5170300,1.7315765923066047,0.868037425855941,137526200.0,-62.45350038969474,89.0859394939463,92.09290994229893,-66.44656149548015,19.755957730190847,20.545809097653294,0.00917265364389915,3.972891870249648,238.3057964477539,236.34209689331053,234.75499725341797,233.16789761352538,231.20419805908202,0.1,0.0,215.88321272533415,0.006694641377570587,-0.0012853765192429641,231.04390825544084,233.3571286882673,3.2656097118256784
2023-10-31,0,234.3450050354004,229.70249938964844,240.14999771118164,232.16687679290771,236.55999946594238,0.17055471169271977,2.9763508000370953,-0.8026683693055197,2.9956518054217307,234.31374740600586,2.4437997817993162,0.012690271080514152,230.28449974060058,238.88400382995604,0.7442877468687332,0.010742166935713103,0.9991771266433446,0.999424276480511,1.006595542331928,0.00044828881740310855,46.57628551428892,240.49070170688572,234.53800010681152,228.58529850673733,232.93571526663644,1.6772724597236472,235.17392948695593,2.9953220970679264,233.0283835081091,233.70691379376396,-1.4778108302226167,-1.6228805154056873,4828400,1.7962068925406875,0.815822399295761,142354600.0,-47.43487785591853,89.0859394939463,92.09290994229893,-8.002238510888912,23.06735776570449,19.514318533004193,0.054197756545404,3.884113574341747,238.3057964477539,236.34209689331053,234.75499725341797,233.16789761352538,231.20419805908202,0.1,0.0,215.91039630001805,0.001917891715111475,0.015419236074384727,231.28770664760046,233.31602478027344,2.971127505982244
2023-11-01,0,237.3599967956543,229.9650001525879,240.14999771118164,232.75875186920166,236.55999946594238,0.22829494250571075,2.7636101269534334,-0.6315678750869917,2.9956630470528465,234.3662509918213,2.2401496887207033,0.011771557911693964,231.89950065612794,238.88400382995604,0.7186432314360666,0.01747570921287485,1.0110315203106137,1.014794795865712,1.019454045792882,0.011258206269666005,52.36444645888193,240.297345643006,234.77012538909912,229.24290513519225,233.6789289202009,2.3087349215422317,235.23339353288924,3.0322959207132096,233.36116823314035,234.0452857927267,0.15599695411149786,-0.9771473103335465,4996200,1.8512860498635235,0.8472860289890465,147350800.0,-21.56129780284716,89.0859394939463,92.09290994229893,79.00147452312204,27.496877705198756,18.10183878721322,0.0547886288230818,3.8881045463614234,238.3057964477539,236.34209689331053,234.75499725341797,233.16789761352538,231.20419805908202,0.02,1.0,215.94318757511797,0.007304223316570102,0.016748372974000354,232.28698076520647,233.44359043666296,2.943531711202368
2023-11-02,0,241.4025001525879,229.9650001525879,240.14999771118164,233.3843755722046,236.80187225341797,0.15627431628554064,2.6189363864425297,-0.6249869014427532,2.995670272059597,234.55249786376953,2.1823369598388664,0.011138621615142088,232.14925117492675,238.88400382995604,0.6855374078494846,0.022772793344136944,1.0267111183259594,1.032719188686237,1.0344683468516238,0.036262360778411384,58.543964390030986,240.3599980170257,235.12212524414062,229.88425247125554,234.70214353288924,3.74146849166376,235.53107234409876,3.4232634517232485,234.36639894270223,234.67712893614691,2.240933653918579,0.3519661107183514,6286700,1.9264187084500615,1.0646879157151,153637500.0,-0.0,89.0859394939463,92.09290994229893,175.19912170156402,32.795952406685636,16.570823537688742,0.0746283145705179,3.9439540908317015,239.65807971191407,237.4359595336914,235.63999938964844,233.84403924560547,231.6219190673828,0.04,0.0,215.99209755549296,0.05175542946663847,0.027021379780848627,233.5059574672154,233.83904811314173,3.3944330394898805
2023-11-03,0,244.07500076293945,229.9650001525879,241.4025001525879,233.86687755584717,237.2662467956543,0.21941676492076465,2.854685491154647,-0.5154049547414505,2.9956589202513517,235.18499946594238,2.343999481201172,0.012117253128086144,232.16875190734862,239.5897533416748,0.6373278095601802,0.029929084510402732,1.0360225585782887,1.0415899850998096,1.0384027122373551,0.06135716565994476,65.09998870785549,241.29787119593232,235.58850021362304,229.87912923131375,236.03892953055245,5.153198975574087,235.85589354378837,3.9989772569560476,236.12502332205278,235.71390044668468,3.057762275503419,1.7566983848185482,5029800,2.056887462151962,0.8618315934666113,158667300.0,-9.947948933827004,89.0859394939463,92.09290994229893,186.0166119310601,34.75880751987986,15.637534178515747,0.059586128470113305,3.880815428442497,241.2395653076172,238.7152240600586,236.6750030517578,234.63478204345702,232.11044079589843,0.06,0.0,216.0338461020213,0.06250264957131946,0.05326871811989931,234.46271187918526,234.08922031947546,3.803506997495758
2023-11-06,0,243.72000122070312,229.9650001525879,244.07500076293945,233.86687755584717,237.72312355041504,0.49103471817024724,3.38282782070179,-0.16501608794647415,2.9956298358952598,235.82625007629395,2.7091618919372564,0.01432959129636349,232.16875190734862,240.27524795532227,0.6506964149228973,0.04516598945931327,1.0323930727037014,1.0356135602260013,1.0245911126070442,0.049748025750003144,69.7756841599543,242.83853104576147,236.07287540435792,229.30721976295436,237.5767865862165,5.6607711500445195,236.11089379446847,4.388693124954515,238.1090071345783,236.95567321918816,3.9867082907360767,1.8985280271928175,5254100,2.0966434683316613,0.9011761033365522,153413200.0,-10.584158048852647,89.0859394939463,92.09290994229893,155.68833412350764,33.3254040527811,14.99266465312884,0.024446156218000788,3.75861419562127,241.2395653076172,238.7152240600586,236.6750030517578,234.63478204345702,232.11044079589843,0.06,0.0,216.07716538709508,0.044662794093408564,0.062022976545860524,236.19337463378906,234.2515149797712,4.102918061551559
2023-11-07,0,244.1575050354004,229.9650001525879,244.07500076293945,234.17499923706055,238.99125385284424,0.41010405236889313,3.7126521885829415,-0.49562665705316133,2.995609392467204,236.26375007629395,2.9697494506835938,0.015692843643969136,232.16875190734862,241.6342502593994,0.7557390903487776,0.03271186957925053,1.032018448376274,1.0324002814554432,1.0165583976584485,0.04187202538632184,67.7249726067941,244.00780483492954,236.58250045776367,229.1571960805978,239.60428728376115,4.980917404212171,236.49267959594727,4.850033827571458,239.5194576627922,238.08322693392202,4.621063855694976,1.4865723687472103,4219700,2.055206791133106,0.7264004214110557,157632900.0,-3.1810455751296987,89.0859394939463,92.09290994229893,144.09276344051267,32.78498692286199,14.491445188209477,0.040858903785509666,3.61085621317734,241.2395653076172,238.7152240600586,236.6750030517578,234.63478204345702,232.11044079589843,0.06,0.0,216.1128400741027,0.04113137277335244,0.05015441598847795,238.39036342075892,234.7688707624163,4.479143291105847
2023-11-08,0,243.7375030517578,229.9650001525879,244.1575050354004,234.17499923706055,239.68312740325928,0.3367765713820127,4.0582623659368515,-0.8350018925088829,2.9955859214634346,236.59249877929688,3.3526624870300283,0.017124165290622793,232.16875190734862,243.75550117492676,0.7956402832420794,0.03169140091314173,1.028470047874407,1.0263204235432355,1.006584961172018,0.026868496554598442,68.1766342449616,245.1069004414074,236.99037570953368,228.87385097765997,241.25678743634904,3.9063368711755824,237.07017980303084,5.210265313131747,240.69080783493396,238.97171660351066,6.171593448305349,2.2381580257834797,5117500,2.0543786027943156,0.8782565641848089,152515400.0,-8.155020042043446,89.0859394939463,92.09290994229893,115.03311758260007,31.46450093882614,15.093598873790816,0.06983641010167664,3.4936522851434693,241.2395653076172,238.7152240600586,236.6750030517578,234.63478204345702,232.11044079589843,0.06,0.0,216.1550900756592,0.02451712047195187,0.0396821176041624,239.9990234375,235.52146584647042,4.750309130456038
2023-11-09,0,242.85499954223633,229.9650001525879,244.1575050354004,234.17499923706055,240.4631233215332,0.22481355763771793,4.314489912061576,-1.1204549071063818,2.995567258381417,236.8812484741211,3.6843128585815434,0.01817818473276253,232.16875190734862,243.77125282287597,0.8323267020328815,0.03048272566411359,1.023217839173088,1.0187351454716154,0.9976850465444982,0.006016919413553312,66.76481457339631,245.97335581594447,237.3443759918213,228.71539616769812,242.4725009373256,2.4492392447716256,237.70410810198103,5.343566066157398,241.4660508552849,239.59332730721485,4.982340943827109,3.430900539537999,4866600,2.059291966782629,0.8323847722812073,147648800.0,-21.284014550999984,89.0859394939463,92.09290994229893,79.57242254965884,29.20727782991923,17.75103697088492,0.0312100431131545,3.494819586692929,241.2395653076172,238.7152240600586,236.6750030517578,234.63478204345702,232.11044079589843,0.06,0.0,216.19304001213322,-0.00450385746876103,0.014982165470016491,240.9989253452846,236.1433159964425,4.855819498504534
2023-11-10,0,244.11750030517578,229.9650001525879,244.1575050354004,234.17499923706055,241.765625,0.08313838840229923,4.472104020352097,-1.310105706601858,2.995555305180683,237.2974967956543,3.949075660705566,0.018817175331909356,232.16875190734862,243.77125282287597,0.86156210036294,0.023689602387892625,1.0271679245216363,1.0197960299512763,1.001676172727908,0.00017412492923685186,63.19505575432414,246.6049590020079,237.6607509613037,228.71654292059952,243.43785858154297,1.003124611871486,238.55839375087194,5.34464199003937,241.82966569232934,239.92990138027892,3.6313957302185336,3.7930575510609073,4094400,2.076496475285276,0.7055715579390156,151743200.0,-0.40490046049925954,89.0859394939463,92.09290994229893,96.97976033160586,28.656518720770922,16.437688866174042,0.05816071756678961,3.5044756792729004,241.2395653076172,238.7152240600586,236.6750030517578,234.63478204345702,232.11044079589843,0.06,0.0,216.22707346944725,0.008916805230549496,0.010368456736844688,242.01834760393416,237.1526641845703,5.16878689156126
2023-11-13,0,244.86499786376953,229.9650001525879,244.1575050354004,234.17499923706055,243.07124996185303,-0.01758793539909049,4.685798705285383,-1.4448904599308685,2.9955384264122014,238.08625030517578,4.250625419616699,0.019687826490548396,232.16875190734862,244.0792507171631,0.8638136763661346,0.019162711011748906,1.0288234503357288,1.016906552703739,1.0047083037701179,0.004698000317296724,64.66879919453432,247.37647354735054,238.00487613677979,228.63327872620903,243.9325011117118,0.6081252460973867,239.3173223223005,5.437821045161635,242.40659218141016,240.26583331714687,2.8469428719023324,5.151674626745207,4088500,2.0367250097036744,0.7177825198845158,155831700.0,-5.722350459492872,89.0859394939463,92.09290994229893,97.4071737138544,28.571820626551666,15.890096250859223,0.023701180325210482,3.3662982782840993,241.51459411621093,238.9376950073242,236.85499572753906,234.77229644775392,232.1953973388672,0.08,0.0,216.2617722301234,0.0069854096407344635,0.006530800197426148,242.293452671596,237.89970506940568,5.385764626451707
2023-11-14,0,246.65499877929688,229.9650001525879,244.86499786376953,234.17499923706055,243.7243766784668,-0.04368663899186091,4.911479525933201,-1.5299999278250032,2.995519741102744,238.08625030517578,4.517500114440918,0.02061293253938582,232.16875190734862,244.12150077819825,0.8682818394276379,0.019633563179369356,1.035183557926754,1.0189681541587674,1.0111028344606432,0.01022902713367091,65.91555031156506,248.09470988347041,238.271750831604,228.4487917797376,244.30107225690568,1.2013653666811006,240.17000089372908,5.594729243905787,243.01462429076656,240.53396402114663,1.4343255388792715,4.535946079618452,14092000,2.0381462388320353,2.2823880205401963,169923700.0,-4.9748268241926255,89.0859394939463,92.09290994229893,113.62466605218125,31.3759629490424,14.788446653546128,0.009604967926787758,3.358705151752088,243.23359411621095,240.3281950073242,237.97999572753906,235.6317964477539,232.72639733886717,0.1,0.0,216.38904398677622,0.011013295157780378,0.016328027126111977,242.84138706752233,238.6520494733538,5.72093259851977
