date,buy?,todays_price,Minimum,Maximum,25th Percentile,75th Percentile,Skewness,Standard Deviation,Kurtosis,Shannon Entropy,Median,Mean Absolute Deviation (MAD),Coefficient of Variation (CV),10th Percentile,90th Percentile,Autocorrelation,Cumulative Return,curr_to_avg_one_month,curr_to_avg_one_two_week,curr_to_avg_one_one_week,momentum,rsi,upper_band_current,middle_band_current,lower_band_current,rolling_mean_7,rolling_std_7,rolling_mean_14,rolling_std_14,ema_7,ema_14,roc_7,roc_14,Volume,Volatility,Relative Volume (RVOL),On-Balance Volume (OBV),Williams %R,Stochastic Oscillator %K,Stochastic Oscillator %D,Commodity Channel Index (CCI),ADX1,ADX2,Chaikin Money Flow (CMF),Average True Range (ATR),Fib_23.6,Fib_38.2,Fib_50,Fib_61.8,Fib_76.4,Parabolic SAR 2,Parabolic SAR 3,VWAP,Adj Close Momentum,Adj Close Return,Adj Close 7d MA,Adj Close 14d MA,Adj Close Volatility
2021-12-30,0,344.70249938964844,308.4550018310547,347.69000244140625,325.9312515258789,334.2874984741211,-0.43298511741739704,10.269549351713527,-0.2396045863521037,2.9952448547486035,331.1062469482422,7.748048820495609,0.031145423402912605,312.8887512207031,342.98425140380857,0.8035780604430535,0.07763248096205135,1.0454115291574584,1.024754307167196,1.0137950919108987,0.03902727710591569,68.43407236334916,350.26809993938906,329.7290012359619,309.18990253253475,339.2646451677595,7.461007514489682,336.05017852783203,6.525769789818522,339.43903755261874,334.0390515536586,3.5018203863096193,5.322638598320275,10593300,4.95819594455568,0.5363060781659287,122210600.0,-27.66735629533904,70.74152269624075,78.01649708558223,117.18633014817505,32.1226260359932,13.98757211816845,0.03716251940259035,9.327273563066552,345.5875131835937,341.1812342529297,337.6199951171875,334.0587559814453,329.6524770507813,0.04,0.0,328.98916372692196,0.04209400331168456,0.030400849733026408,339.2443106515067,335.9788731166295,10.843099327620363
2021-12-31,0,339.7699966430664,308.4550018310547,347.69000244140625,327.6125011444092,335.7999973297119,-0.5708350208586304,10.529337951399848,-0.14484236321002175,2.9952228262899627,331.5200004577637,7.639561157226564,0.03181615548675105,312.8887512207031,344.7617500305176,0.7743968652335538,0.10873355992170593,1.0266718660589196,1.0072034022675762,0.9917352819247118,0.021580456234319367,71.48787445691595,352.00180181832707,330.94312591552733,309.8844500127276,340.64750126429965,6.280858498347883,336.6817855834961,6.418866018662176,340.72106376567274,335.52418530203454,5.441016296073016,4.179855982231741,12870500,4.286968838117186,0.6711755885139045,109340100.0,-54.20804944293778,70.74152269624075,78.01649708558223,57.584544369334935,29.56990643173639,19.70299902500015,0.014237519161070989,9.215273314597969,345.5875131835937,341.1812342529297,337.6199951171875,334.0587559814453,329.6524770507813,0.04,0.0,329.2739614085757,0.003311070705106278,0.017854371574408653,339.55082048688615,336.44933646065846,9.667239144363664
2022-01-03,0,338.7774963378906,308.4550018310547,347.69000244140625,329.52875328063965,338.4574966430664,-0.7107788421608654,9.622226659726213,0.47847890713729857,2.9953101711176298,332.1737518310547,6.963248825073242,0.028948887546809972,321.9930030822754,344.7617500305176,0.7151511586507574,0.10152208466751789,1.019226837164785,1.0037405609200738,0.9847123865053915,-0.0115252046219958,63.83172585687234,351.6312037314397,332.3867504119873,313.1422970925349,341.6507143293108,5.067387101373178,337.02089255196705,6.393350231404568,340.48279425890746,336.43721049404087,2.932531297355076,2.6720350639876416,14537900,4.44902015356818,0.7845855775146524,94802200.0,-46.95157835981629,70.74152269624075,78.01649708558223,52.280305220107394,28.160834086121856,18.764106941729953,0.0004970849186827219,8.816864477707332,345.5875131835937,341.1812342529297,337.6199951171875,334.0587559814453,329.6524770507813,0.04,0.0,329.5842090823947,-0.02206934530279636,0.009843726183264453,340.70416259765625,336.73803056989397,7.546884301803263
2022-01-04,0,337.86000061035156,313.11000061035156,347.69000244140625,330.6768798828125,339.02562141418457,-0.4486205059751917,7.980868616621696,0.45102576802362515,2.9954455094610504,333.1024971008301,6.094661827087402,0.023901766683917556,326.521501159668,344.7617500305176,0.6612271548384064,0.0819759690763786,1.011851127281833,0.9994926496607045,0.9843057637508764,-0.02827231660971119,61.03957900305916,349.8646123705725,333.9028751373291,317.9411379040857,342.40321459089006,3.7064115002212135,337.490535736084,6.177438731924574,340.09087115681814,337.23230154524686,2.116770312947868,1.4212788000908136,15998000,4.426803303254002,0.8770167396828695,78804200.0,-53.6116520954802,70.74152269624075,78.01649708558223,23.16406640421376,25.104799038255212,21.873365871416993,-0.04722964855262785,9.026674474522583,345.5875131835937,341.1812342529297,337.6199951171875,334.0587559814453,329.6524770507813,0.04,0.0,329.84285930951415,-0.02798800389200462,-0.027875607875825183,340.8880702427455,336.93690708705356,6.467567731690503
2022-01-05,0,329.19750213623047,322.9800033569336,347.69000244140625,330.9137496948242,339.02562141418457,0.2604689790100397,6.428733792241494,-0.6919774102891387,2.995548575393747,333.8212471008301,5.371949768066406,0.01918221219871589,327.7520011901855,344.7617500305176,0.7182909893006373,0.04607095516366596,0.9822675110432055,0.9707232745005057,0.9645936995371174,-0.046619567013114205,56.52876472213347,347.9978427218121,335.1403751373291,322.2829075528461,340.4703576224191,6.19891179488615,337.071786063058,6.5427688395527595,339.5615180032239,337.4896980430831,1.5837704850193024,1.9846973622033364,20564500,3.9655183229544586,1.1219094910995198,58239700.0,-94.56588785141233,70.74152269624075,78.01649708558223,-102.29624026833504,22.17385512835457,26.70730617438876,-0.08222355809887863,9.3415086537575,345.5875131835937,341.1812342529297,337.6199951171875,334.0587559814453,329.6524770507813,0.02,1.0,329.76219276030935,-0.0547325125265139,-0.06368776625925923,337.75023978097096,335.690185546875,6.33456153700255
2022-01-06,0,329.2925033569336,326.91500091552734,347.69000244140625,330.9137496948242,339.02562141418457,0.5431234217561796,5.966919626349821,-0.832914625388562,2.995574563295805,333.8212471008301,5.123249816894531,0.017787740021814567,329.06225204467773,344.7617500305176,0.6778675509193199,0.004125427901878696,0.9816404120778813,0.9712590230595394,0.9740609454438468,-0.04470520538725631,42.416529339160924,347.3850893289936,335.45125007629395,323.5174108235943,337.8421434674944,6.519555606068997,336.44839368547713,6.8538545947040355,336.9764703191061,336.24838006918105,-3.9477423735049606,-1.7496852698263614,27962800,4.363178222473795,1.4928489498651045,86202500.0,-67.09743179046613,70.74152269624075,78.01649708558223,-58.36693283290784,21.971439580277213,22.96450283658874,-0.0958529733748652,9.943688762230849,345.5875131835937,341.1812342529297,337.6199951171875,334.0587559814453,329.6524770507813,0.04,0.0,329.85342599386206,-0.03455690015529911,-0.03055933467048164,335.7885524204799,335.5162571498326,6.27128814031474
2022-01-07,0,332.60250091552734,326.91500091552734,347.69000244140625,330.9137496948242,339.02562141418457,0.5806742472457578,5.882401605316953,-0.8148418974848304,2.9955790924982573,333.8212471008301,5.065349731445314,0.01753200419823417,329.28300323486326,344.7617500305176,0.7015340630420736,-0.004775258766687171,0.9912938343284053,0.9817350258828499,0.992904046657582,-0.02109514023708403,41.353746305948775,347.28842839373937,335.5236251831055,323.7588219724716,336.0289284842355,5.8298383185843,336.3762512207031,6.891214614473779,335.06890355573,335.20053341825457,-5.291351190799068,-2.5819458531468613,14722000,4.307382229670796,0.7905148951810648,100924500.0,-69.31738895663834,70.74152269624075,78.01649708558223,-44.58281781611162,20.448108540291464,21.372320409897927,-0.08257615680087288,9.791224207195047,345.5875131835937,341.1812342529297,337.6199951171875,334.0587559814453,329.6524770507813,0.04,0.0,329.9282282004947,-0.013557337246446588,-0.036502490753804684,334.19896153041293,335.37369210379467,6.191646265098068
2022-01-10,0,324.2874984741211,326.91500091552734,347.69000244140625,331.1956214904785,339.02562141418457,0.5723521658360977,5.825819163179969,-0.7811726044236038,2.9955820904076327,333.8212471008301,4.9961499023437455,0.017358889764454277,329.28300323486326,344.7617500305176,0.7093602118142617,0.005061540858860114,0.9662625598783979,0.9571890016609347,0.972242202938637,-0.042771429685865114,46.75749821017068,347.26176329584234,335.6101249694824,323.95848664312246,333.1124997820173,5.87386216967934,336.1885724748884,7.197673045364446,334.4773943540599,334.7280625126786,-3.6758437480052093,-0.30274480743212406,24942400,4.373689735747985,1.302881708522633,75982100.0,-66.09438019762752,70.74152269624075,78.01649708558223,-150.27065478222747,17.77424319583329,29.328019870014074,-0.009585871148845421,10.333783908912437,343.91191174316407,338.4690319213867,334.0699920654297,329.67095220947266,324.2280723876953,0.06,0.0,329.66036220151517,-0.0309269745892925,-0.02461724633747965,331.87659127371654,335.5604509626116,6.2863314147281155
2022-01-11,0,330.26499938964844,324.2874984741211,347.69000244140625,330.9862480163574,339.02562141418457,0.3460532613982094,6.256491720561428,-0.7546827717373366,2.9955585167534617,333.8212471008301,5.261749877929685,0.018660602210661455,328.96925201416013,344.7617500305176,0.6516250740651441,-0.029166542947577975,0.9850478595633056,0.9801675299309289,0.9988416633165428,-0.022479728902452423,36.23219826712906,347.79110844112284,335.278125,322.76514155887713,331.75464303152904,5.129865334101177,336.2010721479143,7.186410558784093,331.94338564484156,333.39346145080424,-5.922498662375645,-0.8037264836571936,16226800,4.6910884130944135,0.8627637384869042,92208900.0,-49.19527075756125,70.74152269624075,78.01649708558223,-48.678680549801285,21.461250435602555,27.143457657792588,0.04000044499239887,10.253424682576174,343.91191174316407,338.4690319213867,334.0699920654297,329.67095220947266,324.2280723876953,0.06,0.0,329.7103646399123,-0.00641847135627438,-0.012317657781515428,331.5943123953683,335.5725664411272,6.287475444108514
2022-01-12,0,333.70999908447266,324.2874984741211,347.69000244140625,330.2212505340576,339.02562141418457,0.39617577061052095,6.347198678516481,-0.8192037077798564,2.9955533035786615,333.1074981689453,5.412349853515627,0.01894177995661141,328.96925201416013,344.7617500305176,0.6965098307320365,-0.00307890986697653,0.9958820720980625,0.9955400390228606,1.0139185493167944,0.013707567399386944,45.625128926856334,347.7842723875506,335.0898750305176,322.3954776734846,331.0307148524693,4.256907225285568,336.34071459089006,7.111980077346836,331.52177605980603,333.0016222621062,-2.797479867948174,0.05301445674211475,14104900,4.873430729614883,0.7628342155610089,106313800.0,-52.17269937319446,70.74152269624075,78.01649708558223,-26.72682656137263,21.76991688815751,25.74320597632216,0.013023829515180387,9.937004060441554,343.91191174316407,338.4690319213867,334.0699920654297,329.67095220947266,324.2280723876953,0.06,0.0,329.79465299411055,0.0280407183730762,-0.00971684994576458,330.84157017299106,335.77286638532365,6.295707577953577
2022-01-13,0,330.71250915527344,324.2874984741211,347.69000244140625,330.2212505340576,339.02562141418457,0.3585873777866134,6.2963145678235,-0.7842469388319291,2.995556243772657,333.66124725341797,5.315349731445314,0.018783131271028687,328.96925201416013,344.7617500305176,0.7154617405451517,-0.004029124586515322,0.9865797532066553,0.9900193820855162,1.0020634663982955,0.004312293124999034,48.84299578452314,347.8037543187525,335.2111251831055,322.61849604745845,330.009644644601,3.0246645837534203,336.2064296177455,7.205331937939434,332.0720729982515,333.24767519333363,-1.4958187330021877,0.589288533069977,14797100,4.860325078613579,0.8222477156621377,91516700.0,-70.35939197325455,70.74152269624075,78.01649708558223,-69.85369982534162,20.036968739689765,27.137778076017202,-0.08690343071406903,9.931636642040568,343.91191174316407,338.4690319213867,334.0699920654297,329.67095220947266,324.2280723876953,0.06,0.0,329.78225101196045,-0.017987054104102174,0.007125809622456045,329.40880039760043,335.148435320173,6.4328565038531
2022-01-14,0,326.9075012207031,324.2874984741211,347.69000244140625,330.2212505340576,339.02562141418457,0.43068598809354575,6.372366972231962,-0.8239438422083882,2.995551819284204,333.1074981689453,5.489249267578122,0.019022345813075808,328.96925201416013,344.7617500305176,0.7065541720087989,-0.021618506479985974,0.9758614913746299,0.9827444986686612,0.989682590830216,-0.01712254020684767,44.4583578181572,347.73848470740336,334.99375076293944,322.2490168184755,329.68250165666853,3.243098716041261,335.0764296395438,7.343168502444601,331.69792279448427,333.2007661886153,-2.115518688855154,-0.565253164435007,16868500,4.846817818351796,0.9526141050250203,74648200.0,-55.82081072961409,70.74152269624075,78.01649708558223,-71.96366392753046,18.2144735842561,28.261896668436496,0.0025299341204271203,10.057772379086627,343.91191174316407,338.4690319213867,334.0699920654297,329.67095220947266,324.2280723876953,0.06,0.0,329.7503951043838,0.00033152687897719524,-0.0016843719496513335,330.5108163016183,334.13052804129467,6.464860506030522
2022-01-18,0,320.82250213623047,324.2874984741211,347.69000244140625,329.89062881469727,339.02562141418457,0.5499126152737129,6.565805763128333,-0.8133751538087357,2.995540225773229,332.5974998474121,5.575562019348138,0.01963234826668327,326.91425094604494,344.7617500305176,0.7091173924373764,-0.020098150679792242,0.9592880631799624,0.9681955904683666,0.9746215197882055,-0.010684951946018817,41.5425439650084,347.56973751807794,334.43812599182127,321.3065144655646,328.4725014822824,4.676268554559946,333.1573224748884,7.303835797445483,330.4498862510811,332.5370322959279,-0.6956313157502884,-4.615911957040005,22645600,4.822303298278097,1.344811286020034,52002600.0,-92.06071090081166,70.74152269624075,78.01649708558223,-154.56251787157052,16.24478045612786,27.91293679034415,-0.048911439243891484,10.388832779646295,341.60464013671873,336.6026787109375,332.55999755859375,328.51731640625,323.51535498046877,0.06,0.0,329.40625925741983,-0.03023745375718012,-0.04111034683684002,328.4707249232701,332.129638671875,7.4407217493485645
2022-01-19,0,321.3999938964844,320.82250213623047,347.69000244140625,329.2687530517578,339.02562141418457,0.3456591343174662,7.206665168818823,-0.7809924412723368,2.9954997523911984,332.1737518310547,6.023211784362786,0.021589858676493857,326.64550094604493,344.7617500305176,0.6860856053258146,-0.018636338994034527,0.9628559513038109,0.9752226749574764,0.978435725832808,-0.02684209804110993,37.25198626966301,348.2119566651523,333.7986263275146,319.38529598987697,326.8721433367048,4.9369418746147895,331.45053591047014,7.036312185305653,328.02186868898787,331.1618187379692,-2.572181611897233,-7.727429640345662,20814700,4.781658497663759,1.2254837168458896,72817300.0,-86.91823501016772,70.74152269624075,78.01649708558223,-126.99572387703525,17.33772169490535,26.011684130641306,-0.0947252989540887,10.276306396901582,339.7252066650391,335.0824039916992,331.3300018310547,327.57759967041017,322.9347969970703,0.06,0.0,329.1737518410001,-0.044202544190151793,-0.02584816098802478,326.73144095284596,330.4652012416295,7.889101563233252
2022-01-20,0,321.06500244140625,320.82250213623047,347.69000244140625,329.2687530517578,339.02562141418457,0.22598746084109345,7.56155235165228,-0.8170802174513883,2.995475660148537,332.1737518310547,6.23494934082031,0.02267176525601695,323.9987480163574,344.7617500305176,0.7440511549820117,-0.026326183666143487,0.9626476190016073,0.9790962620740518,0.98272017998123,-0.03789217187904981,36.93780745883093,348.645980679867,333.5228759765625,318.39977127325795,326.4117867606027,5.351002546439244,329.76214327131,6.420887505909177,326.3793795309807,330.4637317120203,-3.3681367362562686,-6.920173040617535,16925000,4.716448378207089,0.9941090594905991,55892300.0,-95.96571050039658,70.74152269624075,78.01649708558223,-131.96610873993455,15.804104983701373,26.213542867405636,-0.17275846880065623,10.397775072876515,336.82964013671875,332.74017871093747,329.43499755859375,326.12981640625003,322.04035498046875,0.06,0.0,328.9481935000621,-0.05011098958888205,-0.05326432274173241,325.0905282156808,328.48355974469865,8.749500771047941
2022-01-21,0,309.83250427246094,320.82250213623047,347.69000244140625,328.62500190734863,339.02562141418457,0.17515529293920531,8.009004149999933,-0.9540908209023211,2.9954435202306984,332.1737518310547,6.595949401855466,0.024045891415554157,321.3664947509766,344.7617500305176,0.7778987354964692,-0.032222580772164486,0.9302278554500284,0.947191521166847,0.9557377659761166,-0.06313642304049982,35.905454510068274,349.08963420026845,333.07162590026854,317.05361760026864,323.49285888671875,7.87595232589272,327.62375095912387,7.691036894725866,325.0806366938664,329.5505486547704,-0.9937157762410649,-6.857361635061017,28710700,4.6901510382633615,1.6291977347269984,27181600.0,-99.67539345209158,70.74152269624075,78.01649708558223,-207.35050426112997,14.074916013053285,32.617304726085,-0.23274417844872897,10.773900897359411,333.63819921875,327.7909010009766,323.06500244140625,318.33910388183597,312.4918056640625,0.08,0.0,328.10581570676277,-0.07139796919453612,-0.0902898539154765,320.6425258091518,326.11841910226,10.953997391748164
2022-01-24,1,301.27249908447266,309.83250427246094,347.69000244140625,326.2525005340576,339.02562141418457,-0.2824807177671117,9.47938930251366,-0.36253114674954334,2.9953233494006146,331.65250396728516,7.597249221801758,0.02855448452575075,321.0407524108887,344.7617500305176,0.710621634389861,-0.06843207405570235,0.9075142541999672,0.926534736127393,0.9414603759543643,-0.07841668374236432,26.704458860910734,350.93427947477835,331.975500869751,313.0167222647236,318.8589303152902,10.093109267576393,324.9448225838797,9.760540136140577,321.30354373635475,327.12139649492036,-6.186697093227591,-8.811105355501788,38878100,5.242392487352531,2.060627165142322,-11696500.0,-63.57251002063662,70.74152269624075,78.01649708558223,-204.96118034635245,12.150917600742249,37.5049112269101,-0.14690603905560334,11.521964712389405,330.3271195068359,322.43144146728514,316.0500030517578,309.6685646362305,301.7728865966797,0.1,0.0,326.7687104287289,-0.06987048109181682,-0.05442913077906865,317.14257376534596,323.99207196916853,12.005246894982601
2022-01-25,1,300.97750091552734,301.27249908447266,347.69000244140625,323.5656223297119,339.02562141418457,-0.6742360381672947,11.598325189729849,0.1583567162333268,2.995110892504087,330.48875427246094,8.975250244140625,0.03510288039134304,319.7235023498535,344.7617500305176,0.7173885997373961,-0.12095615823158637,0.9109226584264432,0.9346329119713234,0.9558528148650467,-0.061856637513151624,18.1756263362915,353.6061512644694,330.4095008850098,307.21285050555014,314.6110719953264,10.521036166026565,322.3103583199637,10.915588450357914,316.3361741674318,323.9359689022883,-9.720266125975156,-11.070687297367341,25108500,4.7547323791022285,1.3055044781582708,-36805000.0,-77.79110183902466,70.74152269624075,78.01649708558223,-179.37106968353768,11.252437580353277,34.73167100661742,-0.2010037629565368,11.492039127346194,327.3322525634766,320.0088920288086,314.0900115966797,308.1711311645508,300.8477706298828,0.1,0.0,325.94107572149005,-0.05657704522211204,-0.095661302692724,313.3888593401228,321.3988298688616,13.096050801735641
2022-01-26,1,300.00000762939453,300.97750091552734,347.69000244140625,321.31624603271484,338.0893745422363,-0.6422286887238623,12.879789044441335,-0.17625880987507747,2.9949557731252807,329.778751373291,10.001100463867193,0.0392291378881804,308.9765037536621,344.7617500305176,0.7561181737270194,-0.1343510057748958,0.9137371446955375,0.9383900247302479,0.9649110352421124,-0.06658365486460549,15.78286114882338,354.0815789738924,328.32200088500974,302.56242279612707,310.7671443394252,10.189895186614443,320.2248229980469,12.210895253871813,312.52901936047954,320.9213921063662,-8.991195499588786,-10.916503767298634,28348800,4.475699578509899,1.430431536825332,-65153800.0,-88.79586382201,70.74152269624075,78.01649708558223,-169.80044146179821,10.054031482545595,35.334936310232976,-0.20355799995140175,11.884674218291064,327.3322525634766,320.0088920288086,314.0900115966797,308.1711311645508,300.8477706298828,0.1,0.0,324.9395306660534,-0.07809997063396479,-0.0739273108952917,308.0754961286272,319.2931562151228,14.27634910882101
2022-01-27,1,297.09000396728516,300.00000762939453,345.29500579833984,321.0043773651123,334.7474994659424,-0.6373157590536317,13.474194510267159,-0.5199823865795588,2.9948696571041804,329.24500274658203,10.78425003051758,0.04133981043285139,301.2429992675781,340.26324691772464,0.7881983139108409,-0.13117768113738262,0.9114937769485356,0.9381690785558879,0.9688891681585723,-0.07467334742750886,15.632174819820271,352.8858901649434,325.93750114440917,298.9891121238749,307.3767874581473,10.234712936420381,317.92464447021484,13.351182732309999,309.40071605886885,318.1239993673714,-8.230919599835886,-8.869294061275488,21629900,4.487934654579394,1.062241866175568,-86783700.0,-88.26837668581197,70.74152269624075,78.01649708558223,-149.37603285431442,9.563529898987452,33.61106641334788,-0.22794615991989847,11.549274130733734,325.6743623046875,318.66782373046874,313.0050048828125,307.34218603515626,300.3356474609375,0.1,0.0,324.20094601911194,-0.06924432024448779,-0.0780686813100065,304.72381591796875,316.5972704206194,15.155710106890707
2022-01-28,1,298.0649948120117,297.09000396728516,344.70249938964844,318.0750026702881,332.8793754577637,-0.5972834779931744,14.09318514547174,-0.8129770678134998,2.994774587521558,328.0525016784668,11.575799407958982,0.04356104501122614,300.87975158691404,338.8767463684082,0.7928048049576404,-0.13812634230000917,0.9212979550934804,0.9522599820391096,0.9875113404127773,-0.03798022898882514,14.574174880794082,351.71362134379984,323.52725105285646,295.34088076191307,304.0432161603655,8.570942904529527,315.45767974853516,13.618614100264796,306.311080901761,315.260504518669,-7.397392019238043,-9.779299273856482,21871600,4.469042011009532,1.045167077112826,-64912100.0,-73.18415198995807,70.74152269624075,78.01649708558223,-120.24541865399172,9.00051438492464,32.448717344155924,-0.1608641826440018,11.347485661229353,325.19303857421875,318.2784807128906,312.69000244140625,307.1015241699219,300.18696630859375,0.1,0.0,323.54469926678775,-0.004815762754160735,-0.046910546471007945,302.17476981026783,314.4531053815569,14.946693315676738
2022-01-31,1,306.7625045776367,297.09000396728516,339.7699966430664,307.69250297546387,331.1850070953369,-0.5310588890312876,14.254016732098844,-1.153247233243223,2.994739220857142,325.5974998474121,12.043799133300785,0.0443780259772809,299.80650634765624,337.95175018310545,0.8332193516684149,-0.12274480455337683,0.9550651337700218,0.9903767186210649,1.0243137403198688,0.018222723646690087,17.24955776968207,349.70340928817217,321.1953758239746,292.687342359777,302.000002179827,4.640341785961348,314.20589447021484,13.549820587284326,304.25000907583023,312.8390953073705,-7.260423001746642,-10.384018763673483,21579500,4.4948278894932185,1.0101880149509417,-43332600.0,-48.79643686545197,70.74152269624075,78.01649708558223,-58.42037787370623,15.858857177008975,29.407229256551283,-0.08132315282708485,11.581745943845489,325.19303857421875,318.2784807128906,312.69000244140625,307.1015241699219,300.18696630859375,0.1,0.0,323.1768140431956,0.014738787193424363,0.033281648335841935,301.70430646623885,313.3974173409598,14.551105940095258
2022-02-01,0,316.33499908447266,297.09000396728516,338.7774963378906,305.3900032043457,330.3768768310547,-0.3881124251716168,13.914661992295994,-1.3360186955623459,2.9947783306850853,322.84374618530273,12.281499328613284,0.04354523444003251,299.80650634765624,334.12499923706054,0.8601173076795486,-0.09450153007897173,0.9899544598602142,1.0279669925958326,1.052418820274621,0.051025402637174366,33.90412695444765,347.3743252052951,319.5450012207031,291.7156772361111,302.9289300101144,6.674582760631833,313.2108944484166,12.768793625194487,304.86278619461507,312.2487655132997,-4.454704734247611,-5.4041534067595,18023800,5.109974417696775,0.8369087153884444,-25308800.0,-36.67652130431757,70.74152269624075,78.01649708558223,-8.650377091675875,18.956650396851657,27.937735515265476,-0.035820263305198295,11.279608931039697,325.19303857421875,318.2784807128906,312.69000244140625,307.1015241699219,300.18696630859375,0.02,1.0,323.0493093532335,0.0628019185858264,0.03333232954243777,303.96109880719865,312.3018123081752,13.840328650237332
2022-02-02,0,323.92250061035156,297.09000396728516,337.86000061035156,305.3900032043457,329.5356273651123,-0.3537249491881457,13.20527986892064,-1.3370110588860502,2.994867734579663,321.2324981689453,11.70479965209961,0.04147088934047793,299.80650634765624,332.7132507324219,0.8533338848014932,-0.06370982503697838,1.0172714483181027,1.054160698660461,1.066760958607755,0.07974164124192207,46.785195020545956,344.83343609587354,318.4228763580322,292.0123166201909,306.16464451381137,10.263183674838402,312.5117874145508,11.790576044574786,307.7020273866996,313.1472488074309,2.098712924675439,-4.217825180058239,58458300,5.696145833060505,2.4708511602792576,33149500.0,-27.091390402475966,70.74152269624075,78.01649708558223,29.5987020795373,23.07597180959971,25.8817700826688,-0.014337727856893925,11.268462463390172,324.6276860351563,317.8211667480469,312.32000732421875,306.8188479003906,300.0123286132812,0.04,0.0,323.0228732385752,0.09629017717116106,0.07612856701265575,305.9983433314732,311.5704585484096,13.228667457084613
2022-02-03,0,241.53999710083008,297.09000396728516,333.70999908447266,305.3900032043457,329.22125244140625,-0.43196150616322265,12.510634877444293,-1.3400810874084539,2.994952322316152,321.2324981689453,11.147299652099605,0.039375546300809604,299.80650634765624,330.9015083312988,0.8732742433880948,-0.01602382002186631,0.7602147638796759,0.7854135484476886,0.7831147458065874,-0.18698039693241286,56.52627605778467,342.7472711129209,317.72600135803225,292.7047316031436,297.6735725402832,26.6981525783661,306.14232226780484,21.384713134333627,311.7347777822934,314.8217500498471,7.518111209854624,-2.932935333365173,188119900,5.721279873884762,5.871967505016474,-154970400.0,-97.92741361194601,70.74152269624075,78.01649708558223,-319.2441292526095,14.233281569824417,51.591527271553716,-0.1775209846281689,16.912206852972545,309.8427283935547,295.6836467895508,284.24000549316406,272.79636419677735,258.63728259277343,0.02,1.0,309.2862503690295,-0.1930492222857063,-0.1930218343439577,297.103761945452,305.24631064278736,22.10607192652307
2022-02-04,0,236.19499969482422,241.53999710083008,333.70999908447266,301.1987495422363,327.50375175476074,-2.0161909986608566,20.5168707480663,4.732514727908965,2.9934805959287867,320.94375228881836,15.120499649047849,0.06547732833018502,297.9674957275391,330.9015083312988,0.23859269158330498,-0.2664880170715122,0.7537902702059748,0.7884211090516848,0.7944000682784945,-0.20757216108590215,20.77934713638094,354.3768676023948,313.3431261062622,272.30938461012965,288.5585714067732,35.28306488442114,299.6628578730992,27.482363967687316,294.19673519967745,305.4276413491586,-19.748155139137477,-26.963755402604324,89342200,19.20111097883707,2.5449329550305126,-244312600.0,-92.86955177131485,70.74152269624075,78.01649708558223,-257.5589577846292,13.43874759950807,51.23027170927076,-0.15447543459626292,16.58540879902192,304.89796014404294,290.6060202331543,279.0550003051758,267.50398037719725,253.2120404663086,0.04,0.0,303.96109000447393,-0.214179195774161,-0.19532317968980686,288.9006151471819,298.48805563790455,27.410920935996867
2022-02-07,0,231.22999954223633,236.19499969482422,333.70999908447266,300.73312759399414,324.9424991607666,-1.727857336367423,26.156197373244385,2.2835556000417734,2.9919409875686003,318.57875061035156,18.760349960327154,0.08473337516093406,291.53500328063967,330.9015083312988,0.5156361681621598,-0.2898580165673144,0.7490728877782833,0.7912982141655418,0.8114728475032094,-0.24622469796103885,19.383555942456216,361.0006456696455,308.6882509231567,256.3758561766679,279.1499993460519,40.954241169810366,293.2633934020996,32.202037437993475,279.7201773668111,296.52904126612606,-21.268335437308362,-27.748675447075996,88613800,19.110060489214984,2.2838310996209974,-332926400.0,-99.13452340827831,70.74152269624075,78.01649708558223,-221.22379238880075,12.574561200062886,50.68090527496816,-0.23420020879930667,16.415843194804513,303.45835870361327,288.27581790161133,276.00499725341797,263.7341766052246,248.55163580322264,0.06,0.0,298.8877914090249,-0.2820340647215457,-0.25454906007494915,278.95961216517856,291.84171404157365,32.574177195994146
2022-02-08,0,220.73749923706055,231.22999954223633,333.70999908447266,299.5162544250488,324.01375007629395,-1.4308389312201593,30.493444683341938,0.8051107951808669,2.9904101739296323,313.0837516784668,22.258700408935546,0.10043304874486517,241.0054973602295,330.30975036621095,0.6491154042413926,-0.286959871625489,0.7270198644630687,0.7739425133185095,0.8180174133107112,-0.3022033607539082,18.908101378917046,364.6065152211761,303.6196258544922,242.63273648780833,268.103214263916,45.20973735402451,286.0732152121408,36.40074128626407,267.6016186371759,287.89919677747844,-22.168367681701326,-27.92587863925785,94729700,19.09479328445534,2.2400092504422453,-427656100.0,-96.39696150256162,70.74152269624075,78.01649708558223,-192.82797674833904,12.014442603254206,52.062822627791746,-0.2612949166136697,15.915045653520963,301.60339855957034,285.273297668457,272.0749969482422,258.87669622802736,242.5465953369141,0.08,0.0,293.6077410224071,-0.3097806310007827,-0.2971334125938746,267.3363516671317,284.7555607386998,36.888759886573574
2022-02-09,0,227.94499969482422,220.73749923706055,333.70999908447266,297.8212471008301,322.0306205749512,-1.1732091794855277,35.002256505850944,-0.06823963725163651,2.988485877625617,308.2975044250488,26.57952610015868,0.11728323004387982,235.69849967956543,330.30975036621095,0.7039473304658688,-0.33163520310963,0.7637829244549229,0.8223487480249554,0.9091434854459892,-0.296297727804279,16.26642614030013,368.4466389043411,298.4421258926392,228.43761288093725,256.8435707092285,43.76872279129173,279.42178644452775,37.988120370902635,255.90914241928604,278.90513690068406,-25.94316572589186,-31.3200051558946,86563300,18.954744311382434,1.8897521421268222,-341092800.0,-85.82923089977605,70.74152269624075,78.01649708558223,-137.68486875714382,14.82885822212696,48.84986818071081,-0.1866719675820646,15.714685630391964,301.60339855957034,285.273297668457,272.0749969482422,258.87669622802736,242.5465953369141,0.08,0.0,289.8638399554897,-0.2817337490611709,-0.27272729015690467,255.7515869140625,278.72794669015065,38.620082419073064
2022-02-10,0,229.51000213623047,220.73749923706055,333.70999908447266,283.2025022506714,321.1487503051758,-0.9169006747109865,37.374349236939395,-0.7527887337501746,2.987242816248212,304.0175018310547,30.898313426971423,0.12741568491814,230.90149955749513,327.28800201416016,0.7601128794092158,-0.31693686038720087,0.7824396869724954,0.8500929312164622,0.9912775826580353,-0.04980539500287284,20.79130443458641,368.0748243817768,293.32612590789796,218.5774274340191,244.43999971662248,35.64912452387693,273.6844648633684,39.091414747165025,248.94723059584624,271.5685227157596,-25.693330738491557,-29.003473451945688,49310400,19.069233881039068,1.0366521138512712,-291782400.0,-89.34285849148498,70.74152269624075,78.01649708558223,-113.20933981368997,15.02193234789145,46.888924203792456,-0.21476610163364795,15.17065852935226,301.60339855957034,285.273297668457,272.0749969482422,258.87669622802736,242.5465953369141,0.08,0.0,287.94287109331924,-0.04075528532847661,-0.2939008700613186,242.78822762625558,273.37466321672713,39.95510346637005
2022-02-11,0,224.3000030517578,220.73749923706055,330.71250915527344,240.2037477493286,320.8831272125244,-0.7063330448298725,38.62356669832078,-1.2074588944297768,2.986409523245243,301.125,34.15392589569092,0.13405555331606922,229.35350189208984,324.2210006713867,0.7864895985413268,-0.30601354414304055,0.7785055495459121,0.8521251493766739,0.9789480476337328,-0.05036091643953233,22.05452315319584,365.3632594571274,288.11612606048584,210.86899266384427,230.2082143511091,7.017905556766168,268.1864294324602,40.306833850809205,244.1098077550296,265.0592617059288,-27.447167464722053,-25.924491791086048,46156900,19.128707515626157,0.9393902020068806,-337939300.0,-96.96020655365298,70.74152269624075,78.01649708558223,-107.73474876548772,14.162570620955805,48.10055521872708,-0.2357317950497797,14.912842685955031,301.60339855957034,285.273297668457,272.0749969482422,258.87669622802736,242.5465953369141,0.08,0.0,286.04890526040435,-0.07398033775942903,-0.07658982687010213,228.0399627685547,267.0191530500139,41.58550463238227
2022-02-14,0,218.1974983215332,220.73749923706055,326.9075012207031,234.95374965667725,317.4568748474121,-0.5151801868898548,39.703565784661166,-1.5114410862372296,2.985586439762331,300.48875427246094,36.811100482940674,0.140396737849853,227.58050003051758,321.6522445678711,0.7958676631604642,-0.3138731836553133,0.7715734434909891,0.8528411835481069,0.9623055801429342,-0.056361636666969805,21.16925930486142,362.2026323246324,282.79550075531006,203.3883691859877,226.8735716683524,6.238524089968925,262.2735721043178,41.18859404816733,239.16264254741054,260.9355477792972,-30.75504090357412,-25.549127871486476,38184000,19.12539846109743,0.7606263135390349,-376123300.0,-97.42095200718708,70.74152269624075,78.01649708558223,-101.29578618613043,13.71156024072652,48.611589402677964,-0.24743065073915443,14.277416136970347,301.2800797119141,284.7499595336914,271.38999938964844,258.03003924560545,241.4999190673828,0.1,0.0,284.4438407618129,-0.03205729640248889,-0.08178328403864656,225.1801256452288,261.1419437953404,42.23486749844305
2022-02-15,0,219.4199981689453,218.1974983215332,323.92250061035156,230.80000019073486,311.45812797546387,-0.3378743102894879,40.72075810762667,-1.6945210382342346,2.9847226812338494,299.0325012207031,38.92250061035156,0.14681553943617529,223.9437526702881,321.09850158691404,0.8056097586869702,-0.31988094080483087,0.7911018087903631,0.8883715447591769,0.9789504577132934,-0.00596863275460191,20.226516186019843,358.8015168256049,277.36000061035156,195.91848439509823,224.47714287894112,5.195859534059648,256.51785714285717,41.14126968909585,233.91681501518525,256.4434997848543,-9.664030412964122,-27.503717833456015,42685500,19.125431840771288,0.8336567210381165,-333437800.0,-94.50626995792175,70.74152269624075,78.01649708558223,-87.71122435354516,13.346124460205044,47.03233451369997,-0.18427844069278373,13.679932005757532,301.2800797119141,284.7499595336914,271.38999938964844,258.03003924560545,241.4999190673828,0.1,0.0,282.76853181658254,0.003724273485422591,-0.01738478089802674,222.88626752580916,255.89344133649553,42.772528684419676
2022-02-16,0,214.69250106811523,218.1974983215332,323.92250061035156,229.1187515258789,307.5300045013428,-0.14997999585222674,41.30226039254888,-1.7984626944329105,2.9840859840667915,297.57749938964844,40.15338817596436,0.15168489217623915,220.60574913024902,321.09850158691404,0.8136975644477898,-0.31729930822707014,0.7884703782807769,0.9047312577826014,0.9589859533118862,-0.058139018817923604,21.113100120449797,354.89439619708503,272.2898754119873,189.68535462688953,222.11464309692383,5.370444480316961,250.63232122148787,40.78287798809476,230.29329805878956,252.6617239017915,-7.102183173883041,-26.860002470397887,45817500,19.136583339600232,0.8734984377403944,-379255300.0,-96.38534010909427,70.74152269624075,78.01649708558223,-84.18028153358031,12.715006749383983,46.28601060835673,-0.1334555142965149,13.312706717941879,300.708960144043,283.8255202331543,270.1800003051758,256.53448037719727,239.6510404663086,0.12000000000000001,0.0,280.96646753445594,-0.06663794492015263,-0.016531871531106388,221.69300406319755,250.32630811418807,42.89771430178579
2022-02-17,0,211.59750366210938,214.69250106811523,323.92250061035156,227.03375053405762,302.6450004577637,0.023529790965962236,41.50533918253121,-1.8217054026657404,2.983602812715019,269.3150005340576,40.5777509689331,0.15547720327893075,219.2977481842041,316.807999420166,0.8086305796692347,-0.33131141844930234,0.7926350859465918,0.934713939693556,0.9564852960650576,-0.07804670082957321,20.080486690599404,349.9651791356313,266.95450077056887,183.9438224055065,220.80892944335938,6.70608583255836,244.4560718536377,39.57658053725936,226.36920795677042,248.65004276175796,-7.15196925436155,-27.734862095273773,38747500,19.10089107380638,0.7236572467183294,-418002800.0,-99.54485015853531,70.74152269624075,78.01649708558223,-83.72150453900909,11.984591567295093,46.5160273945002,-0.14881318692673687,13.0964160045046,299.4817608642578,281.8391213989258,267.5800018310547,253.3208822631836,235.67824279785154,0.14,0.0,279.4128707691168,-0.08927085382986033,-0.10469821339928131,219.9152330671038,243.62579236711775,43.11333259292447
2022-02-18,0,207.86999893188477,211.59750366210938,323.92250061035156,223.4093770980835,301.0512504577637,0.1905347282145465,41.22569446745908,-1.7801397043692027,2.983366809773273,238.86749839782715,40.092738246917726,0.15766221877906691,217.8469985961914,310.4827537536621,0.8199942103147696,-0.3170584081906575,0.7949713321402584,0.9305563260591581,0.9551027635618984,-0.07325012882894066,20.001724553603797,343.9325147665222,261.481125831604,179.02973689668582,217.94107219151087,7.4021360744709845,237.3923214503697,36.289298748654765,222.61158999590657,244.17540850587574,-4.140662826453105,-29.009609533127836,37128400,19.06095209119681,0.6880104245576012,-455131200.0,-99.20207545360172,70.74152269624075,78.01649708558223,-82.39071415783788,11.598082699573697,46.162294401600235,-0.1437995991520697,12.54953131940323,299.0144782714844,281.08275720214846,266.5899963378906,252.0972354736328,234.16551440429686,0.16,0.0,277.91620752887866,-0.06098835274681491,-0.09606704681403953,216.23137555803572,235.9914812360491,43.57656720678931
2022-02-22,0,202.98999786376953,207.86999893188477,323.92250061035156,220.40812397003174,300.24438095092773,0.37270060500774077,41.2356867240296,-1.640615745907003,2.9829849595108526,233.71249961853027,39.336100616455084,0.16083627476558676,214.38300132751465,307.7197540283203,0.8276831503060121,-0.31002663846327083,0.7917451524351063,0.9203808547389349,0.9469782573102627,-0.06969603489841159,19.612078771488008,338.8543740126343,256.3830005645752,173.91162711651606,214.1525001525879,7.279780761567887,229.29624993460519,29.291369072681427,218.86312093707855,239.72351557284645,-8.806949391219868,-32.237481494653736,39852400,19.04625960038385,0.7378216539743374,-494983600.0,-98.42113159769083,70.74152269624075,78.01649708558223,-83.45122090275342,11.085206294881568,47.172312871135304,-0.19358751596678317,12.177267850536348,297.80615942382815,279.1269190673828,264.0299987792969,248.93307849121095,230.25383813476563,0.18,0.0,276.28676052419144,-0.07175011197204317,-0.07957185086735631,212.52612958635603,227.6571786063058,43.33576945953246
2022-02-23,0,201.9000015258789,202.98999786376953,323.92250061035156,219.11437320709229,298.5487480163574,0.5539281392084987,41.44901105561911,-1.421339678073938,2.9824723951574823,230.3700008392334,38.287038307189945,0.1648275993306202,211.22475318908693,307.7197540283203,0.8228101434455327,-0.32556421245340555,0.8028826673742241,0.9273123160659894,0.9554501906366589,-0.07984685438551797,18.47155271729138,334.3668976147782,251.46887550354003,168.57085339230184,210.95249993460519,6.993367636103309,220.58035714285714,12.046984996888899,214.8470244426448,235.2861458098561,-11.555053821453686,-35.83068631316258,44481400,19.015204467837624,0.8090139652367746,-539465000.0,-99.19921136952452,70.74152269624075,78.01649708558223,-82.63235777817549,10.486857394792315,45.84648602322165,-0.2177223530888034,11.938974898069773,236.21180072021485,228.91910116577148,223.0250015258789,217.13090188598633,209.83820233154296,0.19999999999999998,0.0,274.50103740441074,-0.10203619073633041,-0.08842444712289266,209.51802498953683,218.77899387904577,43.214373757685166
2022-02-24,1,199.30750274658203,201.9000015258789,323.92250061035156,217.3212490081787,297.3337516784668,0.7543138800935151,41.15553552241799,-1.0992732595483377,2.982271221868494,228.72750091552734,36.30850074768067,0.1669494166004397,207.38199882507325,307.7197540283203,0.819535045880868,-0.32700001202901174,0.8085005063172471,0.9233942953150995,0.9590852324777579,-0.07166062272781493,18.269063352424784,328.8260715788937,246.5150005340576,164.20392948922154,208.2539291381836,7.366400215862624,217.563750403268,11.67679163520866,211.7923702774479,231.15346331114011,-9.986625600138778,-37.670275715503415,49957200,19.01391947336767,0.891095784609578,-589422200.0,-66.82572039455582,70.74152269624075,78.01649708558223,-78.10978092417062,9.375426135739916,45.564739983773755,-0.1588478458087312,12.387284824201291,230.24596075439453,222.59702084350585,216.41500091552734,210.23298098754884,202.58404107666016,0.2,0.0,272.61770503853324,-0.04128565167377085,-0.06063345204297778,208.07812717982702,216.6291264125279,42.41325902697687
2022-02-25,0,207.47999954223633,199.30750274658203,323.92250061035156,213.91875171661377,255.42749881744385,0.974321268279838,40.457703172033696,-0.632906518167001,2.982325648166733,226.12250137329102,33.48327484130859,0.16754033582837075,202.88099822998046,307.7197540283203,0.8129795683413023,-0.32913426879037877,0.8592002529942219,0.9741828344826292,1.013417468524849,-0.01945913372611474,17.804491708918263,322.39578163398437,241.480375289917,160.5649689458496,206.54821504865373,5.4944632491076675,215.51267896379744,10.627175187888298,208.81974657791352,226.88957783183474,-8.65729246222388,-17.484679498699435,37627600,19.01603176795137,0.6617290872225293,-551794600.0,-57.861909868418394,70.74152269624075,78.01649708558223,-63.36784977114195,10.696998824021247,43.34360854657035,-0.11327642426884701,12.080030436926299,226.9531226196289,219.93344235229492,214.26000213623047,208.58656192016602,201.56688165283202,0.2,0.0,271.3830103597482,0.013335793968567655,-0.027985611983225894,206.57835170200892,214.73230961390905,41.01270135814269
2022-02-28,0,209.6724967956543,199.30750274658203,323.92250061035156,210.66562747955322,237.53124904632568,1.256877326474816,38.98628734813276,0.06550478173792307,2.982975838491158,222.51875114440918,30.162562084197997,0.16449918944825392,202.88099822998046,307.7197540283203,0.8019642589303224,-0.30391021034491805,0.8846945456612884,0.9947669264688176,1.0282625217075907,0.008671274705496002,26.31723878665951,314.97244976493005,236.99987506866455,159.02730037239908,205.8310715811593,4.490108327791665,213.97285733904158,9.69558953993493,208.6017803929057,224.1707699731691,-5.441618232771849,-12.157327712140017,34239800,19.204954894389058,0.5956720795609607,-517554800.0,-53.52836506057515,70.74152269624075,78.01649708558223,-56.70293987673774,11.412049633410515,41.64616098662773,-0.12046553667987007,11.663720063878579,224.43192028808593,217.89404046630858,212.61000061035156,207.32596075439454,200.7880809326172,0.2,0.0,270.3345078731075,0.023622368437154595,0.015983725062144044,205.7928227015904,213.74291338239397,38.44966937127477
2022-03-01,0,206.83250045776367,199.30750274658203,323.92250061035156,209.2218723297119,232.4712495803833,1.6120383282188955,36.75988784840877,1.2012360676746487,2.9841214294027516,220.07874870300293,26.185375022888184,0.1580524907935226,202.88099822998046,307.7197540283203,0.7521518286410056,-0.3164989408195762,0.8892952015852524,0.9881505096725617,1.0125446750221168,0.018929516894585774,26.38441923702514,306.1000258646642,232.58025016784669,159.06047447102915,205.15035683768136,3.774342099152155,212.97964314052038,9.661468310989079,208.95394840060686,221.82594570507098,-2.33822990904943,-9.322969679219478,27094900,19.01894043127742,0.46912112831882347,-544649700.0,-70.36622457748685,70.74152269624075,78.01649708558223,-68.02622166223917,10.729680924328811,42.04841767206977,-0.1544075932916058,11.509634543245108,224.43192028808593,217.89404046630858,212.61000061035156,207.32596075439454,200.7880809326172,0.2,0.0,269.4694193342685,0.0069774149546213415,-0.012951158831419408,205.19119916643416,212.55321611676897,33.92783824072252
2022-03-02,0,206.01499938964844,199.30750274658203,323.92250061035156,207.77249908447266,229.94000148773193,2.105789873707267,32.92903472028613,3.394951439816751,2.9861385777167704,218.80874824523926,21.35912481307983,0.14468974487767958,202.88099822998046,249.01949729919446,0.6404976344450816,-0.3461599220561362,0.9052271940513333,0.9896181688071841,1.0047625161860236,0.020381366184596406,22.671757768330522,293.4418194024253,227.58374996185302,161.7256805212807,204.88535690307617,3.6132517338568597,211.41321454729353,8.78663405960705,208.39460041672106,218.90066248466127,-2.2519184403775974,-6.2993369170879445,29452100,18.714123747820484,0.5049380967745586,-574101800.0,-60.04912934941946,70.74152269624075,78.01649708558223,-65.96763562505069,10.23652014167114,40.24470052555202,-0.14775864440081332,11.19360922961145,224.43192028808593,217.89404046630858,212.61000061035156,207.32596075439454,200.7880809326172,0.02,1.0,268.56372306864415,0.04867728879104849,0.029839692574867082,205.46919904436385,210.85028730119978,26.3843740077209
2022-03-03,0,205.62250137329102,199.30750274658203,323.92250061035156,207.31812477111816,228.33625030517578,2.866880352055782,26.140321551181778,8.633032903196536,2.9894362525965734,216.44499969482422,16.016825199127197,0.11771327243094065,202.88099822998046,236.7294994354248,0.34655367596199377,-0.3639991078067615,0.9259449037263817,0.9941342402176139,0.9988390329744321,0.03168470097554965,20.0070235363569,274.34839307947544,222.06774997711182,169.78710687474822,205.2614288330078,3.5188661516655912,209.70696449279785,7.173373757341649,207.66736795040094,215.6955852975308,-0.8923844478606929,-9.620741992382353,27263500,18.491319756358127,0.4802583831850114,-601365300.0,-68.28357968182006,70.74152269624075,78.01649708558223,-76.18411289418383,9.719654892624574,38.6081585352029,-0.17134077462586014,10.93881799791871,220.93279888916015,215.0635993347168,210.31999969482422,205.57640005493164,199.70720050048828,0.02,0.0,267.72280211635035,-0.022302547039106946,0.02277649929716954,205.59608023507255,209.06110491071428,11.755985245495788
2022-03-04,0,201.77749633789062,199.30750274658203,241.53999710083008,206.62812519073486,225.2112522125244,0.5249572775321613,11.963778040592294,-0.8538602356798748,2.9942137501723143,213.1450023651123,10.370024681091309,0.05534872001280455,202.88099822998046,231.72649955749512,0.7909240088992234,-0.14870206242714087,0.9334949304306636,0.9798413097424364,0.9741845933898052,-0.02748459233143985,30.775478524641674,240.0803060964434,216.1527500152588,192.22519393407418,205.24392809186662,3.5386193663128225,208.09821401323592,6.0930690837544095,206.93766082826912,212.20702183455543,1.2968636569414655,-10.40804345806268,32130900,4.435038580911029,0.6561484369176794,-633496200.0,-68.18623127060903,70.74152269624075,78.01649708558223,-89.16475038379949,9.253280042434223,38.53302402663752,-0.09065434261711189,10.6622069667558,213.850515625,209.33473669433596,205.68499755859375,202.03525842285157,197.51947949218751,0.02,0.0,266.7153297650108,-0.04950591428902884,-0.036319912548620416,205.8256072998047,207.67181614467077,11.025903254771242
2022-03-07,1,194.1074981689453,199.30750274658203,236.19499969482422,205.91687488555908,221.62812519073486,0.5036104188470982,10.8298718377686,-0.9919549727974091,2.9944635058963542,210.63500022888184,9.474587612152101,0.05056797703601147,201.88775100708008,229.68200187683107,0.7726471363629955,-0.1457164774927612,0.9063471532223865,0.9471118651349877,0.9423426054110603,-0.07423481317093561,28.64339303236709,235.82436865264904,214.16462497711183,192.5048813015746,204.5010702950614,5.164736581245691,206.37749971662248,6.414670444200709,205.6397331569945,210.74004710161336,-0.060676169917006625,-10.041242268137669,38560600,4.38591992609403,0.8305127711966456,-672056800.0,-99.4390243023394,70.74152269624075,78.01649708558223,-149.59781257964158,8.419319725500737,42.68215979347463,-0.14721559271393847,10.874481139736409,213.15667504882813,208.21165576171876,204.21499633789062,200.21833691406252,195.27331762695314,0.02,1.0,265.37191236993954,-0.1116428410992849,-0.10932148962107262,202.95579092843192,205.51695905412947,11.082019173602276
2022-03-08,1,190.23749923706055,194.1074981689453,231.22999954223633,204.96437549591064,219.74937343597412,0.350478908066778,10.42618222747755,-0.9374671866718725,2.994529572675082,208.77124786376953,8.955050201416014,0.049166131947660875,201.53049697875977,228.10149993896485,0.7351109886618751,-0.1605436208397788,0.8970917431533539,0.9345042615650002,0.9377264371858987,-0.08023401150193954,24.07406160546136,232.91261435577294,212.06024990081787,191.2078854458628,202.03785596575057,7.212841439220914,204.29303550720215,6.589542617701597,202.74401094690754,208.22296234809625,-2.609036040278165,-11.040456622050339,37508100,4.527589074446438,0.854893556258139,-709564900.0,-86.68368028971769,70.74152269624075,78.01649708558223,-146.14334816024808,7.828125975120789,40.460860168996405,-0.07652569429784009,10.85400697523191,210.09196014404296,205.5090202331543,201.80500030517578,198.10098037719726,193.5180404663086,0.04,0.0,264.0961147395168,-0.06486811657929958,-0.09827992203858958,200.0774187360491,203.327885219029,11.533365560056112
2022-03-09,1,196.81500244140625,190.23749923706055,229.51000213623047,202.71749877929688,218.50312328338623,0.18216583411338225,10.485321664035256,-0.6923373141427138,2.994488479993266,207.67499923706055,8.631500625610352,0.04992757709163055,198.78750228881836,224.66450271606445,0.8014999679136579,-0.13817316996621673,0.9371668816692321,0.9729096598754717,0.9862842944444081,-0.0446569277746699,23.26704792758762,230.98126821362962,210.01062488555908,189.03998155748855,200.20107105800085,6.551392937355859,203.01607131958008,6.135834868318286,199.61937056808728,205.502369363672,-8.310439725861748,-13.299835555287588,31894700,4.090660276698528,0.7830218544817713,-677670200.0,-60.52883201477754,70.74152269624075,78.01649708558223,-91.08343651868014,8.97715329322803,38.06612799358083,-0.03349027436834647,10.706981697566345,210.09196014404296,205.5090202331543,201.80500030517578,198.10098037719726,193.5180404663086,0.04,0.0,263.1335214047448,-0.04617747118302562,-0.024522014833747753,198.2910919189453,202.04195731026786,11.500310999851257
2022-03-10,1,194.35000228881836,190.23749923706055,229.51000213623047,201.86937522888184,215.56875038146973,0.369717793517957,10.557660095055548,-0.595833845594187,2.9944607944871366,207.15625,8.481900253295896,0.05055999508051929,196.54425201416015,224.66450271606445,0.8052790484156107,-0.13656801989556788,0.9307303958595448,0.9631455119170923,0.9829954821598923,-0.054821330395199985,32.295670147175365,229.92982023588746,208.81450004577636,187.69917985566525,198.4178570338658,6.130860197726171,201.78410693577356,6.010513659743243,198.9497229669842,204.32660930679722,-6.132179733033318,-8.327025181488295,24853000,4.021053161272584,0.6601532326869483,-702523200.0,-66.34612291792817,70.74152269624075,78.01649708558223,-109.17204504057376,8.519204008329089,38.08101324256593,-0.10352491025015498,10.471384854742226,206.76855548095705,202.82071646118166,199.62999725341797,196.4392780456543,192.49143902587892,0.04,0.0,262.36932832809373,-0.03823214368714056,-0.06198639778856796,197.11066327776228,201.15093122209822,10.434480945398088
2022-03-11,1,190.11999893188477,190.23749923706055,229.51000213623047,201.15999794006348,212.37125301361084,0.44108908627361954,10.040164888232447,-0.37770724448694537,2.9945647196512044,206.42374992370605,7.852725009918214,0.04847165856876661,194.32575187683105,219.90799865722656,0.7455626907712108,-0.15319593708400628,0.9178566067297876,0.9445032281949821,0.9726922693103457,-0.057774021472070225,29.662503211923042,227.21507995194096,207.13475017547609,187.0544203990112,196.1471426827567,5.7817176231150365,200.51624979291643,6.4816334465093535,197.80850875261257,202.72612152071002,-6.035075793851995,-8.151089249537074,34694500,3.9521814680420086,0.9398094755668362,-737217700.0,-94.45266134452312,70.74152269624075,78.01649708558223,-141.50334129005162,8.01321603064418,38.879342695486926,-0.09500428235485972,10.332594539511732,206.76855548095705,202.82071646118166,199.62999725341797,196.4392780456543,192.49143902587892,0.04,0.0,261.25565930713617,-0.06223126074383811,-0.07567616350157817,194.18809727260046,199.82864815848214,9.971373286573014
2022-03-14,1,187.94250106811523,190.11999893188477,224.3000030517578,198.6843776702881,210.15374851226807,0.19681057489495232,9.293463997912843,-0.6507752521002779,2.9947085783502536,205.81875038146973,7.488225059509278,0.04529745654891196,193.72049827575682,218.31974830627442,0.7264375843321537,-0.15238521468939045,0.9160542589650896,0.9418080303637631,0.9731600139816794,-0.03176073649387956,27.48003196593736,223.75217801108448,205.16525001525878,186.57832201943307,193.62142835344588,4.716083184841248,199.44142859322685,7.242804369069548,195.88517434628994,200.6494544131156,-7.715457857367225,-8.538990759227527,31010500,3.91421387908185,0.8576101161516134,-768228200.0,-97.0362314066567,70.74152269624075,78.01649708558223,-137.22679973150068,7.642853997524753,37.68958048954334,-0.0738597798729182,10.055144191840856,206.7001170654297,202.70993902587892,199.48500061035156,196.26006219482423,192.26988415527345,0.06,0.0,260.2746981050671,-0.004480770035394821,-0.06712982423745689,191.85859898158483,198.7273396083287,10.089643164411585
2022-03-15,1,190.25500106811523,187.94250106811523,219.4199981689453,196.19875240325928,208.32062339782715,-0.01085721583183969,8.921211721548929,-0.856825818578276,2.9947690928812993,204.30624961853027,7.392624855041504,0.04387178209323231,190.22574920654296,215.04300079345703,0.7556398495419787,-0.13865877237893245,0.9356157223403313,0.9638923564333672,0.9914639944210115,9.199990078134768e-05,26.984683457829874,221.18979835917452,203.34737491607666,185.5049514729788,191.9753576006208,3.143596371340901,198.60964284624373,7.598666487647904,193.89625423789872,198.72149936948566,-8.598280921152288,-7.412925244598978,31721700,3.7830105425840896,0.8851886464176197,-736506500.0,-77.27773689658525,70.74152269624075,78.01649708558223,-108.76387407318684,7.285813011059096,35.928886774627216,-0.030485518391298032,9.79054688260222,206.7001170654297,202.70993902587892,199.48500061035156,196.26006219482423,192.26988415527345,0.06,0.0,259.3229099612323,0.009144036248309728,0.024323865601693327,190.71381051199776,198.26970890590124,9.743341666342559
2022-03-16,1,199.14500045776367,187.94250106811523,219.4199981689453,194.2893762588501,207.57749938964844,0.05242907415787156,8.670655401391734,-0.8911125544500909,2.9948106824793927,202.44499969482422,7.268999671936035,0.042934610871235755,190.22574920654296,211.90700340270996,0.7453076941534137,-0.13291859148760957,0.9861092046437168,1.017477397035435,1.0377729622702427,0.01183851834186811,30.9276199120985,219.29156085618925,201.95025005340577,184.60893925062229,192.69500078473772,4.133717858139508,198.59803553989954,7.597642519960271,192.9909936047422,197.6539560934986,-5.7104957088376995,-5.767706968675308,40640300,3.8331942749870778,1.1373060206532577,-695866200.0,-34.8334931980272,70.74152269624075,78.01649708558223,-3.5545942468943905,14.947604275388791,32.88972329014577,-0.031727121691283715,9.927596227451545,206.7001170654297,202.70993902587892,199.48500061035156,196.26006219482423,192.26988415527345,0.02,1.0,258.32077402609326,0.025843809906457293,0.07010366187314539,193.01764787946428,197.98671940394811,8.646386958641694
2022-03-17,1,204.6724967956543,187.94250106811523,214.69250106811523,194.2893762588501,206.99437522888184,-0.11426712295028783,7.699768994124772,-1.0973961451856336,2.9949966700924686,201.83874893188477,6.6148495101928715,0.03831941428109371,190.22574920654296,209.8649974822998,0.7583501715308727,-0.07241752987645723,1.0185929217672591,1.049402084225146,1.0639937409000793,0.053112911681348685,46.269660746642124,216.3360381560962,200.93650016784667,185.53696217959714,194.75714329310827,5.918612094417267,198.3974996294294,7.3790817861336,194.49356883046886,197.88138051477958,2.59521261998538,-0.08153345287005065,29499700,4.400376529727931,0.8448293341474326,-666366500.0,-19.429199295627576,70.74152269624075,78.01649708558223,56.10815032687736,17.36630712372593,31.20596543439534,-0.034602091198811684,9.712519830256266,206.7001170654297,202.70993902587892,199.48500061035156,196.26006219482423,192.26988415527345,0.04,0.0,257.67617793295665,0.06469952960151781,0.04705289596485778,195.5196533203125,197.7985360281808,8.010981822211264
2022-03-18,1,211.49750137329102,187.94250106811523,211.59750366210938,194.2893762588501,206.21937465667725,-0.29183151059030266,7.090271281874545,-1.1709166682101886,2.995104207265497,201.83874893188477,6.163949317932127,0.035374328816471394,190.22574920654296,208.0502487182617,0.7294007766876653,-0.03272726164819654,1.055189831250421,1.0849238773069365,1.087799028624923,0.11244215527828438,53.79848795498897,214.61604251797274,200.43549995422364,186.25495739047454,196.85464314052038,8.711946585525949,198.52785709926061,7.606210042284072,197.00270735848653,198.66825720141068,7.587882313678795,-1.3531437983305532,52128000,4.583009449150132,1.464806004108527,-614238500.0,-1.0006378352020084,70.74152269624075,78.01649708558223,133.6513813215036,22.409929299264174,28.736886815292696,0.08373321157468742,9.790521121324632,209.4887240600586,204.9656446838379,201.31000518798828,197.65436569213867,193.13128631591798,0.06,0.0,256.73228557509253,0.15393633004740437,0.10901071257819349,198.08438110351562,198.18773651123047,8.647118261705332
2022-03-21,1,212.08250427246094,187.94250106811523,211.49750137329102,194.2893762588501,206.21937465667725,-0.29589770590326,7.0824289110770575,-1.1745472084438497,2.9951055379684353,201.83874893188477,6.159449214935302,0.03533608366360663,190.22574920654296,208.0502487182617,0.6949258204051114,0.01745082243732015,1.058134886865983,1.0825271978645978,1.06733686848227,0.12844355623210912,61.57381639203787,214.59535766193684,200.43049983978273,186.2656420176286,199.38785770961218,10.29629687752335,198.90285737173897,8.156640576913889,200.60428613975168,200.34641087102173,7.460050681987969,0.8704072329597708,30142300,4.77710191157389,0.8554001599425161,-584096200.0,-17.140084864096682,70.74152269624075,78.01649708558223,109.39125665711269,20.945770463886813,26.859354487101392,0.1225738056784122,9.723798079547379,209.4887240600586,204.9656446838379,201.31000518798828,197.65436569213867,193.13128631591798,0.06,0.0,256.18249764360553,0.13320475071852544,0.12728530044225772,200.4053235735212,198.75799342564173,8.898233674089349
2022-03-22,1,214.41499710083008,187.94250106811523,212.08250427246094,194.2893762588501,206.21937465667725,-0.20291089477041732,7.357825039047714,-1.1523558636013356,2.995057922763622,201.83874893188477,6.34901195526123,0.03667156987447497,190.22574920654296,209.85499725341796,0.7472938381266386,0.04479287898112872,1.0686492960338316,1.0844828202691017,1.0534784529342787,0.1269874426274087,63.81078648879954,215.35677518490695,200.64112510681153,185.9254750287161,202.8585717337472,10.736876465702078,199.50285720825195,8.98676004400565,203.46240961417072,202.03299176108973,9.124004000417134,2.5382876497058766,31998800,4.625231088845036,0.9183187936971122,-552097400.0,-8.353189263872192,70.74152269624075,78.01649708558223,135.4421748597669,23.021354240436168,25.01577750753681,0.16811342196176665,9.69198530846931,211.52096685791017,206.6095269470215,202.64000701904297,198.67048709106444,193.75904718017577,0.08,0.0,255.66586910120483,0.12820909510019463,0.1608530169137043,204.5453861781529,199.36674172537667,9.554444067693355
2022-03-23,1,213.93750381469727,187.94250106811523,214.41499710083008,194.2893762588501,206.99437522888184,-0.11793908817784247,7.938600639299212,-1.1809524420385085,2.9949523943498186,201.83874893188477,6.863136920928954,0.03945383894300801,190.22574920654296,211.556001663208,0.766012651488249,0.0619861093628919,1.06324227693098,1.068995341490672,1.0267562724324062,0.07428006388777453,66.2309440827301,217.089576347263,201.21237506866456,185.3351737900661,206.5721435546875,9.086641841238603,200.0967859540667,9.671029648967744,206.20511279201514,203.93888879812616,12.7787704110232,4.077371907903766,23717300,4.627280317103638,0.7015546440025705,-575814700.0,-17.83590995499927,70.74152269624075,78.01649708558223,108.21824098755381,22.200834601202587,24.12417328124944,0.2177217599164262,9.3299253560784,211.52096685791017,206.6095269470215,202.64000701904297,198.67048709106444,193.75904718017577,0.08,0.0,255.2793128661879,0.048273846088924266,0.11159719628921569,208.3703853062221,200.11449214390345,9.860658670150746
2022-03-24,1,217.50749969482422,187.94250106811523,214.41499710083008,194.2893762588501,208.02812385559082,-0.1410833075673002,8.410227703803324,-1.2842469754587686,2.9948618130504396,203.22499656677246,7.408499908447266,0.041673111270253464,190.22574920654296,212.26800422668458,0.8014227175758689,0.07340416625819235,1.077760859292544,1.0776140165352275,1.0292753630911382,0.06270995419567504,66.49868550997998,218.63470559071212,201.81425018310546,184.9937947754988,210.46535764421736,6.359185260469244,201.22035762241907,10.736383030751618,208.15848695398478,205.43860250429083,13.831359377919936,4.04381932223995,31502300,4.572849019030449,0.9579817315578413,-544312400.0,-3.156359063701192,70.74152269624075,78.01649708558223,126.15109187305382,23.97241320729323,22.766321143031995,0.18413389676510067,9.178032550217495,212.44540032958986,207.35730166625976,203.24500274658203,199.1327038269043,194.0446051635742,0.1,0.0,254.82820146784945,0.05643765536409351,0.07827926217750804,212.2966047014509,201.50520760672433,10.521488691572022
2022-03-25,1,221.68000030517578,187.94250106811523,217.50749969482422,194.2893762588501,210.12874794006348,-0.15412709853363882,9.050057744780311,-1.2673705057306164,2.994732946947286,205.14749908447266,7.9768250274658214,0.04464220606769017,190.22574920654296,213.98525314331056,0.8181733446524285,0.048329960356234776,1.093505095082629,1.0858283423735255,1.0364302766325029,0.048144771762162586,67.89975774623214,220.8243655200782,202.72425003051757,184.62413454095693,213.6846433367048,5.286879099193423,203.18982206072127,11.806810662455822,210.54423464686244,207.01262226461074,14.324195670920643,7.795717382969504,40039000,4.287289279727731,1.213133926785963,-504273400.0,-9.27417680202179,70.74152269624075,78.01649708558223,140.32029743684024,26.557254916445714,21.56776961496375,0.13134043078556978,8.99407431056618,216.1355217285156,210.34224279785155,205.66000366210938,200.9777645263672,195.1844855957031,0.12000000000000001,0.0,254.32746940839493,0.024620107095286947,0.06726324516831003,214.8898468017578,203.95374734061105,11.216881680819768
2022-03-28,1,222.3249969482422,187.94250106811523,221.68000030517578,194.2893762588501,211.6437520980835,0.011646879289051802,9.911337492111695,-1.1634050380978367,2.9945448147016362,205.14749908447266,8.615825061798096,0.04872010238574061,190.22574920654296,214.7242473602295,0.8119415047205669,0.05726789966747014,1.0928592253919953,1.072409641967643,1.0296422864468264,0.04829484973745313,70.93039505802294,223.2569250528879,203.43425006866454,183.61157508444117,216.20642907278878,4.408848032100727,205.48178618294853,12.20674142925718,213.35437268415257,208.5400857087768,11.315875264562074,14.204758907475174,26224100,4.35009117816287,0.8043261195047267,-478049300.0,-4.813518182111764,70.74152269624075,78.01649708558223,130.15079653981357,25.570304248561857,20.766243828762406,0.14784660047046858,8.67221217156476,216.1355217285156,210.34224279785155,205.66000366210938,200.9777645263672,195.1844855957031,0.12000000000000001,0.0,254.01089414787037,0.057213150724942485,0.032796015875082005,217.1352321079799,206.3274427141462,11.970885378739986
2022-03-29,0,228.0275001525879,187.94250106811523,222.3249969482422,194.2893762588501,212.54625415802002,0.09907551628187393,10.66450309458132,-1.188030884494656,2.9943679670592744,205.14749908447266,9.185187568664551,0.052259844183894184,190.22574920654296,217.92474975585938,0.8460214711291729,0.07490358844084162,1.117415553442154,1.0819720356033717,1.0461272753943913,0.06348671145123519,72.83518814512922,225.39588126545658,204.06687507629394,182.7378688871313,218.56785746983118,5.703171028691071,207.71125030517578,13.30317459606953,215.58441194370357,209.6931582613861,8.624754390040106,16.86707291667899,31417900,4.272611333835585,0.9572801189763609,-446631400.0,-2.2853316188775663,70.74152269624075,78.01649708558223,149.1651100919868,29.732179783761772,19.500206024387094,0.20740614821407385,8.57395434546284,220.25348126220703,213.67326242065428,208.3550033569336,203.0367442932129,196.45652545166016,0.14,0.0,253.7136068044307,0.06097398049876568,0.08685993890159513,219.04131644112724,208.56284877232142,13.250039114941949
2022-03-30,0,228.65500259399414,187.94250106811523,228.0275001525879,194.2893762588501,214.05687713623047,0.21377907598829538,11.871465778874166,-1.1145754148951592,2.994062758420628,205.14749908447266,10.184375381469726,0.05787384146422644,190.22574920654296,221.74449996948243,0.8374086583729836,0.10684901986823736,1.1147017240007637,1.0658465871579739,1.0360655400961274,0.06879344910018426,77.2183073848444,228.8695566187835,205.12662506103516,181.38369350328682,220.93535723005022,5.994612352685667,210.16160746983118,13.802804103166617,218.68757105593687,211.53080199985286,7.815694593063579,15.858800052843485,25588000,4.38795621443624,0.7842642052106921,-421043400.0,-7.279922282147433,70.74152269624075,78.01649708558223,127.02667328298725,28.81533435721174,18.751405883262752,0.15758971959181295,8.277991627641422,220.45211706542972,213.83393902587892,208.48500061035156,203.13606219482423,196.51788415527344,0.16,0.0,253.47554970189816,0.06741308968429571,0.051696359237467425,221.37366812569755,210.88949584960938,14.143154182316948
2022-03-31,0,225.38999938964844,187.94250106811523,228.65500259399414,194.2893762588501,215.1881227493286,0.20303318736488,12.934065192178904,-1.2314873313245438,2.9937722308245927,205.14749908447266,11.379987926483153,0.06270799671191742,190.22574920654296,222.89524726867677,0.866463397727609,0.11201352510973243,1.0927542988705268,1.0363711563057432,1.0078295800426647,0.036240128298490104,77.8141560737355,232.12675560561027,206.25862522125243,180.3904948368946,222.50321469988143,5.4119276416269795,212.68089321681433,13.062302932370095,221.1747665815306,213.19183870118226,7.814175138295533,17.651144790930353,24192300,4.374871626523214,0.7449927940578692,-445235700.0,-19.391122633843537,70.74152269624075,78.01649708558223,90.97831705561485,27.2350106792955,21.64039136415653,0.14727094386818684,8.13139483516948,220.45211706542972,213.83393902587892,208.48500061035156,203.13606219482423,196.51788415527344,0.16,0.0,253.21732371388455,0.012706620109383948,0.04169397262744718,222.18771144321985,213.3665488106864,14.535063203895671
2022-04-01,0,224.84500122070312,187.94250106811523,228.65500259399414,194.2893762588501,218.5506248474121,0.09614474661398524,13.586515324100894,-1.4106857401121011,2.9935854927700642,208.08499908447266,12.304750442504883,0.06555711453530481,190.22574920654296,225.65374946594238,0.8988951578211842,0.11702248010956094,1.0849131764911792,1.0241093529999938,0.998354914926249,0.014277340811847061,72.81162400714163,234.42003077027215,207.24700012207032,180.0739694738685,224.0614286150251,3.8912318463511584,215.31678608485632,11.28925729356282,222.21730068065756,214.25437620089724,5.118579594344929,18.55144154003495,19544800,4.341372635221011,0.613769138480076,-464780500.0,-13.925705466182523,70.74152269624075,78.01649708558223,84.59797821301802,26.021307977378264,20.67600762373853,0.18070735907464353,7.901554462176248,220.4733562011719,213.86831762695314,208.52999877929688,203.1916799316406,196.58664135742185,0.16,0.0,253.016107239781,0.013659733553616382,0.024046966932495594,223.81151689801897,216.09095110212053,14.907087913809514
2022-04-04,0,230.02000045776367,187.94250106811523,228.65500259399414,194.2893762588501,221.84124946594238,-0.05856491787895593,14.044637152641155,-1.5072991869710743,2.993455826239171,211.79000282287598,12.795837783813477,0.06739257128477459,190.22574920654296,225.65374946594238,0.8981469827920243,0.15835299172732017,1.1037408164623586,1.0413492897290393,1.0184703480235697,0.03461150844550742,75.81786012687631,236.4896496714932,208.40037536621094,180.31110106092868,225.84892872401647,3.1894254793214043,218.1571431841169,9.331336533321263,222.8551139536555,215.15886437595967,5.09845034718804,19.63499471533236,28054800,3.8333008285616805,0.8957870249968031,-436725700.0,-1.1549251637455396,70.74152269624075,78.01649708558223,108.34535170108693,30.12603042176488,18.922503799082524,0.28351699281310205,8.015939361792508,224.9501256713867,219.13494540405273,214.43500518798828,209.73506497192383,203.91988470458986,0.18,0.0,252.79718742719285,0.046066424151576246,0.05441346282693007,225.85303388323103,219.07481929234095,15.014345919231157
2022-04-05,0,233.45000076293945,187.94250106811523,230.02000045776367,196.19875240325928,222.95499801635742,-0.21221244463354472,14.393875632500663,-1.4288366325184005,2.9933733381658216,213.0100040435791,12.803050155639648,0.06847835163174569,190.22574920654296,228.09025039672852,0.8633999164966709,0.20912018597936352,1.11063007968331,1.0483641929941026,1.0266615358349023,0.023780029192632446,81.58107908914631,238.98375174565322,210.19600048065186,181.4082492156505,227.53035736083984,3.6887334204583735,220.60750034877233,8.413863825089239,224.62084955823832,216.8189378230703,5.75267555394422,20.90089572752505,29727200,3.680833773944577,0.9611258614736194,-406998500.0,-14.041969992897648,70.74152269624075,78.01649708558223,109.99768629526335,30.809322660259213,17.916571849145363,0.2652903174520685,7.860249168078447,228.42300061035155,223.20350061035157,218.98500061035156,214.76650061035156,209.54700061035157,0.19999999999999998,0.0,252.58985701601057,0.008613860523362549,0.03689780823482226,227.28152465820312,221.08568572998047,14.8458978368296
2022-04-06,0,225.15250396728516,187.94250106811523,233.45000076293945,198.56250095367432,224.98125076293945,-0.321397750979001,14.47880149962337,-1.255487542503077,2.993387700169767,214.17625045776367,12.432962131500243,0.06818153877539704,190.2415008544922,228.7915023803711,0.8812590896807735,0.1861392570032348,1.0602565536948976,1.0025324781150686,0.9854708808743907,-0.015317830736151117,82.58086149753693,241.31422855619257,212.3566255569458,183.39902255769903,227.93428693498885,3.1373242716614094,222.0703580038888,7.109493882556696,226.8059900896762,218.9264945764778,5.309455269559951,17.226141869653148,28995100,3.54358379107295,0.9418708977026811,-435993600.0,-43.9403671108329,70.74152269624075,78.01649708558223,58.65864202272313,27.951404737500308,24.80147271460832,0.20312855166909152,8.044093604315185,229.5770404663086,225.07148037719728,221.43000030517578,217.7885202331543,213.28296014404296,0.02,1.0,252.30305835193806,-0.019969257314372935,-0.028539075445814546,227.24018205915178,222.18770708356584,14.582767491870605
2022-04-07,0,222.73999786376953,187.94250106811523,233.45000076293945,203.29062271118164,225.21187782287598,-0.5336613047740506,14.273674391865914,-1.0383302154029577,2.9934732789304377,215.96124839782715,12.012299880981448,0.06677008305325237,190.2415008544922,228.7915023803711,0.8921718123468168,0.1584898446910848,1.0419439135532198,0.9868622786650726,0.9779098646218636,-0.0117574050892012,66.2237323353482,242.3208494169716,213.77350063323973,185.22615184950786,227.17892946515764,3.6976302639704053,222.87339346749442,6.425422699587682,226.3430231400643,219.42752958605408,1.2717899731721212,10.00623312475548,21037200,4.1170792459960746,0.6876297444677498,-457030800.0,-47.588113907947154,70.74152269624075,78.01649708558223,41.45318216977526,26.204558091983092,25.81058382606458,0.18945167566012294,7.966544716496558,229.96172161865235,225.69414224243164,222.24500274658203,218.79586325073242,214.52828387451171,0.04,0.0,252.08223355239426,0.002653289784339208,-0.021505452109133984,226.25506155831474,222.648188999721,13.960057483227942
2022-04-08,0,222.46750259399414,187.94250106811523,233.45000076293945,209.79125022888184,225.21187782287598,-0.7625831110811024,13.670372718240431,-0.6110291818778038,2.9936784747663308,219.59375,11.266949882507324,0.06352610304270345,190.2415008544922,228.7915023803711,0.860132445722853,0.17157584217940006,1.0338045483267568,0.9833752256407631,0.978991521167804,-0.01057394477885365,63.78737351882967,242.53374584846816,215.1930004119873,187.85225497550644,226.29500089372908,4.01215363321481,223.61517906188965,5.634623425529723,225.41200598898746,219.72420791642034,-2.3188002698271704,5.315663975923583,18375700,3.9994532022257485,0.6170929063045183,-475406500.0,-54.460249093366265,70.74152269624075,78.01649708558223,36.65242167720741,24.972965739755825,24.597507935407716,0.23397780404208432,7.7615118109297585,230.56351873779298,226.6682375793457,223.5199966430664,220.3717557067871,216.47647454833984,0.04,0.0,251.8929736034749,-0.011207468526680753,-0.0001349130398816561,225.46810695103235,223.42088753836495,12.328587225294873
2022-04-11,0,217.6775016784668,187.94250106811523,233.45000076293945,211.93625354766846,225.21187782287598,-0.9797793231263299,12.4690150658112,0.0469196795952338,2.994044477308547,222.00249862670898,10.053549880981445,0.05751115476640233,198.25600051879883,228.7915023803711,0.8037305344408989,0.18369980887593995,1.0039994676499866,0.9618671125475062,0.9599212430195503,-0.053658372118659314,64.2681895197272,241.7484057267152,216.81037559509278,191.87234546347037,225.1932155064174,5.188593392945655,223.8482151031494,5.281237750897111,224.66908388015332,220.29712509045262,-2.7060418227484346,4.89667846820201,20516600,3.9237298997297634,0.7013465727030127,-495923100.0,-82.59107861119047,70.74152269624075,78.01649708558223,-9.27497633269369,23.326957988928733,27.435242071241564,0.25897442672132115,7.714916178061219,231.0308013305664,227.42460177612304,224.51000213623047,221.59540249633787,217.98920294189452,0.06,0.0,251.64857303690482,-0.0745222148372261,-0.037313800754558354,224.6269771030971,223.4073442731585,9.969383005166202
2022-04-12,0,217.38500213623047,190.25500106811523,233.45000076293945,213.47375392913818,225.21187782287598,-1.0154602026733508,10.56578428017249,0.5760347581245004,2.9945400171823446,222.00249862670898,8.348412437438963,0.048400931757082766,204.11974716186523,228.7915023803711,0.7403175779097213,0.1441355047509828,0.9958216422375427,0.9625513404612273,0.9691815593364266,-0.06881558609640981,55.22418686753582,239.42869418595535,218.29712562561036,197.16555706526538,224.12750135149275,5.97809507855497,224.09446498325892,4.846022285766178,222.9436113573105,220.377532287558,-3.421845570818106,1.5215841343889318,20128800,4.188146682932079,0.7019998598009103,-516051900.0,-95.74380662165977,70.74152269624075,78.01649708558223,-34.53043293742083,21.423445108771954,27.11274338453532,0.1861026947347438,7.799664431116906,231.25972161865235,227.79514224243164,224.99500274658203,222.19486325073242,218.7302838745117,0.08,0.0,251.40525101030426,-0.07634573430720515,-0.08444142594445198,223.10011291503906,223.455814906529,7.8075087420663944
2022-04-13,0,213.68750381469727,199.14500045776367,233.45000076293945,214.29562377929688,225.21187782287598,-0.6496322462481153,8.39757500939055,0.007027506297058395,2.9949948642443105,222.00249862670898,6.8562623786926284,0.03823098746233346,210.81500091552735,228.7915023803711,0.7448735090496614,0.09159156211072086,0.9728385004077409,0.9506591612431672,0.9665422145011738,-0.05092104218505056,51.65424208029234,236.4487756977972,219.6536256790161,202.858475660235,221.7942875453404,6.4625913378949855,223.82160813467843,5.328916277034164,221.58150263130608,220.35140042157633,-3.317840754284805,1.6114511294472549,19231800,3.8140498650100487,0.6967264709723568,-535283700.0,-85.66390976454953,70.74152269624075,78.01649708558223,-70.72032014282935,20.361885233888252,27.458523925428054,0.1347621038201429,7.6194912073410235,230.8349208984375,227.10754107666017,224.09500122070312,221.08246136474608,217.35508154296875,0.1,0.0,251.16196704778557,-0.0372145534507623,-0.07267937051081974,220.40565054757255,223.12934221540178,6.901316012406696
2022-04-14,0,212.51499938964844,204.6724967956543,233.45000076293945,214.29562377929688,225.21187782287598,-0.20776173537100867,7.123208554459866,-0.5805604093296535,2.9952085163207034,222.00249862670898,6.05642469406128,0.03232228099363183,212.02400398254395,228.7915023803711,0.7198615925508255,0.044046010871913004,0.9643083553033175,0.9517805911732664,0.971312860959481,-0.04590553368135897,43.61134814339805,234.6271679557825,220.38075084686278,206.13433373794305,218.8035730634417,4.799816786149117,223.16696521214075,6.116928887381774,219.61787704065873,219.6371744124023,-7.100468050849075,-1.7562593866816691,18379500,3.7887912629784886,0.6795374361183233,-553663200.0,-99.32988580904245,70.74152269624075,78.01649708558223,-109.63208019303141,19.384294518675976,27.419865138666026,0.05462035520196071,7.431479810067362,230.5210404663086,226.59948037719727,223.43000030517578,220.2605202331543,216.33896014404297,0.12000000000000001,0.0,250.916316754575,-0.05727745431524667,-0.05875516864042819,217.31770978655135,222.29961722237724,6.687674592294474
2022-04-18,0,210.6125030517578,211.49750137329102,233.45000076293945,214.29562377929688,225.21187782287598,0.1718472463571017,6.4298038870136835,-1.0889762620146923,2.9953087619847745,222.00249862670898,5.625087051391603,0.02912406634452812,212.47174987792968,228.7915023803711,0.7665588980888476,0.00481092216102141,0.9539781647547894,0.9487306041352385,0.971699663817228,-0.05328867993754505,38.61909972843001,233.63248375058984,220.7728759765625,207.91326820253514,216.7264300755092,4.740121138605041,222.33035850524902,6.980883269018199,217.8507505669456,219.05064668427895,-8.96765958658094,-4.134338191496908,16580800,3.4925546518702277,0.6561530274480737,-570244000.0,-91.35153560277554,70.74152269624075,78.01649708558223,-116.5128467194042,18.414994534520687,27.722123207568824,-0.039664126070943544,7.26335851213806,230.11984118652344,225.95008154296875,222.5800018310547,219.20992211914063,215.04016247558593,0.14,0.0,250.6922516476719,-0.05199481264329142,-0.05463104868589446,215.53137860979353,221.38578033447266,7.000050860312253
2022-04-19,0,213.81499862670898,210.6125030517578,233.45000076293945,214.29562377929688,225.21187782287598,0.14130646194336824,6.496187356241198,-1.0709279292947977,2.9952996726408774,222.00249862670898,5.673761959075927,0.029430651892251893,212.47174987792968,228.7915023803711,0.755817804958431,-0.006931270572015806,0.9686781567159198,0.9693714923814294,0.9973854130617306,-0.017744153722708322,35.76111557278525,233.72100077296824,220.72862606048585,207.73625134800346,215.45143018450057,3.9947163631989953,221.3151798248291,7.120669848407471,216.02708068938216,218.22801447584746,-6.457845531062811,-5.268185789837691,20089900,3.516718294358916,0.8111528622957194,-550154100.0,-68.45239748935197,70.74152269624075,78.01649708558223,-73.15528478549486,21.60823733430243,25.202772145800942,-0.015046134138458872,7.418253768183074,230.11984118652344,225.95008154296875,222.5800018310547,219.20992211914063,215.04016247558593,0.14,0.0,250.4516476442248,0.003926796894022422,-0.022579113757560613,214.7273167201451,220.4911891392299,6.717031231217643
2022-04-20,0,206.7775001525879,210.6125030517578,233.45000076293945,214.29562377929688,225.21187782287598,0.16823781008003538,6.391016150946179,-1.050015325088399,2.9953139969140703,222.00249862670898,5.578474769592285,0.02894282042758789,213.57025337219238,228.7915023803711,0.7980939517224545,-0.0027983046066453105,0.9364276218416144,0.9444040316977754,0.9680458551314204,-0.048795923727043,41.52019793949382,233.5972830800906,220.81525077819825,208.0332184763059,213.21000126429968,3.7989103228761265,219.75250107901437,7.758047097956712,215.4703947481043,217.976879054544,-4.006913586539219,-6.232801533309976,43036500,3.553271904246687,1.6997722657073864,-593190600.0,-96.04638928973036,70.74152269624075,78.01649708558223,-174.05966326254543,18.145053835928966,29.948351666892403,-0.10789907227368499,8.202587811704396,227.9061600341797,222.3669196777344,217.88999938964844,213.4130791015625,207.87383874511718,0.16,0.0,249.79908204728125,-0.06407023613328255,-0.07410147087296597,211.6037336077009,218.53592027936662,8.092014903626586
2022-04-21,1,194.55500411987305,206.7775001525879,233.45000076293945,213.9068775177002,225.21187782287598,-0.07597259645297022,6.964482666873171,-0.8622991022280977,2.995232589700411,222.00249862670898,5.998537101745606,0.03159450168317501,212.3247497558594,228.7915023803711,0.7330707197367141,-0.03346773489659409,0.8826022978523967,0.8995390434094301,0.9199622813030802,-0.08953494871377832,33.113558508735956,234.36234126453246,220.43337593078613,206.5044105970398,209.9067873273577,7.508463226731326,217.55000141688757,10.067668094540032,213.30796157560576,216.91785917679817,-7.052716580381042,-9.567908942824452,49954100,3.883217759985806,1.8758002945459433,-643144700.0,-95.14429494454406,70.74152269624075,78.01649708558223,-247.65526726000996,15.59906111802372,36.5097368444838,-0.14993741627272092,8.859327492753009,224.7579208984375,217.27104107666017,211.22000122070312,205.16896136474608,197.68208154296875,0.18,0.0,248.86513535863213,-0.12521511211646708,-0.12174273098676418,207.55633762904577,216.09165736607142,10.735306838469432
2022-04-22,1,187.61750030517578,194.55500411987305,233.45000076293945,213.78312492370605,225.21187782287598,-0.9240126574819437,8.884790612777051,0.9166682554896655,2.9949016521569587,222.00249862670898,7.064574584960937,0.04048399944171941,210.22900276184083,228.7915023803711,0.6674192417064775,-0.10552507663944861,0.8548886640827046,0.8799110750054441,0.9035058117556883,-0.11715643204469928,22.365030927800177,237.23383217159903,219.46425094604493,201.69466972049082,205.65428706577845,10.428841658828546,214.89089420863561,12.592424205538187,208.642832500889,214.40566816786543,-10.622364452137171,-13.680729115433664,36426800,4.5775409443986295,1.3553126841138972,-679571500.0,-98.4325501114157,70.74152269624075,78.01649708558223,-228.89722994169256,14.415362227134247,35.59418850725808,-0.240960102800094,8.90154777703893,224.21276147460938,216.38862200927736,210.06500244140625,203.74138287353517,195.91724340820315,0.19999999999999998,0.0,248.1386144774095,-0.12403649091073643,-0.14363461937965935,203.27513558523995,213.18762425013952,13.23252383723827
2022-04-25,1,184.63999938964844,187.61750030517578,233.45000076293945,213.39437770843506,225.21187782287598,-1.1769199201673375,11.279419604759612,0.9558907842870017,2.9943636426458635,222.00249862670898,8.708524551391601,0.051747637248860494,205.5552505493164,228.7915023803711,0.7265490530382677,-0.15365617084584923,0.8470900139235472,0.880449752242135,0.9110129159655223,-0.12331890692988279,17.261432526570395,240.52859018608171,217.9697509765625,195.41091176704327,201.50464357648576,12.309179214797027,211.6494655609131,14.143576040556495,203.3935757228727,211.3062857673014,-13.693447817711013,-16.556961779633077,29281100,4.562456384489699,1.1116949483943104,-708852600.0,-90.3441990475971,70.74152269624075,78.01649708558223,-191.53371153911644,13.758599874018634,35.30135445179989,-0.18549857583478171,8.659850471376128,223.8328013305664,215.77360177612303,209.26000213623047,202.74640249633788,194.6872029418945,0.2,0.0,247.5535623671476,-0.11282439598232696,-0.11033392142706853,199.28333827427454,209.84449441092355,14.768458227192484
2022-04-26,1,183.56750106811523,184.63999938964844,233.45000076293945,212.03937530517578,225.21187782287598,-1.0653035037279794,13.366028654350778,0.2331941651417493,2.9937735605693394,220.0012493133545,10.472199859619138,0.06184604733662707,193.86125373840332,228.7915023803711,0.7908770852400072,-0.16950409569719643,0.84938650470643,0.891414849294143,0.9295451237631384,-0.14146574259461397,15.84391570197553,242.8498082394877,216.11775093078614,189.3856936220846,197.3692866734096,12.844585544594016,208.08642986842565,14.507637059445749,198.6999826148069,208.1122017429668,-13.593450204855152,-19.72871966690041,31747400,4.53219146690757,1.1928245072432921,-740600000.0,-97.07012166639895,70.74152269624075,78.01649708558223,-169.32662197896627,12.878331235811906,34.839877249975935,-0.26013571384171774,8.590533697040744,217.31036419677736,210.0848233947754,204.24500274658203,198.40518209838868,191.17964129638673,0.2,0.0,246.90414112333107,-0.16731849082443528,-0.14148117593598003,195.11619131905692,206.21695055280412,16.481652514153353
2022-04-27,1,174.89749908447266,183.56750106811523,233.45000076293945,209.65375232696533,225.21187782287598,-0.8713321350385766,15.031460555173442,-0.42999217974290627,2.993213786750798,217.53125190734863,11.983137531280516,0.07018147935417628,187.31975021362305,228.7915023803711,0.827112030602441,-0.19497647895416828,0.8165916529561321,0.8636177809220178,0.9136296699570051,-0.15417538680267406,12.636391254971233,244.24279724712667,214.1798761367798,184.11695502643292,192.26714324951172,13.767568483255292,204.49678666251046,16.09105493081666,194.94058131238847,205.1943923333781,-13.621390680503293,-21.367530319898435,71062900,4.165111720142,2.4849283496689316,-811662900.0,-89.4727592029902,70.74152269624075,78.01649708558223,-170.5794502233565,11.608380874439582,39.88435969042554,-0.279983274932706,8.849212731304528,212.1812832641602,203.92936264038087,197.26000213623047,190.5906416320801,182.33872100830078,0.2,0.0,245.33258835976602,-0.12708306488607657,-0.19492884464027324,190.0095432826451,202.77046094621932,18.049180918442485
2022-04-28,1,202.5199966430664,174.89749908447266,233.45000076293945,203.72187614440918,224.92187690734863,-0.7881701061968318,16.92498852843961,-0.6158127205496804,2.9924550135529553,215.60000038146973,13.799612541198732,0.08001474277608192,184.53274955749512,228.7915023803711,0.8129398814974627,-0.23510311560939134,0.9574355345162473,1.021443122450078,1.0943743675531252,0.04093954077010431,10.043273445468722,245.37335314025327,211.52337608337402,177.67339902649476,190.65357153756278,11.253601551745204,203.05250086103166,15.211018570566502,189.9427160527835,201.205742768228,-16.957684586516798,-22.32042904133751,100890600,4.330601938826503,3.117496858651605,-710772300.0,-34.5626357877156,70.74152269624075,78.01649708558223,-35.56157731890332,27.374844669897882,30.868740475831284,-0.1281501195472793,10.616619174194847,211.88332373046876,203.68834301757812,197.06500244140625,190.44166186523438,182.24668115234374,0.02,1.0,244.03914913349612,0.09390117787851793,0.026494399627580212,188.35865129743303,201.54298400878906,17.599864898729212
2022-04-29,1,204.32749938964844,174.89749908447266,233.45000076293945,200.52874851226807,223.26624870300293,-0.6681001248558005,16.556752431259376,-0.6978029143704956,2.992568374535831,213.75125122070312,13.694137973785406,0.07876043281242505,184.53274955749512,225.85299949645997,0.8586199656998063,-0.1014685780580928,0.9719854394286628,1.0363970860003955,1.0947181475234775,0.08906418141853734,45.224489114514604,243.33013064834637,210.21662578582763,177.1031209233089,190.30357142857142,10.692668950424345,201.75678634643555,14.166741064125915,193.0940191289297,201.54017144521595,-5.2826050820513615,-9.077849247834653,49193400,8.056512203850687,1.4635339268581118,-661578900.0,-40.65622865337659,70.74152269624075,78.01649708558223,-22.18098055868064,27.71116358353118,28.288895554030642,-0.15509811817561606,10.756928723046627,209.5149190673828,201.77253924560546,195.51499938964844,189.25745953369142,181.51507971191407,0.04,0.0,243.46377601442498,0.08885998600292733,0.06593290450143413,188.36578151157923,199.98475755964006,17.427382887500706
2022-05-02,0,206.2925033569336,174.89749908447266,233.45000076293945,200.52874851226807,222.535626411438,-0.5582583910902387,16.224657345036313,-0.7110654530083047,2.992673034439636,213.10125160217285,13.440550613403321,0.07756925698833805,184.53274955749512,225.639253616333,0.8544068208544221,-0.09125175885460375,0.9862739081239905,1.0507276064876492,1.0858043129413366,0.1172687610423544,46.78126244332713,241.61281547590022,209.16350078582764,176.71418609575505,191.9803570338658,12.273881552701555,200.94357218061174,13.493304012095097,195.9273958387799,202.40216773344454,-1.1848488163032813,-8.154001367764453,49915300,8.083714923497288,1.4208223299609821,-611663600.0,-20.554392131609433,70.74152269624075,78.01649708558223,-0.1505940050889168,25.619752594852564,26.153882102107513,-0.0854377811429476,10.803597913835532,209.5149190673828,201.77253924560546,195.51499938964844,189.25745953369142,181.51507971191407,0.04,0.0,242.95052554151246,0.1290978348487739,0.14676014769096085,191.65331159319197,199.60482461111886,17.005580856207228
2022-05-03,0,211.36749649047852,174.89749908447266,233.45000076293945,200.52874851226807,218.87500190734863,-0.47429739707138996,15.82705520742136,-0.6521934786763364,2.9928022931718434,211.56375122070312,12.892787952423095,0.07600542000544308,184.53274955749512,225.639253616333,0.8284257712817392,-0.10315406074954307,1.015038813962364,1.078950573299727,1.0877233885687216,0.15144290389423398,47.368555861560566,239.88998630748193,208.23587589263917,176.5817654777964,195.3732136317662,14.024593496403272,200.51375034877233,13.016709423628221,198.5397297124082,203.48527248475432,6.032997861020633,-5.230213611303789,41556300,7.984155528923704,1.1605846449023707,-570107300.0,-12.947592241137675,70.74152269624075,78.01649708558223,25.00312653626353,26.486151829515492,24.943857777324933,-0.10963973454054148,10.51822161423065,206.76451440429688,199.54773547363283,193.71499633789062,187.88225720214842,180.66547827148437,0.06,0.0,242.57815617816985,0.1717600717432648,0.13391089015806587,195.63370404924666,199.4544198172433,15.894061266972217
2022-05-04,0,216.3300018310547,174.89749908447266,233.45000076293945,200.52874851226807,217.45812702178955,-0.5171392421659174,15.046223280382925,-0.49644881783992734,2.9930592647499004,210.98999977111816,12.053425273895263,0.07258073971340025,184.53274955749512,222.9812484741211,0.7841125196915525,-0.09459200771168542,1.043543702795535,1.1056636413661955,1.082293979522873,0.23689591311177538,50.90392189181423,237.39569725504077,207.3032506942749,177.21080413350904,199.90035683768136,15.059079436510089,200.70250020708357,13.239680086458304,201.7532470749798,204.871858054471,12.658731806292776,-2.7681328456969228,41375900,8.043123471275598,1.1370508798246493,-528731400.0,-1.609402062447401,70.74152269624075,78.01649708558223,67.74088304088622,29.60738138725263,22.135605762308003,-0.02749226030719518,11.00568019360779,211.24920233154296,203.17540188598633,196.6500015258789,190.12460116577148,182.05080072021485,0.08,0.0,242.29284167291797,0.2769933537032956,0.23465034749059543,200.82589067731584,200.0546144757952,15.288140033641882
2022-05-05,0,213.3375015258789,174.89749908447266,225.15250396728516,200.52874851226807,216.59375190734863,-0.7737141632643594,13.983832948844,-0.4588621863548652,2.9933933831442388,210.98999977111816,11.31605026245117,0.06773562204485352,184.53274955749512,222.49475212097167,0.7880128185357521,-0.03918456148954215,1.0333753574011963,1.0850713276881223,1.0248357788560245,0.05341450257812275,56.5465219289096,234.41491664536866,206.44725074768067,178.47958484999268,204.1532140459333,13.831379538308063,200.76125035967146,13.297826524415255,205.38149719510304,206.47640568082187,17.16312962855377,1.2366179440464187,41129200,7.968660058003224,1.1117355115447856,-569860600.0,-28.969264716797717,70.74152269624075,78.01649708558223,35.024537314343945,26.42068091325858,20.252271754495034,-0.046159993409314676,11.451863639432998,211.24920233154296,203.17540188598633,196.6500015258789,190.12460116577148,182.05080072021485,0.08,0.0,241.93880689999432,0.012394879789569213,0.19051152808715166,204.72216796875,199.91917964390345,14.757207884863233
2022-05-06,0,205.37750244140625,174.89749908447266,222.73999786376953,200.52874851226807,214.4437494277954,-0.872019089554622,13.419316343364736,-0.3539853336901575,2.9935630325633253,210.98999977111816,10.887050437927247,0.06518772204221204,184.53274955749512,218.15650177001953,0.7841573840305089,-0.04221287792074643,0.9976731452115993,1.0347007970745892,0.9764490347824413,0.00513882397080323,54.26340710164129,232.69513331233983,205.85650062561035,179.01786793888087,208.50750023978097,5.175675897244175,200.38732174464636,13.071176630885933,207.36980039664394,207.74528406306118,16.217467844004208,0.38703250998410826,34747200,7.977170897928614,0.922141376858729,-604607800.0,-37.12476970404844,70.74152269624075,78.01649708558223,-0.24295131980631407,25.01543846684402,22.44523223887488,-0.06839325448661729,11.230942440229919,211.24920233154296,203.17540188598633,196.6500015258789,190.12460116577148,182.05080072021485,0.08,0.0,241.58037751926923,0.016461292984701448,-0.009527039320190929,208.83086722237724,199.42020525251115,14.162339595110597
2022-05-09,0,198.5500030517578,174.89749908447266,222.46750259399414,200.52874851226807,213.7193775177002,-0.9039325092598556,12.848473003378418,-0.27226247801958303,2.993727092976619,208.69500160217285,10.279363098144534,0.06267903216374916,184.53274955749512,217.4142520904541,0.7603207180278618,-0.07682020948370759,0.9685915224417186,0.9914326485219431,0.9430467319283,-0.037531661011352746,47.480093044530435,230.685321861249,204.98837585449218,179.29142984773534,207.94035829816545,6.079689232945079,199.29696491786413,12.488617901297307,206.85872731020072,206.92924909318228,17.427352315776822,-2.48560770823044,36303200,8.148742809331317,0.9410492396253606,-640911000.0,-50.79565061072403,70.74152269624075,78.01649708558223,-35.26705056313703,23.68630968664358,24.78184612666189,-0.10303996095684054,11.013665005504027,211.24920233154296,203.17540188598633,196.6500015258789,190.12460116577148,182.05080072021485,0.08,0.0,241.14741490265848,-0.07066729209028155,-0.021249998093212905,207.4736589704241,197.91615513392858,13.610362798154117
2022-05-10,0,198.57749938964844,174.89749908447266,217.6775016784668,197.55125331878662,213.4250020980835,-0.8974759076796539,12.26579716921133,-0.3253520686790301,2.993885255938637,206.53500175476074,10.02000024795532,0.060187676761430595,184.53274955749512,216.43550186157228,0.7472648594972137,-0.08787081108162646,0.9744102385255592,0.9847302354561557,0.9501656680252258,-0.06051070913548062,43.3030492720131,228.32409521580306,203.79250087738038,179.2609065389577,207.1189297267369,6.972121749957259,198.71125057765417,12.301684898080499,204.77981323841567,205.19091577179282,-1.9602970852826709,-7.139347413883586,34452500,8.212394259306151,0.8772307288048936,-606458500.0,-48.191695632151124,70.74152269624075,78.01649708558223,-28.751973161778928,22.318800507971908,24.266143027060313,-0.09636269485642474,10.853357324871913,211.24920233154296,203.17540188598633,196.6500015258789,190.12460116577148,182.05080072021485,0.08,0.0,240.74580127469457,-0.06782058717098927,-0.0638469447339456,207.0716269356864,197.7187042236328,13.27987864183117
2022-05-11,0,193.50250244140625,174.89749908447266,217.38500213623047,197.55125331878662,212.72062492370605,-0.8288589880738059,11.885196870106709,-0.36240705236092907,2.993985056374161,205.83500289916992,9.777500305175783,0.058594672214962826,184.53274955749512,214.06649894714357,0.7291526030662673,-0.08651702077770654,0.953977946452598,0.9524741346869643,0.9373554366963472,-0.10552165301360195,43.38112367784882,226.60789450315286,202.83750076293944,179.06710702272602,205.2917867388044,8.689244704047441,198.6360718863351,12.33221676417521,203.26155737371985,203.70825546621077,-2.8141097097434082,-3.965615580461319,31153400,8.21416961579015,0.7822497155708958,-637611900.0,-64.30378950487848,70.74152269624075,78.01649708558223,-58.639940393749924,20.51529694701759,26.163139732901,-0.11164081418589027,10.963860937423854,211.24920233154296,203.17540188598633,196.6500015258789,190.12460116577148,182.05080072021485,0.02,1.0,240.34114402401684,-0.15518549524302028,-0.10984292175827365,203.8796146937779,197.76646314348494,13.28017962370252
2022-05-12,1,190.28250122070312,174.89749908447266,216.3300018310547,194.29187870025635,211.654372215271,-0.7160444805861775,11.558874946761357,-0.5159237135946282,2.9940644438704465,204.85250091552734,9.723949737548827,0.05732335566270115,184.53274955749512,213.70025329589845,0.714833760293227,-0.09446037326915842,0.9436585778548374,0.9281246943222596,0.94260386464626,-0.10806820245046833,40.343597250231525,224.76112567172098,201.64337577819825,178.52562588467552,202.27964455740792,9.813861288092841,198.82642909458704,12.168535513882832,200.8531489883303,201.57639461432905,-6.199934901850356,-0.5409789808430262,38262200,8.243773451006863,0.9383300500209555,-675874100.0,-59.78299409432465,70.74152269624075,78.01649708558223,-59.18328456449965,18.76751518059845,26.174795802087854,-0.11938426665453412,11.12862640454315,211.24920233154296,203.17540188598633,196.6500015258789,190.12460116577148,182.05080072021485,0.04,0.0,239.841069442915,-0.0818129202165403,-0.1439953072168719,200.91570608956474,198.27470506940568,13.005422073573941
2022-05-13,0,195.59249877929688,174.89749908447266,216.3300018310547,192.69750213623047,210.801251411438,-0.5331805534945901,11.464664286248555,-0.7262681433948903,2.9940782922553786,203.42374801635742,9.806812076568605,0.057188035798624866,184.53274955749512,213.3852512359619,0.7012806390986818,-0.10461613642706602,0.9756544581553582,0.9597535640571038,0.9915567281668775,-0.047643989949196164,38.31177540250292,223.40245422099562,200.47312564849852,177.54379707600143,199.3171441214425,7.786117534866045,199.60875047956193,11.521176082473609,198.2367133655859,199.25690136935643,-9.975514504296173,1.420443674599914,24549800,8.257879230122837,0.5975306328217367,-651324300.0,-46.437624805436656,70.74152269624075,78.01649708558223,-20.03283051136138,18.908824338612,24.697742792207922,-0.07667123790298648,10.951540363820644,211.24920233154296,203.17540188598633,196.6500015258789,190.12460116577148,182.05080072021485,0.04,0.0,239.5596534130608,-0.02527364796799847,-0.046379910622980046,197.38153948102678,199.1037150791713,12.767095624942867
2022-05-16,0,199.59749603271484,174.89749908447266,216.3300018310547,192.69750213623047,207.73625087738037,-0.4163530944245371,11.165271577576766,-0.6989282308442784,2.9941540595040697,200.54874801635742,9.44874973297119,0.05593066841165111,184.53274955749512,213.3852512359619,0.7025570194036173,-0.07131582434481483,0.9998522014297926,0.9836216803440867,1.0219993498992253,0.005275713748964073,44.17331793515739,221.9575437731345,199.62700061798097,177.29645746282745,197.35428619384766,4.8352913448770884,200.7537501198905,10.560855092554366,197.5839493108336,198.07932764133005,-9.586050421223126,5.931812947277595,27112600,8.380354954135694,0.6515570082342804,-624211700.0,-43.86981632337152,70.74152269624075,78.01649708558223,10.828812813006198,21.34331570478454,23.161630721711408,-0.0793621990718714,10.843550231130518,211.24920233154296,203.17540188598633,196.6500015258789,190.12460116577148,182.05080072021485,0.04,0.0,239.28055774685495,0.019519811103881235,-0.018304952732765382,196.2068110874721,200.46448952811105,12.471574142797273
2022-05-17,0,202.13999938964844,174.89749908447266,216.3300018310547,192.69750213623047,206.41375255584717,-0.3497239500078065,10.877772924264937,-0.5840692642554535,2.994228074460268,199.08749771118164,8.897999382019043,0.05464123876993942,184.53274955749512,213.3852512359619,0.6683870161605846,-0.06649441192297229,1.0153898273576587,0.9994487015888166,1.0339086638895705,0.017940099008949995,47.277517957819434,220.83179611555866,199.0762502670288,177.32070441849893,196.89178575788225,4.027281125928441,202.69964299883162,7.49500636731953,198.09959007060138,197.86247685050898,-6.44050173780503,8.732479807878116,24872700,8.402366714284645,0.5943133469076302,-599339000.0,-54.858313741827644,70.74152269624075,78.01649708558223,30.068350041485285,20.380465079978617,22.05076735679763,-0.09126595365051171,10.576101010852502,214.97328204345703,209.20336141967772,204.54000091552734,199.87664041137697,194.10671978759765,0.04,0.0,239.03905583207913,0.025145461379832534,0.03266897591652412,196.04286193847656,202.43686458042689,11.71870261855633
2022-05-18,0,196.21750259399414,174.89749908447266,216.3300018310547,192.69750213623047,205.6062526702881,-0.3764809991040971,10.372703242054445,-0.38522522193800457,2.9943562220575197,199.08749771118164,8.328499603271485,0.05225740633075179,184.53274955749512,211.56449699401855,0.6768102626145281,-0.022427492157112303,0.9885386213197783,0.9746124286726954,0.9999719860629399,0.01403082708664205,51.22173479489072,219.2379067892847,198.49250030517578,177.74709382106687,196.55857140677315,3.963199678888613,202.24946485246932,7.69327974536867,199.01046341493802,198.07458064041992,-1.576366940522838,15.576266354739639,23960000,8.296608035993037,0.585857316357816,-623299000.0,-81.12346683356601,70.74152269624075,78.01649708558223,-23.14555786593107,18.87168655570039,24.95178589102436,-0.07661538923475998,10.605669989590133,214.97328204345703,209.20336141967772,204.54000091552734,199.87664041137697,194.10671978759765,0.04,0.0,238.7646035933783,0.018544059701071758,-0.02737156413656865,195.4768807547433,201.4752698625837,11.763874691323647
2022-05-19,0,191.84499740600586,174.89749908447266,216.3300018310547,192.69750213623047,204.5900001525879,-0.26730695463996357,10.204945285612569,-0.30199184777596066,2.9943958727690054,198.56375122070312,8.08079948425293,0.051549370031436455,184.53274955749512,211.56449699401855,0.7096876829872955,0.008545133452834565,0.9690878768262332,0.9625095475565518,0.9749905867518394,0.008211454943460206,48.4219287019431,218.37439099847123,197.9645004272461,177.55460985602096,195.59678540910994,4.2013528315695226,201.35785756792342,8.144041794396156,198.2226943861699,197.6194222237226,-1.1747672736905665,-3.1120354303482265,24446900,7.929005380605907,0.6170036472189545,-647745900.0,-83.52734361576891,70.74152269624075,78.01649708558223,-46.190575782955136,18.123595555077486,25.376930732303915,-0.0466200645205882,10.254489543903064,214.97328204345703,209.20336141967772,204.54000091552734,199.87664041137697,194.10671978759765,0.04,0.0,238.4697894659787,0.00026136520906860916,0.013510560966190667,194.57017081124442,200.8208988734654,11.651965182540351
2022-05-20,0,193.5724983215332,174.89749908447266,216.3300018310547,191.45437335968018,204.5900001525879,-0.2316413443405705,10.267118902068978,-0.374324218112422,2.994378499977108,198.56375122070312,8.229849853515626,0.05189895767211827,184.53274955749512,211.56449699401855,0.6903316768281443,0.02253253078179645,0.9784839342662114,0.9817630275253949,0.982210131803169,-0.010327596765574376,45.954060496324885,218.36323789569067,197.82900009155273,177.29476228741478,195.60678482055664,4.195616975657148,200.44928577968054,8.259886707856921,196.57314266015834,197.1119379351311,-3.390364973038599,-6.1090660928799885,31465600,7.829458856244951,0.7991484716656283,-616280300.0,-77.8340243932103,70.74152269624075,78.01649708558223,-42.14708953158108,18.68204454990086,23.599266637768928,-0.003706053094361026,10.239167031718358,214.97328204345703,209.20336141967772,204.54000091552734,199.87664041137697,194.10671978759765,0.04,0.0,238.1042034580897,-0.025576467432882888,0.012026717296948056,195.25447736467635,199.56704602922713,11.266596835450368
2022-05-23,0,194.91250228881836,174.89749908447266,216.3300018310547,193.08812618255615,204.5900001525879,-0.2871870504584064,10.050732785092597,-0.16370334385963137,2.9944377096204713,198.56375122070312,7.902324962615967,0.05072880257451166,184.53274955749512,211.56449699401855,0.662829520411262,0.04837791898511863,0.9837768110380046,0.99451370009296,0.9910410527487267,-0.023472207001677958,48.50379415320403,218.22821556255582,198.1267499923706,178.0252844221854,196.26821354457311,3.5282391151503907,199.27392905099052,7.7412115315469805,195.78844021781737,197.19265688739708,0.03617311365166882,-6.166004497697063,25059200,7.798677382794945,0.6398722870151188,-591221100.0,-71.02733878948247,70.74152269624075,78.01649708558223,-33.69993695301506,17.908324233539435,22.62189866286122,-0.015000415896524639,9.918464805926117,214.97328204345703,209.20336141967772,204.54000091552734,199.87664041137697,194.10671978759765,0.04,0.0,237.82816558161085,-0.01904625849684971,-0.012033041248597198,195.9658704485212,198.44078826904297,10.978508157696693
2022-05-24,1,180.40499877929688,174.89749908447266,216.3300018310547,193.55499935150146,204.5900001525879,-0.3534068239875208,9.60080028184056,0.2709071746634142,2.9945560649966825,198.56375122070312,7.352662086486816,0.048332572243699655,189.61100120544432,211.56449699401855,0.6198817955606729,0.06180288534021829,0.9081990438981739,0.9222027919698026,0.9216680440860686,-0.10752449132274322,50.232840833952196,217.84197570101023,198.6403751373291,179.43877457364798,194.09857068743025,6.987183133834818,196.7078574044364,7.605581992982426,195.55253928440285,197.40286539648181,2.433224830666395,-7.785016369535041,50406300,7.792164269776382,1.2571478879562328,-641627400.0,-88.26600441348204,70.74152269624075,78.01649708558223,-158.16336757151473,15.490764764489334,29.719598264222206,0.03300912918153326,10.647245642643535,209.77183874511718,203.3390791015625,198.13999938964844,192.94091967773437,186.5081600341797,0.06,0.0,237.10026216275563,-0.10532028672907945,-0.09378123581883793,193.49380929129464,195.43767438616072,10.951138424672639
2022-05-25,1,182.25,174.89749908447266,216.3300018310547,193.55499935150146,204.5900001525879,-0.4144541638573243,9.870016890087262,0.21090972769563265,2.9944856746546815,198.56375122070312,7.51127492904663,0.0497274536586979,189.2947509765625,211.56449699401855,0.4408743315838969,0.03148987105964383,0.9182181277115895,0.9403697252973916,0.9522416217954414,-0.07118377519509644,39.17696539498587,218.2222838030627,198.4822500228882,178.74221624271368,191.620356968471,7.746870482100394,194.4873215811593,6.880502403405555,191.78688296115232,195.62231584098885,-7.764868333287826,-16.60657456094039,28030200,8.252958290452753,0.7387230565996712,-613597200.0,-76.79591154398103,70.74152269624075,78.01649708558223,-146.44274017756268,16.058431968672238,28.459050864418256,0.054672131403896325,10.324543340350898,201.52828387451171,196.67086325073242,192.74500274658203,188.81914224243164,183.96172161865235,0.06,0.0,236.72096209196786,-0.04374743742545917,-0.09273515879844002,191.18284388950892,193.69482748849052,10.09731737689486
2022-05-26,1,187.4000015258789,180.40499877929688,216.3300018310547,193.55499935150146,204.5900001525879,-0.06336474136218512,9.090894259381132,-0.29491840385446944,2.994685230861222,198.56375122070312,7.164112148284912,0.045717374759435825,189.4792510986328,211.56449699401855,0.7503946854613017,-0.10008886519384792,0.9424195084918615,0.9725894911055664,0.9936531448680549,-0.023169725248138207,32.86694355189211,217.0316635874268,198.84987506866455,180.66808654990228,189.5146429879325,6.274210673013858,193.20321437290735,6.348749732079938,189.4988367119203,194.5855943134817,-8.69123930786763,-14.57198162701265,23056500,5.2036845059203705,0.677088441878727,-590540700.0,-47.12095044299869,70.74152269624075,78.01649708558223,-83.00280365965183,19.983658756111474,26.381214850240305,-0.007975737840612842,10.342078558784657,198.5334052734375,194.24830438232422,190.78500366210938,187.32170294189453,183.03660205078126,0.06,0.0,236.44746782937406,0.0017774424906991104,-0.0031731980254207396,189.6160627092634,192.82946232387,10.088896768021355
2022-05-27,0,192.90500259399414,180.40499877929688,216.3300018310547,193.08812618255615,204.5900001525879,0.09065700724786181,9.378396099181034,-0.5115660039822973,2.9946121467366185,197.38375282287598,7.495874977111816,0.047343190617942316,186.885001373291,211.56449699401855,0.7974557396998575,-0.08284493234799067,0.973805991171522,1.0026599326305585,1.0276866324600928,-0.0034482983550190305,39.36029568071514,216.85066751116727,198.09387531280518,179.3370831144431,189.04142870221818,5.790696654326657,192.80000005449568,6.159487598346478,189.019794896981,193.8029943693529,-7.291974823526375,-8.753393483619893,22562700,5.352262609808192,0.6895504201674252,-567978000.0,-35.19591033344736,70.74152269624075,78.01649708558223,-38.742381275138,20.98029563759989,25.33886744938611,0.09204255209206089,9.99832077064546,198.5334052734375,194.24830438232422,190.78500366210938,187.32170294189453,183.03660205078126,0.06,0.0,236.2079654929943,0.008215470808336178,0.020074381296224537,190.02807399204798,192.75247737339564,10.09663392336536
2022-05-31,0,194.5349998474121,180.40499877929688,216.3300018310547,192.64000129699707,202.9493751525879,0.25247172098059795,9.329064602549833,-0.4243704863377378,2.994620296275927,195.9050006866455,7.386524925231933,0.04723032957068908,186.885001373291,211.56449699401855,0.8035064812595994,-0.06489572110032515,0.9848738911418793,1.012546551613999,1.0371079159017422,-0.0019367790006967756,45.42696267501269,216.18087967812212,197.52275047302246,178.8646212679228,189.42571476527624,6.089315813472045,192.51125008719308,5.959311984471667,190.02719090355424,193.8932973340367,-1.6881776376769508,-2.843112752958326,26131100,5.507791324867824,0.8287254007279982,-541846900.0,-40.27258898185686,70.74152269624075,78.01649708558223,-25.262253958999427,21.789717877538248,24.29393568533986,0.009993952894068826,9.68340938603784,198.5334052734375,194.24830438232422,190.78500366210938,187.32170294189453,183.03660205078126,0.06,0.0,235.940279433915,-0.013198708156832772,0.0005167554049169374,190.36310250418526,192.46663665771484,9.643673616424222
2022-06-01,0,192.4199981689453,180.40499877929688,216.3300018310547,192.64000129699707,200.23312187194824,0.41708348102934256,9.126157655026875,-0.14706236571788667,2.9946643698436595,195.25250053405762,6.979849777221682,0.04634099288527885,186.885001373291,211.56449699401855,0.7668375510865397,-0.07963616413380124,0.9770742631452168,1.0041840894233087,1.0262454605369193,0.06660014673067516,45.87791167479289,215.18719060760014,196.9348752975464,178.68255998749265,189.2610718863351,5.972977631984838,192.43392835344588,5.9524799992762825,191.19160748565574,194.03372353114003,1.4021749213055255,-2.0357288991257474,36623500,5.369511983574833,1.1706395725624088,-578470400.0,-57.30836056693018,70.74152269624075,78.01649708558223,-53.052932581433254,19.534723086105714,26.77260350242933,-0.029568247066137417,10.0296271721754,198.5334052734375,194.24830438232422,190.78500366210938,187.32170294189453,183.03660205078126,0.06,0.0,235.54093421470873,0.04060019215582167,-0.038679011818519994,189.66453988211495,192.45950862339564,9.141293020352371
2022-06-02,0,193.99499893188477,180.40499877929688,216.3300018310547,192.27624797821045,198.83249855041504,0.5939585610124123,8.54361822427588,0.5005428351712276,2.9947892887098453,194.72375106811523,6.222750320434568,0.04359266895922748,186.885001373291,206.17350234985352,0.6680847768279821,-0.11052560190325407,0.989833527925471,1.0175652486037183,1.0215532142654113,0.06444443858372995,42.226311981295574,213.07473683002146,195.98750038146972,178.90026393291797,189.12999997820174,5.836807225357453,192.6991067613874,5.9319218850478395,191.51628978910875,193.6333297881465,-0.5953842423800991,-0.5594264977470906,31951600,5.193476152185568,1.0369243410911078,-546518800.0,-22.487239287916395,70.74152269624075,78.01649708558223,13.203406078030401,18.71948992564182,24.309451364123397,-0.05474783398360769,10.256817143540719,198.5334052734375,194.24830438232422,190.78500366210938,187.32170294189453,183.03660205078126,0.06,0.0,235.23516090364512,0.08176031211424784,0.09697703349096656,190.03948538643974,193.00267791748047,6.5405213536788676
2022-06-03,0,193.2874984741211,180.40499877929688,213.3375015258789,192.27624797821045,198.55687713623047,0.33307083408461813,7.159184053781947,0.9020079039952535,2.9950595993550997,194.26499938964844,5.0465753364563,0.03673811511010744,186.885001373291,202.46374969482423,0.5718015183683718,-0.09066620943644921,0.9918753750346392,1.015037488399343,1.0053913803275214,0.0314167390624549,45.11337076430625,209.18911834407513,194.87075023651124,180.55238212894736,190.97035707746232,4.506673931866615,192.5344638824463,5.877172592105375,192.10530324173635,193.6602739012154,-0.47072575958932145,1.9510452550104032,19465000,5.2133176775829195,0.6547124327418778,-565983800.0,-50.017052408080765,70.74152269624075,78.01649708558223,-24.813945473912856,17.525916990344854,22.75945703546432,-0.031656099893727245,10.17275203370268,198.5334052734375,194.24830438232422,190.78500366210938,187.32170294189453,183.03660205078126,0.06,0.0,235.03505229814394,-0.00443560230110962,0.03780665648210907,191.3938446044922,192.44382694789343,5.750408055360709
2022-06-06,0,193.38999938964844,180.40499877929688,205.37750244140625,192.27624797821045,196.80062770843506,-0.4763564566302257,5.772624958194877,0.48204495311441375,2.995286639668934,193.78374862670898,4.081250190734863,0.029776020342144594,186.885001373291,199.85174636840821,0.5453428273480827,-0.05886722656360283,0.9975331149166103,1.0148070284427837,0.9998009589398562,0.002514174278181125,46.58631372681187,205.4135000003131,193.86825008392333,182.32300016753356,192.56178556169783,2.3784514775520416,192.0910712650844,5.527053808805793,192.35255481722322,193.4864865853784,7.140877349293607,-1.1784707080084411,30574200,4.949917759893858,1.0356426199344488,-535409600.0,-38.19422276891595,70.74152269624075,78.01649708558223,-2.887744132548267,16.465060030489994,22.36224062726572,0.007580151185369077,10.054689658800562,198.5334052734375,194.24830438232422,190.78500366210938,187.32170294189453,183.03660205078126,0.06,0.0,234.7303088173557,-0.004509859725292831,0.013672244807650152,192.87936401367188,192.0311039515904,5.256338421206313
2022-06-07,0,193.89999771118164,180.40499877929688,202.13999938964844,192.27624797821045,195.7487497329712,-0.8890302130759851,5.133443291724578,0.807380168719765,2.995376587391446,193.53750038146973,3.5374624824523893,0.026561148521966543,186.885001373291,198.67949905395508,0.5687977216712372,-0.025988434060936632,1.0032655169130074,1.017580675471958,1.0019351390425923,-0.003264205087663119,49.05835483747428,203.53576151478464,193.26887493133546,183.00198834788628,193.4903564453125,0.7133581042890096,191.50249971662248,4.760168366108974,192.572504352387,193.329913837078,6.112482518325617,-3.1100072728612647,18828700,4.730747703630382,0.6572376971914675,-516580900.0,-21.49460118404271,70.74152269624075,78.01649708558223,27.40174957886229,15.853721006130943,21.531942387099022,0.08113658927527503,9.696471807166077,195.12596014404298,191.4920202331543,188.55500030517578,185.61798037719726,181.98404046630858,0.06,0.0,234.55093737372215,0.010379989777617782,0.002664746145846182,193.45247105189733,191.53426688058036,5.241680702734823
2022-06-08,0,196.9375,180.40499877929688,202.13999938964844,192.27624797821045,195.082501411438,-0.8858283803623873,4.9923525258268615,1.0157458224073883,2.995395138450392,193.53750038146973,3.374712295532228,0.025862237283043897,186.885001373291,198.67949905395508,0.5402646473310757,-0.023555043712624315,1.0202092758034722,1.034070848316726,1.01829901210014,0.023477299002405694,49.864923274425706,203.02107971596035,193.03637466430663,183.05166961265292,194.06642750331335,1.4300602095736736,191.55392810276575,4.818558554015858,192.9004662115586,193.25191090828392,3.4685144783230544,-4.076383547713005,22267200,4.733579189924349,0.7941518536522562,-494313700.0,-20.794752200662508,70.74152269624075,78.01649708558223,90.46145617173593,19.064688320533293,20.304448288275292,0.07939294755546313,9.548142333609883,195.91287921142577,192.12855947875977,189.06999969482422,186.01143991088867,182.22712017822266,0.02,1.0,234.35734096727262,0.04240883320328126,0.015492681158087246,193.66774204799108,191.84790802001953,5.202394431427376
2022-06-09,0,190.35249710083008,180.40499877929688,202.13999938964844,192.27624797821045,195.082501411438,-0.9257738848936505,4.9135115274398675,1.1552849228876712,2.995405352756612,193.53750038146973,3.3173123168945295,0.025464628802591573,186.885001373291,197.2034996032715,0.5583358557204787,0.01775169579336003,0.9865155812190873,0.9908928456417228,0.9796733856426151,-0.018776266662078434,56.70552629054632,202.78139774970396,192.95437469482422,183.1273516399445,193.46892711094446,1.9725239829004342,191.44732093811035,4.828124248668685,193.9148706602948,193.52293605484599,2.090405822441541,0.3669384211334352,23501600,4.643784808696561,0.8497713728260893,-517815300.0,-69.5601853895907,70.74152269624075,78.01649708558223,-73.26009259370184,16.915463236139413,25.68590574349435,0.09177970791706522,9.992588059786911,195.91287921142577,192.12855947875977,189.06999969482422,186.01143991088867,182.22712017822266,0.02,0.0,234.10751730898582,-0.0747259503344786,-0.024597160543030173,192.29342215401786,191.32826232910156,5.5156131971529465
2022-06-10,0,179.18250274658203,180.40499877929688,202.13999938964844,191.4718723297119,195.082501411438,-0.8206072967970678,4.943809800705129,0.9475202439476536,2.9954010508624327,193.48124885559082,3.4623126792907697,0.025642582720170812,186.885001373291,197.2034996032715,0.5339417691322174,0.0003678524282470249,0.9293848942228982,0.9288290573961326,0.925656167308664,-0.07297417494089797,47.278554739522406,202.68449402920567,192.79687442779542,182.90925482638517,191.57785633632116,5.792433766698725,190.41946411132812,5.778998582791103,193.03653770978337,193.07260132860785,-2.1500001284409853,-0.7779719697444961,27450800,4.830520392887012,1.0123540473251582,-545266100.0,-97.96370542904549,70.74152269624075,78.01649708558223,-218.88960785231413,15.821674046798115,30.26078323907746,0.05174356387294875,9.920255953303789,195.6556400756836,191.71218087768554,188.5250015258789,185.33782217407227,181.3943629760742,0.02,1.0,233.74785822854477,-0.07972530635189401,-0.1171175424309977,190.43010820661272,190.04732404436385,6.749268133558161
2022-06-13,0,167.86499786376953,179.18250274658203,202.13999938964844,191.4718723297119,195.082501411438,-0.8895214234143408,5.751928599410673,0.32256661900536354,2.9952804633974286,193.48124885559082,4.201624946594234,0.02992026900615931,182.06549987792968,197.2034996032715,0.4546634632223674,-0.08389890274489306,0.8731968427627806,0.8738849568500556,0.8800146703235232,-0.13198718447922586,33.15909937828544,203.74573170291072,192.24187450408937,180.73801730526802,187.8449990408761,10.48992569996269,188.48749950953894,8.182629136402095,189.59286626916105,191.2447572055318,-6.879480068771605,-7.433904970864559,31749300,5.26030079528236,1.1555375032960842,-577015400.0,-99.39474808542353,70.74152269624075,78.01649708558223,-270.34959319753415,14.52211975303656,35.597522717477794,-0.03509863779313563,10.03595863128863,193.06199877929689,187.51399877929688,183.02999877929688,178.54599877929687,172.99799877929686,0.04,0.0,233.2572134435138,-0.15438873977882395,-0.1390083189352072,185.4973863874163,187.76843588692802,9.016802533117636
2022-06-14,0,164.46749877929688,167.86499786376953,202.13999938964844,189.61437320709229,194.62937545776367,-1.3704567345552712,7.766139222957248,1.6808140719094151,2.9948878575035636,193.33874893188477,5.767799873352056,0.04069119959864475,180.2827491760254,197.2034996032715,0.4789884199429501,-0.1589824461712898,0.8617383268812758,0.8675063869340437,0.8859128164417742,-0.1517921571908687,24.267794797663726,206.38777790422748,190.85549945831298,175.32322101239848,183.7278562273298,13.281954618414554,187.34910665239607,10.242862188096572,184.20357103496957,188.0244437326451,-13.469419939681002,-13.876741669946984,27244300,5.614670845119892,0.9913373555483024,-604259700.0,-94.17262054612735,70.74152269624075,78.01649708558223,-228.7571151118033,13.945941192895235,36.150550662985125,-0.034692838335502484,9.704088247943016,192.43187921142578,186.49405947875977,181.69499969482422,176.89593991088867,170.95812017822266,0.06,0.0,232.8230434695645,-0.16314847431071833,-0.15711719421403633,181.64102390834265,186.5174342564174,10.5196395119447
2022-06-15,0,168.17250061035156,164.46749877929688,202.13999938964844,186.11250114440918,194.1299991607666,-1.356117910133519,9.392700913434707,1.0395036817993306,2.9944687833419454,193.09625053405762,7.302399787902834,0.04967081229154831,178.05075225830078,196.28950233459472,0.5936934161499832,-0.18636836214555152,0.8893357498979979,0.901343803852476,0.9355338547683135,-0.14606156465705333,21.613437156330733,207.8844014225115,189.09899959564208,170.31359776877267,180.12535640171595,13.639574491410567,186.3435709817069,11.4068024182107,179.2810497989514,184.64729081182546,-14.910431312081405,-8.8342895750342,30008300,5.536227666434541,1.0818031554679939,-574251400.0,-80.35405494740088,70.74152269624075,78.01649708558223,-150.52583401396353,17.092362370456776,33.88605231607885,-0.026410174288275193,9.613078398297855,192.43187921142578,186.49405947875977,181.69499969482422,176.89593991088867,170.95812017822266,0.06,0.0,232.38225615644055,-0.13878154097656004,-0.13442363183673284,178.09117562430245,185.48526981898718,10.825801962648656
2022-06-16,0,162.31999969482422,164.46749877929688,196.9375,181.78874969482422,193.92374801635742,-1.2078202097073567,9.936341742494465,0.05878107847549119,2.994294453509253,192.66250038146973,8.206187229156493,0.05302192434362531,168.14175033569336,195.04300231933593,0.7257313901864352,-0.14292813644495433,0.8661657344643254,0.8814314052540028,0.9328306758063488,-0.1472662446406311,28.3758438470873,207.2733081416662,187.40062465667725,167.5279411716883,175.6139281136649,13.546506571241016,184.5521422794887,13.075472443456569,176.4789525234442,182.09903827439842,-13.039711908001944,-7.72427950049297,26944100,5.592745934024922,0.9661416028302853,-601195500.0,-97.02971579155242,70.74152269624075,78.01649708558223,-163.28387758067788,15.856473031488019,34.68000703710288,-0.014957375252904753,9.62214499983601,192.01887921142577,185.82555947875977,180.81999969482422,175.81443991088867,169.62112017822267,0.08,0.0,231.95096984247348,-0.1257065148067189,-0.18190606141002127,173.13279506138392,183.29263305664062,12.208885402634706
2022-06-17,0,162.80499649047852,162.31999969482422,196.9375,180.09937477111816,193.6543731689453,-1.0032011553767117,11.109604226182805,-0.5161416348873584,2.9939042112417686,192.1324977874756,9.527774810791016,0.059823695579666186,167.52524795532227,194.57275009155273,0.7497616332677439,-0.15390027423387656,0.876682584780203,0.8995372452615289,0.9667669026076685,-0.09140125852168857,25.603895680485067,207.9249579640844,185.70574951171875,163.4865410593531,170.73785618373327,10.3600877633248,182.4021418435233,14.035769643593833,172.90783562249703,179.17654652204263,-16.28674491445664,-13.383138541539061,31374200,5.642628693516814,1.1111921775742772,-569821300.0,-90.26401447174983,70.74152269624075,78.01649708558223,-129.69763247110953,15.756233731505448,33.09261110891088,0.01835874905341512,9.363410274841899,192.01887921142577,185.82555947875977,180.81999969482422,175.81443991088867,169.62112017822267,0.08,0.0,231.4647517123717,-0.06738053186745818,-0.1101086555932223,168.4424329485212,181.05508749825614,13.038767336537484
2022-06-21,1,161.67749786376953,162.31999969482422,196.9375,176.4300022125244,193.6543731689453,-0.7680629893228291,12.068666377901954,-1.02825512826811,2.9935479571551675,191.3862476348877,10.656250076293947,0.06550024850448287,164.30124855041504,194.57275009155273,0.7948947767621697,-0.15894562552965757,0.8774719555634016,0.9086106563741295,0.979115942665723,-0.03685997723612078,25.705891645826487,208.3910822217463,184.25374946594238,160.11641671013845,166.64142772129603,6.1084556467133435,180.05517741612024,14.587207303135543,170.35862736992635,177.01637939900434,-17.33164253101694,-15.603538373168531,50724900,5.611332753544694,1.737291843514306,-620546200.0,-97.6552282060354,70.74152269624075,78.01649708558223,-126.4962852534407,14.364828823453319,33.113865049689515,-0.06017407556707762,9.536743904653719,191.15983935546876,184.43507971191406,179.0,173.56492028808594,166.84016064453124,0.1,0.0,230.660026973724,-0.0438937762144872,-0.1054850137948332,164.60032871791296,178.4468754359654,14.146696905832904
2022-06-22,1,157.6150016784668,161.67749786376953,196.9375,168.09562492370605,193.51749897003174,-0.5586773114770367,12.816079092848602,-1.353251166682067,2.993235132515722,188.8762493133545,11.478600215911865,0.07016396198340145,162.7564968109131,194.57275009155273,0.8115813769744044,-0.17051243011493283,0.8628920675085866,0.9018527572726873,0.9617209440594717,-0.041664749276850266,24.46765796861208,208.2911576287514,182.6589994430542,157.026841257357,163.56035614013672,3.6884091427608,177.56910623822893,15.267791679586201,168.16664953370196,175.2286047799794,-15.064157115769984,-16.890277846873364,47267800,5.569738628947733,1.5595757109935737,-667814000.0,-99.11997489947015,70.74152269624075,78.01649708558223,-123.55337800525886,13.77056795474996,32.15379740274408,-0.15440845216083895,9.237680066351482,191.03475964355468,184.23262017822265,178.73500061035156,173.23738104248048,166.43524157714845,0.12000000000000001,0.0,229.8961262555137,-0.04812795871277764,-0.05119927483045261,161.7889622279576,176.10953521728516,14.905397157735278
2022-06-23,1,157.25500106811523,157.6150016784668,196.9375,167.01562309265137,193.31312370300293,-0.40420874492497455,13.587744442576867,-1.4879812122170852,2.992875282934657,184.82500076293945,12.263712520599364,0.07515589617045466,162.25574951171876,194.0489990234375,0.8658087316345155,-0.12632686042536334,0.8698015025603943,0.918870288431923,0.9676159057877792,-0.06491845874095492,24.157412025311135,207.96961329769036,180.79412441253663,153.6186355273829,162.0446423121861,3.802893972230277,174.94482067653112,15.384326910039062,165.49750737130046,173.335784697836,-12.036611129725188,-18.088034934871803,40499200,4.736493404755018,1.3584518843609246,-708313200.0,-90.58183316247832,70.74152269624075,78.01649708558223,-105.80831807727006,13.167489261384457,31.693190878449226,-0.1446846744685609,8.970694589004959,190.7539190673828,183.77803924560547,178.13999938964844,172.5019595336914,165.52607971191406,0.14,0.0,229.2561434949285,-0.0625922622750471,-0.03041583817417001,161.00343540736608,173.2504108973912,15.651986172053663
2022-06-24,0,165.86000061035156,157.25500106811523,196.9375,164.05187320709229,193.31312370300293,-0.304107221656436,14.52528617635402,-1.6323876345750845,2.9924313204050326,184.82500076293945,13.536962394714356,0.08085926917521565,161.27124824523926,194.0489990234375,0.8864746053962779,-0.13714677054532107,0.9233083790518619,0.9921562542357952,1.0344623351387665,0.021808778475744584,23.013519657199442,208.68719687968553,179.63662452697753,150.58605217426953,162.24357114519393,3.9829162704208447,172.98571368626185,14.59492644257038,163.45590994764325,172.06642201884344,-6.320553379606162,-18.93863144207631,68736000,4.687233599351131,2.1582483071962018,-639577200.0,-66.70154024992735,70.74152269624075,78.01649708558223,-53.78967278893759,20.18127476265565,28.84832039407702,-0.05044303134119211,9.151364495360449,190.7539190673828,183.77803924560547,178.13999938964844,172.5019595336914,165.52607971191406,0.14,0.0,228.33835180148515,0.057748502160789084,0.004782966625682278,161.92012459891183,171.78057425362724,15.732999184565552
2022-06-27,0,170.1425018310547,157.25500106811523,196.9375,164.05187320709229,193.31312370300293,-0.16102153674188083,14.814203996970518,-1.7526480581945958,2.9922803098735065,183.29125213623047,14.131662635803224,0.08284555538866918,161.27124824523926,194.0489990234375,0.9157718060329669,-0.1149413059772723,0.9514888590904991,1.0329069711331222,1.0565068371062616,0.04506928840482671,36.416361476738444,208.44553255143612,178.8171245574951,149.1887165635541,162.52499989100866,4.506813702745374,171.3251781463623,13.36557027736941,164.0803695796762,171.89628597671896,0.8466729544682389,-14.190000946927123,29174600,4.991669567602687,0.9073409476377012,-610402600.0,-68.10379681347423,70.74152269624075,78.01649708558223,-37.973251177345794,20.788604115731733,27.969028640866913,-0.08713704003621313,8.764828453983862,190.7539190673828,183.77803924560547,178.13999938964844,172.5019595336914,165.52607971191406,0.14,0.0,227.9726486914452,0.035116626337128976,0.05358365563631981,161.94008309500558,170.015629359654,15.533612844108358
2022-06-28,0,165.62249755859375,157.25500106811523,196.9375,164.05187320709229,193.31312370300293,-0.006406111126466465,14.79172917356684,-1.7667276932777063,2.9922721615287164,174.66250228881836,14.136249923706055,0.08312096625441623,161.27124824523926,194.0489990234375,0.9119700624073456,-0.11799849903761975,0.9307026831684708,1.0110152603096834,1.0191526486773266,0.024400425210367338,40.84899687490132,207.53770791988757,177.9542495727539,148.37079122562022,162.99678530011857,4.652286443639598,169.30535670689173,11.727950445082481,165.61001488132547,172.26066587913894,1.171416975756062,-12.021044331125902,27744500,4.912941023167032,0.8559670959639861,-638147100.0,-86.54250138121105,70.74152269624075,78.01649708558223,-58.27593505666462,19.005480060630042,31.507594327777777,-0.16096590379648887,8.902344316786087,190.7539190673828,183.77803924560547,178.13999938964844,172.5019595336914,165.52607971191406,0.14,0.0,227.59631231055664,0.02311357778482659,-0.018688265481878134,161.91299438476562,167.52289472307478,15.36463001734575
2022-06-29,0,163.5400047302246,157.25500106811523,196.9375,164.05187320709229,193.31312370300293,0.1906281687406108,14.606908257172792,-1.7137862486852797,2.9923242841379336,169.15750122070312,13.868887348175047,0.08271645038667137,161.27124824523926,194.0489990234375,0.8891608108269151,-0.14862365287221593,0.9260993804668354,0.9996714734613579,1.0014758460253737,0.03759161874606809,36.031986422460335,205.80394083532946,176.59012432098388,147.3763078066383,163.10178647722518,4.655529733435673,166.9198213304792,8.674080378409442,165.60634774797643,171.69322990537495,2.0345600480399924,-14.58354847157237,28595200,4.918546861279282,0.8788720273541051,-666742300.0,-78.56194005388514,70.74152269624075,78.01649708558223,-56.3851471591533,18.067209141715388,30.190325324846672,-0.13462494080273396,8.695743109550865,188.78279766845702,182.18359811401368,176.8499984741211,171.5163988342285,164.91719927978517,0.14,0.0,227.2090264285198,0.051908888984816715,0.04387137312996321,161.9415065220424,165.19196973528182,14.960673541439036
2022-06-30,1,161.77999877929688,157.25500106811523,196.9375,163.3562526702881,192.63687324523926,0.39420237173517964,14.260939580244436,-1.574291575410937,2.9924438549567958,168.01874923706055,13.314199600219728,0.08147228669771038,161.27124824523926,193.90949783325195,0.8847175699538515,-0.15008831573402254,0.9242439019067908,0.9894740617361508,0.9835606967163556,0.02877490496611701,34.67973367213137,203.56225372561337,175.04037456512452,146.51849540463567,163.11642946515764,4.650461739399788,164.87892859322685,5.527064829156437,165.09762522524517,170.78255058111847,0.4514654068304838,-16.958423494649516,35250600,4.9183458285223844,1.0857160545103341,-701992900.0,-75.73657359071755,70.74152269624075,78.01649708558223,-61.13992838278032,17.050589080406844,30.019328765432107,-0.1165940007849119,8.556043466651168,176.29140466308593,172.07930377197263,168.6750030517578,165.27070233154296,161.05860144042967,0.14,0.0,226.7241408293032,0.0157480299792776,0.03464873381707159,162.54027666364397,163.57030269077845,14.814405966058514
2022-07-01,1,158.98999786376953,157.25500106811523,196.9375,162.68374729156494,191.08624744415283,0.6119632674822922,13.954092097783791,-1.3279524102488456,2.9925458222922217,166.86249923706055,12.648637218475344,0.08042316188082294,161.27124824523926,193.90949783325195,0.8637271979632772,-0.16606098265398672,0.9163246340949976,0.9762267557236579,0.9613093808477126,-0.04142049150669824,32.53003386444483,201.4165587912097,173.5083745956421,145.6001904000745,163.31285749162947,4.401749815308353,163.4366068158831,3.9035779955779626,164.3081435349631,169.79660901453855,0.06339838065388151,-15.010309166786657,31423900,4.8639683869032515,0.9686411300191546,-733416800.0,-68.46700380845351,70.74152269624075,78.01649708558223,-74.24973464677325,16.143458873903477,31.393052010233397,-0.11216308844024603,8.391322781715111,168.25412139892578,165.57794113159179,163.41500091552734,161.2520606994629,158.5758804321289,0.14,0.0,226.27754989050968,-0.05953227217068746,0.008062890410358578,163.13619341169084,162.46257781982422,13.719905613239751
2022-07-05,0,162.9000015258789,157.25500106811523,196.9375,162.18499946594238,181.97500133514404,0.8349443399851055,13.461329255898082,-0.9374015208174025,2.9927219383482946,165.74124908447266,11.650124816894527,0.07837375548769376,158.85249824523925,193.44099922180175,0.8430045347535415,-0.1774429328389471,0.9484267597823057,1.0022842215842755,0.9932018496742878,-0.042567261132478995,30.393939870594547,198.68078305403247,171.75812454223632,144.83546603044016,164.11928612845284,3.5396078925007934,163.08196422031946,3.6900018131568535,163.03076280069388,168.39143369728745,0.872376468394623,-11.269239224418456,28618600,4.863932821591317,0.8698953460450045,-704798200.0,-22.16638977635783,70.74152269624075,78.01649708558223,-36.491340214339274,20.978346171386253,28.462878629426445,-0.0466523151503675,8.594088900698782,167.93324279785156,165.3183822631836,163.2050018310547,161.09162139892578,158.4767608642578,0.02,1.0,225.91109574921967,-0.00767006124898717,-0.011577324542758087,164.48199898856026,162.74271719796317,12.89712108005702
2022-07-06,0,168.75500106811523,157.25500106811523,196.9375,162.18499946594238,172.40250205993652,1.1075790847258464,12.635129816604541,-0.3062817844778003,2.993047100872217,165.0449981689453,10.256874847412103,0.07422005764994577,158.85249824523925,193.44099922180175,0.8251565676549278,-0.15766067511245654,0.9912843073074209,1.0382479244346479,1.0380675045170888,0.01891351450254075,37.007013957520535,195.50900932803327,170.2387496948242,144.96849006161514,164.53285762241907,3.9250354696038467,163.3882143838065,3.980336927560651,163.03910679461782,167.34236140947073,3.5897112456973828,-2.9577317493668076,23085900,5.014503767436173,0.7098006317394419,-681712300.0,-13.344494142705004,70.74152269624075,78.01649708558223,0.6399729834007989,22.72124582137821,26.982390161992,-0.050316262360365634,8.418078774187459,167.93324279785156,165.3183822631836,163.2050018310547,161.09162139892578,158.4767608642578,0.04,0.0,225.6398421537512,0.0565721125742229,0.0016519743312489999,164.42639814104353,163.17326136997767,11.537054080570725
2022-07-07,1,170.5349998474121,157.25500106811523,196.9375,162.18499946594238,169.1018762588501,1.394316645181309,11.464744000824979,0.6723023597769648,2.993497980133258,165.0449981689453,8.54800004959107,0.06783591221567059,158.85249824523925,190.70724716186524,0.77548107222767,-0.12968023176833884,1.009041046055281,1.0446503996793042,1.0449896687863922,0.04277237932533051,45.26701461335055,191.93648778039753,169.00699977874757,146.0775117770976,164.588928767613,4.020178602048077,163.55696432931083,4.240360497079742,164.47488299608187,166.98769933742832,1.745448237736827,2.6068994303682262,24083400,5.268734193168954,0.734536200385394,-657628900.0,-2.869511338758313,70.74152269624075,78.01649708558223,31.126638997418528,22.727868691543353,25.8169672828886,-0.03975335853419773,8.16964077209286,168.3610809326172,165.66446075439453,163.48500061035156,161.3055404663086,158.60892028808593,0.06,0.0,225.3692780809698,0.0503232670881637,0.0716331156698398,164.81132071358817,163.37570190429688,9.67529419929478
2022-07-08,1,170.35249710083008,157.25500106811523,196.9375,162.18499946594238,169.1018762588501,1.699471210010741,9.960382477535743,2.2100120043536675,2.994025623735669,165.0449981689453,6.923250198364258,0.05934495153429845,158.85249824523925,180.29950218200685,0.6450284399410094,-0.13406537684589218,1.0149771564491812,1.0353383206024978,1.0349986468986583,0.05298861655468268,46.630827178551996,187.75951484063057,167.83874988555908,147.9179849304876,165.2646429879325,4.58121787823882,164.13071414402552,4.589193687608026,165.98848465603203,166.9269713567539,0.23068781294115337,1.4048071048990083,19249200,5.2212217544079635,0.5898091451487177,-676878100.0,-9.962080218100706,70.74152269624075,78.01649708558223,52.48888251345315,21.853352910383883,24.82359013798436,-0.0173938095695251,7.889662268077896,168.3610809326172,165.66446075439453,163.48500061035156,161.3055404663086,158.60892028808593,0.06,0.0,225.15328655526267,0.05972088588204305,0.042332548245238105,166.2654767717634,164.08923557826452,6.881591747643554
2022-07-11,1,164.83750534057617,157.25500106811523,190.35249710083008,162.18499946594238,169.1018762588501,1.6276596954677314,7.444554821673978,2.9947804172179877,2.9947551930146563,165.0449981689453,5.32815002441406,0.04470949004874553,158.85249824523925,171.3997501373291,0.506247002910205,-0.10506823028124482,0.9899585645105586,0.9939086014105173,0.9911669469010076,0.036779090228160616,48.42052460260736,181.39860938394852,166.50949974060057,151.62039009725262,165.4500002179827,4.525721154653807,164.27589334760393,4.5761592193708776,167.03972193161144,166.69857540016815,2.8558919301183425,4.948556814383721,21885600,5.079729797214367,0.6722546591177164,-698763700.0,-53.27555867652526,70.74152269624075,78.01649708558223,-16.188207419995532,20.09582200650076,28.42187480073893,-0.004733783489259508,7.966830401616062,168.3610809326172,165.66446075439453,163.48500061035156,161.3055404663086,158.60892028808593,0.06,0.0,224.88133820436454,0.01780920290404797,0.010108468521124911,166.1143580845424,164.0279323032924,5.44858602807302
2022-07-12,1,164.02000427246094,157.25500106811523,179.18250274658203,162.18499946594238,168.31812572479248,0.724173844454765,5.050664470075678,0.8095515100795168,2.9952682881851107,164.65250205993652,3.9383747863769543,0.030566784724135092,158.85249824523925,170.3707473754883,0.40051739741089043,-0.08005802567840009,0.9926543706778663,0.9895894833570942,0.9793642272089766,0.006875400467102555,44.81214627232651,175.33507909273925,165.2337501525879,155.13242121243655,165.77000100272042,4.29635671522413,164.44321523393904,4.516277391074873,166.44566018251578,165.87600063491897,0.7933842318837632,1.2484314940644499,16639700,4.623384282097945,0.5197475618042999,-715403400.0,-51.164029906233225,70.74152269624075,78.01649708558223,-12.372685051641078,19.382775691950894,27.41340084666485,0.022194931980891317,7.669909963100083,168.3610809326172,165.66446075439453,163.48500061035156,161.3055404663086,158.60892028808593,0.06,0.0,224.67506552370247,-0.02925264020678009,0.020246281894758928,166.40233721051897,164.47130693708147,4.847985735297558
2022-07-13,1,162.06000137329102,157.25500106811523,170.5349998474121,162.18499946594238,167.94187355041504,-0.12220884390344487,3.9089298018759373,-0.8109745536822186,2.995449529884539,164.2437515258789,3.1861874771118153,0.023766012723382746,158.85249824523925,170.16350135803222,0.5071146242356123,-0.02290527292907715,0.9853131802829187,0.9813892755070586,0.9663685146018466,-0.03967289652128225,47.48403330121739,172.29348483263368,164.47562522888182,156.65776562512997,166.20857293265206,3.5870443605848865,164.76071521214075,4.139879409159534,165.8196591706497,165.35007336005748,1.3845997713350942,1.4488759658225394,16555100,3.8985336008413687,0.5296741299982994,-731958500.0,-49.97290263951423,70.74152269624075,78.01649708558223,-30.967798567086778,18.392217627591034,28.382120846844035,0.0825792857021074,7.505628375413635,168.3610809326172,165.66446075439453,163.48500061035156,161.3055404663086,158.60892028808593,0.06,0.0,224.46764909734628,-0.03699112780695346,-0.02794453693016734,166.89561244419642,165.01590292794364,4.85149965298183
2022-07-14,1,159.7849998474121,157.25500106811523,170.5349998474121,161.99000072479248,166.43812561035156,0.053117240335556745,3.8617168232583268,-0.7419167061572862,2.995455724869651,163.78000450134277,3.107662410736083,0.023520467725871685,158.85249824523925,170.16350135803222,0.5197998485610255,-0.014638134731023917,0.9731987362083347,0.969704501801124,0.9604714946605658,-0.0630369133000186,45.78298425288975,171.90880905087454,164.1853754043579,156.46194175784126,165.7635726928711,4.205765752763103,164.94142941066198,3.830712041346204,164.88118500401697,164.79143470740652,1.9309412861002833,2.8201628318933616,23765200,3.8494318164950228,0.7646140927181295,-755723700.0,-82.7877943473596,70.74152269624075,78.01649708558223,-92.16781909372156,17.291682085783567,28.928911373776323,0.061183842031044426,7.413082947927727,168.5380809326172,165.95096075439454,163.86000061035156,161.76904046630858,159.18192028808593,0.02,1.0,224.1561222742081,-0.08211853090289378,-0.06903450617523009,165.45001220703125,164.96600559779577,5.0467671329742485
2022-07-15,1,162.5099983215332,157.25500106811523,170.5349998474121,161.75437355041504,166.43812561035156,0.1576757785571191,3.9777164183225255,-0.9028132070196286,2.9954382762930662,163.22000312805176,3.273625411987305,0.024261580239348313,158.85249824523925,170.16350135803222,0.5125929356227943,-0.04987438928777619,0.9912092641428083,0.988494616093555,0.989641356249322,-0.04603688770499781,40.77840122540875,171.90668329440874,163.95125045776368,155.99581762111862,164.87142944335938,4.127074404158405,164.70214353288924,3.873311915406145,163.58920410106907,163.93315573323704,-1.9122170959414853,1.608851077620738,23342800,3.7668595653770445,0.7591642064815545,-732380900.0,-45.25961467254744,70.74152269624075,78.01649708558223,-10.37013465498081,18.445310894061222,26.988165257968156,0.08041420007211283,7.3785761456926044,168.5380809326172,165.95096075439454,163.86000061035156,161.76904046630858,159.18192028808593,0.02,0.0,223.8710602143839,-0.03616573844295712,-0.04349846050731066,164.72721208844865,164.5768051147461,4.892409539150162
2022-07-18,1,167.82749938964844,157.25500106811523,170.5349998474121,161.75437355041504,165.6818733215332,0.32399994228228457,3.8671670273778815,-0.6598521626144302,2.995453781934593,162.8524990081787,3.0780004882812477,0.023628101191150185,158.85249824523925,170.16350135803222,0.5826965896498671,0.001170518895183578,1.0254134642136377,1.020386131103269,1.031879720861523,0.018139039673614077,48.168673959931894,171.40245939807852,163.66812534332274,155.93379128856697,164.48464366367884,3.60119322713336,164.53678621564592,3.6671161982407083,163.27917438776063,163.41111364310692,-3.700632696545293,-2.019777086995429,23574300,3.601680740268388,0.770917543383181,-708806600.0,-30.981970174752732,70.74152269624075,78.01649708558223,86.39173429003358,23.712681963624522,25.15504420856322,0.08633142137005702,7.350820834516531,168.5380809326172,165.95096075439454,163.86000061035156,161.76904046630858,159.18192028808593,0.02,0.0,223.60944750528054,0.02670678076824906,-0.021360031911735203,164.0200936453683,164.41570717947823,4.901225466542438
2022-07-19,0,173.0374984741211,157.25500106811523,170.5349998474121,161.75437355041504,166.35187530517578,0.15349329074276108,3.9564247648695234,-0.8754114727159128,2.99544137583939,163.22000312805176,3.24610040664673,0.024132855263870802,158.85249824523925,170.16350135803222,0.5354107894719434,0.030849808098264712,1.055470318297824,1.0464400634854836,1.0600157301330841,0.054978014673629616,56.38127168452611,171.85634985780302,163.94350032806398,156.03065079832493,164.8682152884347,4.387506639392874,165.0664291381836,4.314347020508872,164.40906695128564,163.85914303480322,-1.5876508987517137,-1.3606256029460313,25933700,3.791852865200812,0.8556856039971611,-682872900.0,-3.303892658813138,70.74152269624075,78.01649708558223,165.79506623697048,26.1971430468928,22.932792092851077,0.10669359714485192,7.487192679514431,171.41836419677733,168.28082339477538,165.74500274658203,163.20918209838868,160.07164129638673,0.02,1.0,223.35399032554344,0.07662154012129485,0.0791994414891445,164.71865844726562,165.49206760951452,5.550845559745259
2022-07-20,0,180.22000122070312,157.25500106811523,173.0374984741211,161.75437355041504,168.05937480926514,0.20008411779194163,4.411549301841069,-0.8966236375567007,2.995373030089893,163.78000450134277,3.6873872375488275,0.026825246646342508,158.85249824523925,170.3707473754883,0.5096056165178479,0.07026333757294766,1.0958612615599586,1.0832351638211408,1.0919512480744902,0.11205726085107304,63.23983291909189,173.27822403092821,164.4551254272461,155.63202682356396,167.06571469988143,7.2729481600246295,166.25785745893205,5.8795893888030175,166.56544302082602,165.1045098865278,1.5761444175965251,4.477049328944018,24784300,3.9309381965600956,0.8543223000791438,-658088600.0,-1.7832505481956917,70.74152269624075,78.01649708558223,225.00566246042894,31.01050921009158,21.227322938733405,0.21927348559814688,7.510965349524212,176.85040466308592,172.67480377197265,169.3000030517578,165.92520233154295,161.74960144042967,0.04,0.0,223.14752134202377,0.11988486518926478,0.12139393451281687,167.5998796735491,166.85711887904577,6.613954973189991
2022-07-21,0,181.63000106811523,157.25500106811523,180.22000122070312,161.99000072479248,169.1018762588501,0.7553397188378193,5.535612961615618,0.45918689000890467,2.995176470422745,164.42875480651855,4.391224174499513,0.03347162674166602,158.85249824523925,170.785249710083,0.4974720462797119,0.1434190863909663,1.0982436169211531,1.084238460263276,1.0767981316821487,0.13671496849869613,71.60803217642395,176.453476518324,165.38225059509278,154.31102467186156,169.58142852783203,8.906131058524252,167.67571476527624,7.002810084104419,169.98728096295451,167.20526967299767,9.331914996131902,10.199337170127773,27195800,4.02999139453967,0.9710399730351971,-630892800.0,-2.3570460683106056,70.74152269624075,78.01649708558223,196.52399471205254,29.749249618799823,20.197207069533327,0.3338756123919395,7.330181515277569,177.04140466308593,172.82930377197263,169.4250030517578,166.02070233154296,161.80860144042967,0.06,0.0,222.9277215883445,0.15893691270077448,0.12037417971778186,170.43690490722656,168.41962105887276,7.2033453998911146
2022-07-22,0,171.58750534057617,157.25500106811523,181.63000106811523,162.39749908447266,170.19500064849854,0.8998753172006438,6.275681027317553,0.3135205948410218,2.995030129795611,165.23000144958496,4.9835995483398445,0.03767299788122625,159.70549964904785,173.7557487487793,0.5869203024093137,0.15500301951886372,1.0300421096933057,1.017550493918326,0.9915773679862555,0.055858144808313304,72.840658859732,179.1343626192103,166.5830005645752,154.0316385099401,170.9425005231585,8.270428057160341,168.57553672790527,6.598580566900064,172.92713576298178,169.39776115672385,10.736493316023543,12.269750549261706,42583900,4.013514815480103,1.5148420829269846,-673476700.0,-54.34215742087236,70.74152269624075,78.01649708558223,49.24519445329522,25.7593153200681,26.9930037415916,0.2291747213450544,7.860886204248206,177.51812567138668,173.6009454040527,170.43500518798828,167.26906497192383,163.35188470458985,0.06,0.0,222.4981416507447,0.02774748218563472,0.07099018992864664,171.26092529296875,169.0782688685826,6.922083721888122
2022-07-25,0,167.75749969482422,158.98999786376953,181.63000106811523,162.80250072479248,170.3981227874756,0.8973453070717097,5.9809945102956075,0.22869830434698724,2.9950996453461993,165.74124908447266,4.8390873336792,0.035750196585765615,161.5804988861084,173.7557487487793,0.7312218764355577,0.034532163928300066,1.0027368496163465,0.9941096715502314,0.9593790400966422,-0.0004170931169134029,54.43344340947602,179.26161479878945,167.29962577819825,155.33763675760704,172.08142907278878,6.915853559648986,168.92250088282995,6.401974205623799,172.61383877746206,170.04743495363408,5.8789978320062986,7.923459114453732,26166300,4.3673877666374,1.0070689533738502,-699643000.0,-64.73469125224256,70.74152269624075,78.01649708558223,-1.5432472597499742,24.384856777239786,28.887576393509953,0.10015244776246968,7.710822613979843,177.579484375,173.70026330566404,170.56500244140625,167.42974157714843,163.5505205078125,0.06,0.0,222.2186940874939,-0.0034682836690862473,0.01183969689306479,172.48697553362166,168.96849387032645,6.905658526625521
2022-07-26,1,162.2599983215332,158.98999786376953,181.63000106811523,162.80250072479248,170.3981227874756,0.8542649940209412,5.972449285697509,0.19125345162331442,2.9951018330610353,166.68999862670898,4.789999771118164,0.0356788858628301,161.5804988861084,173.7557487487793,0.7419786678731618,-0.014017674070636912,0.9693269349445588,0.9598712606955683,0.9280139850974718,-0.06228418838474914,48.41444907786524,179.3393993038169,167.39450073242188,155.44960216102686,172.0457147870745,6.97392129717632,168.45857211521692,6.645740243856793,171.38204635804158,169.77808895425252,4.98951707295773,2.9818895785422272,28468400,4.353847243503336,1.097161479489982,-728111400.0,-92.96200752085232,70.74152269624075,78.01649708558223,-78.64193726634583,22.437471807341495,32.87764532814247,0.07351035313793954,7.781478355316437,177.579484375,173.70026330566404,170.56500244140625,167.42974157714843,163.5505205078125,0.02,1.0,221.8832672405404,-0.09460692289184669,-0.04831669426384118,171.69574410574776,168.21147809709822,7.146447170908331
2022-07-27,0,166.26499938964844,158.98999786376953,181.63000106811523,162.4474983215332,170.3981227874756,0.9874567441220089,6.037830410400027,0.311503064950752,2.995086021071122,165.23000144958496,4.869912319183351,0.036154591810131434,161.5804988861084,173.7557487487793,0.7293782534191634,-0.020302188933426543,0.9955965597990729,0.9845885033483404,0.9627890179714916,-0.07743314691228387,43.57309566037244,179.07603637774588,167.0003755569458,154.92471473614575,171.82250050136022,7.154113345956815,168.15357208251953,6.641096312129391,169.0672178265364,168.52902248313768,-0.15383668856199478,-3.8487764543110803,43846600,4.410872454324706,1.6389766535183259,-684264800.0,-53.70718983375558,70.74152269624075,78.01649708558223,4.085012658471956,24.422190889375724,29.46401300477297,0.18053200284013646,8.062803013392635,177.579484375,173.70026330566404,170.56500244140625,167.42974157714843,163.5505205078125,0.02,0.0,221.42784241242506,-0.07378879522687565,-0.03527136658126523,172.03077043805803,168.02543204171317,6.996331239316275
2022-07-28,1,159.5349998474121,158.98999786376953,181.63000106811523,162.4474983215332,170.3981227874756,0.9747917893661688,6.032120320393021,0.3029988015485725,2.995087384727199,165.5512523651123,4.840999736785889,0.03611345275304806,161.5804988861084,173.7557487487793,0.7287831322448024,0.016662557053969615,0.9551135211891242,0.9423881181581341,0.9389935204886223,-0.12164841210575672,49.178346788500065,179.0967412892846,167.03250064849854,154.96826000771247,169.89357212611608,8.47102046302563,167.3808937072754,6.98592074700333,168.3484846848027,167.97129700515075,-0.9310154805871907,-2.503885103693844,73214300,4.481351008933291,2.5260787389186494,-757479100.0,-79.75863752693964,70.74152269624075,78.01649708558223,-102.04274416966149,21.412978967266632,31.83126418500422,0.2528800802081596,8.539033573567904,177.0060061035156,172.7720061035156,169.35000610351562,165.9280061035156,161.69400610351562,0.04,0.0,220.56745391585721,-0.12256366254296569,-0.12218028174989283,169.88375418526786,167.30120631626673,7.1210856291647415
2022-07-29,1,158.0250015258789,158.98999786376953,181.63000106811523,162.20999908447266,170.3981227874756,0.911636117585328,6.208633096388979,0.15578962176928624,2.995047148081147,165.5512523651123,5.0212249565124525,0.0372148255588525,159.7599998474121,173.7557487487793,0.673822083156273,-0.01387686332565395,0.94720895476065,0.9336062897748415,0.9549434740571748,-0.07904132522806762,42.6445114921561,179.24951659713588,166.83225040435792,154.41498421157996,166.72285788399833,8.107639964061653,166.89428629193986,7.401606021861684,166.15205396157208,166.4951460083255,-7.8032211201483435,-6.350066736629749,42065400,4.723337691141106,1.4344982901447683,-799544500.0,-85.34482758620689,70.74152269624075,78.01649708558223,-107.57302175629432,20.39337270737825,30.315578008279132,0.302528702953405,8.325530348882722,177.0060061035156,172.7720061035156,169.35000610351562,165.9280061035156,161.69400610351562,0.04,0.0,220.07676884552276,-0.060081495646549854,-0.1314078562317257,166.46364266531808,167.0317611694336,7.234726781492696
2022-08-01,1,159.39999771118164,158.0250015258789,181.63000106811523,162.20999908447266,170.3981227874756,0.810365042856839,6.412019512670758,0.022507621224177043,2.994999186896785,165.5512523651123,5.190199832916261,0.038477234423147114,159.48049964904786,173.7557487487793,0.6646294656857789,-0.006069541171498608,0.9565272012760293,0.9442316703112728,0.9793049512053608,-0.04981894698505951,41.857783783159405,179.46853956702856,166.64450054168702,153.8204615163455,163.5471431187221,5.086062131407227,166.56428582327706,7.638804235918395,164.13638639358342,165.09808257454986,-12.315503021023465,-4.132860298159529,40596700,4.69378481847106,1.363093950997154,-758947800.0,-82.48280492322196,70.74152269624075,78.01649708558223,-85.16372757924287,22.947553877080136,27.760879166225774,0.25235929977951926,8.442279191057102,177.0060061035156,172.7720061035156,169.35000610351562,165.9280061035156,161.69400610351562,0.04,0.0,219.62538050498983,-0.04032405382534843,-0.05517820736676564,163.15045166015625,166.7936782836914,7.240069355166354
2022-08-02,1,159.6875,158.0250015258789,181.63000106811523,162.20999908447266,170.3981227874756,0.8229605391707008,6.388125271308561,0.03698628750517363,2.99500490987383,165.5512523651123,5.171749839782715,0.03832913479637953,159.52149963378906,173.7557487487793,0.710714803745154,-0.02148559718792416,0.9581345782755883,0.9506806933510783,0.991250616928074,-0.015854174461628956,42.43621546656255,179.44125107667475,166.6650005340576,153.88874999144048,161.84714235578264,3.7688983849069775,166.39482143947058,7.771579595801591,162.9847433522891,164.49862236647334,-12.239169314653505,-2.8167335940345413,27374500,4.614664620388028,0.9210628805552251,-731573300.0,-81.58621952451507,70.74152269624075,78.01649708558223,-78.80771702208983,22.0959208202744,26.73061326030013,0.2066711938689766,8.141401621467807,177.0060061035156,172.7720061035156,169.35000610351562,165.9280061035156,161.69400610351562,0.04,0.0,219.32497633025937,0.006534747731817614,-0.038763844279251544,161.85596793038505,166.55844661167689,7.409777013243026
2022-08-03,1,165.6500015258789,158.0250015258789,181.63000106811523,161.4912509918213,170.3981227874756,0.7963634120619806,6.51980512556595,-0.06616606534824454,2.994973055401596,165.5512523651123,5.316312408447265,0.03915695973539024,159.52149963378906,173.7557487487793,0.7514642259021218,-0.05373174727103515,0.9948687598777157,0.9940784437786456,1.0315569993036922,-0.00369890154889585,40.69845508051602,179.5439857088956,166.50437545776367,153.46476520663174,161.54607118879045,3.269109901124747,166.81375013078963,7.542570670368466,162.18801215646357,164.05038580468687,-6.935240020511049,-1.4639647989550282,31721900,4.393335213726944,1.052053811385545,-699851400.0,-51.896562247440684,70.74152269624075,78.01649708558223,1.3065518641053835,26.639824592497146,24.56084298746603,0.23099600528497974,8.227729761291748,177.0060061035156,172.7720061035156,169.35000610351562,165.9280061035156,161.69400610351562,0.04,0.0,219.01840096078107,-0.004599576369756386,0.060634673130511935,162.16248212541853,167.3247288295201,7.393601979193523
2022-08-04,1,169.4550018310547,158.0250015258789,181.63000106811523,161.4912509918213,170.3981227874756,0.872645804276094,6.501306659344604,0.046597300090029936,2.9949766735651444,165.24375343322754,5.215449829101561,0.039082301398096465,159.52149963378906,173.7557487487793,0.7507231989664742,-0.028645136340951147,1.0186708306486654,1.0258824182570607,1.056060885782026,0.06218072518964868,48.74402520610212,179.35173879934106,166.34912548065185,153.34651216196264,162.5739288330078,4.449129687733654,167.30982181004114,7.465734810981106,163.0516386224324,164.44351065976775,-1.2562765734939805,3.6705583653456983,23938200,4.600806040552691,0.7940993385491072,-675913200.0,-45.79309923895469,70.74152269624075,78.01649708558223,42.04449648499685,27.694736722986562,23.390865101474358,0.2159303980006464,8.022176233861085,177.0060061035156,172.7720061035156,169.35000610351562,165.9280061035156,161.69400610351562,0.04,0.0,218.80340667461886,0.06128672769405563,0.005837989743574947,163.79056658063615,167.74315534319197,7.341571183485414
2022-08-05,1,167.87750244140625,158.0250015258789,181.63000106811523,161.4912509918213,169.67937564849854,0.9021062271339298,6.470727816407882,0.1281896746354847,2.994983520462682,165.24375343322754,5.150649948120116,0.03891110935360191,159.52149963378906,173.7557487487793,0.7346994933247172,-0.0052684597235118395,1.0095154735056417,1.0238789837918119,1.0334516426034452,0.06234773498112478,53.485792376310954,179.23658121264975,166.29512557983398,153.3536699470182,162.80428641183036,4.706395803166717,167.3133934565953,7.466013477043863,164.6257334191592,165.10640254294,4.434243549826692,4.27358536782487,25832700,4.689513452662488,0.8476888863949817,-701745900.0,-57.724156872979485,70.74152269624075,78.01649708558223,23.139783561963572,26.23325254200735,23.06478380371536,0.1813346796834198,7.864162937641674,177.0060061035156,172.7720061035156,169.35000610351562,165.9280061035156,161.69400610351562,0.04,0.0,218.56567047006172,0.050345609143563674,0.03975856184355457,163.43843296595983,167.73460170200892,7.280370865572411
2022-08-08,1,170.7224998474121,158.0250015258789,181.63000106811523,161.4912509918213,168.27187728881836,0.9716347424798247,6.415378953830922,0.3024714965643569,2.9949957556064537,165.24375343322754,5.011512622833251,0.0386070038906285,159.52149963378906,173.7557487487793,0.760281240154109,0.018442387213692905,1.0273881345529898,1.043591876757179,1.0383695982007375,0.07103200940282206,53.171287324344306,179.00213375452464,166.1713758468628,153.34061793920094,164.40250069754464,5.276217328511395,167.14803641183036,7.354284313414257,165.39699017962016,165.6354104454274,0.9698391469504952,0.029794313768400624,27299100,4.527509817401441,0.8879215754004439,-674446800.0,-46.89657277074348,70.74152269624075,78.01649708558223,61.07536677123121,29.04922622720502,20.93510619785363,0.1852489426042564,8.045294288500429,177.0060061035156,172.7720061035156,169.35000610351562,165.9280061035156,161.69400610351562,0.02,1.0,218.33392105053187,0.06452827706550823,0.07008161919065839,164.7970690046038,167.34041159493583,7.266787625363962
2022-08-09,1,168.4025001525879,158.0250015258789,181.63000106811523,161.4912509918213,169.77187633514404,0.8234182468851139,6.482066042353684,0.018830061108305873,2.994981682918057,165.95750045776367,5.192437915802003,0.038939366731554334,159.52149963378906,173.7557487487793,0.7492200217509013,0.04086389099110958,1.011635282501871,1.0275478179529691,1.0103432596991118,0.05457534342129411,56.886983891385015,179.429757656912,166.4656255722046,153.5014934874972,165.88500050136022,4.600247748104788,166.30392919267928,6.347826086158239,166.68939506238002,166.63609916286083,7.012567781803573,-1.3378595085591853,18655100,4.559641416873737,0.6047874072622405,-693101900.0,-52.827611462823235,70.74152269624075,78.01649708558223,15.991258659304114,28.069634800567925,20.718795608492428,0.20464857715950988,7.731343346183427,177.0060061035156,172.7720061035156,169.35000610351562,165.9280061035156,161.69400610351562,0.02,0.0,218.16539759982862,0.0520631386861663,0.05377354828705052,166.14144679478235,166.30254473005022,7.219721382479696
2022-08-10,0,177.18999862670898,158.0250015258789,181.63000106811523,161.4912509918213,169.77187633514404,0.7305251045265468,6.469751578075095,-0.0645924278436385,2.994985582948812,167.01124954223633,5.167000579833984,0.038814298031828794,159.52149963378906,173.7557487487793,0.7472026886913976,0.039136731615147184,1.0630246512498458,1.0771297501945842,1.0520628150602236,0.06966493808952512,54.11647828155018,179.62425352236113,166.68475036621095,153.74524721006077,168.4264292035784,5.283770411205163,165.98678616115026,5.588749419893398,167.0909359134153,167.1552107609539,6.566997960135768,-6.557263893058766,30262100,4.569948868147741,0.9597550859763221,-662839800.0,-8.349591322668944,70.74152269624075,78.01649708558223,120.49580774426099,34.823918763709834,18.51716142843658,0.2050512756172229,8.03267656121634,174.4313181762695,170.6893396911621,167.66500091552734,164.64066213989256,160.89868365478515,0.04,0.0,217.94525525499503,0.0565165590544241,0.11330294139853234,168.76605442592077,165.9582530430385,7.564649091967123
2022-08-11,0,179.1675033569336,158.0250015258789,181.63000106811523,161.64124870300293,170.93875122070312,0.5060716678913002,6.762691056683225,-0.5625685502502678,2.994921691207193,167.79249954223633,5.3853755569458,0.04038844100506323,159.52149963378906,177.4929988861084,0.6585569045265344,0.10892761395573997,1.0700320447441876,1.0819653006423253,1.0494232264983048,0.05731611000519288,64.11836629752158,180.9666323422483,167.44125022888184,153.9158681155154,171.20928682599748,5.038205584433285,166.52821459089006,6.47066032216942,169.63612221435906,168.8099124200137,11.160602993082355,-2.4445314184307865,24079100,4.893723423646183,0.7632828220711096,-638760700.0,-19.858409240182443,70.74152269624075,78.01649708558223,121.20411334692783,35.072542758162555,17.3960131792398,0.20623022238948563,7.939628786500043,176.4330061035156,172.3085061035156,168.97500610351562,165.6415061035156,161.51700610351563,0.06,0.0,217.7777940048442,0.040569843607918266,0.051481047059677126,171.23241533551897,166.54419163295202,7.46614844100798
2022-08-12,0,180.42000198364258,158.0250015258789,181.63000106811523,162.4474983215332,171.9500036239624,0.34375563731261005,6.98134147914075,-0.8350941929953222,2.9948765997733373,167.85250091552734,5.572700653076174,0.041454343073449945,159.52149963378906,179.27275314331055,0.6830159267330352,0.10250141657403,1.0713116786922967,1.076763093487815,1.0448712070221076,0.07471221193926203,65.25071783228407,182.37305836263943,168.41037540435792,154.44769244607642,173.3192868913923,5.401666591609834,167.4326790400914,7.464380117517058,172.0649420526481,170.41052934326166,12.198827933891879,4.417569916476279,21274000,4.882013377074283,0.6765824982858044,-617486700.0,-9.203561428373803,70.74152269624075,78.01649708558223,118.33396560026631,33.77349768334899,16.751685637957557,0.18217584044522553,7.6560832992169,176.4330061035156,172.3085061035156,168.97500610351562,165.6415061035156,161.51700610351563,0.06,0.0,217.63596544444778,0.08012691067338307,0.05821657233994337,172.9004167829241,167.5314494541713,7.815430096905189
2022-08-15,0,179.87250137329102,158.0250015258789,181.63000106811523,164.80250072479248,174.07562351226807,0.17844266335466008,7.30808061758668,-1.0314351070537933,2.9948024931054116,168.14000129699707,5.967713146209718,0.04316495568880199,159.52149963378906,180.24000129699706,0.7348464929224804,0.07503241506779457,1.062411453525539,1.0593369479261017,1.0267838061803807,0.053595756470629086,65.20718205409575,183.92203682263676,169.3058755874634,154.68971435229003,174.8075011117118,5.591309653691349,168.69071497235979,7.991129741894736,174.21119114252994,171.8061057482632,8.916390173082013,7.548099078642284,15878700,4.7705121582173975,0.511250689826373,-633365400.0,-7.8230326154589775,70.74152269624075,78.01649708558223,102.14169733521118,32.70871675700836,16.914430641658235,0.2193201010559573,7.340648487237275,176.4330061035156,172.3085061035156,168.97500610351562,165.6415061035156,161.51700610351563,0.06,0.0,217.5304843473848,0.0624963234049325,0.08246064555868457,174.3716779436384,169.08112226213728,8.168942981405456
2022-08-16,0,179.23500061035156,158.0250015258789,181.63000106811523,164.80250072479248,177.68437480926514,0.05104938666447672,7.649754005649712,-1.2316170605854138,2.994718913994548,168.9287509918213,6.467438011169435,0.04502288501350333,159.52149963378906,180.24000129699706,0.7765753144806863,0.03950012546091067,1.0548936366993253,1.0430069012889847,1.0125670482706517,0.06432505721677795,62.92322261436284,185.20763369794494,169.90812568664552,154.6086176753461,176.43000085013253,4.842981077335217,169.61714363098145,8.428149225922663,175.6555492349794,172.85106449405902,6.147649481968371,10.8544947824152,21156700,4.653468713839401,0.6864669956122206,-654522100.0,-12.849574806415841,70.74152269624075,78.01649708558223,85.42597306542336,31.408635011043593,17.409389706344378,0.19541334496160756,7.098459694579898,176.4330061035156,172.3085061035156,168.97500610351562,165.6415061035156,161.51700610351563,0.06,0.0,217.3870862382842,0.06491430151625832,0.05415567280544658,176.13377162388392,169.78610229492188,8.334825776464221
2022-08-17,0,175.97999954223633,158.0250015258789,181.63000106811523,164.80250072479248,179.1843776702881,0.008053330658455957,7.891932263717522,-1.3531065907342132,2.994656975198783,168.9287509918213,6.80830062866211,0.04636367615017176,159.52149963378906,180.24000129699706,0.7816148256294813,-0.005465545464874898,1.0338507015822076,1.0125475130218753,0.9821572990578418,-0.006828822697954817,59.57355935265227,186.0018653208921,170.21800079345704,154.43413626602197,177.18107223510742,4.171430014521758,170.79178646632604,8.052507506616683,176.57756536742932,173.43956969462357,6.765348545085357,7.800800690653736,20118100,4.368948149490236,0.6577470102705845,-674640200.0,-29.538122650472143,70.74152269624075,78.01649708558223,56.920814791404254,29.70268898108243,19.404984143088534,0.14075697544367038,6.969998265979322,176.50852423095702,172.43074307250976,169.13500213623047,165.83926119995115,161.7614800415039,0.06,0.0,217.23951121503399,-0.01956931072259782,0.03750082107526929,176.78956821986608,170.79331861223494,7.880089916090996
2022-08-18,0,174.15499877929688,158.0250015258789,181.63000106811523,164.80250072479248,177.68437480926514,0.002125589615788542,7.6743521988007055,-1.2909614292861464,2.9947128281342237,168.9287509918213,6.575100536346435,0.04514165480495501,159.52149963378906,179.92725143432617,0.7698768064770348,-0.03110720416590226,1.0244050095434691,0.9961262742229612,0.9732863746203451,-0.027976639087563315,53.09601965727322,185.3547051071351,170.00600070953368,154.65729631193227,178.0028577532087,2.301138952923091,171.94392912728446,7.193446506065986,176.42333760707194,173.34972322809142,3.079558757353748,10.30808268439722,18844500,4.4107781576258835,0.6246350743308944,-693484700.0,-30.283456401872595,70.74152269624075,78.01649708558223,47.41494813763433,28.476992777638973,21.048416173808327,0.12355557150600072,6.750711859438233,176.52268365478514,172.45366213989257,169.16500091552734,165.8763396911621,161.80731817626952,0.06,0.0,217.0968449397584,-0.01594459952252436,-0.020634751068312498,177.66348702566964,171.902466910226,7.359089338462432
2022-08-19,0,169.38250350952148,158.0250015258789,180.42000198364258,164.80250072479248,176.2824993133545,-0.03818615150975025,7.270545547310901,-1.223555705041727,2.994812753589992,168.9287509918213,6.163975410461427,0.04286063246702704,159.52149963378906,179.29875068664552,0.8590252873250235,0.014963172485226143,0.9985277146020574,0.9662311970371554,0.9519480874699914,-0.06117668968389545,54.24585117964517,184.17334168971456,169.63225059509278,155.091159500471,176.8875013078962,4.014828145146907,172.6569652557373,6.292770838888605,175.8242993866267,172.70763610369585,3.41592234170912,10.207243852344748,26240800,3.793737266087067,0.894014171600516,-719725500.0,-60.342735718990234,70.74152269624075,78.01649708558223,-5.8927767715471795,26.204664251880413,24.412412342674035,0.1529197113102837,6.8120897261633075,177.1787633666992,173.51562167358398,170.55500030517578,167.59437893676755,163.93123724365233,0.06,0.0,216.87690782777426,-0.06947367172695618,-0.05369313974833675,176.18367222377233,172.47486332484655,7.369855920096896
2022-08-22,0,164.07250213623047,158.0250015258789,180.42000198364258,164.80250072479248,176.2824993133545,0.006197533990504153,7.2567654707304525,-1.2112956476265933,2.994815623641036,168.8925018310547,6.0566500091552715,0.042807219412084,159.52149963378906,179.29875068664552,0.8646788105062523,0.009686623952153488,0.9678537396259917,0.9351378157852064,0.9336890108059882,-0.08783999286400468,47.516134203058,184.03553144500097,169.52200050354003,155.00846956207909,174.73107256208147,6.099010440037671,172.97017969403947,5.676531137731869,174.1963866905411,171.74900148723245,-4.406284314971842,6.262550778970048,19499700,3.8509885397429504,0.6719787113869061,-739225200.0,-93.12589033231986,70.74152269624075,78.01649708558223,-62.63724654023515,24.6199877936696,28.01797666151732,0.1537939544155577,6.732655498918539,178.01892639160155,174.8755465698242,172.3350067138672,169.79446685791015,166.6510870361328,0.02,1.0,216.69606986772024,-0.0986234220441814,-0.09667589722651183,174.1250457763672,172.67873055594308,7.491670910728167
2022-08-23,0,162.33499908447266,158.0250015258789,180.42000198364258,163.61937618255615,176.2824993133545,0.06151851024885673,7.345466326056924,-1.2787647471076338,2.9947917943681137,168.8925018310547,6.2202503204345705,0.04337760658163608,159.52149963378906,179.29875068664552,0.834261731559837,0.011170367517850097,0.9586462468335244,0.9287550079976542,0.9407179800261908,-0.09428962796512452,41.7497791600673,184.0286832777242,169.33775062561034,154.64681797349647,172.1475007193429,7.044647915483618,172.7333938053676,6.06145569742987,171.6356765424291,170.32384642908545,-8.425077616129524,2.745989596073875,18111800,3.836883414506298,0.635490605427975,-757337000.0,-98.16962725654578,70.74152269624075,78.01649708558223,-78.05327152959907,23.454297449606877,28.389368339466085,0.1658571429111874,6.562466020167763,177.81360394287108,174.54320260620116,171.9000015258789,169.25680044555662,165.9863991088867,0.04,0.0,216.5250718050266,-0.10230126603113776,-0.10934824710646113,171.36072431291853,172.1305705479213,7.360577123929039
2022-08-24,0,162.27250289916992,158.0250015258789,180.42000198364258,163.63812637329102,176.2824993133545,0.06148564776361148,7.341870269754292,-1.2773187510719228,2.994792755802203,168.8925018310547,6.216500282287598,0.04335541046333486,159.52149963378906,179.29875068664552,0.8490718664492202,-0.02363696700810538,0.958255963618608,0.9316314756514856,0.9591423726320648,-0.07789235526038585,37.58206727477906,184.02524120326595,169.34150066375733,154.6577601242487,169.6332152230399,6.9683918693059255,172.22035816737585,6.636922907996759,169.28795262502445,169.08890843426315,-10.023834774599749,-2.0012088203261253,20891500,3.742014021334534,0.7637807466855703,-778228500.0,-85.04076313560567,70.74152269624075,78.01649708558223,-67.3912990812112,21.98779018184936,27.636238176987863,0.12469000538820768,6.500147112793541,177.5941256713867,174.18794540405273,171.43500518798828,168.6820649719238,165.27588470458983,0.06,0.0,216.33112254883648,-0.06628550761048668,-0.09032158632418515,168.8473161969866,171.6094970703125,7.497781868927841
2022-08-25,0,166.7150001525879,158.0250015258789,180.42000198364258,162.31937503814697,176.2824993133545,0.09957724605421328,7.475861318446401,-1.3526462043371195,2.99475641907896,168.8925018310547,6.416125106811523,0.044198760841177416,159.52149963378906,179.29875068664552,0.8384931844730165,0.01715926319852138,0.9856518341504489,0.9654046147690092,1.001631177359037,-0.042720557427912476,39.7629212068542,184.09359847612618,169.1418758392334,154.1901532023406,167.84464372907365,5.556972978691971,172.1373222896031,6.702386116689143,167.50806325976598,167.97687503592604,-9.78470769002965,-4.238587739679506,15550500,3.4119001830143825,0.6355039967012068,-762678000.0,-61.38022374759227,70.74152269624075,78.01649708558223,-27.37550042434658,24.411489821238465,25.912838052961693,0.0557377158426551,6.437280127782267,177.5941256713867,174.18794540405273,171.43500518798828,168.6820649719238,165.27588470458983,0.06,0.0,216.19945364002433,-0.033665369756082475,-0.03471549182364242,167.32330540248327,171.7285385131836,7.222812890163658
2022-08-26,0,165.71249771118164,158.0250015258789,180.42000198364258,163.63812637329102,176.2824993133545,0.08070739213355636,7.172133880896067,-1.2468623658531695,2.9948376186702,168.8925018310547,6.073549728393556,0.04231325557900347,159.65874977111815,179.29875068664552,0.8160523231908519,0.054991289623786965,0.9776498019599458,0.9665692397387428,1.0045890931047627,-0.021666971040686822,49.35919086187534,183.8451436162843,169.5008758544922,155.15660809270008,166.3778577532087,4.254047031109948,171.77946499415808,6.914141128315047,167.3007379099295,167.94687950070335,-6.985243069227066,-0.6924705644963379,24023600,3.517293875372111,1.01935443629597,-786701600.0,-91.38450771932463,70.74152269624075,78.01649708558223,-60.87550493504056,21.981755115691566,25.862338620111732,-0.04377934838521148,6.63818891335463,177.5941256713867,174.18794540405273,171.43500518798828,168.6820649719238,165.27588470458983,0.06,0.0,215.9873716611122,-0.036794480836977894,-0.07374321590637312,165.45999145507812,171.1247798374721,7.038239693091951
2022-08-29,1,160.4724998474121,159.39999771118164,180.42000198364258,165.2556266784668,176.2824993133545,0.16392594572689217,6.739774942758034,-1.2240388973587366,2.994946660071102,168.8925018310547,5.766049880981444,0.03967251374928143,162.01400260925294,179.29875068664552,0.798843928797999,0.03960163168532586,0.9445934783651393,0.9441044358449832,0.9771710735789192,-0.021941533419349346,46.9820690709882,183.36480054927338,169.88525066375732,156.40570077824125,164.42321504865373,3.061220606119255,171.21303640093123,7.511126661471707,166.91514073870712,167.94716284139278,-5.834470881783598,-2.934588083415071,20052700,3.524705659986374,0.8896390526020879,-806754300.0,-99.33580911131055,70.74152269624075,78.01649708558223,-112.14498139153689,20.998690598511235,27.650281835518047,-0.08166963312508486,6.452604409814095,177.4147633666992,173.89762167358396,171.05500030517578,168.21237893676758,164.69523724365234,0.08,0.0,215.79664972774555,-0.02379645324920021,-0.05233396820749734,163.25167192731584,170.45757947649275,7.096336839709932
2022-08-30,1,158.77000427246094,159.6875,180.42000198364258,165.2556266784668,176.2824993133545,0.1996951015835202,6.65992928262035,-1.2518312126287061,2.994966001469423,168.8925018310547,5.723149795532225,0.03919014558865148,162.09250259399414,179.29875068664552,0.7406007545433235,0.004915850316475049,0.9342771249517575,0.944872540814201,0.9710614540645182,-0.021960728321787415,38.959804851317436,183.25873433580955,169.93887577056884,156.61901720532813,162.90714372907365,2.8136978609287406,169.89732251848494,7.982147567377228,165.29771395224813,167.3974136464762,-7.856506576204753,-4.7089563979100575,19567900,3.7380489002402135,0.8834292290248256,-826322200.0,-95.40272200161174,70.74152269624075,78.01649708558223,-134.46576360428423,19.65162609469587,29.335025907184523,-0.10997446935513283,6.40241833245247,176.68316552734373,172.71342517089843,169.5050048828125,166.29658459472654,162.32684423828124,0.1,0.0,215.60456517961694,-0.02451737957408906,-0.03612393859860694,161.71197727748327,168.9478247506278,7.340283362195138
2022-08-31,0,164.99499893188477,158.77000427246094,180.42000198364258,165.2556266784668,176.2824993133545,0.16194333582758338,6.733142120961874,-1.2126139497199286,2.9949482530481264,168.8925018310547,5.75984962463379,0.039631662763955626,162.09250259399414,179.29875068664552,0.7934327197229266,-0.04153333649286524,0.9711700774962302,0.9940251143128507,1.0135543846284325,0.016777309674002483,33.63408375711368,183.35928522611565,169.8930009841919,156.42671674226816,163.0389289855957,2.897725589995481,168.88500077383858,7.60586932572793,163.66810498193712,166.8648432325608,-6.2654046416689,-10.395617414645368,40953000,3.482100087957202,1.8111588400410588,-785369200.0,-72.52450812060115,70.74152269624075,78.01649708558223,-62.51382970555171,23.997427101860367,25.99892374612448,-0.23030565234943381,6.70795962883854,175.43020599365235,171.6999055480957,168.68500518798828,165.67010482788086,161.9398043823242,0.1,0.0,215.24871396762882,-0.0020212662837105766,0.011296637743417104,161.69486781529017,167.9099567958287,7.492734463579575
2022-09-01,0,164.16250228881836,158.77000427246094,180.42000198364258,164.7643747329712,176.2824993133545,0.1682331712538304,6.755257155366747,-1.2267466806630776,2.994942862375561,168.8925018310547,5.7860497283935555,0.03976949946431858,162.09250259399414,179.29875068664552,0.8460702550822151,-0.02631968871368288,0.9664562572054912,0.9955985436173905,1.0050785946794767,-0.015310547109938066,44.484440516044245,183.3707651652257,169.8602508544922,156.3497365437587,163.3000008719308,2.9060474738799775,167.72375079563685,6.9193538185698396,163.9952509501069,167.1160836260907,0.5622494833950553,-7.910198088106789,30145700,3.671313296932943,1.3151504033375994,-815514900.0,-62.984734038038795,70.74152269624075,78.01649708558223,-56.708937285532926,22.211886549399942,25.96439591564814,-0.2203268161185505,6.7295335665202805,175.4149227294922,171.68754290771486,168.6750030517578,165.66246319580077,161.93508337402343,0.1,0.0,214.99017958216416,-0.020263110429213915,0.012862978244367928,162.30076599121094,166.83074515206474,7.539885143085426
2022-09-02,0,163.72999954223633,158.77000427246094,180.42000198364258,164.1400022506714,176.2824993133545,0.24714347978904372,6.868659145273862,-1.2881314247711153,2.99491449545201,168.14000129699707,5.997749710083008,0.04050021402226484,162.09250259399414,179.29875068664552,0.8474863175565941,-0.022129231722901793,0.9654140470616562,0.9990298217690838,1.0055735474426626,-0.011963480101546575,43.8333896513768,183.33294416792808,169.59562587738037,155.85830758683267,163.50821467808314,2.872175347815502,166.57071495056152,6.026556420102493,164.03349807127898,167.0959167162368,1.1257604426971064,-9.010918698636404,22634200,3.6607259766833264,0.9943880003198321,-838149100.0,-82.41625462463567,70.74152269624075,78.01649708558223,-71.30548812609939,20.200683848745253,24.788133901340707,-0.22787957968164713,6.870994952803979,175.0711250610352,171.4094447937012,168.45000457763672,165.49056436157227,161.82888409423828,0.1,0.0,214.7906921129737,-0.009024568571826097,-0.05012436944460575,161.88163103376115,165.3644736153739,7.783652676816967
2022-09-06,1,159.50500106811523,158.77000427246094,180.42000198364258,163.98687648773193,176.2824993133545,0.29582302538925553,6.979122811021619,-1.3393398990119023,2.994886528120792,167.5587501525879,6.163649826049806,0.041201929772840935,162.09250259399414,179.29875068664552,0.8556541334960672,-0.04095828207427562,0.9416532751145831,0.9766185285209562,0.9820164266134412,-0.006029062800273155,41.76564039154307,183.34649635446507,169.38825073242188,155.4300051103787,162.47821480887276,2.8228914073198084,165.16142926897322,5.067900075239994,163.96987327504095,166.92299584359202,0.8981784449162286,-8.974413380483329,19339800,3.5899229087279356,0.8647747102203432,-857488900.0,-88.16918520247243,70.74152269624075,78.01649708558223,-94.68493876027733,19.334843149872654,25.365134423447056,-0.23245422672819335,6.665923738653293,172.8937203979492,169.64814102172852,167.0250015258789,164.4018620300293,161.1562826538086,0.1,0.0,214.61113529793926,-0.0039580313993129446,-0.020027272369845694,160.42177254813058,163.87253897530692,8.100912457396866
2022-09-07,1,158.97999954223633,158.77000427246094,180.42000198364258,163.3812494277954,176.2824993133545,0.36567356003972495,7.293044266660647,-1.3617873830968783,2.994803674625006,166.21374893188477,6.4783501434326185,0.04319823270595012,160.37574996948243,179.29875068664552,0.8369044785771963,-0.05283472084090627,0.9416719225484618,0.9761338943815551,0.9799516024594724,0.0013226381818005617,36.626586057195645,183.41346432677835,168.82737579345704,154.24128726013572,161.5164293561663,2.6806094066280823,163.9471435546875,4.246380348287768,162.87417132446882,166.14529181946526,-4.324745270595699,-11.007894370546753,16831200,3.6687759061907252,0.7556847416442851,-874320100.0,-77.43074159286458,70.74152269624075,78.01649708558223,-84.85135912173473,18.451212868649,25.175005246598463,-0.21929364315667177,6.486215435246121,171.07539666748048,168.1772980041504,165.83499908447266,163.4927001647949,160.59460150146484,0.1,0.0,214.45603696523767,0.02055228595256353,0.007664765316874501,160.2236066545759,162.84179905482702,8.285468805187994
2022-09-08,1,160.18500137329102,158.77000427246094,180.42000198364258,162.31937503814697,176.2824993133545,0.40025297258008186,7.6030290586868485,-1.3961979780485445,2.99471814258085,165.3537483215332,6.8552501678466795,0.04516036098589882,159.45250091552734,179.29875068664552,0.8491032939929878,-0.10277103236981315,0.9514645321892189,0.9855628032517556,0.9871236768695599,-0.02915238394940367,30.64220147499614,183.56230888031314,168.35625076293945,153.15019264556577,161.47535814557756,2.701391755169264,162.94928659711564,3.167455241719213,161.93812456093738,165.58874154588915,-4.0627582481312325,-9.660188682930352,22530800,2.951428491226994,1.029451643420299,-851789300.0,-62.522897476953744,70.74152269624075,78.01649708558223,-67.70050702059744,18.94837276399747,23.902236503452773,-0.19941342952578686,6.343627833311542,168.44724645996095,166.05138592529298,164.11500549316406,162.17862506103515,159.78276452636717,0.1,0.0,214.25460743220577,-0.005339773343982834,0.031178333525968147,160.6356157575335,161.94364384242468,7.991198521110383
2022-09-09,0,166.23999786376953,158.77000427246094,180.42000198364258,161.82250213623047,174.61124897003174,0.6094115314776003,7.517967597803518,-1.1491260978465618,2.9947336604816313,164.57875061035156,6.5670502853393575,0.0448817806967981,159.45250091552734,179.29875068664552,0.8363009709202818,-0.10594835351266826,0.992442043689809,1.024132460664521,1.0305462817669127,0.012655116399822752,32.65588583528063,182.5419360958756,167.50600090026856,152.47006570466152,162.54250008719308,2.9210846470069276,162.72482190813338,2.761871779648547,161.52454495440438,165.01374136802198,-0.17915747208678517,-8.021588529715277,22086800,2.9158099229069894,1.013779111931187,-829702500.0,-11.79217135392576,70.74152269624075,78.01649708558223,5.126128403037744,25.49962303567884,21.914528025896555,-0.11883219877632477,6.4247970149115465,167.37763946533204,165.18618026733398,163.41500091552734,161.6438215637207,159.45236236572265,0.02,1.0,214.08260460672093,0.022919683556131165,0.038175907149130675,162.34495980398995,162.0284685407366,7.624932196799644
2022-09-12,0,168.75500106811523,158.77000427246094,180.42000198364258,161.82250213623047,170.57562732696533,0.7941278513299274,7.027278421481188,-0.713234680743021,2.994854747647968,164.57875061035156,5.788725204467778,0.0421149118316289,159.45250091552734,179.29875068664552,0.797568547555069,-0.07859441283654707,1.0113591016124992,1.0399306167405438,1.043449502841125,0.03069078079721521,46.09021615148978,180.91418246857276,166.85962562561036,152.80506878264796,163.07964324951172,3.6913676667517485,163.0592861175537,3.1882458989081472,162.72828966437334,165.0252511806492,4.704914902244091,-1.8552716960965827,23220400,3.2848414874164633,1.0610713254298134,-806482100.0,-15.697631437056986,70.74152269624075,78.01649708558223,38.124867742556575,26.414777963131318,20.88672538914878,-0.13999329331212684,6.259454327012529,167.73672039794923,165.4766410217285,163.6500015258789,161.8233620300293,159.56328265380859,0.04,0.0,213.91068594563154,0.05389222470636201,0.021770795952106042,163.20462472098214,162.44974626813615,6.922306241609031
2022-09-13,0,157.24250030517578,158.77000427246094,179.87250137329102,161.82250213623047,168.9118766784668,0.8745760945965875,6.326760107033106,-0.3028270072581627,2.995015959867351,164.57875061035156,5.016037597656253,0.03804966330887727,159.45250091552734,176.30549964904785,0.742292235542357,-0.06180767054605825,0.9456695201398542,0.9671729814913689,0.9662606854679024,-0.01418451301080692,50.95494351041256,178.92989579390022,166.276375579834,153.62285536576778,162.09107153756278,4.2390232238254,162.6955362047468,3.5475003588508716,164.24721311452993,165.2972911744353,2.2788582445354715,2.853920596637733,44444100,3.3648065237976748,1.9064746812719011,-850926200.0,-97.54269933829679,70.74152269624075,78.01649708558223,-131.44409608911485,22.008835855817726,32.36247975203457,-0.2394463654128809,6.97592283780482,166.9720791015625,164.23895892333985,162.02999877929688,159.8210386352539,157.08791845703126,0.02,1.0,213.48773079077904,-0.03412381603603898,-0.044847845331499124,161.46106610979353,161.88091605050224,6.552681004899431
2022-09-14,0,151.8474998474121,157.24250030517578,179.23500061035156,160.40062522888184,167.22500038146973,0.8960745645511315,5.7952924322606005,0.081345458931251,2.9951226213182136,164.1175022125244,4.501599502563477,0.035092172335272835,158.9590000152588,174.3374988555908,0.5424113609736496,-0.12270204050706837,0.9194805431495927,0.9358484822607144,0.9357100811179193,-0.044864132062909734,35.891124192541504,176.7354603909494,165.14487552642822,153.55429066190703,160.3935715811593,5.625685744950195,161.95089312962122,4.585427533547337,162.49495310043687,163.96036534043904,-4.215336564173414,-3.137030713042319,43064200,4.15677432969852,1.7643791996456837,-893990400.0,-89.16741913318589,70.74152269624075,78.01649708558223,-188.2477150846988,20.970564868734268,34.63921073250274,-0.23180825218949164,6.798356142181954,166.11776025390625,162.85612078857423,160.22000122070312,157.58388165283202,154.3222421875,0.04,0.0,213.05252483610693,-0.055614411879467585,-0.044594392584655654,160.19937133789062,161.0405011858259,6.192126054260751
2022-09-15,0,150.5625,151.8474998474121,175.97999954223633,160.01500129699707,166.35874843597412,0.2676392252615123,5.533954746267008,0.16525573828848916,2.9951627748594354,163.9012508392334,4.241499710083008,0.03378988145215885,158.61725387573242,169.85975303649903,0.4583685965406488,-0.13713205908397713,0.9193224844443282,0.931904798427642,0.9360196197440216,-0.06007117577048915,31.79237869428523,174.84340998081524,163.77550048828124,152.70759099574724,159.11607142857142,6.761735539093127,160.7971431187221,5.274778367723175,159.8079304234559,162.14734333642838,-7.257374780459197,-6.42438051148784,34606300,4.240236783491244,1.3769829072327184,-928596700.0,-96.25382982786958,70.74152269624075,78.01649708558223,-178.80534518201756,20.445016489315186,32.6098272482641,-0.24638145478386894,6.7056163784126745,166.03515881347656,162.72241845703124,160.0449981689453,157.3675778808594,154.05483752441407,0.06,0.0,212.704183844602,-0.07719353828570152,-0.06758522571005655,158.917720249721,159.66974639892578,6.271287579421005
2022-09-16,0,146.80249786376953,150.5625,174.15499877929688,159.3737506866455,165.8443727493286,-0.2599132903901994,5.503745194278955,0.12441920683779983,2.9951567155213104,163.0324993133545,4.287374687194824,0.03386823714689073,156.7030002593994,168.81775131225587,0.4644237287956877,-0.1354683985223713,0.9033742725906554,0.9168222631507871,0.9236957143444312,-0.11692432777777495,31.095049901008036,173.51211589972735,162.50462551116942,151.4971351226115,157.3764283316476,8.213276616233703,159.44642884390694,6.250231423921596,157.47438948487334,160.43739368223743,-5.606407954755235,-9.688690362477354,40122800,4.238231665991359,1.5316448496309918,-968719500.0,-92.61992786141644,70.74152269624075,78.01649708558223,-209.2375940806283,19.281568337588055,35.52515400458041,-0.25723067759104706,6.602358722553284,164.99439794921875,161.03779705810547,157.83999633789062,154.64219561767578,150.6855947265625,0.08,0.0,212.27660218674978,-0.13514626336961177,-0.09730952488554798,156.9075666155134,158.56558663504464,6.447884722661502
2022-09-19,0,146.73500442504883,146.80249786376953,169.38250350952148,158.92750072479248,165.17437362670898,-0.8794953512414336,5.827700547054642,0.16302846729267317,2.9950708763405838,162.3037509918213,4.586550006866455,0.036166122803720925,151.7189998626709,166.91900024414062,0.5322639745832225,-0.13330778077962854,0.9106226627109314,0.9264450836026968,0.9464209994604281,-0.13048500194775492,28.978790339677126,172.79240155950237,161.13700046539307,149.48159937128378,155.45500019618444,8.983838213889722,158.465179170881,7.097657702717119,154.7950534035266,158.4091253414666,-7.6597696021703605,-11.411329929001568,22169500,4.199692608896369,0.8529248537789521,-990889000.0,-86.23612492159461,70.74152269624075,78.01649708558223,-166.70831179938537,18.53026047032638,34.140913510134055,-0.19727888257833748,6.379332712788945,164.99439794921875,161.03779705810547,157.83999633789062,154.64219561767578,150.6855947265625,0.08,0.0,212.04570781129365,-0.12393468531407781,-0.12491863409963642,154.90596880231584,157.77079227992468,6.769330160065929
2022-09-20,0,146.4824981689453,146.73500442504883,168.75500106811523,158.38812828063965,164.37062644958496,-0.8623371344854388,6.296926163133565,-0.2737076913485552,2.9949485528517386,161.37250137329102,4.959199676513674,0.03935465079847955,150.18649978637694,166.28749809265136,0.6681163762911397,-0.10566973432748776,0.915489147272932,0.9348822823752776,0.9724139838163929,-0.06842935030508601,30.024027779560758,172.59847783743655,160.00462551116942,147.4107731849023,152.63250023978097,8.089913166322091,157.58750016348702,7.7836363003790865,152.77759965753762,156.5715319442173,-8.396539521761254,-8.560653965898084,23217400,4.090640659961352,0.8868979200640533,-1014106400.0,-93.3579238141784,70.74152269624075,78.01649708558223,-144.76158825607985,18.055628587764772,32.71297476863557,-0.19988258007504842,6.182237103326037,164.99439794921875,161.03779705810547,157.83999633789062,154.64219561767578,150.6855947265625,0.08,0.0,211.8037367426641,-0.04597397809753978,-0.1353574976000556,151.61844090053015,156.98170035226005,7.340158131779425
2022-09-21,0,145.0275001525879,146.4824981689453,168.75500106811523,155.89375019073486,164.37062644958496,-0.6696517140925901,6.869699694030562,-0.7725283881084435,2.9947907298545458,160.32875061035156,5.557849807739257,0.04317168442460759,146.79574851989747,166.28749809265136,0.7346319914177406,-0.09765300769970335,0.911405410474905,0.9333534992340703,0.9767082424805998,-0.044913480312006926,30.188308929407214,172.8645247008663,159.12512531280518,145.38572592474407,149.2428572518485,4.284728822591663,156.1612502506801,8.14299529852096,151.19455471070125,155.02735022207403,-11.884925378196352,-7.739186101191612,38338600,4.088316965166215,1.4100490813566242,-1052445000.0,-99.5917144617915,70.74152269624075,78.01649708558223,-140.98192580826006,16.495729167879123,33.54714661493833,-0.23369589572185373,6.28350634955328,164.4539595336914,160.16301962280272,156.69499969482422,153.22697976684572,148.93603985595703,0.1,0.0,211.39504355826875,-0.06172839506172845,-0.07189972429212813,147.7920161655971,155.49832044328963,8.184714313892052
2022-09-22,0,142.4550018310547,145.0275001525879,168.75500106811523,151.52624988555908,164.37062644958496,-0.5104933837179556,7.474348624754417,-1.096402706344408,2.9946072401203785,159.84500122070312,6.311825180053711,0.04722836101699184,146.7097537994385,166.28749809265136,0.7654621840427149,-0.10627187255068983,0.9001341244467764,0.9251045648507862,0.9682780394016984,-0.0538480575770548,28.77340077347276,173.20844761571982,158.25975036621094,143.31105311670206,147.13035746983118,3.1884037654360884,154.61071450369698,8.558359825510228,149.65232016800218,153.86854739683693,-14.060324592069493,-12.101881213708847,34418500,4.0863043925749665,1.2351476176976162,-1086863500.0,-93.61070794871807,70.74152269624075,78.01649708558223,-134.0232435122939,15.779072898495402,33.412951694019846,-0.2333590416285406,6.099684893189009,164.18727838134765,159.73135775756836,156.12999725341797,152.52863674926758,148.07271612548828,0.12000000000000001,0.0,211.02248831251774,-0.04500169208889648,-0.057107030307031396,146.32217843191964,153.89162227085657,8.714164900592221
2022-09-23,0,140.83499908447266,142.4550018310547,168.75500106811523,149.62249946594238,164.37062644958496,-0.39572662639412076,8.158948992446522,-1.2391591857000306,2.994376259187699,159.24250030517578,7.0995999908447285,0.0518789809885682,146.33699836730958,166.28749809265136,0.7639745254022365,-0.14551778963697898,0.8955045860431964,0.9252373218361701,0.9679348085528794,-0.0406498449694952,23.727507512929023,173.5867732976982,157.26887531280516,140.95097732791214,145.55714307512557,3.189843039410595,152.97535732814245,8.863751897701919,147.8553832761458,152.64411482280514,-9.404263125695381,-13.22317834774028,31710700,3.898837075818375,1.1059077746983232,-1118574200.0,-95.32306377704327,70.74152269624075,78.01649708558223,-132.89138367901157,15.033969626731507,34.2142216932463,-0.26301203653019534,5.9447079254433595,163.71999938964845,158.97499938964845,155.13999938964844,151.30499938964843,146.55999938964842,0.14,0.0,210.67227246113814,-0.04019408836133531,-0.0611166150860716,144.74542018345423,152.47239576067244,8.94992208727771
2022-09-26,0,138.72999954223633,140.83499908447266,168.75500106811523,146.78562450408936,163.83812522888184,-0.29855168147278066,8.59861402745231,-1.2944035287029843,2.994203035773981,158.87500190734863,7.705150070190427,0.05512819941770806,144.77025032043457,165.76524772644044,0.7817541589246041,-0.1501244563344141,0.8894381182322896,0.9268779871498597,0.9613532180567832,-0.05455415982149914,22.611931921883514,173.17210331430402,155.97487525939943,138.77764720449483,143.8667858668736,3.2302149084676217,151.49142864772253,9.408770951493441,146.0995936000593,151.22410971596176,-7.252342497575297,-13.98338760262294,30497000,3.8989884561700086,1.0517084529122775,-1149071200.0,-99.48865712674376,70.74152269624075,78.01649708558223,-132.31555204072558,13.942474743499657,34.97028377385538,-0.26909456203074533,5.952229007792934,163.08280010986329,157.94360055541992,153.79000091552734,149.63640127563477,144.4972017211914,0.16,0.0,210.32742953741558,-0.07870571131604942,-0.06781062462784558,142.86642238071985,150.89207131522042,9.744418096740741
2022-09-27,0,136.46499633789062,138.72999954223633,168.75500106811523,146.67187786102295,161.28687477111816,-0.2105760561834247,9.068861425165466,-1.292898456919371,2.994003544437826,158.00625228881836,8.215425224304198,0.05865039558147322,142.2930015563965,165.11949882507324,0.8221012108375519,-0.13549050663415846,0.882550261053917,0.9304093230085857,0.956266706174612,-0.06838702204205327,21.946552006882357,172.76347320128312,154.62575035095216,136.4880275006212,142.38999993460519,3.947732188732847,149.8832141331264,9.939550522263037,144.25512270059525,149.77656207434157,-7.858862902624273,-13.024670942453472,30826500,3.7940802214657356,1.0436829024111711,-1179897700.0,-99.24872887792029,70.74152269624075,78.01649708558223,-130.8942871995965,13.048714612322746,35.232238224384325,-0.27960007123724534,5.905641428584643,162.59427838134766,157.15285775756837,152.75499725341797,148.35713674926757,142.91571612548827,0.18,0.0,209.9712274266844,-0.0800192913909551,-0.09201470630465876,141.17133222307478,149.03944941929407,10.588722446639235
2022-09-28,0,138.13249969482422,136.46499633789062,168.75500106811523,146.11874866485596,161.07125091552734,-0.12904570724439204,9.776746509927715,-1.3013141480361103,2.9936940185675502,154.54500007629395,8.831125450134277,0.06372313900973571,140.62449913024903,165.11949882507324,0.8386673021764893,-0.14048628414907194,0.9003236885478622,0.9553111548848469,0.9817345128482252,-0.047542710523929776,20.488561451396613,172.97886819533153,153.42537517547606,133.8718821556206,141.16107068743025,3.7009663425375217,148.30803544180733,9.928771239858545,142.31452314185316,148.30407955675582,-7.041774953633247,-14.162160818451962,32658500,3.800509262165883,1.0817368204883606,-1147239200.0,-79.90339513135372,70.74152269624075,78.01649708558223,-94.7631822823402,14.938408718908693,31.997987032215264,-0.2069892683768004,6.038095248717668,162.59427838134766,157.15285775756837,152.75499725341797,148.35713674926757,142.91571612548827,0.18,0.0,209.61434443003017,-0.0035885363075311982,-0.030666110839046773,140.2574942452567,147.58173152378626,10.817428157343778
2022-09-29,0,137.70249938964844,136.46499633789062,168.75500106811523,144.3843755722046,161.07125091552734,0.017171217156247844,10.2364717967434,-1.3953125310152008,2.9934744175811208,151.20499992370605,9.225350246429443,0.06717131505169667,138.6702495574951,165.11949882507324,0.8504508641061043,-0.16280796030763484,0.9035982468931142,0.9614568891352185,0.9883652081909099,-0.03336142908511208,20.931518621488514,172.86644354008098,152.39349994659423,131.9205563531075,139.90678514753068,3.02253785979004,146.26964269365584,8.833058391178865,141.26607095201362,147.2529759067449,-5.862612512898179,-13.766895458006216,38985400,3.453982000338922,1.295522261087676,-1186224600.0,-93.855625751527,70.74152269624075,78.01649708558223,-101.35463379186956,13.810618823669312,29.582267451771937,-0.18947397352338408,6.0646601407575105,162.59427838134766,157.15285775756837,152.75499725341797,148.35713674926757,142.91571612548827,0.18,0.0,209.1801106912031,-0.044881639482104996,-0.04017729768530532,138.87747192382812,145.24795641217912,11.029499589510511
2022-09-30,0,137.05500030517578,136.46499633789062,168.75500106811523,142.05000114440918,159.67500114440918,0.17961759835723146,10.284674985227333,-1.340322759597772,2.9934201629224777,148.68249893188477,9.138762817382812,0.06809740844130303,138.08949966430663,164.3702518463135,0.8548268867761816,-0.16118177129523567,0.9074754766786798,0.9656061636190582,0.9904750311406477,-0.026839910561078928,20.73696519089788,171.59822493993707,151.02887496948242,130.45952499902776,138.7678565979004,2.1465187948208073,144.00535692487443,6.3357253216458815,140.35104110684097,146.08484632824988,-5.993889296706614,-17.166445404737686,33166400,3.4587134507220014,1.0966471919296257,-1219391000.0,-94.3293456749585,70.74152269624075,78.01649708558223,-91.12361911144133,14.275225450616636,27.65643191981435,-0.26116460311844186,6.023613372511763,155.137642578125,151.12118115234375,147.875,144.62881884765625,140.612357421875,0.18,0.0,208.81598462474813,-0.0336872103355752,-0.04999305723355434,137.95935712541853,142.8756866455078,10.946178310087141
2022-10-03,0,137.86750030517578,136.46499633789062,168.75500106811523,140.30874919891357,159.11124992370605,0.34856069168243553,10.250675500707505,-1.2011124020852328,2.9934025028516027,146.76875114440918,8.998600177764894,0.06848690990449369,137.63774948120118,163.98099937438965,0.8522064582413842,-0.16292065786135532,0.9211216442766754,0.9780472780582178,1.0018202784026884,-0.006217106897617786,20.251838001210924,170.1748508717153,149.6734998703003,129.1721488688853,138.11249923706055,1.4056081844847268,142.62142835344588,5.243868965896243,139.53821378377305,144.9982311411559,-5.497233172345933,-18.78462893680067,27723100,3.4559043155919444,0.9090166863948009,-1191667900.0,-77.63941691369742,70.74152269624075,78.01649708558223,-79.4458975046475,13.591377414882306,26.331563411837944,-0.2118824532069486,5.874783994353812,149.4611165161133,146.5294362487793,144.15999603271484,141.7905558166504,138.8588755493164,0.18,0.0,208.51748114100337,0.01642605924373819,-0.012819610934940934,137.35916355678015,141.8406709943499,10.86077987427293
2022-10-04,0,140.625,136.46499633789062,168.75500106811523,138.5806245803833,157.67687511444092,0.5422841352537628,10.024669480290449,-0.9507293388014038,2.9934745246471124,146.60875129699707,8.62745018005371,0.06756061565739949,137.63774948120118,160.79050102233887,0.8802267039627731,-0.1356540586065972,0.9477331492575589,1.0039246799190789,1.023140255243519,0.030484034541789162,24.28026726880442,168.42971386902815,148.38037490844727,128.33103594786638,138.08249936785018,1.3384543902879564,141.81982122148787,4.534868309104324,139.1410472687715,144.1328129074711,-3.2203162169900357,-12.321732332160234,34670700,3.4223793493295833,1.1089497990448896,-1156997200.0,-69.3226937231518,70.74152269624075,78.01649708558223,-55.321002992745996,16.406335717164897,25.089759623263383,-0.21017292584200647,5.725156454779895,149.4611165161133,146.5294362487793,144.15999603271484,141.7905558166504,138.8588755493164,0.02,1.0,208.16114419412702,0.04375006754854249,0.028672079343267088,137.34062848772322,141.04302433558874,10.704331643194354
2022-10-05,0,138.0525016784668,136.46499633789062,168.75500106811523,138.5806245803833,153.19624996185303,0.7689511587974132,9.819485155910513,-0.5967590658076052,2.9935485353189213,145.7549991607666,8.175787601470944,0.06660150973981128,137.63774948120118,160.79050102233887,0.8874325795890081,-0.11545477163849119,0.9363530662918099,0.9896981637377861,0.998380069928029,-0.0005791397139279786,33.745290897739075,167.07534516686252,147.4363748550415,127.79740454322047,137.98571395874023,1.307977599636746,140.92624991280692,3.86229392076731,139.540075383954,143.84115361098824,-0.14911001231071763,-7.390638541095065,27979300,3.530158330895763,0.8792480638303556,-1184976500.0,-68.60466950156629,70.74152269624075,78.01649708558223,-72.23155010490031,15.2773702642419,29.06846507853677,-0.20162708596014617,5.709073848450452,145.94672351074217,143.6866419067383,141.86000061035156,140.03335931396484,137.77327770996095,0.02,0.0,207.86498645714386,-0.018572111427485827,0.034077457558184185,137.7127227783203,140.2895725795201,10.381893943662002
2022-10-06,0,138.71000289916992,136.46499633789062,168.75500106811523,138.11250019073486,150.88374996185303,1.0058899777420431,9.647148726634878,-0.1124317028226125,2.993604591323828,143.7412509918213,7.734250125885009,0.06590032604104636,137.63774948120118,160.79050102233887,0.8604528934296424,-0.13816836473501792,0.9475374201469746,0.9994092100565394,1.0032511278520269,0.00731652304051944,29.135428793075217,165.68429741512278,146.38999996185302,127.09570250858326,138.30642918178015,1.137016345070725,140.34821455819267,3.5041601533345754,139.19998700177757,143.23684697688913,-0.48835714409648445,-8.308840728291043,36231100,3.508594730945292,1.114567645941865,-1148745400.0,-68.02319965145323,70.74152269624075,78.01649708558223,-58.16727435437767,15.908522633958075,27.285418878067144,-0.228375169823908,5.647710768194,145.94672351074217,143.6866419067383,141.86000061035156,140.03335931396484,137.77327770996095,0.02,0.0,207.49088598707132,0.019500118422679513,-0.017936470694176476,138.37850080217635,139.77491651262557,9.781969331463594
2022-10-07,0,135.2349967956543,136.46499633789062,168.75500106811523,138.11250019073486,147.74249839782715,1.3004420021364511,9.238428123994712,0.7321395875962917,2.993762406325357,141.64500045776367,7.213749923706052,0.06357463891044211,137.63774948120118,158.14225006103516,0.793525792959187,-0.1656039179401332,0.930625423929903,0.9770079424219775,0.9766939361141611,-0.013279365987880376,26.301494972303114,163.79310628613638,145.31625003814696,126.83939379015754,137.89250019618444,1.6309977526064898,139.52678544180733,3.2289110920073827,139.09504587993905,142.62970113845276,1.6451153200639133,-5.512504952135979,33214800,3.1081875853371757,1.0045831831792777,-1181960200.0,-94.11425238173996,70.74152269624075,78.01649708558223,-95.85701908866159,14.590930209208778,30.222298537704823,-0.28682214606893036,5.7178746426144675,145.5502452392578,143.04488470458983,141.02000427246094,138.99512384033204,136.48976330566407,0.02,1.0,207.13009853084858,-0.01643566728561252,-0.021699316690491313,137.21517726353235,138.73633575439453,8.28616316389793
2022-10-10,0,133.82999801635742,135.2349967956543,168.75500106811523,138.00625133514404,146.751877784729,1.5384102617951902,8.132447427901583,2.0961034624885366,2.9941747787436177,140.72999954223633,6.332700195312498,0.056567251149539755,136.99599990844726,152.3869998931885,0.6498071879110522,-0.19863117572990402,0.9308876788013971,0.9707850375396152,0.969094394495495,-0.029285381107811315,20.081879257488715,160.0308948405444,143.7659999847412,127.501105128938,137.33928571428572,2.2467169317244187,138.6230354309082,2.8846146149560328,138.11626925710354,141.37918268424858,-2.097625761910751,-7.837262604417375,24024000,2.991737323927755,0.7257250718165436,-1205984200.0,-89.1709138227503,70.74152269624075,78.01649708558223,-106.67441921143549,13.803558933320847,29.316865968727427,-0.28349735815455057,5.612312547810944,145.4157235107422,142.8271419067383,140.73500061035156,138.64285931396483,136.05427770996093,0.04,0.0,206.86849492198672,-0.03477396322709947,-0.013929832339177089,136.84165736607142,137.85956464494978,5.935183954967679
2022-10-11,0,129.9524974822998,133.82999801635742,157.24250030517578,137.82625007629395,146.5456247329712,0.8792413610133525,6.066383566072358,-0.06895044780354276,2.9948306287957953,139.67749977111816,5.0997003936767555,0.04271507007470399,136.34199638366698,150.6909999847412,0.7300099758356321,-0.1488942381568561,0.9150311673966808,0.9460206956911477,0.9465512733790439,-0.07589335123697916,21.573141336360518,154.15251696429806,142.0197498321533,129.88698270000856,136.32464245387487,3.5954540139106554,137.54624952588762,3.1145011793732964,137.00934130225795,139.9337580506849,-2.8122230100800367,-8.637550772785943,38481400,1.9164427169001765,1.1730235135714309,-1244465600.0,-91.18820311100521,70.74152269624075,78.01649708558223,-164.2587862674454,12.626727451470197,32.93578511186132,-0.2518745809678105,5.697147048327617,140.4287608947754,137.86062031555176,135.7849998474121,133.70937937927246,131.14123880004882,0.06,0.0,206.42757162471045,-0.08368989083590817,-0.0726500794180722,135.82374790736608,136.8915525163923,5.930351615457065
2022-10-12,1,127.93500137329102,129.9524974822998,151.8474998474121,137.54062461853027,145.39124965667725,0.3538075972827361,5.534751241120807,-0.5207561778917817,2.9949611741105024,138.72000122070312,4.550550384521483,0.039349766562424865,135.0944969177246,147.1784980773926,0.7352761645658531,-0.144190733381281,0.9095643543652849,0.9357702664793852,0.946572863694374,-0.07328733765897333,18.84201811544479,151.72475217325112,140.65524969100952,129.5857472087679,134.90571403503418,4.681094948549668,136.50910663604736,3.7140321792875293,135.23525835054596,138.36327090336212,-5.182228161731474,-10.394582168504051,34605200,1.7670957467431216,1.068643545436466,-1279070800.0,-92.36407835768028,70.74152269624075,78.01649708558223,-175.35360234087656,12.069399526020739,32.43708749421005,-0.2747212142854016,5.534493540070367,138.75667626953125,136.3666569824219,134.43499755859375,132.5033381347656,130.11331884765625,0.08,0.0,206.02723006700407,-0.08260182198940214,-0.09110350745765164,134.23985835484095,135.79951095581055,5.9544020482869495
2022-10-13,1,126.87249755859375,127.93500137329102,150.5625,136.9074993133545,143.098126411438,-5.72459433558283e-05,5.5705354345832445,-0.3177745677750248,2.994933949922457,138.42125129699707,4.3848003387451175,0.03994371448996804,133.44224796295165,146.7417537689209,0.7236051261747108,-0.15028641678179483,0.9097435746746625,0.9349725138279842,0.9529791614590923,-0.08533995453219767,17.27384443422204,150.60069563647,139.45962476730347,128.31855389813694,132.941070829119,4.765841549095067,135.51178509848458,4.2926434470048696,133.4102089593125,136.74595065781875,-7.204380227318796,-10.192692619514862,34325700,1.777528374330666,1.0604717636034977,-1313396500.0,-60.92651425805485,70.74152269624075,78.01649708558223,-161.43832670992853,10.779434414256231,33.588013634696495,-0.19535217755827297,5.754172637679613,137.70303924560548,134.80347915649415,132.45999908447266,130.11651901245116,127.21695892333985,0.1,0.0,205.63503419583185,-0.0631337680291646,-0.06252698851368857,132.81564222063338,135.0781353541783,5.711757808723239
2022-10-14,0,129.01749801635742,126.87249755859375,146.80249786376953,136.15749645233154,141.23999977111816,-0.31259848665678047,5.602313909049873,-0.40992798694840893,2.994907454144508,138.0925006866455,4.192638216018676,0.040515703192627754,129.75074787139891,146.50774879455565,0.7795927402138534,-0.1357606348338195,0.9330492259354122,0.9584291201107795,0.9866363304222698,-0.045975516150540297,17.145060204022425,149.4797524633329,138.27512464523315,127.07049682713341,131.65035602024622,4.356710519244244,134.81803498949324,4.5117713767384116,131.77617140950156,135.26369186934022,-9.779557291666666,-9.914085004895847,23559400,1.6712093754594994,0.7469651390481215,-1289837100.0,-78.70089009600122,70.74152269624075,78.01649708558223,-137.37364634013085,10.881737066305853,31.37745587020066,-0.23012828473130503,5.71958863497103,137.70303924560548,134.80347915649415,132.45999908447266,130.11651901245116,127.21695892333985,0.1,0.0,205.36939634328223,-0.05013110912614849,-0.08851664830207615,131.0735081263951,134.3931154523577,5.8922947394263545
2022-10-17,0,132.32749557495117,126.87249755859375,146.73500442504883,134.88374710083008,140.67749977111816,-0.23810356038753056,5.589680977137732,-0.5850652182953238,2.9949013679859755,137.9600009918213,4.272451133728026,0.04068599476664806,128.90924835205078,145.17299995422363,0.8111639083733961,-0.12074492026025992,0.9631812288512734,0.9889226768296556,1.0216643346340017,-0.011226948095916511,26.087465755018997,148.56523660713802,137.38587465286255,126.20651269858709,130.73856925964355,3.127458433902815,134.52249922071184,4.531060139584328,131.09538023493602,134.31114071181943,-6.544614224487205,-7.001010277464851,29612200,1.8070954791719969,0.927924488038231,-1260224900.0,-42.04433961176909,70.74152269624075,78.01649708558223,-58.045484952291716,13.462554995953807,28.31911025053349,-0.21970086148499396,5.884617399744138,137.70303924560548,134.80347915649415,132.45999908447266,130.11651901245116,127.21695892333985,0.1,0.0,205.05808059141526,0.0018686686293154509,0.004421137683029165,130.35640825544084,134.3674545288086,5.3281033598877015
2022-10-18,0,134.78249740600586,126.87249755859375,146.4824981689453,133.45437240600586,139.20374965667725,-0.19837585266515986,5.256866102341291,-0.5920353044210125,2.9949901637889766,137.7849998474121,4.168901252746582,0.03846520250330217,128.90924835205078,142.712251663208,0.8148592422853784,-0.09663272248175679,0.9862218203187224,1.0114572802947865,1.043038666245713,0.03716742669269535,37.419056502725525,147.17923141504022,136.66549921035767,126.15176700567511,130.67392648969377,3.0219260135201136,134.2832133429391,4.412660676925772,131.3994997126685,133.98747052093069,-4.601331692609275,-3.031913585147433,25445000,2.0379906720993946,0.7945683935400918,-1234779900.0,-48.28799618914444,70.74152269624075,78.01649708558223,-34.62487715479625,16.09459453635745,26.12023045608737,-0.22256558563198708,5.924287762922365,137.70303924560548,134.80347915649415,132.45999908447266,130.11651901245116,127.21695892333985,0.02,1.0,204.79642655400784,0.03314157803024509,-0.0073995894894675245,130.26374162946428,133.73945944649833,4.860977386779073
2022-10-19,0,133.83499908447266,126.87249755859375,145.0275001525879,133.45437240600586,138.71500205993652,-0.33862022320584717,4.7593095649922805,-0.577154415974626,2.995117955510902,137.3787498474121,3.8691511154174805,0.03497422183151566,128.90924835205078,140.99699935913085,0.8067374183205146,-0.07064179369983589,0.9834987371342874,1.0087697841355001,1.028021239870894,0.04611715048930609,44.912835798023146,145.59911830219522,136.0804991722107,126.56188004222616,130.67464092799597,3.0227969907087653,134.00696332114083,4.301801475541207,132.2359922911391,134.0323781273336,-0.33460228518523416,-2.4252093433619972,30691000,2.1502263336873777,0.9699666211512519,-1265470900.0,-46.12287704228436,70.74152269624075,78.01649708558223,-25.306251576361117,15.154054746530942,24.59381014100012,-0.19458848383599975,5.842552829667147,137.70303924560548,134.80347915649415,132.45999908447266,130.11651901245116,127.21695892333985,0.02,0.0,204.4839846571325,0.04494121359019276,0.036486877582829265,130.18390764508928,133.51278250558036,4.645223165305923
2022-10-20,0,133.1349983215332,126.87249755859375,142.4550018310547,133.45437240600586,138.27687549591064,-0.5178510371690122,4.311324569095403,-0.6959301570283531,2.995223260917762,136.7599983215332,3.590038576126099,0.03181299262662564,128.90924835205078,140.64599990844727,0.8136188718497487,-0.060510355100096606,0.9823947726666806,1.006693773798357,1.0134584852110908,0.049360585496846854,44.23245937138747,144.14352325699573,135.52087411880493,126.89822498061413,131.1292839050293,3.1333894207933564,133.72696317945207,4.214842268681583,132.62562381457684,134.03965850880985,0.0037368812593295544,-2.8085912182553416,26356300,2.099366474712214,0.8437205938821349,-1291827200.0,-54.68278084891417,70.74152269624075,78.01649708558223,-36.32793081437471,14.137742246924754,24.062176344194448,-0.23870753990560928,5.815228105292937,137.70303924560548,134.80347915649415,132.45999908447266,130.11651901245116,127.21695892333985,0.02,0.0,204.21428660802812,0.009517232071867943,0.03160784747798665,130.61017717633928,133.21696254185267,4.355234870355181
2022-10-21,0,127.96999740600586,126.87249755859375,140.83499908447266,132.9331226348877,138.07250118255615,-0.5499592126131723,4.031237674220261,-0.7519334287056174,2.995284206117991,135.84999656677246,3.380638265609741,0.029848887022854365,128.90924835205078,138.91949958801268,0.8113769913609246,-0.05467391495718335,0.9475407563573313,0.9717352341195288,0.9649410504792154,-0.008119058472353502,43.554284097173884,143.11734929176936,135.05487394332886,126.99239859488834,131.1342833382743,3.1274657180122785,133.01999868665422,4.2961974569495345,132.74274544400743,134.0225840506625,2.4489724329206304,-2.8601670679026965,46348600,2.082448937008082,1.4497492655633017,-1338175800.0,-62.336377151769625,70.74152269624075,78.01649708558223,-115.75108433871699,13.083746015293999,29.454170021169876,-0.15498874184084185,5.834854408833253,137.70303924560548,134.80347915649415,132.45999908447266,130.11651901245116,127.21695892333985,0.02,0.0,203.71399611139705,0.025638916288690083,-0.0021491167591323967,130.9680121285575,132.60393524169922,4.256165423916872
2022-10-24,0,128.7549991607666,126.87249755859375,140.625,131.73374605178833,137.91375064849854,-0.4554729851917472,4.083673341573339,-1.0493464101846113,2.995268475530014,135.00874710083008,3.482963190078735,0.030381846631395946,127.96649780273438,138.71200256347657,0.748289412929891,-0.0775607451289192,0.9579156583618412,0.9831196408482674,0.9723963562780843,-0.02699738552945774,34.76554980459969,142.57897054255224,134.41162385940552,126.24427717625882,131.40321213858468,2.75917158980881,132.17214148385185,3.8253725201134055,131.533923183701,133.33742670854681,0.027354541242964235,-7.178996411236414,63563400,2.313216670559483,1.8904512928496227,-1274612400.0,-61.997869253456415,70.74152269624075,78.01649708558223,-91.54815565829425,15.672418909573773,26.358052227307603,-0.08996925063168794,6.054507394562222,136.9848773803711,134.2225576477051,131.98999786376953,129.75743807983397,126.99511834716797,0.02,0.0,203.04513298800146,-0.032229193385540866,0.02335118450069554,130.88675035749162,131.8511962890625,4.33377189957235
2022-10-25,0,134.33250045776367,126.87249755859375,140.625,129.7187476158142,137.74374961853027,-0.26020787846032,4.134620671997652,-1.2411300616024268,2.9952542158758844,134.30874824523926,3.5498756408691405,0.030875453221379398,127.96649780273438,138.19025001525878,0.8005786748038071,-0.05649798398142982,1.0031335793594571,1.0296972585069901,1.020023480047019,-0.0033386897920926195,38.02370319095559,142.1821151843273,133.91287384033203,125.64363249633674,132.1624982016427,2.7243243222571727,131.90642711094446,3.5009364792809095,130.83707098720674,132.7993874587419,1.4837743706459727,-8.440889485677083,38433200,2.29552619740629,1.1302640724614517,-1236179200.0,-20.824539232108624,70.74152269624075,78.01649708558223,29.323421249399996,19.699824890229973,23.753589497872028,-0.004145955835361121,6.238471510660593,136.9848773803711,134.2225576477051,131.98999786376953,129.75743807983397,126.99511834716797,0.04,0.0,202.68014556912559,0.035466803633205535,0.025887730137840587,132.41931370326452,131.7464109148298,4.409921234680313
2022-10-26,0,131.39500045776367,126.87249755859375,140.625,129.7187476158142,137.74374961853027,-0.20180194444492902,4.094735292712954,-1.2042198945824334,2.995262937144198,134.08374977111816,3.448500747680663,0.03060197353933221,127.96649780273438,138.19025001525878,0.7754955774838551,-0.02750981300892893,0.9819795517343348,1.0038102850750037,0.9984005347031366,-0.018231394204806795,50.710544047386556,141.9957196317516,133.8062490463257,125.6167784608998,132.02928461347307,2.737677413130874,131.3839269365583,2.9020689526831736,131.71424589017857,133.0192848217181,4.119598134458002,-2.694627895528651,82791500,2.623937961252203,2.2676150908844157,-1318970700.0,-53.91905708057641,70.74152269624075,78.01649708558223,-45.48081825916236,17.735969365956997,23.67246864390105,-0.11545556941522198,6.434294678690517,134.616484375,132.30676330566405,130.44000244140625,128.57324157714845,126.2635205078125,0.04,0.0,201.85902218786939,-0.025594781221136564,-0.022439669267718346,131.81769452776228,131.08705139160156,4.117241011508901
2022-10-27,0,98.70000076293945,126.87249755859375,140.625,129.7187476158142,137.21687507629395,-0.037281703675127946,4.001031883349092,-1.1468840197529082,2.9952826665639387,133.83249855041504,3.38643814086914,0.02997715326676247,127.96649780273438,138.1182518005371,0.7466270869748807,-0.04580526105075854,0.7394954943032273,0.7520444217316307,0.7527599397081299,-0.25864722268918405,45.24573715819826,141.47143785117086,133.46937408447266,125.46731031777448,126.87464223589215,12.663845392385188,128.77428436279297,9.061970683378057,131.64284291940703,132.68662552366112,-0.7046873464474573,-5.273594036850838,232316600,2.694302374738357,5.031008439384633,-1551287300.0,-96.28304775069245,70.74152269624075,78.01649708558223,-421.629380046609,12.67053181489678,44.37004086808768,-0.19439842699502485,8.363274438111917,128.4450840148926,122.31746272277832,117.3650016784668,112.41254063415526,106.28491934204101,0.02,1.0,198.64074171884457,-0.2553790143605068,-0.26488031844081156,126.84790693010602,128.55582427978516,8.860620476914745
2022-10-28,1,99.28499984741211,98.70000076293945,140.625,128.95187330245972,135.68999767303467,-2.764993811285474,8.470818582043954,8.414518275126868,2.993515715543487,133.4824981689453,5.15565010070801,0.06440744329509347,127.8287509918213,138.1182518005371,0.19297650812537495,-0.2798511506828101,0.7549085056880727,0.7730971452568282,0.7991998754564541,-0.22415408408258286,19.392217850679696,148.46088631722506,131.5192491531372,114.57761198904932,121.93892805916923,15.834828487429894,126.30678449358258,11.852844341798358,123.41811800200007,128.06333811277835,-26.770906710813463,-27.01593293037951,95928300,7.715797474496438,1.9452138739013494,-1455359000.0,-93.28091708320504,70.74152269624075,78.01649708558223,-297.16765477557465,12.292889806516481,43.047602979123894,-0.14944144252275424,8.004468844229073,128.4450840148926,122.31746272277832,117.3650016784668,112.41254063415526,106.28491934204101,0.02,0.0,197.3729567533557,-0.23698173626715335,-0.24579945323753385,121.99644688197544,126.09017726353237,11.344867393973455
2022-10-31,1,95.82500076293945,98.70000076293945,140.625,128.55874872207642,134.89562225341797,-2.0786293468184684,10.890750639316357,3.388335115921235,2.991966798805674,132.7312469482422,6.888024978637693,0.08401363652055781,124.11374778747559,138.1182518005371,0.5369313146851582,-0.27985203454301855,0.7392150504866513,0.7638394972004139,0.8086941532816754,-0.25575704720179415,19.97678462849557,151.4122504088818,129.63074913024903,107.84924785161627,116.60892840794155,17.617101988769836,123.86910615648542,14.301761601110956,117.40460578509956,124.15684185144733,-25.81536927814646,-25.81259708658371,121361400,7.711569985977903,2.247560070748434,-1576720400.0,-98.77594514841462,70.74152269624075,78.01649708558223,-242.23550062865365,11.54718067582568,44.86854445264501,-0.24107136087158237,7.912721153202596,127.55300430297852,120.87350318908692,115.47500228881836,110.0765013885498,103.39700027465821,0.04,0.0,195.74860194018845,-0.28183779009077903,-0.2834396818388914,116.52625928606305,123.56821823120117,13.743861349849196
2022-11-01,1,95.14249992370604,95.82500076293945,140.625,127.96124839782715,134.44499969482422,-1.6432713745142677,12.959118322871431,1.2689843680334318,2.9902378104389444,131.86124801635742,8.94319976806641,0.10161733029684408,99.22649993896485,138.1182518005371,0.6443274111055095,-0.31857777235243057,0.7460481954973364,0.781127493654405,0.8501887678173536,-0.2917387854801349,17.620464896678723,153.44686079888004,127.5286241531372,101.61038750739436,111.91928591047015,18.438899690182645,121.52678462437221,16.150496117974047,112.02582340203244,120.40495557052536,-28.024184496165834,-26.261516616107123,110189600,7.632961382582117,1.907288711489297,-1686910000.0,-94.31694417368665,70.74152269624075,78.01649708558223,-176.8833379363403,11.080749824872347,43.05614764708552,-0.2292957016975634,7.656812075828869,127.55300430297852,120.87350318908692,115.47500228881836,110.0765013885498,103.39700027465821,0.04,0.0,194.3232935015479,-0.3076866924471282,-0.2661116425755336,111.5636008126395,121.26580647059849,15.137019815893467
2022-11-02,1,92.60750007629395,95.14249992370604,138.71000289916992,127.6693754196167,133.9593744277954,-1.335057442667327,14.374783556189628,0.07798997620505954,2.988759187210158,130.67374897003174,11.206549530029294,0.1147646084876575,98.41250076293946,135.51674728393556,0.7245155004224101,-0.31082378973979713,0.7393546795144791,0.7858915911835179,0.8898620610649127,-0.295197688240336,17.601155724077056,154.00406626170178,125.25449914932251,96.50493203694325,106.7553574698312,17.994438324041102,119.07928480420794,17.791064351692366,107.80602979629289,116.91832035856217,-25.652495231479286,-25.632157812624264,71821100,7.641826645065189,1.1977172013203037,-1758731100.0,-99.87466564622657,70.74152269624075,78.01649708558223,-153.42147721173285,10.579102049162934,44.051511879458715,-0.29203729115352645,7.4470393197747375,127.05268545532226,120.06366505432129,114.41500473022461,108.76634440612793,101.77732400512696,0.06,0.0,193.38524094238056,-0.30257288287987993,-0.34157514187667487,105.97793579101562,118.43234307425362,16.601929199960697
2022-11-03,1,89.46500205993652,92.60750007629395,138.71000289916992,119.97562313079834,133.83124828338623,-1.063471792187084,15.702648370503086,-0.6678435961801723,2.987152795655145,129.4849977493286,13.335124397277834,0.12768223454480576,95.75675067901611,134.8277473449707,0.758444602499103,-0.3323661009248805,0.7274627252066761,0.7867493204006173,0.9289081506437856,-0.09356634885124082,16.382002029316876,154.38754581022002,122.98224906921386,91.57695232820771,100.34571484157017,14.104797103915734,116.25410652160645,19.17787272226367,103.99903685260844,113.44221936772617,-28.074637350071367,-27.007427253077555,60664000,7.610900227392487,0.9914583470720363,-1819395100.0,-98.99879860721545,70.74152269624075,78.01649708558223,-135.98288863905668,10.351356794184623,45.195322760936754,-0.3121469429253175,7.06725058871246,126.56416552734375,119.27292517089843,113.3800048828125,107.48708459472657,100.19584423828124,0.08,0.0,192.58458363385793,-0.09219923149613773,-0.3151286559219508,99.049318586077,115.73431614467076,17.74420111368312
2022-11-04,1,90.15499877929688,89.46500205993652,135.2349967956543,99.13875007629395,133.30874824523926,-0.8510141041533843,16.861573796825244,-1.1285814218689916,2.985488758473913,128.886248588562,15.209499073028564,0.13990685307765788,94.88899993896483,134.37750015258788,0.7897386035094534,-0.3384478561039798,0.7480501120723613,0.8244796870883352,0.9543746177907779,-0.0919575069964933,15.572117963901004,154.24314662090265,120.5199990272522,86.79685143360174,94.45428603036063,3.8837660112072308,113.24178532191685,19.762148962698607,100.33984484984612,110.05274195443417,-33.400329961053785,-30.65669119657417,55638100,7.6088510694016325,0.8929556171137482,-1763757000.0,-94.62792667524835,70.74152269624075,78.01649708558223,-111.85759110174554,10.969596671975726,43.62825298288478,-0.26066759305126214,6.798161471010805,126.48864379882812,119.15068237304688,113.22000122070312,107.28932006835937,99.95135864257813,0.1,0.0,191.86682108142517,-0.08477815186227666,-0.07300380786123295,93.48503766741071,112.65136609758649,18.606678961763993
2022-11-07,1,95.36999893188477,89.46500205993652,134.78249740600586,97.98125076293945,132.52937126159668,-0.6276495244220806,17.73435252242407,-1.480907296283132,2.9840648229610123,128.36249828338623,16.66819916725159,0.14995309432480974,92.36224994659423,133.88474922180177,0.8218464294564177,-0.3263468570904586,0.806402513286408,0.9034137210056222,1.029480009520869,-0.004748258047816867,17.037555943915752,153.73470417128246,118.26599912643432,82.79729408158619,93.9785714830671,3.4576036208354344,110.42660685947963,19.258361153089343,97.76807942969545,108.14052017780774,-31.386279184742047,-31.869791393253955,81987300,7.637725679449444,1.257358893469332,-1681769700.0,-82.82928132514026,70.74152269624075,78.01649708558223,-79.074745851064,16.074020579189586,40.815646968919005,-0.18979803075240542,6.747578245834195,126.48864379882812,119.15068237304688,113.22000122070312,107.28932006835937,99.95135864257813,0.1,0.0,190.8832121391743,0.03821387278635724,-0.024999926786099348,93.3111103602818,110.07950864519391,18.802211244083995
2022-11-08,1,96.2450008392334,89.46500205993652,134.78249740600586,95.71125030517578,131.62812423706055,-0.4111465295294553,18.025225899800237,-1.7181130095483679,2.9834083914396072,127.95249938964844,17.419399223327634,0.1549317623582948,92.36224994659423,133.88474922180177,0.8579598471886806,-0.26611645963268504,0.8272521898526247,0.9414762688731314,1.0399468479798417,0.011587890967879266,27.107122899841652,152.39345097181118,116.3429991722107,80.29254737261022,93.54428591047015,2.810350782479309,107.74160698481968,18.342330503959072,97.14980166928855,107.0583295870255,-3.3738620114631845,-29.241555270636265,52088300,7.806791132930787,0.7905784980218197,-1629681400.0,-83.32669467855148,70.74152269624075,78.01649708558223,-67.8192023660355,16.554770678787094,39.46155027784052,-0.17000516222077772,6.48060851694515,126.48864379882812,119.15068237304688,113.22000122070312,107.28932006835937,99.95135864257813,0.1,0.0,190.27374672291012,0.01334033060924078,0.03553021933134832,92.92190987723214,107.4591783796038,19.060048931568826
2022-11-09,1,102.20750045776367,89.46500205993652,134.78249740600586,95.71125030517578,131.62812423706055,-0.2059232001466181,18.248392670341556,-1.8489064152429866,2.982863743674347,127.40374946594238,17.91236170768738,0.1591555099399195,92.36224994659423,133.88474922180177,0.8699018552060017,-0.2477039136584051,0.8914147754765223,1.0384935856310795,1.1017479026443417,0.10366331424086428,28.954420618743736,151.1544096807405,114.65762434005737,78.16083899937423,94.45607158115932,4.30926489115287,105.53249999455043,16.85050560269744,96.91978969496984,106.30581152654169,-3.0618915373427877,-28.08682220822789,107677300,7.829627318276642,1.5484243833199969,-1522004100.0,-73.37842761032715,70.74152269624075,78.01649708558223,-41.026539141080534,22.709885013849128,35.872120122610625,-0.204629123711406,6.619850790814014,126.48864379882812,119.15068237304688,113.22000122070312,107.28932006835937,99.95135864257813,0.1,0.0,189.11757776941752,0.12072020739476264,0.06586141779960804,94.10661860874721,105.31643894740513,19.022161357996097
2022-11-10,1,109.0875015258789,89.46500205993652,134.78249740600586,95.71125030517578,131.62812423706055,-0.03134287822580572,18.173742500725332,-1.8720682602896899,2.982798756594532,114.53999900817871,17.870999050140387,0.16030292171828528,92.36224994659423,133.88474922180177,0.8819996612593588,-0.19440775247164185,0.9622148666873852,1.1422745097212132,1.1520670543917249,0.21933157116339652,38.64549011106514,149.71873429573168,113.371249294281,77.02376429283032,96.44821466718402,7.038533266291442,104.18375028882708,15.627744049266537,98.26060015939034,106.38986868869976,6.660578809296149,-23.230178580899363,80671000,8.013203680601185,1.1226574713897761,-1441333100.0,-52.68602907245037,70.74152269624075,78.01649708558223,-10.801178594116967,28.14283064993826,31.71508757510029,-0.17320286044726943,6.952718511560188,126.48864379882812,119.15068237304688,113.22000122070312,107.28932006835937,99.95135864257813,0.1,0.0,188.3430655722909,0.2582385946894308,0.23558653852486725,96.48316410609654,104.02338245936802,18.599484217263953
2022-11-11,0,111.48999977111816,89.46500205993652,134.78249740600586,95.71125030517578,131.62812423706055,0.09423643387906612,17.924773102759072,-1.820087184823953,2.983035117099565,105.64750099182129,17.321199045181277,0.15935681427792453,92.36224994659423,133.88474922180177,0.8770831511941062,-0.15447514327050196,0.9911808135879381,1.1548700463134887,1.130581157153307,0.23664800932503183,46.825964650202074,148.33154569816338,112.48199949264526,76.63245328712713,99.14571462358747,8.73512422812661,102.95053604670933,14.151071066109946,100.98784583411827,107.34636850932962,14.656963621257843,-14.755408504244265,59961700,8.188130569688779,0.813842310578856,-1381371400.0,-50.3979397906395,70.74152269624075,78.01649708558223,1.9488819481372248,28.594865346947735,29.71307334151533,-0.1388235825940367,6.891096042859983,126.48864379882812,119.15068237304688,113.22000122070312,107.28932006835937,99.95135864257813,0.02,1.0,187.79510436048724,0.24485071268676095,0.2711730486235517,99.68800789969308,102.83297184535435,18.293036648774585
2022-11-14,0,113.06999969482422,89.46500205993652,134.78249740600586,95.71125030517578,131.62812423706055,0.20908737077980435,17.51877636707382,-1.719715379340682,2.9834837490481085,105.64750099182129,16.368749122619626,0.15697037163620747,92.36224994659423,133.88474922180177,0.8599745237312241,-0.15746913151568345,1.0131209795200438,1.1566139283960064,1.0990474276771147,0.18559296383741342,48.673063135640696,146.64317731453093,111.6056245803833,76.56807184623568,102.51785714285714,8.92920745361344,101.43178599221366,11.396929377861852,103.61402490883759,108.37489347744346,20.389816893089677,-13.409187606060206,53395000,8.165179256682894,0.713203453590384,-1327976400.0,-44.94310748764042,70.74152269624075,78.01649708558223,12.774343454040473,28.3906217655324,28.003204111119622,-0.1410289671954376,6.789588722977007,124.34944146728516,117.42028048706055,111.81999969482422,106.21971890258789,99.29055792236329,0.04,0.0,187.32343717150874,0.18093463534579524,0.25806803920366644,103.29630715506417,101.1728128705706,17.54348347130579
2022-11-15,0,116.57500076293945,89.46500205993652,134.78249740600586,95.71125030517578,129.41499948501587,0.31291090491750484,16.870620035393642,-1.5732546314648337,2.984230516194677,105.64750099182129,15.298024368286132,0.15247831482827862,92.36224994659423,133.88474922180177,0.8353341060565297,-0.1610928579678784,1.0536162648525653,1.171796475026706,1.0954237949773935,0.21123174966422487,49.82722266029609,144.38398985716424,110.64274978637695,76.90150971558965,106.29214314052037,8.40070285542686,100.3732145854405,8.789874833842637,105.97941222658297,109.1990374182516,26.384616432550544,-15.828262475933537,50670500,8.147465592063993,0.6655986368170014,-1277305900.0,-5.415973735966211,70.74152269624075,78.01649708558223,31.249778607036415,29.669654548131064,26.6390302871952,-0.12148373764473952,6.627475000143439,111.50659750366209,107.03169728088378,103.41499710083008,99.79829692077637,95.32339669799805,0.06,0.0,186.89927049014508,0.2136416246354087,0.21050451230772002,107.04431915283203,100.26467841012136,16.842504960732388
2022-11-16,0,114.11750221252441,89.46500205993652,134.33250045776367,95.71125030517578,128.16624784469604,0.36791943921541975,16.012877548057517,-1.4351373289232905,2.985219190319606,105.64750099182129,14.296612052917478,0.14592664703317967,92.36224994659423,133.20499839782715,0.8122944328096701,-0.1289647583935739,1.0399620190498027,1.1229025865304423,1.0328684336067473,0.11652766872703668,54.11371855836706,141.75813005033865,109.73237495422363,77.70661985810861,108.97035789489746,7.2475745527806374,101.47446468898228,9.501141500418067,108.70380230978171,109.99932205376936,29.305088282813717,-11.278967725707373,33287800,8.213477021390773,0.43651808902856176,-1310593700.0,-17.977142683610108,70.74152269624075,78.01649708558223,25.00773040885671,28.22183037377852,27.271149107620516,-0.12420816774312138,6.46979808106436,111.50659750366209,107.03169728088378,103.41499710083008,99.79829692077637,95.32339669799805,0.06,0.0,186.61255202860298,0.11589626510310524,0.17373279175121473,109.39805276053292,101.35458156040737,15.959838617335832
2022-11-17,1,110.99750137329102,89.46500205993652,134.33250045776367,95.71125030517578,119.42374992370605,0.43409737959524297,15.078293693824174,-1.247809469623607,2.986261597171588,105.64750099182129,13.246249866485595,0.13865543882778064,92.36224994659423,131.56900024414062,0.7881464511286118,-0.14284370262340632,1.020699528356084,1.069564198998563,0.9834275489331211,0.017508878842174225,51.228709370452364,138.90308749827457,108.74650011062622,78.58991272297786,111.0778579711914,4.587078298065116,102.31107194083077,9.804346270235904,110.10383182525004,110.2119025778845,19.657652815986193,15.620568723819128,35093800,8.220502369346468,0.45757954375432114,-1345687500.0,-23.784667382062306,70.74152269624075,78.01649708558223,18.106865128562337,27.116006856559366,29.469753001011963,-0.10073958884909966,6.252669665221156,111.50659750366209,107.03169728088378,103.41499710083008,99.79829692077637,95.32339669799805,0.06,0.0,186.3011629085074,-0.003754333967404433,0.09835418857583479,111.53366524832589,102.22778756277901,15.073175837121
2022-11-18,1,112.69750213623047,89.46500205993652,134.33250045776367,95.71125030517578,114.73187685012817,0.5141333748545138,14.022951788922315,-0.9902737888604967,2.9873907548214014,105.64750099182129,12.139375019073489,0.13027685440776673,92.36224994659423,129.01899929046633,0.7825187613145372,-0.13262871279794441,1.0469889862645674,1.063871479905211,0.9951214249625878,0.010830588999831692,48.94665711808516,135.68552884105875,107.63962526321411,79.59372168536947,112.5764296395438,2.396793321797542,103.51625061035156,9.981144181943392,110.35572186966114,109.69321292683341,15.328069411833695,11.796849014331944,33357700,8.178557830303127,0.43865806613147396,-1312329800.0,-21.827061921556894,70.74152269624075,78.01649708558223,30.56906613184899,28.27704692813119,28.18672212117579,-0.13562134208049173,6.070335897165224,111.50659750366209,107.03169728088378,103.41499710083008,99.79829692077637,95.32339669799805,0.06,0.0,186.01199607294598,-0.008582543950202415,0.0016090393225428492,113.041994367327,103.57430648803711,14.200895897219594
2022-11-21,1,110.73500061035156,89.46500205993652,134.33250045776367,95.71125030517578,113.33187532424927,0.6001046430694634,13.291838038621139,-0.6647774282632115,2.9881482801906256,105.64750099182129,11.375750255584716,0.12436691096665146,92.36224994659423,129.01899929046633,0.7451643196563573,-0.12471358105859916,1.0361072653596926,1.0235636377399548,0.97571183220249,-0.02065091616498471,50.86139353485476,133.4596765769676,106.87600049972534,80.29232442248306,112.81178665161133,2.0533793443088157,104.63000065939767,9.843883739293938,110.95724976359693,109.32138948140481,10.26343627569847,17.607619346679407,24351100,8.190982794102124,0.3286946290146767,-1336680900.0,-28.97225713323458,70.74152269624075,78.01649708558223,27.521200848060275,27.181709666952102,28.83678190311496,-0.1554124736251573,5.863883352191378,111.50659750366209,107.03169728088378,103.41499710083008,99.79829692077637,95.32339669799805,0.06,0.0,185.79704469586522,-0.038172015194028575,-0.027959710699427927,112.75543975830078,104.61930193219867,13.19249752176898
2022-11-22,1,110.31000137329102,89.46500205993652,134.33250045776367,95.71125030517578,112.7906265258789,0.6901168145495508,12.356019688708084,-0.1945221804159556,2.989078340488627,105.64750099182129,10.474750328063967,0.1165937213681776,92.36224994659423,118.0570007324219,0.6581099673478557,-0.17566485971004125,1.0409058813652265,1.0053567114222381,0.975983083210324,-0.053742220447320466,46.462720324631846,130.68703994962075,105.97500057220459,81.26296119478843,112.64321545192173,2.221527089850121,105.8944650377546,9.302871010470183,110.89370546263164,108.57448719977613,1.510254668434054,16.388575767032624,29029000,8.05166833551914,0.3943404557730178,-1365709900.0,-23.817275885613363,70.74152269624075,78.01649708558223,39.965954115430335,26.05384374064681,28.734164729844302,-0.15929205771746535,5.680749042802737,111.50659750366209,107.03169728088378,103.41499710083008,99.79829692077637,95.32339669799805,0.06,0.0,185.54234860375695,-0.04817218259368261,-0.02433899944599653,112.53018842424665,106.10909816196987,11.038067937786245
2022-11-23,1,111.84000015258789,89.46500205993652,131.39500045776367,95.71125030517578,111.79187536239624,0.4819082119945432,10.58115036285658,-0.21997991796189398,2.99069327613689,105.64750099182129,9.273625373840332,0.1009903499364366,92.36224994659423,114.36325206756592,0.5552123871346981,-0.16047033000506236,1.0674416641832638,1.0064002263538347,1.0006128450499967,-0.01995751760930642,46.853209979496704,125.93617634369411,104.77387561798096,83.61157489226781,112.46750123160226,2.230768824201073,107.4926791872297,8.108525489607016,110.69819675272522,107.59056108723328,-1.0583894521926718,19.115623769579145,21343100,8.043363688783145,0.30256032483511336,-1344366800.0,-21.207176758251766,70.74152269624075,78.01649708558223,63.48640346660159,26.772347678930938,27.998654398585956,-0.12069277989748611,5.413552309031308,111.50659750366209,107.03169728088378,103.41499710083008,99.79829692077637,95.32339669799805,0.06,0.0,185.35970413056464,-0.008743254183910198,-0.041339285014665904,112.24791063581195,107.77210889543805,9.53803992735157
2022-11-25,1,111.6150016784668,89.46500205993652,116.57500076293945,95.71125030517578,111.5774998664856,-0.1809734735909624,8.835555405247893,-1.5356874308754358,2.9920840188667306,105.64750099182129,8.295875358581545,0.0851241349707582,92.36224994659423,113.17474994659425,0.9114000645330197,0.1331306918751548,1.0753291708177166,0.9957445733973329,1.0026860518369636,0.005563191040662163,64.41489131261119,121.46723641321798,103.79612560272217,86.12501479222637,111.75892993382045,1.3037553056488393,109.02553653717041,6.43446053338107,110.9042092559855,106.85298314115178,-1.0878213014558196,25.00977765323403,12007600,3.0513813364679656,0.20171962977301502,-1356374400.0,-28.588121591841624,70.74152269624075,78.01649708558223,56.60392324826131,26.220503036869815,27.33447878191437,-0.05285686209596899,5.14901333518956,112.68895800781249,108.94551809692382,105.91999816894531,102.89447824096679,99.15103833007812,0.06,0.0,185.25712327554945,-0.0003588965248910725,-0.016073422404539177,111.43957192557198,109.241945539202,9.574630088378479
2022-11-28,1,109.99499893188477,89.46500205993652,116.57500076293945,95.71125030517578,111.67125129699707,-0.3510576217733082,8.911131405879118,-1.4902239538389597,2.9920490924564107,109.69875144958496,8.367437915802006,0.08532144171624924,92.36224994659423,113.17474994659425,0.9169637782683339,0.12418796243142738,1.0531695093458049,0.9790844518835781,0.9870377896268976,-0.02398015176129531,63.60539938751144,122.26413846025677,104.44187564849854,86.6196128367403,111.17000089372907,0.9415762376571923,110.07017939431327,5.0946270255496575,111.06516697721699,107.17801939412071,-4.254770793061404,23.803453152614296,23309400,3.058223225389635,0.41701940988177166,-1379683800.0,-41.58664030729099,70.74152269624075,78.01649708558223,37.38909603331304,24.861140777107735,29.656889607163247,-0.07361130591952966,5.042655500368246,113.08779858398437,109.591099029541,106.76499938964844,103.93889974975585,100.4422001953125,0.06,0.0,185.05344714165324,-0.02918343397127554,-0.023956960404356752,110.80516161237445,110.10160718645368,9.534372192813892
2022-11-29,1,109.6200008392334,89.46500205993652,116.57500076293945,95.71125030517578,111.67125129699707,-0.5103140021120327,8.906946347683048,-1.384425293275978,2.99207349656978,110.15250015258789,8.280150299072266,0.08484634233371026,92.36224994659423,113.17474994659425,0.9100953539658694,0.1478737078646139,1.0442250076252702,0.9770467106859091,0.988466986142817,-0.0100690817263962,61.488111681729485,122.79126829808824,104.97737560272216,87.16348290735608,110.97321510314941,1.1121350652904136,111.02553653717041,3.2070489160465616,110.77384648872834,107.3700762123942,-3.6125074600407814,15.335011181498993,23899200,2.9539301312205986,0.468408512149532,-1403583000.0,-51.55554877387145,70.74152269624075,78.01649708558223,32.80557483706005,23.983100969064704,28.609474692003573,0.013001570052740814,4.853894500493202,114.49199786376951,111.86399786376951,109.73999786376952,107.61599786376952,104.98799786376952,0.06,0.0,184.84551586500277,-0.0036409780348559684,-0.02311472725411933,110.52145821707589,111.02756173270089,9.160256472299974
2022-11-30,1,113.78750038146973,89.46500205993652,116.57500076293945,96.02625036239624,111.67125129699707,-0.7194989141675912,8.703294684582513,-1.0945572625038267,2.99226542669258,110.15250015258789,7.847737817764281,0.08236520710320241,92.36224994659423,113.17474994659425,0.9001865985137381,0.15216649685615516,1.076848638858314,1.0173200270624965,1.0281135907481906,0.031524784379349136,60.900994243947075,123.07371497570188,105.66712560653687,88.26053623737187,111.1289291381836,1.4258549628827075,111.8526793888637,2.038088953461889,110.45559304044976,107.59392681845483,-1.2410194076576582,13.896825687955943,43348600,2.9468943157789296,0.909155353766185,-1360234400.0,-4.529366695337549,70.74152269624075,78.01649708558223,75.55903495602706,31.09806797655507,25.114912165887073,0.07751924862033659,5.134331067705922,115.40531851196288,113.34233891296385,111.67499923706055,110.00765956115723,107.9446799621582,0.06,0.0,184.4989829969337,0.05976307410931536,0.07500459288909411,111.38397107805524,112.21298272269112,9.195176219756785
2022-12-01,0,119.80999946594238,89.46500205993652,116.57500076293945,100.7168755531311,112.05437564849854,-0.9582615038374054,8.522727573822266,-0.6556000287125698,2.9924459083929253,110.52250099182129,7.354625263214109,0.07995100837597874,92.36224994659423,113.8205005645752,0.8504841731439013,0.22870718125126807,1.1239277787371087,1.0738405276030414,1.0757689268722623,0.0712625116459289,69.34151196312702,123.64483077706959,106.59937562942505,89.55392048178052,112.42535754612514,3.5505654545694347,112.61857209886823,2.7936733022852307,111.24899705892159,108.48382925548661,0.9671893560885237,11.329892495014478,36551400,2.932241038769138,0.7960389920027824,-1323683000.0,-5.90057972748624,70.74152269624075,78.01649708558223,118.04940527470072,34.07024202151936,24.000233401387945,0.17491172153628345,4.98902159560902,118.16031759643556,116.27983799743653,114.7599983215332,113.24015864562989,111.35967904663086,0.08,0.0,184.22951460053017,0.073057781054497,0.08076095360338499,112.89230128696987,112.82387052263532,8.809918900227416
2022-12-02,0,120.74250030517578,89.46500205993652,119.80999946594238,107.3675012588501,112.7906265258789,-1.0786656816469495,8.350110502128905,0.006320986922534466,2.992648202318578,110.86625099182129,6.635500192642214,0.07734484186946496,94.84849891662597,114.36325206756592,0.7505000453029903,0.3391828838910261,1.118405509800938,1.0767049405113356,1.068844027848487,0.08177662939075958,78.04638450870922,124.65972160316527,107.95950059890747,91.25927959464967,113.91571453639439,4.560538610560151,113.27946499415806,3.5089945841900367,113.36399496432549,110.20888343293389,8.195239811776807,9.829263472057585,39950500,2.9460400736052064,0.8901444088044541,-1283732500.0,-3.4987468768989456,70.74152269624075,78.01649708558223,145.31201455425867,34.98104587931983,21.835450190205933,0.25045694149680753,5.091948647033337,120.3300806274414,118.03496044921874,116.18000030517578,114.32504016113282,112.02991998291016,0.1,0.0,183.94528038652908,0.10842827171139424,0.10023164079166577,114.61019897460938,113.57019369942802,8.143864651068075
2022-12-05,0,122.54999923706055,90.15499877929688,120.74250030517578,109.48687601089478,113.2493748664856,-1.0878466816739383,7.63849271261575,0.6045775340036834,2.993230997714583,111.24375057220459,5.455187702178955,0.0697430359223795,96.15750064849854,116.89850063323975,0.6937419498051772,0.339276822583719,1.1189392096901052,1.0834082813820227,1.0675924005658173,0.11414155577155438,78.68764352101641,124.80036093640093,109.52337551116943,94.24639008593793,115.44571440560478,5.456602413605429,113.95660781860352,4.292651813235953,115.20603345049986,111.95468843295674,9.457437042885172,8.29895107458284,35474900,2.942605793079162,0.8085860110009035,-1248257600.0,-13.70029402336049,70.74152269624075,78.01649708558223,161.80723523050352,34.21664851464606,20.79260559365011,0.2017354526701493,4.965380863886603,120.81139852905275,118.42429875183106,116.49499893188477,114.56569911193849,112.17859933471681,0.12000000000000001,0.0,183.69948280167625,0.12548263999994935,0.09891389333515224,116.06292833600726,114.1554194859096,7.201338976036392
2022-12-06,0,117.08000183105469,95.36999893188477,122.54999923706055,109.90124940872192,113.8700008392334,-0.7705985855747332,6.74173020874078,0.6219402621169547,2.99385957951165,111.55250072479248,4.5720624923706055,0.060658094473642545,101.61125049591064,119.90324954986572,0.6871677503646886,0.28499528792684903,1.0534164957883771,1.026112957662223,0.9981074643685952,0.06805328347663475,79.14447656057388,124.62658595153917,111.14312553405762,97.65966511657606,116.22642871311733,5.202194905076603,113.99267932346889,4.318391501325778,117.04820178798566,113.78403635395276,9.576179425840992,8.384186404725245,43689200,2.818646774220648,1.0412639063650895,-1291946800.0,-64.52597190796004,70.74152269624075,78.01649708558223,60.3588170234003,30.156804864105766,28.7160441266887,0.07525846500005275,5.231425263932293,120.81139852905275,118.42429875183106,116.49499893188477,114.56569911193849,112.17859933471681,0.12000000000000001,0.0,183.36655630558232,0.04257270309607297,0.049089967209400405,116.44927760532924,113.94442476545063,6.284779166580439
2022-12-07,1,114.11249923706055,96.2450008392334,122.54999923706055,110.23125076293945,114.73187685012817,-0.719654439244063,5.796150835738034,1.269680787019829,2.9943794171341045,111.72750091552734,4.037237491607667,0.05164592189086894,108.39950141906738,119.90324954986572,0.6294133927548572,0.21647878653587263,1.0167860342817747,0.9945744438900118,0.9605914356157816,0.0028561911853346444,63.68589841891072,123.82092735049218,112.22862567901612,100.63632400754005,116.81464304242816,4.575168467085714,113.99232196807861,4.318380584410852,117.07330157339229,114.6113937469605,4.89629536388944,0.4331984257432491,29461100,3.212969998345947,0.7216171753171562,-1321407900.0,-65.68806645926536,70.74152269624075,78.01649708558223,17.453238335718364,28.882726705762703,28.713958865255155,0.05910213062974526,5.072037744161283,120.81139852905275,118.42429875183106,116.49499893188477,114.56569911193849,112.17859933471681,0.12000000000000001,0.0,183.137584227407,-0.03530910011542698,0.040836812064826804,117.18348257882255,113.99432209559849,5.009703766113324
2022-12-08,0,115.9124984741211,102.20750045776367,122.54999923706055,110.62875080108643,114.73187685012817,0.10483529488422019,4.494539085526437,0.49152316105365523,2.9949433290984366,112.26875114440918,3.3798998641967786,0.0397317856980143,109.56675090789795,119.90324954986572,0.613445529648901,0.11647871952622996,1.024668038581706,1.0069256529148032,0.9752101099558348,-0.032530681989771715,54.97685575898021,122.11107876996034,113.12200059890748,104.13292242785461,117.71357127598354,3.3908574043508355,114.34339318956647,4.255511853125719,116.37112957933527,114.97514497851705,3.7433522843393767,-0.004384056228771987,30619400,3.118559229115221,0.8281422420321527,-1290788500.0,-57.12536519605224,70.74152269624075,78.01649708558223,38.293415729647826,29.567836038379284,27.301998562714505,0.1406473160886997,4.953320478422562,120.81139852905275,118.42429875183106,116.49499893188477,114.56569911193849,112.17859933471681,0.12000000000000001,0.0,182.90643705172974,-0.04242780170724292,-0.02345470657131192,118.02033451625279,114.27089636666435,4.144514003011348
2022-12-09,0,115.65250205993652,109.0875015258789,122.54999923706055,110.93187618255615,116.07812404632568,0.8661870504569942,3.76355449246867,-0.25068775967200096,2.995190431598344,112.88375091552734,3.044199752807617,0.03306954939991062,109.95749912261962,119.90324954986572,0.6913800879494911,0.0625644262887723,1.0162138312990492,1.0011253394078783,0.9794460701415442,-0.04215581284447745,55.18015799321322,121.33435948466268,113.80725049972534,106.280141514788,117.98000008719308,3.0909698338961356,114.55446461268834,4.240854842645125,116.28245418729573,115.29457754609865,5.740282418092801,4.428024991572251,26033400,2.7691554421184956,0.760283069892517,-1316821900.0,-53.63912820510431,70.74152269624075,78.01649708558223,33.04954107032916,27.973524259827357,26.887693321413806,0.06358116139914127,4.861654598718612,120.81139852905275,118.42429875183106,116.49499893188477,114.56569911193849,112.17859933471681,0.02,1.0,182.7112019582878,-0.06146244560105918,-0.03769514405254457,117.70669337681362,114.54533222743443,4.123397798412916
2022-12-12,1,114.6875,109.6200008392334,122.54999923706055,111.36687517166138,116.07812404632568,0.8170503127380127,3.6211932404895952,-0.2787199646126881,2.9952330938853646,113.42875003814697,2.937399845123289,0.03172714207049982,110.27850112915038,119.90324954986572,0.7107013559721094,0.03733520761829501,1.0048363521518353,0.9893143263455975,0.9797200602722266,-0.06415748091398465,53.46598631596412,121.37788700740742,114.13550052642822,106.89311404544901,117.24821444920131,3.1902887706936247,114.83678599766323,4.096119790544383,116.14149442303437,115.21725844603922,1.6390215728567952,2.6220633711419845,24747100,2.729290521218595,0.7618948806671225,-1341569000.0,-60.91743127828071,70.74152269624075,78.01649708558223,2.713016456201757,26.80303885347681,26.869353000177888,0.03998194517834535,4.711536564990958,120.81139852905275,118.42429875183106,116.49499893188477,114.56569911193849,112.17859933471681,0.04,0.0,182.5232264537727,-0.06305645407895488,-0.07109886479742829,116.88979993547711,114.89105061122349,4.110999611238952
2022-12-13,0,121.05500030517578,109.6200008392334,122.54999923706055,111.46062660217285,116.07812404632568,0.7380307840312638,3.571103740345155,-0.28202295697991087,2.9952477055899958,113.94999980926514,2.8646997833251957,0.031244516442940885,110.27850112915038,119.90324954986572,0.7205833931575992,0.014305300340863292,1.059141717112287,1.0400316173283357,1.0481950659309358,0.03395113095280755,50.389785772637254,121.43758301856262,114.29537553787232,107.15316805718201,117.29285730634417,3.2489816009433334,115.60428592136928,4.188300460152043,115.7888499201223,114.96767423366204,-4.275519145961204,3.56933161860565,44701100,2.7216534660135516,1.3948913595159753,-1296867900.0,-27.74706193391328,70.74152269624075,78.01649708558223,123.50272512698793,34.35977040398121,23.564543175243454,-0.004886418526798662,4.988569952056288,120.82555795288087,118.44721781921388,116.52499771118164,114.6027776031494,112.22443746948241,0.04,0.0,182.21688490906877,0.05283909046152657,-0.018622866640477354,116.41363634381976,115.51191765921456,4.299715697103404
2022-12-14,0,121.12749862670898,109.6200008392334,122.54999923706055,111.46062660217285,116.70125102996826,0.5504897111858451,3.8474576527025866,-0.8000913498299673,2.995172868544936,114.11500072479248,3.1820497894287114,0.03354523050784478,110.27850112915038,120.77375030517578,0.6400569781099797,0.038430190975049704,1.056086961585513,1.0305302792524142,1.0416523219945533,0.06147441723342917,60.699984246777305,122.38954087379508,114.6946255683899,106.9997102629847,117.0896429334368,2.8900158265503824,116.26767866952079,4.280716706543157,117.10598357674422,115.54247024365303,0.2588152466696967,9.740729578566043,36922000,2.9742928889490665,1.1774021194003483,-1259945900.0,-18.907315272885544,70.74152269624075,78.01649708558223,128.40638287660428,33.221729139365685,21.956363376419542,-0.028176565063172194,4.971529241127317,120.82555795288087,118.44721781921388,116.52499771118164,114.6027776031494,112.22443746948241,0.02,1.0,181.97025099020536,0.06723423038516785,0.06545727773403591,116.29388100760323,116.17840467180524,4.53737889190793
2022-12-15,0,116.78000068664551,109.6200008392334,122.54999923706055,111.46062660217285,117.76250123977661,0.48532345035722363,4.0796347315598185,-1.0798931244466032,2.9951055502884656,114.11500072479248,3.455199661254883,0.03549908494807758,110.27850112915038,121.0622501373291,0.6961907931290024,0.061427881598123714,1.0161652788524902,0.9873766686550948,0.9922931232220539,0.007484112791495967,62.33293101996891,123.081519924698,114.92225046157837,106.76298099845874,117.04678562709263,2.8924060628786625,116.63660717010498,4.066074624805705,118.09959188807817,116.12595317607462,-1.1607512192634775,8.304272587133207,34531000,2.9065979452988593,1.098977340971954,-1294476900.0,-52.30200223589486,70.74152269624075,78.01649708558223,21.93183526527272,29.734387311715764,27.102067104579586,0.003149075811469897,5.157848167568107,120.82555795288087,118.44721781921388,116.52499771118164,114.6027776031494,112.22443746948241,0.02,0.0,181.72073019932546,0.007110056561471456,0.019485708652876188,116.58328574044364,116.51628167288644,4.524255023330531
2022-12-16,0,120.44750022888184,109.6200008392334,122.54999923706055,111.46062660217285,117.76250123977661,0.3874943309207358,4.094615745751545,-1.1625321905807267,2.9951016822128547,114.39999961853027,3.521162252426147,0.035588217691176614,110.27850112915038,121.0622501373291,0.7141347966864476,0.052095761092023254,1.0468654752160937,1.021001103254943,1.0219496768282852,0.0414603928452868,53.72478715846895,123.24460687678751,115.05537538528442,106.86614389378133,117.95178576878139,2.8112192901645647,117.38321440560478,3.695491535187926,117.7661792886573,116.20623821096002,-0.25623602640703613,4.627513264800822,67064000,2.9957049464690058,2.031039802492706,-1227412900.0,-32.48604312476977,70.74152269624075,78.01649708558223,92.53534401036563,33.17186184187334,24.48725231024598,-0.08713524469847211,5.300858729854982,120.86331881713868,118.50833921813965,116.60499954223633,114.70165986633302,112.346680267334,0.02,0.0,181.27266492973462,0.030457268992826636,0.03555015023001506,117.36738913399833,117.27543585641044,4.532475859462032
2022-12-19,1,115.86000251770018,109.6200008392334,122.54999923706055,111.78375053405762,119.96937465667725,0.18734909836355898,4.144038531555452,-1.314896507151179,2.9950901387571824,115.17000102996826,3.5878747940063476,0.03587046433415005,110.27850112915038,121.0622501373291,0.6869444026150063,0.06876814433103451,1.0028748662493192,0.9823597699708488,0.9750924936349474,0.010223455195205844,59.226025456025305,123.81595239117486,115.52787532806397,107.23979826495308,117.94428634643555,2.817628855212378,117.82892881120954,2.9975372053335905,118.4410403718623,116.81201653501543,5.551539957652473,9.502705939812646,29769900,3.075111806689567,0.9065092577226352,-1257182800.0,-66.64482800431713,70.74152269624075,78.01649708558223,-3.9949815800040502,30.8860384493952,28.866521996081854,-0.1174878150953983,5.286511568685424,121.06155795288086,118.82921781921387,117.02499771118164,115.22077760314941,112.98843746948242,0.02,0.0,181.05972029312363,-0.002005007052580998,-0.012251904539893294,117.24621037074498,117.63327244349888,4.466055412174436
2022-12-20,1,115.03499984741211,109.6200008392334,122.54999923706055,111.78375053405762,119.96937465667725,0.09504361907550533,4.093044909674406,-1.264412979793215,2.995106854305653,115.75625228881836,3.450499820709228,0.035380641541694416,110.27850112915038,121.0622501373291,0.6648849493967989,0.0462816804000589,0.9943726942087038,0.9809288655662259,0.9662422042968556,-0.04972946547096313,50.98132495186455,123.87209016648626,115.68600034713745,107.49991052778864,117.85607174464634,2.909507237778906,117.91803591591972,2.8845705599883393,117.7827653181686,116.70055829858319,-0.04528929762706566,5.6923933868767715,28742500,3.2333984335369697,0.8694114771691956,-1285925300.0,-62.08028173150407,70.74152269624075,78.01649708558223,-7.764602370095352,28.84220664762012,29.49727751174594,-0.05621172127951208,5.256760938447166,121.78843838500978,120.00577851867676,118.56499862670898,117.12421873474122,115.34155886840821,0.02,1.0,180.85571020544475,-0.025468239195123865,0.020747930811927887,117.41586085728237,117.561277117048,4.259515112840636
2022-12-21,1,118.10499954223633,109.6200008392334,122.54999923706055,113.30062532424927,119.96937465667725,0.041982559699779,3.9373038759872476,-1.1251222339807496,2.995155316199208,115.75625228881836,3.23959963798523,0.03397126742211413,110.27850112915038,121.0622501373291,0.6250021782330835,0.04283381756230439,1.019016222701875,1.008866711730148,1.002163760372857,-0.024953038069310707,49.674054773795675,123.77560806096497,115.90100030899048,108.02639255701598,118.34428596496582,2.554246153405248,117.79625020708356,2.834098687289439,117.07506392251346,116.59060176124369,-0.5339289695647014,1.0963413922971963,20392800,3.2391504606951362,0.6250109185663439,-1265532500.0,-40.21291073607725,70.74152269624075,78.01649708558223,46.339121477406295,31.098833961955734,27.591570007427617,-0.07301727174015624,5.2184204135462275,121.78843838500978,120.00577851867676,118.56499862670898,117.12421873474122,115.34155886840821,0.02,0.0,180.71823882397115,-0.015050526078979165,-0.003245990107155842,118.13580976213727,117.51280484880719,4.193322393367821
2022-12-22,1,116.82999992370605,109.6200008392334,122.54999923706055,114.03124952316284,119.96937465667725,-0.08805970210689765,3.745714083694502,-0.9817086930158534,2.995212861822427,115.88625049591064,3.1080748271942147,0.032209905574526375,111.4530014038086,121.0622501373291,0.5889105856409934,0.05601751950197463,1.0046370816703825,0.9945835480068866,0.9964561485185498,0.00042814897042786626,54.3835862009697,123.78217838482675,116.29075021743775,108.79932205004874,117.74071448189872,2.2927436514449013,117.51678589412144,2.711476258983268,117.3185564928425,116.76642027848943,2.979836113121594,-1.4230864963743899,23618100,3.2890812308343866,0.7213470544865471,-1289150600.0,-61.834528980141634,70.74152269624075,78.01649708558223,1.3895337687339773,28.81376035517721,27.257748524920355,-0.08036017619986485,5.2299621613804055,121.78843838500978,120.00577851867676,118.56499862670898,117.12421873474122,115.34155886840821,0.02,0.0,180.55502199824048,0.008351262338663012,-0.0367628098984925,117.70383998325894,117.05873816353935,4.0763095526738375
2022-12-23,1,116.94750022888184,109.6200008392334,122.54999923706055,114.54374980926514,119.96937465667725,-0.21251201623778576,3.604470066153334,-0.732411046674899,2.99525274994459,116.3462495803833,2.9124998092651375,0.03092897140500524,111.4530014038086,121.0622501373291,0.5506423085087171,0.04672309426883569,1.0034945010171878,0.9948068175452366,0.9973732559920577,-0.029058303354981052,52.01145604061048,123.74919033830032,116.54025020599366,109.33131007368699,117.1435718536377,1.741783926787504,117.11660739353725,2.2925665077153163,117.18148421608862,116.74394852071893,-3.49014941210081,-3.240367204241183,17796600,3.306711459447615,0.5387829836781144,-1271354000.0,-52.22601296866396,70.74152269624075,78.01649708558223,7.919468567102684,27.73675567761672,26.238904670482874,-0.04568882134200309,5.04496482010421,121.38351931762695,119.67823927307128,118.29999923706055,116.92175920104981,115.21647915649415,0.02,0.0,180.4336327570018,-0.011638587471234918,0.01627205741564438,117.19773864746094,116.74580982753209,3.8901057722546786
2022-12-27,1,117.36499977111816,109.6200008392334,122.54999923706055,114.94812488555908,119.96937465667725,-0.33326132687818283,3.422938004402332,-0.35866330500459886,2.9953013410507747,116.80500030517578,2.6626248359680185,0.02930425114523261,113.40825023651124,121.0622501373291,0.4601745755293061,0.06320743092422283,1.004778183107508,0.9972596884198064,1.0069451836787584,0.01298979130600375,53.0331615393231,123.65275114231908,116.80687513351441,109.96099912470974,117.2271431514195,1.7354550163272644,117.13696438925606,2.293481609392218,117.13182930575122,116.89847684209387,-3.450907882370359,-4.571602646313563,21392300,3.276946448495619,0.6495258652164679,-1249961700.0,-62.15755091216345,70.74152269624075,78.01649708558223,-3.126562959132631,27.315107802866272,25.256890425843828,-0.0295048865899668,4.8667527198736,121.38351931762695,119.67823927307128,118.29999923706055,116.92175920104981,115.21647915649415,0.02,0.0,180.28815594389414,0.02096431284639233,-0.021351407873099606,117.30181012834821,116.94254793439593,3.376216460220199
2022-12-28,1,116.38250160217285,109.6200008392334,122.54999923706055,115.49812650680542,119.96937465667725,-0.2781170469806157,3.0456862260079696,0.009347225634201095,2.9953935366918394,116.88875007629395,2.3799496078491225,0.025992545118348455,114.07999935150147,121.0622501373291,0.2892390194935126,0.0706531551960434,0.993233445405096,0.9866665658083396,0.9959437578478297,0.0117138414964848,54.045175731894226,123.26674762749202,117.17537517547608,111.08400272346013,116.64642906188965,1.0044021726111776,117.29910741533551,2.138196799455584,117.21665158038317,117.0617399203135,0.5009411551917848,0.24342153707404773,19612500,3.2722905719452537,0.5993871810450317,-1269574200.0,-72.94517483266597,70.74152269624075,78.01649708558223,-35.56408458863442,26.220975017858873,25.06452948045391,-0.048648703503402564,4.707698910246954,121.38351931762695,119.67823927307128,118.29999923706055,116.92175920104981,115.21647915649415,0.02,0.0,180.1537912391906,-0.012554399076976086,0.009958026898259103,116.75864083426339,117.06301498413086,2.853349051267862
2022-12-29,1,118.36499977111816,113.78750038146973,122.54999923706055,115.80812740325926,119.96937465667725,0.4519386084158847,2.517761784402406,-0.961319023072416,2.9955034572457593,116.88875007629395,2.124299621582032,0.021425298198296097,114.62999992370605,121.0622501373291,0.19008367072589147,0.022805679112410843,1.007245972215509,1.0074645876289554,1.010578347721559,0.0022014328765891378,49.586917166874706,122.54902378242785,117.51350021362305,112.47797664481824,117.00428581237793,1.1174025492332578,117.47428607940674,2.116207210463832,117.03482828288138,117.24610956540783,-3.3749132352140316,1.9892670656494318,22366200,3.1610271430370425,0.7061865760708265,-1247208000.0,-33.21915369898238,70.74152269624075,78.01649708558223,35.50167840519046,28.41500256896846,23.028816544707816,-0.09278717978056646,4.757862990518366,121.38351931762695,119.67823927307128,118.29999923706055,116.92175920104981,115.21647915649415,0.02,0.0,180.00745700050078,0.004175042030024612,0.027073246900722384,117.58266122000558,117.41443579537528,2.907902224114721
2022-12-30,1,119.16499900817871,114.11249923706055,122.54999923706055,115.89937448501587,119.96937465667725,0.445805475781338,2.372517542338096,-0.9456299046223173,2.9955298407703137,117.01375102996826,2.0263496017456055,0.020150073740643565,115.0002498626709,121.0622501373291,0.27815174988833175,-0.012060760381148148,1.0120825133929978,1.016664272902042,1.0169570972740671,0.01998629706408872,50.79077976812771,122.48741026778166,117.74237518310547,112.99734009842928,117.59428569248745,0.9870347879033461,117.7251787185669,2.0916809951950928,117.38594211593178,117.59091233118619,2.162089762629937,2.1158212697353096,19583800,2.8814660910575247,0.6353545453424702,-1227624200.0,-32.53427185334841,70.74152269624075,78.01649708558223,51.202943547286125,27.234937530756163,22.072437913037632,-0.09257485239147797,4.609444227018242,121.38351931762695,119.67823927307128,118.29999923706055,116.92175920104981,115.21647915649415,0.02,0.0,179.88090500005023,0.0274931473728679,0.004843028327112975,118.04599543980189,117.73092814854213,2.9033082004239508
2023-01-03,1,124.05249977111816,114.11249923706055,122.54999923706055,115.89937448501587,119.48562431335449,0.47784215534109253,2.3484545648915947,-0.8583209481353409,2.9955338534836304,117.01375102996826,1.9876495742797864,0.019951168701036318,115.0002498626709,121.0622501373291,0.2341837382466619,-0.013065004393730024,1.0538813003746972,1.056213158450098,1.0544647005029444,0.06075375299455654,52.17198939957695,122.40703429000048,117.71012516021729,113.0132160304341,118.4439285823277,2.653295912712236,118.39410727364677,2.5026088841784904,117.83287631284985,117.7386200080383,3.590210949923787,3.037112804028959,35528500,2.879176166765908,1.1609740699397955,-1192095700.0,-11.718220371520346,70.74152269624075,78.01649708558223,182.73854582221378,33.766483308200435,20.054373783828904,-0.13557075921680903,4.710912954446537,123.08724188232424,121.05638134765626,119.41500091552734,117.77362048339845,115.74275994873047,0.02,1.0,179.67142491632544,0.056760387023040204,0.065061445179766,118.75596509660993,118.4458874293736,3.0409286698370646
2023-01-04,1,127.41250038146973,114.11249923706055,124.05249977111816,115.89937448501587,119.48562431335449,0.7523653420006563,2.6531810033355665,-0.3490219111184847,2.995480335888832,117.01375102996826,2.186249542236329,0.022508309078576535,115.0002498626709,121.26974868774414,0.15383546128370115,0.012260306351786933,1.080906253834524,1.0815014773009974,1.0700997799354826,0.08560900293908658,61.27155057703501,123.18198714018554,117.8756251335144,112.56926312684327,119.95571436200824,4.164771220171752,118.84821442195347,3.4282058802414492,119.36623306540045,118.51664036288284,5.035773465927588,8.165667375361886,32397100,3.061958626098095,1.063999030491884,-1159698600.0,-10.126581696355604,70.74152269624075,78.01649708558223,232.1989061937009,35.63471842869997,18.735808036720286,-0.11856211357238607,4.682276685370324,125.13476211547851,122.71262153625489,120.75500106811523,118.79738059997558,116.37524002075196,0.04,0.0,179.49195132683764,0.0897501935960221,0.07904100586456836,120.21724809919083,118.96054404122489,3.578626224744295
2023-01-05,1,126.53250122070312,114.11249923706055,127.41250038146973,115.89937448501587,119.48562431335449,1.3256873472689674,3.230382400702783,1.3521968389479193,2.9953626250326777,117.01375102996826,2.4793746757507313,0.02734859957023294,115.0002498626709,121.41999874114991,0.4080790843819295,0.08825160906065525,1.071231290683164,1.0636022160695695,1.0450710598682433,0.08721242007003549,70.21463588284665,124.57951499214042,118.11875019073486,111.6579853893293,121.3250002179827,4.567130439794429,119.2342860358102,3.9666896806183916,121.35019693034272,119.56534313128603,9.058033437194558,5.251745124337607,25447100,2.8470187135004195,0.8615526813169885,-1185145700.0,-12.71850576113433,70.74152269624075,78.01649708558223,174.5308086797524,33.4477149839853,19.605993463101836,-0.04764360521739927,4.632114304696973,125.13476211547851,122.71262153625489,120.75500106811523,118.79738059997558,116.37524002075196,0.04,0.0,179.34980556666602,0.09790698124973596,0.08607123143160848,121.48606981549942,119.34190423148019,3.9463597444845657
2023-01-06,1,128.84000205993652,114.11249923706055,127.41250038146973,115.89937448501587,120.59937524795532,1.0848988801520993,3.701027763334085,0.20890259729711813,2.9952505475951052,117.15625,2.965287342071533,0.031208237178580536,115.0002498626709,124.30049991607666,0.5716151028839905,0.10883997867613883,1.0864196648860283,1.0726320397533213,1.046582013216285,0.08849746385395862,69.72679361184888,125.99343068688546,118.59137516021728,111.1893196335491,122.96428625924247,4.952018457062,120.09571470533099,4.644331401031107,122.64659389374295,120.48888961534337,8.195986210104676,4.4622423935718265,27584500,2.7479498291121454,0.9368941049323435,-1157561200.0,-1.7347370506310793,70.74152269624075,78.01649708558223,181.65179019946166,34.02918280766459,18.302117989264982,0.007288599446537682,4.607677634010005,126.11268118286132,123.50366078186035,121.39500045776367,119.286340133667,116.67731973266602,0.06,0.0,179.20277688280208,0.08115753489709165,0.12454597877589842,123.35936410086494,120.33058711460659,4.501668422242657
2023-01-09,1,130.7150001525879,114.6875,128.84000205993652,116.26500082015991,121.07312488555908,1.0256294665812618,4.1718172714305135,-0.16971608363827828,2.9951281026159093,117.73499965667725,3.417325048446654,0.034960998266494,115.59075183868408,126.62050113677978,0.6325231748613265,0.11152812471471017,1.095428346067603,1.078602266697441,1.0440453484035617,0.0969244429198246,72.24339912289443,127.6713848442221,119.32775030136108,110.98411575850005,125.0117860521589,4.735377661197385,120.82910755702427,5.445696560805456,124.19624834393262,121.7137072595822,9.777192784217252,10.327111921887623,26649100,2.761396028715396,0.9112678917165173,-1130912100.0,-16.983875501970648,70.74152269624075,78.01649708558223,175.38903964004678,36.18606323372013,17.245504129214407,-0.00933079465309292,4.5407005292811,128.11435745239257,125.12281776428223,122.70499801635742,120.28717826843261,117.29563858032226,0.08,0.0,179.06650329874978,0.07586841835432367,0.07658409573212228,125.33387865339004,121.04625974382672,4.888502184911525
2023-01-10,1,130.2125015258789,114.6875,130.7150001525879,116.68062591552734,121.85874891281128,0.9152260449630372,4.770382575107928,-0.4472490076583062,2.9949520650416557,118.23499965667725,3.9639499664306648,0.03973071531248723,115.59075183868408,127.55525054931641,0.6814307654328939,0.13023927562626597,1.0844907608137606,1.062284966924586,1.0211904179931757,0.04965640971464658,74.74198536900161,129.60864053550029,120.06787538528442,110.52711023506856,126.70428630283901,4.028204385908064,121.85428605760846,5.779041359754961,125.83818189208091,122.92788877799255,12.314994396157104,8.5244607851513,28684400,2.7642805100936076,0.9764393548182853,-1159596500.0,-2.1448850154424304,70.74152269624075,78.01649708558223,154.44746688259877,32.70147229549539,18.845732488445876,0.02783899539813201,4.6656505570111735,128.48872164916992,125.42564115905762,122.95000076293945,120.47436036682129,117.41127987670899,0.1,0.0,178.92255703370833,0.06613766082599648,0.10511892045528916,127.14872196742466,122.36569159371513,5.52745189837067
2023-01-11,1,132.01000213623047,114.6875,130.7150001525879,116.81750011444092,124.6725001335144,0.7212597326113702,5.137846031975335,-0.899841222655342,2.9948364284089677,118.76499938964844,4.358050117492676,0.04253329028597775,115.77750225067138,128.97725200653076,0.7325206344778816,0.13536786071611034,1.0928353451172061,1.0654194797625067,1.0253801273162035,0.03608360043948555,73.80771876074418,131.0715674225322,120.79587535858154,110.52018329463087,128.53928674970354,2.741586054373561,123.0667862210955,6.014206636683712,126.94694523481083,123.90996102384818,10.009294789566342,12.387794490152944,25423000,2.750697464307928,0.8644243135701493,-1134173500.0,-4.9306947996706825,70.74152269624075,78.01649708558223,144.2228688300418,31.551563719521493,17.81479216942583,0.03825385893767531,4.583104786111345,129.2550840148926,126.41246272277832,124.1150016784668,121.81754063415526,118.974919342041,0.12000000000000001,0.0,178.7987998968544,0.04333826218510284,0.0653358904346011,128.93790217808314,123.49194880894252,5.892597381379105
2023-01-12,1,134.89749908447266,115.03499984741211,132.01000213623047,116.91812515258789,126.75250101089478,0.612223633231759,5.483567145647827,-1.1210181819480658,2.994725240569396,119.80624961853027,4.814100399017334,0.045072143517873815,116.33025169372559,130.26275138854982,0.811618561218114,0.09049607040962768,1.1087890924729982,1.076005769089549,1.0403780414316153,0.0661094800392743,74.12136302443764,132.62913475668873,121.66200046539306,110.69486617409741,130.08857236589705,2.8457971882587576,124.26625047411237,6.595005662696389,128.22282963344304,124.91593085568807,10.77917445135896,14.756380502746824,30757700,2.4367307670953116,1.0712058636537851,-1103415800.0,-4.163030697349716,70.74152269624075,78.01649708558223,151.6299374033158,34.547172549812736,16.204670690729454,0.10258595614275993,4.678597170692438,132.1811937561035,128.77939442443846,126.02999496459961,123.28059550476073,119.8787961730957,0.14,0.0,178.65964108338576,0.07696541107770583,0.07332960993445238,130.64439501081193,124.70018005371094,6.712013250579116
2023-01-13,1,136.0449981689453,115.03499984741211,134.89749908447266,116.91812515258789,127.76937580108643,0.5771545768270626,6.191201049453076,-1.13260075207305,2.9944635375659114,119.80624961853027,5.58395030975342,0.05060067267035168,116.33025169372559,130.84450035095216,0.8132677570006421,0.11368186921947503,1.1118954732367345,1.0693659037953325,1.035862467290173,0.05592204279581603,77.58013964154524,134.73652750326406,122.35412540435792,109.97172330545177,131.32178633553642,3.3232338677156203,125.63875034877232,6.919825410814,129.8861516124437,125.92969323326562,8.742265841771792,14.218280011280173,22423800,2.486644959261189,0.8011863552001921,-1080992000.0,-3.1574075189315423,70.74152269624075,78.01649708558223,137.38235986678635,33.157036205221445,15.55261438577901,0.1372806667404204,4.526554733488253,132.44787490844726,129.21105628967285,126.59499740600586,123.97893852233888,120.74211990356446,0.14,0.0,178.56112673719716,0.05353020403204933,0.07909246839346284,132.01443699428015,126.1158425467355,7.398687449919146
2023-01-17,1,135.6349983215332,115.03499984741211,136.0449981689453,116.91812515258789,129.18312692642212,0.49427813113518393,6.8608607436305755,-1.2549244323651363,2.994192038826102,119.80624961853027,6.281750106811524,0.05573404323614724,116.33025169372559,132.2987518310547,0.8314286391691559,0.16496829396322202,1.1018277652414237,1.0515298715386598,1.0215324915896724,0.03763912453201268,82.98580187501635,136.8217218687309,123.10000038146973,109.37827889420856,132.62214306422644,2.8894449411962384,126.97357164110456,6.916727009669927,131.41638792660103,127.00783442577847,6.775236151578621,16.446972744832067,21147600,2.180615699597332,0.7740964875274876,-1102139600.0,-10.464560466504818,70.74152269624075,78.01649708558223,112.8234798884963,31.686987280012858,15.821246254243398,0.14095937646934875,4.398229090098464,132.44787490844726,129.21105628967285,126.59499740600586,123.97893852233888,120.74211990356446,0.14,0.0,178.46655491683364,0.04549310981009147,0.04107053587356855,133.21482631138392,127.35044806344169,7.6147445070117765
2023-01-18,1,134.72000122070312,115.03499984741211,136.0449981689453,117.26062488555908,130.33812618255615,0.32683278820006917,7.2140017788120145,-1.419616645466638,2.9940503779030547,122.25,6.592500019073486,0.05815738334972556,116.33025169372559,134.97124900817872,0.882832748864339,0.12609226479413138,1.0860771865734375,1.031268366919257,1.0071770437678391,0.03461648952292329,80.26339285410641,138.47075382083815,124.04275026321412,109.6147467055901,133.46214294433594,2.4238595974018553,128.2132146017892,6.610614863251937,132.47171082034566,127.98042922316834,7.193801602762229,15.979390800211586,20215500,2.1083523688368087,0.8093759571439725,-1122355100.0,-21.019352241071086,70.74152269624075,78.01649708558223,90.7300463359698,29.398914621386137,17.031677192787136,0.21548651948171887,4.401926794254469,132.44787490844726,129.21105628967285,126.59499740600586,123.97893852233888,120.74211990356446,0.14,0.0,178.37424348978703,0.0002254603484115325,0.027419396363480043,133.64251708984375,128.50094059535436,7.731783306490656
2023-01-19,1,134.55749893188477,115.03499984741211,136.0449981689453,117.26062488555908,131.03875064849854,0.15124704538070083,7.522396839657607,-1.5744080053633678,2.9939184031731254,125.29250049591064,6.945625114440918,0.06029669282067942,116.33025169372559,134.97124900817872,0.887424814023135,0.16278265400625777,1.0785621063012207,1.0216815120148162,0.9992276867949846,0.01929775588538618,81.26494792690139,139.8011689921204,124.75637531280518,109.71158163348994,134.01107134137834,2.1132252842969033,129.51142869676863,5.849339944257944,133.0250038355626,128.5898225191721,4.56379933774855,14.787203581502308,28625200,1.7421841271838487,1.1487107542452342,-1150980300.0,-6.983108426913278,70.74152269624075,78.01649708558223,90.51375451455537,26.902583759711884,16.640891549736402,0.2998621574399233,4.466788991754215,132.50923361206054,129.31037419128418,126.72499465942383,124.13961512756347,120.94075570678712,0.14,0.0,178.2468187960211,0.024531541547854196,0.02376106031897868,134.5948442731585,129.9643614632743,7.653415113181981
2023-01-20,1,137.45249938964844,115.03499984741211,136.0449981689453,117.91999959945679,132.64687633514404,-0.03004596637854407,7.5205247188772955,-1.6046763688279702,2.9939396944029593,126.97250080108643,6.897375173568724,0.05983331943065795,116.78525009155274,134.97124900817872,0.8815815771938241,0.16970921119979335,1.093572537815009,1.0380315073772908,1.0168786223270028,0.018940308919854987,81.47266545206017,140.73229957126898,125.6912501335144,110.65020069575982,135.04535675048828,1.6693510130617193,130.87482152666365,5.244675519915516,133.40642217242691,129.28976970999307,2.9396004856454123,15.616606516879155,28688600,1.7118218188538816,1.1513794753081465,-1122291700.0,-2.5676000301051705,70.74152269624075,78.01649708558223,107.69284560255188,28.568398102453397,15.241862865437712,0.293158149361886,4.528447051745682,134.700801361084,131.459600692749,128.8400001525879,126.22039961242675,122.97919894409179,0.16,0.0,178.12791534765057,0.019457216057213733,0.04876208964473223,135.50440107073103,131.32656151907784,7.847115951827073
2023-01-23,1,141.24499893188477,116.38250160217285,137.45249938964844,118.2999997138977,134.59812450408936,-0.14692298598301942,7.51934152889546,-1.5524219491193003,2.993967705932652,128.12625122070312,6.756412515640259,0.059295130669373,116.93575019836426,135.6759983062744,0.8833917919162498,0.1638160951898833,1.1138130427880444,1.0579476125262082,1.0410002782821137,0.03822265304073813,83.89118716314289,141.85080816841716,126.81212511062623,111.77344205283529,136.36464200701033,2.372024004072536,132.45196437835693,4.748954532525367,134.4191251011897,130.3181322596014,5.560140369725274,16.1259659996111,27470100,1.701245456501214,1.087038546990503,-1094821600.0,-2.2811467962574756,70.74152269624075,78.01649708558223,131.6654741019057,32.262338502749856,14.026705743493913,0.3025283437032475,4.569271608412648,138.69071551513673,135.554636138916,133.0199966430664,130.4853571472168,127.3492777709961,0.18,0.0,178.02577828019437,0.04591910087075024,0.04798484026434023,136.98421805245536,132.96106011526925,8.36781480567177
2023-01-24,1,142.79750061035156,116.38250160217285,141.24499893188477,118.96499919891357,134.7643756866455,-0.19599755203757144,7.862985352435971,-1.3119860812539532,2.9938349618889584,129.52625179290771,6.866962404251099,0.061444394087353055,116.93575019836426,136.1857482910156,0.8431991284717353,0.20897884981702072,1.1158746339865993,1.0597295774865434,1.04443689588873,0.05280718382020466,88.54941302077506,143.69509578498057,127.96912508010864,112.24315437523671,137.49321365356445,3.2678339151228544,133.79089300973075,4.840250270837151,136.10742137508066,131.6148844659221,6.995679604734836,18.528930564746304,21970200,1.7179546826783592,0.8722421102905766,-1072851400.0,-9.090912480847273,70.74152269624075,78.01649708558223,131.50282911972485,32.36648827481686,13.2167950379059,0.28884824590290153,4.502895021319602,140.17144021606444,137.18428034973144,134.77000045776367,132.3557205657959,129.36856069946288,0.19999999999999998,0.0,177.94736093972446,0.05747630597956954,0.0449699688973147,137.9009050641741,134.27265003749304,8.497606266368699
2023-01-25,1,141.54999923706055,116.38250160217285,142.79750061035156,122.8306245803833,135.0818738937378,-0.22601616094638258,8.057964476444445,-1.08951772648805,2.993777849541419,130.4637508392334,6.8344997215271,0.06233557908453946,117.32324981689453,137.83174934387208,0.8364839601140376,0.22103935809553715,1.0950161418124889,1.0411360880851281,1.0245775521221987,0.05069772828437169,89.47172155694274,145.38342906732979,129.2675001144409,113.15157116155203,138.27964237758093,3.5143354325729215,134.80071435655867,4.881738212563408,137.7625898957807,133.02199697870404,5.856299471446786,15.110538581502732,26622000,1.6963756850660296,1.038726527987714,-1099473400.0,-17.106550130083793,70.74152269624075,78.01649708558223,108.86458400639873,30.858805203083364,14.311304009891854,0.24412182917602593,4.385545420473032,140.17144021606444,137.18428034973144,134.77000045776367,132.3557205657959,129.36856069946288,0.19999999999999998,0.0,177.84871580915626,0.06374986048403164,0.045360537802839135,138.54529462541853,135.27986580984933,8.381846909274298
2023-01-26,1,145.62749862670898,116.38250160217285,142.79750061035156,125.91250085830688,135.73749828338623,-0.3326918604906195,7.9606189134935255,-0.9360194072864791,2.9938566200477945,131.36250114440918,6.615112047195436,0.06100202137423998,118.26499977111817,141.27549896240234,0.847783000205024,0.20606654039200162,1.1159398384019668,1.0622688509686364,1.043771339924406,0.08226966005386327,83.44924254329416,146.41886289183688,130.49762506484984,114.5763872378628,139.70714242117745,4.219713178428256,136.16464274270194,5.058271853456367,138.70291110124913,134.1599064641753,4.046456056604843,11.095849161788298,25482100,1.7835907173246428,0.9863803251148199,-1073991300.0,-0.9780694818797384,70.74152269624075,78.01649708558223,140.31975822942115,34.80247644560919,12.946530715516683,0.3010392499022059,4.501577498128353,142.4430760192871,139.30845695495606,136.77499771118164,134.24153846740722,131.10691940307618,0.2,0.0,177.7661542581929,0.08189509758515645,0.10735240819791807,140.2475128173828,136.73116956438338,8.415735787535839
2023-01-27,1,150.1400032043457,116.38250160217285,145.62749862670898,127.19250059127808,136.3968734741211,-0.30405262839166164,8.01229634540431,-0.686980124784689,2.993873533098765,133.28375053405762,6.551924457550049,0.06074028344877805,119.08499908447266,141.67474937438965,0.7912032631130234,0.25128345431604066,1.1381938408784877,1.0844133035648664,1.0593045721628913,0.0923046424840257,87.57615806295017,147.93534269843803,131.9107500076294,115.88615731682073,141.9099998474121,5.11274252455703,137.68607139587402,5.830116707584093,140.42836896318354,135.77654476054425,7.367199048056749,15.090982334016768,35771900,1.8045873545052005,1.3426922684250986,-1038219400.0,-5.5683444595333,70.74152269624075,78.01649708558223,172.18880485418688,40.43842384403572,11.762639115245294,0.35921729967017885,4.600750490425796,147.0445622253418,143.2427220916748,140.17000198364258,137.09728187561035,133.29544174194336,0.2,0.0,177.66816875103675,0.08875657006165971,0.11450606372469967,142.91631426130022,138.27941567557198,8.43932356295613
2023-01-30,1,148.6349983215332,118.36499977111816,150.1400032043457,128.48312664031982,138.40062427520752,-0.009032158896092976,8.118308267055946,-0.45732073670997675,2.993882758294126,134.63875007629395,6.508261976242065,0.06076640580488325,123.56374969482422,143.08050041198732,0.7614054717657291,0.2684493177431733,1.1125488621153126,1.061853009265738,1.030241475794134,0.052320432196061306,89.68524548636275,149.83524162184997,133.59862508773804,117.36200855362611,143.92107118879045,4.46647317835496,138.9660712650844,6.140777712864876,142.85888657755817,137.88333996818403,11.445963363955869,16.532133501907577,28040100,1.9219132199351276,1.0413912551301057,-1066259500.0,-23.540724528766244,70.74152269624075,78.01649708558223,136.87894435463457,37.43995479267295,11.571571891506451,0.2767365977698458,4.614268922895625,147.0445622253418,143.2427220916748,140.17000198364258,137.09728187561035,133.29544174194336,0.2,0.0,177.5850576863022,0.02645354024423252,0.05517694364061257,144.47169058663505,139.53326742989677,8.187897083603632
2023-01-31,1,148.5800018310547,119.16499900817871,150.1400032043457,129.8693766593933,141.3212490081787,0.1011150131493824,7.957242366252588,-0.5745365417679316,2.9939990505880663,134.8087501525879,6.3118369674682615,0.05889362161503968,126.28450107574463,145.92824859619142,0.7780538879877774,0.2473041543963078,1.0996792613118542,1.051998089496667,1.0194168221684712,0.040494414790085864,83.81555773561213,151.02660974776398,135.11212501525878,119.19764028275358,145.51071439470564,3.6939308528036667,140.27803557259696,6.088603066222585,144.31223499620998,139.4459624793004,10.462069748171153,13.709213286942365,29842100,2.0421389474334126,1.0875983516609673,-1096101600.0,-18.468271743935553,70.74152269624075,78.01649708558223,124.61823433534673,35.758876842606654,11.052000902114518,0.2504501169199459,4.486107380081725,147.79740100097655,144.4613001098633,141.76499938964844,139.0686986694336,135.73259777832033,0.2,0.0,177.4983664087443,0.04072942776249966,0.03978500522086879,145.8403080531529,140.67235456194197,7.836000067514501
2023-02-01,1,150.4474983215332,124.05249977111816,150.1400032043457,130.58937549591064,141.8618745803833,0.2727346461449242,7.583419017804484,-0.978799142287567,2.9941971028921817,135.26624870300293,6.33644989013672,0.05552247314402062,127.32450046539307,148.58550148010255,0.825241345524619,0.19771872477532293,1.1015106992677821,1.0555459939403882,1.0241037535541848,0.06285764134531413,82.6486185022519,151.74971319201157,136.5828751564026,121.41603712079362,146.8253571646554,3.557814373884875,141.59499958583288,6.156298910628796,145.39125897204588,140.74623419329032,8.095525720388801,14.105788683834906,55661000,1.91115983693326,1.9567831498896737,-1040440600.0,-2.1081877152103923,70.74152269624075,78.01649708558223,131.08542923515475,37.86950193522918,9.940653590300158,0.31294725336516266,4.6313857295913445,148.43048010253906,145.24475903320314,142.6699981689453,140.0952373046875,136.90951623535156,0.2,0.0,177.35181352329283,0.08212018010601962,0.06972206095442171,147.24456569126673,142.11439187186105,8.018213821895818
2023-02-02,0,187.36750411987305,126.53250122070312,150.4474983215332,131.68625164031982,143.50500011444092,0.27618367858227927,7.584680450694969,-1.1691229981685718,2.994226041240945,135.83999824523926,6.580149841308594,0.055000261569199016,128.69725189208984,148.78549880981444,0.8432591171150156,0.18079072203353116,1.35869425259923,1.3002309417528903,1.2601556571765955,0.2866217293215849,83.55072995076414,153.0719859853133,137.90262508392334,122.73326418253339,153.1925005231585,15.381843778713161,145.34285708836146,13.434501416200275,146.654362164561,142.0225841750036,6.515274494133652,13.966741827847088,150475700,1.8543294350040131,4.380777537451143,-889964900.0,-12.903720145096864,70.74152269624075,78.01649708558223,353.8860035915202,63.67552603699134,5.74118336122446,0.2643502999962056,7.446287360228689,181.81528265380857,172.32236203002927,164.6500015258789,156.97764102172852,147.48472039794922,0.2,0.0,177.52052883015375,0.28153420866032497,0.3340636223466061,153.74977111816406,145.82533809116907,13.390020720532547
2023-02-03,0,187.41500091552734,126.53250122070312,187.36750411987305,133.9206247329712,146.3656244277954,2.217230874471866,12.859916346710037,5.7477318179257235,2.9918055422945553,136.74874877929688,8.828662576675416,0.09126956774948446,130.07525157928467,150.17075271606444,0.4223514979272207,0.48078558719912634,1.3301242140432332,1.2545834021330171,1.19346765370239,0.2482682623927288,94.84187316814861,166.62020796426359,140.9003752708435,115.18054257742344,159.74464362008231,18.950480868865103,149.01214299883162,17.1899784005639,156.82656834815475,148.05809572614274,31.212033347235316,38.89620296262404,76809700,8.145995023673361,2.080593024148761,-813155200.0,-16.34882218442854,70.74152269624075,78.01649708558223,263.73967575696787,55.690319009546805,5.021212273820101,0.18939347090937866,7.905838611989002,181.81528265380857,172.32236203002927,164.6500015258789,156.97764102172852,147.48472039794922,0.2,0.0,177.60498006148194,0.2292737866104717,0.2663271071411405,160.16943577357702,149.35736519949776,16.237868860243918
2023-02-06,0,187.20249938964844,128.84000205993652,187.41500091552734,134.67937564849854,148.59375095367432,1.8649665326142393,15.93641996274174,2.6598058160009304,2.9899649664059975,139.3487491607666,11.060100355148318,0.11071225322569031,130.66475028991698,154.13949890136723,0.6487688679606533,0.4546336379934367,1.3005185961065253,1.2126045639836038,1.1380852129371661,0.2594779258158597,94.78949157896301,175.8173401810682,143.94450025558473,112.07166033010124,165.68392944335938,20.258490397162824,152.69553593226843,19.475925175743498,164.47895187913977,153.27193420575264,32.401979460031285,37.75956737695642,42483800,8.174635643886711,1.1280228600681108,-855639000.0,-17.071678520662573,70.74152269624075,78.01649708558223,201.14529061364564,53.01815881251771,4.780282004114951,0.10967681265784314,7.7111353307734,181.81528265380857,172.32236203002927,164.6500015258789,156.97764102172852,147.48472039794922,0.2,0.0,177.64573762435973,0.2651978174165832,0.22617635823478727,165.69522094726562,152.97136688232422,18.26750111435324
2023-02-07,0,188.84499740600586,130.2125015258789,187.41500091552734,134.85312461853027,149.01124954223633,1.4966916007096442,18.099985073460356,0.8865302933115569,2.988539843872677,141.39749908447266,13.174913024902343,0.1232443248131775,131.8805019378662,187.2189998626709,0.7455178772122154,0.4321424409679137,1.2858615134316191,1.1878818179585737,1.0966449174779545,0.2709987554094604,94.3103166655699,183.06259526899103,146.8626251220703,110.6626549751496,171.21321432931083,20.588221089690947,156.56160708836146,20.94950748267038,170.16733501316986,157.6511061389664,28.548866907004843,38.01931780606544,47080700,8.204106680336425,1.2170662831120864,-808558300.0,-8.520467826650552,70.74152269624075,78.01649708558223,170.3492350602658,51.291264283747125,4.3712588341566,0.1704857094602944,7.8303402988091095,181.81528265380857,172.32236203002927,164.6500015258789,156.97764102172852,147.48472039794922,0.2,0.0,177.7019867577952,0.28629921120835267,0.3030055230007197,171.38068062918526,157.14849744524275,20.209904259922588
2023-02-08,0,186.7949981689453,130.2125015258789,188.84499740600586,135.45062351226807,150.21687698364258,1.1909621651150388,19.855739918959888,-0.1652558953717147,2.9873423339226033,142.17374992370605,15.280275344848633,0.13257565550298056,134.30274925231933,187.37225379943848,0.7870256227315588,0.4502831540216906,1.24721966685708,1.1419113345200704,1.036279049112624,0.2415959072295839,94.77370261125435,189.480604822661,149.7691249847412,110.05764514682141,176.66464287894112,18.566271941063434,160.2928570338658,21.37653318523355,174.84328598288693,161.73407671466686,25.779268266686614,40.17591723194333,36139100,8.170192407944457,0.9253032050111,-844697400.0,-21.950456141412218,70.74152269624075,78.01649708558223,124.31295302882927,47.252745058156464,5.366509394645914,0.09709195976576554,7.892458630927401,182.3982029418945,173.26590249633787,165.88500213623047,158.50410177612304,149.3718013305664,0.2,0.0,177.7300855532001,0.1979491514828704,0.2313216106495032,176.56573704310827,160.51871381487166,21.020621221411815
2023-02-09,0,181.99250030517578,132.01000213623047,188.84499740600586,135.94249820709229,159.53437328338623,0.9363334165511737,20.872689060361214,-0.8402964158974013,2.986720400383285,144.21249961853027,17.46337509155274,0.13678196889811475,134.7037509918213,187.37225379943848,0.8253554839197804,0.41500640213745565,1.1926250826831366,1.082608839521236,0.9704972686584497,-0.028686958498729154,90.26154348292741,194.343627937617,152.59824981689454,110.85287169617209,181.43785694667272,13.834695014997772,163.47428567068917,21.027311854314387,177.8353460922503,165.08829079057338,25.673630220564114,38.82169306929823,37118800,8.2469368007096,0.9363672242209101,-881816200.0,-32.88889827891289,70.74152269624075,78.01649708558223,89.06834454128615,43.29469421845816,9.962442747635503,0.04080423181556601,7.998710844745277,183.35400366210936,174.81300366210937,167.91000366210938,161.00700366210935,152.46600366210936,0.2,0.0,177.7404179093435,-0.0574773197268299,0.16196448796090868,180.6929713657924,163.26663970947266,21.14709479737681
2023-02-10,0,175.68500137329102,134.55749893188477,188.84499740600586,137.10062408447266,183.19312477111816,0.7111168236723642,21.24690152146599,-1.267172397357265,2.9866070669861022,147.10375022888184,18.903325195312505,0.13699072314468,134.8797492980957,187.37225379943848,0.8562180223293776,0.3491169335260418,1.1327400072658054,1.0229588637046998,0.9422633525995221,-0.06258837064768008,80.37733162159189,197.59117776827378,155.0973747253418,112.60357168240984,185.04321452549524,4.656456334725542,165.93428584507532,20.22595428324661,178.86915561960575,167.3256741395264,22.48788401020032,32.403922164606094,33433600,8.42361427914337,0.8405665054602027,-915249800.0,-40.47494686935845,70.74152269624075,78.01649708558223,61.82296468639119,41.104726793252894,13.03766193091564,-0.015217618621018184,7.823088161948413,183.74340222167967,175.44330133056638,168.73500061035156,162.0266998901367,153.72659899902342,0.02,1.0,177.73309157994382,-0.06637003364356531,-0.07744879032738178,183.69109453473772,165.46783011300224,21.062756650224365
2023-02-13,0,178.61750030517578,134.55749893188477,188.84499740600586,140.29687404632568,183.19312477111816,0.5186764374522036,21.16748788023537,-1.493411784964669,2.9868317382651908,148.60750007629395,19.534525279998775,0.13470743095945303,135.5434986114502,187.37225379943848,0.8720999244963943,0.2913742051370341,1.1367009976170115,1.024791090409381,0.9701989145078568,-0.045859425555016764,69.56451173720843,199.47172560025348,157.1367498397827,114.80177407931193,183.7932139805385,5.0833959313496795,168.4928572518485,19.319310820876293,178.06172205253995,167.44225266925676,16.77495693402675,24.383165918684952,31463200,8.647141691606771,0.7821403756924756,-883786600.0,-31.187351069135023,70.74152269624075,78.01649708558223,64.36681349111673,40.45463495127355,12.214926430287125,-0.01855442643235652,7.7535823006175155,183.74340222167967,175.44330133056638,168.73500061035156,162.0266998901367,153.72659899902342,0.02,0.0,177.73616127944203,-0.03563369788296489,-0.03806363300504004,182.3595428466797,168.05465698242188,21.049098147780956
2023-02-14,0,178.50749969482422,134.55749893188477,188.84499740600586,141.4737491607666,183.19312477111816,0.32419839435863423,21.07983707041337,-1.6566306749946356,2.9870652835295695,149.38750076293945,19.97970024108887,0.1323566850452082,135.5434986114502,187.37225379943848,0.8624581878025,0.3168983117598398,1.120818004256621,1.0068403011354816,0.9787292963463371,-0.054740648961733473,71.61879428229977,201.42504908742097,159.26537494659425,117.10570080576753,182.52071380615234,5.140235455376159,171.13267871311731,17.821506627386086,178.19525547898382,168.1100640732299,-4.669968709781837,25.084472446450917,24034600,8.628546705085352,0.5953372932323377,-907821200.0,-32.82585914262375,70.74152269624075,78.01649708558223,57.818614911424085,38.793773929858375,11.5687539957325,-0.007253812340726861,7.601897109403304,184.4490435180664,176.58548342895506,170.2300033569336,163.8745232849121,156.01096319580077,0.02,0.0,177.73896921311513,-0.06335451999660091,-0.035364891768353064,181.3544660295759,170.76195090157645,20.708112422550112
2023-02-15,0,176.7750015258789,134.55749893188477,188.84499740600586,142.4856252670288,183.19312477111816,0.1428494935258641,20.745062924690714,-1.7381833590237228,2.9874950572996957,150.29375076293945,19.974650154113768,0.1285248215572216,137.17924957275392,187.37225379943848,0.853862394317529,0.32502596553860513,1.0951991618135761,0.9805172378888104,0.980343232738537,-0.05364167531939956,71.80670159997098,202.8991258646402,161.40900001525878,119.91887416587737,181.03107125418526,5.067757098389739,173.35750034877233,16.26913840384769,178.2635887881461,168.89946752737677,-4.75282190709908,26.109149174822093,25308900,8.614807127840677,0.6229718995708913,-933130100.0,-39.83269732261619,70.74152269624075,78.01649708558223,45.16271177381056,37.230341423109785,11.63663522937513,0.023924487988961848,7.355332594151161,185.3104420776367,177.9797810974121,172.05500030517578,166.13021951293945,158.79955853271483,0.02,0.0,177.73692552187887,-0.03418180878522814,-0.07546175847842242,180.0856475830078,172.89043426513672,19.83908273159604
2023-02-16,0,173.20750045776367,134.55749893188477,188.84499740600586,144.91999912261963,183.19312477111816,-0.017205486186398427,20.053095656559755,-1.7533155845867372,2.9881828445886622,163.0662498474121,19.408500289916994,0.12264008949092084,140.86574897766113,187.37225379943848,0.8428210552726516,0.3137506488238559,1.0592969644410049,0.9469017244090997,0.9713541438363618,-0.048271219048482195,68.91107283995856,203.61794134363714,163.5117500305176,123.40555871739805,178.7971431187221,4.459273964621405,175.00517872401647,14.842417766882175,177.88181178102616,169.54533915539398,-5.570170215551156,21.388476210122363,25827500,8.64554947401817,0.6379336556408068,-958957600.0,-49.233216321948525,70.74152269624075,78.01649708558223,28.034798323226095,35.25065394859978,14.523197510589522,-0.015718222376800307,7.213523864258236,185.3104420776367,177.9797810974121,172.05500030517578,166.13021951293945,158.79955853271483,0.04,0.0,177.72615735783984,-0.030800376134793916,-0.05991373399913225,177.3512682233538,174.36597442626953,18.813426864032586
2023-02-17,1,171.49499893188477,137.45249938964844,188.84499740600586,147.84187602996826,183.19312477111816,-0.14286311278738398,19.004605622045876,-1.7246216227976594,2.9890795956953355,174.44625091552734,18.25232524871826,0.11487014876477375,141.51949920654297,187.37225379943848,0.8364973249455651,0.260126234349202,1.036572735656675,0.9448539027330586,0.9713211104520749,-0.02384951708258487,62.50887160760958,203.45346135090324,165.44425010681152,127.4350388627198,176.61142894199915,3.5408319369416636,176.63803591047014,12.840661313550982,176.72106961195914,169.90655706401733,-8.280598990198543,15.363991448716245,24171300,8.73899892410233,0.6003752578220938,-983128900.0,-48.46306551166883,70.74152269624075,78.01649708558223,17.914782060714273,33.98931922478567,16.15249837297273,-0.01897143171967185,6.946843283023303,185.33640222167966,178.02180133056638,172.11000061035156,166.19819989013672,158.88359899902343,0.06,0.0,177.71281967604446,-0.00729247304294256,-0.028327329396556657,175.84722028459822,176.20647866385323,17.822356579560424
2023-02-21,1,174.11000061035156,141.24499893188477,188.84499740600586,148.62124919891357,183.19312477111816,-0.2637921096841502,17.914560504472504,-1.6360871899482388,2.989918918240051,174.44625091552734,16.81485015869141,0.1071788753748186,142.67275047302246,187.37225379943848,0.8288841399987245,0.21416687478321286,1.041661839946764,0.9677495603919053,0.9908348794188743,-0.02523548749211557,58.9304845137708,202.97549609286835,167.14637508392335,131.31725407497834,175.4853575570243,2.697217769244042,178.4616072518485,10.061562390369598,175.42464665395045,170.24045065388333,-8.190797070070676,15.37995819860669,34592600,8.76207628210542,0.8516895065533185,-948536300.0,-50.05987779569303,70.74152269624075,78.01649708558223,21.830753277217646,36.94181448503496,15.100736422552467,-0.08600005437466192,6.899925426095903,185.33640222167966,178.02180133056638,172.11000061035156,166.19819989013672,158.88359899902343,0.06,0.0,177.70079552945276,-0.040962985200948765,-0.01188627714066644,175.014644077846,177.8538077218192,16.923242719724005
2023-02-22,1,171.1599998474121,141.54999923706055,188.84499740600586,149.76375198364258,183.19312477111816,-0.4215349243835906,16.944372131337254,-1.4604136187378278,2.9906086499639097,174.8975009918213,15.374987602233887,0.10038752153449917,145.34449882507323,187.37225379943848,0.8071141507786438,0.21927904806570628,1.0140433671631672,0.958326567663451,0.9790697785045184,-0.04116073475889459,61.281989300376814,202.67836943052117,168.78962516784668,134.9008809051722,174.838928767613,3.146258957678332,179.94107164655412,6.5276645226006025,175.0978963386384,171.10891259676592,-4.331222265536424,17.182661505366095,22433200,8.765035104290236,0.5520035325155185,-970969500.0,-94.79434797147545,70.74152269624075,78.01649708558223,3.7356826884665817,35.719304274374856,16.961714347269776,-0.08724499898632117,6.626358757440883,190.67708337402343,186.66646319580076,183.4250030517578,180.18354290771484,176.17292272949217,0.08,0.0,177.68698947625327,-0.04657897068395034,-0.04631321543937461,174.58267647879464,179.1368855067662,15.820647266659442
2023-02-23,1,171.7775001525879,141.54999923706055,188.84499740600586,150.37062454223633,183.19312477111816,-0.5626120925547805,15.861969467038671,-1.202471077874898,2.9913020078913037,174.8975009918213,13.626650123596187,0.0931918167941925,148.2847515106201,187.37225379943848,0.7674289353213304,0.20918403934967375,1.0092225531545538,0.9714026393831998,0.9909316143422415,-0.02827040775083467,57.114860005028746,201.93168906377707,170.20775012969972,138.48381119562237,173.86178588867188,2.822668873955636,178.82749993460519,6.492994250635544,174.02389549937212,171.4833196576558,-2.5756333725178386,13.767262172490623,20017800,8.802799156418823,0.496603954637363,-950951700.0,-90.28846855569627,70.74152269624075,78.01649708558223,-1.3199142746531316,35.045478653095316,16.153502114487907,-0.0765990212905122,6.460904386074438,190.30596441650394,186.30702450561526,183.07500457763672,179.8429846496582,175.84404473876953,0.1,0.0,177.6756887577303,-0.02890049487556645,-0.04145309193510463,173.5291290283203,177.9443359375,14.319565602727174
2023-02-24,1,169.35250091552734,145.62749862670898,188.84499740600586,165.98187446594238,183.19312477111816,-0.6704196845070549,14.435293287278974,-0.9411760834772158,2.992123449958925,174.8975009918213,11.594887714385985,0.08406339871885475,148.62949867248534,187.37225379943848,0.7380990377361819,0.1795677449140971,0.9862180507993484,0.9658920002453744,0.9826080702960682,-0.022256539307178302,56.658928908770704,200.589711750034,171.71912517547608,142.84853860091815,172.5539289202009,2.4007749680224233,177.53732136317663,6.449765942515132,173.41469941181887,172.0753443953313,-3.8294120905854423,-8.320548453968337,19791300,8.784572838989984,0.4944753689864383,-970743000.0,-89.54825330061922,70.74152269624075,78.01649708558223,-23.16694029448307,33.30851136752796,17.29920709685068,-0.08640966465826112,6.312267617339642,187.6156799316406,183.80216064453126,180.72000122070312,177.637841796875,173.82432250976564,0.12000000000000001,0.0,177.66061907208726,-0.011888255681289706,-0.0382141395164341,172.23321969168526,176.79384286063058,13.138532463700228
2023-02-27,1,170.89999771118164,148.5800018310547,188.84499740600586,170.70812511444092,183.19312477111816,-0.7664555551474577,13.160999189921823,-0.5651266488805962,2.992771787273997,174.8975009918213,10.165550079345701,0.07611677293348616,149.98950271606446,187.37225379943848,0.7086517509166729,0.12796388238404904,0.9884018783373688,0.9817959704809519,0.9960426253795116,-0.003469496046000997,51.29051007297672,199.22737366976065,172.905375289917,146.58337691007335,171.71464266095842,1.5582868376089292,176.37285695757186,6.028445170912035,172.37717008690646,172.33627961954272,-5.1286353766358435,-9.637702378018941,19277000,8.790805283519877,0.4917589495945163,-951466000.0,-92.8024886084823,70.74152269624075,78.01649708558223,-26.06331297192827,34.52504122793661,16.483657103140455,-0.1298154790421649,6.151391184555126,187.6156799316406,183.80216064453126,180.72000122070312,177.637841796875,173.82432250976564,0.12000000000000001,0.0,177.64777670922206,-0.019319903454875553,-0.016817562704532503,171.1468767438616,175.6162621634347,12.209161270000521
2023-02-28,1,174.06499862670898,148.5800018310547,188.84499740600586,171.0949993133545,183.19312477111816,-0.9113984030542419,12.100513414696604,0.04950330443218709,2.993255031224459,174.8975009918213,8.993537864685058,0.0695658194147096,150.2662483215332,187.37225379943848,0.6350251593068943,0.1497964788984886,1.0006992138185171,1.0027348806249687,1.0151930408352685,-0.00025846868924717104,54.12796355847334,198.144401844652,173.9433750152588,149.74234818586558,171.8371423993792,1.7204676046768947,175.31714275905065,4.8565295734191505,172.00167677220966,172.8514587051738,-3.323435872711446,-8.708485053147886,46051100,8.77122361004384,1.148387869024567,-905414900.0,-68.58006320840268,70.74152269624075,78.01649708558223,-5.484113273237117,36.417044865509304,14.982894281046757,-0.08913234343400621,6.284149654644536,185.3618822631836,181.97906253051758,179.24500274658203,176.51094296264648,173.12812322998047,0.12000000000000001,0.0,177.63544498248353,0.016620213344081147,0.011915752085280937,171.50328717912947,174.42727770124162,10.482379488906368
2023-03-01,1,174.72750091552734,148.5800018310547,188.84499740600586,171.4112491607666,183.19312477111816,-1.032420551810052,10.61982842055449,0.9356456876306316,2.9938523688241117,174.8975009918213,7.705375289916992,0.06061031301540357,167.46200065612794,187.37225379943848,0.510422489480928,0.17152373456444311,0.9972184204400149,1.0091980308402042,1.0191104249922218,0.020843077069967464,58.419679828074685,196.45453187162659,175.2148750305176,153.9752181894086,172.2989283970424,2.020908983539776,174.4551786695208,3.5606956632059945,172.55447312502602,173.9035182577232,0.495069882469906,-7.826523859417218,30998400,8.776987715060987,0.771902013685035,-874416500.0,-69.66825977398665,70.74152269624075,78.01649708558223,-19.879502081740924,34.74292056276664,14.151414859938235,-0.1301506851860554,6.1781391830001375,182.1683562011719,179.39581762695315,177.15499877929688,174.91417993164063,172.1416413574219,0.12000000000000001,0.0,177.62716524343355,0.01344079800398923,0.0077870625186373076,171.58026994977678,173.7137451171875,8.524326526003286
2023-03-02,1,173.33749771118164,150.4474983215332,188.84499740600586,171.7068748474121,183.19312477111816,-0.8982366673076498,8.695549411619167,1.758564443676378,2.9944985681894303,175.20625114440918,6.48172519683838,0.049260359033327636,170.7452480316162,187.37225379943848,0.2799070753162741,0.16138521985991042,0.9819583521406798,1.003360198092128,1.0068132399487824,0.009081501111659174,58.68881650103516,193.91334880797953,176.52224998474122,159.1311511615029,172.18857084001814,1.9243107356581626,173.8369641985212,2.8271831906147513,173.17948475059177,174.92896096721205,1.8848957717574488,-6.460289285960223,17352000,8.77731002209515,0.45372991643049065,-891768500.0,-50.39711437929729,70.74152269624075,78.01649708558223,-49.68840943546808,33.260370749519204,15.478524579611598,-0.18257049761623065,5.992557943559805,178.24139666748044,176.21929800415037,174.58499908447266,172.9507001647949,170.92860150146484,0.12000000000000001,0.0,177.62074600421786,0.014473378759390254,0.01992749333580425,171.92955235072546,173.47209821428572,6.588242791965542
2023-03-03,1,181.95999908447266,169.35250091552734,188.84499740600586,172.85000038146973,183.19312477111816,0.5850859138051852,6.388677330016275,-1.1526469447331116,2.995090039148943,175.20625114440918,5.540850067138672,0.035958767364531276,171.13399963378907,187.37225379943848,0.8490134232246418,-0.07487961412836752,1.02416461792291,1.0553713216314422,1.0549843019411511,0.07444530255407278,37.89417375815176,190.44410461425622,177.66674995422363,164.88939529419105,173.73142787388392,4.082030289477259,174.28517832074846,3.548178883713476,173.33880944979745,175.75623653930242,-0.443686690288825,-4.755691899106238,45877700,2.5473904916423984,1.3896810403986415,-845890800.0,-7.22571589989071,70.74152269624075,78.01649708558223,68.58627010867947,41.69302879742752,13.39908744049028,-0.16485242469885228,6.428089257474699,182.14543713378907,179.37727838134765,177.13999938964844,174.90272039794922,172.1345616455078,0.02,1.0,177.64352850312662,0.0872117079852357,0.07678445161847675,173.94398280552454,174.2633296421596,6.3107055231271625
2023-03-06,1,186.79999923706055,169.35250091552734,188.84499740600586,172.85000038146973,181.96812438964844,0.626990175544527,6.079347258209154,-0.9590346196174253,2.995149038756097,175.20625114440918,5.216399765014648,0.034269850600983386,171.13399963378907,187.22374954223633,0.7773178251666591,-0.029106537920693946,1.0530091133507073,1.07797112808529,1.067440773651774,0.09303687383746873,56.38989651424877,189.55506921887192,177.3963747024536,165.2376801860353,175.87749917166573,6.254441055941784,174.86964253016882,4.777622558924718,175.5025746128062,176.57277058538497,6.309885047142245,3.5717321695826985,33209400,3.2962014707459786,1.0770697724198994,-812681400.0,-21.636408025567953,70.74152269624075,78.01649708558223,116.51285562522393,42.76207542855242,12.639778853187586,-0.16555574019705363,6.327511758537826,184.46800366210937,181.25600366210935,178.66000366210938,176.06400366210937,172.85200366210938,0.04,0.0,177.67042465232828,0.09059812934251554,0.0851575574138719,175.77735682896204,174.6532429286412,6.194072231916794
2023-03-07,1,186.96999740600586,169.35250091552734,188.84499740600586,172.85000038146973,181.96812438964844,0.6181321213618391,6.029948729281414,-0.9641650772545223,2.9951581926969646,175.20625114440918,5.179499664306638,0.03399727958701325,171.13399963378907,186.84024925231932,0.7131814896113328,-0.0021500789460621233,1.0541501365224082,1.069506163293832,1.0493439051661007,0.0741389646460302,63.154310139386226,189.42552207709306,177.36562461853026,165.30572715996746,178.39428438459123,6.7185893573194555,175.47410665239607,5.716394185027624,178.3280931737163,177.9250252726028,8.745324079770837,4.581017491513771,36701500,3.4896238431617492,1.2015950112599911,-775979900.0,-25.770955462479293,70.74152269624075,78.01649708558223,117.41973420597037,40.48755709103013,11.733957913911901,-0.16269554265511185,6.329118497464922,185.0028013305664,181.68860177612305,179.01000213623047,176.3314024963379,173.01720294189454,0.06,0.0,177.69959661653178,0.05470435019202724,0.08829775327562583,177.79036167689733,175.0117906842913,6.085769505009354
2023-03-08,1,183.6099967956543,169.35250091552734,188.84499740600586,172.85000038146973,181.96812438964844,0.6145734563257076,6.0111679483889455,-0.9665879576719512,2.995161654589893,175.20625114440918,5.165549545288087,0.03389361370298935,171.13399963378907,186.81699905395507,0.6864308313760797,-0.009928777705288418,1.0352740693373743,1.042616607538985,1.0157723706294794,0.050836278396846124,62.86128018120267,189.37633541612607,177.35399951934815,165.33166362257023,180.2099985395159,6.038739599157902,175.96232060023718,6.11408558575521,180.48730500129264,179.01258777478054,10.402855815672947,4.740695895494081,19432400,3.468099814692009,0.6663701577109874,-795412300.0,-23.744493895475262,70.74152269624075,78.01649708558223,96.25784836021323,38.64632924443791,14.29783807787895,-0.18556544359244243,6.157038473988438,185.0028013305664,181.68860177612305,179.01000213623047,176.3314024963379,173.01720294189454,0.06,0.0,177.71060570503866,0.06660135747428164,0.057333933378706736,179.99012974330358,175.5685032435826,5.39346569248199
2023-03-09,1,184.31750106811523,169.35250091552734,186.96999740600586,172.85000038146973,181.96812438964844,0.5368865407382162,5.605385847536414,-1.0289684949800657,2.995234013747927,175.20625114440918,4.851449508666991,0.03165234991207197,171.13399963378907,186.79549827575684,0.7036768318347351,-0.017050785109408367,1.0407993664326929,1.0392867339018015,1.0097625012137783,0.06334465134156186,56.85595690486259,188.30302118390338,177.09224948883056,165.88147779375774,181.67464174543107,5.521058937200344,176.75589207240515,6.441273048101081,181.26137258861513,179.30860866949763,7.437097281857405,3.8664942501922615,26582800,3.5188577935524967,0.9267545340559491,-768829500.0,-38.1938296675264,70.74152269624075,78.01649708558223,97.25606456049496,39.02392971772636,12.906295040054554,-0.16519493965680815,6.333677841858369,185.0028013305664,181.68860177612305,179.01000213623047,176.3314024963379,173.01720294189454,0.06,0.0,177.72507345678864,0.041024423056132964,0.04768767193918911,180.95243617466517,176.22786167689733,5.293196500368645
2023-03-10,1,181.02249908447266,169.35250091552734,186.96999740600586,172.85000038146973,181.96812438964844,0.4956277778987073,5.413691156851701,-1.0496682119067635,2.9952665849572897,175.20625114440918,4.702799682617188,0.03059129162515374,171.13399963378907,184.56575088500978,0.7505064260602049,0.012775255898131815,1.0229087511204926,1.0135411309465967,0.9799222132688603,-0.005152231285540876,60.41845455802528,187.79575694749246,176.96837463378907,166.14099232008567,182.57392719813757,4.643886210022358,177.43642779758997,6.345277558191975,182.01684786156187,179.64451629350071,5.890042525662066,6.414272234741195,25665000,3.347825846657341,0.9129856873085385,-794494500.0,-47.79739014174543,70.74152269624075,78.01649708558223,58.52133619441994,36.38573837638746,13.732375997623867,-0.1464801837874392,6.307700940345876,185.0028013305664,181.68860177612305,179.01000213623047,176.3314024963379,173.01720294189454,0.06,0.0,177.73283294465702,-0.0309852210121343,0.028533689744187723,181.8206503731864,176.70046016148157,5.325113281821303
2023-03-13,1,179.3650016784668,169.35250091552734,186.96999740600586,172.85000038146973,181.25687408447266,0.5147503471245114,5.372653348285285,-0.9933190884644052,2.9952734372804666,175.20625114440918,4.6445996093750015,0.030367720762066865,171.13399963378907,184.56575088500978,0.8244747744994824,0.030381066508009192,1.0138205337959778,0.9977415874175334,0.971936247855442,-0.03980191428779556,56.51491171483444,187.66518126932448,176.9198745727539,166.17456787618335,183.434999193464,2.863259600675093,177.81178501674108,6.288542032146018,181.75636506541787,179.62942662040692,3.60275179119551,5.555555679132119,24728000,3.101853497856038,0.8934886580452912,-819222500.0,-41.67404398968305,70.74152269624075,78.01649708558223,37.330460671397105,32.801574641224036,16.755213374099128,-0.08987111045801875,6.497150262836266,185.0028013305664,181.68860177612305,179.01000213623047,176.3314024963379,173.01720294189454,0.06,0.0,177.73757861527025,-0.02163328194168479,-0.023481783515152087,182.7287837437221,177.32916804722376,5.367121089612707
2023-03-14,1,190.62000274658203,169.35250091552734,186.96999740600586,172.85000038146973,181.25687408447266,0.4125608211479937,5.390198023490681,-1.080664469270511,2.995270925191994,175.75125122070312,4.7235123062133795,0.030435234892684373,171.13399963378907,184.56575088500978,0.8400755259419574,0.004184927971860971,1.076317518123255,1.0553794822334033,1.0413150197633565,0.019521877259538023,51.734636213048105,187.88427063499404,177.1038745880127,166.32347854103136,184.67214257376534,3.8280656076312094,179.20178522382463,6.832330827578894,181.16885650553112,179.3251474603561,3.4773225914039108,3.01820748359862,41642600,3.064449478224433,1.4774866767513146,-777579900.0,-1.125292612709444,70.74152269624075,78.01649708558223,170.3632522443988,39.07236211497496,14.458029341746718,-0.04206721821051432,6.991640488923475,188.02824645996094,184.13588592529297,180.99000549316406,177.84412506103516,173.95176452636719,0.08,0.0,177.79024780877563,0.0515420706078078,0.049324074677434986,183.97907366071428,178.96152823311942,6.559896929887767
2023-03-15,1,194.82999801635742,169.35250091552734,190.62000274658203,172.85000038146973,182.37249851226807,0.5171788565802955,6.1411576636383165,-0.9473968170420757,2.9951384528433898,175.75125122070312,5.383649940490722,0.03455835363107961,171.13399963378907,186.81699905395507,0.6867280367314721,0.06785430904844504,1.0963737357302863,1.0688911603640527,1.0600858478847588,0.06110779051529658,67.08309305169422,189.98631503735962,177.703999710083,165.42168438280638,185.81928525652205,5.437021498468017,180.84839221409388,7.6360093339758865,183.52661161640538,180.37170447906206,4.759289792087258,11.369480554170584,42123600,3.9563193693059038,1.4480835760207267,-735456300.0,-0.09959755697223427,70.74152269624075,78.01649708558223,177.55210897443393,39.83732010912214,13.432399207030125,0.019498649858777164,6.9879520569577975,190.67167993164063,186.27416064453126,182.72000122070312,179.165841796875,174.76832250976562,0.1,0.0,177.85772369851932,0.06909224221698396,0.07175769721831349,185.81102425711495,180.7941905430385,7.93052326212816
2023-03-16,0,201.25999450683594,169.35250091552734,194.82999801635742,172.85000038146973,183.78687286376953,0.6562977203195277,7.1889128426399935,-0.6720195136750684,2.9949281082418957,175.75125122070312,6.2813873481750475,0.0402694814251018,171.13399963378907,187.3349979400635,0.7151252310450522,0.1021354622239127,1.1273798678344866,1.0921231055457634,1.081862667757346,0.09192015592952041,71.62940594234847,192.89795031143964,178.52012462615966,164.14229894087967,187.8607134137835,8.013390646305218,183.12749889918737,8.636994271475382,186.34816918150548,181.8719457680806,4.298714567501855,13.419975167465049,50447100,3.9913329415004632,1.6623907211845734,-685009200.0,-2.2615855587813996,70.74152269624075,78.01649708558223,200.994965788307,43.9439652260654,12.140120683314336,0.07587733566574476,7.1795267792503195,197.09879522705077,191.7405956726074,187.40999603271484,183.07939639282225,177.7211968383789,0.12000000000000001,0.0,177.96883522242948,0.12791015800378003,0.10790930399133362,188.72218540736608,183.2562735421317,9.838942863530278
2023-03-17,0,198.37499618530273,169.35250091552734,201.25999450683594,172.85000038146973,184.93812561035156,0.834286920319801,8.711170531772877,-0.18646241500465566,2.9945724826437283,177.04625129699707,7.3690619468688965,0.048464217958973,171.13399963378907,191.04100227355957,0.7186146238980605,0.16195888731685043,1.1036506537977637,1.0604007327820695,1.0472786435201937,0.09585823413438055,77.80386528291218,197.16671533875328,179.74437427520752,162.32203321166176,189.9699990408761,8.627712398012893,185.089998790196,8.765423405754754,190.06600958769064,184.2042201425904,7.6429359250614475,18.840875345102805,50141100,4.019955470822196,1.5886643963057234,-735150300.0,-29.56595792343576,70.74152269624075,78.01649708558223,137.89183676312712,39.88433235952059,11.660407231184628,0.025756000414648646,7.345274866452915,197.65811407470702,192.64593380737304,188.5949935913086,184.54405337524412,179.53187310791014,0.12000000000000001,0.0,178.05749009290372,0.0896887040053096,0.07661407223556518,190.23906816755022,185.11459895542689,10.244733358648414
2023-03-20,1,197.3224983215332,169.35250091552734,201.25999450683594,172.9474983215332,186.84249877929688,0.6480160462964834,9.461472010381142,-0.6891496698722004,2.9943801121080855,180.19375038146973,7.973749351501465,0.05227253209928853,171.13399963378907,195.18449783325195,0.7916537593810047,0.15673924849607013,1.0901629911399637,1.045600023896006,1.022979416902803,0.10011706004528897,72.92180402908194,199.92569308234675,181.00274906158447,162.07980504082218,191.82785579136439,8.607860920302217,186.75124876839774,8.718994792918565,192.13220698891777,185.9578642725958,8.04150081549258,16.076652335919523,25186300,4.077029719146981,0.7967185179174913,-760336600.0,-23.15757799072021,70.74152269624075,78.01649708558223,116.70685781395446,37.63019103845932,12.770014649260297,0.012321803522802923,7.229183891752476,197.65811407470702,192.64593380737304,188.5949935913086,184.54405337524412,179.53187310791014,0.12000000000000001,0.0,178.10011832073928,0.093477134513551,0.1019443297629069,192.5372052873884,186.74482073102678,10.67850564853925
2023-03-21,0,201.7150001525879,169.35250091552734,201.25999450683594,173.88312339782715,187.8824987411499,0.4552707722910024,9.831004448191427,-1.0245786540955897,2.99428863600243,181.49124908447266,8.345786800384522,0.05392935455514743,171.13399963378907,197.42774810791016,0.8342059583876785,0.13332087547992094,1.1065359414339173,1.0629488268567426,1.0266361069705183,0.05820479092509512,70.37291488218625,201.95613292744974,182.2941240310669,162.63211513468406,194.78392737252372,7.793191402815686,188.67892728533064,8.838688699904603,193.42358384134423,187.5204628401247,7.055758231342298,13.361387917338327,31827000,4.10237377884055,1.0112070925246388,-728509600.0,-10.486427767883304,70.74152269624075,78.01649708558223,132.55337207131828,39.665930812722735,12.03495249371175,0.08929588542318574,7.122814006135593,197.65811407470702,192.64593380737304,188.5949935913086,184.54405337524412,179.53187310791014,0.12000000000000001,0.0,178.16589831150347,0.041954430611180094,0.11752357125047015,195.76628766741072,188.79346902029855,11.235738930340107
2023-03-22,1,202.33749771118164,169.35250091552734,201.7150001525879,173.88312339782715,191.67250156402588,0.31707957236446527,10.500146957025919,-1.1860101111761716,2.994106522537136,182.78499794006348,8.914062156677247,0.05716718520874537,171.13399963378907,198.66349601745605,0.8093513203230142,0.17851717885262527,1.1016098397165186,1.058008426011183,1.0183039314021851,0.038533592215064916,75.14130914638399,204.67466792223058,183.67437400817872,162.67408009412685,198.0657125200544,4.24902640742243,190.7503558567592,8.35149498025367,195.48764773418725,189.46316134100005,11.43090012168004,15.445478871759148,28477800,4.036499227013033,0.8961907221044989,-700031800.0,-23.2258076613682,70.74152269624075,78.01649708558223,122.6235194536508,40.42938317650389,11.111001763042267,0.0476811100099377,7.16404135914444,199.6881979980469,194.93589978027345,191.09500122070312,187.2541026611328,182.5018044433594,0.14,0.0,178.22713980361226,0.010417247376454775,0.029842259807931457,198.46217782156808,190.5954807826451,11.335444997364494
2023-03-23,0,204.2874984741211,169.35250091552734,202.33749771118164,174.56187534332275,195.45312309265137,0.18648039616573048,10.835503055807958,-1.281201144940754,2.994025912412224,183.96374893188477,9.313074417114256,0.05849653407298188,171.68974990844725,201.30549507141114,0.8227701133284717,0.17790454239610934,1.1028662493681138,1.057845909530677,1.0204068947972096,0.01504275091879892,75.46956043312231,206.90425501298307,185.23324890136718,163.56224278975128,200.01821190970284,3.289164073824497,192.3451772417341,8.669542503352814,197.17872869017225,191.045086926598,12.80768032656437,16.7303672793987,27389700,4.036434830703722,0.8520648098978725,-672642100.0,-10.88931146209303,70.74152269624075,78.01649708558223,123.07325639797344,37.70944721232549,10.224997704391944,0.028908379637826862,7.228753213794401,200.07784545898437,195.2510858154297,191.35000610351562,187.44892639160156,182.62216674804688,0.16,0.0,178.29180697600145,-0.0031717371434967223,0.033021532931570584,199.92488534109933,191.95197950090682,11.618154102942645
2023-03-24,0,205.57999801635742,169.35250091552734,204.2874984741211,178.20562648773193,197.5856227874756,0.0700842993522124,11.129521064034348,-1.3024086007523015,2.9939591961168093,185.5587501525879,9.598874416351318,0.05956114516697102,173.09374771118163,201.77724990844726,0.8048563161748871,0.20628569031891208,1.1001893104678966,1.0536431328381008,1.0237665420411586,0.0363201107478508,78.15297320228844,209.11779094551255,186.85874881744385,164.59970668937515,201.55392619541712,2.9557450992055068,193.6866057259696,9.183228987851777,198.929287543529,192.6254962740313,7.170021787120204,12.270553694212305,27716400,3.9229695652091077,0.8517287776519379,-644925700.0,-5.656414138150754,70.74152269624075,78.01649708558223,114.16881021897547,36.15880284059815,9.80453714839477,0.014110622098343198,7.000270754181545,200.07784545898437,195.2510858154297,191.35000610351562,187.44892639160156,182.62216674804688,0.16,0.0,178.35924548259302,0.05316703988553928,0.00527018708847065,201.1024671282087,193.45674569266183,11.660422528990043
2023-03-27,1,203.71749877929688,170.89999771118164,205.57999801635742,180.6081247329712,199.09624576568604,0.014530990131676797,11.08088367629274,-1.3470530623925625,2.9940064218653153,186.8849983215332,9.82963710784912,0.05873152283256131,173.99224853515625,202.5324977874756,0.8050193617646225,0.20292569203999902,1.0797549437818381,1.0311194694646302,1.007263343138665,0.032408876393522856,78.7588007954898,210.83189102507083,188.67012367248535,166.50835631989986,201.90499823434013,3.0591519522418738,194.8828558240618,9.330610575808539,200.58587524022306,194.16527787166882,5.517630811194413,10.053532578158052,18527200,3.9243787252362288,0.570000081528791,-663452900.0,-15.245036046930155,70.74152269624075,78.01649708558223,88.83468259983789,34.40101887624806,11.617426184435033,0.027015329654365452,6.832393835770585,200.07784545898437,195.2510858154297,191.35000610351562,187.44892639160156,182.62216674804688,0.16,0.0,178.4002671393395,0.02542843476725687,0.036961331356451015,200.80451093401228,194.76334817068917,11.128960159597652
2023-03-28,1,199.93999481201172,173.33749771118164,205.57999801635742,181.72562408447266,201.37374591827393,-0.08276714526078846,10.752944627071512,-1.4069241715960736,2.994132180126759,188.79500007629395,9.693499565124512,0.056501960995744664,174.6612506866455,203.7744987487793,0.8285346657825597,0.17035303126149529,1.0505961092663354,0.9996774898587028,0.9823733704835771,-0.00879957038015744,73.61141897016712,211.81688798003412,190.31099872589112,168.80510947174812,202.12856946672713,2.804784582141958,196.04928425380163,8.81970411352333,201.3809397613534,195.40903286223926,1.2210594949496865,8.957320214817017,19127300,3.9939995160193447,0.6138874655722757,-682580200.0,-21.77862292418606,70.74152269624075,78.01649708558223,58.89344223772402,32.58852865579196,14.695573614625516,0.046027307551848494,6.697223021884414,200.07784545898437,195.2510858154297,191.35000610351562,187.44892639160156,182.62216674804688,0.02,1.0,178.4365842331521,-0.007321056493285294,0.014508747406295016,201.52730887276786,195.88318852015905,10.718223403491159
2023-03-29,1,204.29249954223633,173.33749771118164,205.57999801635742,183.1974973678589,201.37374591827393,-0.23576880015048732,10.26602561384334,-1.3340685781570583,2.9942896945500355,192.72500038146973,9.331748962402344,0.053579181582546716,178.90125160217286,203.7744987487793,0.8297974816008734,0.14429608255356122,1.066218353689455,1.0167018042340392,1.0055125668931622,0.009662083663035448,65.06699188547641,212.13679976284294,191.60474853515626,171.07269730746958,203.12428392682756,1.908098609872244,197.476069859096,8.38060567729581,201.03110368384648,196.02597966102076,0.7889092157799534,8.893850172292973,18851100,4.165903821631954,0.6170512237195707,-663729100.0,-7.652749443834262,70.74152269624075,78.01649708558223,84.9689000431778,35.89733268417068,13.891418629920949,0.11352760786259394,6.578850559241791,200.07784545898437,195.2510858154297,191.35000610351562,187.44892639160156,182.62216674804688,0.02,0.0,178.48002385506797,0.027726271140072756,0.015779495187756933,202.60224042619978,197.56972285679407,10.207592335214322
2023-03-30,1,205.53250122070312,173.33749771118164,205.57999801635742,184.140625,201.87062454223633,-0.3621635543213148,9.849514504013072,-1.2454978805464296,2.9944221367062216,196.0762481689453,8.974449138641358,0.05101181658789286,180.85674934387208,204.28799858093262,0.7691682711586092,0.17858225854069107,1.0644774674781734,1.0180785808249524,1.009672673715922,0.006094365812305158,70.08682803191907,212.7820274745178,193.0829984664917,173.38396945846557,203.6696412222726,1.9822785521673334,199.22678429739815,7.148562255469741,201.87169049171496,197.0995839426329,3.532289161140481,10.837277175724761,22608300,4.16613298481117,0.7337232863344066,-641120800.0,-0.7514279607885217,70.74152269624075,78.01649708558223,92.29278928436901,36.424024005021984,13.085123280540492,0.1251583158354307,6.48536044884215,200.23827893066408,195.380860534668,191.4550018310547,187.52914312744142,182.67172473144532,0.02,1.0,178.53534419673727,0.01742708214822497,0.04018818639115175,203.41200474330358,199.58914620535714,9.676668877684165
2023-03-31,0,209.53000259399414,179.3650016784668,205.57999801635742,186.17937469482422,202.68249797821045,-0.35662690912846184,9.092684217258235,-1.4569875110301973,2.9946350206123653,197.84874725341797,8.287699203491211,0.0467027369056221,181.86624908447266,204.416499710083,0.8224951553444468,0.12954771518374886,1.07620855966912,1.0356878272569905,1.0280527649809417,0.019213953768607572,69.25740633993723,212.87811707648422,194.69274864196777,176.50738020745132,204.69714191981726,2.8505992013122246,201.38142721993583,4.891093498146255,202.82640871138977,198.33003223670633,1.8925221551334679,13.539754594147482,25440300,3.826180556788644,0.8539522265685775,-615680500.0,-0.8980699807015945,70.74152269624075,78.01649708558223,116.05097206597353,38.77951871227502,12.297475993620361,0.11355873989549743,6.407834266529499,206.12603802490236,202.386977935791,199.36499786376953,196.34301779174805,192.6039577026367,0.04,0.0,178.60637459481958,0.028784971260006342,0.037497529984491296,205.1413072858538,201.80174255371094,10.085382374587782
2023-04-03,0,210.9000015258789,179.3650016784668,209.53000259399414,186.92749786376953,203.85999870300293,-0.45755609696850175,9.147551760888861,-1.1962586705866587,2.9946354902449603,199.15749549865723,8.103499450683591,0.04665422297282289,183.35124702453612,205.53725090026856,0.830585859530621,0.12168096065186723,1.0756294091962542,1.0367431939535663,1.0307792043353166,0.035257171276991794,71.96689688894851,214.36635233922155,196.07124881744386,177.77614529566617,205.6417852129255,3.6700748793572533,202.82999856131417,4.441191090982679,204.48902431735937,199.73431803769483,3.5547068458260496,16.81766266175032,17924600,3.788910819469158,0.6175146212983392,-597755900.0,-1.8542958021169533,70.74152269624075,78.01649708558223,116.99615241614089,37.95389818821256,11.563167474903596,0.193800479315648,6.327989572127637,208.14460333251955,204.83770199584964,202.16500091552737,199.4922998352051,196.1853984985352,0.06,0.0,178.65826525133943,0.05043388158445228,0.034270229790064034,206.39444841657365,203.1596668788365,10.360568293116057
2023-04-04,0,214.2224998474121,179.3650016784668,210.9000015258789,189.707501411438,204.2887487411499,-0.5611704843741627,9.429871146927004,-0.955132087489178,2.994578704930364,200.59999465942383,8.019874572753906,0.04780033682708016,183.35124702453612,205.9749984741211,0.8331055191515138,0.12798847115512857,1.085901120927023,1.046093860692376,1.0397182082560654,0.07143395721715984,73.16928310289447,216.1359912257388,197.27624893188477,178.41650663803074,206.8764283316476,4.895084920732665,204.21517726353235,4.766399336876165,206.05869087766814,201.0437376063722,3.2368613356903366,10.638966785798408,21026400,3.781270370917409,0.7444752285944429,-576729500.0,-6.725680805123828,70.74152269624075,78.01649708558223,129.5247603660724,39.51932448881473,11.065471669645733,0.26056023118774385,6.140276903189303,210.9064040527344,207.60680316162112,204.94000244140625,202.2732017211914,198.97360083007814,0.08,0.0,178.72429479223277,0.06996217007003458,0.05856824730654809,207.6361803327288,204.36932373046875,10.523697371176487
2023-04-05,0,212.68999862670898,179.3650016784668,214.2224998474121,193.77749919891357,204.60249996185303,-0.6027166547151518,9.803751965610706,-0.6455659901354092,2.9945010533175176,201.4874973297119,7.964849853515625,0.0493546492966315,183.35124702453612,209.66700248718263,0.7996465542500123,0.16672568806712354,1.0707370329180244,1.0323053447418569,1.0181645734995706,0.041105273582188184,77.94489897182532,218.2463779851765,198.63887405395508,179.03137012273365,208.15821402413505,5.10047514152269,205.0316061292376,5.182062412526428,208.05643461623865,202.74107103430876,4.203960460378557,9.953550289225246,19396600,3.643511369536439,0.686812933892228,-596126100.0,-21.061984425236904,70.74152269624075,78.01649708558223,104.9004057047063,37.0805367309229,13.438773831814894,0.21706877205674432,6.076685695817733,210.9064040527344,207.60680316162112,204.94000244140625,202.2732017211914,198.97360083007814,0.08,0.0,178.78109441951892,0.02985148641284252,0.05381707734361982,208.86793300083704,204.83622196742468,10.29243028356432
2023-04-06,0,212.73500061035156,179.3650016784668,214.2224998474121,196.69937324523926,205.5443754196167,-0.7481116275261329,9.621734970507104,-0.21783454491783516,2.994560968511298,202.02624893188477,7.495050125122072,0.04808634496154104,183.98800086975098,211.07900123596193,0.808013158640912,0.15393273777137736,1.0631812927813231,1.0273616255645501,1.0102576271617532,0.0350431165235241,73.88821396038377,219.33634408652202,200.0928741455078,180.8494042044936,209.98607199532645,3.7883478173881624,206.05732073102678,5.184307574717827,209.20248882644768,204.27614177531817,4.404383472787834,5.679223110325991,26104400,3.7065401853932323,0.9251125363869424,-570021700.0,-3.605134025196112,70.74152269624075,78.01649708558223,114.75940517121214,35.56372341660315,12.162436591435284,0.28606440157231233,6.234780185041546,211.44120172119142,208.03940127563476,205.29000091552734,202.54060055541993,199.13880010986327,0.1,0.0,178.86109071632552,0.03974208916749489,0.052349704796325364,211.06627546037947,206.29679216657365,9.828958664038234
2023-04-10,0,213.94500350952148,179.3650016784668,214.2224998474121,198.11187171936035,206.5674991607666,-0.9248550757635388,9.279382869200184,0.3958708406674787,2.994655655183922,203.02749824523926,6.937500762939453,0.046048385827776685,189.6602523803711,212.69449882507325,0.7565958537657462,0.1751854144444251,1.0616893608551619,1.0290072047330252,1.0091007632122178,0.021070972466326277,76.10023080481626,220.07251486102,201.51374912261963,182.95498338421925,211.36500113351005,3.0565701800009943,207.24464253016882,4.927034836985789,210.08608554910194,205.54284926713638,6.399422892038189,7.238817744770163,16106100,3.551226822616105,0.5806177054856064,-553915600.0,-11.502108500840693,70.74152269624075,78.01649708558223,108.11190284016115,33.326910552769476,11.397469034337957,0.344714174339912,6.1780103462097555,212.4465604248047,209.6667191772461,207.4199981689453,205.17327716064455,202.39343591308597,0.1,0.0,178.90997583889165,0.013258432737791592,0.03324664700468695,212.40637860979353,207.50430951799666,8.608408608094633
2023-04-11,0,214.69000244140625,179.3650016784668,214.2224998474121,199.54874515533447,209.87250232696533,-0.9595036773781429,8.374333171331486,1.090948902495243,2.994870468949695,204.00249862670898,6.267388496398925,0.04122040928789382,194.40899848937988,212.85600090026855,0.6528650233176188,0.19279124415276663,1.0567539635214485,1.028452637629877,1.0084148155599877,0.017970606392159194,78.37315425360197,219.90854068653508,203.15987434387208,186.41120800120908,212.67321559361048,1.8758700444028573,208.17142840794153,5.026201580042779,211.06232033747315,206.94981525091436,4.724845008462758,8.424029357717856,16710100,3.466568915556764,0.6112251131180342,-537205500.0,-16.228965079507727,70.74152269624075,78.01649708558223,109.88823460613355,32.71209321664636,11.038738719013084,0.31336024011377717,5.923152507931267,212.4465604248047,209.6667191772461,207.4199981689453,205.17327716064455,202.39343591308597,0.1,0.0,178.96162057319262,0.003660750416160541,0.009012052045072967,213.26319013323103,208.3375974382673,6.9297252421088
2023-04-12,0,214.56499862670898,190.62000274658203,214.69000244140625,200.92999458312988,211.34750080108643,-0.19329695705514569,6.734033806444952,-0.795549977127028,2.9951909970326573,204.2899990081787,5.548988895416261,0.03286078740205668,197.07324829101563,213.97275314331054,0.7435680720395852,0.12627216109541164,1.0470358490102576,1.0224793839488546,1.0042521412423524,0.0015987992836459242,76.4352862496794,218.394191994909,204.92612438201905,191.45805676912912,213.3925007411412,1.3656980974382102,209.0448213304792,4.9967582584165156,212.00234405845325,208.31274048449788,4.455500305944167,6.432343791489667,18972200,2.662088547002858,0.7239866316506889,-556177700.0,-15.441182363284058,70.74152269624075,78.01649708558223,99.59334170360965,30.997206903834893,11.481450806412534,0.2415369454101825,5.804355507851772,212.4465604248047,209.6667191772461,207.4199981689453,205.17327716064455,202.39343591308597,0.1,0.0,179.02015176242648,-0.0033531932420292065,0.004364655319462108,213.55687168666296,209.34908948625838,6.58258108994142
2023-04-13,0,218.22999954223633,194.82999801635742,214.69000244140625,201.6012487411499,212.70124912261963,-0.03045405785970685,6.190795042637629,-1.2481207003772057,2.995280983437191,204.91250038146973,5.429051437377927,0.030034415395076976,198.26974639892578,214.2567497253418,0.7741520581802682,0.10129343946661984,1.058734849526925,1.0327468670344302,1.0210784829253259,0.026047303358399,74.73616372462833,218.50496426130064,206.12337417602538,193.74178409075012,214.43964331490653,1.85760047211641,210.04071426391602,5.352417497971207,212.6524405911185,209.22240805974016,2.402995261003812,6.04312154387764,23310400,2.5847082043347593,0.9226535869274382,-532867300.0,-3.4408077116937927,70.74152269624075,78.01649708558223,135.61720810412376,33.53174865242612,10.487676849036644,0.2004996646474706,5.900472535612192,215.6629938964844,212.26849389648442,209.5249938964844,206.7814938964844,203.3869938964844,0.12000000000000001,0.0,179.10107956540355,0.04194248467460837,0.026220192334532884,214.59473528180803,210.49459184919084,6.88790876906848
2023-04-14,1,219.75750350952148,197.3224983215332,218.22999954223633,202.1818733215332,213.03750133514404,0.0807844430476286,6.156991531187946,-1.3072087098568403,2.995291417562233,205.55624961853027,5.586713905334472,0.029701825026465154,199.78349494934082,214.5774990081787,0.8182923728071596,0.08431881893360577,1.0601279674382198,1.0331611188632719,1.0229224678787285,0.033010566568838495,77.30487465095622,219.60735731469524,207.29337425231932,194.9793911899434,215.2303581237793,2.725189702425568,211.05339322771346,5.768545958464295,214.05028149340302,210.3667130378969,3.47557987829506,6.824940915256963,21591200,2.3436647648160407,0.906365932777748,-511276100.0,-2.560904358743308,70.74152269624075,78.01649708558223,131.52729536316104,32.831530575880905,9.899193373379424,0.1579302651554843,5.804724322967142,216.39643902587892,212.86177804565432,210.00499725341797,207.14821646118165,203.61355548095705,0.14,0.0,179.17821384531445,0.02494211006965319,0.0473330778227753,215.55989510672433,211.59803771972656,7.48192907077615
2023-04-17,1,219.18999862670898,197.3224983215332,219.75750350952148,203.37249851226807,214.01437759399414,0.02323669194855491,6.5574989490056845,-1.2004619252002418,2.995236330236065,207.55500030517578,5.90825138092041,0.03149339194992,199.78349494934082,215.04400215148925,0.8002516487997892,0.10778831876697444,1.052693502802632,1.0236472249708288,1.0136539549337917,0.024515623319775637,81.78207726991924,221.33324760046497,208.21824970245362,195.10325180444227,216.1589295523507,2.8210389852441686,212.15857178824288,5.7370504156042506,215.47257736727633,211.48595188754175,2.583763921180962,6.896344795195493,15481900,2.169958866266508,0.7008947761452485,-526758000.0,-13.424201151247283,70.74152269624075,78.01649708558223,106.55142182756539,31.038208694693132,9.884652510766324,0.273954167916493,5.7015297720651565,216.39643902587892,212.86177804565432,210.00499725341797,207.14821646118165,203.61355548095705,0.14,0.0,179.2314812669945,0.019138562821742644,0.012771834322758746,216.61201913016183,212.73997606549943,7.139663170047518
2023-04-18,1,218.6125030517578,197.3224983215332,219.75750350952148,204.14499855041504,214.30812454223633,-0.05442453483202401,6.5644583464533515,-1.187594448782615,2.9952398077334452,210.21500205993652,5.860601139068604,0.03137001683061679,201.53749961853026,218.32599945068358,0.7947138320708734,0.1108211202026396,1.0446982124308983,1.0163650631885133,1.0061025535368704,0.018270532235995063,80.4344214001782,222.38791651743065,209.25899982452393,196.1300831316172,216.9985727582659,2.487009390883517,213.49232237679618,4.766339134622008,216.4189148992043,212.51256288985215,3.0560910442282307,7.595076485881402,12281000,2.1469197127656936,0.5727143423415021,-539039000.0,-21.563615949600013,70.74152269624075,78.01649708558223,91.50677319832191,29.362501143669842,10.525212231284462,0.24940871220446462,5.5964201974553225,217.49147888183595,214.6342578125,212.3249969482422,210.01573608398436,207.15851501464843,0.14,0.0,179.27277553429516,0.018891639390842485,0.014621650959765451,216.86720711844308,213.96674128941126,6.757734546002009
2023-04-19,1,214.8574981689453,199.93999481201172,219.75750350952148,204.29124927520752,214.5962495803833,-0.06461872372187083,6.261737007679048,-1.3524647519620772,2.9952886972529362,211.79500007629395,5.597900924682617,0.029771932313136254,202.27524795532227,218.67025260925294,0.8491450026880251,0.08376919359684583,1.0215572587304529,0.995338482415987,0.9852639622299718,0.00136322114095222,76.45930171028061,222.84697407639322,210.32350006103516,197.8000260456771,217.1289291381836,2.318485856534971,214.2469651358468,3.9670568313796237,216.97811512412778,213.3833621571126,2.762828131028409,9.3390560789513,15898100,2.0359344557222125,0.7699935898848528,-554937100.0,-33.22968321983501,70.74152269624075,78.01649708558223,52.51165422548184,27.48846046375368,14.074098711723268,0.23019206563271913,5.550962091484409,217.55756219482421,214.74122317504882,212.46500396728516,210.1887847595215,207.3724457397461,0.02,1.0,179.3221822993852,0.007943944898889388,0.008650853767023826,217.00264413016183,214.70451136997767,6.513667211439409
2023-04-20,1,214.0175018310547,199.93999481201172,219.75750350952148,205.22250080108643,214.73187637329102,-0.23401490622419968,6.008334263878989,-1.2204638450087415,2.9953257723420363,212.71249961853027,5.2708131980895985,0.028478132837862925,203.57949867248536,218.67025260925294,0.8634147306570001,0.06187681769018827,1.0143941031066277,0.991155591365175,0.9811488187620256,-0.01930301846683713,61.44765216111279,222.997293489611,210.98062496185304,198.96395643409508,217.03285762241907,2.4467757118304996,214.85303660801478,3.0829091407654134,216.44661391906834,213.5519761228523,0.42650898336273513,5.171505880236553,16475400,2.2854891591575637,0.8218413438263754,-571412500.0,-58.93086991033729,70.74152269624075,78.01649708558223,33.563919568340786,26.05162885181395,13.548557642321121,0.2706308198972449,5.4387502083446915,218.4897614746094,216.25012200927736,214.44000244140625,212.62988287353517,210.39024340820313,0.04,0.0,179.37164715918044,-0.0330382327187182,-0.004345687889697617,216.89144461495536,215.07731737409318,5.904498838770998
2023-04-21,1,211.52250289916992,199.93999481201172,219.75750350952148,205.56812381744385,214.73187637329102,-0.40068568952314376,5.699559018754989,-0.9616184018875682,2.995367994271936,213.34000205993652,4.8737006378173815,0.026940037892597562,204.23049850463866,218.67025260925294,0.8742710648367513,0.04762897108050975,0.9998009011731364,0.9789988981217161,0.9734705798740796,-0.03747312596311303,57.6314069472128,222.96374320535665,211.56462516784669,200.16550713033672,216.5982153756278,3.1323993008150794,214.99535805838448,2.8559043044573236,215.82893996432796,213.62290980897544,-0.31324263016630366,4.128301149432455,17717200,2.2874494888331265,0.9056340670367131,-589129700.0,-66.28324078604135,70.74152269624075,78.01649708558223,-2.8191002075435048,24.712936244397795,17.13229289374232,0.3282656779269271,5.323839609966107,218.82723974609374,216.79637921142577,215.15499877929688,213.51361834716798,211.4827578125,0.06,0.0,179.42127765081358,-0.03882795297270758,-0.03385523372272607,216.73319789341517,215.14503479003906,5.603010918205377
2023-04-24,1,212.77499771118164,199.93999481201172,219.75750350952148,208.54250144958496,214.73187637329102,-0.5385982289070006,5.450355020927022,-0.6048170985696353,2.9953999459611804,213.34000205993652,4.4396003723144535,0.025718153348869913,204.2349994659424,218.67025260925294,0.8742753239066827,0.028906046016887652,1.0040043261275262,0.9853488385403881,0.9867139529206921,-0.029266850475474504,49.450020590459175,222.82708543095313,211.92637538909912,201.0256653472451,215.81892939976282,3.3310363651713835,215.12928635733468,2.688113465500878,214.73793209482366,213.24590198005183,-1.4179832437779223,0.9509379470760781,15750900,2.3741450787858227,0.8305231179378261,-573378800.0,-69.24221898505311,70.74152269624075,78.01649708558223,-0.15072314801045175,24.321761153111137,16.372908954428006,0.33477339742903445,5.172850456044653,218.93343902587893,216.9682780456543,215.37999725341797,213.79171646118166,211.82655548095704,0.06,0.0,179.46596733576706,-0.027734643398204306,-0.03927942956002226,215.65541294642858,215.1250741141183,5.382151746950499
2023-04-25,1,209.19000244140625,199.93999481201172,219.75750350952148,210.55750179290771,214.73187637329102,-0.7188442374406167,5.253487651745033,-0.1628084849949074,2.995424155134472,213.36000061035156,4.056787624359134,0.02474720211927902,204.2349994659424,218.67025260925294,0.8363050649813233,0.04446107470471873,0.9854153307147053,0.96927210450397,0.9758953602011557,-0.043101380199286776,54.05603489611199,222.7931006773304,212.28612537384032,201.77915007035025,214.3092863900321,3.6297835582840756,214.76982225690568,3.120419492888194,214.22556666569392,213.06323807653314,-2.4996571701861385,0.8890451264755724,19198200,2.3253224523400453,1.0105068351142994,-592577000.0,-97.19627310591822,70.74152269624075,78.01649708558223,-74.07406386460129,22.43359126037767,20.012196635441892,0.3106198439340578,5.207646023707389,218.57472161865235,216.38764224243164,214.62000274658203,212.85236325073242,210.66528387451172,0.08,0.0,179.51397875359655,-0.04745509848702012,-0.05167686137743345,213.6680690220424,214.61398206438338,5.0063998026992325
2023-04-26,1,211.2224998474121,199.93999481201172,219.75750350952148,210.55750179290771,214.73187637329102,-0.785228615815514,4.932797638359938,0.35838887299983524,2.99546128070038,213.36000061035156,3.7010748863220213,0.023206640134997795,205.40850105285645,218.67025260925294,0.7161724574317943,0.046263918522612774,0.9937088244315782,0.9811900503368309,0.9941168821407538,-0.016918182295294848,46.85211203514945,222.42534583366566,212.5597505569458,202.69415528022594,213.17107227870397,3.0465869362235907,214.66500091552734,3.2187579580712193,212.96259869963617,212.55540792490805,-4.808710009602641,-2.3491918027240097,41992700,2.307111752964459,2.084847696500645,-550584300.0,-84.84653096730341,70.74152269624075,78.01649708558223,-53.87716301778013,24.28973760852381,18.244340062695944,0.17261241385217901,5.304242561914046,218.57472161865235,216.38764224243164,214.62000274658203,212.85236325073242,210.66528387451172,0.08,0.0,179.6261563218153,-0.029207295660363286,-0.038964643336955464,212.3194100516183,214.46571459089006,4.169952174125852
2023-04-27,0,239.22750091552734,204.29249954223633,219.75750350952148,211.1418752670288,214.73187637329102,-0.3296121069483633,4.0175559064240005,-0.16835075507780495,2.9955541990954715,213.36000061035156,3.0848751068115234,0.018850801634397174,208.82425231933593,218.67025260925294,0.7329260531296442,0.03392195171484033,1.1224809984698298,1.1130095961215163,1.129787881426983,0.11779410033658566,49.48870687917083,221.1589876215638,213.1238758087158,205.08876399586782,216.1160719735282,10.362651637733485,216.55732236589705,7.254411998517461,212.5438159091685,212.57821785858644,-3.63497368913529,-0.6899707502807755,71196500,2.1557139105100256,3.1282617411697506,-479387800.0,-9.056727731261622,70.74152269624075,78.01649708558223,391.5844571414972,43.78384786642473,12.425692674913876,0.0783842912442939,7.231797274995068,233.53384301757814,228.48808337402343,224.41000366210938,220.33192395019532,215.28616430664061,0.02,1.0,179.98499424038872,0.11963197162048322,0.10598055195650793,215.2662135532924,216.06671033586775,6.587558923184334
2023-04-28,0,238.87749862670898,205.53250122070312,239.22750091552734,211.44750213623047,215.70062351226807,2.3561365629720425,6.5772274939144335,6.705737793671764,2.9952743779444146,213.9812526702881,4.066437625885013,0.03061017515566712,209.49600257873536,219.24674911499022,0.10192683341841624,0.16394000702906908,1.1117271039319658,1.1006290285923144,1.1018970087575541,0.12932428158993003,80.0288202266826,228.02508086520925,214.87062587738038,201.7161708895515,219.54750061035156,13.406359881472738,218.33821487426758,9.327825946358312,219.2239833990532,216.3741046277979,9.42992627411105,12.453287060975837,39554000,6.5446226730937935,1.675561849514602,-518941800.0,-3.9641065218965403,70.74152269624075,78.01649708558223,271.00354897159616,41.7076383520117,12.869980697508915,0.11206856686749408,7.049525517907573,233.53384301757814,228.48808337402343,224.41000366210938,220.33192395019532,215.28616430664061,0.02,0.0,180.18190287744966,0.12884595923666908,0.12789217976650494,218.7761448451451,217.88939448765345,8.39496519170916
2023-05-01,0,240.56499862670898,209.19000244140625,239.22750091552734,212.39812469482422,218.3256254196167,2.051420350588684,8.058329090551481,3.19938926532301,2.9950565044106496,214.1200008392334,5.466774978637693,0.03721440908537127,210.76300163269042,221.66950302124027,0.45875087835018585,0.14006345472911308,1.1109603703096533,1.0987249244929969,1.0823657980495798,0.13060745489114822,78.89466680041662,232.65453392878362,216.53787574768066,200.4212175665777,223.3400001525879,15.214334680123615,220.1864288875035,10.96850845688079,224.14869356880496,219.6443463934296,11.179503001974092,11.653693569935553,29143900,6.538860546497422,1.224966469243964,-489797900.0,-2.224050536520118,70.74152269624075,78.01649708558223,224.58302741239902,42.13639192407152,11.891599716197248,0.11021200313876901,7.084558929923803,235.29868115234376,229.91566186523437,225.56500244140625,221.21434301757813,215.83132373046874,0.04,0.0,180.33199986279146,0.1428168113562256,0.14228001356283082,223.0687473842076,219.98009599958147,10.134144373991152
2023-05-02,0,241.58250045776367,209.19000244140625,240.56499862670898,212.72375011444092,218.7568769454956,1.6291542092087257,9.430713529210818,1.160842266210567,2.9948181301237216,214.39374923706055,6.783262405395504,0.04324237572262813,211.19025001525878,238.91249885559083,0.602108858535607,0.1406590653684276,1.1077211942075387,1.0927045605744499,1.0604258267538953,0.15484725674416722,79.60335843646148,236.95105260773803,218.0896255493164,199.22819849089475,227.63428551810128,15.561197720609474,222.11625044686454,12.209891179322758,228.25862218318957,222.6822521900168,12.404357853224022,12.052259486263038,24350100,6.5387986733600005,1.0098385239580614,-465447800.0,-15.030414620014016,70.74152269624075,78.01649708558223,173.5201063259187,40.52596784672083,11.172252246786746,0.031242740773935174,7.002089911770452,236.00155975341798,230.4842207336426,226.0250015258789,221.56578231811523,216.04844329833983,0.06,0.0,180.4565079344544,0.15268611119276176,0.12430099806658237,226.82531520298548,221.77925654820032,11.041031160498033
2023-05-03,0,237.75,209.19000244140625,241.58250045776367,212.76499843597412,219.3318748474121,1.2860615166387728,10.563902792602518,-0.019016674738346673,2.9945980581008977,214.62750053405762,8.18912496566773,0.04810000179283531,211.49250259399415,239.36125068664552,0.6953218962904398,0.12771767965475025,1.08253319353285,1.0643119736220692,1.0147463680815896,0.12559031434506962,79.71442252065805,240.7515560811157,219.62375049591066,198.49594491070562,231.2021429879325,14.406753299955094,223.51053619384766,12.830712776288122,231.58573756037143,225.38448896364875,14.211252772913229,12.591756346084471,34463900,6.526368421490137,1.3905290109962825,-499911700.0,-20.878541390330714,70.74152269624075,78.01649708558223,117.04393669475817,36.879621411007065,16.4053332696666,0.019430232295153057,7.144797775215918,236.00155975341798,230.4842207336426,226.0250015258789,221.56578231811523,216.04844329833983,0.06,0.0,180.62065098554066,0.13194848228508094,0.14203804111402427,230.28107125418526,222.96824210030692,11.609732249312817
2023-05-04,0,235.17749786376953,209.19000244140625,241.58250045776367,212.76499843597412,224.2556276321411,0.9841385328424399,11.188456313487126,-0.7695551357832251,2.994468599906013,214.77375030517578,9.400187110900882,0.050672327689903165,211.49250259399415,239.36125068664552,0.7575348623182344,0.11782407040809513,1.0651148740402276,1.0421162368291201,0.9815400975096361,-0.016929504493665593,72.53195181777325,243.1770381305143,220.80012550354004,198.4232128765658,234.91464233398438,10.646735016444774,224.61196436200822,13.141836303787215,233.1140039385923,227.21647159900536,11.737752347538098,8.944691609178033,17889400,6.601280926485865,0.7239922652854908,-517801100.0,-30.16669997839777,70.74152269624075,78.01649708558223,85.85019919357158,34.89947817239659,15.524496956596792,0.007618660896886866,7.010883953590129,236.00155975341798,230.4842207336426,226.0250015258789,221.56578231811523,216.04844329833983,0.06,0.0,180.70203999671062,-0.02112675469566594,0.11518634956530056,233.98346383231026,223.82576642717635,11.711184218906231
2023-05-05,1,232.38750076293945,209.19000244140625,241.58250045776367,213.65250205993652,235.82062339782715,0.740926854388198,11.443953404540215,-1.1994189490270586,2.9944186122212164,216.54374885559082,10.163299369812012,0.05156687693581082,211.49250259399415,239.36125068664552,0.7847274626563938,0.1054950863234958,1.0471466659859756,1.0201875456023195,0.9731857072380111,-0.027168728327616076,67.63884755760402,244.81240727447351,221.92450046539307,199.03659365631262,237.93821389334542,3.193554267488206,225.5546430860247,13.196218712703235,233.62842018026362,228.4339484635256,12.422914632185796,7.016822683180846,26978900,6.653535404179156,1.0899198302596784,-544780000.0,-32.12490485967685,70.74152269624075,78.01649708558223,61.04841874995021,33.14308122489068,17.95246358081778,-0.022817241223925172,6.855105569209342,236.00155975341798,230.4842207336426,226.0250015258789,221.56578231811523,216.04844329833983,0.06,0.0,180.8187997155837,-0.031374890137080724,-0.02422875174005843,237.31661551339286,224.81801278250558,11.859259314556873
2023-05-08,1,232.64500045776367,209.19000244140625,241.58250045776367,213.9993772506714,235.82062339782715,0.5444579869108628,11.456434480312856,-1.4241533295642563,2.9944229509452995,218.42125129699707,10.521761894226074,0.051395550752366514,211.49250259399415,239.36125068664552,0.8011146963934652,0.08620204702559084,1.043685794987831,1.0120478290889239,0.9795888329365511,-0.032922487536247824,62.415250012647554,245.81999443364816,222.90712547302246,199.99425651239676,236.99785668509347,3.682360629895688,226.55696432931083,13.161240405748247,233.3235654029032,228.37517489203788,10.02023976177586,6.021032993711745,16400500,6.7123157749487135,0.6621695687853092,-528379500.0,-30.828250770712252,70.74152269624075,78.01649708558223,57.462641831957235,32.261127753651266,16.935747021618823,-0.039460049027193564,6.747597374603127,236.00155975341798,230.4842207336426,226.0250015258789,221.56578231811523,216.04844329833983,0.06,0.0,180.8903657378371,-0.040751590082745204,-0.029335864893963434,236.5624520438058,225.9143327985491,11.915280069607872
2023-05-09,1,232.94750213623047,209.19000244140625,241.58250045776367,214.4281244277954,235.82062339782715,0.3545963340871167,11.44993428992192,-1.5690600519473938,2.994431127477303,218.9012508392334,10.747549514770508,0.051151829770786465,211.49250259399415,239.36125068664552,0.8026877912482485,0.08363220369918131,1.040677673171488,1.004679506760388,0.9874485329126932,-0.0357434760596117,62.49532420842779,246.7419939002784,223.84212532043458,200.94225674059075,236.15071432931083,3.8558925857646247,227.84910746983118,12.807521311018583,233.16973759612767,228.4380448877064,-2.751565113781794,6.418890598715473,16865600,6.714060825159911,0.680734270814834,-511513900.0,-30.563654680500118,70.74152269624075,78.01649708558223,53.441150372594244,30.868409966650592,16.05709679382914,-0.018655133484965124,6.60848349439953,236.00155975341798,230.4842207336426,226.0250015258789,221.56578231811523,216.04844329833983,0.06,0.0,180.96430577066488,-0.024536067715323684,-0.040340444988641797,235.5716291155134,227.17388698032923,11.858039908338258
2023-05-10,1,234.18000030517578,209.19000244140625,241.58250045776367,214.4281244277954,235.82062339782715,0.168874598198972,11.411616064081525,-1.6426360746831867,2.9944462339532345,219.47375106811523,10.836499710083007,0.05077358033675183,211.49250259399415,239.36125068664552,0.7994835157663317,0.0856733559861857,1.0419345508985456,0.9997513230041882,0.9999935949724326,-0.01501577158706291,62.89614011120627,247.57823243333883,224.75500030517577,201.9317681770127,235.23857171194894,3.361081785763446,229.28928593226843,12.254208448884263,233.13037608479084,228.56667016052774,-2.4824424755657923,8.419535795330143,19119000,6.711153009167768,0.771458107875821,-492394900.0,-31.331035833328286,70.74152269624075,78.01649708558223,48.371417342006026,29.79013439294696,15.003975467288358,-0.014270534892986759,6.567163157606384,236.00155975341798,230.4842207336426,226.0250015258789,221.56578231811523,216.04844329833983,0.06,0.0,181.04799043563423,-0.016664535778346035,-0.025748209843877424,234.13173348563058,228.60024043491907,11.713786019438599
2023-05-11,1,234.8375015258789,209.19000244140625,241.58250045776367,214.64749908447266,235.82062339782715,-0.02288033001288258,11.336350162487486,-1.6520259516494245,2.99447007158038,226.07250213623047,10.798249626159668,0.05021956045042533,211.49250259399415,239.36125068664552,0.8075551232930533,0.07308803004351601,1.0403203795636764,0.9928276759820134,1.0058680596610334,-0.0014457009747061988,63.297654153444704,248.40845071407406,225.7357503890991,203.06305006412416,234.2750004359654,1.8795993703635407,230.95464297703333,11.192200034397292,233.41518396727503,228.9239954567521,-2.6541676295315813,9.420957772900909,20449000,6.681609515202468,0.8299150928961881,-471945900.0,-24.15984785623868,70.74152269624075,78.01649708558223,54.837282702440056,29.46083878583924,14.032563169135567,-0.04028173326275638,6.520223193642207,236.00155975341798,230.4842207336426,226.0250015258789,221.56578231811523,216.04844329833983,0.06,0.0,181.1404609706785,0.009720752540680166,-0.00523140608568803,233.63988603864397,230.23260062081474,11.848905895806771
2023-05-12,1,234.7400016784668,209.19000244140625,241.58250045776367,214.64749908447266,235.82062339782715,-0.20221486586589474,11.364356167430817,-1.627166364475305,2.9944693179408715,232.51625061035156,10.795012130737305,0.05015911422300691,211.49250259399415,239.36125068664552,0.8113615020706563,0.06862108358317807,1.0360772210433917,0.9942607916415456,1.0057433740642538,0.010123181788194158,63.655492978364244,249.29483782314287,226.56612548828124,203.83741315341962,233.84500067574638,1.1578477438331287,232.52357183183943,9.91431502314338,233.77495695211496,229.41998274995916,-2.792006423935498,11.022467258636281,16155300,6.679718319945601,0.6629698899071839,-488101200.0,-29.399318825569683,70.74152269624075,78.01649708558223,42.48853231972201,27.662630363104622,14.1176501586181,-0.07773897480233785,6.448065091640828,236.00155975341798,230.4842207336426,226.0250015258789,221.56578231811523,216.04844329833983,0.06,0.0,181.21146891227949,0.004424736036773069,0.0012417676826506688,233.18082754952567,231.73094940185547,11.895302942794421
2023-05-15,1,237.84249877929688,209.19000244140625,241.58250045776367,214.64749908447266,235.82062339782715,-0.3696240993712356,11.384645313223785,-1.5587472141350047,2.9944696050754493,232.79625129699707,10.713449859619141,0.05008306874859651,211.49250259399415,239.36125068664552,0.810864165499241,0.07094303184079219,1.0463112279717062,1.0091702178019208,1.0169859218277633,0.022340898413059973,63.752944710956086,250.0845410231761,227.31525039672852,204.54595977028094,234.22571509225028,1.8812011433592772,234.57017871311731,7.353766581298961,234.01972443812429,229.93686419680375,-1.266035045860443,10.323113243361517,20653200,6.675500559402382,0.8386527760181657,-467448000.0,-16.814646746689235,70.74152269624075,78.01649708558223,62.76297264500248,29.341668427346285,13.108966041617446,-0.055621603652854054,6.448203081398066,236.41455975341796,231.15272073364258,226.9000015258789,222.64728231811523,217.38544329833985,0.06,0.0,181.30894899162507,0.02396358262226328,0.02611909931467596,233.94211905343192,233.9627914428711,12.005395098021225
2023-05-16,1,237.44250106811523,209.19000244140625,241.58250045776367,214.64749908447266,237.77312469482422,-0.5520429949048212,11.444672193302727,-1.425599900082803,2.9944627385578593,233.56375122070312,10.553762187957767,0.0501414182849573,211.49250259399415,239.36125068664552,0.7989014948080886,0.08796384222811925,1.040283510404942,1.0086381602570833,1.0107828766974623,0.019296188586113372,68.08696977841967,251.13721979096334,228.2478754043579,205.35853101775245,234.94785799298967,2.0228591136092913,236.44303594316756,3.0005420863546086,234.96671057098064,230.9510908490469,1.1331870352116298,13.696876525404765,18163800,6.685567765426626,0.7288616166909704,-485611800.0,-40.47773096523275,70.74152269624075,78.01649708558223,57.75277251435469,27.967112932301173,12.494856405981613,-0.027960483522667896,6.281902512525583,241.3634800415039,239.16326119995117,237.38500213623047,235.60674307250974,233.40652423095702,0.06,0.0,181.3941685019544,0.02335355595955968,0.023792177269447837,234.80320957728796,236.0599125453404,11.98039954929242
2023-05-17,1,240.72999954223633,209.19000244140625,241.58250045776367,214.64749908447266,237.77312469482422,-0.7523633815556484,11.38767476639043,-1.19046566536818,2.9944815505157703,234.4600009918213,10.155124893188475,0.04968674813667622,211.49250259399415,239.36125068664552,0.7824864046261011,0.10511619604455709,1.0503540978795098,1.024404770626188,1.020870744086143,0.02796993436042694,69.47126658003248,251.96472483795668,229.1893753051758,206.4140257723949,236.10285786220007,2.6877372498042447,236.55035727364677,3.1317953578098376,235.50086596692415,231.84074080517408,2.175246210996706,12.413450858523381,21193100,6.601099521053328,0.8414792144536962,-464418700.0,-16.124711049819197,70.74152269624075,78.01649708558223,77.68791537291634,30.949863953445085,11.67964592344484,-0.013699647602546758,6.240337829362416,241.3634800415039,239.16326119995117,237.38500213623047,235.60674307250974,233.40652423095702,0.06,0.0,181.4994001944676,0.040372397811937466,0.039079598384880544,236.1176496233259,236.34005083356584,11.894971260173689
2023-05-18,1,244.10750198364258,209.19000244140625,241.58250045776367,227.79500102996826,238.1012487411499,-0.9888460797947456,11.153243297062033,-0.7345979163618424,2.994541682685139,234.78875160217285,9.368749713897708,0.04839074152528222,211.49250259399415,240.5814987182617,0.7505969804098216,0.12481454779464006,1.0591128264891705,1.0374618095575368,1.029474720232931,0.03947410612670876,73.75436545208878,252.7894869679644,230.48300037384033,208.17651377971626,237.6971435546875,3.6439314577469477,236.92392894199915,3.692475887455687,236.7544834112295,233.21245679617792,3.475251593012623,0.6280626687813479,22943300,6.59867855720229,0.8994224570419961,-441475400.0,-1.3920555122852503,70.74152269624075,78.01649708558223,102.93517219042766,32.58614084834249,10.887800751261159,0.05521162920805179,6.21602754844252,243.02135864257815,240.5043200683594,238.47000122070312,236.43568237304686,233.9186437988281,0.08,0.0,181.61963084665513,0.04690622761986796,0.059078487354142395,238.03941781180245,236.80552346365792,11.688432546784702
2023-05-19,1,246.3025016784668,209.19000244140625,244.10750198364258,232.58062553405762,238.96499919891357,-1.217393663220971,10.856198039053716,-0.05759498062640045,2.9946152868236697,235.00749969482422,8.323999862670906,0.04679647834992091,211.49250259399415,240.81524963378905,0.6954451364844972,0.1540497991365274,1.0617059163681584,1.0428327708636373,1.0306729897766225,0.04925662399814423,78.59346642979003,253.69989645957713,231.98750038146972,210.2751043033623,239.42892946515764,4.478796965248692,237.3337505885533,4.381743607192729,238.55800790490264,234.91771132263892,4.790778928758638,2.1894081221548864,21599800,6.5460454362632206,0.8403592491242773,-419875600.0,-16.188979005392387,70.74152269624075,78.01649708558223,113.1851163280544,32.446119897978214,10.220026655668832,0.023162645612625272,6.14916835064631,244.24376330566406,241.49312384033203,239.27000427246094,237.04688470458981,234.2962452392578,0.1,0.0,181.7339530213059,0.05059670871778321,0.041774473894244775,239.83002362932478,236.98087855747767,11.126570288180028
2023-05-22,1,248.1050033569336,209.19000244140625,246.3025016784668,232.87187671661377,239.56187534332275,-1.4406135214946425,10.204806322736289,0.9605092352529221,2.9947578647398565,236.30999946594238,7.119149856567378,0.043661314864791516,212.6197479248047,241.83500061035156,0.647002940232671,0.15757257350694467,1.0615184971185825,1.0443118662366493,1.0282653406939106,0.04314832139044955,80.06166245224122,254.13611296590716,233.72650032043458,213.316887674962,241.32428686959403,4.990058839927289,237.7996436527797,5.148002027645713,240.48780384546617,236.82790680912956,5.176574155561263,2.3850115704740764,27738500,6.545923767879157,1.0545981769368502,-392137100.0,-22.133219771581317,70.74152269624075,78.01649708558223,140.63486154322763,34.86531112519921,9.242991573907224,0.0009812825795971498,6.31351434038831,247.97208703613282,244.50896685791014,241.7100067138672,238.9110465698242,235.44792639160153,0.12000000000000001,0.0,181.88721066745057,0.0396048426346034,0.06205905379886969,241.6163548060826,237.62812042236328,10.408667941801738
2023-05-23,1,247.95249938964844,209.19000244140625,248.1050033569336,233.87187576293945,240.60624885559082,-1.6581792554667114,9.455492754821947,2.4637705854237906,2.994907036425521,237.59625053405762,6.210949840545655,0.04015190570684268,230.27100067138673,244.327001953125,0.5205588486847089,0.18602705894813193,1.0529081490958856,1.036922335695556,1.0189654197763625,0.0442633407004005,84.06807267272538,254.40398611236603,235.49300060272216,216.5820150930783,243.21178654262,4.565193095200635,238.52839360918318,5.818855078584417,242.41678583030318,238.78248347537405,5.649652097662357,2.6999070242301193,17748100,6.423594712084675,0.6766354313564695,-409885200.0,-28.794272679435345,70.74152269624075,78.01649708558223,135.56867345461305,32.878400111734194,8.716250203677857,-0.0024671103043294616,6.216835224208109,247.97208703613282,244.50896685791014,241.7100067138672,238.9110465698242,235.44792639160153,0.12000000000000001,0.0,181.98392940595312,0.03316300463813415,0.03299005935733381,243.459712437221,238.32026999337333,8.342881023859233
2023-05-24,1,247.25749969482422,211.2224998474121,248.1050033569336,234.60000133514404,240.94312477111816,-1.650325337649794,7.669392752995216,4.3354292839249755,2.9952005997201296,237.79624938964844,5.131149902343748,0.03230154740013628,232.61925048828124,246.46750144958497,0.29565277815694196,0.17389245733181935,1.0413862092683113,1.0275679015325914,1.0074071145672268,0.02711544122045595,83.21301193920522,252.7699109561247,237.4311254501343,222.09233994414387,244.5567866734096,4.080876015852804,239.39125088282995,6.168863758016122,243.86530215843283,240.57188627423488,5.628566761825005,4.291272088180205,17724300,6.442376987580737,0.7085041038897912,-427609500.0,-18.381114612026632,70.74152269624075,78.01649708558223,126.8256509353281,31.09326324864779,10.232258061562984,0.09427678552333195,6.104204093168004,247.97208703613282,244.50896685791014,241.7100067138672,238.9110465698242,235.44792639160153,0.12000000000000001,0.0,182.07963304679595,0.027712496851203694,0.04350552383820643,244.9352525983538,239.43868582589286,5.5701126567087025
2023-05-25,1,252.71999740600586,232.38750076293945,248.1050033569336,234.81312656402588,242.2137508392334,0.42399962283610027,5.10456275359018,-1.042054842583762,2.9955052882395203,238.35999870300293,4.273950119018553,0.02133721272274289,232.9172519683838,247.32699966430664,0.8655015765584924,0.03356636987205044,1.0563765408017358,1.044592107061065,1.02421526740458,0.035281567966478855,72.65476723955591,249.44200094968525,239.23287544250488,229.0237499353245,246.7392861502511,3.7104158878923776,240.8435720716204,6.7583970179896635,244.8001928227225,242.0946425757584,3.9585023550664435,5.136546625754233,22371400,1.9519801101695171,0.9909699801840555,-405238100.0,-11.558160686242479,70.74152269624075,78.01649708558223,159.84339183943564,35.78355012841115,9.463091901592023,0.15195184277613333,6.128903582816187,249.63739727783204,245.93629861450196,242.94499969482422,239.9537007751465,236.25260211181643,0.14,0.0,182.20840273258833,0.02365800572050203,0.042063567378880506,246.91261509486608,240.85791233607702,6.285739092129417
2023-05-26,1,257.497501373291,232.38750076293945,252.71999740600586,234.81312656402588,244.65625190734863,0.5310487721251432,5.8903789139678215,-0.8436462017089119,2.99543210165926,238.35999870300293,5.0154999732971195,0.024552708470604468,232.9172519683838,247.96774978637694,0.804933566970652,0.0579481067027095,1.0733199299175042,1.0565300381160756,1.0363427855032321,0.045452237060257694,80.21625021949397,251.68825809496445,239.9075002670288,228.12674243909316,249.1346435546875,4.510480867745618,242.61875070844377,7.6450398664085,246.78924172134887,243.31461923328152,6.43418775879048,8.74939339521869,25727200,2.2409986357722724,1.1756214553017592,-379510900.0,-0.854666175912267,70.74152269624075,78.01649708558223,197.04641246778237,39.42048354169328,8.443615539560517,0.12610235838034592,6.378267263842956,254.85475842285157,250.24261895751954,246.51499938964844,242.78737982177734,238.1752403564453,0.16,0.0,182.36960467119854,0.06676435162851502,0.061535256804733436,249.69974408830916,242.9086968558175,7.947328231106142
2023-05-30,0,264.42749786376953,232.38750076293945,257.497501373291,234.81312656402588,246.54125118255615,0.7012715198119738,7.017632383601476,-0.43405793535372084,2.995310493924564,239.20374870300293,5.8817002105712906,0.02913833283224717,232.9172519683838,248.56650276184084,0.7953798857124758,0.07038639387792503,1.0979452928821873,1.0749270969295655,1.0547293253516254,0.065788655149988,83.89510454968816,254.87376517156088,240.83850040435792,226.80323563715496,252.03750010899134,6.729039471687943,244.86732183183943,9.077061721506633,249.4702371853232,244.9369907415192,6.96527307063481,10.682585426992349,23816500,2.4104085394753305,1.101720847580056,-355694400.0,-16.161365848948822,70.74152269624075,78.01649708558223,197.3952778053952,43.22946812326198,7.755238985370321,0.03823564449023463,6.448389984394416,259.698515625,254.16073669433592,249.68499755859375,245.20925842285158,239.6714794921875,0.18,0.0,182.52818627950717,0.05718428964774369,0.06871850733726521,251.93372453962053,244.9865711757115,9.247854415469984
2023-05-31,0,262.0425033569336,232.38750076293945,264.42749786376953,234.81312656402588,247.43124961853027,0.951858031476127,8.697236169764674,0.15776613026132802,2.995093577205241,239.2862491607666,7.211699981689452,0.03593429642347417,232.9172519683838,253.19774780273437,0.7771580609485248,0.09456395791383032,1.0826787737364685,1.0538428480637896,1.0317812043051473,0.056825416166276455,87.67358972205898,259.4260977057403,242.03162536621093,224.63715302668157,254.28607177734375,7.112163224931274,246.8575006212507,9.593372310974694,253.19958703529588,247.17949525129765,8.324199672277413,13.513772604923313,25473700,2.7625573563682764,1.1753263456097187,-381168100.0,-10.564497306946565,70.74152269624075,78.01649708558223,152.62340994875214,40.0965245403764,10.335514984277005,0.1433163563798683,6.45564697072116,259.87079461669924,254.43959506225585,250.04999542236328,245.66039578247072,240.22919622802735,0.18,0.0,182.6941634487391,0.07287017468714518,0.06604373121635781,254.65384783063615,247.24193572998047,10.472265274127482
2023-06-01,0,269.5999984741211,232.38750076293945,264.42749786376953,234.81312656402588,247.99062538146973,0.7992140331168283,9.72661626337175,-0.48833740919329527,2.9949395636817675,239.2862491607666,8.292087650299072,0.04001823146922488,232.9172519683838,257.9520015716553,0.8540939986107593,0.10217667027101407,1.109215666672148,1.0736148899076208,1.0498892029572968,0.09036125823027796,83.12333788750665,262.5078580379129,243.05462551116943,223.60139298442593,257.3567853655134,8.502969725345578,249.3405361175537,10.6801419478221,255.3898063810766,248.75007337339846,6.390516365527796,11.897900339673884,25609500,2.639893646088933,1.2062311699328412,-355558600.0,-3.2667791979866285,70.74152269624075,78.01649708558223,180.40775246676571,45.76052658297965,9.306437109804579,0.18991021178756073,6.657386385619585,263.95819927978516,257.7458988342285,252.7249984741211,247.70409811401368,241.49179766845702,0.19999999999999998,0.0,182.8771737639434,0.09389674069163889,0.104847237363229,258.1167319161551,249.86654336111886,12.177200169896492
2023-06-02,0,272.93499755859375,232.38750076293945,269.5999984741211,234.81312656402588,249.25875186920166,0.7593480113899534,11.220378631058168,-0.5701549449361716,2.9946918916877348,242.41875076293945,9.408087368011474,0.04586352122925314,232.9172519683838,262.2810028076172,0.8160620538576595,0.14636817264843666,1.115627240963632,1.0745419444459723,1.0446972732932454,0.07998971335897731,88.60231644179035,267.0878826969918,244.64712543487548,222.20636817275914,260.9257136753627,9.118500610953168,252.06875010899134,11.50976006886165,258.9293769971848,251.26523309485228,8.663668538060055,14.802787767017437,19405300,2.8247527751995625,0.9107561905119492,-336153300.0,-6.84662783466673,70.74152269624075,78.01649708558223,165.2682710981048,45.11534616195527,8.87277274396169,0.2083580584851609,6.4840024285272095,265.9052850952148,260.06236447143556,255.34000396728516,250.61764346313475,244.77472283935546,0.2,0.0,183.01878782604382,0.07883183508789693,0.09389674069163899,261.80486842564176,252.63229043143136,13.261526079720714
2023-06-05,0,271.7050018310547,232.38750076293945,272.93499755859375,234.81312656402588,253.91437339782715,0.6787113422263531,12.56420780685812,-0.7297545621001666,2.9944473977897625,245.2050018310547,10.37224946975708,0.050963180828170924,232.9172519683838,264.9447479248047,0.8235107863191237,0.1744822620086489,1.1020950427671414,1.057695309224847,1.024140558017581,0.0551752944474877,91.5745377081808,271.6634160333329,246.5350004196167,221.40658480590048,264.4182139805385,7.559457557763681,254.48750032697404,11.843403607444097,262.41608446598093,254.0269754626308,10.075517782817835,16.27119178964829,20742900,2.6235324420134694,0.98799237913789,-356896200.0,-10.43693472477224,70.74152269624075,78.01649708558223,138.21025454350706,42.11271557907876,10.009782533557528,0.17843512493747216,6.450145809748458,266.1182066040039,260.2709061584473,255.54500579833984,250.81910543823244,244.9718049926758,0.2,0.0,183.16824167696444,0.0356816344840738,0.07400378220671,264.9669429234096,254.9510977608817,13.830553742131329
2023-06-06,0,271.8800048828125,232.64500045776367,272.93499755859375,236.79125118255615,258.63375186920166,0.5332094881178108,13.253811312755163,-1.0300431187300878,2.9943221554810737,246.7800006866455,11.14213695526123,0.05333506889070905,234.05675048828124,269.8104988098145,0.8564593906527113,0.1678952966813585,1.0940806722120708,1.0480130706779713,1.0139403937781866,0.028183555338417987,88.03078062727097,275.00849809853275,248.50087547302246,221.99325284751217,267.1553579057966,5.9056293169782075,256.94732202802385,11.604766304913987,264.7363644383715,256.24639166748494,9.887466372670039,14.237364316955029,19419000,2.6994592086276152,0.9183329648620242,-337477200.0,-14.181657771994907,70.74152269624075,78.01649708558223,119.9958555245078,40.021547115106856,9.250762250768792,0.14562067972531917,6.480850029253051,267.50052545166017,261.8897442932129,257.3550033569336,252.8202624206543,247.20948126220702,0.2,0.0,183.30815250639296,0.03275930254297954,0.03465116599318607,267.59439958844865,257.2535073416574,14.115549554812846
2023-06-07,1,268.0800018310547,232.94750213623047,272.93499755859375,237.74249935150146,262.6387519836426,0.3822280687746469,13.65920189310279,-1.2591379817378667,2.9942542699898884,247.60499954223633,11.910649719238279,0.054535888758811386,234.6840015411377,271.72250213623045,0.8681250414807185,0.1671299429680677,1.0703393414005182,1.0239809384144993,0.9942421652337168,0.023040149581754266,88.07141202849672,277.7810294804804,250.4626256942749,223.14422190806934,268.66714368547713,4.099614731041854,258.9008936200823,10.948208973183009,266.5153722204716,258.14215713365707,7.581516173421464,14.50351291777295,26163600,2.7039639934406345,1.2106710410176382,-363640800.0,-36.659127842585214,70.74152269624075,78.01649708558223,79.05945955217891,35.23322825402435,15.343485867253262,0.09220210752661653,6.835790184808846,268.220326171875,263.05484545898435,258.8800048828125,254.70516430664063,249.53968359375,0.02,1.0,183.4842170986145,-0.004230897368422304,0.004113871152055159,267.8167986188616,258.75827135358537,13.728030674300188
2023-06-08,1,262.9324951171875,234.18000030517578,272.93499755859375,240.00812435150146,265.3406238555908,0.2180768832936185,13.552405116955681,-1.4144779719267457,2.9942932247364435,248.02875137329102,12.09142484664917,0.05373263571464254,234.8277515411377,271.72250213623045,0.8899382141351828,0.14476044701384203,1.0424759189051969,0.9966567216410386,0.9708037742888425,-0.024731095677560266,77.20419810950364,279.32406091292745,252.2192506790161,225.11444044510475,268.45357186453685,4.386216150381762,260.2455359867641,10.115939925791283,266.89686337829306,259.1878390603859,4.1097487941921225,11.361277090859534,20899400,3.0011314605172763,0.9631128701610542,-384540200.0,-36.15808030097909,70.74152269624075,78.01649708558223,54.30974428011294,32.06843901474522,17.980198104148467,0.11583538103098312,6.973947244013424,268.74424645996095,263.90288592529294,259.99000549316406,256.07712506103513,251.23576452636718,0.04,0.0,183.61898257808318,-0.029456061012953394,-0.0005288477311300245,268.11047799246654,260.02210126604353,13.162779894629587
2023-06-09,1,264.27001190185547,234.7400016784668,272.93499755859375,243.26312637329102,265.3406238555908,0.07018899273942002,13.079329959000011,-1.4342523980557824,2.9944035802111464,250.41250038146973,11.818812351226807,0.051563080785266634,237.1820011138916,271.72250213623045,0.8980112196521297,0.11963589038700681,1.0418405235997714,0.9958098587404013,0.9805700851833201,-0.031747433397133595,65.36980574322527,279.81553533761667,253.6568754196167,227.49821550161673,268.77178737095426,3.8971121679972627,261.528929574149,9.3193262418881,265.89580386688533,259.5600662071561,-0.5653734043016366,7.7117634569077556,16938500,3.3727597374297185,0.7869470440878039,-367601700.0,-36.74886560447128,70.74152269624075,78.01649708558223,54.360080070768916,30.309862998690225,16.8206199980118,0.10975386540150638,6.922236726583867,269.1076848754883,264.4911633605957,260.76000213623047,257.02884091186525,252.41231939697266,0.04,0.0,183.72945708641612,-0.028098731895641382,-0.028098731895641358,268.14327130998885,261.3985595703125,12.619814500947255
2023-06-12,1,268.8249969482422,234.7400016784668,272.93499755859375,245.75375175476074,265.3406238555908,-0.0740741454886132,12.523046040030822,-1.4143942051597294,2.9945253592035406,255.10874938964844,11.408500480651856,0.049085249174312014,237.8024990081787,271.72250213623045,0.8790518567917311,0.12579879872301084,1.053684695984369,1.0085841572351804,1.0039268031497735,-0.010599749225828625,66.83021856463576,280.1745930184772,255.12850093841553,230.08240885835386,268.66107286725725,3.8806355411220728,263.00892911638533,8.644309661663511,265.4828544373719,259.95529260274054,0.8500561994279756,7.2948955454964,15442500,3.352625420019879,0.7186341832071583,-352159200.0,-17.457361542941992,70.74152269624075,78.01649708558223,73.88786731813914,32.10647174236092,15.638874824889358,0.14342148851784786,6.913504659897069,269.1076848754883,264.4911633605957,260.76000213623047,257.02884091186525,252.41231939697266,0.04,0.0,183.8354968680747,-0.001252891515640453,-0.005722544428971641,267.9208679199219,263.0187999180385,11.95588313047895
2023-06-13,0,272.75250244140625,237.44250106811523,272.93499755859375,247.01875019073486,268.26625061035156,-0.19210774848416126,11.938063909532966,-1.4317494982244698,2.9946481574385015,259.7700023651123,10.903475341796877,0.04648185979750304,240.44124946594238,271.72250213623045,0.8640474921264233,0.13026476902975676,1.0619848975490647,1.0189888900269826,1.0207898661505583,0.003209127346344598,70.50784181048903,280.7088785209702,256.8327507019043,232.95662288283836,268.63500213623047,3.847609628717773,264.7803579057966,7.823646943662434,266.32386484445385,260.9609122953702,-0.2874634756176746,8.351300179746879,16164000,3.4032357962535102,0.7601501489356299,-335995200.0,-16.60341011142966,70.74152269624075,78.01649708558223,84.11631639304909,34.014486650808514,14.56447236991232,0.11151388063908757,6.89325467581959,269.1076848754883,264.4911633605957,260.76000213623047,257.02884091186525,252.41231939697266,0.02,1.0,183.94966150558855,0.0007377754687907245,-0.0002579250543484936,267.7369602748326,264.77091435023715,11.482293868865082
2023-06-14,1,272.1375045776367,237.44250106811523,272.93499755859375,247.77874946594238,269.0187473297119,-0.31568211373954447,11.5806321238107,-1.3584715142139923,2.994724101403189,262.48749923706055,10.508925247192384,0.04478579340750754,243.76975173950194,271.9672546386719,0.8259884603632448,0.148709692723299,1.0524377191284227,1.013539004324512,1.0178234927378906,0.015135417483095548,73.95316982014099,281.73951513263114,258.57825088500977,235.4169866373884,268.696788242885,3.908121920970422,266.55750111171176,6.192952477904228,267.9389489980289,262.4486209432065,-0.0668639488595895,10.001916944900604,19175100,3.404521489078258,0.8996149855604924,-355170300.0,-11.751825345953943,70.74152269624075,78.01649708558223,79.89810388512821,31.658123544467248,14.355234724419303,0.10846282406997398,6.877306692557917,270.10360516357423,266.1032038269043,262.87000274658203,259.63680166625977,255.63640032958983,0.02,0.0,184.08498142367569,0.036987999091872004,0.008225277218483842,268.0163879394531,266.4916654314314,10.843182340302842
2023-06-15,0,277.38499450683594,240.72999954223633,272.93499755859375,248.0668773651123,270.1262493133545,-0.4001581968853241,10.860863420311256,-1.3718253485065475,2.9948566332363713,263.6012535095215,9.783150405883793,0.041722324186903165,246.08300170898437,272.19900436401366,0.8307180465251115,0.13046776511080377,1.0655825616730656,1.029212985723155,1.0343104338416838,0.05496657757424406,71.93338469824003,282.03472790110834,260.3130010604858,238.5912742198633,269.48321533203125,5.0441928432184255,268.3192866189139,5.412863987442459,268.99195422106914,263.8001454242417,0.15918100280353326,10.062386343597451,25973500,3.4297349352060094,1.205054049621401,-329196800.0,-6.905386189520309,70.74152269624075,78.01649708558223,122.04732051683148,36.58147043812657,12.585732085749179,0.1209297490215685,7.283925986421121,276.6079141235352,272.04103652954103,268.3499984741211,264.65896041870116,260.092082824707,0.04,0.0,184.2818333595474,0.06519769236583817,0.06915786216850228,269.54325212751115,268.5688258579799,10.897529031870848
2023-06-16,0,283.43250274658203,244.10750198364258,277.38499450683594,251.5662488937378,271.74875259399414,-0.43281939104151174,10.487961345439873,-1.2659541228204205,2.994926951099044,264.3487548828125,9.118099822998044,0.04000813025992092,247.16199989318847,272.770751953125,0.8070049596076795,0.13632310458620503,1.0812019720792607,1.0486227362271774,1.0455908739929936,0.07251103031638384,75.48283173127736,283.12167349959554,262.14575080871583,241.16982811783612,271.67642974853516,7.206543017107666,270.1717867170061,5.845063191975138,271.0832249909314,265.8102894925344,2.0247864959382484,9.759812185026526,43102500,3.5038389296471806,1.9104223450603266,-286094300.0,-23.299345325152405,70.74152269624075,78.01649708558223,142.19538851717414,37.593007782572016,11.63698800530345,-0.005173841147420569,7.315074217441275,280.9116075439453,276.61920843505857,273.15000915527344,269.6808098754883,265.38841076660157,0.06,0.0,184.62012223903457,0.0605773632231843,0.06206060625674268,272.0238691057478,269.9203338623047,10.932664549886354
2023-06-20,0,281.0199966430664,246.3025016784668,283.43250274658203,256.3031253814697,271.94437980651855,-0.33086514130547967,10.607476765959834,-0.9120451757776982,2.994921718143269,266.2537498474121,8.808600540161137,0.04016279734335228,247.88299942016602,273.37999725341797,0.7747573872023126,0.15074958969189128,1.0640182791466837,1.0356747803667747,1.0222384570517484,0.04536408382131274,79.04062959928174,285.32695437878243,264.11200084686277,242.89704731494308,274.26035853794644,6.778822502207191,271.3569652012416,6.258309306919115,274.1486792650586,268.5019268877415,5.726835575449811,10.071942925649347,20701600,3.6327393788496063,0.9193823915462439,-306795900.0,-11.972858034065514,70.74152269624075,78.01649708558223,123.13506650293961,34.48189572974592,14.445307210047332,0.04319765897677993,7.405425099928758,280.9116075439453,276.61920843505857,273.15000915527344,269.6808098754883,265.38841076660157,0.06,0.0,184.77978696574885,0.04899469196999129,0.07314580962913769,274.83951241629467,271.4749952043806,10.830768925887146
2023-06-21,0,281.8824996948242,247.25749969482422,283.43250274658203,260.90625286102295,272.2912540435791,-0.39067748900473603,10.389437196480003,-0.719348018799312,2.994964298313021,268.45249938964844,8.542587089538575,0.039080384498930254,248.0897529602051,277.748494720459,0.7982977511588151,0.1326655764324914,1.0603150356715787,1.0352993188571729,1.016358655571204,0.033473559991917146,73.67100758720657,286.62674998805284,265.8478755950928,245.06900120213274,276.77642822265625,5.622727250431543,272.77410779680525,6.233132518887749,275.8605056444334,270.4874600740298,6.879142693191046,6.274876445658148,20556200,3.7616432830994366,0.9277209679326501,-286239700.0,-21.435937844007462,70.74152269624075,78.01649708558223,111.15355394693826,32.468438203727345,13.601820739765191,0.06664986529145565,7.302894822841182,281.0130858154297,276.78346563720703,273.36500549316406,269.9465453491211,265.71692517089843,0.06,0.0,184.93707882302215,0.03803623423788571,0.039070341100272216,277.21890694754467,272.68108912876676,10.444617977174582
2023-06-22,0,281.75250244140625,247.25749969482422,283.43250274658203,262.709997177124,272.7981262207031,-0.4600627169369478,10.109554384366511,-0.47486884672917595,2.9950137485107726,269.21249771118164,8.119399719238277,0.03778753524066703,252.2432476043701,281.1062469482422,0.7759524215706203,0.13684072710981632,1.0531356982079199,1.0310341328024148,1.0092452231370428,0.035331395717367986,74.39016155119297,287.75585918072034,267.5367504119873,247.3176416432543,278.6232147216797,4.60709747933216,273.6421437944685,6.592904241978746,277.34800166054697,272.22172209908047,6.664580542536045,7.571289422031719,17563100,3.7416499529359823,0.7929705365918851,-303802800.0,-10.251988593568448,70.74152269624075,78.01649708558223,115.84552417159684,31.330453739137273,12.609652347205943,0.14090428669060176,7.314830994117038,281.0130858154297,276.78346563720703,273.36500549316406,269.9465453491211,265.71692517089843,0.06,0.0,185.0728834891026,0.04218032356818857,0.04997789770548653,279.1905735560826,273.5557207380022,9.790900726750408
2023-06-23,0,284.7150115966797,247.25749969482422,283.43250274658203,263.9356327056885,274.0474967956543,-0.4881024414744431,9.501274925898864,-0.2589687747555929,2.995105607352121,270.6525001525879,7.49882495880127,0.03529097649462564,257.0197509765625,281.76550216674804,0.7325739719146869,0.13951044069100932,1.0575286853911257,1.0366882011259282,1.0128800542179106,0.02642542760063793,74.48082752077855,288.2293004163729,269.2267505645752,250.22420071277747,280.3321446010045,4.2730496577535195,274.48357336861744,7.217816182845613,278.4413909028803,273.6926251805925,4.808892640163608,4.507605354623797,50988400,3.7240192311238407,2.1413175332541425,-252814400.0,-3.052946347951834,70.74152269624075,78.01649708558223,137.67368438509132,32.32407511353091,11.332155832034893,0.18822991219421903,7.55805743887325,282.4035714111328,277.9082301635742,274.27500915527344,270.64178814697266,266.14644689941406,0.08,0.0,185.4776347053117,0.024482894926870724,0.056264819580781014,281.672616141183,274.7047882080078,9.338253770682043
2023-06-26,0,283.64000701904297,252.71999740600586,284.7150115966797,264.388126373291,278.29374504089355,-0.19946143429494198,8.638777374365425,-0.6751407375148806,2.9952232840425674,271.7925033569336,6.950163116455076,0.0318656926855277,261.58800315856934,282.0375,0.7225416592213267,0.12660262155381563,1.0462574627527856,1.0246471439596785,1.0038204362764946,0.0007321117742324912,75.77323605296942,288.3771809083989,271.099626159668,253.8220714109371,281.97535923549106,2.3959155725563503,275.33607373918807,7.561056788679649,280.028746729503,275.49966456201696,4.385847626766787,4.316051126992976,24232700,3.6359628499856704,1.0137186066708053,-277047100.0,-36.622471637217025,70.74152269624075,78.01649708558223,92.34961264129024,28.756403878869985,11.303739841853512,0.13976568299695152,7.888910653339973,282.4952476806641,277.9823871459961,274.3350067138672,270.6876262817383,266.1747657470703,0.1,0.0,185.66155651013764,-0.00900355591105595,-0.011922113847479624,282.4025399344308,275.209463936942,8.245056825360297
2023-06-27,0,284.76499938964844,257.497501373291,284.7150115966797,267.1668758392334,281.20312309265137,-0.032657320343982735,7.950526837037846,-1.0808628654074286,2.9953068501586473,272.0087547302246,6.5704374885559105,0.02916066153346504,262.84349594116213,283.4532531738281,0.749356655514247,0.10152527891077855,1.044451007333841,1.0215628909260945,1.0076538590810282,0.013326463566002644,72.08029418102096,288.5466803143956,272.64562664031985,256.7445729662441,283.02964564732144,1.4928983871045283,276.25643048967635,7.885263627654005,280.95227091864757,276.7198476722417,4.226724449192838,4.392633594360339,26108300,3.6086394429731823,1.091310060707291,-250938800.0,-8.86451124983833,70.74152269624075,78.01649708558223,113.4643501907927,25.99828258931772,10.219560970228848,0.11462432021383744,8.102560241159487,282.4952476806641,277.9823871459961,274.3350067138672,270.6876262817383,266.1747657470703,0.1,0.0,185.8665761618253,0.009566329480064084,0.021530266053972583,283.14672415597096,276.34498814174106,8.337195015252249
2023-06-28,1,285.9300003051758,262.0425033569336,284.76499938964844,268.6387481689453,281.78500175476074,0.022658832322248888,7.564572737627518,-1.3450787979436765,2.9953511988841286,272.4450035095215,6.652050170898439,0.027607022744075175,264.13626022338866,283.7475074768066,0.805964104549407,0.07691144714592651,1.0435058654897815,1.0199100517215214,1.0091017721489977,0.014358821901797825,71.49132302864784,289.1381470163928,274.0090015411377,258.8798560658826,283.3864310128348,1.858815316490335,277.531430380685,7.904580918515436,281.9358771778406,277.72363432137246,2.6605638477068467,4.739221081149278,16722100,3.3628381329627453,0.7094926640161618,-234216700.0,-14.558393616485613,70.74152269624075,78.01649708558223,105.35734976897525,24.89082433755285,9.713301876625543,0.13040841838363207,7.915948097817699,282.4952476806641,277.9823871459961,274.3350067138672,270.6876262817383,266.1747657470703,0.1,0.0,185.99825671374302,0.012959923143189833,0.0033764907662754027,283.7583312988281,277.89110020228793,8.15603559200746
2023-06-29,1,283.32250213623047,262.0425033569336,285.9300003051758,269.40624809265137,282.2700004577637,-0.11529789699278838,7.653895518975267,-1.303544983864972,2.995344691323631,272.84375,6.876537437438964,0.027823835609192063,264.13626022338866,284.7200103759766,0.7780807292442584,0.09115886408589421,1.0299485672726907,1.0058810798357383,0.9970509553512171,0.005572265308098512,74.40865543520745,290.39191770115855,275.084126663208,259.77633562525745,283.71536036900113,1.548003009811832,278.9878594534738,6.8105246363983625,282.96339396755945,278.7071112483672,0.8811613115616352,6.658459546479058,15395700,3.262795645262119,0.6674862276256498,-249612400.0,-29.405520977171022,70.74152269624075,78.01649708558223,65.47945956944963,23.545463913372142,12.286076195644766,0.058918676643458234,7.770523582460156,283.1607694091797,279.05962994384765,275.74501037597656,272.43039080810547,268.32925134277343,0.1,0.0,186.11512430883596,-0.011759370231558042,-0.0003905599372150742,283.3591526576451,279.0993325369699,7.822837308969963
2023-06-30,1,286.30250549316406,262.9324951171875,285.9300003051758,271.1787509918213,283.35000228881836,-0.21418868097136706,7.23459503661811,-1.322895963003723,2.995388391179034,275.15999603271484,6.636375045776367,0.026198240508220002,267.6990028381348,284.7200103759766,0.8680075364170703,0.050899494583738276,1.0367714929517515,1.012440582226796,1.0064258883574129,0.005575729525400641,64.60082988578161,290.6173166754091,276.14812660217285,261.6789365289366,284.3467897687639,1.5769643805243996,280.5616089957101,5.582924372436608,283.08557842416997,279.3283182142449,0.8193386665250578,7.754844835726851,19676000,3.0094196356339316,0.8641756249418057,-229936400.0,-11.488123607309241,70.74152269624075,78.01649708558223,94.15707284430196,24.199034129278004,11.434833467186943,0.027298788458941767,7.752628256118133,284.017443359375,280.4462801513672,277.55999755859375,274.6737149658203,271.1025517578125,0.1,0.0,186.27005337723185,-0.006060982854470209,0.007371558335538367,284.12044852120533,280.669677734375,8.094389679644701
2023-07-03,1,286.7425003051758,262.9324951171875,286.30250549316406,271.83625411987305,283.48437881469727,-0.37675035309801125,7.39280747930566,-1.221215227388749,2.9953748131563467,279.2024955749512,6.7331750488281275,0.026690449430338756,267.6990028381348,284.88149948120116,0.8705568053075381,0.04897689213234947,1.0352340738410508,1.0108089680715466,1.006848849043781,0.01093813710815672,67.66371429055515,291.7688669117363,276.983251953125,262.19763699451363,285.0596466064453,1.3148414406835838,281.8414306640625,4.663456337196527,283.8868638892296,280.1187598934523,1.5680312907417435,8.337114541581439,8629300,2.9942038290279274,0.3881875255288866,-221307100.0,-17.559475160227937,70.74152269624075,78.01649708558223,85.1988380371738,23.486020392651437,10.940897263589633,0.03143131096046178,7.523868223035997,284.7230882568359,281.5884680786133,279.0550079345703,276.52154779052734,273.3869276123047,0.1,0.0,186.33780984856898,0.027112430750416916,-0.009386018602788078,284.282967703683,281.7367706298828,8.240243021672766
2023-07-05,1,291.62499237060547,262.9324951171875,286.7425003051758,271.83625411987305,283.90875816345215,-0.5035931826177412,7.623628587066905,-1.1636104856699796,2.9953535495337142,281.3862495422363,6.909512977600099,0.027455357092963876,267.6990028381348,285.9672508239746,0.8725500066310465,0.05534494533697014,1.0502437535258133,1.0268223427431613,1.0217667089266,0.02409001455818105,69.1439764544638,292.9208842645879,277.6736270904541,262.42636991632025,286.0467867170061,2.784981167282202,283.1894656590053,4.560620838970578,284.5758533308249,280.732862268274,1.77105715850998,6.665118036022265,33865500,2.9604759961378715,1.479757142513824,-187441600.0,-12.583897772215884,70.74152269624075,78.01649708558223,131.7682934752198,28.83419221452137,9.736415680924777,0.07505182120992926,7.8507352144988785,291.08719799804686,286.7363997802734,283.2200012207031,279.70360266113283,275.3528044433594,0.12000000000000001,0.0,186.61918362944166,0.02550079819831441,0.057097741844230825,285.0870274135045,283.37982177734375,8.853299278454084
2023-07-06,1,294.32749938964844,262.9324951171875,291.62499237060547,272.07312965393066,284.7275085449219,-0.5184218144500619,8.067124832333876,-0.9387285337741167,2.9953110408607686,281.81750106811523,7.109450073242192,0.02894870506791447,267.6990028381348,286.34650497436525,0.8401262014471415,0.07262390441806701,1.0561879418373519,1.032482619472197,1.0263019767957036,0.029369073114083655,74.77157954346535,294.80387628209934,278.6696266174316,262.5353769527639,287.57357134137834,3.9369369531926455,284.7744652884347,4.270914419886098,286.31880349081234,282.02905378897805,2.4269815403039905,6.919272879358267,47600500,3.0925568420267964,1.959277503429214,-139841100.0,-22.958835530714765,70.74152269624075,78.01649708558223,128.24959267237352,27.03055870137862,9.127384379151025,0.015650655051301532,7.776396810505644,291.81879943847656,287.9206021118164,284.77000427246094,281.6194064331055,277.7212091064453,0.12000000000000001,0.0,187.01534011928618,0.02348472481012065,0.017209549828934675,287.0144958496094,284.7085178920201,9.088491628690242
2023-07-07,1,291.8925018310547,262.9324951171875,294.32749938964844,272.59875297546387,285.0562496185303,-0.4961728332248952,8.589079046030346,-0.7066264432300753,2.9952585225168047,282.60250091552734,7.216150207519524,0.030698086452828423,267.6990028381348,287.2307495117188,0.8158018838940669,0.0979091964313513,1.043248200199465,1.0194900838037004,1.011885371806587,0.030248214067739365,79.9842450925384,296.9701594348341,279.79200134277346,262.6138432507128,288.591785975865,4.010498562396534,285.8107158115932,4.096508677674569,288.2880588189952,283.52611247339223,3.7679777556513505,8.153964241882452,25546200,2.8913429986041876,1.0528413325802304,-165387300.0,-34.6575271836448,70.74152269624075,78.01649708558223,106.37151150797591,25.154422259277666,10.933267782050505,0.035520260257527705,7.759511934392516,292.95159655761717,289.75419744873045,287.1699981689453,284.5857988891602,281.38839978027346,0.12000000000000001,0.0,187.22276500072354,0.03196814948789717,0.018367144152459592,287.5106201171875,285.32867213657926,8.48506294144949
2023-07-10,1,293.7074966430664,262.9324951171875,294.32749938964844,276.2268714904785,286.02312660217285,-0.6554186273702414,8.533302405490637,-0.3727265822932484,2.9952678699697612,283.37750244140625,6.759325256347665,0.030369501903227212,268.3694984436035,291.65174331665037,0.7873574036079691,0.11014236449153947,1.0452870359492255,1.0222090554391359,1.012163212809453,0.025864220563306173,76.32519793606113,298.0492311537547,280.9826263427734,263.9160215317921,289.7028568812779,4.221939425780257,286.5446439470564,4.534653972947737,289.15842511995834,284.6353555224955,2.5029418842494673,5.230098098857768,37058300,2.619644269396968,1.478075143586471,-128329000.0,-18.393419012824065,70.74152269624075,78.01649708558223,117.13253442418916,24.38881842309067,9.851205966189909,0.042020391247320286,7.9966908740676335,292.95924401855467,289.7603834838867,287.1750030517578,284.5896226196289,281.39076208496095,0.14,0.0,187.52592088184608,0.024810013387000618,0.04464887304362674,288.76660592215404,286.26246861049106,7.940090434075743
2023-07-11,1,296.06749725341797,264.27001190185547,294.32749938964844,280.1112461090088,286.412504196167,-0.6132300942183405,7.890199775112031,-0.18809643044311652,2.9953399205752387,283.5362548828125,6.01460021972656,0.027927797447115654,271.80625381469724,292.07400131225586,0.7452920977677948,0.11139169567277056,1.0479472421026912,1.0272078520181305,1.0151152516264104,0.03252045629203115,77.71444650788658,298.30177596929144,282.5213764190674,266.74097686884335,291.5235704694475,3.73147356265458,287.61946541922435,4.8935574366033245,290.3015856827933,286.1349425057112,2.7200700624592136,3.62519957905861,27585900,2.620022973494477,1.077390304858116,-100743100.0,-8.370173847582311,70.74152269624075,78.01649708558223,146.75051512131157,24.416076752041747,9.124458210937247,0.06910071567309481,8.016927153012583,294.85111584472656,291.5544378051758,288.88999938964844,286.2255609741211,282.9288829345703,0.16,0.0,187.7583256824002,0.04289922371051347,0.039410400814025116,291.1559840611049,287.257568359375,7.443910176752121
2023-07-12,0,305.1600036621094,268.8249969482422,296.06749725341797,281.5693759918213,287.9631233215332,-0.33408495253315784,7.228195241580372,-0.4220514557877393,2.9954076324178875,284.1775093078613,5.496249771118164,0.025441425582799455,272.6910026550293,293.7694969177246,0.7428179183874027,0.10133916344997067,1.0740863057150776,1.0542088957143307,1.0396424355887548,0.046412384554144204,78.8343903550707,298.56764116980617,284.1112506866455,269.6548602034849,294.2174987792969,5.648530963206613,289.28214427403043,6.48883330450496,291.75756820227525,287.7128836692382,4.4984055347143945,5.354601377162471,36677100,2.5318558284061567,1.3754204776851509,-64066000.0,-0.34541867522116854,70.74152269624075,78.01649708558223,226.72183914236467,30.08879408425947,8.241905454384144,0.1108611052030323,8.241432617948092,301.9334107666016,297.28330987548827,293.52500915527344,289.7667084350586,285.1166075439453,0.18,0.0,188.09260379794958,0.050854366783761096,0.08153279512220729,294.34371512276783,289.2320818219866,8.595185410671117
2023-07-13,0,313.38999938964844,272.1375045776367,305.1600036621094,281.8500003814697,291.6918697357178,0.4124358918305889,7.708128637453171,0.2750598968416531,2.995370103828001,284.74000549316406,5.840298805236818,0.026958285337192116,276.92174530029297,294.5014991760254,0.6753491688346761,0.11881651288484522,1.0960451521680943,1.0750657553882024,1.0579243888989698,0.06476628938692519,84.35965621449749,301.34425829724523,285.9280010223389,270.51174374743255,298.02428436279297,8.1823313137579,291.54196548461914,8.772169870114878,295.122497184429,290.2322716744001,6.5865641435665205,8.257874821064163,30281000,3.0159974635799323,1.106278507742415,-33785000.0,-7.323984820183943,70.74152269624075,78.01649708558223,237.212767939639,34.222352660798805,7.743222654092225,0.12036232187902893,8.14561556641496,307.1209539794922,301.4795162963867,296.9199981689453,292.36048004150393,286.71904235839844,0.19999999999999998,0.0,188.38346820520368,0.07335876401963204,0.06468058052375122,298.24855259486606,291.26576014927457,9.740814516762622
2023-07-14,0,310.7249984741211,272.1375045776367,313.38999938964844,282.9625015258789,292.3462505340576,1.0545523677639883,9.182326027182736,1.1850223441030279,2.9952292178404236,285.3474998474121,7.045085945129398,0.03188751904913327,280.65649642944334,296.97674789428714,0.6464163153600371,0.15158695188315363,1.0790565787528925,1.0559763423074482,1.035599833780612,0.06451860368090756,88.18107746805882,306.32452792411647,287.959875869751,269.5952238153855,300.7528566632952,8.850091597563047,293.39982169015065,9.897245828062129,299.6937911273894,293.3384274168473,9.293180835108894,11.228825538052346,22576000,3.2918762757356066,0.8196937077361317,-56361000.0,-19.073494161457326,70.74152269624075,78.01649708558223,174.32544368379462,31.95318853735603,9.813294765921338,0.07740135953682467,8.100930135331746,307.1209539794922,301.4795162963867,296.9199981689453,292.36048004150393,286.71904235839844,0.19999999999999998,0.0,188.59435604999823,0.06312593652334741,0.05781014372495564,300.3157305036272,292.70137895856584,10.035575957200017
2023-07-17,0,308.6449966430664,277.38499450683594,313.38999938964844,283.40500259399414,293.8624973297119,1.1558617046632853,9.694730179369282,0.3741003609985971,2.9951799276795157,286.1162528991699,7.778098449707033,0.033442875720601103,281.67925186157225,305.71650314331055,0.7697812256007788,0.12019397093400998,1.0646996949419938,1.0392297392614585,1.0159145438700632,0.050858422650863044,81.18183569217571,309.2787109233137,289.8892505645752,270.4997902058367,302.79821341378346,8.771744366814417,295.1858923775809,10.250410395828851,302.470984807782,295.69898185605604,6.549509336717885,9.135446259604505,25323100,3.375783979749161,0.920522838040348,-81684100.0,-15.790940419974739,70.74152269624075,78.01649708558223,139.96078206142772,29.961663704563787,11.561159338755523,0.07820129582856614,8.02229226852233,307.84075109863284,302.64461163330077,298.4449920654297,294.2453724975586,289.04923303222654,0.19999999999999998,0.0,188.82741356979312,0.05617134361743292,0.06914947365230106,302.9717014857701,294.9930986676897,10.771391769261458
2023-07-18,0,311.1875,281.0199966430664,313.38999938964844,283.58813095092773,294.7624988555908,0.9825087080280318,10.065580136636296,-0.3681701716368222,2.995142351466165,286.5225028991699,8.24697296142578,0.034535949245371476,281.86949996948243,308.8529968261719,0.8512853673243593,0.08895413776530404,1.0677134909171275,1.0399669866060928,1.0143091157151793,0.051069444930120556,75.36078300419302,311.5834109446593,291.4522506713867,271.3210903981141,305.5546417236328,7.745119974636254,297.07321384974887,10.610265550811441,304.02296617282514,297.46205949780455,4.864478271010486,8.815748485842006,20764600,3.3191875687330405,0.7867590057508588,-60919500.0,-11.786227510983757,70.74152269624075,78.01649708558223,135.68534378516765,30.429363729497297,10.875015640014059,0.15839335423531448,7.9192726129024225,307.8501931152344,302.65989489746096,298.4649963378906,294.2700977783203,289.07979956054686,0.19999999999999998,0.0,189.02145285127554,0.04612949560928015,0.06103362001791354,306.0396815708705,296.77515084402904,11.342035730356555
2023-07-19,0,314.55999755859375,281.0199966430664,313.38999938964844,284.4462604522705,298.3406238555908,0.7461205337511588,10.753987133615148,-0.9137631342783537,2.9950638324152736,289.1837463378906,9.048998718261714,0.03672308125257105,281.86949996948243,310.771248626709,0.8444060206132683,0.10735002390328267,1.0741701850325263,1.0427193011440157,1.0152942837421084,0.030803492540564248,78.57474335207395,314.3479748012879,292.8400005340576,271.3320262668273,308.533570425851,6.305351882766131,299.11821365356445,11.047375648601516,305.805349750907,299.15695127537293,6.610309633823044,9.278703726576046,21763700,3.20792362687714,0.8229584523902481,-39155800.0,-7.028122128181895,70.74152269624075,78.01649708558223,136.83391913158806,32.22662179064852,10.076350082684153,0.1374439319520115,7.936467687845777,309.7143549804687,304.16781640625,299.68499755859375,295.2021787109375,289.6556401367188,0.2,0.0,189.2304366360634,0.021562099816265112,0.05940525036950284,309.1632646833147,298.9649353027344,12.182520694422745
2023-07-20,0,308.4449996948242,281.75250244140625,314.55999755859375,284.75250244140625,306.03125190734863,0.5886845270543188,11.377090975050114,-1.2066092849186343,2.99499147930562,291.7587471008301,9.811598892211908,0.038629657889532105,283.17850189208986,311.40774993896486,0.8425106080786776,0.11592595460572162,1.0472909851980339,1.0147343681209386,0.989552508618531,-0.01577906029054854,80.56054993952947,317.2711825299342,294.51700057983396,271.7628186297337,310.30178506033764,3.1954018440996377,300.9126777648926,10.299296572850448,308.00220585818636,301.1281046251893,7.099750995075465,10.012939258860877,23836900,3.2269620464474045,0.8957967239038968,-62992700.0,-47.1687491259372,70.74152269624075,78.01649708558223,71.11939388165356,28.427118920870278,15.984538095728672,0.08752342767753674,8.354577749065527,310.5946375732422,305.59268060302736,301.5500030517578,297.50732550048826,292.5053685302734,0.02,1.0,189.4434716557738,-0.03474684105656112,-0.022046892414201893,309.7663094656808,300.46114676339283,11.868489828274871
2023-07-21,1,298.8725051879883,281.75250244140625,314.55999755859375,285.63875007629395,308.49499893188477,0.39743406315004676,11.375069686627622,-1.4366428466009615,2.9949965802435425,292.79999923706055,10.141898803710934,0.03844940714954607,283.6082565307617,311.40774993896486,0.8746469083695637,0.09473739193840519,1.0102329879602405,0.9786969135109425,0.9618940552945958,-0.03814464025854669,67.58105956918675,318.59526495308927,295.84512557983396,273.09498620657865,309.40357099260603,5.160855235079527,301.8105348859514,9.439690083073335,308.1125394798628,301.8172085096044,4.180635347084982,8.867102813638875,42089700,3.6557830674738385,1.51205720639243,-105082400.0,-72.18442980458097,70.74152269624075,78.01649708558223,1.9925639549183525,25.127926208831525,23.098262747249947,0.012173655754119505,8.776392141849936,310.6961158447266,305.75693780517577,301.76499938964844,297.7730609741211,292.8338829345703,0.04,0.0,189.78653258679356,-0.047301386018785974,-0.061102129535878444,307.61644199916293,300.9800785609654,11.586892820654159
2023-07-24,1,293.302490234375,283.32250213623047,314.55999755859375,286.209379196167,308.49499893188477,0.32246102801934506,10.917308466789477,-1.4340699107647308,2.99505775528788,294.0174980163574,9.737599487304692,0.03679564221538088,284.60751113891604,311.40774993896486,0.890368713971844,0.04972513922575938,0.9885452558544455,0.9582668708450408,0.9512245831205266,-0.049709234154326154,52.31241391904861,318.535742650742,296.7011257171631,274.8665087835842,306.533926827567,7.5885412226312425,302.27910559517994,8.7735094012087,305.80523755306297,301.0200841711466,-2.0603940223709567,4.390460947301891,24915700,4.375389843166023,0.9390664212059098,-129998100.0,-83.75619179991351,70.74152269624075,78.01649708558223,-32.59736960288067,23.249135455243195,23.722984948417206,-0.07970474481068249,8.808078504625165,311.05247094726565,306.3337498779297,302.5199890136719,298.7062281494141,293.9875070800781,0.06,0.0,189.98010731274348,-0.061200255219702626,-0.05588113457268975,304.508536202567,301.37854439871654,11.502901945778339
2023-07-25,1,294.95499420166016,283.32250213623047,314.55999755859375,286.63250160217285,308.49499893188477,0.3011599735447601,10.60176644514638,-1.3789471992100146,2.9950977878663507,294.0174980163574,9.394100341796877,0.03568050556125517,284.6525001525879,311.40774993896486,0.8663665523731297,0.034066009646810204,0.9926782829431604,0.963793400924903,0.9661991480327999,-0.0521631035897645,46.2873930657586,318.33403253934057,297.13049964904786,275.92696675875516,304.28106907435824,8.43104155428865,302.51696286882674,8.503431378504391,302.6640088084481,299.69449490435545,-6.409747979959614,2.2877633842968934,19585600,4.5839619676875,0.7446979208412452,-110412500.0,-76.54121946795414,70.74152269624075,78.01649708558223,-21.043474641694413,22.60936582521889,22.413468903188555,-0.047968838583408197,8.656787357252377,311.2153115234375,306.59733081054685,302.864990234375,299.13264965820315,294.5146689453125,0.06,0.0,190.13531096199267,-0.05633711720125423,-0.051992793912452866,302.4556143624442,301.3856724330357,10.702560133738606
2023-07-26,1,298.3574981689453,283.32250213623047,314.55999755859375,290.40436935424805,308.49499893188477,0.29157760319118653,10.159446394742412,-1.3165740736297964,2.9951516943929133,294.6412467956543,8.941500854492187,0.0341268874854493,285.81350021362306,311.40774993896486,0.8594303597120777,0.035783873839314743,1.0022212210028498,0.9752659347120088,0.9878504264902487,-0.051508454715798235,47.96246532581874,318.01514179766355,297.6962490081787,277.3773562186939,302.8114264351981,8.440188111840524,302.8048199244908,8.269881678280903,300.72384561286566,298.9580558608963,-5.0752286909333915,1.1418780688120258,47256900,4.589205991590831,1.7273843470289123,-63155600.0,-63.57882468266741,70.74152269624075,78.01649708558223,-6.651075953817595,23.621109815000388,20.606230719468705,-0.038236694007901695,8.743445054390605,311.2153115234375,306.59733081054685,302.864990234375,299.13264965820315,294.5146689453125,0.06,0.0,190.5169318529536,-0.05518812523702599,-0.04319812706132767,300.7377188546317,301.8547101702009,10.419918473821166
2023-07-27,0,318.00499725341797,283.32250213623047,314.55999755859375,291.8256244659424,308.49499893188477,0.24097684216997756,9.716659028584639,-1.2417388298181737,2.9952032519546243,295.51124572753906,8.397800903320308,0.032565163195151355,286.26525497436523,311.40774993896486,0.8488720856990232,0.043463427588939764,1.0657865632586356,1.041805897523212,1.064321848265638,0.030994172601443992,51.63881729517267,317.80919200431276,298.37587394714353,278.9425558899743,303.7853546142578,9.84434596895632,304.6699981689453,8.559046068945335,300.1307972528044,298.77364246083454,-3.333116877322365,1.369222647443391,64229200,4.632333254033492,2.160210366683713,1073600.0,-35.613598243845686,70.74152269624075,78.01649708558223,117.8981023669005,35.90656721580897,16.677036513137455,-0.10162751087256264,10.031770320455399,316.3112017822266,310.7193991088867,306.1999969482422,301.68059478759767,296.0887921142578,0.02,1.0,191.1189480844593,0.03037811821244607,-0.01360721695185915,300.68924822126115,303.36446489606584,10.393039700633647
2023-07-28,0,320.70250701904297,283.32250213623047,318.00499725341797,292.9499931335449,309.1649971008301,0.18479940264727393,10.166689955819242,-1.2170170986810895,2.9951589684399242,297.21249771118164,9.028050231933594,0.033891268437558984,286.6985008239746,313.50699920654296,0.6620022690373618,0.12241348588863955,1.0690809694417098,1.0490570480025034,1.0665251413250278,0.07304118462594533,68.02809753645778,320.31300370619414,299.97962379455566,279.6462438829172,304.66285596575057,11.151785655929205,306.5982131958008,8.932039221902164,304.5953594355603,301.21638769073815,2.190800483122866,8.945928812339622,39220300,6.205923392486679,1.2682772241368578,40293900.0,-1.8997381448545303,70.74152269624075,78.01649708558223,142.9884905564899,32.902583938414985,15.009365402636478,-0.024159785789400038,10.350216779848108,317.2556064453125,311.72220288085936,307.25,302.77779711914064,297.2443935546875,0.04,0.0,191.5022999533004,0.10609664518861872,0.07589576379304751,302.0393284388951,305.6012965611049,11.047123185154751
2023-07-31,0,321.38500213623047,286.30250549316406,320.70250701904297,293.60624504089355,310.8406238555908,0.23440148114380693,10.366645171169539,-1.2506656587410867,2.9951439050454463,298.6150016784668,9.418238334655763,0.0343438543216303,291.1367431640625,314.90449752807615,0.6765034848245556,0.12015263878541316,1.0647224354914722,1.0478695729740026,1.0534985385095603,0.0957459034166912,69.11946368206019,322.58191438103535,301.8486240386963,281.11533369635725,306.5114277430943,12.829516605223906,308.406606401716,9.19500853594643,308.6275998944211,304.0479792213692,1.952730642206036,9.191120650482667,25799600,6.2034772981692425,0.8261091688172255,66093500.0,-20.052773635406165,70.74152269624075,78.01649708558223,118.94109950223337,31.040861647413013,14.160092585760315,-0.0582231437196443,10.187344675874577,317.2556064453125,311.72220288085936,307.25,302.77779711914064,297.2443935546875,0.04,0.0,191.75063541290012,0.0925552754439023,0.082716015255019,304.3317609514509,307.04903520856584,11.11286824874815
2023-08-01,0,319.7625045776367,286.7425003051758,321.38500213623047,294.17249870300293,311.7381248474121,0.19585535828948197,10.554136229225934,-1.316762728032632,2.9951292093295665,302.0162544250488,9.617751312255859,0.034762979809894894,291.8657508850098,318.27474822998045,0.6870875037829604,0.12081397697999141,1.0532266449065035,1.0382666429576453,1.0292309630422003,0.0841060869069934,69.44744888225385,324.7110213293015,303.6027488708496,282.4944764123977,309.49571337018693,13.181269238872048,309.4496421813965,9.616937897412766,311.7999597350706,306.8553222335997,4.195238196180551,8.551261154189469,22817900,6.200893330628233,0.7144059185305053,43275600.0,-9.208492094422454,70.74152269624075,78.01649708558223,108.11612804382646,28.96731981088189,15.278796627965828,-0.025424687498862054,10.13682084090697,317.2556064453125,311.72220288085936,307.25,302.77779711914064,297.2443935546875,0.04,0.0,191.96928318856277,0.09590104476860195,0.10664930766746226,308.38770839146207,308.0020751953125,11.165823482567749
2023-08-02,0,315.3375015258789,291.62499237060547,321.38500213623047,294.7981204986572,313.68249893188477,0.12909723862181197,10.368581194165992,-1.482567480536402,2.995156068032984,306.8025016784668,9.427001190185546,0.03396708877536735,293.16149139404297,319.8565048217773,0.7282108638123672,0.0964852565560406,1.0330340003084313,1.0210557650360295,0.9990337159811924,0.05691160256116179,66.50449669036139,325.99091147280467,305.25374908447264,284.5165866961406,312.64357212611606,11.143144847727454,309.58874947684154,9.692110152758923,313.76716321615777,309.25554569523274,6.9896022641857956,4.785194894576049,20461100,6.202113873141564,0.6543476199544828,22814500.0,-31.372050103550343,70.74152269624075,78.01649708558223,60.46256169335505,26.538586217442052,16.785614848724578,-0.04736102375550931,10.274190606456033,317.2556064453125,311.72220288085936,307.25,302.77779711914064,297.2443935546875,0.04,0.0,192.1555128729068,0.052717888777146005,0.06737529473524065,311.62391880580356,308.0662275041853,11.059166070550022
2023-08-03,0,312.25,291.8925018310547,321.38500213623047,295.7893714904785,314.75437355041504,-0.041185408207051286,10.094489632497755,-1.4908815858017044,2.995189317764901,308.5449981689453,9.13118843078613,0.03294122906880701,293.66699600219727,319.8565048217773,0.7520383848525639,0.07138307558688617,1.0189617455865247,1.0108040302674706,0.9787219960939058,-0.01809719124895326,60.27934323863568,326.6283538072319,306.43937454223635,286.2503952772408,315.11428724016463,8.057668608122938,309.69767815726146,9.71440669208963,314.14913765153324,310.58108082777494,7.5127256075787,0.6214308497474015,15180200,6.331092995934123,0.5120065298523194,7634300.0,-34.32718043526574,70.74152269624075,78.01649708558223,45.331607323424045,25.394026396550398,16.5774999957073,0.016419426546163067,9.970321243941306,317.2556064453125,311.72220288085936,307.25,302.77779711914064,297.2443935546875,0.04,0.0,192.29170461160678,0.004748082710702262,0.04896676686660564,314.292724609375,308.3741694859096,10.658793635656009
2023-08-04,0,313.5750045776367,291.8925018310547,321.38500213623047,297.7849979400635,314.75437355041504,-0.21558614019249808,9.769799040676903,-1.3633431511502847,2.9952257180106034,309.68499755859375,8.636900939941404,0.031788709909068444,293.66699600219727,319.8565048217773,0.7247098152335728,0.06974313502827863,1.020301933924186,1.0138444922668688,0.9864338848406415,-0.022224654579900194,57.25653772230726,326.8750976541078,307.3354995727539,287.79590149140006,317.2882167271205,3.606793719912213,310.04982158115934,9.762548208713824,313.67607140569066,311.1605949082537,5.863608393935273,0.49078816746889997,17600200,6.351941850579721,0.6016925830266502,25234500.0,-40.817918879659366,70.74152269624075,78.01649708558223,41.06111320870526,25.66621672737699,15.590001680605322,0.012449382054160142,9.844583401879648,317.2556064453125,311.72220288085936,307.25,302.77779711914064,297.2443935546875,0.04,0.0,192.44934151502608,-0.04531760686401043,-0.0031438707910897566,316.02630615234375,308.3820125034877,9.948996752356278
2023-08-07,0,314.3300018310547,293.302490234375,321.38500213623047,298.74375343322754,314.75437355041504,-0.3620172724414514,9.181280311297222,-1.2040100371562388,2.995287472382745,310.95624923706055,7.851488761901862,0.02976879412238343,294.83024444580076,319.8565048217773,0.694559844772702,0.06764385710833482,1.0191634275105792,1.01147739271591,0.9932630119409225,-0.02195186538973981,58.05737802853741,326.78218533267744,308.419624710083,290.0570640874885,316.7632173810686,3.749703465674224,310.27428599766324,9.82663479765397,313.66646326969317,311.41407501064174,5.100427005214554,1.5973069345658752,16236500,6.34986503053577,0.5755570884996345,41471000.0,-25.435378466037744,70.74152269624075,78.01649708558223,49.71910269410951,24.405687683893586,14.824339560819803,0.019343053620672585,9.613542863826853,317.2556064453125,311.72220288085936,307.25,302.77779711914064,297.2443935546875,0.04,0.0,192.59630347737698,-0.006403047816206486,-0.027405663404286785,316.7177429199219,308.70349557059154,9.553733691383222
2023-08-08,0,313.76000213623047,293.302490234375,321.38500213623047,303.5881290435791,314.75437355041504,-0.5341854060738104,8.611444775798827,-0.9245760815555246,2.9953430462351465,311.71875,7.180101470947261,0.027828159332779365,295.9562469482422,319.8565048217773,0.6680054554430167,0.06168358481446205,1.0139254862596812,1.0028574565592092,0.9959022496168666,-0.018771752020565247,58.22737522627056,326.6736395210801,309.45074996948244,292.2278604178848,315.7714309692383,3.4394154888847326,310.2171434674944,9.802091411281914,313.8496334516662,311.71410903886226,-1.1556407773789417,1.0098419220099417,15183500,6.342489713532086,0.5503274019443318,26287500.0,-35.778334627041616,70.74152269624075,78.01649708558223,34.75065649469339,23.593097951914952,13.95557490296079,-0.017012287432280913,9.482577609044574,317.2556064453125,311.72220288085936,307.25,302.77779711914064,297.2443935546875,0.04,0.0,192.732123654163,-0.03120429266905933,-0.018706766709449634,314.88722446986606,308.4632764543806,9.228617522901093
2023-08-09,0,308.6425018310547,293.302490234375,321.38500213623047,307.6237506866455,314.75437355041504,-0.7409149124445039,8.083769501463463,-0.44653823613558474,2.9953907288528994,312.8199996948242,6.461013870239265,0.026048495102754254,298.0172477722168,319.8565048217773,0.7176496157423536,0.028181932005884706,0.9945450196214239,0.980606614992488,0.9834061116688273,-0.021231219447188976,54.998678242031374,326.50291421655,310.335375213623,294.16783621069607,313.9510737827846,3.3439253589541305,310.23125076293945,9.799486505259251,313.8697596142797,311.9177473775524,-2.1647803590136143,-0.25432204621449506,19955800,6.050787559291975,0.7459031635604189,6331700.0,-55.38260483063158,70.74152269624075,78.01649708558223,-29.130533529689817,21.695843851734427,18.249060797323622,-0.10544191086003274,9.575250549776882,317.2556064453125,311.72220288085936,307.25,302.77779711914064,297.2443935546875,0.04,0.0,192.90086102654627,-0.028952376727067408,-0.05422825533326226,312.97828456333707,308.65502275739397,9.287186854407397
2023-08-10,0,307.47249603271484,293.302490234375,321.38500213623047,308.59312629699707,314.75437355041504,-0.8144892351024846,8.00756375864149,-0.28855687661999685,2.9953973206810423,312.8199996948242,6.234651489257805,0.025788466232091075,298.0172477722168,319.8565048217773,0.7388689616954717,-0.015148848297137347,0.9902192876927709,0.9737075253078147,0.9838757741426489,-0.015300252897630595,45.54867524659025,326.5246276393533,310.50950012207034,294.4943726047874,312.1953582763672,2.992003343402098,310.8455358232771,9.288934466085365,312.6094881645875,311.28142482684007,-3.9648708621986097,0.0640315571417522,14358900,5.879450978901767,0.553163850361568,-8027200.0,-53.984192065756886,70.74152269624075,78.01649708558223,-25.078597063970403,20.313623233243927,17.086431296736993,-0.12696419361581465,9.496304169128754,317.2556064453125,311.72220288085936,307.25,302.77779711914064,297.2443935546875,0.04,0.0,193.02205795050844,-0.023787575434027874,-0.02726608744011226,310.55897303989957,309.4733407156808,9.28327901204555
2023-08-11,0,302.32250213623047,293.302490234375,321.38500213623047,308.2018737792969,314.75437355041504,-0.7094010627351359,8.004988514930707,-0.39794886700369947,2.995397200932278,311.71875,6.3016517639160154,0.02580476120644912,298.0172477722168,319.8565048217773,0.742501251441792,-0.010467463053755994,0.9745622945505452,0.9606025006369813,0.9703632762408,-0.035884564385361584,44.91219485948162,326.22360198408506,310.21362495422363,294.2036479243622,310.33607264927457,4.4180336294024,311.4898223876953,8.23112352324983,311.35269464418997,310.49984852260604,-3.8434801982663114,2.8774780869579293,13967800,5.856562166401336,0.5471697817557319,-21995000.0,-71.5200301443052,70.74152269624075,78.01649708558223,-67.90812596783954,19.46532912235997,19.09739111294498,-0.11393848093973453,9.20228279153473,318.0957658691406,313.08212194824216,309.0299987792969,304.9778756103516,299.96423168945313,0.02,1.0,193.1344819811855,-0.029253760485678737,-0.03687864110612001,308.752685546875,310.1883021763393,9.43942851692254
2023-08-14,0,302.9075012207031,293.302490234375,321.38500213623047,306.18499755859375,314.75437355041504,-0.5541740072799592,8.185581963733053,-0.7064912408487234,2.9953813952612265,311.71875,6.712651710510255,0.026422704027374518,298.0172477722168,319.8565048217773,0.7270396271064207,-0.020484681675068943,0.9777722937583473,0.9681151532981626,0.9793149505704192,-0.036339199388580434,39.57693207293957,326.1646640647952,309.7935001373291,293.422336209863,309.00142996651783,5.101728217546748,312.05785860334123,7.2138035918042895,309.11039572062225,309.30533286145277,-4.12732368547048,3.075327418682218,15641900,5.948622146332154,0.6245942028406799,-6353100.0,-58.33818974805662,70.74152269624075,78.01649708558223,-50.74969504178469,18.250937265850826,19.559681407491357,-0.11988120869479332,9.113547696073542,318.1052078857422,313.09740521240235,309.0500030517578,305.0026008911133,299.99479821777345,0.04,0.0,193.261614435062,-0.03275846845842534,-0.014610887912859222,307.7547302246094,311.0237274169922,9.449650453498904
2023-08-15,0,303.83750915527344,293.302490234375,321.38500213623047,302.76125144958496,314.75437355041504,-0.45243490447437545,8.320237435966582,-0.8974915445508134,2.9953693878200007,311.71875,7.028213958740236,0.026882259551381186,298.0172477722168,319.8565048217773,0.741900459807459,-0.026607748638029723,0.9816833768768932,0.9768564012046397,0.9896310300951671,-0.03162446747004044,39.51533378194207,326.1471002381441,309.5066253662109,292.86615049427775,307.61035919189453,4.972737893681634,312.44928795950756,6.5294347808066595,307.55993936693415,308.382440017715,-2.9919932039381507,2.6961764253450324,11623600,5.91478726581647,0.4727683156235701,5270500.0,-86.76203724125583,70.74152269624075,78.01649708558223,-50.0415735538968,18.016962704006467,18.439103121291964,-0.14777293207299078,8.976866589713376,319.60380932617187,315.5231075439453,312.2250061035156,308.92690466308596,304.8462028808594,0.04,0.0,193.35548762603744,-0.03419271918447353,-0.04615231835804635,306.50301688058033,311.26466151646207,9.5309540983254
2023-08-16,0,297.4625015258789,293.302490234375,321.38500213623047,302.76125144958496,314.75437355041504,-0.32413225265288964,8.399819761830953,-1.033964262488708,2.99536195017634,310.44625091552734,7.227626037597656,0.027171648814889426,298.0172477722168,319.8565048217773,0.7465516378383157,-0.03408725993941112,0.9622285782591479,0.9612821066216184,0.9751701829197827,-0.036223139194534903,39.70351545733872,325.9387653476365,309.1391258239746,292.3394863003127,305.2007162911551,5.252769088834201,310.9819668361119,7.430866836166696,306.5622302645771,307.62973488621594,-3.1053162019335683,1.8367264171202635,18547700,5.8568800083704335,0.7593596023819418,-13277200.0,-99.9686410983264,70.74152269624075,78.01649708558223,-96.96589844202106,16.90583343741109,21.925268150330936,-0.20199856261160534,8.883519935286303,318.6668890380859,314.0065670776367,310.24000549316406,306.4734439086914,301.8131219482422,0.06,0.0,193.496066485838,-0.03577857107145044,-0.058693823494314123,303.32811192103793,310.0229274204799,9.826432371751174
2023-08-17,0,289.78499603271484,293.302490234375,321.38500213623047,301.4600028991699,314.58187675476074,-0.13233064734096744,8.670296784802604,-1.2218279220179704,2.995336199924977,308.54375076293945,7.506826133728026,0.02812435846479338,297.21175079345704,319.8565048217773,0.741203036827366,-0.035606017863189246,0.9399928639615017,0.9419123765075526,0.9570162338078401,-0.057525470499703024,34.355983538209024,325.6248445919441,308.2842510223389,290.94365745273365,301.77571541922435,6.426742807770717,308.7735731942313,8.789748400556094,304.2076687971576,306.0529452120651,-5.366175741074084,-6.459802803403357,23950100,5.870122036998298,0.9803115781476978,-37227300.0,-99.65614306007939,70.74152269624075,78.01649708558223,-140.71285936628635,15.423404640882666,27.37318625448256,-0.20314452814799708,9.041838196047106,316.0524456787109,310.10878692626954,305.3050079345703,300.5012289428711,294.5575701904297,0.08,0.0,193.66323600450576,-0.06754099318229756,-0.06592171561440477,299.4004647391183,307.1438446044922,10.958565048678475
2023-08-18,1,280.5875015258789,289.78499603271484,321.38500213623047,298.74375343322754,314.58187675476074,-0.16717902429567796,9.561034815680502,-1.2192111681581868,2.995247445581184,308.05749893188477,8.435875968933107,0.03110784416713373,294.7897438049316,319.8565048217773,0.724102124175677,-0.030405972438172158,0.9129212936655533,0.9187255144711146,0.9375950239000891,-0.07189342657847375,29.65238459472335,326.47332047059444,307.3512508392334,288.22918120787233,297.76785823277066,9.461900412345214,305.8594660077776,10.816276931986136,300.54659950343745,303.9788311630836,-7.641192612277582,-9.640557934426212,34061200,5.73090177948728,1.417463441572372,-71288500.0,-82.17445061010612,70.74152269624075,78.01649708558223,-175.49790864734635,14.069633611747479,33.17363231698892,-0.11625289294550437,9.203849579086155,312.39665234375,305.13169091796874,299.260009765625,293.38832861328126,286.1233671875,0.1,0.0,193.88106416033324,-0.06096674023481652,-0.07355923113384423,296.26975795200894,304.624021257673,11.830566090056656
2023-08-21,0,286.4250030517578,280.5875015258789,321.38500213623047,298.1337490081787,314.58187675476074,-0.5413173072171823,11.081425486995123,-0.5485396980261852,2.995073795365994,308.05749893188477,9.441551170349124,0.03616216534970685,292.950740814209,319.8565048217773,0.6900094352165511,-0.04335111065144956,0.9346945781301821,0.9480794767438825,0.9712087550832901,-0.054414295131423374,24.375313197133124,328.5998516301182,306.4370006561279,284.2741496821376,294.76107352120533,9.204712970323607,303.4782158987863,11.18348007785893,295.5490211378755,301.2761628774877,-9.089804592282816,-12.694276440771212,20181500,5.953450017722172,0.8482125501329699,-51107000.0,-64.75132990244494,70.74152269624075,78.01649708558223,-125.73690469895807,16.870081027070224,30.937064654269147,-0.0661173081711789,9.164288458900314,308.0189239501953,301.59054412841795,296.39500427246094,291.19946441650393,284.7710845947266,0.1,0.0,194.0189173195607,-0.053202156710036475,-0.03892052510829928,294.0115443638393,302.2852587018694,11.942910320551732
2023-08-22,0,289.9499969482422,280.5875015258789,321.38500213623047,298.1337490081787,314.58187675476074,-0.5704793442828285,11.579204439591969,-0.653424300019005,2.9950111957312546,308.05749893188477,9.819812965393066,0.03782902471438336,289.44899673461913,319.8565048217773,0.7717418761343865,-0.02891963627532411,0.9472607257011989,0.9686948862606374,0.9942750560331873,-0.04570703678305288,33.24712347638154,329.251535176181,306.09312629699707,282.93471741781315,292.9935727800642,8.683924690652344,301.66482271466936,11.170860000983048,293.3081049020142,300.05058101785414,-6.845325436431099,-10.425706907041294,12999900,6.110615928480954,0.5540432898661719,-38107100.0,-69.97501342898235,70.74152269624075,78.01649708558223,-108.845108086989,17.95758300533705,29.4184340987593,-0.07918346714193815,8.94898170444203,308.0189239501953,301.59054412841795,296.39500427246094,291.19946441650393,284.7710845947266,0.1,0.0,194.10908112380554,-0.04752457158227941,-0.060713948284261784,292.0099400111607,300.38131277901783,12.369614779025637
2023-08-23,0,291.95249938964844,280.5875015258789,321.38500213623047,298.1337490081787,314.58187675476074,-0.5511185132867129,11.867707545687685,-0.7901837507385876,2.994973629529616,308.05749893188477,10.095087814331055,0.038803282535292416,289.44899673461913,319.8565048217773,0.8184593412279311,-0.028179285830927457,0.9545832905882298,0.9832061556681754,1.0107688617816166,-0.018523350365058033,37.180374067063724,329.57829152570156,305.8428764343262,282.1074613429508,291.42857251848494,7.506847586753283,300.2150012425014,11.007343580509302,292.5296128940766,299.42944772641897,-4.092485706675274,-8.050899260249652,18287000,6.114739119457338,0.8306535554193365,-19820100.0,-54.89442220720486,70.74152269624075,78.01649708558223,-79.01240923901682,20.129954704017585,27.132817138050022,-0.10757148590462232,9.00976785362251,308.0189239501953,301.59054412841795,296.39500427246094,291.19946441650393,284.7710845947266,0.1,0.0,194.24098198407864,-0.00016989627183150446,-0.02553410935052919,290.3063005719866,299.030515398298,12.529220079797048
2023-08-24,0,292.8375015258789,280.5875015258789,321.38500213623047,296.0850009918213,314.58187675476074,-0.4977236094116443,12.148477546587438,-0.965903183796633,2.9949360772279254,308.05749893188477,10.447362747192381,0.039762938954610895,289.44899673461913,319.8565048217773,0.8861550304803252,-0.08192480649292537,0.9584805710955256,0.9917609404596557,1.0177156535311156,0.010533690615298186,32.73622444609471,329.8195815885362,305.52262649536135,281.2256714021865,289.85714285714283,5.304623743689693,298.7337510245187,10.452535015046355,292.44612342090085,299.0628433489256,-3.6166162234036925,-6.50040051572508,18360900,3.9496435567277293,0.9309960865601381,-1459200.0,-71.56977168283609,70.74152269624075,78.01649708558223,-83.28797280589158,19.729285100018398,24.456016623877826,-0.042259477898109084,9.28192563598095,307.62165234375,301.26919091796873,296.135009765625,291.00082861328127,284.6483671875,0.1,0.0,194.3701858555659,0.005822686886334694,-0.025620981264753567,288.13932146344865,297.3211691720145,13.060672210947882
2023-08-25,1,284.0125045776367,280.5875015258789,321.38500213623047,292.6162509918213,313.9025020599365,-0.3039144226542202,12.093681837407493,-1.1165791064911335,2.994938769956014,305.65500259399414,10.457500457763672,0.03974729784876134,289.44899673461913,319.8565048217773,0.8758333616418489,-0.08688739527536486,0.9334402677356998,0.9666643239752876,0.9849558231967737,0.01220654174947966,33.14523593342034,328.4516153837994,304.2642517089844,280.0768880341694,287.9357147216797,4.459247170256033,296.5682155064174,10.107650521100794,292.54906517214886,298.4577753554784,-3.6203586778922268,-6.6132512952331,23701400,3.8713332561954514,1.251008467032464,-25160600.0,-74.44267381899594,70.74152269624075,78.01649708558223,-117.34606678331095,17.89613954957335,30.159640402029464,-0.10172451487296631,9.501789224063787,307.62165234375,301.26919091796873,296.135009765625,291.00082861328127,284.6483671875,0.1,0.0,194.5233017240031,0.007943534047279988,0.0014381070148129205,286.8861825125558,295.1071472167969,12.622347957452922
2023-08-28,1,288.87750244140625,280.5875015258789,321.38500213623047,291.4518737792969,313.62125396728516,-0.18738950408585825,12.242859179874314,-1.24239176563626,2.994910421363362,303.3725051879883,10.653275756835939,0.040481662652676845,286.1837532043457,315.7800018310547,0.816273207948968,-0.11628575481176961,0.9551887700386743,0.9893886768401576,0.9994533589935284,0.008562448681218138,26.089499632996052,326.91546994666265,302.42975158691405,277.94403322716545,287.8060727800642,4.4094365751783355,294.7908940996443,8.976486927604315,290.40919993625414,296.7935630135619,-4.521577301087833,-9.645117257917029,14239300,4.164559103810058,0.7752308112775496,-10921300.0,-59.54138883359873,70.74152269624075,78.01649708558223,-71.87662696126974,19.437133330096458,28.77363829044598,-0.02984104946521514,9.248090865704317,304.3670048828125,298.6365048828125,294.0050048828125,289.3735048828125,283.6430048828125,0.1,0.0,194.62109554061763,0.001241776998496702,0.024748496680486547,287.6232386997768,293.5118517194475,12.22368783551925
2023-08-29,0,293.47499084472656,280.5875015258789,319.7625045776367,289.90874671936035,312.5812511444092,-0.07941612796872419,11.767066487996834,-1.3478380563591195,2.9949660218154652,302.6150016784668,10.53493824005127,0.03911866782297287,286.1837532043457,314.4307518005371,0.8328562225858257,-0.0965873161927644,0.9756340454875105,1.0099879951273476,1.0136394999234757,0.012157247572289531,34.415163075360695,324.3385095781665,300.80437660217285,277.2702436261792,289.6471426827567,3.4871401326638614,293.7075004577637,8.042853052744494,290.0253698191819,296.0957507453114,-0.31316099995948155,-7.930424377043625,20844500,4.435915209317876,1.1409671495389768,9923200.0,-37.80297506256668,70.74152269624075,78.01649708558223,-28.519148590303452,23.680984225260858,26.36770507540012,-0.028627621598845805,9.371084462489948,303.38143835449216,297.8392796020508,293.36000061035156,288.88072161865233,283.33856286621096,0.02,1.0,194.77285509129263,0.036126638134984956,0.02790612157452513,289.7246355329241,292.99719674246654,11.045353835561698
2023-08-30,0,295.9975051879883,280.5875015258789,315.3375015258789,289.90874671936035,309.544376373291,-0.006423619013835602,11.020514246153073,-1.369275546953559,2.9950549382240377,299.8925018310547,9.953501129150391,0.036797603300490374,286.1837532043457,313.8170021057129,0.853243390859905,-0.06933051278507116,0.9883385230997274,1.0223149945045904,1.0198686750794355,0.013855013424431295,41.98161205016883,321.5310294078335,299.49000091552733,277.44897242322116,291.01464298793246,3.8690093129594825,292.8878582545689,7.05637158707232,290.884542399259,295.83530909888384,4.593037554689166,-4.914265176165059,17717000,4.591031779202255,0.9771152515629183,27640200.0,-36.92542657249108,70.74152269624075,78.01649708558223,-20.146888114087044,22.772504419819086,25.356153893701645,-0.04106228728580188,9.048865277250709,299.4774095458984,294.68130865478514,290.8050079345703,286.9287072143555,282.13260632324216,0.02,0.0,194.90212579934652,0.002922816363198688,0.026077992503787978,290.4659685407366,292.23875645228793,10.480885569045508
2023-08-31,0,297.1125030517578,280.5875015258789,314.3300018310547,289.90874671936035,307.7649974822998,0.09382179155674941,10.419662093579525,-1.243164138813801,2.995123574867729,296.7300033569336,9.23905090332031,0.03490405112916858,286.1837532043457,313.59350433349607,0.8578629325340429,-0.052049623096915035,0.995275077492575,1.026685451795494,1.0208648368510451,0.014598545280585018,46.089773904278566,319.3623252857918,298.5230010986328,277.68367691147375,292.03785814557756,4.444791703760684,292.5157154628209,6.645977352199167,292.17724956939685,295.8528542262689,3.342062331932904,-3.7320381474073803,17229900,4.637140026115999,0.9449102604249214,44870100.0,-34.5205303833323,70.74152269624075,78.01649708558223,-0.560808434927741,23.94017084966188,24.125623562912384,-0.08753902245080532,8.831089186018515,299.4774095458984,294.68130865478514,290.8050079345703,286.9287072143555,282.13260632324216,0.04,0.0,195.02994478612155,0.0318745264320881,0.005607737528326054,291.64783150809154,291.82888575962613,9.876743184816599
2023-09-01,0,297.98999786376953,280.5875015258789,314.3300018310547,289.90874671936035,304.7462558746338,0.2052199949434661,9.933501341663877,-1.0277851586046545,2.9951768935188947,296.55500411987305,8.471850891113286,0.03336007848415617,286.1837532043457,313.59350433349607,0.8296681596166234,-0.05249940615659953,1.0007518370721589,1.027116959928534,1.0208807845889007,0.049214358737194264,47.12872602352186,317.63312893454844,297.7661262512207,277.899123567893,292.9003579275949,4.9791294374404504,292.1644652230399,6.16721154351247,293.42347611457944,295.9551913916958,2.470255623004602,-1.7233249419604773,12819800,4.63217733024535,0.7123927712677844,57689900.0,-33.028931773484366,70.74152269624075,78.01649708558223,6.108595320166736,22.514440821657264,23.66366847386104,-0.06301692541572163,8.719582030850896,299.4774095458984,294.68130865478514,290.8050079345703,286.9287072143555,282.13260632324216,0.06,0.0,195.12482284207744,0.03810861069191884,0.033583290097904915,291.95292009626115,291.12961033412387,9.36161461081755
2023-09-05,0,298.5175018310547,280.5875015258789,314.3300018310547,289.90874671936035,303.1400032043457,0.2578656116709385,9.250604955738506,-0.7599089735143956,2.9952482930591606,296.55500411987305,7.596875762939453,0.031148194435264127,286.1837532043457,309.1542518615723,0.7885043898587032,-0.05198359644991044,1.0051538503538544,1.022800085422409,1.012986512815005,0.03337054394398109,48.07280498122044,315.4880858270044,296.9868759155273,278.48566600405024,293.71178654261996,5.4112509282770755,291.7844646998814,5.522875441318455,294.56272867373673,296.0156464925655,2.0679728677586247,-1.623433997876013,14956000,4.634514290530326,0.8340683109531137,72645900.0,-5.811393235266561,70.74152269624075,78.01649708558223,29.434435323167765,21.40415023613609,22.49670418931399,-0.07741554337200611,8.516755091705296,295.2830336914063,291.28847583007814,288.05999755859375,284.83151928710936,280.8369614257812,0.06,0.0,195.23689265219784,0.03407290658662521,0.051313511807258703,293.86328125,291.00130135672435,8.168640215806237
2023-09-06,0,299.95999908447266,280.5875015258789,313.76000213623047,289.90874671936035,302.46875190734863,0.187833549487812,8.36818642927374,-0.5598801885306575,2.9953337582685897,296.55500411987305,6.806250762939453,0.028252168632817286,286.1837532043457,307.5894966125488,0.7372513983316492,-0.04858012557814073,1.0127069406088423,1.023501879518293,1.011265309922893,0.02209731132823256,49.009061560521424,312.93262377407484,296.19625091552734,279.45987805697985,295.9900000435965,3.7488245200406594,291.9628573826381,5.755811216038289,295.55444677393143,296.2633313894765,1.9396423871871558,-1.7509383021896774,15418100,4.644597334114256,0.859276664057495,88064000.0,-14.280694349179548,70.74152269624075,78.01649708558223,44.605394729752234,21.636242639336754,21.044544191967738,-0.06605933104474193,8.454128594502015,296.47487182617186,292.25255432128904,288.8399963378906,285.4274383544922,281.2051208496094,0.08,0.0,195.3525721804977,0.003959869924732962,0.03069660077952029,295.8121337890625,291.34915815080916,7.208677536451771
2023-09-07,0,298.98500061035156,280.5875015258789,308.6425018310547,289.90874671936035,300.5506248474121,-0.10919012854137215,7.405029781934326,-0.6924803667039483,2.99541793943057,296.55500411987305,6.165376052856447,0.02505879237009703,286.1837532043457,304.2010078430176,0.7308305813075109,-0.028131260908890236,1.0117721700926146,1.016702471308876,1.0035899414481737,0.010092975008238358,52.97623374896712,310.31631032680804,295.50625076293943,280.6961911990708,297.4339283534459,2.1644866673241814,292.62000056675504,6.00770922014593,296.6660250356423,296.4376036679059,5.615067734623841,0.8396008054065499,33748700,4.553921453624535,1.8112560887383298,54315300.0,-25.650378784340468,70.74152269624075,78.01649708558223,51.1860338921895,22.07024588210071,18.542490519864764,-0.04529651678826912,8.909547021485132,299.3398718261719,294.57005432128904,290.7149963378906,286.8599383544922,282.0901208496094,0.1,0.0,195.60473487136738,0.012097607804844035,0.002282002423517976,297.0110996791295,292.3171691894531,6.868289719201792
2023-09-08,0,299.7850036621094,280.5875015258789,307.47249603271484,289.90874671936035,299.22875022888184,-0.2767786773765692,6.824831731667834,-0.5932286692729911,2.9954640722766803,296.55500411987305,5.730788497924806,0.023133189752949403,286.1837532043457,303.00050201416013,0.6950028651759435,-0.027604080143351157,1.0161398328145235,1.0169908488236992,1.0042611315813632,0.00899491129757668,51.84531120349491,308.6730391652399,295.0233757019043,281.37371223856866,298.3353587559291,1.4304047628527246,293.99125071934293,5.184555981388058,297.27639670587814,296.3925145484206,3.498887273506334,3.174769123173685,17548000,4.552522406588312,0.9337909341714109,71863300.0,-29.529259795978803,70.74152269624075,78.01649708558223,66.69352475412676,20.566272718749175,17.27891564749807,-0.05802917786782365,8.878150892857844,299.7292703857422,295.2003519897461,291.5399932861328,287.87963458251954,283.3507161865234,0.1,0.0,195.73619814393115,0.0067592057372583,0.0094543972869657,296.99684361049106,293.3607395717076,6.420963595796325
2023-09-11,0,304.82250213623047,280.5875015258789,303.83750915527344,289.90874671936035,299.185001373291,-0.5297387076384998,6.309929437737809,-0.598862723882823,2.9955020453746637,296.55500411987305,5.384851341247559,0.021415798365241837,286.1837532043457,302.38100204467776,0.712917311723405,-0.008393349671926384,1.0345626377207775,1.031648599285812,1.0193113184831581,0.022928636267800284,55.36513686765648,307.25885995884965,294.639001083374,282.01914220789837,299.596072605678,2.508918119042231,295.30535779680525,5.444310291473739,297.8994842680113,296.3681346529073,2.150102398579288,6.841894963899474,19489300,4.420966046153306,1.022079064247502,91352600.0,-4.4835218069803044,70.74152269624075,78.01649708558223,134.7777003756397,21.748952836866724,15.756706904705958,-0.010458146421619218,9.040425393116884,301.24964624023437,296.4301848144531,292.5350036621094,288.6398225097656,283.8203610839844,0.12000000000000001,0.0,195.89018067148788,0.037721845869896686,0.039440292580252195,298.773193359375,294.6195809500558,6.889862402388377
2023-09-12,0,304.2200012207031,280.5875015258789,304.82250213623047,289.90874671936035,299.185001373291,-0.43568087077982254,6.483283101364949,-0.6084673264189484,2.9954895674097513,296.55500411987305,5.49735134124756,0.02199482663261567,286.1837532043457,303.00050201416013,0.6644199146585872,0.006322065012619295,1.0320799015570916,1.0224086711973157,1.0126691823194025,0.019102730508832044,62.13112057501734,307.73056728610396,294.764001083374,281.79743488064406,300.6114294869559,2.761761868250043,296.32464381626676,5.694615883935222,299.6168222573955,297.0989931119429,2.981443016770504,6.423147032714939,13480400,4.568392088205026,0.7109834988685518,77872200.0,-22.356869735002846,70.74152269624075,78.01649708558223,105.3897174024422,20.29333176472236,15.535754747241251,-0.07504851031116017,8.996823056164338,301.24964624023437,296.4301848144531,292.5350036621094,288.6398225097656,283.8203610839844,0.12000000000000001,0.0,195.9940775088256,0.005030796281583649,0.01781494251260645,299.59578595842635,295.62180873325894,6.559826879409686
2023-09-13,0,303.97999572753906,280.5875015258789,304.82250213623047,289.90874671936035,299.185001373291,-0.39452241369246216,6.571424528771805,-0.6226047683036127,2.995483098653085,296.55500411987305,5.556413841247559,0.02228888804720558,286.1837532043457,303.8757583618164,0.6725922224559702,0.0012588704616921355,1.0310361267479187,1.016361471244055,1.0080433035287661,0.013401775754554368,60.614190327966774,307.97247514091765,294.829626083374,281.6867770258304,301.4671434674944,2.742066785846106,297.18375069754467,5.8882432536380005,300.73662013766926,297.5903186103266,2.3921908690955247,4.921539721556962,13210900,4.566568006327908,0.6938650957636671,64661300.0,-12.056982153554866,70.74152269624075,78.01649708558223,115.39589728992611,19.325086364630618,14.794505195646215,-0.05089987753647416,8.772763220121348,301.24964624023437,296.4301848144531,292.5350036621094,288.6398225097656,283.8203610839844,0.12000000000000001,0.0,196.09665110510758,0.019687831023686764,0.016358493291898053,300.833243233817,296.39308166503906,6.778895051941601
2023-09-14,0,309.0899963378906,280.5875015258789,304.82250213623047,289.90874671936035,299.185001373291,-0.3898237923820088,6.581256334521381,-0.6237293503967627,2.9954823720867183,296.55500411987305,5.562825736999514,0.022321696075286158,286.1837532043457,304.00399627685545,0.7424929708833957,0.021910305225793784,1.0483428402530781,1.0298296953369352,1.0222632922559036,0.03379766779908899,63.59074604233148,307.99926308103005,294.8367504119873,281.6742377429445,302.97749982561385,3.618306402838511,298.34464318411693,6.532343885225318,301.50176309118353,297.9223003590304,2.010133865804431,4.1196757565135185,19343100,4.31280976985472,1.0138238462002112,84004400.0,-3.121590691640718,70.74152269624075,78.01649708558223,155.36027253256202,22.750351924260492,13.842886926134941,0.033489983414281305,8.706137014247725,304.1757559814453,298.7971165161133,294.4499969482422,290.10287738037107,284.72423791503905,0.14,0.0,196.25388582028037,0.043693658964717885,0.04194938638564324,302.4827096121652,298.1729954310826,7.7767881180243625
2023-09-15,0,305.66749572753906,280.5875015258789,309.0899963378906,289.90874671936035,299.8287525177002,-0.15516322028292978,7.265532387738578,-0.6493122039639583,2.9954293827474108,296.55500411987305,6.086063003540039,0.02459406437565678,286.1837532043457,304.28025131225587,0.7435674175637218,0.06661835695246407,1.0346944540713514,1.0140033109478537,1.0042315461830358,0.019622369343264,74.43035673724775,309.94918992806504,295.4181251525879,280.88706037711074,303.792856488909,3.464822486069862,299.8914282662528,5.330955112330281,303.3878866810285,299.0250001624427,3.541666549527611,5.550004602322233,28106400,3.9947005889432905,1.4572592706081997,55898000.0,-46.398205246722206,70.74152269624075,78.01649708558223,80.55664982247175,20.366086443686434,17.35931811814251,0.03794547867626301,9.030698656087175,306.4814733886719,302.5292523193359,299.3349914550781,296.14073059082034,292.1885095214844,0.14,0.0,196.46918378712797,0.008123707428683069,0.005490875213441033,302.64522879464283,299.2286812918527,7.444284442529392
2023-09-18,0,300.53499603271484,280.5875015258789,309.0899963378906,291.4518737792969,300.96499824523926,-0.31224168761016663,7.4714924252764705,-0.6722403986583925,2.9954132479788185,297.5512504577637,6.179524574279787,0.02522344171050508,286.1837532043457,304.9070014953613,0.7387000507113802,0.08938386088215337,1.0145934069012394,0.9941556627084034,0.9835676529789918,-0.014065582670138466,71.2381933361361,311.15523498788207,296.2122501373291,281.2692652867761,304.0142844063895,3.1407253277023344,300.7241063799177,4.286371506091175,303.94911542994475,299.7923787939137,1.902752587173832,7.624661168389791,14234200,3.3781335575148397,0.77800305698325,41663800.0,-41.79832443803907,70.74152269624075,78.01649708558223,49.59902157487459,19.407283388449226,17.31318838016573,0.011896179796495732,8.799935774262867,307.0431545410156,303.4384141845703,300.5249938964844,297.61157360839843,294.00683325195314,0.02,1.0,196.57548748914874,-0.016289502149598567,0.015643385104281364,303.19837733677457,300.104738507952,6.9034903977320665
2023-09-19,0,303.38250732421875,284.0125045776367,309.0899963378906,292.6162509918213,301.3962459564209,-0.23232508415265862,6.599705361867757,-0.735148494197726,2.9954852599886603,298.2537498474121,5.424661674499509,0.022205557323108988,288.6322525024414,304.9070014953613,0.7878817646034202,0.0492624346010998,1.0207694567913137,1.002730923883548,0.9956810102511976,-0.0027529218760234953,57.258827976421614,310.4090355864064,297.2096248626709,284.01021413893545,304.52821350097656,2.577091331074498,301.43178612845287,3.7861571721033216,303.1056548686015,300.0676401589193,0.5184191244373805,4.035445298712077,15924400,3.4922254471976535,0.8806301623185585,57588200.0,-37.77234914484253,70.74152269624075,78.01649708558223,72.74319090327702,20.51336990759193,16.40135582225075,-0.007224411422485122,8.62565578103985,307.9965965576172,304.9816974487305,302.5449981689453,300.10829888916015,297.09339978027344,0.02,0.0,196.6968401761851,0.011304144021546225,-0.00809598130104234,304.2219892229353,300.60941641671315,6.890607944916059
2023-09-20,0,303.05249786376953,284.0125045776367,309.0899963378906,293.31561851501465,303.5318794250488,-0.37851776712007384,6.23915370860286,-0.4683075502672578,2.995512564561648,298.7512512207031,5.031249885559083,0.020932718374829757,289.8427474975586,304.9070014953613,0.7868026246413709,0.04632698919591417,1.0167585039336269,1.000032167334145,0.9951449922181834,-0.0030511805934784197,60.18471453074649,310.5358074934997,298.05750007629393,285.57919265908816,304.27535574776783,2.629701184220757,301.9357141767229,3.4629345960386897,303.16963923863887,300.4545092551908,1.2000278927107897,3.3759321197948733,19379500,3.467001995973558,1.0531226598934678,38208700.0,-63.92244838242009,70.74152269624075,78.01649708558223,50.91186718779436,20.612472100256216,15.22928192884777,-0.03126815293405097,8.625966431166468,307.9965965576172,304.9816974487305,302.5449981689453,300.10829888916015,297.09339978027344,0.02,0.0,196.84236677048827,-0.01766862238435829,-0.0065967704067626575,303.097159249442,300.93517630440846,6.450262382144429
2023-09-21,0,296.24000549316406,284.0125045776367,309.0899963378906,295.36687660217285,303.5318794250488,-0.5950266724806299,6.03810980110872,-0.06555081439496302,2.995527114586473,299.38500213623047,4.76411193847656,0.020213775024210033,291.6449996948242,304.9070014953613,0.7953091406828025,0.03801987822445975,0.9917224133800979,0.976555308094185,0.9733674616518924,-0.04157362255968722,58.71415762070185,310.78884472428774,298.71262512207034,286.63640551985293,303.1353563581194,4.019920588798334,301.8733929225377,3.5628236956703927,303.1284455696986,300.72915236302924,-0.5806671948614515,2.3834635603771788,21300500,3.460244498531768,1.1481130827109818,16908200.0,-83.00236899235804,70.74152269624075,78.01649708558223,-36.39763424978426,19.402999008802247,19.506606716727642,-0.06528607251645198,8.509113168365515,307.9965965576172,304.9816974487305,302.5449981689453,300.10829888916015,297.09339978027344,0.04,0.0,196.99284076552982,-0.05129605216817712,-0.030584198192669453,302.2517525809152,300.92376926967074,6.406138332187701
2023-09-22,0,300.5074920654297,284.0125045776367,309.0899963378906,296.1793804168701,303.5318794250488,-0.6852274338432033,5.868009934750536,0.2954134210140369,2.995538694862624,299.38500213623047,4.528299102783206,0.019630243926990844,292.44150161743164,304.9070014953613,0.7648324573691309,0.011619085498120421,1.0052872160625326,0.9915202940308525,0.9957981730763436,-0.016881100327097998,45.71283428160976,310.6630202967471,298.92700042724607,287.19098055774504,302.6392844063895,4.111532817349317,302.053213936942,3.412088177815893,301.3914745469125,300.06211815587267,-2.623100287791334,-0.2936589842675717,25369600,3.831962454773582,1.3420902975974776,42277800.0,-66.7797221347828,70.74152269624075,78.01649708558223,23.953428362279354,22.103296958727473,17.94145299480947,-0.06815806644341384,8.590604648945433,307.9965965576172,304.9816974487305,302.5449981689453,300.10829888916015,297.09339978027344,0.04,0.0,197.1795345068213,-0.0040957694394013755,-0.040549295462380223,301.3992135184152,301.11622837611606,5.763858674750813
2023-09-25,0,297.7800064086914,284.0125045776367,309.0899963378906,296.8943786621094,303.5318794250488,-0.8854040222586438,5.705897524015814,0.8325295861124409,2.995549500108582,299.872501373291,4.258698768615721,0.019063472630891566,293.0152420043945,304.9070014953613,0.6503112225488283,0.05807838465536278,0.9948866025556528,0.9822868315013715,0.9901461100586589,-0.009166951138440904,56.262234574756704,310.7222950022552,299.31049995422364,287.8987049061921,301.0235715593611,3.295335462341524,302.00053569248746,3.4759690076860132,301.1563942576953,299.9407254707146,-1.1423461118875144,0.8448250678571653,18987000,3.289654710243065,1.0171245700376004,23290800.0,-58.30514335876712,70.74152269624075,78.01649708558223,-32.5800658072196,20.75585068026172,20.690364353782634,-0.053642566584266034,8.494847174020759,307.9965965576172,304.9816974487305,302.5449981689453,300.10829888916015,297.09339978027344,0.04,0.0,197.31557566376827,-0.005685174336451659,0.001731501753955067,299.84668404715404,301.1646968296596,4.774323637863092
2023-09-26,1,298.2324981689453,288.87750244140625,309.0899963378906,297.613130569458,303.5318794250488,-0.30502978185413643,4.52759248226269,0.19751548194544677,2.9956182001460143,299.872501373291,3.526760902404783,0.015092031533691022,295.7452537536621,304.9070014953613,0.5947207930081254,0.030817574549928384,0.9941120549983345,0.986070213445736,0.9934708440412264,-0.016975300259384207,49.54976674904909,309.05406001030167,299.99887504577634,290.943690081251,299.9614290509905,2.6920390936516068,301.8771427699498,3.5829923333892024,300.3293113063271,299.8943401908699,-3.659125194344814,-0.24705265783065045,19417200,3.2406517957223215,1.0259415176560567,42708000.0,-67.36081246240721,70.74152269624075,78.01649708558223,-48.855373613981904,19.88782357900264,19.825075945676698,-0.05542932395932111,8.232356433493607,307.9965965576172,304.9816974487305,302.5449981689453,300.10829888916015,297.09339978027344,0.04,0.0,197.45422584969484,-0.020028299823356632,-0.011865920165989665,299.6542227608817,301.1497257777623,4.200735710389288
2023-09-27,1,296.5699996948242,293.47499084472656,309.0899963378906,297.9375,303.5318794250488,0.3733892420688204,3.7751902940215345,-0.42577226086213615,2.9956534592919164,299.872501373291,3.10578609466553,0.012564424738123348,296.2157554626465,304.9070014953613,0.5848880118755219,0.016210946324676366,0.9870314210787775,0.9825184487305648,0.9913341401239266,-0.02139067724120647,48.328080117642365,308.0170054201964,300.46662483215334,292.91624424411026,299.39500100272045,2.9554857397944647,301.70464270455494,3.7853618496610673,299.8216235532622,299.9892491021346,-2.4323808263934734,-0.5759104283237636,36429800,3.091435905748383,1.8487132266185717,6278200.0,-58.01385227284695,70.74152269624075,78.01649708558223,-118.91189164573738,17.513344420431633,25.044655329480694,-0.04786407123203336,8.680758063104555,306.7151182861328,302.90744024658204,299.8300018310547,296.75256341552733,292.9448853759766,0.06,0.0,197.70525764550055,-0.006440463495400284,-0.024027283788327105,298.96848842075894,301.08343287876676,4.208840593274292
2023-09-28,1,301.4824981689453,295.9975051879883,309.0899963378906,297.9375,303.5318794250488,0.6391561802892731,3.5416311410076498,-0.48585468434179857,2.995663047344145,299.872501373291,2.9865369415283167,0.011781035655804222,296.5370002746582,304.9070014953613,0.5675559540735943,0.0019341193652032498,1.0028644765978478,1.001251217081831,1.0121413581888772,0.017696774839893292,44.14342435468411,307.70463755667345,300.6213752746582,293.53811299264294,299.12357112339566,2.5932956589395957,301.8258923121861,3.7461267168782277,299.01616932950986,299.68302980291736,-1.319312689114919,-0.8077331339690392,22167100,3.070722291361785,1.1123597732737287,28445300.0,-34.164142061271555,70.74152269624075,78.01649708558223,31.659719525320575,20.243155707192784,23.075519754972575,-0.005184801435675112,8.7485592275424,306.7151182861328,302.90744024658204,299.8300018310547,296.75256341552733,292.9448853759766,0.06,0.0,197.8683746047343,0.027829480835124265,0.014315701391404619,298.81024169921875,301.516115461077,4.079863458839356
2023-09-29,1,304.39749908447266,296.24000549316406,309.0899963378906,298.17187309265137,303.5318794250488,0.6189968111352417,3.3817164535166904,-0.3903425331405965,2.9956692608614515,300.2337455749512,2.853249511718752,0.011238835574209979,297.05825271606443,304.9070014953613,0.5262321664413578,0.014708216827974536,1.0116381690882164,1.0134928145757915,1.0183430385720924,0.012944792132490335,52.91560416239207,307.6590578307394,300.89562492370607,294.1321920166727,299.31571415492465,2.957209057075499,301.79553495134627,3.7216170896794636,299.6241734566462,300.0449290157281,-0.6262751178474955,0.566237298764017,25356600,3.2530062669919957,1.2469847789428026,53801900.0,-48.54298382029256,70.74152269624075,78.01649708558223,50.83311619052567,21.8642845122425,20.993367658097608,-0.019249889313001554,8.929378518209013,306.7151182861328,302.90744024658204,299.8300018310547,296.75256341552733,292.9448853759766,0.02,1.0,198.056249769057,0.003778365475802792,0.015148995802538992,298.88722446986606,300.99219185965404,3.912104797962842
2023-10-02,1,304.5924987792969,296.24000549316406,309.0899963378906,298.44625091552734,304.0399971008301,0.4402877305317407,3.3467721510412693,-0.5642208584984938,2.995670663346675,300.52124404907227,2.87561210632324,0.011109252946787279,297.6590057373047,304.9070014953613,0.48591543886315397,0.021502403659979245,1.0110622898485684,1.014571074180544,1.0163500870696847,0.02287760166562558,57.13496348681646,307.95341902742433,301.2598747253418,294.5663304232592,300.50892748151506,3.1856103115989636,301.8221419198172,3.7415617660723077,300.81416399187697,300.92067253808415,0.4438178962998484,-0.1394264034903405,16265600,3.305740069587877,0.793187760830405,70067500.0,-23.197817898428365,70.74152269624075,78.01649708558223,84.5792634160559,20.625830960961412,19.80424524638719,0.030259809274501993,8.789422996958592,306.7151182861328,302.90744024658204,299.8300018310547,296.75256341552733,292.9448853759766,0.02,0.0,198.17847583273746,0.01991180376159063,0.02587954894375396,300.46826607840404,301.3600093296596,3.942830135119536
2023-10-03,1,302.90250396728516,296.24000549316406,309.0899963378906,298.86812591552734,304.2643756866455,0.24462717755450009,3.333559014760991,-0.6775569094769391,2.995671238229667,301.0087471008301,2.88949962615967,0.011053281001660817,297.6590057373047,304.9070014953613,0.4870553184299156,0.020350555364356218,1.0043519486626316,1.0075800852720256,1.0061367696782297,0.015658943364697864,57.235774618763564,308.2571178006402,301.5899997711182,294.9228817415962,300.851072038923,3.3115566427753,301.74517822265625,3.7046604660151448,301.75907013230653,301.5636229294148,2.819502137203934,0.12244348073732121,17362300,3.3055666105289156,0.8417295153157752,52705200.0,-45.74386049902351,70.74152269624075,78.01649708558223,15.442130787675513,19.406378747520424,20.271994934768184,-0.017618860671068805,8.674463688303067,306.7151182861328,302.90744024658204,299.8300018310547,296.75256341552733,292.9448853759766,0.02,0.0,198.30527922730485,0.006623104548163727,0.00036584940646296,300.7334420340402,301.0663277762277,3.931100020303337
2023-10-04,1,302.42749786376953,296.24000549316406,309.0899963378906,299.5850028991699,304.2643756866455,0.10290515998740239,3.2678228653371786,-0.5773880987227589,2.995673675784072,302.19250106811523,2.801499938964844,0.010827444376402937,297.6590057373047,304.9070014953613,0.49679751056961546,0.00980965759365752,1.0020484726233205,1.0061606696297858,1.0014520327723635,0.01975081152838376,53.151973924567635,308.3448956086041,301.8092498779297,295.2736041472553,301.51499938964844,3.0486751761109954,301.2692854745047,3.06050764301362,302.0355359937592,301.9612556574397,0.796989081834273,-0.3544614038417433,16880500,3.323525580319098,0.8154809250506823,35824700.0,-25.46614678221627,70.74152269624075,78.01649708558223,41.219016991044924,18.061028212365695,19.807489795366546,0.013424706014692882,8.654858703173161,306.05044201660155,302.36978326416016,299.39500427246094,296.4202252807617,292.7395665283203,0.02,0.0,198.4296974496722,0.02633166867580683,0.02214350295118845,301.41062709263394,300.62865556989397,3.976541613207857
2023-10-05,1,303.7825012207031,296.24000549316406,309.0899963378906,299.5850028991699,304.2643756866455,0.0007781365325640142,3.242155148570251,-0.5137889902101245,2.995674618551661,302.66500091552734,2.7276123046875,0.010738008688317266,297.6590057373047,304.9070014953613,0.4802519470580738,0.011513946339750869,1.0061267854208549,1.010878892200436,1.0020517239179438,0.007628977024294548,52.66211474643261,308.416935114035,301.93262481689453,295.44831451975404,302.30785696847096,2.7608244627420198,301.1346430097307,2.8887765720088954,302.1369203690682,302.1840287074365,1.5607130616753446,-2.155520577520662,19130000,3.3164471187940054,0.9579791197609109,54954700.0,-24.528321200946365,70.74152269624075,78.01649708558223,33.43003098333819,17.044536530148203,18.69270561000035,0.05253913771291061,8.515939614023516,305.0114132080078,301.5293123168945,298.7150115966797,295.90071087646487,292.41860998535157,0.02,0.0,198.5701271047116,0.002730656025471845,0.023678412117411302,302.24178205217635,300.94800240652904,3.9422312027325948
2023-10-06,1,308.52249908447266,296.24000549316406,309.0899963378906,300.3268699645996,304.2643756866455,-0.17594339701617345,3.1922887854098136,-0.3664979055735773,2.9956764323559724,302.97750091552734,2.624749908447268,0.010564458337611207,297.6590057373047,304.9070014953613,0.4625260277779723,0.013334548125360429,1.0210144842441555,1.0240815871385396,1.0161451512609028,0.013551359693843246,54.858339626125314,308.55707741823176,302.1724998474121,295.78792227659244,304.0153568812779,2.273865620334008,301.7051789419992,3.487880935498425,302.57292556622144,302.6239165440813,1.8609652153380678,-0.6166813721391408,21784000,3.324203990780648,1.0794354271262163,76738700.0,-2.9810474604341315,70.74152269624075,78.01649708558223,198.60558769068408,22.972150490245927,16.409984781728962,0.13187250454377294,9.007657777056435,309.3432801513672,305.0333617553711,301.5500030517578,298.0666443481445,293.75672595214843,0.04,0.0,198.74080286583435,0.0506978226174144,0.037735207454202,304.7637416294643,301.8661150251116,4.768636781108692
2023-10-09,0,315.7524948120117,296.24000549316406,309.0899963378906,300.52812004089355,304.4462490081787,-0.1916209010809194,3.42504974235491,-0.4338278936060673,2.995668170801331,303.21750259399414,2.7100003051757766,0.011318386109724894,297.6590057373047,305.95299606323243,0.4720137881653354,0.012138201485494646,1.0434326273270604,1.0452992348000347,1.0371396345884756,0.036639103318172106,60.78644898455637,309.4594741032401,302.6093746185303,295.7592751338205,306.05392783028736,4.713056724063029,302.58874947684154,5.1270997248580725,304.0762808187063,303.4743253229163,4.030245608776266,2.657761377942265,22503700,3.3020569901030754,1.1068315197396768,99242400.0,-5.873591267999832,70.74152269624075,78.01649708558223,280.81218911270804,24.61618479908486,15.29821699178178,0.1309677350436224,8.97210931069861,312.4145517578125,307.5177149658203,303.55999755859375,299.6022801513672,294.705443359375,0.06,0.0,198.92590471287386,0.03761150038855754,0.060457621531717895,306.81666346958707,302.8134525844029,5.7881762938380215
2023-10-10,0,320.9449996948242,296.24000549316406,315.7524948120117,300.52812004089355,304.4462490081787,0.8226270668564096,4.452469835766297,1.197309583677585,2.9956248369931506,303.21750259399414,3.1828746795654297,0.014687064358385042,297.6590057373047,308.57924880981443,0.4708493778890137,0.037908400318958944,1.0586797979302847,1.05620482913719,1.046522814140493,0.05956535681028163,69.95903798823315,312.0608139238519,303.15587425231934,294.25093458078675,308.417856488909,7.2245020159276985,303.86678532191684,7.101476398246026,306.9980918501328,304.953253836554,4.7332753077658785,4.077356864406626,19038000,3.647626962638424,0.9237478602121738,118280400.0,-7.446547894955695,70.74152269624075,78.01649708558223,265.7431641494563,26.83319166415213,14.490676849983444,0.1569216692423868,8.795530074220137,315.72268481445315,310.19366552734374,305.7250061035156,301.2563466796875,295.7273273925781,0.08,0.0,199.08829334240244,0.06944897764247049,0.04895367518098054,309.9003252301897,304.3937748500279,7.029638890651057
2023-10-11,0,325.6550064086914,296.24000549316406,320.9449996948242,300.52812004089355,304.8612480163574,1.2901834462791977,5.906877736480332,1.616663168961841,2.9955450154120418,303.21750259399414,4.102261428833015,0.019431022275629675,297.6590057373047,309.75624618530276,0.588647748474579,0.05580960657191105,1.0712613272182083,1.0637540556784824,1.0495317479554072,0.07680356022184487,74.56718329949103,315.8058796489861,303.9921241760254,292.17836870306473,311.42678615025113,9.418695487089,305.96785681588307,8.815887577394323,310.5054600291944,306.9387319017877,5.436148674059738,5.90409317104453,22036300,3.7805243368733015,1.0468158202138733,140316700.0,-2.4256582872122237,70.74152269624075,78.01649708558223,239.59311506430524,28.730038038465786,13.654735221389098,0.17917033558896336,8.667277926061555,318.91619921875,312.7769010009766,307.81500244140625,302.8531038818359,296.7138056640625,0.1,0.0,199.28334717244766,0.07277964908621892,0.08932006771683308,312.89416939871654,306.6812177385603,8.717338698950115
2023-10-12,0,326.3475036621094,296.24000549316406,325.6550064086914,300.52812004089355,306.38124656677246,1.3576235050211367,7.561792469382611,1.1847024679332963,2.99542840422188,303.21750259399414,5.517724380493155,0.024786596044569786,297.6590057373047,316.271745300293,0.6841641014377432,0.05359283790178788,1.0697257001139178,1.0559835874231913,1.036249163418454,0.07428012591486421,77.03070609706377,320.1994596488481,305.075874710083,289.95228977131785,314.7760718209403,10.030880410659242,307.81357192993164,10.18361988505253,314.29666902819076,309.3405807327957,6.914979099552975,9.92944922025601,20530500,3.7580290343707183,0.972541183960709,160847200.0,-14.582868303571427,70.74152269624075,78.01649708558223,184.80475926099533,28.26930434232776,12.765375391069085,0.11587709183372062,8.608901367308274,320.2150085449219,313.8275085449219,308.6650085449219,303.50250854492185,297.11500854492186,0.12000000000000001,0.0,199.46348232747675,0.06355189659189175,0.06080241888312391,316.20450701032365,308.4689745221819,9.55648235539025
2023-10-13,0,318.90999603271484,296.24000549316406,326.3475036621094,300.52812004089355,306.38124656677246,1.244955642743567,8.846163165118003,0.3609513363286294,2.9953190668875016,303.21750259399414,6.75287532806397,0.02891481763232666,297.6590057373047,321.41600036621094,0.7801625195157007,0.06765524049375443,1.0423981792211223,1.0236813031196128,0.9983267681914024,0.03366852329754444,79.46520590493608,323.6310764065299,305.93875007629396,288.246423746058,317.1307144165039,8.460723267159652,309.3228569030762,10.147930810305372,317.2998535575683,311.3679582695392,7.740114191118204,8.598791137977194,21341000,3.6203548942907324,1.027398084623017,139506200.0,-36.228585379464285,70.74152269624075,78.01649708558223,90.10221169426708,25.392362827140325,19.74904973115157,0.13691624037723105,8.899693603627773,320.2150085449219,313.8275085449219,308.6650085449219,303.50250854492185,297.11500854492186,0.12000000000000001,0.0,199.637732389064,-0.00234594632535301,0.032481384842876576,317.5032697405134,309.45694841657365,9.607455433713593
2023-10-16,0,319.2825012207031,296.24000549316406,326.3475036621094,300.52812004089355,310.3299980163574,0.9983970947556937,9.28575119982608,-0.35660995173856724,2.995278091641296,303.21750259399414,7.6527249145507765,0.030286120993794633,297.6590057373047,321.41600036621094,0.8582710043625069,0.06114096608569267,1.0413620023927317,1.0201248501401252,0.9930346946693634,0.011179662763371123,66.13301814442546,325.1723774912049,306.6008750915527,288.02937269190056,319.34500013078963,6.077787310903292,310.8264285496303,9.935541357373932,317.6937326432162,312.17451056504916,5.450065977919099,7.095838931181751,16536100,3.8576267158763646,0.7916939663623065,156042300.0,-21.462890625,70.74152269624075,78.01649708558223,92.98384412010746,23.918345608364966,18.602624738867913,0.14558983709295079,8.773287266426681,320.2150085449219,313.8275085449219,308.6650085449219,303.50250854492185,297.11500854492186,0.12000000000000001,0.0,199.7748290356767,0.008763641229293961,0.018133918847203643,319.8356148856027,311.0386984688895,10.022024392361763
2023-10-17,0,320.9699935913086,296.24000549316406,326.3475036621094,301.2387466430664,316.5418701171875,0.7469134208622611,9.568068801711892,-0.8592093202712543,2.9952518871979756,303.58250427246094,8.264724845886224,0.03111180085987073,297.6590057373047,321.41600036621094,0.8777299035452075,0.05240906615453729,1.0436750330244404,1.0207256676443683,0.9960959078446956,7.787594917552099e-05,65.80919823898915,326.6743879543759,307.5382503509521,288.40211274752835,321.1232136317662,3.7642343985475786,312.56928525652205,9.366122347979541,318.09761077755127,312.94659223355603,5.102334709114462,7.058252598559271,16387800,3.8336434038780234,0.7837244630659123,172430100.0,-19.32626847716006,70.74152269624075,78.01649708558223,96.87531643273394,24.64617278758066,17.51244098760343,0.1552930359163904,8.653767183361605,322.55376940917967,317.61312994384764,313.62001037597656,309.6268908081055,304.68625134277346,0.12000000000000001,0.0,199.9131083255791,0.00671133988684991,0.01771574372994057,321.05738612583707,312.91056387765065,10.591953453721855
2023-10-18,0,319.96500396728516,296.24000549316406,326.3475036621094,301.2387466430664,319.0031223297119,0.5257276114509992,9.946442466019478,-1.2349689196676559,2.995215027848624,304.0900001525879,8.90439971923828,0.03224991592761783,297.6590057373047,321.43849487304686,0.8782921496143186,0.059123405528217994,1.0374407244577775,1.0117166586795436,0.9929616264798096,-0.017472485696305884,67.71411574256236,328.3105095963455,308.41762466430663,288.52473973226773,321.7250006539481,3.0270601604200285,313.88946424211775,8.977728055293984,318.7968597443563,313.59711599903596,4.034550006490076,8.22739788973679,16851000,3.827789321967319,0.810778431013105,155579100.0,-42.35331992871614,70.74152269624075,78.01649708558223,70.57927315523993,22.56422681531792,17.449125035326265,0.17074071177936967,8.777069876179526,322.9785665283203,318.3007252807617,314.52000427246094,310.7392832641602,306.0614420166016,0.12000000000000001,0.0,200.05216726632963,-0.03309745907104089,-0.015131751603365353,320.8592224121094,313.8379429408482,10.488673933166487
2023-10-19,0,316.58250427246094,296.24000549316406,326.3475036621094,301.2387466430664,319.45312690734863,0.32221381345277844,10.170767165368243,-1.4550853673278958,2.9951932547376012,304.49499893188477,9.372149963378911,0.032887086216586925,297.6590057373047,321.43849487304686,0.870941306820466,0.08008708491152308,1.0236667444440966,0.9955009871533378,0.9859465409718244,-0.02992209004227231,69.20452891530906,329.6047843002189,309.26324996948244,288.921715638746,321.1017870221819,3.6077846436666063,314.7598217555455,8.568028965902807,319.06213706807193,313.9506040300546,1.3341174573399404,6.130540217290685,18709200,3.4047879560672243,0.9058318261716221,136869900.0,-55.33709818294731,70.74152269624075,78.01649708558223,36.93596601805064,20.72264560953934,19.09160904883488,0.1512594059493525,8.874423074197953,322.9785665283203,318.3007252807617,314.52000427246094,310.7392832641602,306.0614420166016,0.02,1.0,200.20101557669082,-0.035013563777299694,-0.04578731838697042,319.5718688964844,314.73609706333707,9.953499362465895
2023-10-20,0,311.13999938964844,296.5699996948242,326.3475036621094,302.1912479400635,319.45312690734863,0.18241058186984208,9.828951670130147,-1.50730888480784,2.995231379000549,306.55749893188477,9.188662948608396,0.03167764533296804,298.18724899291993,321.43849487304686,0.9020943231056519,0.05349288331064714,1.0027704764810048,0.9744646938887801,0.9749265203832864,-0.024364230471688786,60.40201000001708,329.93827824870743,310.28037490844724,290.62247156818705,319.02821459089006,4.591734383102554,315.22750037057057,8.13828131604023,318.43923586182694,313.96081638203617,-1.359265739148898,4.002991228455149,22287400,3.4755810904280566,1.0871873270583907,114582500.0,-68.32087643717848,70.74152269624075,78.01649708558223,-5.964030387018067,19.249341377897128,21.985558325971983,0.17265662573014334,8.871249038345644,322.9785665283203,318.3007252807617,314.52000427246094,310.7392832641602,306.0614420166016,0.04,0.0,200.36963596415814,-0.019193603181772545,-0.04784679516375587,316.8389107840402,314.86654009137834,9.584758631465265
2023-10-23,0,312.0325012207031,296.5699996948242,326.3475036621094,302.78375244140625,319.45312690734863,0.08407400581018629,9.570117614900138,-1.4307298616196602,2.9952585319692915,309.83124923706055,8.743000030517578,0.030790695360678546,298.18724899291993,321.43849487304686,0.8811962009621981,0.044865312289035834,1.003926814102951,0.9764594543121258,0.9825072129329927,-0.02270716363183478,51.624199949083796,329.9522355044585,310.8120002746582,291.6717650448579,316.98321424211775,3.9284852028529587,315.87964303152904,7.407685814541154,316.608338955235,313.21537676025764,-4.457173000075695,2.1495935180911276,17796800,3.6699450225620462,0.8706617167008023,132379300.0,-51.59174273040813,70.74152269624075,78.01649708558223,10.249788950293476,19.341681548364054,20.21516602220334,0.14290747970437698,8.959015220316491,322.9785665283203,318.3007252807617,314.52000427246094,310.7392832641602,306.0614420166016,0.04,0.0,200.50725832301345,-0.022232533621180717,-0.0021609007662903757,315.39188494001115,315.7981959751674,9.277466873602323
2023-10-24,0,314.57749938964844,296.5699996948242,326.3475036621094,303.56250190734863,319.45312690734863,0.009795188017121424,9.09187302286723,-1.3245799856401488,2.995306328217868,311.5862503051758,8.119625473022461,0.02918508616268104,301.1574981689453,321.43849487304686,0.8660735383598535,0.04627263338665483,1.0097997850867813,0.9855709685580186,0.9950638610473193,-0.01991617387698774,52.83274216476953,329.7083710609933,311.5246250152588,293.3408789695243,316.36428615025113,3.9155980372674803,316.7475002833775,6.346109772413786,315.4707897278306,313.0702716499255,-4.386429275778246,3.014170280482082,19525500,3.6696784665126625,0.9549808372901052,151904800.0,-57.95752512734498,70.74152269624075,78.01649708558223,12.853929099825525,18.936521190941512,18.95850585498643,0.10105085430098718,8.870514220344107,323.2145665283203,318.6827252807617,315.02000427246094,311.3572832641602,306.8254420166016,0.04,0.0,200.65915745205044,-0.03533939735493685,-0.026778679818874024,315.08679635184154,316.2950330461775,8.761812733458603
2023-10-25,0,304.8125,296.5699996948242,326.3475036621094,304.2437496185303,319.45312690734863,-0.08682418225898457,8.580572690330452,-1.1966654813221789,2.9953545395671237,313.3050003051758,7.556875228881836,0.02747173329939998,302.33299789428713,321.43849487304686,0.8222947775386134,0.060719222151108525,0.9758938020255696,0.9568861637013292,0.9680905242009086,-0.04735675395561201,57.3691996806945,329.5030204569548,312.34187507629395,295.1807296956331,314.2971431187221,5.5828258945159455,316.82107162475586,6.188249863454615,315.2528358601984,313.3456544179082,-1.3585327198781076,4.017492328476015,42192500,3.6457162551492086,2.0349332825956474,109712300.0,-97.8233369851725,70.74152269624075,78.01649708558223,-91.84901537875042,16.924382684996182,26.081683227571407,-0.03518036673515657,9.216191165682252,323.0588056640625,318.43060388183596,314.69000244140625,310.94940100097654,306.32119921875,0.06,0.0,200.95493603820717,-0.055020885806729924,-0.07552454403510164,312.0045645577567,315.9200897216797,8.610221802613879
2023-10-26,1,289.4375,301.4824981689453,326.3475036621094,304.5437488555908,319.45312690734863,0.08026287077170893,7.990829272696797,-1.3543422648276378,2.995406040157935,313.3050003051758,7.1447502136230465,0.02554988671722068,302.8550033569336,321.43849487304686,0.7921263064690658,0.011045423370442602,0.9254477957604786,0.9146042802889335,0.9281930135005607,-0.08574385478074009,41.07827188347617,328.7356586369463,312.7540000915527,296.7723415461591,309.7925011771066,10.15250378984179,315.45785740443637,9.416860571982749,312.6464066980063,312.37332568513926,-4.532037040984209,0.3390579691581917,66684100,4.23170665210183,2.904366713422005,43028200.0,-82.4990034348676,70.74152269624075,78.01649708558223,-207.61385842033667,14.489862797304937,36.22153505348467,-0.034871906637251544,9.995749288334412,318.47096508789065,311.00452294921877,304.9700012207031,298.9354794921875,291.4690373535156,0.08,0.0,201.34851686061396,-0.07819446760812099,-0.09029246303944952,306.92215401785717,313.9897700718471,10.02966032617225
2023-10-27,1,295.8725051879883,289.4375,326.3475036621094,304.5437488555908,319.45312690734863,-0.4761653156506177,9.182661300492635,-0.24205945959460173,2.9952973877984634,313.3050003051758,7.747000122070313,0.029417298782102506,302.8550033569336,321.43849487304686,0.6605891682914532,-0.04914626148200101,0.9478482981896852,0.945971670246265,0.9656413354699357,-0.049069532145046724,27.474044952915392,330.5170727840908,312.1517501831055,293.7864275821202,306.35071563720703,10.212780070568412,314.03785814557756,10.770594080916092,306.82290032060064,309.45678426024244,-9.824125064930197,-6.185934296884855,29596300,5.414101830951227,1.277247946114113,72624500.0,-66.11260827948699,70.74152269624075,78.01649708558223,-124.21017014176935,16.421600498084878,33.404115734289135,0.023801511108655114,10.064623728816105,318.47096508789065,311.00452294921877,304.9700012207031,298.9354794921875,291.4690373535156,0.08,0.0,201.53967084964248,-0.03861964339605406,-0.05140491799015714,304.03666033063615,312.4479413713728,10.270044335848597
2023-10-30,1,302.5499954223633,289.4375,326.3475036621094,304.38999938964844,319.45312690734863,-0.48019945016496973,9.71513510625289,-0.520703575052377,2.995244001554152,313.3050003051758,8.203949890136721,0.031165673296009715,301.7719985961914,321.43849487304686,0.7583577743447748,-0.028628392446482964,0.9705654332047087,0.9744989032479301,0.9973742708939786,-0.03038948109970374,36.32065462525857,331.15577070078695,311.7255004882812,292.2952302757755,304.3460715157645,9.1962949941665,312.7239292689732,10.983087408842088,304.0530192332609,307.862205706148,-7.5297293393249385,-6.2960673155913796,28435100,5.6479421307692,1.1957365738724803,101059600.0,-54.51700605577423,70.74152269624075,78.01649708558223,-63.41148298428851,22.002659142758965,30.454988105712815,-0.02465085994162802,10.250720813197544,318.47096508789065,311.00452294921877,304.9700012207031,298.9354794921875,291.4690373535156,0.08,0.0,201.736817236103,-0.03614533511082907,-0.019407016792260694,302.58963448660717,311.08075169154574,10.415827104246327
2023-10-31,1,301.27999114990234,289.4375,326.3475036621094,303.56250190734863,319.45312690734863,-0.45833361729949973,9.799945386304723,-0.6007876344205418,2.9952352078492086,313.3050003051758,8.316287574768069,0.031448043254867136,301.7719985961914,321.43849487304686,0.7890958416562062,-0.0011637690025829153,0.9668080606600954,0.9756665962152842,0.9994360296895085,-0.04227100878335632,44.34123709405855,331.22326609304395,311.62337532043455,292.02348454782515,302.9374989100865,8.725307110875143,310.9828567504883,10.703985641118296,303.64637033652195,307.55661241951924,-4.432496635386027,-5.731512966381195,19434200,5.85713251359228,0.8136911740077039,81625400.0,-57.23506286118026,70.74152269624075,78.01649708558223,-86.42989372756732,20.93142154333486,30.535635252854433,0.010480001885118561,10.005669849699059,318.47096508789065,311.00452294921877,304.9700012207031,298.9354794921875,291.4690373535156,0.08,0.0,201.86703825073909,-0.03609031766711979,-0.04057203186598391,301.53751046316967,309.1882106236049,10.398453580993388
2023-11-01,1,307.07250213623047,289.4375,326.3475036621094,303.47437477111816,319.45312690734863,-0.4458849495939537,9.878205715209646,-0.6612412770781355,2.9952270223529007,313.3050003051758,8.40552577972412,0.03170743526879518,300.73924255371094,321.43849487304686,0.7843795943543512,-0.00379432003363692,0.9856528366604135,1.0008066557035133,1.0277184309068,0.0074144011030730095,43.359653741156784,331.2986611099848,311.54224967956543,291.7858382491461,302.2289276123047,8.037936890524787,309.6060709272112,9.775007226101682,303.0457265475005,307.1765954844384,-3.1689941052542583,-7.48491955569657,20434600,5.863080476281498,0.849258188478331,102060000.0,-30.275018802995103,70.74152269624075,78.01649708558223,-24.368189298220187,25.636090713415097,28.061178596041632,0.021871859362221937,10.110264947627922,314.9565604248047,308.1617191772461,302.6699981689453,297.17827716064454,290.3834359130859,0.02,1.0,202.01494774660438,0.04113101222762272,-0.0022396844971291413,301.2295706612723,308.31072780064176,10.302905776888956
2023-11-02,1,313.82999420166016,289.4375,326.3475036621094,304.5550003051758,319.45312690734863,-0.5041269948991984,9.714422531069578,-0.49121299075477465,2.9952441041778255,313.3050003051758,8.15005054473877,0.031158489659666406,300.73924255371094,321.43849487304686,0.7957757290762266,0.010830119912460337,1.006592887837767,1.027146559411579,1.048748073825978,0.08427551440867243,49.102687659350245,331.2033449553276,311.7744998931885,292.34565483104933,302.1221411568778,7.849291628095787,309.24321365356445,9.493297843780619,304.0838076282615,307.60404489199965,-1.5895777090747378,-5.906281282860885,21631800,6.001558149285683,0.8943640527816935,123691800.0,-32.38075753611585,70.74152269624075,78.01649708558223,3.6706885739232624,28.025255783699915,25.987086439052387,-0.024112308552602258,10.137390362222579,314.9565604248047,308.1617191772461,302.6699981689453,297.17827716064454,290.3834359130859,0.04,0.0,202.17672064920288,0.07809952747167448,0.037859198160016795,300.9900599888393,308.0384281703404,10.172068759191603
2023-11-03,1,313.42999267578125,289.4375,326.3475036621094,306.50750160217285,319.45312690734863,-0.6593862524062427,9.546479745314706,-0.21223711373027276,2.995261645380777,314.2037467956543,7.777187728881836,0.03057056261149276,300.73924255371094,321.43849487304686,0.801221693581068,0.017202943490141773,1.0036926145595484,1.0267623681996818,1.0306095111124005,0.05934139597269272,54.22626088690081,331.3698340328657,312.2768745422363,293.18391505160696,303.35321153913225,8.941373958959053,308.82517732892717,9.13947656270322,306.5601795001324,309.1396794655601,-0.2376219498974372,-1.5929264978365758,16754100,6.098483451372871,0.6999745146290207,106937700.0,-24.36612431419067,70.74152269624075,78.01649708558223,11.603299259560368,27.064152453632527,25.095880467264283,-0.04435132814232289,9.747576241762484,314.9565604248047,308.1617191772461,302.6699981689453,297.17827716064454,290.3834359130859,0.04,0.0,202.30287865366614,0.060223057904982946,0.09103530324067298,303.1385018484933,307.571533203125,10.159869236908854
2023-11-06,1,316.13999938964844,289.4375,326.3475036621094,306.50750160217285,319.45312690734863,-0.7412983283525012,9.509825661490051,-0.09769822828169739,2.9952656083632108,314.2037467956543,7.598049926757812,0.030429275628119472,300.73924255371094,321.43849487304686,0.8155433191464591,-0.007355451419673524,1.0115759763564196,1.0348637230285231,1.0276547647192478,0.044918209132058795,52.18434654745057,331.54190054478187,312.52224922180176,293.50259789882165,307.16785430908203,7.6123083369536415,308.4801777430943,8.727648937347036,308.3102269320005,310.6812373563571,2.8271454339245436,-1.8330188853276193,12887700,5.874675268225345,0.5494766462725703,119825400.0,-21.787736971835834,70.74152269624075,78.01649708558223,33.512522648675386,28.388759595988326,24.350302236255917,-0.07937837895880029,9.328461822010476,314.9565604248047,308.1617191772461,302.6699981689453,297.17827716064454,290.3834359130859,0.04,0.0,202.40187573812022,0.04341499763822698,0.06426703877336702,307.0518886021205,306.98702130998885,10.09361006722607
2023-11-07,1,318.0,289.4375,326.3475036621094,306.50750160217285,319.45312690734863,-0.7449908100944406,9.516779402593855,-0.09974904967410758,2.9952649637217212,314.2037467956543,7.613550109863286,0.03044963825001019,300.73924255371094,321.43849487304686,0.8012690306984843,-0.014971413512423294,1.0174644755203726,1.0395545676263884,1.0246479518806952,0.055496579066807605,53.615100724552185,331.57518325587125,312.54162445068357,293.5080656454959,310.3289249965123,6.676916985236675,308.33982031685963,8.5425816092556,310.28884583277795,311.91392331944326,9.22565299577575,-1.5048117575159354,14055600,5.781891633135877,0.6057043668321742,133881000.0,-7.225243174487346,70.74152269624075,78.01649708558223,54.26977202122777,29.17582440910447,23.224231560692385,-0.07782887125579088,9.08214346921062,311.86236975097654,305.6588267211914,300.64500427246094,295.63118182373046,289.42763879394533,0.06,0.0,202.51165591329314,0.05825349150457226,0.053393249117808274,310.2011282784598,307.118894304548,9.961162878669041
2023-11-08,1,318.5325012207031,289.4375,326.3475036621094,306.50750160217285,319.0031223297119,-0.750096555684474,9.407776838701338,-0.0375765149526357,2.9952751914138287,314.2037467956543,7.495750122070308,0.030115064827222055,300.73924255371094,321.43849487304686,0.7669845345431758,-0.023506490789472173,1.019648646891463,1.0401316057828434,1.0154226598675125,0.0373201735901072,54.33846674595894,331.2099281433451,312.3943744659424,293.5788207885397,312.6121401105608,6.295272582314281,308.4791058131627,8.701730181995298,312.2323714348556,312.817687697845,7.478726283793281,-0.6141309027302462,13609700,5.687389468239256,0.5973345388550324,147490700.0,-3.6966087853958114,70.74152269624075,78.01649708558223,63.187163578421824,27.929538194008014,22.02122434380973,-0.09536589978128986,8.894131913513657,311.43450830078126,305.3127293701172,300.364990234375,295.4172510986328,289.29547216796874,0.08,0.0,202.61807611930507,0.025428955126844288,0.061440025497956206,312.64182826450894,307.615731375558,9.433745219018519
2023-11-09,1,320.7374954223633,289.4375,326.3475036621094,306.50750160217285,318.62687492370605,-0.8737199920325746,9.026131611783962,0.1266708452997829,2.9953101935578084,314.2037467956543,7.210849914550783,0.028926362824864542,300.73924255371094,320.0655029296875,0.7347524666103483,-0.023946873665985427,1.027878781649176,1.042660529212216,1.0150354460156683,0.02201032835715666,54.72848509920785,330.0905124301109,312.03824920654296,293.985985982975,315.39178357805525,4.4963247129477475,309.1646412440709,9.285927084698518,313.81730767832624,313.4884652601334,5.282599914116039,0.6159522152759138,16103100,5.685879624032937,0.7137051094994035,163593800.0,-8.106308579201569,70.74152269624075,78.01649708558223,90.49069999378887,29.04305403271137,21.042128042211175,-0.08031442631217742,8.643122839892145,313.6119129638672,307.07403314208983,301.7899932861328,296.5059534301758,289.9680736083984,0.1,0.0,202.7464633984245,0.03113834386974701,0.027897932337001954,315.39046369280135,308.4639870779855,9.210818150648763
2023-11-10,1,324.31749725341797,289.4375,320.9699935913086,306.50750160217285,318.62687492370605,-1.0682590397086347,8.656701304456943,0.22850713175617932,2.9953427818099105,314.2037467956543,7.013924827575687,0.02776739740368602,300.73924255371094,320.042253112793,0.7668735264309333,0.00573045502612896,1.0402868846321411,1.0436789699385192,1.0218972913500082,0.03473663922424608,59.73090145788768,329.07115140346957,311.75774879455565,294.44434618564173,317.85535430908203,3.857358146547633,310.04214096069336,10.120710250036163,315.54032075351523,314.0925222808903,6.45827962162274,3.08462301585842,19096200,5.4620193535315416,0.8505935741125786,182690000.0,-0.6640181263316898,70.74152269624075,78.01649708558223,124.68957252201605,30.780962341033554,19.37946078213965,-0.010961500074672434,8.714329397645384,317.37080322265626,310.1146014404297,304.25,298.3853985595703,291.12919677734374,0.12000000000000001,0.0,202.90425389440068,0.04504118667068835,0.0575803058481572,317.80264718191967,309.51610892159596,9.987049401945406
2023-11-13,0,328.3550033569336,289.4375,324.31749725341797,306.50750160217285,318.7200012207031,-0.9431039607884972,8.955166488718325,0.1006871358865844,2.995316535207279,314.2037467956543,7.203187370300293,0.02869986967220573,300.73924255371094,320.7607452392578,0.7557991442365021,0.01576972121386138,1.052325025384247,1.0470871319347905,1.0275688586968859,0.03863795783788171,63.199775120282425,329.93845683302743,312.0281238555908,294.1177908781542,319.93035561697826,5.052638986437864,311.026248386928,11.20716459249587,317.7341991411298,315.0634372688899,5.615935975125797,3.937088599634551,16908900,5.5172390576884265,0.7525408249914994,199598900.0,-5.932334338478214,70.74152269624075,78.01649708558223,143.64778725592433,31.772663208399816,18.308001983218986,-0.03793658171843942,8.565446895330313,319.83850830078126,312.1107293701172,305.864990234375,299.61925109863284,291.89147216796874,0.14,0.0,203.04737297370443,0.04240027973509597,0.04637627965041268,320.41442435128346,310.70224217006137,10.520640248715035
2023-11-14,0,335.5699996948242,289.4375,328.3550033569336,306.50750160217285,318.89062690734863,-0.6974104725519367,9.522934488272488,-0.04079354925940404,2.995264397013452,314.2037467956543,7.565649719238285,0.03047517021359953,300.73924255371094,321.3047439575195,0.74716208542328,0.02300841173031377,1.0738867175733833,1.061361080548494,1.042180078690111,0.0552515713673718,66.43480301724738,331.5276179389473,312.4817489624023,293.43587998585735,323.0932137625558,6.897982933856899,313.223212650844,12.79729216614484,320.40890024068057,316.4219474600987,4.628304949698336,4.379685131332226,17179400,5.573793317699283,0.7632351281684472,216778300.0,-3.049417670661852,70.74152269624075,78.01649708558223,183.2144558626876,34.21657988844575,16.95158038387759,-0.06065105944187018,8.590058092957388,324.24680322265624,315.6766014404297,308.75,301.8233985595703,293.25319677734376,0.16,0.0,203.20032341080633,0.0548584407524888,0.06494612668858545,323.50948660714283,313.3239942278181,11.541865845942496
