date,buy?,todays_price,Minimum,Maximum,25th Percentile,75th Percentile,Skewness,Standard Deviation,Kurtosis,Shannon Entropy,Median,Mean Absolute Deviation (MAD),Coefficient of Variation (CV),10th Percentile,90th Percentile,Autocorrelation,Cumulative Return,curr_to_avg_one_month,curr_to_avg_one_two_week,curr_to_avg_one_one_week,momentum,rsi,upper_band_current,middle_band_current,lower_band_current,rolling_mean_7,rolling_std_7,rolling_mean_14,rolling_std_14,ema_7,ema_14,roc_7,roc_14,Volume,Volatility,Relative Volume (RVOL),On-Balance Volume (OBV),Williams %R,Stochastic Oscillator %K,Stochastic Oscillator %D,Commodity Channel Index (CCI),ADX1,ADX2,Chaikin Money Flow (CMF),Average True Range (ATR),Fib_23.6,Fib_38.2,Fib_50,Fib_61.8,Fib_76.4,Parabolic SAR 2,Parabolic SAR 3,VWAP,Adj Close Momentum,Adj Close Return,Adj Close 7d MA,Adj Close 14d MA,Adj Close Volatility
2024-01-02,0,157.40750122070312,143.08250045776367,155.04249954223633,148.4656276702881,154.31875133514404,-0.9342843144194406,3.9739097749763426,-0.6858339489602998,2.995383924572246,152.9937515258789,3.3981244659423853,0.026284101642698843,144.1025032043457,154.59124984741212,0.8353959731206405,0.08177101130821487,1.041119450537307,1.0226794736596012,1.0181663572300446,0.020834018821861644,77.12476452627529,159.13844531289215,151.19062576293945,143.24280621298675,154.65892900739397,1.5276300206189883,154.05303600856237,1.3290660418415987,154.14227436742743,152.47564783736627,0.815803068693274,3.9820615566117157,8059900,0.976804619735711,1.4229647467585662,75003600.0,-3.209548909233938,73.63263747053657,76.71321854558761,139.16597274401062,45.381050409858496,7.951978555240408,0.2623380731030609,2.335727246295826,157.7870791015625,156.33145892333985,155.15499877929688,153.9785386352539,152.52291845703124,0.04,0.0,151.8813645818309,0.031496071763821964,0.047381905152278046,150.94599260602678,150.1541508265904,3.8437410687815716
2024-01-03,0,160.6599998474121,144.0800018310547,157.40750122070312,150.7000026702881,154.41500186920166,-0.9671657377017155,3.731532795936893,-0.23260186844855957,2.9954280882238025,153.32999992370605,3.004624290466313,0.024564607600929975,145.57875061035156,154.80850105285646,0.7796196904810379,0.09250068864710312,1.0576216448410631,1.0418058097483214,1.03490367564791,0.039399625830443874,82.29772066628405,159.3699413929602,151.90687580108641,144.44381020921264,155.8660719735282,2.3740666711399077,154.65857178824288,2.1119267024087276,154.95484780805268,153.27901444288477,2.9766280215330525,4.026367961535126,5301400,1.0731314944502353,0.9322019741637235,80305000.0,-12.332623882761226,73.63263747053657,76.71321854558761,189.26766015131471,48.27171490634878,7.347690587671368,0.2537638484297012,2.2989995253087487,159.28143841552733,157.75427743530273,156.5199966430664,155.2857158508301,153.75855487060548,0.06,0.0,152.2592411041157,0.03777007748720429,0.035626702466073724,152.03929138183594,150.65564945765905,3.7649506399161576
2024-01-04,0,160.87249755859375,144.1050033569336,160.6599998474121,151.96562480926514,154.47624969482422,-0.5370519646448368,3.7423197876419905,0.45443794670778637,2.9954306803052915,153.61249923706055,2.744362182617189,0.024501904156073343,147.142000579834,155.278999710083,0.6803078903537585,0.11488148297997298,1.053272499465481,1.0381147940736983,1.0282053608034154,0.04188656362129528,86.71047079742722,160.22051527718824,152.7358757019043,145.25123612662034,156.82000023978097,2.8786315027618588,155.17125020708357,2.6600708665617367,156.3778882885032,154.36350461458193,5.551541169282787,5.5706148703221,8332200,1.2004965483876935,1.410924411014158,88637200.0,-7.545332475142046,73.63263747053657,76.71321854558761,192.618632559624,45.092905594510185,6.552990218817882,0.2545692266471292,2.3488307843742953,159.6939932861328,158.08799328613281,156.7899932861328,155.4919932861328,153.88599328613282,0.08,0.0,152.81553164591924,0.04248446069766176,0.0442375773616193,152.94504874093192,151.1529824393136,3.654082476630796
2024-01-05,0,161.7775001525879,145.74250030517578,160.87249755859375,152.20312404632568,154.62312507629395,-0.04474760251921,3.589946814181075,0.4399201102397501,2.9954588746090742,153.94499969482422,2.5048247146606455,0.02337596833160815,148.6992530822754,157.73275108337404,0.7017087262746744,0.10381321317897449,1.053415528440439,1.0390317285869357,1.0255114024948646,0.043439706082117446,86.50053241377832,160.75414404034944,153.5742504119873,146.39435678362514,157.84964316231864,3.2096798145040784,155.7060715811593,3.1725889039485624,157.50485176835446,155.36195676831636,4.330554088644465,4.669961858239451,5607600,1.194786472254618,0.9445285694795121,94244800.0,-7.580911185830909,73.63263747053657,76.71321854558761,197.53982194873433,43.790773412240235,5.96509058103009,0.24850834546184528,2.355044175590469,160.25935748291016,158.5453166809082,157.15999603271484,155.7746753845215,154.06063458251953,0.1,0.0,153.18730536702276,0.04775439403758064,0.04687493667972381,153.98972647530692,151.65726034981864,3.6410742529912286
2024-01-08,0,161.53999710083008,147.29750061035156,161.7775001525879,152.6956262588501,154.84750080108643,0.42469774068354593,3.5415766131680178,0.1805660846039725,2.9954699050933424,154.24250030517578,2.4578497886657713,0.022941238300587828,151.069002532959,160.68124961853027,0.7160526491733865,0.09830444835951767,1.0464061556051942,1.0315963723483534,1.0153362482767447,0.04365800931522279,87.11215210130503,161.45915363069395,154.3760004043579,147.29284717802187,158.86892809186662,3.063027865884889,156.21285711015975,3.504918601577038,158.57901469981087,156.34494740010598,4.662936192012566,4.852873933910921,6001600,1.1818084564067424,1.0214176731330697,88243200.0,-13.628665714400833,73.63263747053657,76.71321854558761,149.90129746283586,39.12081321429549,8.289271017551302,0.21076205453493996,2.4096140986416836,160.25935748291016,158.5453166809082,157.15999603271484,155.7746753845215,154.06063458251953,0.1,0.0,153.5278881968201,0.04168540280357069,0.043166256192475265,154.89964730398995,152.17056819370814,3.5759088938615506
2024-01-09,0,162.0124969482422,148.8550033569336,161.7775001525879,153.06187629699707,155.63374996185303,0.6840454985464944,3.478006269100334,-0.3517731168453704,2.9954820415324397,154.34750175476074,2.6816869735717774,0.02242599982408344,152.09574928283692,160.9392475128174,0.760920876626461,0.08521711368666349,1.0446479813276563,1.0284858909253165,1.0097287827177253,0.02925524953910763,84.69906173284517,162.0441377670825,155.08812522888184,148.13211269068117,159.86464200701033,2.7262056827147454,156.84732110159737,3.702328833973377,159.33071469521724,157.1363752978006,4.6209607117441065,4.59386669689872,4454000,1.1861865369066267,0.7661181084416617,92697200.0,-9.523833386158609,73.63263747053657,76.71321854558761,139.5939274969318,37.97348067258275,7.528731755078254,0.2059329391800508,2.4282839839872974,160.59551934814453,158.81723818969726,157.37999725341797,155.94275631713867,154.1644751586914,0.12000000000000001,0.0,153.78928052162559,0.015580033145873307,0.047364009059768085,155.9498792375837,152.78806631905692,3.590703864548391
2024-01-10,0,163.53000259399414,151.31500244140625,162.0124969482422,153.42999935150146,158.22062587738037,0.7890098434297828,3.4811613415286864,-0.9045738712170919,2.9954839036832044,154.42500114440918,2.9793993377685526,0.02235152969305812,152.20724906921387,161.56374740600586,0.8178876748049794,0.0706968531489687,1.0499788289273726,1.0329928747280543,1.01336971475872,0.017863828889006728,84.49561231446815,162.70832259150458,155.74599990844726,148.78367722538994,161.1142850603376,1.8827569980598526,157.56160708836146,3.968189339849931,160.01125921375825,157.8762140413149,4.495539885247469,5.800624187402601,6609900,1.1086103799106624,1.1343485420140054,99307100.0,-1.37782685766513,73.63263747053657,76.71321854558761,146.12272663512113,39.29770634291932,6.720751362856876,0.2783211505676792,2.492800781548263,161.82555981445313,159.81221856689453,158.18499755859375,156.55777655029297,154.54443530273437,0.14,0.0,154.22400406495228,0.027608170374788354,0.031723231958277046,157.32796369280135,153.57226889474052,3.896445019927365
2024-01-11,0,164.05999755859375,152.18249893188477,163.53000259399414,153.65374946594238,160.71312427520752,0.6972159164540405,3.7139354701877023,-1.140652461503115,2.995451680837075,154.50749969482422,3.330274600982668,0.023752959000370177,152.7927516937256,161.8009998321533,0.819107160436133,0.07456510270072772,1.049267125638335,1.0305082045211975,1.013050598206693,0.019813828021405744,86.45427004561328,163.78462085645208,156.35674991607667,148.92887897570125,162.06464168003626,1.2834442747824901,158.36178534371513,4.074699864192686,160.898373434151,158.60034433401623,5.651479530504565,6.513387542634267,4591500,1.127349339352884,0.7967882051397741,103898600.0,-9.689053944170272,73.63263747053657,76.71321854558761,125.14246573927588,36.747874673476176,6.261659749897568,0.2280894417881629,2.4545749206566185,161.8561146850586,159.83693441772462,158.20499420166016,156.5730539855957,154.5538737182617,0.16,0.0,154.50606434891293,0.014368893769235669,0.020690554834033457,157.87808663504464,154.41203962053572,4.096615843932956
2024-01-12,0,162.65749740600586,152.20999908447266,164.05999755859375,154.06999969482422,161.03937244415283,0.5604190027673659,3.94162553913935,-1.3424242786564828,2.9954183476152823,154.67625045776367,3.6254994201660167,0.02511379322619079,153.10275115966797,162.16424751281738,0.8550822484235361,0.06743874481505711,1.0363609419468192,1.0155398723303153,1.000452064998196,0.005439552796822511,86.67646756209028,164.8338759256908,156.95062484741212,149.06737376913344,162.3499984741211,1.1322422424240273,159.10803522382463,3.8094371717848747,161.69622058660337,159.21159966168025,4.226289272302895,7.3287182045863615,4971100,1.1065218559955763,0.8867716524196195,98927500.0,-22.610153754829412,73.63263747053657,76.71321854558761,88.65802516545176,34.733936727491894,9.035484125220881,0.16856616669427996,2.3847700433562546,162.28091540527345,160.5245355834961,159.10499572753906,157.68545587158204,155.92907604980468,0.16,0.0,154.75213050238764,0.011173087581472174,0.015431694133518864,158.36313956124442,155.20121547154017,4.284159411065321
2024-01-16,0,161.69499969482422,152.20999908447266,164.05999755859375,154.26625061035156,161.59937286376953,0.3475481196257299,4.053894539949405,-1.570126182742536,2.995401536613074,154.91250038146973,3.792874279022217,0.025755570147964223,153.10275115966797,162.7447479248047,0.8967852096356864,0.05423226677573007,1.0272953245762222,1.004753622929516,0.9934566316189984,0.0009595307464156377,74.70296300317092,165.50653881287,157.3987497329712,149.2909606530724,162.46749877929688,0.9866783642317104,159.64374950953894,3.5861931849507056,161.93381831486164,159.53721249043542,1.2433073325599941,6.863871220270561,4747700,1.1886697568585634,0.8711783762359523,94179800.0,-31.9298363025525,73.63263747053657,76.71321854558761,63.90854095243204,33.05148098946848,12.669442004589921,0.10578819218744917,2.303528426699154,162.42959655761717,160.76519744873048,159.4199981689453,158.07479888916015,156.41039978027345,0.16,0.0,154.94473223579558,0.009867043601968994,0.005444815236579264,158.5802459716797,155.7626473563058,4.379286733682481
2024-01-17,0,162.06499862670898,152.20999908447266,164.05999755859375,154.35250186920166,161.71562480926514,0.14576382400021504,4.0910448726415005,-1.679199695350857,2.995396449584002,156.22500038146973,3.8883991813659664,0.02593060031532428,153.10275115966797,162.7447479248047,0.9135197074301412,0.04694227727880894,1.027229677336524,1.0027456143375542,0.9955402926525739,0.0003240594364986027,67.76551670750982,165.95108941721904,157.76899967193603,149.58690992665302,162.50856998988561,0.9587583571349122,160.17910657610213,3.3200691575308743,161.8688425156036,159.67829392474522,0.511275792141471,4.863970955506768,4423100,1.2283216994603146,0.9006974494730947,98602900.0,-27.017574386636507,73.63263747053657,76.71321854558761,66.91764138190774,33.63926598211632,12.002500231770187,0.15634379896998765,2.2367628720444017,162.42959655761717,160.76519744873048,159.4199981689453,158.07479888916015,156.41039978027345,0.16,0.0,155.12922051118758,0.007874928448631024,0.013369221503663922,158.78142656598772,156.38557652064733,4.426470908997047
2024-01-18,0,162.28000259399414,152.20999908447266,164.05999755859375,154.35250186920166,161.83624935150146,-0.05241516256378043,4.118472866153187,-1.7080824151513696,2.9953929882249843,159.03375053405762,3.9369991302490233,0.026041561024895694,153.10275115966797,162.7447479248047,0.8962840620746096,0.058349098780579825,1.026114467185746,1.0011907422970672,0.9967967335394903,-0.0076438572749457645,71.20662872112344,166.3869453508366,158.14999961853027,149.91305388622393,162.6142850603376,0.8709367949190041,160.74160657610213,2.908091755007325,161.9127419082847,159.88165404104555,0.17771227386374888,4.848935075811957,5074300,1.1616466515960928,1.0365265137162099,103677200.0,-16.993403524768837,73.63263747053657,76.71321854558761,68.48191959794713,32.99288981914868,10.88579207336944,0.17899164146434965,2.270373023202208,162.59243713378908,161.02877838134765,159.76499938964844,158.50122039794923,156.9375616455078,0.02,1.0,155.34335208648645,-0.0001806175827124834,0.015712057086028988,159.25795418875558,157.07880074637276,4.457040954980597
2024-01-19,0,164.03750228881836,152.20999908447266,164.05999755859375,154.5287504196167,162.0256223678589,-0.24732077192307972,4.042936975268059,-1.6382419684930805,2.9954066674028543,160.76624870300293,3.846749343872071,0.025490200545668088,153.46274909973144,162.7447479248047,0.8944724319590508,0.05699214410387386,1.034235471868871,1.0110232006123039,1.0091417373590863,-0.00013711611672651003,71.57258923234193,166.69337364536034,158.6074996948242,150.5216257442881,162.90357153756278,0.9685708622080167,161.38410677228654,2.5198410520434598,162.002223776996,160.14260792782017,0.458094284044196,5.10022335267673,5863000,1.1629693099088854,1.1929274843330349,109540200.0,-3.267890980068102,73.63263747053657,76.71321854558761,86.27455849595408,34.59278860294395,10.028315690730285,0.22526875584703918,2.2703427699679204,162.59243713378908,161.02877838134765,159.76499938964844,158.50122039794923,156.9375616455078,0.02,0.0,155.62149174038183,0.01565668517338681,0.008819524208751293,159.81839207240515,157.88413565499442,4.52285466890665
2024-01-22,0,164.7599983215332,152.20999908447266,164.05999755859375,154.7293758392334,162.11874961853027,-0.42051380074079237,4.031688968926452,-1.4672270609462101,2.9954101402157605,161.2062473297119,3.759299392700194,0.025335361861667117,154.06124992370604,163.58075256347655,0.852657421427071,0.07314001707532918,1.0353611625242065,1.013499166993431,1.0136145127120215,0.01292593916085738,77.65347663790381,167.19625280815325,159.1328748703003,151.06949693244735,163.0792852129255,1.187894114004902,162.09678513663155,1.823974688543745,162.50963706197,160.5870338673422,1.2499068767658685,5.801636824186798,4864000,1.1649501680393166,0.9881800340499535,114404200.0,-0.5617752784588042,73.63263747053657,76.71321854558761,95.44501051025257,34.576559315826735,9.43259642438147,0.31335807642440844,2.224955875189766,162.92951867675782,161.37023974609374,160.11000061035156,158.84976147460938,157.2904825439453,0.02,1.0,155.859386663206,0.018411390785317838,0.019478426657341452,160.10736955915178,158.71766662597656,4.372944521530405
2024-01-23,0,165.8849983215332,152.20999908447266,164.7599983215332,154.97749996185303,162.37437629699707,-0.5596892952210089,3.938851744851577,-1.2306345293292018,2.995426767828988,161.61749839782715,3.548349475860596,0.02465974502006707,154.38400230407714,164.0397518157959,0.8158056825021088,0.08245187118157472,1.0385467710507614,1.0185507764675472,1.0179023302860637,0.025912975878147115,80.5004534246148,167.60570317689798,159.72799968719482,151.85029619749167,163.33999960763114,1.5759113728329193,162.7023206438337,1.5311443086576078,163.06748440219155,161.1153454178542,0.7521529432081326,6.446140243336193,5784700,1.1280339900493632,1.1547206269549926,120188900.0,-0.37035502089133865,73.63263747053657,76.71321854558761,122.30566364654828,37.521601995725355,8.337446253733054,0.34025814914568925,2.321671986027318,165.6183973388672,164.43579644775392,163.47999572753906,162.5241950073242,161.34159411621093,0.04,0.0,156.17128905727043,0.037280226615697964,0.03140405792707262,160.84647042410714,159.3622785295759,4.3434463517132675
2024-01-24,0,166.0,154.19499969482422,165.8849983215332,156.81625080108643,162.87562370300293,-0.576230790795268,3.757186981455938,-1.084119264681036,2.9954566924393426,161.73624992370605,3.2067993927001908,0.023422143263669835,154.55349998474122,164.1299976348877,0.8257420281806284,0.07581308505363535,1.0348369141486096,1.0165448838178979,1.013396985870887,0.024280390007929364,81.75774258509439,167.92612361195972,160.41174964904786,152.897375686136,163.81749997820174,1.8218455173741883,163.08374922616142,1.644197813148447,163.76489904009662,161.82481527567154,1.112398384796792,5.385700830701625,5422200,1.0906137860877119,1.060664152360683,125611100.0,-43.77927062308481,73.63263747053657,76.71321854558761,99.72170719419528,34.236175507587426,7.312475580316174,0.2662548112256484,2.44274393502507,165.9392759399414,164.6953553161621,163.68999481201172,162.68463430786133,161.44071368408203,0.06,0.0,156.42146737766117,0.013453456333914371,0.01696807176933787,161.10172162737166,159.73243059430803,4.175984095057128
2024-01-25,1,164.38500213623047,154.40500259399414,166.0,159.84687519073486,163.6568775177002,-0.6883070339733708,3.6602031409045934,-0.7299921367704911,2.9954724592607422,161.89499855041504,2.927399597167965,0.022733898638130034,154.76125106811523,164.87249832153321,0.8208286138650893,0.07394708111368725,1.021012176736795,1.0042029016824996,0.9987393218490479,0.012971404415754062,81.80372264362087,168.32240594611585,161.00199966430665,153.68159338249745,164.20178604125977,1.5651436214004784,163.33464241027832,1.5458725585556934,164.31660226214532,162.4623525384306,2.0549330017361527,3.3237894669859274,4465800,1.0951641899027167,0.853603991054533,121145300.0,-34.51643448524454,73.63263747053657,76.71321854558761,75.99456272058332,32.04407978704129,9.583790161567517,0.30237927801822967,2.409529298568681,166.02187738037108,164.82905764770507,163.86499786376953,162.900938079834,161.70811834716798,0.06,0.0,156.59800258026212,0.011206404573476991,0.019069438416179675,161.6136256626674,160.09693581717355,3.9394797336457947
2024-01-26,1,164.75749969482422,154.40500259399414,166.0,160.81937313079834,164.0431261062622,-0.8990550544474832,3.4146676933864097,-0.19201509813280015,2.99550726645971,162.0387477874756,2.5786496734619164,0.021144402444712482,155.016499710083,164.87249832153321,0.8052165947255655,0.06463520853970386,1.020216077271369,1.0059530169695585,0.9984486086382786,0.004389224390518809,69.1094318571663,168.32208517314973,161.49274978637695,154.66341439960416,164.58642905099052,1.2520218867160264,163.54749952043807,1.5199165545289324,164.32871957084714,162.80876339060885,1.6636274754836193,2.183408992178652,4654300,1.1921502777810888,0.8819898257452798,125799600.0,-43.45169947836221,73.63263747053657,76.71321854558761,74.64778899876968,31.706896569600254,8.865995218870452,0.25892257747410014,2.405747852462533,166.02187738037108,164.82905764770507,163.86499786376953,162.900938079834,161.70811834716798,0.06,0.0,156.77560447110469,-0.002245528257574736,0.006736025687736687,161.9446084158761,160.36301749093192,3.585453307387895
2024-01-29,1,165.04999923706055,154.78250122070312,166.0,161.373122215271,164.14124870300293,-1.073705119806778,3.068084345447323,0.5014585588794453,2.995551703871035,162.17250061035156,2.2305500793457043,0.018937579474388535,157.17100105285644,164.87249832153321,0.7660831925765057,0.06266023949092328,1.0187619132562946,1.007309935196389,0.9993491033833625,0.0017601415299932643,69.80343638131,168.1465433323131,162.01037464141845,155.87420595052382,164.98214285714286,0.7308124736801316,163.79821395874023,1.4512417374096938,164.438211844813,163.1882544326044,1.661371110931228,1.8420358451735281,4704100,1.1923057773582617,0.874012251518434,130503700.0,-56.82127903408225,73.63263747053657,76.71321854558761,75.65310813191168,31.470097906866602,8.021596698044293,0.23154419260268194,2.4569741661153612,166.27203680419922,165.2339767150879,164.3949966430664,163.55601657104492,162.5179564819336,0.06,0.0,156.95158089143317,-0.008948535559623938,-0.005219379290899814,162.03015790666853,160.64405604771204,3.0599406031361687
2024-01-30,1,164.34499740600586,154.78250122070312,166.0,161.65624904632568,164.4781265258789,-1.2232556755094819,2.682753835083581,1.4992955932857415,2.9955950681202097,162.46875,2.001500129699707,0.01650816232929205,160.33474998474122,165.1334991455078,0.6590003586427914,0.06633500515485971,1.0112869319972106,1.0015448534160007,0.9947311089300519,-0.009283545414651484,71.24929641911797,167.87625729632686,162.51074962615968,157.1452419559925,165.02607073102678,0.6713943384195871,163.9648211342948,1.3615858719938643,164.59614348242343,163.52252898786242,1.7069242043313362,2.172837810588541,3819600,1.1798117012311262,0.7089613185834137,126684100.0,-43.597123881662,73.63263747053657,76.71321854558761,54.04838306238556,29.765226501804644,8.909886878459666,0.250509564041165,2.401236189060294,166.30979766845704,165.29509811401368,164.4749984741211,163.6548988342285,162.64019927978515,0.06,0.0,157.08192495569952,-0.015403025449130414,-0.0028417551463171694,162.0511954171317,160.93479374476843,2.3840143080082146
2024-01-31,1,164.98999786376953,157.40750122070312,166.0,161.75687503814697,164.4781265258789,-0.7443734512247998,2.0372768298619337,0.5735281862694461,2.995653905343798,163.09375,1.6921253204345703,0.01249948401029722,160.8512477874756,165.1334991455078,0.6470732366411501,0.044073478909849285,1.0122776688609967,1.0038544140428152,1.000500269357658,-0.0060843502182558185,63.24927843628211,167.0634280951487,162.9888744354248,158.9143207757009,165.05892780848913,0.6617617594792101,164.06910651070731,1.3814867447224866,164.54127532846869,163.7434517576657,0.18745415706592386,1.4397040362317428,4993900,1.1018874527511398,0.9540721777506066,131678000.0,-51.079203029804056,73.63263747053657,76.71321854558761,62.42666679079993,30.757492821408913,8.36776945338495,0.16480516699197112,2.3642392733665476,166.30979766845704,165.29509811401368,164.4749984741211,163.6548988342285,162.64019927978515,0.06,0.0,157.2534453948686,0.001096095728028157,-0.018507496812108032,161.91235133579798,161.0098604474749,2.184781116148037
2024-02-01,1,165.40999603271484,160.6599998474121,166.0,161.9537477493286,164.75812435150146,-0.06212635936890894,1.6276976512269974,-1.2988553237671172,2.995682627432781,163.78375244140625,1.4752003479003917,0.00996338119169235,161.47324714660644,165.1334991455078,0.7602902284477553,0.026951313459914514,1.0124993681399757,1.0046219305754984,1.0042773117368244,0.006235324896823213,62.541643062544615,166.62339457003208,163.3679992675781,160.11260396512415,164.99107033865792,0.5825512437990584,164.16553497314453,1.4271622352939533,164.65853831803378,163.9522198105151,0.13959671314603825,0.8927996371407205,5584400,0.8721587169251264,1.0640093741961913,137262400.0,-5.179867171634008,73.63263747053657,76.71321854558761,112.67946851050533,31.57438103164994,7.140505766952414,0.23336572638584374,2.5627315969180473,166.30979766845704,165.29509811401368,164.4749984741211,163.6548988342285,162.64019927978515,0.02,1.0,157.46675820057442,0.014897265044663932,0.020521247892824345,161.9249725341797,161.38572147914343,2.1989455311308004
2024-02-02,0,169.04249954223633,160.87249755859375,166.0,162.05187320709229,164.81749820709229,-0.15725765611489462,1.5603903296513264,-1.3365056711417982,2.9956867675451617,164.04874992370605,1.4019499015808095,0.00953751761680353,161.67949943542482,165.45749626159667,0.7299994395593487,0.028205557463098527,1.033232382139181,1.0247360024339027,1.0250560245969715,0.0260079198540224,64.34793040370205,166.72627973614593,163.60549907684327,160.48471841754062,165.42571313040597,1.6385936421747662,164.62160655430384,1.86210973568111,164.84966088589886,164.12190128969425,-0.2863443310875329,0.8228687639952842,7870400,0.8731960742550822,1.5061928747492996,145132800.0,-35.274310393225875,73.63263747053657,76.71321854558761,231.07152635499057,38.60052921911434,5.757394387627521,0.1936300847794011,2.9407846351084554,170.05340466308593,168.32330377197266,166.9250030517578,165.52670233154296,163.7966014404297,0.02,1.0,157.84807588600893,0.025973257356533885,0.021437596618748535,162.549072265625,161.82539694649833,2.3303495359944595
2024-02-05,0,170.6699981689453,161.53999710083008,169.04249954223633,162.22625160217285,165.00499820709229,0.6875254921214786,1.8364447957763608,0.5521871078667719,2.9956697447730627,164.2024974822998,1.4554498291015647,0.011196878345765023,161.7692501068115,165.8964984893799,0.5683182438549459,0.044907353512052786,1.0405818956086577,1.0314723840711448,1.0295745559971239,0.034050281477510325,75.93255710474507,167.68688876757813,164.01399917602538,160.34110958447263,166.3235697065081,2.4794608257426463,165.26267787388392,2.2759830332512214,165.9045522804883,164.81077646913667,1.8328310495399567,3.925427501379173,6486700,1.150943049326919,1.2310328761897893,151619500.0,-15.416402499773572,73.63263747053657,76.71321854558761,267.5111386124239,34.8962572379584,5.103547512480469,0.1903055790839234,3.0703680018186454,170.26732373046875,168.4963430175781,167.06500244140625,165.6336618652344,163.86268115234375,0.04,0.0,158.19800219098926,0.04484171709936269,0.04172752046275861,163.4087851388114,162.51120540073939,2.719559760793871
2024-02-06,0,172.16749954223633,161.53999710083008,170.6699981689453,162.56312370300293,165.13999843597412,1.0827951986903452,2.2671254753768006,1.1149879999267496,2.995637715736263,164.36499977111816,1.643737049102782,0.013785385157530486,161.9807472229004,166.30424995422365,0.6223702528623851,0.05651851697395084,1.046874254899464,1.0368194632729972,1.03161336442518,0.047598054456780226,79.78337672109949,168.99287502759682,164.45862407684325,159.92437312608968,167.38214111328125,3.1817522059160432,165.98428508213587,2.7386500914099323,167.09928006779415,165.6018128572818,3.823339082665395,5.550572677609139,7037400,1.1732046094250272,1.3225448473578327,158656900.0,-5.169854017262673,73.63263747053657,76.71321854558761,247.48032637102708,33.407295062609755,4.599874767726119,0.2275855289227151,3.153532028129131,170.90144512939452,169.00928414916993,167.4800033569336,165.95072256469726,164.05856158447267,0.06,0.0,158.596332332692,0.05075188111645579,0.0572265307558371,164.65558079310827,163.3000946044922,3.154411424396843
2024-02-07,0,174.4749984741211,161.69499969482422,172.16749954223633,163.31187629699707,165.52874660491943,1.232000180214058,2.7208302550028014,0.946729643860329,2.9955971960221954,164.57125091552734,1.929499645233156,0.01649087986067896,162.05974845886232,169.20524940490722,0.6861363569179617,0.06268036593027969,1.0574883285123986,1.0467552660098176,1.0357304002670378,0.057488337069882434,82.13287604010867,170.4316597089192,164.98999919891358,159.54833868890796,168.72856957571847,3.9353300407606624,166.85535621643066,3.3426204881361206,168.37020397123663,166.49858689786717,4.497518996790706,6.233610589043259,6409100,1.1949598003989825,1.18273954300351,165066000.0,-4.2438535061094065,73.63263747053657,76.71321854558761,237.6515926175515,35.425948250081895,4.349433406304713,0.24873203728726903,3.0880919522702204,172.50143957519532,170.6092808227539,169.0800018310547,167.55072283935547,165.65856408691405,0.08,0.0,158.9973376349077,0.06453776704448333,0.06118123935039281,166.21232386997767,164.12124088832311,3.679758517587326
2024-02-08,0,174.8375015258789,161.69499969482422,174.4749984741211,163.9106273651123,165.9137487411499,1.2996468889086905,3.327103394204781,0.850328385250283,2.995532182621821,164.7587490081787,2.456124839782717,0.020089611911891528,162.2585021972656,170.81974830627442,0.7324835835774677,0.06692958910604777,1.0556983469217256,1.0436237419315422,1.0263247680828047,0.056994774918557534,84.79863731940772,172.26733106361712,165.61312427520753,158.95891748679793,170.22749873570032,3.9853222244544764,167.62678473336356,3.850008671815002,169.89482231531102,167.6018152276523,5.7103903548181565,7.514786594277687,5709100,1.2412868796127976,1.0623913715010924,170775100.0,-8.459289360225977,73.63263747053657,76.71321854558761,189.71396313395607,34.87951162060479,4.175780614002437,0.17583257331946697,2.978902519606667,172.78536236572265,170.8523215637207,169.29000091552734,167.727680267334,165.79463946533204,0.1,0.0,159.34608490684514,0.04296200585689558,0.06319951927076795,167.5965619768415,164.8238786969866,4.128169385516559
2024-02-09,0,174.4000015258789,161.69499969482422,174.8375015258789,164.0543737411499,166.76062488555908,1.095594499638797,3.845446027665798,0.03434644651133967,2.9954667251355773,164.87499809265137,3.030000114440918,0.02314045466575796,162.2585021972656,172.39824943542482,0.8057528436113149,0.06569245475842451,1.0494739231764498,1.0345574379300464,1.0125494711234069,0.03169322506559347,85.08680125008605,173.86939127713336,166.17849922180176,158.48760716647016,171.57178497314453,3.479113515674261,168.31535639081682,4.1483410627970345,171.12364068882093,168.55284175373075,6.384437789701535,6.583859840809543,3502700,1.242177095011343,0.658478995672428,167272400.0,-13.821760361047694,73.63263747053657,76.71321854558761,139.37292047388834,32.81978478584902,7.070299280500201,0.1873882297298298,2.93255685030299,172.78536236572265,170.8523215637207,169.29000091552734,167.727680267334,165.79463946533204,0.1,0.0,159.5417636746545,0.032074393728707795,0.0387254203661784,168.9541516985212,165.4332515171596,4.344380019155154
2024-02-12,0,173.39999771118164,161.69499969482422,174.8375015258789,164.26812362670898,169.44937419891357,0.8479032091299237,4.204214372332662,-0.656264119610463,2.9954164158543195,165.01999855041504,3.541950225830078,0.02522092310204301,162.2585021972656,174.40750122070312,0.845378927032403,0.07219159465218401,1.0402200318205144,1.0227750222508025,1.0005192883494822,0.01599577882185188,84.388238114129,175.1039281648313,166.69549942016602,158.28707067550073,172.71321378435408,2.193934284999944,168.852142061506,4.293344845195537,171.93226074202371,169.2975641307663,5.70337825561954,5.850936697348709,3477100,1.1787079189356078,0.6629765781706415,163795300.0,-21.45011449849429,73.63263747053657,76.71321854558761,105.4207515775046,30.716718894797935,8.69413522926808,0.20769423949826052,2.9029585877657293,172.78536236572265,170.8523215637207,169.29000091552734,167.727680267334,165.79463946533204,0.1,0.0,159.72032664021526,0.010568739644240654,0.026086459718447953,169.7227063860212,165.82383946010046,4.411234678025317
2024-02-13,0,173.72999954223633,161.69499969482422,174.8375015258789,164.37500095367432,171.04437351226807,0.6233454071746853,4.3381052384543715,-1.085704627182739,2.995397560070921,165.2299976348877,3.83641254425049,0.02594054391659378,162.2585021972656,174.40750122070312,0.8639282032397078,0.07238936292679986,1.038852318013585,1.0196993421051452,0.9992752610562765,0.00907546432488382,78.75028490276964,175.9088349123336,167.2326244354248,158.55641395851603,173.38285664149694,1.4888947365231786,169.40428488595145,4.39420286776588,172.29474050378315,169.7622665695002,4.83042250777065,4.530246535664539,5480400,1.1813815749592615,1.0376961040952868,169275700.0,-19.788589795746674,73.63263747053657,76.71321854558761,93.86709879203326,29.33262281055525,7.990187457016035,0.20941813224577965,2.9269538249449822,172.78536236572265,170.8523215637207,169.29000091552734,167.727680267334,165.79463946533204,0.1,0.0,159.99524334634367,0.0,0.011853291703222189,170.37064688546317,166.45985957554407,4.360524587799322
2024-02-14,0,173.75499725341797,162.06499862670898,174.8375015258789,164.66437530517578,172.47562408447266,0.4637803997710638,4.362864171863749,-1.3829886133646916,2.9953956990641797,165.64749717712402,4.004750061035156,0.025995057250567652,163.86175231933595,174.40750122070312,0.8663687954992412,0.07197729932047711,1.0352765805324922,1.014259040289635,0.9976258479402358,-0.004126672743945736,79.21864533088572,176.5601027715229,167.8343744277954,159.1086460840679,173.8235707964216,0.8869545269411057,170.07357025146484,4.283075307227613,172.6593142742052,170.22121701835826,2.772971301710313,4.656626230262848,4348500,1.181853684908125,0.8239564118815709,173624200.0,-11.253813255087893,73.63263747053657,76.71321854558761,90.5336634295709,27.70231034923567,7.546091398385877,0.24556262760789785,2.8722554924479815,172.78536236572265,170.8523215637207,169.29000091552734,167.727680267334,165.79463946533204,0.1,0.0,160.2134882097061,-0.0033712564155782276,0.006520896413152688,170.81382751464844,167.1113063267299,4.341617698308438
2024-02-15,0,175.29000091552734,162.28000259399414,174.8375015258789,164.75937366485596,173.4824981689453,0.311583565664311,4.333745203384398,-1.5995303105861465,2.995402041103676,165.9424991607666,4.070762405395508,0.025731944949016,164.31424789428712,174.40750122070312,0.8671356860433371,0.0707110825486794,1.0407978415871888,1.0180107701744752,1.0072719726668335,0.002588114024161259,79.16165048341293,177.08636476589967,168.41887435913085,159.75138395236203,174.26964242117745,0.6751686248095738,170.82589176722936,4.2017236258342345,172.93907252554672,170.60804579345114,1.807581366127884,5.700030413615424,5276200,1.1859837194393104,0.9978289155168241,178900400.0,-1.0661625954893872,73.63263747053657,76.71321854558761,105.73192442147105,30.41716179180991,6.9842243805219715,0.25488202018061146,2.8764770620164506,173.41948376464845,171.3652626953125,169.7050018310547,168.04474096679687,165.99051989746093,0.12000000000000001,0.0,160.5013928141496,0.01029803102365312,0.009027968905932266,171.27664184570312,167.96611131940568,4.4855402868762075
2024-02-16,0,177.34250259399414,164.03750228881836,175.29000091552734,164.93249797821045,173.73624897003174,0.19718210056022917,4.339876614294782,-1.7469565466008112,2.9954033302774143,167.52124977111816,4.110062618255614,0.02566920610488819,164.381001663208,174.51124877929686,0.8713290862157609,0.06859711023212776,1.0489333349357512,1.0240549218516688,1.0185366178425728,0.016872139004417308,81.36561249632015,177.74912750379707,169.0693742752075,160.38962104661795,174.6792858668736,1.3515892063637118,171.70392772129603,4.186243779857949,173.53345241058489,171.12169683748027,1.8136415883329944,6.392729460092673,6689400,1.1755887103182234,1.255282416963783,185589800.0,-8.799954927884615,73.63263747053657,76.71321854558761,118.72703361732377,33.75073675541706,6.47889799820832,0.20252159440844017,2.874544207110398,175.0849981689453,172.7124981689453,170.7949981689453,168.87749816894532,166.50499816894532,0.14,0.0,160.89234286142968,0.019588732597081382,0.01544709099675237,171.62445286342077,168.91838836669922,4.693195657845594
2024-02-20,0,176.44499969482422,164.34499740600586,177.34250259399414,165.0349988937378,173.9162483215332,0.10195793568298224,4.533014148343901,-1.6579486554032463,2.9953759226474994,169.85624885559082,4.2721254348754885,0.026706478818290892,164.72024993896486,174.88275146484375,0.8549268437581525,0.07636868415054163,1.039534511195986,1.0140123872972229,1.0099683182964705,0.01756056530470307,84.38460013183183,178.80065258715408,169.73462429046631,160.66859599377855,174.90892846243722,1.5102054701339265,172.56821359906877,3.779360220285827,174.49054277070996,171.82703841518705,1.6435043100449533,7.447745176464938,5484100,1.2200188272523962,1.0231520306417625,180105700.0,-19.50768103966346,73.63263747053657,76.71321854558761,95.81373060507144,31.06677303452363,7.347793456885495,0.11548791666742059,2.895342565956199,175.0849981689453,172.7124981689453,170.7949981689453,168.87749816894532,166.50499816894532,0.14,0.0,161.1840670834194,0.0154850257025545,0.009593340607698475,171.75908987862724,169.67782592773438,4.731113664647443
2024-02-21,0,175.38999938964844,164.34499740600586,177.34250259399414,165.31999683380127,174.41875076293945,-0.06786365545968447,4.606623584924521,-1.6469055671630124,2.995366217850834,171.41874885559082,4.300487899780274,0.027047052784127085,164.72024993896486,175.40550079345704,0.8900361521836375,0.06365856756270795,1.0297742986477512,1.0046152474365937,1.0004420642546792,0.009555055844045812,77.3476874647816,179.53212152897993,170.31887435913086,161.1056271892818,175.05035672869002,1.5009292844168793,173.31107085091728,3.1439041448402976,174.9801518441605,172.35186148068,0.9194241252111325,7.362561976210281,3819100,1.2624917227055417,0.7258266062935634,176286600.0,-23.26153094951923,73.63263747053657,76.71321854558761,66.12810961687686,28.637518738018798,11.8196638992971,0.06536498933711565,2.9124163045451628,175.0849981689453,172.7124981689453,170.7949981689453,168.87749816894532,166.50499816894532,0.14,0.0,161.36106712288233,0.01067580068729379,0.011960488833488398,171.90775408063615,170.4309528895787,4.783252009197694
2024-02-22,0,175.50249862670898,164.34499740600586,177.34250259399414,165.31999683380127,174.56562423706055,-0.2668464013630394,4.614972465555849,-1.580197450643265,2.995366274187154,172.78374862670898,4.249712963104247,0.027020674636375842,164.72024993896486,175.49549942016603,0.9044997566836559,0.05656626138342432,1.0275675420941282,1.0034075278191836,0.9991915411937288,0.01005727260173317,70.25062630684818,180.0240693436483,170.79412441253663,161.56417948142496,175.3507140023368,1.3144059664202226,174.03196389334542,2.21174296128386,175.07891651758328,172.69712683624024,0.567659320589299,6.3034133344653265,4852300,1.3101250248851648,0.927209390758671,181138900.0,-15.850969919348007,73.63263747053657,76.71321854558761,70.5325523456712,27.446334944640004,10.619676302053012,0.14660010896732095,3.005974622301052,175.68915759277343,173.69041723632813,172.0749969482422,170.45957666015624,168.46083630371095,0.02,1.0,161.58995348736042,0.01335856724200113,0.019966573488367004,172.42386300223214,171.07328469412667,4.689415835927674
2024-02-23,0,177.81749725341797,164.34499740600586,177.34250259399414,165.31999683380127,174.95062637329102,-0.4726248856559254,4.586009714376137,-1.4168035814505389,2.9953721991381164,173.56499862670898,4.150400466918944,0.02677660894728632,164.72024993896486,175.5967487335205,0.8811657178719126,0.06763084433496636,1.0382336463470943,1.016046279710627,1.0103611316678283,0.01441894189451598,73.21888845729788,180.44126877262437,171.26924934387208,162.09722991511978,175.9346422467913,1.3806687480650086,174.65874944414412,1.9120861861776315,175.17107525011184,173.02954770948168,1.2125149615222657,6.101507064904374,3941800,1.2172445594147725,0.7570150354424692,185080700.0,-7.927428216660205,73.63263747053657,76.71321854558761,100.89903284812715,29.85467213079118,10.054329500001668,0.11304836880722065,2.944580324815425,176.44907788085936,174.92045770263672,173.68499755859375,172.44953741455078,170.92091723632814,0.02,1.0,161.79944135327943,0.008494262799154884,0.02104110903491973,173.09704807826452,171.73384748186385,4.659671847489115
2024-02-26,0,178.8599967956543,164.34499740600586,177.81749725341797,168.13437366485596,175.31500053405762,-0.6157666840383813,4.511622750310211,-1.1257385391117476,2.9953860915302264,173.74249839782715,3.9321130752563476,0.02623938475323395,164.966748046875,176.5347499847412,0.8452286408735664,0.07926800044176699,1.040241290688737,1.0202658324518983,1.013373960212158,0.008556855685826648,78.20156855292095,180.96411960035186,171.94087409973145,162.91762859911103,176.6639278956822,1.3857201008241662,175.24374934605189,1.849701655023349,175.82286390060554,173.7057356547544,2.3527874989649726,5.191000922811812,4327400,1.2752839568381449,0.8336857274136266,189408100.0,-9.780407206054791,73.63263747053657,76.71321854558761,111.12862074869793,30.730342395225964,9.598313391200534,0.12008415922625733,2.8608847101734116,177.42527587890626,175.96235748291016,174.77999877929688,173.5976400756836,172.1347216796875,0.04,0.0,162.0352790363563,0.007437044286523031,0.012571523025333426,173.71273149762834,172.2632795061384,4.516161578466897
2024-02-27,0,178.56750106811523,164.34499740600586,178.8599967956543,170.26312351226807,175.41812419891357,-0.726844159285686,4.4352235943554525,-0.731191663734891,2.9954001554609064,174.07749938964844,3.6847004890441895,0.025689698117575963,165.04399909973145,177.39000205993653,0.8256437907374081,0.0836716002570743,1.0342985192196288,1.0160125181572706,1.0099800497305536,0.012029252044331473,79.95507977138305,181.51644614348385,172.64599895477295,163.77555176606205,177.13214220319475,1.3977758641655156,175.7008923121861,1.821589494779635,176.5725869387578,174.41703854117526,2.9380447313355798,4.798733646555588,3888500,1.2740574607418325,0.755062472026183,185519600.0,-10.230033307901993,73.63263747053657,76.71321854558761,102.59505790470713,28.731152278678575,11.576130295071685,0.18164913410101238,2.8383728932926324,177.9444751586914,176.80275631713866,175.87999725341797,174.95723818969728,173.81551934814453,0.04,0.0,162.23720887672243,0.0184352749018859,0.008451190669678135,174.04932512555803,172.66298348563058,4.2015015370270845
2024-02-28,0,178.65750122070312,164.34499740600586,178.8599967956543,171.79312419891357,175.7381238937378,-0.8855318053775357,4.252369924040875,-0.22534837346908398,2.99542903669114,174.4375,3.3306255722045877,0.02453452541659165,165.3679962158203,177.8924976348877,0.7945981987539226,0.08654053294347264,1.0307844996699684,1.0135445731925394,1.0080687399250956,0.01862992098993943,79.10782887732974,181.82661389440744,173.3218740463257,164.81713419824393,177.31999914986747,1.514271068316721,175.99964250837053,1.9439382064613702,177.06117620631974,174.97431279403256,1.8697587628899184,3.717311073748185,4331300,1.252810370421134,0.8368869421059648,189850900.0,-23.86363417430088,73.63263747053657,76.71321854558761,95.76895945492605,27.45712132690933,10.694638931777039,0.13554515736694694,2.8500652593497247,178.02087982177736,176.86456008911134,175.93000030517578,174.99544052124023,173.8391207885742,0.06,0.0,162.45314620041208,0.01632976019991017,0.012802291433469818,174.12085178920202,172.8726523263114,3.7884551321704745
2024-02-29,0,176.83250045776367,164.98999786376953,178.8599967956543,173.0918731689453,176.6693754196167,-0.9815383675582146,3.8684312988206018,0.3021671442171634,2.9954833756578503,174.65625,2.913500823974607,0.022227573458472424,168.67924919128419,178.576501083374,0.7606690568729471,0.08283837525847297,1.0160597643206535,1.0003946022381254,0.9941056181318276,0.007578250118726704,78.9723350819946,181.77436183470175,174.03749923706056,166.30063663941937,177.37535640171595,1.483727353727642,176.14214243207658,1.9252260259335956,177.45958503841155,175.56377580361712,0.7415022385916854,2.397193169886973,7485700,1.261325521015885,1.4123749075485652,182365200.0,-48.48481345548074,73.63263747053657,76.71321854558761,49.50549114960893,25.615590431978802,13.802596796787556,0.122096470651242,2.8341602581083127,178.02087982177736,176.86456008911134,175.93000030517578,174.99544052124023,173.8391207885742,0.06,0.0,162.77257266870504,-0.003960394820682556,0.00519583279088051,174.16292681012834,172.9610083443778,3.036872359174493
2024-03-01,0,177.47500228881836,165.40999603271484,178.8599967956543,173.64749908447266,176.9600009918213,-1.062290867367764,3.3033144083896118,0.9904082117832709,2.9955521217682826,175.06375122070312,2.4616631507873534,0.018916117012609108,170.50724830627442,178.576501083374,0.695130726228583,0.06905570823416066,1.0162937871072906,1.0022844148948342,0.996227850748371,-0.0019261038418030285,66.17049382152193,181.2362531835395,174.62962436676025,168.022995549981,177.67321395874023,1.2011060270096316,176.36178534371513,1.8861947163111386,177.3099686437078,175.88829497302913,0.21961561030897264,1.1410589344240154,4028700,1.3831069095212183,0.771442440536201,186393900.0,-12.373686289242745,73.63263747053657,76.71321854558761,85.30060025775771,26.340319908814955,12.611172751592157,0.10466201991757172,2.877910821459646,178.02087982177736,176.86456008911134,175.93000030517578,174.99544052124023,173.8391207885742,0.06,0.0,162.9562464369255,0.004604444784234385,0.012220619238072692,174.69165693010603,173.2997055053711,2.6556779303723546
2024-03-04,0,177.91500091552734,169.04249954223633,178.8599967956543,173.74874782562256,177.3756275177002,-0.5938145014914636,2.5889585909869255,-0.16766272369475876,2.9956228017037345,175.3400001525879,2.0618378829956043,0.01477438862839607,172.01774940490722,178.576501083374,0.7248150871079184,0.04988392131811277,1.015306067659202,1.0035309634369758,0.9990818686683268,-0.0052834389861171616,65.36730293310974,180.41079186153928,175.23287467956544,170.0549574975916,178.01785714285714,0.7269728947219177,176.68428557259696,1.7194520519722125,177.36748594743648,176.28151989729324,1.188780948985498,1.7631884954331032,4723600,1.1851935102703195,0.9326045344924091,191117500.0,-36.5792095522752,73.63263747053657,76.71321854558761,73.78976168386598,25.886826159438087,11.4648636234059,0.08823663792443762,2.9372307048844655,178.08963702392577,176.92017782592774,175.9749984741211,175.02981912231445,173.8603599243164,0.08,0.0,163.16350058075437,-0.009842770359783759,-0.005839645266270666,174.73373195103235,173.57879747663225,2.1670183552753968
2024-03-05,0,178.5824966430664,170.6699981689453,178.8599967956543,174.23875045776367,177.56062602996826,-0.37717641691475895,2.2247598127744097,-0.6366863040533564,2.995651952854282,175.4462490081787,1.8824004554748541,0.01266395799075468,173.2767478942871,178.576501083374,0.7067804744554623,0.04245035931511666,1.0165417508830215,1.0069708092138612,1.0038956512230588,8.39770667198092e-05,65.51735712104217,180.1260193737788,175.67649974823,171.22698012268117,178.12714276994978,0.7490001980239412,177.03089250837053,1.5597877033875958,177.5142345596892,176.55103544788696,1.3746256080089851,2.6038081106932762,5309800,1.1519704076937427,1.0606638687523846,196427300.0,-11.232763323739112,73.63263747053657,76.71321854558761,103.0714167516858,24.256796147903863,10.742949253942532,0.10395667357483937,2.90858783310245,178.2571950073242,177.19139456176757,176.32999420166016,175.46859384155275,174.4027933959961,0.08,0.0,163.4063292191757,0.0009498119306381447,0.0019574278777053926,174.88379778180803,173.99042293003626,2.00787283004949
2024-03-06,0,179.93000030517578,172.16749954223633,178.8599967956543,174.45624923706055,177.8418731689453,-0.1795778491827361,1.9904836444315634,-1.1815445083366307,2.9956683270668507,175.9737491607666,1.7773752212524414,0.011304933408058231,173.69699935913087,178.5899971008301,0.6988445370612664,0.037260209493002155,1.0219107688989832,1.0133476055776176,1.0114535463637009,0.007122561749594247,66.63685078108948,180.0530919607991,176.07212467193602,172.09115738307295,178.28000041416712,0.9929476180711848,177.47196415492468,1.4298441918310747,177.78955998237623,176.8324202426669,0.43021603692812793,2.793125605028488,6047100,1.1242178833406653,1.220010914750953,202474400.0,-12.19518384125426,73.63263747053657,76.71321854558761,148.76282483890395,28.074963018277924,9.692379068855532,0.08465453758420476,2.991554292574845,180.03128265380857,178.7143620300293,177.6500015258789,176.5856410217285,175.2687203979492,0.1,0.0,163.70148560635573,0.017191003808939564,0.011564902425884625,175.19935389927454,174.45604269845145,2.1490066453805925
2024-03-07,0,181.18000030517578,173.39999771118164,179.93000030517578,174.74687576293945,178.07812595367432,-0.005961437614565851,1.9476240508414595,-1.2892119532821453,2.995671360400204,176.63875007629395,1.737750244140625,0.011037182901199144,173.75249748229982,178.67775077819823,0.7452641548614105,0.031265235012246165,1.0267468203340249,1.017785122268758,1.0170252666675677,0.02458541182281415,69.4168904531866,180.35549781176596,176.46024971008302,172.56500160840008,178.65321459089006,1.4870547413864792,177.8926783970424,1.5953892520459327,178.3265579125605,177.2513533161125,0.5982352279386164,3.55385637786964,6125200,1.053925251850958,1.2393169310456458,208599600.0,-19.935248793930686,73.63263747053657,76.71321854558761,143.40542403085664,26.75092749467388,9.018635667139867,0.034257587011400775,2.9835214851375875,180.22991845703126,178.8750386352539,177.77999877929688,176.68495892333985,175.3300791015625,0.12000000000000001,0.0,163.99716303578958,0.025674574366001846,0.014438274197017202,175.4209463936942,174.7351357596261,2.279687149014308
2024-03-08,0,179.85250091552734,173.39999771118164,181.18000030517578,175.17687606811523,178.57124996185303,0.09558980568104475,2.144198680166904,-0.9054747224366109,2.9956587524512654,177.0875015258789,1.8409502029418945,0.012128129293860371,173.75249748229982,178.96699714660645,0.7435651899922765,0.036276535205223566,1.0172911704049117,1.0071157953830105,1.0046699651906226,0.01339624508267323,73.00903838386598,181.08389716196956,176.79549980163574,172.50710244130192,178.8239288330078,1.5546841409813745,178.07196399143763,1.6681789610867392,179.03139983060294,177.73471964164656,1.4630317507013773,3.3601456779538963,6195600,1.07567448272528,1.2474215906860153,202404000.0,-38.469747144731606,73.63263747053657,76.71321854558761,98.62795237371367,24.5435812250916,10.325407432440501,0.0003384854269607502,3.0178137808724657,180.22991845703126,178.8750386352539,177.77999877929688,176.68495892333985,175.3300791015625,0.12000000000000001,0.0,164.26969234474623,-0.0003353367532469287,0.01590456765007691,175.5401567731585,174.83050428118025,2.262958067604083
2024-03-11,0,179.38500213623047,173.39999771118164,181.18000030517578,175.36499977111816,178.6012477874756,-0.08419058565424825,2.1932367316268992,-0.9697479351857496,2.995655512476494,177.40875244140625,1.867125282287597,0.012387931031932456,173.75249748229982,179.8602508544922,0.7892527894369281,0.03126433108912187,1.0132098384921215,1.0033545946568334,0.9994038860741804,0.00826237929988305,64.442487854072,181.432723234372,177.04624977111817,172.65977630786435,179.18857192993164,1.28585385575993,178.2819641658238,1.6322784670655648,179.2316436492089,178.03041843410406,0.6688774256100142,1.4153394052860324,5134800,1.1264239364925803,1.017128436532477,197269200.0,-30.06458677944141,73.63263747053657,76.71321854558761,85.71347173258695,22.776971163767843,10.630866719802441,0.0005726110037868083,3.0179702461955626,180.22991845703126,178.8750386352539,177.77999877929688,176.68495892333985,175.3300791015625,0.12000000000000001,0.0,164.48605348463306,0.014572192372533488,0.004024475412996315,176.04224286760603,175.1025848388672,2.213939416464853
2024-03-12,0,180.80500030517578,173.39999771118164,181.18000030517578,175.47437381744385,178.70812511444092,-0.2803516443951556,2.161369571762025,-0.8417898747478674,2.995657877414941,177.64624977111816,1.8019004821777345,0.012190775141953625,173.75249748229982,179.8602508544922,0.762218563403016,0.0345155969091624,1.019794639499968,1.0110001924799636,1.0056678509104973,0.012445249136322056,62.98898300563295,181.6182389451598,177.29549980163574,172.9727606581117,179.66428593226843,1.1556321447192386,178.66874994550432,1.5328238060558776,179.27048598736798,178.22879681281347,1.4434573236589279,1.6662429915788037,5391100,1.1003774511184023,1.0480304352812873,202660300.0,-20.205140725160255,73.63263747053657,76.71321854558761,131.7965444558855,24.879005609234863,9.810008171756328,-0.00020144779308206234,3.0353704118093776,180.58899938964845,179.16549938964843,178.01499938964844,176.86449938964844,175.44099938964843,0.14,0.0,164.72790357677397,0.009823628239400417,0.021858200771335778,176.32414027622767,175.50789860316686,2.1061427447541523
2024-03-13,0,181.0724983215332,173.72999954223633,181.18000030517578,176.2093744277954,178.99124813079834,-0.2871240598625301,2.095594457326342,-0.7468848183117669,2.9956626285743417,177.86624908447266,1.7229248619079585,0.011795151615526632,175.1365005493164,180.0175003051758,0.7031573263131127,0.04072411662684323,1.0191750429754434,1.0112307657762698,1.0046717815484578,0.0063496805114191535,67.70301116603348,181.8569388459881,177.66574993133545,173.4745610166828,180.11535699026925,0.9584468591922014,179.0666070665632,1.3610213773248456,179.6585648202585,178.6211937247036,1.8763194666357952,3.087405743982766,5987900,1.1277374740141541,1.1583344698277656,208648200.0,-40.399983723958336,73.63263747053657,76.71321854558761,103.26087905579593,23.061355595850184,9.731688619414463,-0.031940202980446294,3.039295876495892,181.11999938964843,180.02499938964843,179.13999938964844,178.25499938964845,177.15999938964845,0.14,0.0,164.97940259191918,-0.006627696710788666,0.003907034171020106,176.71823120117188,175.72598157610213,1.8777223326963903
2024-03-14,0,180.51499938964844,173.75499725341797,181.18000030517578,176.7356252670288,179.5018768310547,-0.26147174958433056,2.0155707832294056,-0.6956930730382656,2.995668120773244,178.2412509918213,1.6563749313354492,0.011321340424895009,175.37999954223633,180.8317501068115,0.6651773116547097,0.042113902815945,1.0139419448298883,1.0067595027885512,1.0003103142142913,-0.0036703880914407128,68.54507075735403,182.06401643675912,178.0328748703003,174.0017333038415,180.39142881120955,0.6816971398045378,179.25928579057967,1.361524688060971,180.01126972780546,178.98766036105093,1.7747224178724619,3.173743814708598,6999400,1.12510305245601,1.3201557917370024,201648800.0,-22.533365885416668,73.63263747053657,76.71321854558761,96.73255000385191,21.233891219339675,10.742315672312166,-0.022397070694397947,3.0637678354847058,181.11999938964843,180.02499938964843,179.13999938964844,178.25499938964845,177.15999938964845,0.02,1.0,165.26413101185352,0.0034888385056490723,0.0007731897920405318,177.00433349609375,175.9440656389509,1.790720565433313
2024-03-15,0,178.95999908447266,175.29000091552734,181.18000030517578,177.21500205993652,179.87187576293945,-0.1455219642935661,1.8279269053301124,-1.0221300825840114,2.995679735901544,178.57499885559082,1.5327872657775885,0.010247900087750695,175.49124870300292,180.8317501068115,0.7088490271473902,0.02980773830127956,1.0033028043812446,0.9960413751921289,0.9924248243318647,-0.004962409899842757,63.274412361653745,182.02672878777202,178.3708749771118,174.7150211664516,180.25285720825195,0.8650555006171488,179.26642881120955,1.359529604825638,180.13715336988054,179.21441023610194,1.0821344660918997,1.5170060190342816,20957800,1.109461142355645,3.4435913066481763,180691000.0,-66.7999267578125,73.63263747053657,76.71321854558761,4.153644354090768,19.43767262848935,12.422231929587495,-0.19208441749700184,3.106578151214308,181.11999938964843,180.02499938964843,179.13999938964844,178.25499938964845,177.15999938964845,0.04,0.0,165.95635787150061,-0.005423501626016347,-0.014897285330386086,176.558349609375,175.87885175432478,1.744791468567608
2024-03-18,0,178.7375030517578,175.38999938964844,181.18000030517578,177.4418773651123,179.87187576293945,-0.20608415447572107,1.6883153338035084,-0.8173095145466593,2.995687540113306,178.61999893188477,1.3714997863769554,0.009455468872636702,176.3507495880127,180.8317501068115,0.7836934822346476,0.009120749210253298,1.0010256156776673,0.9939814910130522,0.9921730981731715,-0.0036095497213358696,51.43284465421764,181.9310055531661,178.55437488555907,175.17774421795204,179.90392902919226,0.9196352441162827,179.27857181004114,1.3535528132750254,179.8426823668404,179.1492621620291,-0.5390992158383398,0.05591093067759079,8569000,1.097643738097141,1.3865673356515604,172122000.0,-58.66658528645833,73.63263747053657,76.71321854558761,0.43508690759588026,18.380832119256752,11.746826073691516,-0.2030793991334052,3.0494041772503713,181.11999938964843,180.02499938964843,179.13999938964844,178.25499938964845,177.15999938964845,0.04,0.0,166.21880542491274,-0.006346378715429868,-0.0020127823541879926,176.26663643973214,175.84379141671317,1.728932663139361
2024-03-19,0,178.99250030517578,175.38999938964844,181.18000030517578,177.73187351226807,179.87187576293945,-0.32106578688992654,1.6654695056868414,-0.6658109565808767,2.995688761355127,178.69750213623047,1.308962783813476,0.009323877760299555,176.3507495880127,180.8317501068115,0.7563373514026241,0.012992736325192905,1.0020622936398837,0.9949444712100524,0.9943033489697255,-0.010024612134292399,51.4162921702574,181.95506391982093,178.62412490844727,175.2931858970736,179.781071799142,0.9829186189255182,179.3025003160749,1.3446606675052233,179.56179091592415,179.0596030176997,-1.3481053368494744,0.09520320474089529,7625600,1.0759744046087223,1.2128991416530872,179747600.0,-43.066609700520836,73.63263747053657,76.71321854558761,26.070805326326923,17.725750201152813,11.250620501250525,-0.12053076510428724,2.955454450938506,181.11999938964843,180.02499938964843,179.13999938964844,178.25499938964845,177.15999938964845,0.04,0.0,166.4544791936456,-0.0069643504226496455,0.00016699630410355778,176.38023812430245,175.96019744873047,1.6161892094518666
2024-03-20,0,177.61249923706055,175.38999938964844,181.18000030517578,177.890625,179.87187576293945,-0.4807214998868264,1.5896288758030217,-0.2483647408339209,2.995692673447149,178.79874992370605,1.2037498474121093,0.008892954052669792,176.6995002746582,180.8317501068115,0.6776404470996876,0.020539944854689157,0.9936280215702066,0.9870486700255583,0.9886282312920562,-0.019108363316049704,54.43248354939415,181.9307576905709,178.75149993896486,175.5722421873588,179.52785709926061,1.284120065652223,179.3582145145961,1.2470644724477737,179.42367880886871,179.06545700514982,-0.4781699481373825,0.18750910663348963,7326600,1.0397937839449458,1.1337168818066186,172421000.0,-92.45798507367263,73.63263747053657,76.71321854558761,-102.96436229936243,16.074165560082275,16.03464117524744,-0.15786979209480206,3.025355694870799,181.20023852539063,180.15487799072267,179.30999755859375,178.46511712646483,177.41975659179687,0.06,0.0,166.63576355998754,-0.019959837323704988,-0.02570192896338514,175.9090074811663,175.97562517438615,1.5031121378569934
2024-03-21,0,176.98250198364258,175.50249862670898,181.18000030517578,177.890625,179.87187576293945,-0.2723269364850842,1.4193142821981362,-0.17429263842413922,2.995700766079016,178.79874992370605,1.0928876686096203,0.00793522002007409,177.4107521057129,180.8317501068115,0.5535970087636873,0.012022624332201106,0.9894884526691105,0.984815929348333,0.9889307136504606,-0.019568996581723508,46.17758229472685,181.70125349573172,178.86262493133546,176.0239963669392,178.98178591047014,1.4522492756446286,179.32303592136927,1.3096506772726657,178.97736836812663,178.89307837502037,-0.9880998288941841,0.44109469541950924,5743600,1.0974307348638044,0.8826767993053661,166677400.0,-75.27928258154711,73.63263747053657,76.71321854558761,-113.892390834931,15.345414535364402,15.307682059157242,-0.15085418727652547,2.9417938227005638,181.20023852539063,180.15487799072267,179.30999755859375,178.46511712646483,177.41975659179687,0.06,0.0,166.77312554306124,-0.020419445551919324,-0.013121311227211899,175.42936052594865,175.87675040108817,1.4593531996724614
2024-03-22,0,177.86249923706055,176.83250045776367,181.18000030517578,177.890625,179.87187576293945,0.20619730058888008,1.273262613359948,-0.892712245787608,2.995706968763098,178.79874992370605,1.026287517547607,0.00711571827541844,177.42575225830078,180.8317501068115,0.6418423588945059,-0.004695799247390097,0.9939971715598961,0.9920297324067688,0.9977868947994165,-0.006132654520712544,39.294302289092585,181.48315032590202,178.93662509918212,176.39009987246223,178.52321461268835,1.1593014115633056,179.3192858014788,1.31406040123429,178.48540350198058,178.6711152429607,-2.114155203164356,-0.27750404216042696,4084000,0.9765145749747218,0.6269443295234133,170761400.0,-62.011175565491286,73.63263747053657,76.71321854558761,-52.053174294283544,17.60529782440818,14.468347944364552,-0.13880166743228187,2.8893354790103887,181.20023852539063,180.15487799072267,179.30999755859375,178.46511712646483,177.41975659179687,0.06,0.0,166.87822154417358,0.0032044076179846837,-0.01517650481825936,175.2316153390067,175.97492327008928,1.4519952240268095
2024-03-25,0,178.7150001525879,176.83250045776367,181.18000030517578,177.90187549591064,179.87187576293945,0.20578497212579688,1.2713211951586274,-0.8858320365553785,2.9957070464624067,178.79874992370605,1.0242624282836914,0.007104779180875554,177.42575225830078,180.8317501068115,0.7060009752184971,-0.005576974038154438,0.9987488741866283,0.9978921498558309,1.0038053746359343,-0.0001258991469932358,43.67471930592806,181.48151758868153,178.93887519836426,176.396232808047,178.26607186453683,0.7821548144082575,179.32875033787317,1.3088121564818143,178.3289201908264,178.56311321733148,-1.772770086141194,-0.02950941640481696,4366400,0.9676327761822618,0.6700956172302848,175127800.0,-60.89383212783278,73.63263747053657,76.71321854558761,-18.167522426828423,17.661448289899468,14.066210780626363,-0.14406122874717323,2.7589488547623366,181.20023852539063,180.15487799072267,179.30999755859375,178.46511712646483,177.41975659179687,0.06,0.0,166.99382594296813,0.0002240548334366821,0.0036541413733297834,174.85715811593192,175.93074580601282,1.4538378764523334
2024-03-26,0,179.1425018310547,176.83250045776367,181.18000030517578,177.90187549591064,179.87187576293945,0.22221256856999114,1.272163485122362,-0.8865078248408507,2.9957070119690568,178.72625160217285,1.0307872772216797,0.0071097743762103816,177.42575225830078,180.8317501068115,0.7117054356622265,0.0008260130403930119,1.0011785309858565,1.0006535478139893,1.0062319999483698,0.0008380324629420066,49.47083034880752,181.47595233645566,178.93162536621094,176.3872983959662,178.29214368547713,0.811627299824733,179.27250044686454,1.2978606856664445,178.4183639200648,178.60330149333916,-0.9971466322170717,0.07419736649013241,4392400,0.9862843110895372,0.6714893721106573,179520200.0,-51.675908600752706,73.63263747053657,76.71321854558761,9.571789134973018,18.535273805078933,13.539728268121753,-0.1550854400478039,2.6608639214350185,181.20023852539063,180.15487799072267,179.30999755859375,178.46511712646483,177.41975659179687,0.06,0.0,167.11268267037227,-0.002616126969362198,0.003921699758511907,175.04088047572546,175.79961504255022,1.4554663714887106
2024-03-27,0,179.88500213623047,176.83250045776367,181.18000030517578,177.90187549591064,179.87187576293945,0.15678213882587216,1.2701053055291467,-0.8903450019356365,2.9957070978122,178.84875106811523,1.023162517547607,0.007097131432918407,177.42575225830078,180.8317501068115,0.7089098966913303,0.002714694916461531,1.005166656192933,1.0057349668823024,1.0102323427267481,0.012794723957669119,51.853593458522376,181.5005860154162,178.9603754043579,176.42016479329962,178.45607212611608,1.0085615653307944,179.18000057765417,1.1933974165879737,178.59104092977822,178.7102250026075,0.10197963093187452,-0.4376693562971338,5073500,0.9906351104377636,0.7712373392273794,184593700.0,-35.474748421909965,73.63263747053657,76.71321854558761,52.17615178860523,19.86455223003549,12.878695348881507,-0.11711086265347906,2.5970481369591383,181.20023852539063,180.15487799072267,179.30999755859375,178.46511712646483,177.41975659179687,0.02,1.0,167.2560613638198,0.023146268694618888,0.0038405332192757344,175.30173819405692,175.78418731689453,1.4761833473532768
2024-03-28,0,181.4250030517578,176.83250045776367,181.18000030517578,177.90187549591064,179.8962516784668,0.027688737361358535,1.2835734034318702,-0.9832155024079516,2.995706570863396,178.97624969482422,1.0571751594543457,0.0071699299118930465,177.42575225830078,180.8317501068115,0.6750213972686908,0.017262107760535144,1.0134243609817286,1.0150189934640637,1.0162869296637376,0.025101357582377526,58.96628687148443,181.58889725699802,179.02175045013428,176.45460364327053,178.80357251848494,1.5157329677663183,179.29232215881348,1.327974733277917,178.911463994251,178.8931648707196,0.6420024140878648,-0.7147577915686305,5418700,0.8999547055380367,0.8368596950752428,190012400.0,-11.033420140739212,73.63263747053657,76.71321854558761,136.1822804670766,23.5732758815684,12.156488430023034,-0.056713450874862854,2.5542880094737805,181.20023852539063,180.15487799072267,179.30999755859375,178.46511712646483,177.41975659179687,0.04,0.0,167.42523529785197,0.025915624724444086,0.03307426070658544,175.64394051688058,176.0120893205915,1.4646526704441778
2024-04-01,0,180.94499969482422,176.98250198364258,181.4250030517578,178.41562271118164,180.07625007629395,0.0629084884023111,1.282175244930991,-1.0207795304726186,2.9957066946478457,179.06750106811523,1.0787626647949224,0.00715294507940857,177.59874954223633,181.08324851989747,0.6089077072368809,0.022256659878844915,1.0094483186503411,1.011818380295653,1.0085782995111134,0.01733080593709202,65.22099105619245,181.81572606969598,179.251375579834,176.687025089972,179.27964401245117,1.6002721068468833,179.40375055585588,1.3998528777475585,179.54517928930414,179.34983802851917,1.3589970207884137,0.8743287573015387,3502100,0.946363383544196,0.5430698542809337,186510300.0,-29.748656332181504,73.63263747053657,76.71321854558761,72.29190470483249,21.699330523002768,14.136406251338586,-0.0792175270690275,2.576178736725643,181.20023852539063,180.15487799072267,179.30999755859375,178.46511712646483,177.41975659179687,0.04,0.0,167.52538356929247,0.01294470222768962,0.01836621556433092,176.27364676339286,176.09132712227958,1.4967995329303252
2024-04-02,0,179.90499877929688,176.98250198364258,181.4250030517578,178.68187427520752,180.58749961853027,-0.08996969891594538,1.2647190132245847,-1.0069293114964697,2.9957074255351985,179.26375198364258,1.078612537384032,0.007048738420755238,177.83749923706054,181.08324851989747,0.6488784304629114,0.017030597553353552,1.0026759016995725,1.0048874362171776,0.9993472894049478,0.006658638758318958,61.23643963321113,181.95431347658345,179.42487545013427,176.89543742368508,179.6971435546875,1.2422621103748686,179.33946473257882,1.350342879929376,179.89683557491554,179.68184786237367,1.8762758657631196,0.8696365582497472,4523800,0.9567283480047897,0.7025930619750509,181986500.0,-26.843545621086534,73.63263747053657,76.71321854558761,33.958329456360566,20.177311378111458,15.176758392640927,-0.03227630140672954,2.572157043649469,180.90991479492186,179.9200349731445,179.1199951171875,178.31995526123046,177.3300754394531,0.04,0.0,167.6471235447541,0.012098775513828652,0.012552496589648732,176.72103663853235,176.07519858224052,1.4215082423394478
2024-04-03,0,179.06250381469727,176.98250198364258,181.4250030517578,178.73187732696533,180.58749961853027,-0.24772407507961186,1.219489163016561,-0.7698161956245886,2.995709188544875,179.6187515258789,1.0271249771118165,0.006792889047431067,177.83749923706054,181.08324851989747,0.6714778394548684,0.007405552957822957,0.9974272489307248,0.999529732881727,0.9933540777006937,-0.00044656078563010126,53.49547704032944,181.96335366935588,179.52437534332276,177.08539701728964,179.86857278006417,1.0075070617965487,179.19589369637626,1.255427035816568,179.90122877184538,179.79253305810778,1.6512913779037917,-0.49777468784592155,5893000,0.9845772932039605,0.911117707811524,176093500.0,-75.6468140055554,73.63263747053657,76.71321854558761,-63.12079106586595,17.547406040566447,18.177571280579503,-0.08582068998477714,2.7459448143182157,180.74948132324218,179.79026025390624,179.01499938964844,178.23973852539064,177.2805174560547,0.04,0.0,167.78266440432327,-0.01037997604614238,-0.006721532278825449,176.563960484096,175.89778791155135,1.5018608372508622
2024-04-04,0,172.67499542236328,176.98250198364258,181.4250030517578,178.90437507629395,180.58749961853027,-0.2952381286600143,1.2053577446761201,-0.6598056335695306,2.9957097242337163,179.6187515258789,1.0031246185302733,0.006713275683859813,177.83749923706054,181.08324851989747,0.6939499315944169,-0.00482129988888552,0.9617185048170385,0.9638368968911303,0.9580042330822899,-0.04008119981234959,46.71793450010707,181.9590911912565,179.5483757019043,177.13766021255208,179.00571496146065,2.9239124179173404,178.63589341299874,2.0917591340968955,179.69573264119765,179.73334881233586,0.6746810501281195,-1.110049579846609,10539000,0.956004114730289,1.5747537346049107,165554500.0,-96.96971876573402,73.63263747053657,76.71321854558761,-362.68480119596603,13.626407103135646,34.062938762131424,-0.17546210711323962,3.2830117114034554,178.79540161132812,176.62730072021483,174.875,173.12269927978517,170.95459838867188,0.02,1.0,167.85325444006355,-0.0690324829695268,-0.06300577543327893,175.07313319614954,174.96514565604073,2.910529130894683
2024-04-05,0,169.0824966430664,172.67499542236328,181.4250030517578,178.73187732696533,180.58749961853027,-1.8028749275378053,1.9173381312368145,4.042676554031918,2.9956746494676665,179.26375198364258,1.311375045776367,0.010700289860520957,177.54949951171875,181.08324851989747,0.2994903340065807,-0.04694229422942294,0.9436164101395583,0.9463925672530741,0.945638324401356,-0.06803090092918607,24.797752697826137,183.0203017202373,179.18562545776368,175.35094919529004,177.56857136317663,4.7484990972254835,177.93035752432687,3.2942180637575826,177.94575796781754,178.77892208901469,-3.379685378993156,-4.343131592274065,7029700,1.6675729905155114,1.0433382311471273,158524800.0,-81.94533677070966,73.63263747053657,76.71321854558761,-304.9193640192112,12.523820481896257,31.651968426947956,-0.13811094386935494,3.3164294333396125,178.75764074707033,176.56617932128907,174.7949981689453,173.02381701660155,170.8323555908203,0.04,0.0,167.87607262114844,-0.06644709338243293,-0.05738846111915708,173.78426252092635,174.4125714983259,3.458913448945563
2024-04-08,0,169.84500122070312,169.0824966430664,181.4250030517578,178.50187492370605,180.05749893188477,-2.1038939645777512,2.8661988003410737,4.072489127541154,2.9956019842638013,179.10250282287598,1.86887588500976,0.01604987545372524,176.55175132751464,180.9577495574951,0.5142470704925599,-0.059882427086845824,0.9510823588739579,0.9548827860114205,0.9632005302908196,-0.06134459914803936,19.915958014162193,184.31314787534035,178.58075027465821,172.84835267397608,176.13428551810128,5.403346418035465,177.29517882210868,3.923768982380653,175.7306532249507,177.4122617138257,-5.615644018121198,-5.519391200233452,4745000,1.8017711078710235,0.7119098237554331,163269800.0,-83.27776060896862,73.63263747053657,76.71321854558761,-208.89439886572265,13.560003955684722,29.227350410997953,-0.1053812572874169,3.3345731027826573,178.75764074707033,176.56617932128907,174.7949981689453,173.02381701660155,170.8323555908203,0.04,0.0,167.89699211561893,-0.06063280475927324,-0.06754532966634341,172.30465698242188,173.80319758823939,3.922467699626991
2024-04-09,0,169.45499801635742,169.0824966430664,181.4250030517578,177.79999923706055,180.05749893188477,-1.6314363902511515,3.4204558950201567,1.529945002599483,2.995545832432555,179.02750205993652,2.442225799560549,0.019207371331353123,172.39199600219726,180.9577495574951,0.7058161138529156,-0.05318170862624499,0.9515646951017632,0.9570038544657694,0.9732416624641547,-0.05808621680245396,23.859658527872487,184.92128707995732,178.080375289917,171.23946349987665,174.42428479875838,5.343678311312007,176.61392865862166,4.4048716842280005,174.2617347354455,176.3240467585709,-5.581344078882047,-4.975174028519155,5934000,1.8261099103326568,0.8849940269614459,157335800.0,-81.01262991818611,73.63263747053657,76.71321854558761,-175.29031364010834,12.639945941039121,29.398238860936306,-0.06897975545250337,3.321369039895544,178.75764074707033,176.56617932128907,174.7949981689453,173.02381701660155,170.8323555908203,0.04,0.0,167.91437585036294,-0.058387281576280814,-0.05875186793149314,170.62730189732142,173.135621207101,4.241270702831473
2024-04-10,0,168.73500061035156,169.0824966430664,181.4250030517578,177.45499992370605,180.05749893188477,-1.2778168178221316,3.884296612049884,0.18727480509910643,2.9954907678989415,178.97624969482422,2.987938213348386,0.021873025409622503,169.80600090026854,180.9577495574951,0.7634855141255869,-0.06277482519654326,0.9501707321715446,0.9579473439897759,0.9808805839199342,-0.05767540933658066,21.469240127941067,185.3524683080231,177.58387508392335,169.81528185982359,172.67999921526228,4.828386442209103,175.97982161385673,4.865014102116361,173.06691470492007,175.36201479267567,-6.597770337082772,-5.328436818613775,3231700,1.7696941336035399,0.4898623043855235,154104100.0,-88.40769912655942,73.63263747053657,76.71321854558761,-151.10646037948558,11.874212380832494,27.704431961331256,-0.053688897905899986,3.2826427514610823,178.75764074707033,176.56617932128907,174.7949981689453,173.02381701660155,170.8323555908203,0.04,0.0,167.91995022908029,-0.0468054492691532,-0.06453041373413594,168.9822060721261,172.62792641775948,4.527239105385749
2024-04-11,0,168.32999801635742,168.73500061035156,181.4250030517578,175.90562534332275,179.89000129699707,-1.013545067802851,4.256746941820907,-0.5686484500216018,2.9954406023128297,178.84875106811523,3.510938358306879,0.02405208452878106,169.41774787902833,180.9577495574951,0.7910264084348647,-0.06813567949603123,0.9511223937796667,0.9613281329687766,0.9904182469149305,-0.025162863884130915,20.053009784414833,185.49386898282395,176.98037509918214,168.46688121554033,171.0264276776995,3.8179770763490466,175.3617856161935,5.261292492611132,171.98608069224855,174.42285089506197,-6.747906327925962,-4.99823980003802,3307000,1.7579930145040539,0.5116727769813781,150797100.0,-98.07559121450586,73.63263747053657,76.71321854558761,-134.24065282894082,11.306392927885172,26.670122151508213,-0.040320897910725545,3.20091369766842,178.74348132324218,176.54326025390625,174.76499938964844,172.98673852539062,170.7865174560547,0.06,0.0,167.92073314285042,-0.002263190504301349,-0.05532062255574752,167.1351536342076,171.92809513637,4.893738686260311
2024-04-12,0,162.7949981689453,168.32999801635742,181.4250030517578,171.96749687194824,179.32812690734863,-0.7936246755941355,4.540720625852336,-1.0604919756767077,2.9953984288132536,178.72625160217285,3.9937010574340777,0.025749330488642835,169.04774703979493,180.55799942016603,0.8203033829981875,-0.06750132351599897,0.9231711340891682,0.9358938901247752,0.96277414757676,-0.037185980801986984,19.661897388825384,185.424691335628,176.34325008392335,167.2618088322187,168.70249829973494,2.9674644489518056,174.28553553989954,6.17258057219487,171.0678134211363,173.56528028012758,-6.433951719784832,-4.888903631888341,7029400,1.7587419543677736,1.0873656049122802,143767700.0,-89.77579162655248,73.63263747053657,76.71321854558761,-180.67611028219184,9.573859490562562,37.31586572037197,-0.06619592381481745,3.5098120843276233,177.03720233154297,173.78140188598633,171.1500015258789,168.51860116577149,165.26280072021484,0.08,0.0,167.8431060967464,-0.036496805503238416,-0.024445845567056135,165.2369842529297,170.90047236851282,5.441567877061484
2024-04-15,0,163.0974998474121,162.7949981689453,181.4250030517578,169.7475004196167,179.08250331878662,-0.849268795954405,5.304783650440508,-0.5861666913217034,2.9952711389389064,178.28874969482422,4.7283262062072735,0.030234052167969722,168.69450035095215,180.0089988708496,0.7624397083797734,-0.09032745305221612,0.9295569138701093,0.9477839226333822,0.9717902463087248,-0.03972740631043392,14.013741397013952,186.06681732376921,175.4572500228882,164.84768272200716,167.3342846461705,3.0377153032996684,173.16999980381556,6.699252932894702,168.99236152500382,172.2603741577194,-9.084819713336731,-8.471432220252797,5433700,2.0653776333306197,0.9552229884976645,149201400.0,-92.5112199981799,73.63263747053657,76.71321854558761,-145.42151920485952,9.458289262707455,34.86740396710681,0.025092477961766585,3.4876563293545346,177.03720233154297,173.78140188598633,171.1500015258789,168.51860116577149,165.26280072021484,0.08,0.0,167.78851440408224,-0.0389880063448923,-0.0401185456354068,164.5749969482422,169.82406507219588,6.010878127622126
2024-04-16,0,162.6349983215332,162.7949981689453,181.4250030517578,169.36187267303467,179.08250331878662,-0.6930350949071687,5.8767670571032555,-0.9091953611455157,2.9951616136115162,177.73749923706055,5.329801254272462,0.03364610251274931,167.8067481994629,180.0089988708496,0.8224885791070247,-0.08750263899466447,0.9311299516411945,0.9550010010379263,0.9768894590420236,-0.040246671828268465,15.597028994370369,186.41765917524168,174.66412506103515,162.91059094682862,166.41321345738,3.3777390715906046,171.99089241027832,7.012577845420522,167.5140601062124,171.27945524694093,-5.546544565717002,-8.73877418898328,4881300,2.0770770457897205,0.8868600705847085,144320100.0,-88.60989713661678,73.63263747053657,76.71321854558761,-123.34274975393078,9.04485322674315,33.3432973469631,0.02200345371234072,3.3862847877559545,177.03720233154297,173.78140188598633,171.1500015258789,168.51860116577149,165.26280072021484,0.08,0.0,167.74195753093002,-0.03574727713745529,-0.033816510907903774,163.74164472307478,168.76295362200057,6.354207593493685
2024-04-17,0,164.09249877929688,162.6349983215332,181.4250030517578,168.9956226348877,179.08250331878662,-0.5208704059282336,6.347719156513752,-1.1886908281608202,2.995061256370943,177.29750061035156,5.80810121536255,0.03651073089641901,163.06724967956544,180.0089988708496,0.8465480713330937,-0.09138652153444209,0.9438251626025436,0.9734311144086941,0.9937862794303439,-0.02751356751273737,14.82208632359206,186.55443813755141,173.85899982452392,161.16356151149643,165.59142739432198,3.0912767169628452,170.86285645621163,6.914557477849471,166.28872866159747,170.3145278771083,-3.813226353727133,-9.214733154217832,4792200,2.063610674548289,0.8936745142759105,149112300.0,-80.94170664400428,73.63263747053657,76.71321854558761,-96.88833100678961,10.779638677530409,31.754603121221454,-0.01076906134583708,3.301464868694597,177.03720233154297,173.78140188598633,171.1500015258789,168.51860116577149,165.26280072021484,0.08,0.0,167.7087370899458,-0.019204053423805045,-0.02560281907534855,163.17840358189173,167.74153028215682,6.436072386292145
2024-04-18,0,165.37250137329102,162.6349983215332,181.4250030517578,168.63374996185303,179.08250331878662,-0.3157516246044149,6.571917463752271,-1.4186869082269857,2.9950085230714043,174.82874870300293,6.039751243591309,0.03796294622797811,163.06724967956544,180.0089988708496,0.8860631853526433,-0.0761207714312856,0.9552809224776858,0.9898144259418865,1.0072020388359373,-0.017569635109120685,22.857724589048555,186.25783467573453,173.11399974823,159.97016482072544,165.00821358816964,2.5844320036983466,169.716249193464,6.33502783497764,165.73029343062723,169.63921546805602,-3.3869130089564585,-8.779221819156229,4480100,2.1224758067744585,0.8582517724993918,153592400.0,-78.72143853493291,73.63263747053657,76.71321854558761,-73.59911973991694,15.894375140013453,29.555617369185487,0.0011056557713852101,3.2934957496497588,176.7315953369141,173.53419622802735,170.9499969482422,168.36579766845705,165.16839855957033,0.08,0.0,167.69027982672654,-0.007893022091944535,-0.016755811780837637,162.6255166190011,166.62640925816126,6.56444050155876
2024-04-19,0,165.32000350952148,162.6349983215332,181.4250030517578,167.59062385559082,179.08250331878662,-0.11635498088584287,6.6933004006258425,-1.543825136802301,2.9949780930850665,171.2599983215332,6.158000755310058,0.03880129161546196,163.06724967956544,180.0089988708496,0.9066077768291307,-0.06559970889904475,0.9583657212579839,0.9938441086197765,1.0105227384041524,0.015510337350510994,29.229337252491426,185.8886006562932,172.5019998550415,159.11539905378982,164.52035685947962,2.025585299063682,168.60017803737097,5.529828488399879,165.63943695976587,169.24677798721308,-2.409192228530388,-8.84800959539588,5532400,2.168687497557451,1.0619890315137623,148060000.0,-70.32406550539775,73.63263747053657,76.71321854558761,-68.3540226755755,14.739986416396407,29.967275746675128,0.007284053640627397,3.2975357421312443,176.5024046630859,173.34880377197263,170.8000030517578,168.25120233154297,165.09760144042968,0.08,0.0,167.66698713152945,0.02544984643741066,0.0026510481860226214,162.4760284423828,165.72911725725447,6.538215008171568
2024-04-22,0,168.0199966430664,162.6349983215332,181.4250030517578,165.35937690734863,179.08250331878662,0.07306339813458597,6.784949829254752,-1.586915428502376,2.9949539540347443,169.64999961853027,6.234762973785399,0.039465997156883835,163.06724967956544,180.0089988708496,0.9052062034591931,-0.07051793256779802,0.9773214064492555,1.0123653351891013,1.023866013022973,0.030181313633008466,28.09176033372385,185.48877458984492,171.91887493133544,158.34897527282595,164.47607094900948,1.929523214005657,167.7512493133545,4.4719223124300065,165.56578306448188,168.8935314531558,-2.0238818789683726,-8.635218553513681,5580700,2.1448088094062334,1.0560896844523546,153640700.0,-63.47223536958043,73.63263747053657,76.71321854558761,-35.523974576315794,20.219745862939405,27.896098398073818,-0.02701446905537468,3.289132974540842,176.5024046630859,173.34880377197263,170.8000030517578,168.25120233154297,165.09760144042968,0.08,0.0,167.67176408523642,0.03847339700370367,0.03456984920064519,162.74781581333704,164.94148472377233,6.394291013560202
2024-04-23,0,169.17999649047852,162.6349983215332,181.4250030517578,165.35937690734863,179.08250331878662,0.2522315656335158,6.692315454547746,-1.4906667511770022,2.9949724662735244,169.2687473297119,6.0341006469726555,0.03903892165191064,163.06724967956544,180.0089988708496,0.9067971561738769,-0.05984390510248177,0.9868937997497064,1.0204767744754921,1.0247867608302517,0.04024347918032811,39.16485040507748,184.81138071073124,171.42674980163574,158.04211889254023,165.38821356637138,2.4431959850190195,167.04535593305314,3.1267580013904364,166.18717847446052,169.03102433168814,-0.1841628806179225,-6.606265649578033,4084100,2.250457595410859,0.7749435978589008,157724800.0,-46.10172355379844,73.63263747053657,76.71321854558761,-17.66964838530104,20.835952993802174,26.365652293203127,-0.007802825211185303,3.2312937743469377,173.52279766845703,170.93859811401367,168.8499984741211,166.76139883422852,164.17719927978516,0.08,0.0,167.68444957859725,0.043066308753419325,0.04867936321247812,163.7755170549665,164.50625065394811,6.195966616162684
2024-04-24,0,168.0425033569336,162.6349983215332,181.4250030517578,165.35937690734863,179.08250331878662,0.42409397547658956,6.492785285933888,-1.282890127719251,2.9950145894428513,169.13124656677246,5.639000740051273,0.03798061012238865,163.06724967956544,180.0089988708496,0.8970143260364988,-0.055612181580290694,0.9829921247845295,1.0137836945317225,1.0098890244664285,0.02407181685342885,43.15802433118858,183.93557019039807,170.94999961853028,157.9644290466625,166.09464263916016,2.3846673574164385,166.71446364266532,2.7013473715905083,166.95760876658872,169.21030408017606,3.9221096430167854,-5.519026660347415,4074700,2.273252593048768,0.7754974254444689,153650100.0,-34.83707388210579,73.63263747053657,76.71321854558761,-31.8064166072006,19.53298687997661,28.022289546964526,-0.01883270772062704,3.200464583877074,169.1450809326172,167.39746075439453,165.98500061035156,164.5725404663086,162.82492028808593,0.08,0.0,167.6859151326801,0.021613389078973366,0.03236131224836001,164.6432604108538,164.60912867954798,5.932576199466003
2024-04-25,0,167.45249938964844,162.6349983215332,181.4250030517578,165.35937690734863,174.27187252044678,0.6274607467534933,6.238193484845988,-0.9555751251829441,2.995066952623943,168.90874862670898,5.152750473022456,0.0366101910033659,163.06724967956544,180.0089988708496,0.8716778200445767,-0.06583371953559707,0.9827312989791616,1.0106464838827869,1.0015880368363215,0.01257765347373141,39.417987528928116,182.8713866645162,170.3949996948242,157.91861272513222,166.78285707746232,1.8564748311387824,166.59803526742118,2.625495522855635,167.2536269436534,169.15017876967812,3.031930908902861,-2.6827810558781864,5503700,2.2568132325284274,1.043194274249571,148146400.0,-39.097806660836795,73.63263747053657,76.71321854558761,-34.29862695424547,17.92884793615097,28.303927097571457,-0.05826896963891196,3.237597434758168,169.1450809326172,167.39746075439453,165.98500061035156,164.5725404663086,162.82492028808593,0.08,0.0,167.6829331883113,0.015972235860517214,0.018508283796497476,165.31565420968192,164.52864946637834,5.518894851268484
2024-04-26,0,162.95499801635742,162.6349983215332,181.4250030517578,165.35937690734863,170.55249977111816,0.8543545437220541,5.870140392564616,-0.4364719457988997,2.995140101485381,168.5324993133545,4.521725463867187,0.03457633099338934,163.06724967956544,180.0089988708496,0.8235012501134698,-0.0770153144664588,0.9598383635896417,0.9840233116200412,0.9722677883751631,-0.014305622084189284,36.33888986091035,181.5136553426244,169.77337455749512,158.03309377236585,166.620356968471,2.156719191006344,166.10589218139648,2.6157806997310953,167.3151430714125,168.8920753154172,2.9621552051120768,-0.96402483153469,10721700,2.1987246416845183,1.9349878586130755,137424700.0,-84.7286835459508,73.63263747053657,76.71321854558761,-119.50644793308878,14.538109959006261,38.2195981864525,-0.152490031999547,3.7073397241042056,167.5056008911133,165.62219955444337,164.0999984741211,162.57779739379882,160.6943960571289,0.1,0.0,167.56791146188056,-0.04080284834027881,-0.03060854227980544,164.66024562290735,163.91932460239954,5.143932988321101
2024-04-29,0,160.30500030517578,162.6349983215332,180.94499969482422,165.01312732696533,169.55249881744385,1.0132295568419902,5.398350314477608,0.14319278698969562,2.9952264452207795,168.1862506866455,3.935099563598635,0.03197130194306913,162.93899803161622,179.14675331115723,0.7399238872341654,-0.09942248588691664,0.949393660873696,0.9679274633677994,0.9591635342310161,-0.04591713184163426,27.629897210175482,179.64657493468027,168.8498743057251,158.05317367676994,165.8964282444545,3.229207917047728,165.4523209163121,2.847450597725452,166.2241522682461,167.9247940913476,-0.6932070456611077,-4.056641735009068,6219000,2.3518429730040173,1.0955096260047457,131205700.0,-69.57539304573558,73.63263747053657,76.71321854558761,-129.23591389957852,13.688379881954877,35.98572169195479,-0.0995710425649043,3.656072778545747,167.36807482910157,165.51095465087892,164.00999450683594,162.50903436279296,160.6519141845703,0.1,0.0,167.49199049800202,-0.03794148303298528,-0.029385261230802658,164.21575709751673,163.42063685825892,4.563051995360541
2024-04-30,0,161.66250228881836,160.30500030517578,179.90499877929688,163.84374904632568,169.24874687194824,0.965113694701957,4.940981972864347,0.6733196213109798,2.9953027249544064,168.03125,3.6335871315002435,0.02944252507313085,162.7789981842041,173.3137462615967,0.6614462859683933,-0.10894638062928924,0.9633211177786025,0.9777727536814641,0.9762994846547561,-0.044434888034078246,24.21211490890162,177.69983828197138,167.81787433624268,157.93591039051398,165.37392807006836,3.61131372970821,164.947142464774,2.8476378779260942,164.73671528098293,166.6842728425876,-3.064294865248786,-5.399662340026344,5484800,2.3824774414411976,0.9580670968373026,136690500.0,-60.7704008310761,73.63263747053657,76.71321854558761,-96.809398692787,15.733256308418754,33.60847679018678,-0.09137157221126141,3.6349137344280567,167.36807482910157,165.51095465087892,164.00999450683594,162.50903436279296,160.6519141845703,0.1,0.0,167.4381840723012,-0.04069834295412633,-0.03127046514417918,163.68208748953683,163.07905796595983,3.6385112108615534
2024-05-01,0,162.1599998474121,160.30500030517578,179.06250381469727,163.06187438964844,169.10687160491943,0.8642449393705951,4.262725952682668,1.0787270316332842,2.995408394490577,167.73624801635742,3.39167449951172,0.02553971906392221,162.53774871826172,170.12800064086915,0.5810895698702226,-0.09717278132045606,0.9715662900877275,0.9813589596507979,0.9882773050544134,-0.03500604544688701,29.849697957766747,175.43120141708408,166.90574951171874,158.3802976063534,164.53678567068917,3.5747150253734423,164.50642830984933,2.7599161922492526,163.95471372909148,165.68774799308287,-2.212376689486626,-4.191482677541958,5176400,2.441580537212304,0.909891492925859,141866900.0,-68.00309014440667,73.63263747053657,76.71321854558761,-81.86042031618965,16.212976076793275,31.88684119215331,-0.08007670886864528,3.5573825777286268,167.36807482910157,165.51095465087892,164.00999450683594,162.50903436279296,160.6519141845703,0.1,0.0,167.3917714408104,-0.0362336236927403,-0.046124764460572246,162.80868312290735,162.7782494681222,2.9568962586101044
2024-05-02,0,160.8849983215332,160.30500030517578,172.67499542236328,162.9149980545044,168.82187461853027,0.02004159233391739,3.3456492914572107,-1.131663571757282,2.9955293213486014,166.41250038146973,3.021124267578125,0.02014715592748832,162.11025009155273,169.493998336792,0.6703142975337556,-0.060894720450007704,0.9688329125991064,0.9747829297263274,0.9875880002189715,-0.03922008385693421,34.73154490393397,172.7519228962689,166.06062431335448,159.36932573044007,163.35178593226843,3.125649227009466,164.3699997493199,2.8949288492704954,163.49971411590138,164.8375325470397,-3.487678200650719,-3.6654180726276397,5904300,2.087907002858624,1.0819096273886606,135962600.0,-75.15720629832849,73.63263747053657,76.71321854558761,-108.8611591753426,14.827238062141905,35.13649236670041,0.017876889278973643,3.6118802741880343,167.36807482910157,165.51095465087892,164.00999450683594,162.50903436279296,160.6519141845703,0.1,0.0,167.32260168045488,-0.03873507417348754,-0.04165675553646745,161.57289341517858,162.67420523507255,3.1009536968071436
2024-05-03,0,162.48500061035156,160.30500030517578,169.84500122070312,162.75499820709229,168.43124866485596,-0.0874526291645458,3.161916992001921,-1.5315699929738846,2.9955495867111868,165.34625244140625,2.8902370262146007,0.01910857258239337,161.58475189208986,169.2074966430664,0.7213336422940823,-0.04848224082495153,0.9819538069996392,0.9871611684274053,1.0055169351232514,-0.002884215959787162,33.866400644403896,171.79495844231687,165.471124458313,159.14729047430913,162.557856968471,2.3435842556920665,164.32624980381556,2.920157246763302,162.84682001132165,164.11397225704238,-4.903060847038235,-1.173254626306117,5849900,1.9712374943992028,1.0836549620667968,141812500.0,-51.7295691791684,73.63263747053657,76.71321854558761,-48.37239723694964,17.383695661758164,32.6915923630514,0.029057012927357264,3.6045996800666966,167.36807482910157,165.51095465087892,164.00999450683594,162.50903436279296,160.6519141845703,0.1,0.0,167.27958629120383,0.02612449695556518,-0.020921746878601436,161.0052490234375,162.82425471714564,3.0020410172626057
2024-05-06,0,163.19250106811523,160.30500030517578,169.84500122070312,162.5974988937378,168.11437702178955,0.10511976914018746,3.111695359202748,-1.5057402115200962,2.995554852743,164.70625114440918,2.8340002059936524,0.018842629359241567,161.58475189208986,169.2074966430664,0.7197923335334767,-0.0433336310015253,0.9881995044084178,0.9931701295100227,1.010483009486579,0.018012543323305374,39.64266427238901,171.36464037508276,165.14124965667725,158.91785893827173,161.94928577968054,1.0651337506316985,164.36607142857142,2.8990448354046117,162.7623935761453,163.80573989671592,-3.3072006400532614,-0.37554176957560853,5834600,2.0064910235345406,1.0700220162724186,147647100.0,-60.062882519331396,73.63263747053657,76.71321854558761,-46.00499965935892,16.88632508488671,30.34029301482402,0.03564527199247427,3.6064150411040976,167.36807482910157,165.51095465087892,164.00999450683594,162.50903436279296,160.6519141845703,0.02,1.0,167.23616069325047,0.007491262291424716,0.019483707462205645,160.35974993024553,162.83770206996374,2.917172868169395
2024-05-07,0,162.94750213623047,160.30500030517578,169.45499801635742,162.5974988937378,168.0256233215332,0.24612432136552262,2.9420444808076565,-1.4127313315212442,2.9955731594718706,163.64249992370605,2.6629875564575203,0.01785127742600001,161.58475189208986,168.77950019836425,0.6999227758147188,-0.03695669659526756,0.9887073718576285,0.9946011900396949,1.0053709144831757,0.007948657414175164,42.61496333750322,170.69271361066316,164.80862464904786,158.92453568743255,161.9482149396624,1.0639572520393141,164.2842859540667,2.9234048273427575,162.86418051850083,163.72126067375143,-2.5440040232666408,0.3427938342519826,5301700,2.0213264772413067,0.9779623217866253,142345400.0,-61.47791914282082,73.63263747053657,76.71321854558761,-40.543406590626056,16.162109407448035,29.039067570628077,-0.022791582314126178,3.4987756582033267,167.36807482910157,165.51095465087892,164.00999450683594,162.50903436279296,160.6519141845703,0.02,0.0,167.1976261167696,-0.0005533172905404227,0.006376954186377755,160.7745121547154,162.7173788888114,2.7807511718499485
2024-05-08,0,161.33999633789062,160.30500030517578,169.17999649047852,162.5974988937378,167.59437370300293,0.39869876360624806,2.764689231620747,-1.248759354472326,2.9955913174998208,163.14500045776367,2.4586500549316384,0.01680833297042257,161.58475189208986,168.37049827575683,0.674000611147567,-0.03429933595985682,0.9808901300289178,0.988549914204649,0.9938767968730602,-0.0050567557368838,42.41381078600953,170.01262831828296,164.4832498550415,158.95387139180002,162.09607151576452,0.8474249984390115,163.9962498801095,3.005443354284635,162.87245562938202,163.6688927693428,-0.004599969450584565,-0.6977751277993626,5906700,2.019279847581659,1.0633276446825517,136438700.0,-77.98739950432932,73.63263747053657,76.71321854558761,-80.87211304778346,15.152346857701232,31.389943248333033,-0.06333393771476824,3.4652804000781776,167.36807482910157,165.51095465087892,164.00999450683594,162.50903436279296,160.6519141845703,0.02,0.0,167.1387935856537,-0.007853164842380633,-0.013465379607474215,160.62304469517298,162.41940089634485,2.7838643647398853
2024-05-09,0,160.63750076293945,160.30500030517578,169.17999649047852,162.4037504196167,165.89250087738037,0.579294768513539,2.6640052996110044,-0.9904742012070824,2.995600924726891,163.02624893188477,2.2923001289367675,0.016232700572663135,161.29449653625488,168.07125282287598,0.622630676584504,-0.041525585224491866,0.9788195432668615,0.9883043151550128,0.9905500466500052,-0.0015383507547367392,38.16482472374868,169.44151024064047,164.11349964141846,158.78548904219645,161.94964272635323,1.0081444507723785,163.6617853982108,3.1056735666191844,162.47589884653274,163.35842862912654,0.6456417646015418,-2.4384374680878307,3570000,2.0401715011774106,0.6411557325967525,132868700.0,-78.38050521941705,73.63263747053657,76.71321854558761,-89.63243771263316,14.727210437523976,30.5092210587284,-0.05485384069106451,3.3105697159163308,167.36807482910157,165.51095465087892,164.00999450683594,162.50903436279296,160.6519141845703,0.02,0.0,167.10093240650403,-0.0025496717247380785,-0.008162343810821702,160.3059561593192,161.99402182442802,2.833289410213196
2024-05-10,0,160.81250381469727,160.30500030517578,169.17999649047852,162.03562545776367,165.33312797546387,0.7469732736135165,2.5815060399381458,-0.6010324386967563,2.995608450870092,162.95125007629395,2.1377876091003403,0.015766956460347165,160.86024856567383,168.02224731445312,0.7676333121548939,-0.013252848246399149,0.9821878030494543,0.993546796524203,0.9919319495873077,-0.010293238079649214,40.02999439545632,168.89188685862385,163.72887477874755,158.56586269887126,161.75714329310827,1.0868589271507136,163.14696448189872,2.9194512149785026,161.99446174699042,162.96635898967415,-0.6340378946056943,-2.832387277509552,3509500,1.6426481874046144,0.6508626085505116,136378200.0,-75.62888517282497,73.63263747053657,76.71321854558761,-77.97969301521626,14.635332812492766,29.755380895246844,-0.06691406240091662,3.1519116074678615,167.36807482910157,165.51095465087892,164.00999450683594,162.50903436279296,160.6519141845703,0.02,0.0,167.06564124866523,-0.01856035933854505,-0.00037317173857524236,160.16864449637276,161.48866380964006,2.8878722707290927
2024-05-13,0,161.48250198364258,160.30500030517578,169.17999649047852,161.58187580108643,165.33312797546387,0.7364409735166386,2.652546404581183,-0.6738927269590387,2.995601390440782,162.95125007629395,2.2071749114990267,0.01621066098060874,160.79500350952148,168.02224731445312,0.7879767538121865,-0.014010000366974357,0.986877398049,0.9990086250999239,0.9981240723005309,-0.010478417042943167,40.51538554302251,168.93484287019757,163.62975006103517,158.32465725187276,161.8425009591239,1.0288637296026437,162.59714344569616,2.3687428659028593,161.69270417664742,162.8259784542701,-0.8309669671822884,-4.289663714063982,3505900,1.6411946216849955,0.6620295580269597,139884100.0,-68.81438940589037,73.63263747053657,76.71321854558761,-55.148489656888586,16.65398450616894,28.489575587434732,-0.03742815375089652,3.056750121198991,166.54295343017577,164.84351351928711,163.4699935913086,162.09647366333007,160.39703375244142,0.02,0.0,167.03472415929966,-0.008910446614348255,-0.015324499794667986,160.23517499651228,160.90403420584542,2.901565997591062
2024-05-14,0,161.30249786376953,160.30500030517578,169.17999649047852,161.4468755722046,165.33312797546387,0.7697104806436863,2.6918118589538955,-0.6995468688256228,2.9955973864396483,162.79125022888184,2.2636998367309586,0.016458748486333448,160.79500350952148,168.02224731445312,0.8040517268186639,-0.007086398067973738,0.9862640413468036,0.9971686360306563,0.9991235156312538,-0.010095302173368959,44.174467913134855,168.93262388575448,163.54900016784669,158.1653764499389,161.67357199532645,1.0025303006266975,162.11571448189872,1.791466625234578,161.64117178455479,162.73481224703565,0.371385566300748,-4.54988454103033,4025000,1.6482328400568846,0.7662477845444491,135859100.0,-66.15117999997379,73.63263747053657,76.71321854558761,-61.746647156885444,15.656884744729478,29.33964759627756,0.001303006860093184,3.0191156734239475,166.54295343017577,164.84351351928711,163.4699935913086,162.09647366333007,160.39703375244142,0.02,0.0,166.9973307535849,-0.005905981749746214,-0.007005472200110602,159.92374965122767,160.4644993373326,2.9242054399226554
2024-05-15,0,163.09749603271484,160.30500030517578,169.17999649047852,161.33062171936035,165.33312797546387,0.7852393994085892,2.7298316526276762,-0.7296637121188732,2.995593456471597,162.71625137329102,2.3103373527526854,0.01669801805978875,160.79500350952148,168.02224731445312,0.8164284202306137,-0.01700261094372067,0.9976457455312697,1.0084897202076673,1.0123048498168972,0.010893143267113548,41.66513910847413,168.94203845021383,163.4823751449585,158.02271183970316,161.6599998474121,0.9789047226147141,161.8046428135463,0.9941942390041735,161.56478865614025,162.62476874377543,-0.7277611731175982,-4.0108932909954556,5261300,1.608939996614978,0.9971523740482249,141120400.0,-37.41089329905166,73.63263747053657,76.71321854558761,-0.25552559208228215,19.76185087318152,27.365943805885934,0.01057986939128785,3.0056044241838493,165.14484368896484,163.71258181762695,162.55500030517578,161.3974187927246,159.96515692138672,0.02,0.0,166.9671813293888,0.02081647797300734,0.007628334767601233,160.07380022321428,160.2167750767299,2.9189408680697126
2024-05-16,0,163.72749710083008,160.30500030517578,169.17999649047852,161.33062171936035,165.33312797546387,0.8414366791404417,2.7273246652382337,-0.6620106830948433,2.9955936697008463,162.71625137329102,2.279175071716304,0.016687761486489715,160.79500350952148,168.02224731445312,0.8149650966119972,-0.013756853900642537,1.0018042425322786,1.0117987137353286,1.014002886097087,0.01923583424303077,48.99746355179769,168.88727433810584,163.43262500762938,157.97797567715293,161.77142769949776,1.1746982819274492,161.85982131958008,1.0806306768021188,161.96683980687627,162.73329191752467,-0.05821654474229566,-2.6007395367684856,4642000,1.6368449959596978,0.8784313131810113,145762400.0,-8.516692807528567,73.63263747053657,76.71321854558761,15.947985383249385,19.68183815291285,25.56614875134083,0.07186999700417732,2.987343052587094,163.3228332519531,162.32857360839844,161.52499389648438,160.7214141845703,159.72715454101564,0.04,0.0,166.944332424219,0.024626049570254827,0.024306749226980784,160.32860238211495,160.55155726841517,2.9126156028053884
2024-05-17,0,165.69750213623047,160.30500030517578,169.17999649047852,161.33062171936035,164.12562370300293,0.9478844415126717,2.6921601352521,-0.440677960779567,2.99559715534582,162.71625137329102,2.1640247726440407,0.01648089353114163,160.79500350952148,168.02224731445312,0.8082358031524973,-0.009632871853887223,1.0143686682395678,1.0221773406960921,1.0222908593442626,0.030376980680321575,51.83030010268096,168.73469506451053,163.35037479400634,157.96605452350215,162.39392852783203,1.8616691800384495,162.24500002179826,1.398190131839504,162.42731446344254,162.91014997612746,0.47867868753674,0.47405669901276226,5152200,1.645392921734311,0.9784993001494661,150914600.0,-0.8364066598971445,73.63263747053657,76.71321854558761,73.53851963562266,22.461679884795252,24.230650464868265,0.0710533082592794,2.9268064609949844,164.51468304443358,163.29266152954102,162.30500030517578,161.31733908081054,160.09531756591798,0.06,0.0,166.93518505287923,0.03527219423746453,0.03753122393805009,161.17369733537947,160.89837101527624,2.9131597019271025
2024-05-20,0,165.3499984741211,160.30500030517578,169.17999649047852,161.33062171936035,164.21999835968018,0.9246026998651724,2.7071845901211473,-0.5088578816192628,2.995595661064011,162.71625137329102,2.190449676513674,0.01657095563989243,160.79500350952148,168.02224731445312,0.7434328146334201,-0.0138227267779902,1.0121243670526083,1.0180161371215082,1.0140345787594818,0.023949941591010715,57.0659366725438,168.7836189055841,163.3692497253418,157.9548805450995,163.06714248657227,1.9695881384103162,162.50839260646276,1.611129942972824,163.25759483123738,163.32983724679204,2.7008218031776945,3.363901201328016,3058700,1.5874438305101217,0.5951577157244844,147855900.0,-23.05860862621847,73.63263747053657,76.71321854558761,63.72234497836652,21.334418233794434,23.214361626441313,0.06232453905413254,2.8613077921767536,164.51468304443358,163.29266152954102,162.30500030517578,161.31733908081054,160.09531756591798,0.06,0.0,166.92665886090597,0.02033736022015309,0.023701467647908578,161.76257542201452,161.03426579066686,2.7326073729187117
2024-05-21,0,164.12749862670898,160.30500030517578,169.17999649047852,161.33062171936035,164.13312244415283,0.9994375700564718,2.5349008097137182,-0.11338593546492248,2.9956123074455574,162.71625137329102,2.0035498046874975,0.015529078725445728,160.79500350952148,167.51149978637696,0.6625175054067471,-0.022638598509327756,1.0054629504309855,1.0091490625922586,1.0017853346853385,0.01751368267914466,54.22062763725632,168.30555143632196,163.23574981689453,158.1659481974671,163.54071317400252,1.7198226575754525,162.64892823355538,1.663366353243957,163.77989606428574,163.54202074833015,2.933622403735042,2.280984231405025,3645200,1.5587881036377442,0.7123197192305024,144210700.0,-42.53295584436419,73.63263747053657,76.71321854558761,32.958081410849445,19.63928468803713,26.09757245438612,0.02742329814583499,2.8862191315650767,164.51468304443358,163.29266152954102,162.30500030517578,161.31733908081054,160.09531756591798,0.06,0.0,166.90867285028173,0.008292605992339164,0.010230646414537964,162.07116917201452,161.11990683419364,2.295023614833567
2024-05-22,0,160.57500076293945,160.30500030517578,168.0425033569336,161.33062171936035,163.8274974822998,0.9362031794911216,2.1528957591110482,0.00034673304059573695,2.995645382653736,162.71625137329102,1.6822496795654274,0.01320931697756341,160.79500350952148,165.87300186157228,0.6006106448686568,-0.023297705354394033,0.9852247024844206,0.9865904885512335,0.9767335903486413,-0.015466180236570981,49.72641818269584,167.28891644192814,162.98312492370604,158.67733340548395,163.4110701424735,1.923031696423716,162.6267855507987,1.6904960894002223,163.8603334722925,163.48113902124516,2.061403642985098,1.213307092469311,6904900,1.5615874261988767,1.312999453305127,137305800.0,-94.11754882908308,73.63263747053657,76.71321854558761,-97.5813744357018,17.854518735246547,31.771586076088802,-0.014421516172248938,2.9479275949924992,164.76484246826172,163.69758059692384,162.83499908447266,161.97241757202147,160.9051557006836,0.02,1.0,166.83874373332668,-0.025520400074009797,-0.012253128464921121,161.83477129255022,161.03497314453125,2.090369197574198
2024-05-23,1,158.7724952697754,160.30500030517578,167.45249938964844,161.19812297821045,163.32625007629395,0.9365442095628654,1.8723351073654146,0.2227095605034446,2.9956662177900593,162.32250022888184,1.5059744834899902,0.011514285642387892,160.63125076293946,165.38474884033204,0.37954379886038087,-0.041071340540015475,0.9764020636579788,0.9759744254587223,0.9687422524198961,-0.03026371207521239,37.609189696795724,166.35442000873718,162.60974979400635,158.86507957927552,163.04964120047433,2.527983025622281,162.3616065979004,1.980716142630785,163.02528682688464,162.96279501387946,-0.5619811493848731,-0.19268269995827153,5672900,1.7308639746681531,1.0769962419325902,131632900.0,-94.27263034624997,73.63263747053657,76.71321854558761,-159.74718367372216,16.851776456713562,33.48503092058651,-0.040697281720167976,2.9002113357508894,164.42972290039063,163.15514129638672,162.125,161.09485870361328,159.82027709960937,0.04,0.0,166.76907713119286,-0.037055134271712586,-0.03376273171304062,161.36338806152344,160.64356885637557,1.9611982365097393
2024-05-24,1,157.63999938964844,158.7724952697754,165.69750213623047,160.86687469482422,163.12124729156494,0.30188338012440424,1.6973206848891262,-0.32310842844365517,2.9956775606786645,161.91125106811523,1.399824790954591,0.01046593395868962,160.5480007171631,164.2497486114502,0.5259961498573744,-0.025666612239547214,0.9720318838674291,0.9701251436781002,0.9676835219722016,-0.04862778643432686,35.6797051865886,165.57039095779095,162.1757495880127,158.78110821823446,162.26999882289343,3.249390400393902,161.96499933515275,2.3271491341933803,161.94386159934328,162.21679987592978,-1.5684832085680984,-2.284829569886869,3689900,1.4781245373108822,0.7506288466956688,127943000.0,-93.08986563836838,73.63263747053657,76.71321854558761,-186.00710873008262,15.835222457654297,34.95486735707961,0.0058277723790246625,2.8659056832821648,164.09932434082032,162.62034362792969,161.4250030517578,160.22966247558594,158.7506817626953,0.06,0.0,166.71728604934822,-0.05624321807739141,-0.04435659286753175,160.41071210588728,160.24225616455078,2.1896851585682016
2024-05-28,1,155.49750137329102,157.63999938964844,165.69750213623047,160.7687530517578,163.12124729156494,-0.021266854099771706,1.9515543981124075,-0.13383157355009168,2.9956596209327615,161.57250213623047,1.559499912261964,0.012053328406216968,160.15174980163573,164.2497486114502,0.6225488923993776,-0.01662456511309023,0.9603946742203467,0.9588120563047294,0.9640685139151842,-0.059585710261570335,34.370373813106006,165.81310845290207,161.90999965667726,158.00689086045244,161.09428514753068,4.029423651811537,161.43285642351424,2.8729755847976097,160.8619418843081,161.52129987662195,-3.3461559961482896,-3.4024245244879405,5533500,1.3825824392093964,1.1335724689489026,122409500.0,-88.91548291479177,73.63263747053657,76.71321854558761,-228.8213216683041,14.615065631416426,38.23250055371195,-0.047579338059458486,2.8833432592394623,163.5305634765625,161.6997222290039,160.22000122070312,158.74028021240235,156.90943896484376,0.08,0.0,166.6227047739293,-0.05602822119554174,-0.06657852808256108,159.13528442382812,159.73194340297155,2.624351995849991
2024-05-29,1,154.93499755859375,155.49750137329102,165.69750213623047,160.7687530517578,163.12124729156494,-0.6671970047811456,2.382853335740003,0.5712145033462668,2.9956232837728574,161.57250213623047,1.775837364196778,0.014739029301348957,158.65924568176268,164.2497486114502,0.6586133717421153,-0.0381350086027572,0.9583432746654403,0.958882271352274,0.9724615069993807,-0.0560082932173519,27.584785047092964,166.43533138156303,161.669624710083,156.903918038603,159.5567844935826,4.033554861546048,160.97535651070731,3.357942521279589,159.52795682674486,160.6645169001727,-5.026642362016134,-4.572025140165059,4254500,1.4037554265317218,0.8826845893789464,118155000.0,-91.3348985190294,73.63263747053657,76.71321854558761,-192.92053951130927,13.632931773394866,36.33528131559787,-0.09904394938281603,2.8702466330236494,163.46684246826172,161.59658059692381,160.08499908447266,158.5734175720215,156.7031557006836,0.1,0.0,166.5493815364609,-0.04996009672055912,-0.059370495457980565,157.48897879464286,159.33133806501115,3.004890718847283
2024-05-30,1,155.24249649047852,154.93499755859375,165.69750213623047,160.62187576293945,163.12124729156494,-0.7462018791390562,2.7986781392192737,0.10759788280813476,2.9955811380610564,161.4112491607666,2.094175014495849,0.01734718756580756,157.4257495880127,164.2497486114502,0.7410486462012158,-0.04455477488663591,0.9622473792416175,0.9645866074174633,0.9857667928396375,-0.033208807392960504,25.782639527688243,166.9306057520103,161.33324947357178,155.73589319513326,158.1128556387765,3.3683484556440866,160.5899990626744,3.6925876492644356,158.38490117491315,159.8367607645976,-6.495272673928529,-3.9698766113041395,4311100,1.3909849061642912,0.90252873851977,122466100.0,-78.8536409516943,73.63263747053657,76.71321854558761,-149.93456224116542,12.665428958937554,34.00562540287419,-0.029079059983310934,2.8687996318721507,163.44324462890626,161.55838409423828,160.03500366210938,158.51162322998047,156.6267626953125,0.12000000000000001,0.0,166.47911573942906,-0.020675474139569494,-0.04063093303734463,156.32113429478235,159.04185485839844,3.186309514082174
2024-05-31,1,158.93249893188477,154.93499755859375,165.69750213623047,160.12437438964844,163.12124729156494,-0.6029702666707284,3.0876621384522633,-0.49123529607007566,2.995547608695039,161.32124710083008,2.3888875007629395,0.019179529772245366,155.47200088500978,164.2497486114502,0.8138375197897965,-0.03507164676583449,0.9872357979456328,0.9923574766171046,1.0160787696224647,0.0010077542828657027,28.245482510176867,167.16269858262962,160.9873743057251,154.81205002882058,157.37071282523019,2.187657844880454,160.45571299961634,3.7179707656209384,157.60148057128293,159.19226446715612,-6.112792305362193,-3.3584961461910483,15664400,1.3822673180468013,2.9753670440547837,138130500.0,-40.66613873556562,73.63263747053657,76.71321854558761,-31.51370575326832,23.2457606224922,29.676362532394688,0.08674842857032294,3.052475731915055,163.44324462890626,161.55838409423828,160.03500366210938,158.51162322998047,156.6267626953125,0.12000000000000001,0.0,166.32667124634244,0.018829817159478512,0.010212363046124712,156.0819048200335,159.076536996024,3.1871864188193095
2024-06-03,1,160.5525016784668,154.93499755859375,165.69750213623047,158.89249801635742,163.12124729156494,-0.5047682484925415,3.120052634902009,-0.6534459052829269,2.9955435977347755,161.32124710083008,2.496274967193602,0.019392488631338634,155.47200088500978,164.2497486114502,0.8577000947822804,-0.0218635668838498,0.9979038586412918,1.0054829611222866,1.0262257339429124,0.018475655291138038,44.093503700313875,167.1298546060467,160.8897493362427,154.64964406643867,157.36749867030554,2.1821750571730973,160.38928440638952,3.7065044677288177,157.9378942075657,159.2654237096877,-3.1652220001474025,-1.169066358781909,4467800,1.5955556198640886,0.8599215873461917,142598300.0,-48.799390121384754,73.63263747053657,76.71321854558761,-0.4011517147595801,24.463995165035808,26.738250712747398,0.03018872256317688,3.1458792229064105,163.44324462890626,161.55838409423828,160.03500366210938,158.51162322998047,156.6267626953125,0.02,1.0,166.2910810884842,0.019928740836461678,0.01219520620021743,156.16400800432478,158.9993896484375,3.1181443375163433
2024-06-04,1,161.22750091552734,154.93499755859375,165.69750213623047,158.89249801635742,163.12124729156494,-0.42843878509176514,3.099005894155591,-0.6518188688339008,2.9955460060109296,161.0575008392334,2.4353127288818373,0.01927324881532745,155.47200088500978,164.2497486114502,0.8516917295509792,-0.016177210180426876,1.0027014620651709,1.0129741746629028,1.026717495352435,0.03684946376392739,49.37539972472209,166.99113617795962,160.79312438964843,154.59511260133723,157.7182137625558,2.6024322673850513,160.38392748151506,3.7051370383174307,158.59074003432445,159.54243261635997,-0.014011573635843953,-0.5759139806181514,4215500,1.6350022170355698,0.824203486661316,146813800.0,-33.69484794402354,73.63263747053657,76.71321854558761,25.247345528260816,22.771164016191214,24.88804826761097,0.05638314752250226,3.138315275701925,163.44324462890626,161.55838409423828,160.03500366210938,158.51162322998047,156.6267626953125,0.02,0.0,166.2629097892076,0.043774920214669555,0.032344287256394745,156.71324811662947,159.03831808907645,3.1012828329327817
2024-06-05,0,164.11999893188477,154.93499755859375,165.69750213623047,158.89249801635742,162.98500061035156,-0.3760069611627661,3.052174338740356,-0.578056986713972,2.995551439218957,161.0200023651123,2.3468877220153814,0.01899360107457092,155.47200088500978,164.2497486114502,0.8472700942139237,-0.010555554385026025,1.0213144604831839,1.0338251427169725,1.037565273616686,0.059282934895438455,51.878096651013074,166.79922305949975,160.69487438201904,154.59052570453832,158.64392798287528,3.549977238897945,160.45696340288436,3.7722123920964163,159.2411506826994,159.86581751663533,1.5462411430774423,-0.04649459818379707,5100500,1.6447384632401463,0.9992016965173398,151914300.0,-8.13325138581914,73.63263747053657,76.71321854558761,103.99785541552578,27.91423981763087,22.746879249442156,0.11161817783241772,3.1884394497658683,163.44324462890626,161.55838409423828,160.03500366210938,158.51162322998047,156.6267626953125,0.04,0.0,166.25045547667602,0.06880298273662988,0.06501872479478461,157.89949471609933,159.1551034109933,3.252758227243059
2024-06-06,0,166.82250595092773,154.93499755859375,165.69750213623047,158.89249801635742,163.25499629974365,-0.365555109819869,3.1056704012786103,-0.6550747587429968,2.9955451860437536,161.0200023651123,2.3996500778198255,0.019319457531643033,155.47200088500978,164.2497486114502,0.821119096953235,0.017230709415488304,1.0377534968663555,1.0508537467198875,1.0425429277708054,0.07459303813218088,61.68358949790926,166.96484002435898,160.75349922180175,154.54215841924452,160.26178577968054,4.364266272723471,160.6780354636056,4.058458816815389,160.4512304463702,160.57296069902142,4.110631544865283,0.6269274047989207,5186700,1.7309800137198321,1.0233053668930616,157101000.0,-2.0261274298120777,73.63263747053657,76.71321854558761,152.2280213730102,31.47149350283513,20.505653129946896,0.19253413622466026,3.2842723918704286,165.26920416259765,163.03540371704102,161.2300033569336,159.42460299682617,157.19080255126954,0.06,0.0,166.25781446181824,0.07843391849909631,0.08902388057593048,159.7722909109933,159.45378766741072,3.6723167239393284
2024-06-07,0,169.1374969482422,154.93499755859375,166.82250595092773,158.89249801635742,163.82562255859375,-0.23852658469877167,3.3755721074782605,-0.7595193239871807,2.9955121538785554,161.0200023651123,2.6678750991821287,0.020962689561593133,155.47200088500978,165.38474884033204,0.78524879602369,0.03850287235927427,1.0503632358781543,1.0612598793135881,1.0419297337708815,0.06420963670074231,68.15325891613065,167.77876891741013,161.0276247024536,154.27648048749708,162.29071426391602,4.758652488394464,160.9237493787493,4.469093281987278,162.03552004230278,161.5794979734339,7.283078170143482,1.890341515568166,3781700,1.808357258575515,0.7445522487970452,160882700.0,-5.489251017177069,73.63263747053657,76.71321854558761,166.1572936896977,32.92470735700747,19.34988795055187,0.21709703743121897,3.231820884144093,166.38463763427734,163.9376784362793,161.95999908447266,159.982319732666,157.53536053466797,0.08,0.0,166.27317981622065,0.05073176098529664,0.08387177811152646,161.843266078404,159.66612243652344,4.08495316199362
2024-06-10,0,169.47500228881836,154.93499755859375,169.1374969482422,158.89249801635742,164.12187385559082,-0.01920290312007576,3.8071976272123447,-0.6523553582580699,2.995454141816889,161.26499938964844,3.0488875579833974,0.023580896493485038,155.47200088500978,165.81000251770018,0.7776058750231616,0.05176831985115867,1.0496887418297578,1.056506515194714,1.0310454419021067,0.05557372521183357,72.03202598076673,169.06701976614343,161.45262451171874,153.83822925729405,164.32392937796456,4.25964622503646,161.21839250837053,4.898690352174772,163.8094509570036,162.74784359597803,9.166747096166763,2.0760692030127768,4247500,1.8613414227950844,0.8302287307029237,165130200.0,-1.6889535064558814,73.63263747053657,76.71321854558761,146.93897857158103,31.599031288038002,18.036160840559837,0.2583003219539822,3.219546985984504,166.6978804321289,164.1910606994629,162.16500091552734,160.1389411315918,157.6321213989258,0.1,0.0,166.29288550799228,0.0641113500779753,0.057181866167909975,163.84629603794642,160.08371516636439,4.512229005763814
2024-06-11,0,169.00249862670898,154.93499755859375,169.47500228881836,158.89249801635742,164.433123588562,0.02652442602904324,4.183849436548028,-0.7898162900194117,2.9953982998133184,161.39249992370605,3.4583251571655267,0.025844457904041388,155.47200088500978,167.05400505065919,0.8187629075866804,0.0494945285526068,1.0439615544672942,1.0458447532322512,1.017128415694717,0.0482237686935012,72.30953503065061,170.25344830852086,161.8857494354248,153.51805056232874,165.76250076293945,3.812317543776253,161.56660679408483,5.279823993098743,165.23079174361618,163.68154336751653,9.167918656353717,2.4947105248040686,3790200,1.8606423372565863,0.7387908055611054,161340000.0,-17.763560728120698,73.63263747053657,76.71321854558761,110.31662155845173,29.341524706465474,17.346675893037293,0.2427060676747572,3.219579433293904,166.6978804321289,164.1910606994629,162.16500091552734,160.1389411315918,157.6321213989258,0.1,0.0,166.30482664703297,0.03429132204836005,0.046881703519612454,164.76075090680803,160.42132786342077,4.6670668454948
2024-06-12,0,166.8849983215332,154.93499755859375,169.47500228881836,158.89249801635742,165.43687438964844,-0.02839027402390996,4.45953985979918,-0.9965692149284839,2.9953544053015735,162.1999969482422,3.794000244140625,0.027483617549599843,155.47200088500978,169.0159984588623,0.8545711316391451,0.047736401264180085,1.0284925379815246,1.024181500130803,0.9950718810273826,0.01684742510141013,70.45157437721575,171.18082898717648,162.26174926757812,153.34266954797977,166.66714314052038,3.0438423036556324,162.01732090541296,5.4550825922778134,166.18825280384908,164.3573861715269,6.336023005049468,2.970251810811839,4725600,1.8667484820634586,0.9148733714659638,156614400.0,-27.140385317790756,73.63263747053657,76.71321854558761,67.57632777126202,27.07115238502943,21.273162132694594,0.20431123169113935,3.2403245380658454,166.6978804321289,164.1910606994629,162.16500091552734,160.1389411315918,157.6321213989258,0.1,0.0,166.30642919310662,0.003928856881358911,0.024361680122158377,165.59593418666296,160.87997109549386,4.727416654517531
2024-06-13,0,166.11499786376953,154.93499755859375,169.47500228881836,158.89249801635742,165.97875308990479,-0.15774535513940546,4.564241274373513,-1.1054979353345,2.995337333292293,163.41249656677246,3.9492876243591297,0.028080575389406677,155.47200088500978,169.0159984588623,0.8922660816728916,0.02322232027436304,1.0219890756027072,1.0120339403247782,0.987225454222259,-0.004241082958952314,61.00351938015257,171.66935683921335,162.54087429046632,153.4123917417193,167.36535699026925,1.9533089288002632,162.54178537641252,5.4720564300820165,166.38140258245082,164.6447715696877,3.9441905774525323,3.9296263606495905,3690800,1.9172012897685355,0.7255670581389405,152923600.0,-24.403045359576915,73.63263747053657,76.71321854558761,56.595527123663885,25.902754383059772,20.423152129638453,0.2045980643539762,3.144581616944049,166.6978804321289,164.1910606994629,162.16500091552734,160.1389411315918,157.6321213989258,0.1,0.0,166.30566195109094,-0.011923803054451398,0.0067698085452497555,166.22161647251673,161.46743229457311,4.79871167361376
2024-06-14,0,167.57500076293945,154.93499755859375,169.47500228881836,158.89249801635742,166.29187488555908,-0.22604599244388676,4.629553077253635,-1.1693192995113766,2.9953264331759635,163.92374801635742,4.08507520675659,0.02845597945094873,155.47200088500978,169.0159984588623,0.902509102520901,0.014582161244846568,1.0300153597184203,1.0142107568164558,0.9967404932653211,-0.00923802358137582,57.802707996941784,171.95085553652632,162.69174938201905,153.4326432275118,167.85892868041992,1.3353404758747207,163.2514283316476,5.431529519632804,166.32840880516238,164.66066149553052,3.0314288322331038,4.624543175137647,4377600,1.9261162861028185,0.8628261023817596,157301200.0,-12.580104207675962,73.63263747053657,76.71321854558761,79.0455417053458,29.30449636851077,18.923265707572558,0.20451197283348435,3.151397939846244,166.6978804321289,164.1910606994629,162.16500091552734,160.1389411315918,157.6321213989258,0.1,0.0,166.31533870166166,-0.004899000103708029,0.00011866434916441207,166.66751970563615,162.28350721086775,4.955595327089103
2024-06-17,0,168.9599952697754,154.93499755859375,169.47500228881836,158.89249801635742,166.8381290435791,-0.2774069406059651,4.7470435030285625,-1.2529516056504755,2.9953063457215507,164.12374877929688,4.258212871551512,0.02914368429521561,155.47200088500978,169.0159984588623,0.8902138860935944,0.011330880686211993,1.0373017979552797,1.0172721021543294,1.0068499629042766,-0.0030388376579886245,60.32728180147852,172.37821157118165,162.88412456512452,153.3900375590674,168.16428429739815,1.3028357730544098,164.21303503853935,5.136883197363056,166.65234905690437,164.78326445190427,2.1051680803925836,6.302335328442919,4076000,1.9036492057485295,0.8119926291149958,161377200.0,-6.2318429722026965,73.63263747053657,76.71321854558761,92.07800671938324,29.91607802884185,17.616026352899844,0.18034586039182837,3.143440104945404,166.6978804321289,164.1910606994629,162.16500091552734,160.1389411315918,157.6321213989258,0.1,0.0,166.33083069914062,-0.004575964451764558,0.0015346243483368223,166.82464599609375,163.29846845354353,5.118954659932438
2024-06-18,0,171.1699981689453,154.93499755859375,169.47500228881836,158.89249801635742,167.05749893188477,-0.26693102010220926,4.894677511249464,-1.3122077242819077,2.9952803543504434,164.12374877929688,4.405025062561035,0.030019994416409786,155.47200088500978,169.0159984588623,0.8840673935764417,0.021832457387166514,1.0498183746485275,1.0253875745297005,1.0206460655474805,0.012825251459884557,63.97240831372536,172.8366042443007,163.04724922180176,153.25789419930283,168.45464161464147,1.7166492420513473,165.37267793927873,4.6947511615946045,167.2293157565117,164.96632114014187,1.2812955342347014,8.657691459727054,4250900,1.9214961858455584,0.8368967743967743,165628100.0,-8.491994433641912,73.63263747053657,76.71321854558761,114.38134779590769,33.56778571407775,16.288631424674687,0.20171268508503065,3.1567665017615165,168.42451623535158,165.5877373046875,163.2949981689453,161.00225903320313,158.16548010253905,0.12000000000000001,0.0,166.35966906946803,0.02182474476244778,0.005279785256512465,167.0992671421596,164.47126661028182,5.421862862366571
2024-06-20,0,171.5349998474121,154.93499755859375,171.1699981689453,158.89249801635742,167.92124938964844,-0.2051298708686202,5.18719642629572,-1.33607317087292,2.9952267702686086,164.12374877929688,4.666925048828125,0.03175738965915114,155.47200088500978,169.1712474822998,0.8734664936731991,0.04290871183173128,1.0501826772399419,1.0214900919231726,1.0201854503590928,0.027863508240086654,69.7089333484719,173.71264205913442,163.33824920654297,152.9638563539515,168.74892698015486,2.0624642026677935,166.5364281790597,3.950873131604058,168.2058064803781,165.43518496423636,1.2016857629890854,10.4785883539397,5847500,1.9414583786908715,1.1267999171399805,171475600.0,-5.2349182143311,73.63263747053657,76.71321854558761,104.16787753202341,31.430848891955293,15.251691527302473,0.2520214424154723,3.130567394026957,169.04283508300782,166.58857543945314,164.60499572753906,162.621416015625,160.1671563720703,0.12000000000000001,0.0,166.40066707361223,0.03636589354162467,0.02641633483604055,167.3356672014509,165.59098161969865,5.738221676016207
2024-06-21,0,171.40249633789062,154.93499755859375,171.5349998474121,158.89249801635742,168.9706211090088,-0.20961854764400512,5.48616618415867,-1.3918235950393663,2.995169268526591,165.11749839782715,5.000262603759765,0.033511772569731285,155.47200088500978,169.64450187683104,0.8896845633390245,0.06825470361138689,1.0469973534059942,1.0162138105395495,1.0137900525674228,0.03183034971024923,74.33617067460254,174.68095663589548,163.70862426757813,152.73629189926078,169.09178379603796,2.2977100087809275,167.4271422794887,3.482636681672534,169.01560541884734,165.9562455065254,1.2155170560689024,10.494873327377121,12308100,1.707831908215628,2.2543814742194304,159167500.0,-18.47670289465189,73.63263747053657,76.71321854558761,86.72353860487445,29.04690328089056,15.071388164884155,0.2243606519731448,3.145527145602995,169.66351623535155,167.5932373046875,165.9199981689453,164.24675903320312,162.17648010253907,0.12000000000000001,0.0,166.4739591122481,0.022994707532093983,0.02588961238176924,167.7164568219866,166.23860386439733,5.804199421953025
2024-06-24,0,171.99500274658203,154.93499755859375,171.5349998474121,158.89249801635742,169.03624820709229,-0.3429413575146372,5.68099782673939,-1.3616092402755389,2.995131562354759,166.46875190734863,5.133000087738037,0.03458750599527919,155.47200088500978,171.19324798583983,0.8918090161223923,0.07954778972677351,1.0471537518735201,1.0169652127448547,1.0109711464586042,0.026376261157804448,75.96604903943852,175.61199469980446,164.24999904632568,152.8880033928469,169.82178442818778,2.2914805763396586,168.24446378435408,3.0625067785934803,169.59335413962202,166.57291254926972,1.4200959930673756,7.846096606931378,6249900,1.6240332916676485,1.1387295401189945,165417400.0,-4.9120102560545735,73.63263747053657,76.71321854558761,95.75892490179774,28.142318178265164,14.034830084645815,0.2809781719341109,3.1365609248349515,170.19096380615235,168.19952389526367,166.59000396728516,164.98048403930665,162.98904412841796,0.14,0.0,166.520893695058,0.024615957666606736,0.03710376408231454,168.6578107561384,167.12687247140067,5.874934137369233
2024-06-25,0,171.72000122070312,154.93499755859375,171.99500274658203,160.1475009918213,169.22187328338623,-0.5083219824075561,5.773712088615542,-1.1889628280476847,2.9951155190803656,166.85375213623047,5.114150009155276,0.035011052825672864,155.47200088500978,171.41574668884277,0.8795385371915694,0.09106193486750437,1.0412881594524166,1.013626596840078,1.004137140576828,0.016335262950977647,78.60370910531894,176.4585485973971,164.911124420166,153.3637002429349,170.622499193464,1.6773118771995408,168.99392809186662,2.432222141451649,170.1791725492912,167.28658091950788,3.0619914770310923,7.1269528338030845,5712700,1.568283638458013,1.0220184717221639,159704700.0,-23.64447699652778,73.63263747053657,76.71321854558761,81.58659560876912,26.33997143867236,13.319625731787678,0.24346739818715377,3.1118064110900168,170.75500366210937,169.11250366210936,167.78500366210938,166.4575036621094,164.81500366210938,0.14,0.0,166.55807745613228,0.006306059801659325,0.012812128304510482,169.25093296595983,167.73627471923828,5.660618584458987
2024-06-26,0,170.9849967956543,154.93499755859375,171.99500274658203,161.0587511062622,169.8987512588501,-0.7111648937915821,5.702167338573347,-0.8673727302441088,2.9951344584049706,167.22999954223633,4.879837570190427,0.03443023308037224,155.47200088500978,171.55349998474122,0.8518382334479095,0.10432643421367903,1.0324238036819855,1.0079523089889155,0.9966222448712511,-0.0010808049031374445,80.21219349387704,177.01945918886545,165.61512451171876,154.21078983457207,171.10964148385185,1.0052574587572007,169.48428508213587,2.0333191607996985,170.54834992916793,167.89403826640546,3.3741705619683073,6.50788497346564,5576100,1.436564705031015,0.9972003422896747,154128600.0,-24.94492687231792,73.63263747053657,76.71321854558761,73.39603034681708,24.98134953227591,13.734534435111692,0.2310077298474538,3.0466763667914245,171.27184423828126,169.94908459472657,168.8800048828125,167.81092517089843,166.48816552734374,0.14,0.0,166.591174057499,-0.0012255545099471021,0.008663367796767834,169.61331612723214,168.14041791643416,5.186898289870738
2024-06-27,0,169.89749908447266,154.93499755859375,171.99500274658203,163.3968744277954,171.03124713897705,-0.9222466325520228,5.313992622282692,-0.3677823020560136,2.9952170423407365,168.26749801635742,4.360150260925295,0.03193706721389738,158.56349868774413,171.55349998474122,0.8179705266763712,0.10359182553955064,1.0210830600293632,1.0003724240041325,0.9904971487896935,-0.009546161217221405,76.18562529575094,177.0174845274023,166.3894992828369,155.7615140382715,171.24357060023718,0.681420898257353,169.70392744881767,1.8842935306366206,170.6473723615921,168.3911134374671,2.0349073651736433,4.1829136658834205,5382000,1.4460011502455579,0.9528817502430008,148746600.0,-52.556435722605855,73.63263747053657,76.71321854558761,40.349930553150195,22.789077936241206,18.057189462093955,0.21876624541568704,3.101200775846224,171.42524279785155,170.19738226318358,169.2050018310547,168.2126213989258,166.98476086425782,0.02,1.0,166.610530388069,-0.018242036967522357,-0.013830487784713621,169.51564461844308,168.17014530726843,4.381638130141944
2024-06-28,0,170.5950050354004,155.24249649047852,171.99500274658203,165.61624813079834,171.03124713897705,-1.0884680050911615,4.66195764703782,0.18088961624246158,2.9953391628364883,168.9812469482422,3.720349578857423,0.027892927549458338,160.3905014038086,171.55349998474122,0.7659358882333792,0.09440071452917517,1.0206858311497873,1.0027008250999963,0.9964661553483862,-0.004711082508964237,69.168861693966,176.4615396532065,167.13762435913085,157.8137090650552,171.16142872401647,0.725028737123985,169.80803516932897,1.890843225277961,170.45539017859107,168.69029576428383,0.5548673301040108,1.8432723546602623,24463400,1.505602712204301,3.675531439380565,173210000.0,-22.473229092202235,73.63263747053657,76.71321854558761,62.38413274764992,21.89691019050238,16.87275467149842,0.2999570531183458,3.08182893874074,171.42524279785155,170.19738226318358,169.2050018310547,168.2126213989258,166.98476086425782,0.02,0.0,166.73622632568703,0.006631882616165763,-0.003543827229632991,169.53829520089286,168.31878117152624,3.6018171613498176
2024-07-01,0,171.26499938964844,158.93249893188477,171.99500274658203,166.64562892913818,171.03124713897705,-1.03775481066821,3.8298264990299846,-0.04639187095368236,2.995470017146484,169.0699977874756,3.101199493408205,0.022809450591346068,161.16000099182128,171.55349998474122,0.7801458988535848,0.07338024747546402,1.0200097948548128,1.0039951101047915,1.0013242539650005,-0.0042443288774453025,68.59368841297237,175.5649027844369,167.90524978637694,160.245596788317,171.12285723005022,0.7088437998424454,169.93589210510254,1.9267692295048735,170.49592776421602,169.08922592749775,-0.3359193431651509,0.8617297249019924,5194500,1.3393900871517022,0.8470789677524563,178404500.0,-39.527115265654,73.63263747053657,76.71321854558761,69.91554596793179,24.3960080888118,15.223580016713807,0.1904703873897685,3.171701213234774,171.78432373046874,170.48784301757811,169.44000244140625,168.39216186523439,167.09568115234376,0.02,1.0,166.76490735079892,-0.013720086068006676,-0.00011739684825160485,169.28915405273438,168.31241062709265,3.2319224849338926
2024-07-02,0,167.1675033569336,160.5525016784668,171.99500274658203,166.86937522888184,171.1937484741211,-1.138083571324246,3.2903233228385087,0.3518272786585328,2.995540215037393,169.30624961853027,2.635561923980711,0.019524606681254476,163.83074913024902,171.55349998474122,0.7457468267672677,0.06672270814337859,0.9919632305665692,0.9778593700225009,0.9782026891666388,-0.026511168363657522,69.41359024508009,175.10252145494218,168.52187480926514,161.9412281635881,170.51785823277064,1.6339735268882762,169.8048210144043,2.0534015620056434,170.6945846895585,169.48183697715757,-0.15740254642134205,1.0562012548491222,5965500,1.318463897181502,0.961071412173249,172439000.0,-89.18911952711527,73.63263747053657,76.71321854558761,-67.49084706664955,21.795243091111757,22.46282743345554,0.1690698088070465,3.296582256998254,171.78432373046874,170.48784301757811,169.44000244140625,168.39216186523439,167.09568115234376,0.02,1.0,166.76429406971323,-0.028052711971084054,-0.03924978522668001,168.66205705915178,168.1892569405692,2.6453008068885957
2024-07-03,0,165.13750076293945,161.22750091552734,171.99500274658203,167.0968770980835,171.1937484741211,-1.0891173726018641,2.7627889256057467,0.7195132155292003,2.9955975960030394,169.30624961853027,2.205586814880371,0.016362131932230316,165.91549797058104,171.55349998474122,0.6188116479539605,0.03684236502877026,0.9779978301634392,0.9669986404259536,0.9714999238236499,-0.03419888377518432,48.23467452824952,174.37820274439997,168.85262489318848,163.32704704197698,169.53821509225028,2.4517885556104844,169.67999976021903,2.2846366923428967,169.82763931649362,169.26151561124667,-2.4707883907410944,-1.0857799646078072,3527600,1.6787414559355471,0.5714804122642457,168911400.0,-96.91127368168341,73.63263747053657,76.71321854558761,-141.78517236902908,20.114881263453395,24.88735973431499,0.12745106750409163,3.3168269171870133,171.43504473876953,169.9224846496582,168.70000457763672,167.47752450561524,165.9649644165039,0.04,0.0,166.75602471297358,-0.04271104134767323,-0.0404685576680013,167.4021998814174,168.0300053187779,2.435996128836187
2024-07-05,0,165.72750091552734,164.11999893188477,171.99500274658203,167.0968770980835,171.1937484741211,-0.5232833240451092,2.319000642918333,-0.888168573359224,2.9956379504768855,169.30624961853027,1.9648124122619635,0.013717990924112484,166.01724815368652,171.55349998474122,0.5781885824017726,0.006199743100638116,0.9803569310675306,0.9738937560657822,0.9817252834803907,-0.024544199834701463,38.63408620720676,173.68612617139573,169.04812488555908,164.41012359972243,168.68214362008231,2.6044495898584934,169.65232140677315,2.3329846503847538,168.67497169415364,168.83286539496206,-3.9870355964623245,-1.0471268095811042,5978300,1.6399966865397921,0.9616625084651974,174889700.0,-63.99618235724711,73.63263747053657,76.71321854558761,-107.72614132831568,18.98184981040711,22.930320203309833,0.14364149283466732,3.3427678102815297,171.43504473876953,169.9224846496582,168.70000457763672,167.47752450561524,165.9649644165039,0.04,0.0,166.75106760022422,-0.010296499454443664,-0.022786953773244873,166.90675136021204,168.07884216308594,2.326572512915824
2024-07-08,0,166.5999984741211,165.13750076293945,171.99500274658203,167.0968770980835,171.1937484741211,-0.3433815253856408,2.1698639892953318,-1.2584079793947436,2.9956498484370813,169.30624961853027,1.8763998031616211,0.01282967678121131,166.0762481689453,171.55349998474122,0.6756498291028183,-0.006563892738324502,0.9850498200430546,0.9823735756806362,0.9917935723771706,-0.023418074640874087,38.29702599499322,173.46822796333188,169.1284999847412,164.78877200615054,168.0557152884347,2.4827489628251738,169.58267838614327,2.4129480540406782,167.94858477183755,168.51411081554505,-3.489692675621357,-0.23327029661702955,3500200,1.5241586520688124,0.5707804814013654,178389900.0,-71.04247274848186,73.63263747053657,76.71321854558761,-85.31103067861417,19.006838532621,21.873276596783487,0.1050378900826832,3.2539975860856822,171.43504473876953,169.9224846496582,168.70000457763672,167.47752450561524,165.9649644165039,0.04,0.0,166.75052073097888,-0.029151185334717722,-0.014616299915856563,166.25134495326452,167.93233054024833,2.3974269054847817
2024-07-09,0,167.1150016784668,165.13750076293945,171.99500274658203,167.0968770980835,171.1937484741211,-0.34107915387802745,2.1821942004227783,-1.2767728913897525,2.995648898167126,169.30624961853027,1.8886377143859874,0.012903429972487994,166.0762481689453,171.55349998474122,0.7588136792860048,-0.01500257790203431,0.988159862716406,0.9882087937924324,0.9996141937190656,-0.024231440901359536,39.830142379655165,173.48176301174644,169.11737461090087,164.7529862100553,167.6582156590053,2.3583534980755907,169.45089312962122,2.4984408856166276,167.6121530290042,168.32862315573908,-2.5645515125363625,-0.5818303949749938,4224600,1.4375494274932397,0.6864301440421159,182614500.0,-56.2741456330556,73.63263747053657,76.71321854558761,-60.45861921016519,19.25144133018412,20.127078543372207,0.12144929082162341,3.2837123892663223,171.43504473876953,169.9224846496582,168.70000457763672,167.47752450561524,165.9649644165039,0.04,0.0,166.7525057106357,-0.013617373664261967,-0.020230885633189283,166.1182817731585,167.81696319580078,2.4063948599938145
2024-07-10,0,167.5374984741211,165.13750076293945,171.99500274658203,167.0575008392334,171.1937484741211,-0.22162191131834477,2.2253538894235176,-1.4265207331433993,2.995645506813856,169.23875045776367,1.987750244140625,0.013166508495085931,166.0762481689453,171.55349998474122,0.779997649507439,-0.013925361135736482,0.9912508331321632,0.993574334199468,1.0071415749918897,0.0022133196330478278,42.021124995142145,173.46695762625913,169.0162498474121,164.56554206856507,167.22142900739397,1.975911185400753,169.1914288657052,2.4947936908373625,167.4769114023129,168.16057668083343,-1.6377506561308521,-1.0919706693662754,3887800,1.4411524923903885,0.6335569419853286,186502300.0,-55.40545516405406,73.63263747053657,76.71321854558761,-42.542654514849175,18.250980981254042,19.081113013982268,0.1170408460465878,3.2163030975372746,171.43504473876953,169.9224846496582,168.70000457763672,167.47752450561524,165.9649644165039,0.04,0.0,166.75624276983456,0.013135695404186132,-0.013089161398855034,165.6398184640067,167.58905683244978,2.3887426109928565
2024-07-11,0,168.7825050354004,165.13750076293945,171.99500274658203,167.0575008392334,171.1937484741211,-0.10094592142106606,2.2453569252277368,-1.5011204316631177,2.9956438851548457,168.9812469482422,2.0414371299743665,0.01329247713467651,166.0762481689453,171.55349998474122,0.7935866940110217,-0.008668511794158548,0.9991897340281124,1.0034467607533435,1.014174710743976,0.02207254109830248,44.610794233424635,173.4100885071327,168.91937465667723,164.42866080622176,166.8667869567871,1.199406111103271,168.99482209341866,2.402653611673054,167.48075436443855,168.04936030014179,-1.7922603071788823,-2.122159101292348,3689500,1.4436232051670947,0.6017356473122909,190191800.0,-38.320472845690354,73.63263747053657,76.71321854558761,8.894476312769731,21.269146413088414,17.80368264812293,0.1639309237368456,3.2008526629538374,171.43504473876953,169.9224846496582,168.70000457763672,167.47752450561524,165.9649644165039,0.04,0.0,166.76685598986822,0.03704839215544009,0.023800932158561043,165.574702671596,167.43192836216517,2.382075379005185
2024-07-12,1,170.61000061035156,165.13750076293945,171.99500274658203,167.0575008392334,171.1937484741211,-0.08624966188968743,2.2454616259600932,-1.503233372746887,2.9956438711536597,168.8712501525879,2.044124412536621,0.013293962636632838,166.0762481689453,171.55349998474122,0.7972768415379654,0.0113701455070953,1.0100742525849908,1.0156415065292803,1.0206847021485577,0.02946101080298602,52.79311620465936,173.39929822903198,168.9083749771118,164.41745172519163,167.35857227870397,1.864568698969253,168.9382152557373,2.3503309522600038,167.79857698511887,168.24798618266715,-1.449504780950645,-1.6046257699362716,4133500,1.3876637422727716,0.6774202799981972,194325300.0,-34.74909161606179,73.63263747053657,76.71321854558761,49.07602193924226,23.37350553773766,17.09301822085786,0.16106982639011905,3.095791196182478,171.43504473876953,169.9224846496582,168.70000457763672,167.47752450561524,165.9649644165039,0.02,1.0,166.7854072764617,0.018116542828950477,0.03930663697654788,166.18622698102678,167.42414202008928,2.296996084382786
2024-07-15,1,168.68249893188477,165.13750076293945,171.99500274658203,167.1543779373169,171.1937484741211,-0.28050195612328294,2.2242937404484135,-1.4107170070381494,2.9956456475086597,169.42874717712402,2.0228748321533203,0.013154136266863103,166.0762481689453,171.55349998474122,0.7438218148410698,0.027059584049529177,0.9975627483165427,1.0037413479524009,1.0032921035310953,0.012500002862167792,60.7529852919965,173.54321257244956,169.09462509155273,164.6460376106559,167.8650005885533,1.6270645486478292,168.70160784040178,2.1794565433256325,168.50153257440078,168.7737334100323,2.0593100837712455,-0.4623595014490297,2395100,1.4227386478979784,0.39673416111206816,191930200.0,-56.467237054700405,73.63263747053657,76.71321854558761,-22.95851431265237,21.77720636580403,21.667072837794137,0.13153734054052896,3.0853771973469346,171.43504473876953,169.9224846496582,168.70000457763672,167.47752450561524,165.9649644165039,0.02,0.0,166.79049593416323,0.018337542955858765,0.013892762286183483,166.9978528703962,167.20002637590682,2.2129079168263375
2024-07-16,1,168.72750091552734,165.13750076293945,171.99500274658203,167.44499969482422,171.1937484741211,-0.3673058928361235,2.1202796907973824,-1.203134595384751,2.9956536552298583,169.42874717712402,1.8944997787475586,0.012529500652872984,166.51274871826172,171.55349998474122,0.7546780235469875,0.0066089700963930685,0.9970719155847214,1.0051530279166367,1.0010798269218748,0.00964903940917905,50.50487583861433,173.46355952655324,169.2230001449585,164.98244076336374,168.29357201712472,1.339982708155183,168.48785781860352,2.0000139530823646,168.55452284647777,168.97315768308744,2.1466948164816175,-1.9259302664612408,3829500,1.469730417251336,0.6372267200919857,195759700.0,-45.17381910088032,73.63263747053657,76.71321854558761,-19.032909530509198,20.45627053736429,20.72753812905068,0.12619841811244248,3.049993548990172,171.43504473876953,169.9224846496582,168.70000457763672,167.47752450561524,165.9649644165039,0.02,0.0,166.7992997486118,0.01609225630722788,0.025428259311761164,167.49391174316406,167.20033155168807,2.22592841636119
2024-07-17,1,172.50749969482422,165.13750076293945,171.99500274658203,167.44499969482422,171.1937484741211,-0.4423060857866173,2.090154588030546,-1.0722311489098537,2.99565590341231,169.42874717712402,1.836874771118164,0.01234727592804257,166.51274871826172,171.55349998474122,0.7733951494586639,-0.001376031964707547,1.019062279214338,1.0292272852851567,1.0215523301292508,0.029665007929378984,49.24986941098419,173.460934328649,169.2806251525879,165.10031597652682,169.13750076293945,1.8563767119563148,168.5966080256871,2.179572484537782,168.607187543937,169.0833494006156,1.8102004697030485,-1.7426626391235989,6983200,1.4361419137850255,1.1345581921674996,202742900.0,-3.846163451332959,73.63263747053657,76.71321854558761,131.91941312140344,30.31166817882255,17.792708426761916,0.1539597283662659,3.2992828934580998,172.85608520507813,171.07196502685548,169.6300048828125,168.18804473876952,166.40392456054687,0.04,0.0,166.85325966296892,0.05198096991103229,0.052544310379979975,168.96045139857702,167.60589817592077,2.767251809839579
2024-07-18,1,173.24749755859375,165.13750076293945,172.50749969482422,167.44499969482422,171.29937362670898,-0.4625776224139134,2.202902635667273,-1.0973904938181764,2.9956476035608484,170.24625205993652,1.9644494819641125,0.012999696861803292,166.51274871826172,171.74750137329102,0.6866483052016938,0.007813878250783108,1.0223624566346436,1.0303596021392556,1.019930864468309,0.02645411929546171,60.99395862250018,173.86380564517486,169.45800037384032,165.05219510250578,170.0135716029576,2.164327350342658,168.83589363098145,2.494514293519678,169.59264666778887,169.62348305286397,3.54591913253875,0.8904306972555486,5957800,1.5977045712601048,0.9547236208283523,208700700.0,-42.09725051683976,73.63263747053657,76.71321854558761,104.07262732889028,28.53770381398535,15.621902008236013,0.11258124840932829,3.489335316604445,173.57423541259766,171.6528771057129,170.0999984741211,168.5471198425293,166.62576153564453,0.06,0.0,166.89411544356543,0.016491868395671405,0.02719243544164033,169.6204071044922,167.86934443882532,2.8216221978616574
2024-07-19,1,172.7650032043457,165.13750076293945,173.24749755859375,167.44499969482422,171.435622215271,-0.3305262170402746,2.3266838281307867,-1.0868447347051262,2.995637982479567,170.24625205993652,2.057936954498291,0.013721739178808924,166.51274871826172,172.04625244140624,0.6929592059098816,0.009983371980674395,1.0188906135564813,1.0225579661315642,1.0117712726859993,0.012631162219592484,62.8535170666639,174.21524299958432,169.56187534332275,164.9085076870612,170.76035799298967,2.067264118267529,168.99089350019182,2.673242053005391,170.508259960089,170.1048437910873,3.669626196651106,1.971776213407051,4293600,1.6035275573359353,0.6967138298571474,204407100.0,-33.13061697275098,73.63263747053657,76.71321854558761,88.84039109114137,26.92888610648394,14.741214734322083,0.0839882355723077,3.4336684951164274,173.57423541259766,171.6528771057129,170.0999984741211,168.5471198425293,166.62576153564453,0.06,0.0,166.92134131844188,0.021276665012643914,0.023500565803704996,170.43619646344865,168.03800746372767,2.9198186371057484
2024-07-22,1,173.41500091552734,165.13750076293945,173.24749755859375,167.44499969482422,171.48187255859375,-0.2889373585633351,2.3933273396489962,-1.1281415438773545,2.9956325908815464,170.24625205993652,2.1132871055603033,0.014109655184237267,166.51274871826172,172.53325004577636,0.7282680268416712,0.007949165826436563,1.0223532009838363,1.0221475646383174,1.0130209295952792,0.028055678648403193,60.69805629260244,174.4100301904674,169.62337551116943,164.83672083187145,171.4221431187221,2.0700642286294917,169.1444650377546,2.8685548458481804,171.07091427907545,170.39932339463934,3.120199822627818,1.2720174125233112,4066900,1.6079833541440238,0.7072150050820917,208474000.0,-23.32822774110589,73.63263747053657,76.71321854558761,109.3671813215175,27.234650233136314,13.891610453837691,0.1521039561286382,3.3834057414646193,173.57423541259766,171.6528771057129,170.0999984741211,168.5471198425293,166.62576153564453,0.06,0.0,166.95141765178434,0.03320836678921757,0.02892197597570386,171.1857147216797,168.38020869663782,3.1409277512007705
2024-07-23,1,173.45750045776367,165.13750076293945,173.41500091552734,167.44499969482422,171.78875160217285,-0.21697745340155794,2.5056831269274213,-1.1673390407400395,2.9956231726682443,170.24625205993652,2.2038498115539538,0.01476328106809783,166.51274871826172,172.8132526397705,0.7289271497742519,0.008256043177240109,1.0219974764996884,1.0183076086099436,1.007697558546331,0.02803336454680494,62.26201422159719,174.73536699390613,169.72400074005128,164.71263448619644,171.82892881120955,2.161626598586859,169.59375054495675,3.023494949893118,171.6660549138415,170.686168241255,2.744654061838539,1.2553653890409882,2933800,1.6090142878546683,0.5253206034973624,211407800.0,-26.823722568070373,73.63263747053657,76.71321854558761,106.36252133045348,26.152496929481437,13.339635230472542,0.1130344446221,3.271732483749172,173.57423541259766,171.6528771057129,170.0999984741211,168.5471198425293,166.62576153564453,0.06,0.0,166.97313047826972,0.023345136048970927,0.030470720433156007,171.817143031529,169.0016850062779,3.2529943027023633
2024-07-24,1,174.7400016784668,165.13750076293945,173.45750045776367,167.44499969482422,171.9168758392334,-0.16503219971135538,2.5907873677909854,-1.196573495527158,2.9956157623357043,170.24625205993652,2.269662208557128,0.015258134425099002,166.51274871826172,173.2642478942871,0.7529948484574668,0.01011821118512238,1.0291104813149494,1.0220312305337729,1.0095996978754747,0.012941477834830462,62.75452438207648,174.97870036119232,169.79712562561036,164.6155508900284,172.69428634643555,1.8871581772988744,170.27964346749442,3.0239967624268043,172.1225983023198,170.96986422069452,1.6690110997158865,3.7626912973628426,6117700,1.6069426568019516,1.091466058165612,217525500.0,-3.6014283643030525,73.63263747053657,76.71321854558761,140.37037915064047,28.437881941651415,12.285337611262445,0.20174848890096103,3.298752437486127,173.6001955566406,171.69489733886718,170.15499877929688,168.61510021972657,166.70980200195314,0.06,0.0,167.02995766517898,0.005363167789652179,0.04143031851099467,172.98571559361048,169.99178423200334,3.6541722964930283
2024-07-25,1,179.27000045776367,165.13750076293945,174.7400016784668,167.44499969482422,172.5718755722046,-0.03215379308935374,2.7795875295046972,-1.161038779504844,2.9955984878472006,170.24625205993652,2.410624885559082,0.016355505651493216,166.51274871826172,173.41925086975098,0.7593753356621749,0.02196101969870573,1.0548512952037226,1.0441280509615565,1.0331076194759552,0.03476242360807014,67.66583765420705,175.50730070750797,169.94812564849855,164.38895058948913,174.20035770961218,2.345032646505732,171.24696486336845,3.572155144440817,172.77924426607237,171.38050908094453,3.5910677070465358,5.814851787851667,9442200,1.6154580314012577,1.6284329898151797,226967700.0,-18.541187959558826,73.63263747053657,76.71321854558761,217.58881714105286,37.95039060322971,9.211505322029668,0.23597972907783382,4.085275121933617,181.09500061035158,177.99250061035156,175.48500061035156,172.97750061035157,169.87500061035155,0.08,0.0,167.16618283496922,0.06445015086265116,0.03936779670386833,174.8385729108538,171.16624232700892,4.677742843479743
2024-07-26,0,184.3925018310547,165.13750076293945,179.27000045776367,167.44499969482422,172.88562679290771,0.6123146789867802,3.441746072731907,0.09068954225009751,2.9955290024469883,170.24625205993652,2.824875068664551,0.02020250102718647,166.51274871826172,173.58575057983398,0.6850593902126286,0.055165622942048305,1.0823546040078642,1.067442975639752,1.0553026272840154,0.0673023958038308,78.32625834713077,177.24586797706783,170.362375831604,163.47888368614016,175.8982151576451,4.3556488765778605,172.51785796029228,4.759462451386904,174.39941760872097,172.25141321150724,6.248240200934632,8.171546344103174,6948800,1.8501973949276291,1.182437347649819,233916500.0,-7.68532068776252,73.63263747053657,76.71321854558761,248.39611175615462,36.12000606308079,8.456727105468199,0.26578188939215835,4.132041862792665,181.66036480712887,178.44982400512694,175.8550033569336,173.26018270874022,170.04964190673826,0.1,0.0,167.30044853091792,0.07451251040009677,0.08192125933423909,176.25142996651786,172.60594068254744,5.767902139081781
2024-07-29,0,183.1599998474121,165.13750076293945,184.3925018310547,167.44499969482422,173.28937339782715,1.199501175677894,4.599105296264577,1.3939774797989877,2.9953746611750476,170.60250282287598,3.527587146759032,0.02688165617499301,166.51274871826172,175.1930015563965,0.6776942824722226,0.08087866812273407,1.070565647824789,1.051915192372678,1.0344808039449176,0.056194671051737144,83.8934215251172,180.28533656146226,171.0871259689331,161.88891537640393,177.31428691319056,4.9244367087150644,173.6639292580741,5.263501998956459,176.89383235606033,173.70884598568932,6.889556777099968,10.679774021545025,5458500,2.1200635334031355,1.1080031584737833,228458000.0,-23.67407117480127,73.63263747053657,76.71321854558761,173.883336946388,32.70993968807544,10.322025599144483,0.09503942633180917,4.2368970463740165,181.9553648071289,178.92732400512693,176.4800033569336,174.03268270874023,171.00464190673827,0.1,0.0,167.3934878487123,0.047981117457343014,0.05582633883648551,177.7942875453404,173.7073473249163,6.291868434225346
2024-07-30,0,185.17000198364258,165.13750076293945,184.3925018310547,167.44499969482422,173.42562580108643,1.021372228809615,5.294589391367961,0.28387356205469594,2.995261671540924,170.9375,4.151662425994874,0.030833519534814748,166.51274871826172,179.65900039672852,0.7969595706590097,0.06945377339301603,1.078354231346575,1.054689565406224,1.0344461637712925,0.0675237536282316,78.30359829838804,182.30455449226963,171.7153757095337,161.12619692679777,179.08642959594727,5.236622807641577,174.92339379446847,5.76999490312169,178.45071435060458,174.81268531242526,5.721584685785068,9.60117165292932,6032200,2.1648083955284108,1.214133966948553,234490200.0,-4.547713346843634,73.63263747053657,76.71321854558761,178.63929292508917,32.204818319392345,9.343245570590753,0.16512916441015607,4.346405282357503,182.88380383300782,179.89810205078126,177.48500061035156,175.07189916992186,172.0861973876953,0.12000000000000001,0.0,167.51359067080742,0.07871790564983239,0.07585967468834884,179.86000061035156,175.1480985369001,7.1514309075352
2024-07-31,0,185.66500091552734,165.13750076293945,185.17000198364258,167.44499969482422,173.77812576293945,0.8888100449854478,6.0490090550155475,-0.3368079237910626,2.9951228706647113,171.5587501525879,4.8018749237060545,0.035084897033295544,166.51274871826172,183.28325004577636,0.8127717728378127,0.10769137700328224,1.0768767876792766,1.047696974627625,1.0238135267471034,0.06252145548884269,84.85990956945761,184.5086439492645,172.4106258392334,160.3126077292023,180.83642959594727,5.069653306798267,176.12928635733468,6.140158278679809,180.1128392101985,176.00877352609413,7.180272942561345,10.524511628807154,6473900,1.8733824984626775,1.2964043947065673,240964100.0,-11.687031603955194,73.63263747053657,76.71321854558761,149.5959838778877,30.050842984730426,8.718335338055043,0.19989822788869704,4.3252335908758806,182.88380383300782,179.89810205078126,177.48500061035156,175.07189916992186,172.0861973876953,0.12000000000000001,0.0,167.63883512460697,0.05169967801626907,0.07028595932270186,181.5328587123326,176.35928671700614,7.485576156840403
2024-08-01,0,188.80500411987305,165.13750076293945,185.66500091552734,168.39624881744385,175.87250137329102,0.7052305868178685,6.568449076667099,-0.7923232341989013,2.9950203067723575,172.63625144958496,5.258600234985352,0.037894424682137336,166.51274871826172,184.4702518463135,0.8266947268231704,0.12430550333964313,1.0892460190711424,1.0575637367414894,1.0287335039699237,0.0531879491145304,87.73044016052668,186.4723988704973,173.3355007171631,160.19860256382887,183.02893011910575,4.647732113899854,177.42892946515764,6.774865100359149,181.49033098150278,177.24296839422053,7.0639794339170985,10.002515294216082,6595500,1.7424325705249895,1.2813937087269993,247559600.0,-5.314188739132701,73.63263747053657,76.71321854558761,159.76140701338952,32.914764619167144,7.922273149602308,0.24771060256051589,4.419859756877271,185.37443963623048,181.91277865600586,179.11499786376953,176.3172170715332,172.85555609130859,0.14,0.0,167.7910060689913,0.04138995784546928,0.07661312913926353,183.89857482910156,177.8578589303153,7.891111866430752
2024-08-02,0,190.1599998474121,165.72750091552734,188.80500411987305,168.7162504196167,180.24250030517578,0.6496617297217482,7.095707371273347,-0.939531504290168,2.9949125310314004,173.00625038146973,5.957037963867191,0.040658681390709266,167.06350135803223,185.21950187683106,0.815906995976733,0.139249690466934,1.0896242534401164,1.0559516571158194,1.0254612610845117,0.03127837606781725,89.65972212622997,188.71029062755645,174.51887588500978,160.3274611424631,185.23178700038366,3.6006076921272605,178.9630366734096,7.067344619932942,183.3231673983986,178.7844570937617,8.84799078829482,10.664675836369186,6303900,1.7968483590446434,1.2208792251632157,253863500.0,-17.33586787553633,73.63263747053657,76.71321854558761,140.14150307561687,33.6663732613934,7.012970904585974,0.1762591137606509,4.636299040737796,187.62060150146482,183.7297001647949,180.58499908447266,177.44029800415038,173.54939666748047,0.16,0.0,167.93939784158712,0.02230497700550993,0.039084345329928494,185.76714433942522,179.37642996651786,8.255393128923297
2024-08-05,0,186.03499603271484,166.5999984741211,190.1599998474121,168.76875400543213,183.46812534332275,0.5679449242654071,7.564689011206031,-1.1062910265024637,2.9948128746646425,173.33124923706055,6.643900318145754,0.04304465376740094,167.49524879455566,185.97900123596193,0.8331483711152466,0.14141657616491948,1.0585778187293042,1.0231625438920127,0.9970148489428795,0.015696637845041828,90.28652626547226,190.86987885401606,175.740500831604,160.61112280919195,186.1982149396624,2.461389165788288,180.19928632463728,6.640005281660126,185.03743453323526,180.20314275605782,8.824538182916545,12.732501030945787,6459300,1.795242766948241,1.2161280574767503,247404200.0,-39.13934208378691,73.63263747053657,76.71321854558761,84.77008625279215,30.50326943288377,11.495276283308172,0.1409345021724006,4.751563846483455,188.15160150146482,184.5892001647949,181.70999908447266,178.83079800415038,175.26839666748046,0.16,0.0,168.0598468988395,0.013301078028316926,-0.004320603996193885,186.0800018310547,180.45928737095423,8.064613118636705
2024-08-06,1,185.51000213623047,167.1150016784668,190.1599998474121,170.15312671661377,184.58687686920166,0.3916567937353541,7.576385313322712,-1.3533664390085942,2.994817867304301,173.4362506866455,6.895949935913086,0.04287413737815045,168.5679988861084,186.31199684143067,0.8753429502517482,0.1132154155175761,1.049785747119241,1.013242454533922,0.9911469519815447,0.0018361513687186193,72.89591742216592,191.86502133617913,176.7122507095337,161.55948008288826,186.35785784040178,2.358857625867314,181.12803649902344,6.385860319662913,185.28184649803387,180.77653996497284,3.7736350519757025,10.25766103526444,4273200,2.156502300042897,0.8041710303088471,243131000.0,-35.360052112805725,73.63263747053657,76.71321854558761,75.11487262454456,28.329378869920173,10.676037129750318,0.1159279575064506,4.750738246814766,188.43716308593747,185.05142272949217,182.31500244140625,179.5785821533203,176.192841796875,0.16,0.0,168.13851012360954,-0.005728622295870234,0.020721140056459364,186.1585736955915,181.2050018310547,7.930911489484332
2024-08-07,0,187.7449951171875,167.5374984741211,190.1599998474121,172.03312492370605,185.25500202178955,0.22485576323452425,7.471300848674936,-1.5006370598891514,2.9948501300252475,174.09875106811523,6.9479500579834,0.04206055675705314,168.72300071716307,186.31199684143067,0.8785125272108497,0.10727451362111344,1.0569322776474237,1.0187434486841558,1.0027238203603677,0.011202941811345957,70.87995790897233,192.57460242977177,177.6320007324219,162.689399035072,187.0128571646554,1.918330049486862,182.16357203892298,6.181848924880031,185.3352878840809,181.29203419190964,0.606044331563799,7.537354876981251,6351000,2.1800097637675515,1.1681170802406862,249482000.0,-28.206295577977887,73.63263747053657,76.71321854558761,86.31130253877205,29.351345005165815,10.044968942806564,0.07812307891073966,4.688541706542476,188.55516308593747,185.24242272949218,182.56500244140625,179.8875821533203,176.57484179687498,0.16,0.0,168.26845415206503,0.011817327304470382,0.003908318515418839,186.95428684779577,182.37428719656808,7.774520962591555
2024-08-08,0,188.73749923706055,168.68249893188477,190.1599998474121,172.70062732696533,185.5487518310547,0.07324812542028879,7.403928892765991,-1.5961100501115073,2.994873932237302,177.00500106811523,6.948874664306641,0.041445535357257035,168.7770046234131,187.85099601745605,0.867372031658015,0.11234867072158884,1.056510240868557,1.0169525718712416,1.0057900026621627,-0.00035753757230738703,73.57632628379042,193.45023335010717,178.6423755645752,163.8345177790432,187.5224996294294,1.8184273443006957,183.30446461268835,5.77433879165418,185.9391146720452,182.0360332068766,2.50327324393704,8.368084828290565,5744600,2.1982897652766376,1.0369856905866914,255226600.0,-15.875213336636524,73.63263747053657,76.71321854558761,93.14299256739858,29.363071593299193,9.456924128025495,0.09650871637556345,4.624360565134689,188.69204351806638,185.46398342895506,182.8550033569336,180.2460232849121,177.01796319580077,0.16,0.0,168.39437067633784,0.003637062665112323,0.02741197049155183,187.47142900739397,183.66571480887276,7.794202812057627
2024-08-09,0,189.95499801635742,168.68249893188477,190.1599998474121,173.12687397003174,185.75749969482422,-0.08479916816755703,7.3523725640570285,-1.6051244485879406,2.9948934119022868,181.2150001525879,6.89787483215332,0.04092834244473902,170.42175064086913,188.7442497253418,0.8738873344973417,0.1062510905683047,1.0574196478984217,1.018317972250101,1.0123509403028839,-0.0010780491755321142,74.30043980777629,194.34487040277224,179.6401252746582,164.93538014654416,188.13535635811942,1.8109694171887443,184.48589297703333,5.264877315139942,186.6386662540582,182.83365755309399,1.9266064779397216,9.245215024146207,3206500,2.1895973556762267,0.5837046907539284,258433100.0,-18.000953760556303,73.63263747053657,76.71321854558761,88.23143337281992,28.483323712939583,9.020289615079616,0.1259395469779289,4.501905054093546,188.69204351806638,185.46398342895506,182.8550033569336,180.2460232849121,177.01796319580077,0.16,0.0,168.46512119072585,0.003381052418766739,0.0011595907128181143,188.12999834333147,184.83142852783203,7.6496332723346985
2024-08-12,0,189.63249969482422,168.68249893188477,190.1599998474121,173.37312507629395,186.462495803833,-0.2511462009549309,7.373227408694859,-1.5135837678858115,2.994895751651743,183.7762508392334,6.86538724899292,0.040824619718751703,172.12949981689454,188.92000350952148,0.8456091136295583,0.12610969851153703,1.0499709634926149,1.0135666915108756,1.0108530895163241,0.01933777912128276,77.7495507500435,195.35382996234827,180.6073751449585,165.86092032756872,188.25357001168388,1.8873636882590175,185.64125006539481,4.354664607688599,187.4653246793095,183.61771424309288,2.3106116282960154,9.537812192433641,4808300,2.0817211776025046,0.8564807392919869,253624800.0,-16.870243705835843,73.63263747053657,76.71321854558761,80.48197908324,27.151815288889722,9.250156564969686,0.16692742209265354,4.385340833292835,188.69204351806638,185.46398342895506,182.8550033569336,180.2460232849121,177.01796319580077,0.16,0.0,168.5693625200661,0.03156862685051931,0.00470177727938901,188.1971391950335,186.0478570120675,7.28921680375429
2024-08-13,0,190.7775001525879,168.72750091552734,190.1599998474121,173.4468755722046,187.99312114715576,-0.38799260668390384,7.087293990839103,-1.43022347668128,2.994967032684094,184.78125190734863,6.510899658203124,0.03901515983920175,172.73925285339357,189.66474952697754,0.8322627175403333,0.1238979933079366,1.0502195438481183,1.0161711739130304,1.0130711215585186,0.028394684683843652,76.35585069540157,195.82946316478373,181.65487518310547,167.48028720142722,188.3417843409947,2.002253997078071,186.78678567068917,3.230773580068039,188.01038717895176,184.35045763552998,0.4382805311800908,9.325050340500615,3477300,2.0932910431338554,0.6213447549411141,257102100.0,-12.121247673397066,73.63263747053657,76.71321854558761,90.62481980668751,28.28479754775689,8.85262984449226,0.16424640193702594,4.254958843411296,188.69204351806638,185.46398342895506,182.8550033569336,180.2460232849121,177.01796319580077,0.16,0.0,168.6489908360346,0.029723702622965087,0.03726402199199022,188.47428240094865,187.12071337018693,6.913059989318493
2024-08-14,0,191.9550018310547,172.50749969482422,190.7775001525879,174.41937637329102,188.75437545776367,-0.4723262019980499,6.69473628985394,-1.403447412068854,2.995057214458403,185.34000205993652,5.98991220474243,0.036631825580466154,173.19924812316896,189.9754981994629,0.8534892728394804,0.10590844160447728,1.050326979574974,1.019398346611647,1.0136532198094255,0.022424068941168773,76.66070075018153,196.1468477246664,182.7573751449585,169.3679025652506,189.18749945504325,2.1127216398616295,187.69285719735282,2.694831988720868,188.6988903133033,185.3316925388963,0.32472670681072513,9.177920521959908,4153400,1.9961946178145604,0.7614043835656619,261255500.0,-6.801220702679327,73.63263747053657,76.71321854558761,100.90062053962549,29.30792145339312,8.4145181459277,0.1429730143644433,4.156747617222469,190.7523225097656,188.798841796875,187.22000122070312,185.64116064453123,183.68767993164062,0.16,0.0,168.74940877877899,0.029278468636315447,0.03925471446115919,189.7085680280413,187.89428492954798,6.996550391389268
2024-08-15,0,193.54249954223633,172.7650032043457,191.9550018310547,178.13750076293945,189.01187801361084,-0.6235121794911974,6.546052255979687,-1.1214618282109237,2.995092613087901,185.5875015258789,5.60532476425171,0.03562870056160991,173.39825057983398,190.22174987792968,0.8415138037702903,0.10798138233502566,1.0534086029998933,1.0244070260108722,1.0175120839675853,0.025458641364854318,78.03970011175731,196.82185476372945,183.72975025177,170.63764573981058,190.33499908447266,1.9581584800533398,188.34642846243722,2.9319637322793253,189.49272027569828,186.30830350079108,3.182200083095544,7.07591975283094,4719900,1.996029167740209,0.8751860041442419,265975400.0,-10.995925715268575,73.63263747053657,76.71321854558761,109.33491320879655,30.27021061665656,7.875288648397045,0.19821492324358816,4.124123588714496,191.57744390869144,189.46628292846682,187.76000213623047,186.05372134399414,183.94256036376953,0.18,0.0,168.86707465956343,0.015756303026096763,0.03141165571008412,190.80713762555803,188.48285566057478,6.610384264549085
2024-08-16,0,193.57500076293945,172.7650032043457,193.54249954223633,182.1875,189.71312427520752,-0.7440826731132526,6.414179895350917,-0.7248244887652637,2.9951240890736837,185.8499984741211,5.2011494064331085,0.03471919263180307,173.45325050354003,190.89525032043457,0.8071795229820885,0.12026449774272334,1.047798448101093,1.0220163228037786,1.012567188886712,0.019057159771443954,80.61252513397301,197.57286014165396,184.74450035095214,171.9161405602503,191.1678570338658,1.9122513597359403,189.09035709926061,2.8344617769576606,190.49567704886852,187.33781342206237,4.32995381031107,4.96223958150159,3674900,1.9692918055502273,0.685348436896807,269650300.0,-8.797511302465134,73.63263747053657,76.71321854558761,109.19231529696938,29.19211870905044,7.594805467443315,0.2280566940761803,3.9709712907129004,192.06596563720706,190.25702572631837,188.79500579833984,187.3329858703613,185.52404595947263,0.18,0.0,168.95882837827588,0.020902444973396772,0.01838235353044633,191.7199946812221,189.33714076450892,6.16616955524244
