date,buy?,todays_price,Minimum,Maximum,25th Percentile,75th Percentile,Skewness,Standard Deviation,Kurtosis,Shannon Entropy,Median,Mean Absolute Deviation (MAD),Coefficient of Variation (CV),10th Percentile,90th Percentile,Autocorrelation,Cumulative Return,curr_to_avg_one_month,curr_to_avg_one_two_week,curr_to_avg_one_one_week,momentum,rsi,upper_band_current,middle_band_current,lower_band_current,rolling_mean_7,rolling_std_7,rolling_mean_14,rolling_std_14,ema_7,ema_14,roc_7,roc_14,Volume,Volatility,Relative Volume (RVOL),On-Balance Volume (OBV),Williams %R,Stochastic Oscillator %K,Stochastic Oscillator %D,Commodity Channel Index (CCI),ADX1,ADX2,Chaikin Money Flow (CMF),Average True Range (ATR),Fib_23.6,Fib_38.2,Fib_50,Fib_61.8,Fib_76.4,Parabolic SAR 2,Parabolic SAR 3,VWAP,Adj Close Momentum,Adj Close Return,Adj Close 7d MA,Adj Close 14d MA,Adj Close Volatility
2024-01-02,0,158.8324966430664,154.2400016784668,158.8000030517578,154.8918752670288,156.47250175476074,0.8665152869935969,1.2667992178663872,0.03557049666060985,2.995699356242506,155.69250297546387,0.9947000885009742,0.008123254533794188,154.71300201416017,157.61575050354003,0.7031899661058113,-0.004167038681799858,1.0185014170143922,1.020935140662864,1.018049340912283,0.021004044292615598,53.34460391241538,158.4808499463529,155.9472515106201,153.41365307488732,156.16500091552734,1.4013427098462583,155.71607262747628,1.1612969372642559,155.94219530631187,155.95339347476357,0.4701504107189955,1.0653222374592004,9622100,0.9500491974664006,1.319838800827394,6294100.0,-16.919949291942366,87.8223044403071,81.94094994263789,197.9486399581691,32.24007298742612,18.225136916979107,0.1353796056313606,2.1265366966653194,159.31068054199218,157.8696612548828,156.7050018310547,155.54034240722658,154.0993231201172,0.06,0.0,156.18712840349602,0.029010578496822204,0.03313114031075591,152.99556841169084,152.43583134242468,1.5404197983179855
2024-01-03,0,160.7125015258789,154.2400016784668,158.8324966430664,154.8918752670288,156.47250175476074,0.8857705289343071,1.3918821572605355,-0.2557967677212676,2.995692588056314,155.69250297546387,1.101599559783932,0.008920634540158243,154.71300201416017,158.7325023651123,0.5455039431796417,0.0006772364321812928,1.0300135573033533,1.0306625538266334,1.0258026492391887,0.03295625240970024,64.31982589759416,158.8132654665596,156.02950115203856,153.2457368375175,157.08964375087194,1.9481597072802563,156.1412511553083,1.7331894458936137,156.66877754777977,156.35001162698254,2.5420421405895537,2.5734976667890295,8232000,1.0284721307869005,1.1345179711257458,14526100.0,-6.788232020283223,87.8223044403071,81.94094994263789,242.96269144378036,29.94176731567659,16.92591729173071,0.16814554478925062,2.0824945869696707,159.31068054199218,157.8696612548828,156.7050018310547,155.54034240722658,154.0993231201172,0.06,0.0,156.4149628729368,0.030933776232679788,0.03544304229801512,153.8512224469866,152.8476050240653,1.7759699171960548
2024-01-04,0,161.15499877929688,154.2400016784668,160.7125015258789,154.8918752670288,156.47250175476074,1.3248968163155093,1.631164879099391,1.1337465294766824,2.9956779456270146,155.69250297546387,1.2307870101928728,0.010447554095691447,154.71300201416017,158.80325241088866,0.5135555669569036,0.012043441041356602,1.0321921401761636,1.0300323419519413,1.0219378396477672,0.03339262618337613,71.34444834699167,159.3912058720904,156.1288761138916,152.8665463556928,157.88821465628487,2.3277503237471056,156.63160814557756,2.101199869959279,157.6776340210938,156.8512243954831,4.1963821168161495,3.8462776605602755,6766600,1.1105768306927113,0.9357939886860009,21292700.0,-15.21974732669997,87.8223044403071,81.94094994263789,225.79687943115042,30.259809469698155,15.774006854541435,0.1612696980675972,2.0360834739145295,159.8866768798828,158.59165759277343,157.5449981689453,156.4983387451172,155.20331945800783,0.08,0.0,156.59663441434648,0.02737447895270062,0.02875631891193345,154.5728716169085,153.1854008265904,1.9595128404761486
2024-01-05,0,160.61000061035156,154.2400016784668,161.15499877929688,154.8918752670288,156.47250175476074,1.4764550650276573,1.8849889514505958,1.2513307038526902,2.995659925913286,155.69250297546387,1.3838617324829101,0.01206418980627316,154.71300201416017,159.02049713134767,0.6639822095339747,0.02325506590487935,1.027926201189574,1.0230473886472362,1.0117993984036124,0.02657354354104302,75.33166963380906,160.01660380316974,156.24662590026855,152.47664799736737,158.60607147216797,2.2732735186327764,156.93321527753557,2.351595427929404,158.53554414217632,157.32906070290016,3.593350850231307,4.4494120312618755,5602500,1.061453592869565,0.7804180198903863,15690200.0,-9.582765644138007,87.8223044403071,81.94094994263789,171.39328431145844,27.816025498295613,18.602878378592624,0.22223974818427497,2.021582843562339,159.8866768798828,158.59165759277343,157.5449981689453,156.4983387451172,155.20331945800783,0.08,0.0,156.72500899739194,0.029058695656943856,0.030572403163584755,155.26939828055245,153.4827161516462,2.2198124876579866
2024-01-08,0,160.97500228881836,154.2400016784668,161.15499877929688,154.8918752670288,156.47250175476074,1.286089723404147,2.098387027718753,0.28163560697781964,2.995642780149776,155.69250297546387,1.5879992675781296,0.013416582314448328,154.71300201416017,160.6202507019043,0.7862382813378971,0.030757132603104056,1.0292354747943615,1.0216532188853504,1.0088144170357887,0.028380719380524333,74.11900137359972,160.59927497096484,156.40250091552736,152.20572686008987,159.32428577968054,2.0792488508505964,157.3403581891741,2.52914805096325,159.04794955190485,157.68761054475954,3.2297442668289786,2.7000238681560624,6569800,0.9839646193137058,0.914922817574573,22260000.0,-5.07324910889999,87.8223044403071,81.94094994263789,146.30939111896703,26.753557882586573,16.983587824169227,0.27404510884658795,2.0240253365637284,159.8866768798828,158.59165759277343,157.5449981689453,156.4983387451172,155.20331945800783,0.08,0.0,156.87582595907227,0.030559997274026474,0.03161321748871544,155.99244253976005,153.9272918701172,2.4473991678806506
2024-01-09,0,161.78500366210938,154.2400016784668,161.15499877929688,154.8918752670288,157.107497215271,1.0063384826263693,2.3162482100064876,-0.5530179881273058,2.9956235056038256,155.69250297546387,1.8983119964599637,0.014785156716035296,154.71300201416017,160.73875160217284,0.8106235548088063,0.03933628786982792,1.0327117029663808,1.022423696460273,1.008276383659669,0.018588809478188528,77.44441501670579,161.2928723965755,156.6603759765625,152.02787955654952,160.08607155936105,1.8113268166653285,157.79196548461914,2.7249404774021215,159.52683004422687,158.07823704250836,3.2238414105511204,3.6709069115606883,6357000,0.9433918277876918,0.8846515666835516,28617000.0,-16.224131696726637,87.8223044403071,81.94094994263789,143.03995675726506,30.431951769253516,15.129489759866242,0.2820166801289758,2.0795940621787086,160.8798792114258,159.39505947875978,158.19499969482422,156.99493991088866,155.51012017822265,0.1,0.0,157.04208747372417,0.010376906114757167,0.03119805045063751,156.69734409877233,154.35930633544922,2.5843076147133996
2024-01-10,0,161.87749862670898,154.2400016784668,161.78500366210938,155.1800012588501,159.2768726348877,0.7932996382576216,2.5300084209202915,-0.9963744779508965,2.9956029829373882,155.87375259399414,2.203699645996096,0.016114138689328456,154.71300201416017,160.9930019378662,0.8163595644558687,0.04480216872428379,1.031030743606583,1.0190027158956252,1.0051537418857193,0.007248951324688946,79.76096346761314,162.06551801676736,157.00550117492676,151.94548433308617,160.84964316231864,1.0153373450038057,158.22607231140137,2.863756170759988,160.090503761845,158.55354513484426,3.4083829587557237,4.066898495890985,4945100,0.9454923162587632,0.6936971627728528,33562100.0,-13.864345289804517,87.8223044403071,81.94094994263789,121.32637881275964,28.647407037538006,14.242288983220973,0.2713651623377521,2.0244504833004253,160.8798792114258,159.39505947875978,158.19499969482422,156.99493991088866,155.51012017822265,0.1,0.0,157.16543566712232,0.0055910922823698694,0.011877158174284617,157.41340855189733,154.73688071114677,2.7185590688481236
2024-01-11,0,161.54999923706055,154.2400016784668,161.87749862670898,155.4156265258789,160.6356258392334,0.5894690905490462,2.6891187915125982,-1.3231579275962997,2.995586730234877,156.16750144958496,2.4448494338989293,0.017089285970608145,154.71300201416017,161.21799926757814,0.8385557366556058,0.045990542725717995,1.026646403359798,1.0129288645068368,1.0016709921055407,0.0024510592954340993,80.22820232849257,162.7352386969168,157.3570011138916,151.97876353086642,161.23785781860352,0.5086098309398825,158.70142936706543,2.8203006135490467,160.53958366723134,158.92519551289564,3.4146271919750557,3.9008314864616445,4946000,0.9418042855833912,0.6956697861160007,28616100.0,-21.342743433595952,87.8223044403071,81.94094994263789,93.32914332132422,26.94574794759248,15.153194697882208,0.22919644597954553,1.974524791596913,160.92471978759767,159.46764041137695,158.29000091552734,157.11236141967774,155.65528204345702,0.1,0.0,157.2698043953709,0.0032370605320402035,0.0011181020380404993,157.57811410086495,155.2868412562779,2.759049267634769
2024-01-12,0,162.0974998474121,154.2400016784668,161.87749862670898,155.5393772125244,160.77812671661377,0.3862686342160148,2.767298538618347,-1.560100166944366,2.995578639502843,156.42000198364258,2.592549362182615,0.01754825580539366,154.83450050354003,161.57349967956543,0.8502887190040835,0.047054237335237295,1.0279080312590196,1.0128039490997747,1.004573631911072,0.009261560496903964,77.90066428807937,163.2310980461698,157.6965009689331,152.1619038916964,161.4357147216797,0.5386800945361438,159.2626792362758,2.640253193386697,160.79652325765312,159.17303984138502,1.7109235524396507,4.296458090725492,4496500,0.9355953083918317,0.6616109671600241,33112600.0,-10.557534554037519,87.8223044403071,81.94094994263789,100.40246764553666,26.581426269926855,14.302687249433989,0.1925634004233793,1.9210609738389344,161.2905205078125,160.05974157714843,159.06500244140625,158.07026330566407,156.839484375,0.1,0.0,157.37807218156678,0.007819717438406926,0.010956773244862493,157.77632359095983,155.81377301897322,2.8797329189828065
2024-01-16,0,161.13000106811523,154.2400016784668,162.0974998474121,155.580002784729,161.020001411438,0.23086757561099386,2.8095864515328204,-1.696393034663776,2.9955745492935275,156.49250030517578,2.6813117980957033,0.017772420608995424,155.23700141906738,161.79425315856935,0.8914374204919105,0.03651186352244466,1.0192497013744137,1.0032204865795935,0.9967400133497533,0.0009628748382857211,78.01189569596275,163.70604881859296,158.08687591552734,152.46770301246173,161.43214362008231,0.5409293844545604,159.6601791381836,2.453007114724634,161.12388434610534,159.4874793809747,0.8617863006196703,5.0943322636401955,6923200,0.8457249323882623,1.0363428020564591,26189400.0,-32.740176806620475,87.8223044403071,81.94094994263789,63.66284226969209,24.138623752249785,19.26736999379768,0.11095840183564974,1.9444237092131615,161.2905205078125,160.05974157714843,159.06500244140625,158.07026330566407,156.839484375,0.1,0.0,157.49637222537615,-0.006252716076417086,-0.0037858508307704714,157.76096670968192,156.1669191632952,2.903501358882891
2024-01-17,0,160.46249771118164,154.2400016784668,162.0974998474121,155.580002784729,161.13625049591064,0.041180888330619864,2.8559034463772237,-1.7758241569852038,2.995569612039103,157.68249702453613,2.748499298095703,0.01803834813159963,155.23700141906738,161.79425315856935,0.9013809681053018,0.03770729019288082,1.01350709158323,0.996212869876401,0.9924205706459432,-0.008174465624080973,70.31062849303858,164.03580782354058,158.32400093078613,152.61219403803167,161.41107177734375,0.5797720092275082,160.00857162475586,2.1583744226994503,161.12144266936303,159.6095084845059,-0.015511595278453137,3.577281868912031,5072100,0.8335056726609196,0.8672635825726546,21117300.0,-36.259616821940035,87.8223044403071,81.94094994263789,47.57763936641621,22.68586041250737,19.412453635940388,0.12557848493965948,1.9032189899549068,161.4250386352539,160.2774785461426,159.3499984741211,158.4225184020996,157.27495831298828,0.1,0.0,157.56766593689144,-0.0074244131035354766,-0.006809877309480684,157.6632559640067,156.46632712227958,2.834437678010157
2024-01-18,0,160.56750106811523,154.2400016784668,162.0974998474121,155.74625301361084,161.13625049591064,-0.14825368884585766,2.8022754609031284,-1.7290937271697364,2.995576000455099,159.64749717712402,2.6770366859436026,0.01767067605810459,155.40575141906737,161.79425315856935,0.908676786718145,0.03216207211531596,1.012511559416646,0.9958569963426953,0.9946971894816893,-0.008092524098204712,63.56780331462903,164.18792666185755,158.58337574005128,152.97882481824502,161.3528573172433,0.6473723780527678,160.3385715484619,1.815680829464408,160.9549076664483,159.66740585787898,-0.09183917477702512,3.1349389215698893,5368500,0.8614181583731866,0.9328004865123148,26485800.0,-28.35604383660143,87.8223044403071,81.94094994263789,48.461927336729936,21.080691144042547,18.796975253877697,0.1773339017628053,1.8854922718835583,161.55719805908203,160.49139761352538,159.62999725341797,158.76859689331056,157.7027964477539,0.1,0.0,157.64498263011302,-0.004077266820751602,-0.0025984769527925317,157.61859130859375,156.80551692417689,2.7834222537301216
2024-01-19,0,161.25749588012695,154.2400016784668,162.0974998474121,155.9106273651123,161.13625049591064,-0.3463285280953384,2.738145372474443,-1.5994543544046045,2.99558338391478,160.51499938964844,2.5697621536254873,0.017238536030588284,155.49800224304198,161.79425315856935,0.9081889054664937,0.03060011503833942,1.015228475769307,1.0002263699527005,1.000595651528915,-0.0018106057463013192,63.69033583493373,164.314916462112,158.8386257171631,153.3623349722142,161.2774990626744,0.618753754167764,160.6817853110177,1.4398401221389672,160.85490605690367,159.72766428290743,-0.2531456529952358,2.9625347431656137,7055800,0.8619263735782836,1.2216851803274715,33541600.0,-21.917882666231897,87.8223044403071,81.94094994263789,57.861493702512824,21.943090409520853,17.495564134767854,0.1652871619596429,1.866151726674413,161.55719805908203,160.49139761352538,159.62999725341797,158.76859689331056,157.7027964477539,0.1,0.0,157.7576466168998,0.00328902389542729,-0.0011737264715646286,157.62557111467635,157.16145760672433,2.7811605049379433
2024-01-22,0,162.3474998474121,154.2400016784668,162.0974998474121,156.3262529373169,161.1806230545044,-0.5608823317461697,2.693299977537234,-1.386687774619514,2.9955885452534083,160.5887508392334,2.4841996002197275,0.01692712325298599,155.49800224304198,161.79425315856935,0.871265449364146,0.041076183243875505,1.0203379358596818,1.0069232847069791,1.0077248762546847,0.0015422816529269134,69.56468518504035,164.498100313656,159.11150035858154,153.72490040350706,161.3446420942034,0.7130313393647248,161.09714262826103,0.8811498383636134,160.95189447952387,159.8847616670644,-0.3260548073319147,3.0712149549345042,6824200,0.8220051031088474,1.1834707418673456,40365800.0,-16.347558372098252,87.8223044403071,81.94094994263789,86.55538280972333,26.764448888167134,15.878503879146662,0.22137138804090048,1.8953898490777559,161.97755981445312,160.98621856689454,160.18499755859375,159.38377655029296,158.39243530273438,0.12000000000000001,0.0,157.89411630527508,0.0004927598252644216,0.008191355681575583,157.7093244280134,157.56136648995536,2.503976672652945
2024-01-23,0,159.2224998474121,154.2400016784668,162.3474998474121,156.51249885559082,161.33062171936035,-0.7477513514280324,2.5980100971755324,-1.058072029707612,2.995599039817798,160.66125106811523,2.3233870887756383,0.01629008587426079,155.58300285339357,161.8994987487793,0.8095177707600764,0.05256417324117021,0.9983595515847506,0.9864781135818248,0.9880207053037802,-0.011838274735049281,75.7905168173521,164.68014552241502,159.48412532806395,154.2881051337129,161.01214218139648,1.0597094696877276,161.125,0.8070995145350301,161.294975307477,160.22675752821166,0.29034376283942476,3.7148851118905992,9149800,0.8035540751695893,1.5265390018385603,31216000.0,-56.52181870174435,87.8223044403071,81.94094994263789,-24.75104573291185,21.461978921402707,28.51785127857602,0.23340850889974266,2.1800594851572015,162.0058822631836,161.03206253051758,160.24500274658203,159.45794296264648,158.48412322998047,0.02,1.0,157.9383776951941,-0.004423071497436926,-0.01588765768386534,157.52228437151228,157.5501992361886,2.242621631678424
2024-01-24,0,159.36750411987305,155.56500244140625,162.3474998474121,158.25749683380127,161.33062171936035,-0.806971040697673,2.305639606922613,-0.9289034645666607,2.99562768680945,160.66125106811523,1.9995247077941911,0.014434312226845294,155.9112522125244,161.8994987487793,0.8054308036730571,0.023511055498382165,0.9977102693641016,0.9884497398067448,0.9912671414968619,-0.006823984463207644,49.790476727703236,164.34452945035645,159.73325023651122,155.121971022666,160.62214279174805,1.0954482631647904,161.02892875671387,0.9305807263463254,160.77181438326687,160.13880845541564,-1.4407300530116591,0.24554370962393868,7247900,1.1010465867827637,1.1754069302611456,38463900.0,-69.26531312553618,87.8223044403071,81.94094994263789,-28.722826136534856,19.940346644939503,26.07629807534294,0.2194981971495184,2.2001265963156524,162.0058822631836,161.03206253051758,160.24500274658203,159.45794296264648,158.48412322998047,0.02,0.0,157.97585809645838,-0.00916279432422662,-0.009718323972670041,157.04351152692522,157.4099175589425,2.010177530640639
2024-01-25,0,159.1624984741211,155.58500289916992,162.3474998474121,159.12499904632568,161.33062171936035,-0.9475898858255928,2.1018564357480085,-0.4807534423815687,2.9956455407965286,160.66125106811523,1.752362098693851,0.013142896912578103,156.4020030975342,161.8994987487793,0.7572947760063019,0.024311477007552283,0.9952422411996438,0.988660637722469,0.99134238534345,-0.008750230181374774,50.58278021257329,164.12708819193054,159.92337532043456,155.71966244893858,160.34107099260603,1.191614688480854,160.88660730634416,1.0539974880682759,160.41556324907108,160.09890519004725,-1.6841689292610313,-0.8368965657530255,5478900,1.1003694476864425,0.8791933546596574,32985000.0,-60.269945667715184,87.8223044403071,81.94094994263789,-41.87503845372699,19.109925600297984,24.990343699840384,0.23247648540552776,2.119523356908377,162.0058822631836,161.03206253051758,160.24500274658203,159.45794296264648,158.48412322998047,0.02,0.0,158.0022913607176,-0.01023518807247692,-0.0054229180049151825,156.90951102120536,157.33523886544364,1.798712441237425
2024-01-26,0,160.00749969482422,155.94750213623047,162.3474998474121,159.20749950408936,161.33062171936035,-1.0206716855959546,1.8637803533428092,-0.055258345098121886,2.9956642419990764,160.66125106811523,1.5198248863220214,0.01164118775462688,156.52449798583984,161.8994987487793,0.699064240805263,0.02061588864105122,0.9994081881778725,0.9955885051221389,0.998352795477873,-0.0077515539881131135,48.81846742951708,163.82981080586774,160.10225009918213,156.37468939249652,160.27607127598353,1.1962875919145788,160.84357152666365,1.0781832652416008,160.10318582235783,160.07635194900072,-1.2210653391371908,-1.2363875277021517,5591900,1.1032266820138128,0.8951444110502367,38576900.0,-61.169459536745784,87.8223044403071,81.94094994263789,-25.23233631431512,22.278842873250305,23.714076437700122,0.16699170730110308,2.063062155229956,162.0058822631836,161.03206253051758,160.24500274658203,159.45794296264648,158.48412322998047,0.02,0.0,158.04196527362905,-0.01348338678103611,-0.010607269290996865,156.77970014299666,157.22147805350167,1.570113840072338
2024-01-29,0,159.35000228881836,156.4525032043457,162.3474998474121,159.3312530517578,161.33062171936035,-1.1155188451749416,1.6030660015236209,0.5930244427697722,2.9956820837557343,160.66125106811523,1.2559250450134243,0.010000084225267136,158.60249671936035,161.8994987487793,0.6200085177229685,0.022722528675909164,0.994041070467562,0.9924499845456558,0.995803700713683,-0.018463466092246916,53.17013225018437,163.51138198015906,160.30524997711183,157.0991179740646,160.10214287894112,1.2347428105733662,160.7275000980922,1.1481452583784615,160.08225726868665,160.17543031257054,-0.2835541156640714,-0.3751328766812243,6483200,1.1112564443238195,1.0206211696401726,32093700.0,-63.26840148698884,87.8223044403071,81.94094994263789,-64.52955347915383,21.33502159390057,24.236060010246774,0.15190116338658122,1.9906534914645158,162.0058822631836,161.03206253051758,160.24500274658203,159.45794296264648,158.48412322998047,0.02,0.0,158.07618877917932,-0.019142133966005725,-0.014349406666266787,156.52146693638392,157.07002912248885,1.3254268177141166
2024-01-30,0,159.00250244140625,156.53249740600586,162.3474998474121,159.36312866210938,161.33062171936035,-1.0264964660927343,1.3609826874086772,1.0860930787657637,2.9956961928329715,160.66125106811523,1.0675876045227084,0.008482278764140004,159.12949829101564,161.8994987487793,0.4451135941472795,0.01799948847365926,0.9909777415845036,0.9919831704992982,0.9973686289139847,-0.0013816979774635696,48.95803563033694,163.1720903061528,160.45012493133544,157.72815955651808,159.7800009591239,1.1758315829349404,160.52875001089913,1.1910360297403009,159.90267648851093,160.1588914632128,-0.758247323523079,-1.0094735063798634,7200500,1.127087103521367,1.1083353343553939,24893200.0,-72.11392622247641,87.8223044403071,81.94094994263789,-126.46656970537377,19.995424871079642,25.91155079160119,0.11498473139512329,1.9633761341433755,162.0058822631836,161.03206253051758,160.24500274658203,159.45794296264648,158.48412322998047,0.02,0.0,158.09729790703716,-0.006507731669130212,-0.022773534682231773,156.11527579171317,156.87042345319475,1.0821334120455026
2024-01-31,0,159.6474952697754,158.8324966430664,162.3474998474121,159.36312866210938,161.33062171936035,-0.13360864080060106,1.0837028354421356,-1.2329656089032484,2.995709492262339,160.66125106811523,0.9187624359130865,0.006748946685399714,159.1464988708496,161.8994987487793,0.47027306259763163,0.001070346446306176,0.9942323659176656,0.9973309040483452,1.0016909100603164,0.001756889846826759,43.014221673063815,162.74103085398977,160.57362518310546,158.40621951222116,159.3942860194615,0.33653988920604627,160.36946405683244,1.1450108360803088,159.6851334974509,160.08660158928495,-1.3983805381654844,-1.7198758585279166,8256800,1.0100345741055923,1.2844223653886688,33150000.0,-70.16505576208178,87.8223044403071,81.94094994263789,-88.00496501664358,21.799602352510774,23.97233928024048,0.043833065447933695,1.9623684878950507,162.0058822631836,161.03206253051758,160.24500274658203,159.45794296264648,158.48412322998047,0.02,0.0,158.13497937676388,-0.0003775443349339769,-0.005694314070267789,155.61695643833704,156.66314043317522,1.140916492744368
2024-02-01,0,158.0150032043457,159.00250244140625,162.3474998474121,159.5774974822998,161.33062171936035,-0.06923945018445682,1.0315331695165173,-1.2192331037667907,2.995711646497364,160.66125106811523,0.8743749618530273,0.006422421210937872,159.216499710083,161.8994987487793,0.5956332360623292,-0.006626779161495547,0.9838160693384816,0.9876354365564581,0.9910997877949327,-0.007209583166740585,44.453435316708905,162.67744145347393,160.61437511444092,158.5513087754079,159.22178649902344,0.6250563421894874,160.11696434020996,1.2496425547162842,159.68078722257349,160.14577673048422,-1.6631020374039704,-1.3775869875998037,8012000,0.9235699833441161,1.2484777749296252,25138000.0,-78.26090935087218,87.8223044403071,81.94094994263789,-157.7966281271942,20.251136918154458,28.489636134565718,0.06768484809897346,1.9539375872487712,162.0058822631836,161.03206253051758,160.24500274658203,159.45794296264648,158.48412322998047,0.02,0.0,158.13037275297194,-0.007520633760766171,-0.003774559170569579,155.41455950055803,156.46842193603516,1.2393477584951194
2024-02-02,0,157.20750045776367,158.0150032043457,162.3474998474121,159.36312866210938,161.33062171936035,-0.24100303406564738,1.1761057408008107,-0.9427959727244937,2.9957054023423484,160.5887508392334,1.0077998733520501,0.007328697680059191,159.1464988708496,161.8994987487793,0.5433566295139723,-0.019484320056689163,0.9796111046173738,0.984158436644031,0.9874563839916767,-0.0174991749911777,35.01983001187209,162.8317116799659,160.47950019836426,158.12728871676262,158.91321454729353,0.975856091738169,159.7676786695208,1.3340319786485437,159.26393607104086,159.92026230579987,-0.7583706098218456,-2.1881745895445937,8295500,0.9791684762765093,1.2774374563048787,16842500.0,-91.23038975823606,87.8223044403071,81.94094994263789,-180.51021539303613,18.40903325027819,30.070408219912217,0.07720197784366077,1.9887775924351114,161.77696197509766,160.66152206420898,159.76000213623047,158.85848220825196,157.74304229736327,0.04,0.0,158.0979365347184,-0.01811922554387735,-0.018488342924691776,155.08653477260046,156.06502314976282,1.5006860065443335
2024-02-05,0,156.1599998474121,157.20750045776367,162.3474998474121,159.3181266784668,161.33062171936035,-0.41574513725535434,1.3626268948361362,-0.5661975900042875,2.9956960927773406,160.51499938964844,1.1556621742248523,0.008501427669718557,158.90375251770018,161.8994987487793,0.614226497004048,-0.02118485859945009,0.9742820640316838,0.9800857279664602,0.9843391931422807,-0.020018841516076247,32.212218470277406,163.00737907195992,160.2821252822876,157.5568714926153,158.4842861720494,1.410907658243248,159.41267858232771,1.581878398025604,158.7515580581135,159.60370561851332,-1.3553601620595523,-3.0167025365915947,9121600,0.9862553730211093,1.3675941536609337,7720900.0,-94.41739797080461,87.8223044403071,81.94094994263789,-189.5750916147605,17.32218354335969,30.580480216076293,0.014806434947148736,1.9560860558019062,161.63536053466797,160.432319732666,159.45999908447266,158.4876784362793,157.28463763427735,0.06,0.0,158.03652913930287,-0.022339348623898192,-0.023197594246682534,154.56169782366072,155.73560442243303,1.777441844129685
2024-02-06,0,157.05500030517578,156.1599998474121,162.3474998474121,159.20749950408936,161.33062171936035,-0.6427131428043501,1.6283324540953195,-0.2168092714884846,2.9956804103802437,160.23499870300293,1.3453746795654298,0.010173286683706819,157.9342529296875,161.8994987487793,0.6596257835331456,-0.029911491678485967,0.9812280896298373,0.9895456756183068,0.9939780962334166,-0.012248248337777823,27.672945048242067,163.31629015233122,160.05962524414062,156.80296033595002,158.06250054495675,1.3179099215085464,159.16928591047014,1.6677386166965482,158.1089269295723,159.17597822359775,-1.8864359729796358,-3.084466696305757,9229900,0.9956330286250639,1.356775572483176,16950800.0,-66.99029845356719,87.8223044403071,81.94094994263789,-107.50241102194659,22.040027041828388,27.100968168551933,0.011150049061514641,2.0432810756956377,161.63536053466797,160.432319732666,159.45999908447266,158.4876784362793,157.28463763427735,0.06,0.0,158.01996394566856,-0.00447192176079525,-0.008157635564527588,154.3606937953404,155.57019696916853,1.7914881739424064
2024-02-07,0,158.20999908447266,156.1599998474121,162.3474998474121,159.12249946594238,161.33062171936035,-0.4538131913227316,1.7385463285966838,-0.6971013888730817,2.995673038754643,159.8274974822998,1.4446245193481446,0.010875183938936913,157.19225044250487,161.8994987487793,0.737144930746155,-0.029236352256803003,0.9896560205050624,0.9981860816431063,1.0037622798826715,-0.009004188777742006,33.376142441604266,163.3407178021519,159.8636251449585,156.3865324877651,157.89964294433594,1.1972020338701514,159.00089291163854,1.6343856991297736,157.84907249018914,158.92838279275637,-1.8452256270984917,-2.1235475295536372,8690300,1.0005798819356857,1.2559171672458282,25641100.0,-67.96119381426881,87.8223044403071,81.94094994263789,-61.47991614201639,23.03081230941233,25.42855022839052,-0.019527873348344396,2.0163734654971552,161.63536053466797,160.432319732666,159.45999908447266,158.4876784362793,157.28463763427735,0.06,0.0,158.02861803953218,-0.005789823661579985,-0.004975818278568316,154.1680668422154,155.34476688929968,1.7869526446857082
2024-02-08,0,156.59749603271484,156.1599998474121,162.3474998474121,158.80437660217285,161.16187477111816,-0.2737095889838479,1.7154389757257908,-0.7853539352963681,2.9956745122473247,159.50749969482422,1.4133618736267095,0.010742651591939123,157.19225044250487,161.8994987487793,0.7578109406593372,-0.022656018120798965,0.9806658026629985,0.9887344717879845,0.995347315383184,-0.008970712545553261,41.45478828920552,163.11575286752824,159.68487491607667,156.2539969646251,157.55607060023718,1.1727993632883067,158.66803577968054,1.613852566706673,157.93808021451997,158.84584040332058,-0.7154083388586795,-1.4682310978001016,9755000,1.0467269198956355,1.362433973279255,15886100.0,-86.81988180441084,87.8223044403071,81.94094994263789,-140.77008462196727,20.830666626668613,31.514826076204965,-0.011892971097802046,2.0646579716845372,161.6282808227539,160.42086019897462,159.44499969482422,158.46913919067381,157.26171856689453,0.08,0.0,157.98014593254328,-0.0123768849632504,-0.01573312246550253,153.8372519356864,154.97626386369978,1.8471184760258395
2024-02-09,0,156.4749984741211,156.1599998474121,162.3474998474121,158.16125011444092,160.70812606811523,-0.16402419551012423,1.763306636013078,-0.89907080095078,2.9956710643817583,159.3587532043457,1.427961654663085,0.011060701042921128,157.00924987792968,161.6047492980957,0.7063393358042226,-0.030656163588576292,0.9815213891141715,0.9895636440733974,0.9963641183188776,-0.004659459513761455,35.22925031343949,162.94748805840308,159.42087478637694,155.8942615143508,157.10285677228654,0.7756277517565727,158.24857139587402,1.3204431954039548,157.59817423101006,158.52835450761654,-1.512558841379035,-2.8897880510783738,6529200,1.0936908019669311,0.9019303397917432,9356900.0,-73.29659614287601,87.8223044403071,81.94094994263789,-117.79782106492893,19.670999329110938,29.76035926802305,0.023754812955526616,2.025257942856493,159.45852362060546,158.6657424621582,158.0250015258789,157.38426058959962,156.59147943115235,0.08,0.0,157.9529026668539,0.000957774652227128,-0.010103627862724146,153.53854152134485,154.57774897984095,1.8862637348144626
2024-02-12,0,157.29750442504883,156.1599998474121,162.3474998474121,157.8131275177002,160.48874855041504,-0.028661312983505115,1.8033613134307669,-0.9560297463528338,2.9956680795077375,159.28625106811523,1.4619124412536622,0.011329986115432554,156.58524627685546,161.34149627685548,0.6958297236121991,-0.03468592284633426,0.9882537281103839,0.9969925251861427,1.0025366918278482,0.007284225017598622,33.856607435640555,162.77384737509155,159.16712474822998,155.5604021213684,157.00035694667272,0.6760083272689023,158.11107172284807,1.311420795370129,157.3220850769835,158.2806041571159,-1.9871885808752283,-3.6172416445036037,6701500,1.077750423514514,0.9118443843638724,16058400.0,-53.2227470838333,87.8223044403071,81.94094994263789,-64.82282283820452,22.58902838592942,27.537485371377535,0.019887007275692505,2.0278121886686935,159.45852362060546,158.6657424621582,158.0250015258789,157.38426058959962,156.59147943115235,0.08,0.0,157.94495694325593,0.01315800684141788,0.00791786970176363,153.46735491071428,154.44095720563615,1.7537774372261143
2024-02-13,0,157.07749938964844,156.1599998474121,162.3474998474121,157.27500343322754,160.12124919891357,0.07489764220199649,1.714622767021725,-0.9307882143078663,2.995674088488858,159.1924991607666,1.4399497985839844,0.010788735826364816,156.58524627685546,161.14275054931642,0.7365416367468645,-0.023785121440210735,0.9883618004935926,0.9968949631523317,0.9996849664617541,0.00014325608499521358,40.515392699205286,162.3563705111553,158.92712497711182,155.49787944306834,156.9817853655134,0.6711373118514677,157.94749995640345,1.28520539554676,157.31644262069352,158.16589920663822,-0.4540700343302227,-1.2089971104636998,8621000,1.0930545895031378,1.1596281011745588,7437400.0,-78.63716451086239,87.8223044403071,81.94094994263789,-84.65315034529118,20.43463596522007,27.03057461275058,0.02386828085814209,2.0771314578667557,159.45852362060546,158.6657424621582,158.0250015258789,157.38426058959962,156.59147943115235,0.08,0.0,157.91967074222487,-0.010059374754540107,0.004300468687337663,153.44781494140625,154.26717485700334,1.7942991966993176
2024-02-14,0,155.84750366210938,156.1599998474121,162.3474998474121,157.17500019073486,159.7374963760376,0.26370184211036685,1.6814567778056424,-0.7969534424590226,2.99567621179686,159.08250045776367,1.4425497817993176,0.010593555367552939,156.58524627685546,160.6365005493164,0.7452536624511346,-0.021095261321594918,0.9818742775499993,0.9902986289666627,0.991828526913247,-0.014932655559285357,40.2530774269743,162.08741344879974,158.72449989318847,155.3615863375772,156.93714305332728,0.7416046499326306,157.71071461268835,1.3479787907961027,157.25869860484858,158.07418214777954,-0.08269393491830325,-1.4369332963275334,9098800,1.0875716606360761,1.1916263457494911,-1661400.0,-84.74563120857181,87.8223044403071,81.94094994263789,-124.331419411753,19.24153475464618,28.711963758952336,0.037059693570313676,2.044388687090823,159.34760333251953,158.4862019958496,157.79000091552734,157.0937998352051,156.23239849853516,0.1,0.0,157.8644109990085,-0.01417896593793988,-0.014677949137981712,153.43944004603796,154.00056893484933,1.8644745241493728
2024-02-15,0,157.06749725341797,155.84750366210938,162.3474998474121,157.07187461853027,159.43750190734863,0.36185735703891975,1.742663196191628,-0.6824185906864275,2.9956719042104183,158.60625076293945,1.4994997024536132,0.010995154030329074,156.4434986114502,160.6365005493164,0.7046188837704946,-0.029395720644637566,0.9910012039238109,1.0004665569911568,1.0026075543419464,0.003001332924282174,34.787344087357404,161.97907658311814,158.49375019073486,155.00842379835157,156.9389283316476,0.741950617847692,157.50071443830217,1.1813523703471764,156.90633683908243,157.8073630582037,-0.20011282377566747,-2.082773796461054,7462500,1.1099030731544652,0.9641080498661876,5801100.0,-46.712759835057206,87.8223044403071,81.94094994263789,-40.97884322106864,24.449456721886097,25.967341029812644,0.035844505633260366,2.0952355468231696,159.25591540527344,158.4120355834961,157.72999572753906,157.04795587158202,156.20407604980468,0.1,0.0,157.8557945592942,0.009718714153797992,-0.00037968870073709627,153.4199000767299,153.89029693603516,1.7609885489110555
2024-02-16,0,156.52000045776367,155.84750366210938,162.3474998474121,157.06437301635742,159.35437774658203,0.578849863352057,1.700863805715214,-0.3572269691758123,2.9956746811635573,158.11250114440918,1.4496247863769525,0.010743287233604447,156.4434986114502,160.1324993133545,0.6906906224764489,-0.025983279746720607,0.9886384301149654,0.9975812578390425,0.9985135839049148,0.000287598556200086,41.83758939576626,161.72047761143043,158.31875,154.91702238856956,156.69749995640345,0.4924108037953259,157.2985714503697,1.0781959230263014,156.9479950961743,157.6915573441238,0.007957052126901088,-1.837415400536598,8540700,1.1394053099970332,1.092921418480375,-2739600.0,-70.41510250846098,87.8223044403071,81.94094994263789,-78.22144418073256,22.543717474677504,24.70543230756364,0.009415414029233696,2.1065296183521975,159.25591540527344,158.4120355834961,157.72999572753906,157.04795587158202,156.20407604980468,0.1,0.0,157.82555258797623,0.006242939372747225,0.008559054570899994,153.38621085030692,153.77713884626115,1.5883476637689848
2024-02-20,0,157.36750030517578,155.84750366210938,162.3474998474121,156.94062423706055,159.25437545776367,0.7600509327372938,1.6021209869377444,0.18832079287429027,2.9956810460260415,157.65625381469727,1.3580624008178717,0.010134754440495365,156.4434986114502,159.68349571228026,0.55842442874593,-0.03589522102357975,0.9954809814681681,1.0034224819581163,1.003862538520626,0.0004449904045382702,37.711334502914674,161.2861172027573,158.08187522888184,154.87763325500637,156.807500566755,0.5490915437981703,157.1817855834961,0.9616895809974362,156.83987433798114,157.5300934387946,-1.0681996311792201,-1.7759659808007857,9501700,1.0982027969382093,1.1954177143047657,6762100.0,-47.75078009915575,87.8223044403071,81.94094994263789,-11.192425820822493,25.514659142603733,22.85514260146674,0.027328035012522695,2.111154135887274,159.25591540527344,158.4120355834961,157.72999572753906,157.04795587158202,156.20407604980468,0.02,1.0,157.82100065475822,0.007656418634252704,0.014663092270817269,153.75730678013392,153.79727935791016,1.2639859441663575
2024-02-21,0,158.13000106811523,155.84750366210938,160.00749969482422,156.94062423706055,159.17749881744385,0.21936757696765566,1.2730002260231974,-1.359117347110709,2.9956997660564815,157.3325023651123,1.1489127159118653,0.008065494745581664,156.4434986114502,159.39550323486327,0.7253589950270904,-0.011650360621231497,1.0018825343951394,1.007508696187094,1.008636531437511,0.006700524789078566,47.06280473310912,160.3788757038164,157.83287525177002,155.28687479972365,157.0439295087542,0.7136956124067529,157.07339314052038,0.7167186175216521,156.96340429128395,157.4545725763211,0.4917091856309603,-1.0282870465092087,7473300,0.9024474908287358,0.9502441951984905,14235400.0,-15.231846078187,87.8223044403071,81.94094994263789,24.614156446977248,24.39739189097984,21.60257266382586,0.03897298173001494,2.071052668176716,158.30091540527343,157.6395355834961,157.10499572753906,156.57045587158203,155.9090760498047,0.04,0.0,157.82743067187528,0.02182386310841533,0.01289056366931909,154.19347926548548,153.86601039341517,1.2695190796635762
2024-02-22,0,159.48500061035156,155.84750366210938,160.00749969482422,156.94062423706055,159.04250144958496,0.3024533504840108,1.2350737035474715,-1.1862838340089643,2.99570165909168,157.3325023651123,1.0888252830505365,0.007827908479773741,156.4434986114502,159.39550323486327,0.6908241331058533,-0.007765090245919817,1.0108173990658575,1.0154464283795075,1.0159153815920003,0.023340104029696773,51.4207724212162,160.2483977199001,157.77825031280517,155.30810290571023,157.35642896379744,1.1738189157670667,157.17839295523507,0.9386071562166594,157.2591473653403,157.540099476256,1.0576786132820166,-0.9505280362187114,8065000,0.9215177679954041,1.0201803435977517,22300400.0,-4.91539143905675,87.8223044403071,81.94094994263789,114.70816886000358,28.90533152365207,19.420379668201594,0.09560021090335152,2.1363721607732926,159.34760333251953,158.4862019958496,157.79000091552734,157.0937998352051,156.23239849853516,0.06,0.0,157.86336368330913,0.038064946010351264,0.03322184729743258,154.72644260951452,154.09689876011439,1.4924471321429524
2024-02-23,0,161.28250122070312,155.84750366210938,160.00749969482422,156.94062423706055,159.04250144958496,0.30755599388454097,1.242874082671301,-1.1932044057346942,2.9957012740387876,157.3325023651123,1.0952875900268566,0.007877054054643026,156.4434986114502,159.50125007629396,0.6309694220368487,0.002026244494288997,1.0221719141918058,1.0260582241380949,1.0226264078212417,0.02683562188862365,58.61702752613342,160.2698733026717,157.7841251373291,155.29837697198653,157.95714351109095,1.8742705678865335,157.46946443830217,1.4440734322508526,157.82024333258983,157.78850285666687,1.390674437778548,0.9302897675512826,6726000,0.9734320191809088,0.8441455755777616,29026400.0,-5.533110114451158,87.8223044403071,81.94094994263789,195.02132547809674,31.98744234896028,18.039411615503894,0.08970544148710442,2.13300654753102,160.5012391357422,159.41937860107421,158.5449981689453,157.6706177368164,156.58875720214843,0.08,0.0,157.92073968828836,0.032603825365461914,0.04705795646033264,155.64753069196428,154.54767281668526,1.8229216796428906
2024-02-26,0,161.29249954223633,155.84750366210938,161.28250122070312,156.94062423706055,159.08937740325928,0.6631533918870879,1.4319343785660898,-0.46539784227171754,2.995691229545569,157.3325023651123,1.211887741088867,0.009069182610851467,156.4434986114502,159.68349571228026,0.5547560209673768,0.007968386033846317,1.0215489997342109,1.0230725244346717,1.017252463134257,0.03049130507612352,64.93652563632912,160.75399403179037,157.8901252746582,155.02625651752604,158.73500006539481,1.9797278768577522,157.83607155936105,1.7125961840408916,158.6919698520935,158.272681426532,2.6770236650022716,2.592115993876684,5465400,1.037221086795014,0.6864791097651886,34491800.0,-19.70318478157909,87.8223044403071,81.94094994263789,165.6334493560265,30.38429702294607,17.13531312272829,0.09393303900248343,2.0827698137361716,160.5012391357422,159.41937860107421,158.5449981689453,157.6706177368164,156.58875720214843,0.08,0.0,157.96221632213914,0.027083991083018066,0.025904387520159774,156.52284022739954,154.98114013671875,1.9819290491869683
2024-02-27,0,160.49999618530273,155.84750366210938,161.29249954223633,156.94062423706055,159.08937740325928,0.8006692574869129,1.5495005047030646,-0.3065534664710685,2.9956842814012723,157.3325023651123,1.2825627326965332,0.0098097979374333,156.4434986114502,159.81099586486818,0.6544606925893262,0.01219013006286147,1.0161161785735306,1.014944314841351,1.006197017974141,0.01990560868065039,66.07014947314462,161.05337627643493,157.9543752670288,154.85537425762269,159.22535705566406,1.9221268874367492,158.08214269365584,1.8348657890430742,159.3405707825515,158.62267770358628,3.493797303248544,3.2866929430323477,5078600,1.0232941161194935,0.6435723550026516,29413200.0,-17.139050537249137,87.8223044403071,81.94094994263789,126.31750703747889,28.869399264093108,19.593015000185346,0.13566236174551038,2.0333280856583107,160.5012391357422,159.41937860107421,158.5449981689453,157.6706177368164,156.58875720214843,0.08,0.0,157.99302797885798,0.019764367076347433,0.028297666098687748,157.1205771309989,155.27023860386439,2.140567396123812
2024-02-28,0,161.11249923706055,155.84750366210938,161.29249954223633,156.94062423706055,159.12312698364258,0.7561915316962969,1.6199586886554866,-0.5830395760608011,2.9956798540445653,157.3325023651123,1.345812397003175,0.010252132563116375,156.4434986114502,160.57824668884277,0.7354167369876139,0.00941805141996632,1.0196227294686304,1.0167584850659142,1.0060853733241963,0.018861051974954357,61.175267420862625,161.25179233916404,158.01187496185304,154.77195758454204,159.88142830984933,1.6019142447640724,158.2894641331264,2.0063837550561825,159.62568204178763,158.84273888486703,2.1853655224076416,2.193496465208324,6071100,1.0383022677737217,0.7748894514789474,35484300.0,-9.44664780425928,87.8223044403071,81.94094994263789,136.5739028649717,29.559073012461536,18.648905515101912,0.18172938353649076,1.9817253091885445,160.5012391357422,159.41937860107421,158.5449981689453,157.6706177368164,156.58875720214843,0.08,0.0,158.03727586642975,0.018086852562790856,0.02337517718025352,157.82379804338728,155.6050044468471,2.3306269198380702
2024-02-29,0,161.62750244140625,155.84750366210938,161.29249954223633,156.94062423706055,159.52562427520752,0.6948633322385415,1.7449247380314816,-0.9012237627946997,2.9956715340702993,157.3325023651123,1.4720993804931652,0.0110356293242318,156.4434986114502,161.1294994354248,0.7383000236032773,0.009176492025819537,1.0221995061844031,1.0174178130370983,1.0055557648534441,0.013433876683420332,63.06907390013806,161.60722427769872,158.11737480163575,154.62752532557278,160.49000004359655,1.2605025095747548,158.64875030517578,2.1268433993554563,159.99695786371024,159.0919907570014,2.934129035181126,1.8345870484697786,9849100,1.0373947749312158,1.2444515763019606,45333400.0,-11.740818990902389,87.8223044403071,81.94094994263789,135.4666051200221,30.347888754962636,17.77541308154289,0.20134178901028388,1.9288394051737083,160.5012391357422,159.41937860107421,158.5449981689453,157.6706177368164,156.58875720214843,0.08,0.0,158.11433478492378,0.005796361157174079,0.01701556579286014,158.31886727469308,156.0380870274135,2.4775462986112418
2024-03-01,0,161.9025001525879,155.84750366210938,161.62750244140625,156.94062423706055,159.73874950408936,0.6960990646467372,1.8798796877507906,-1.019508852321743,2.99566187748694,157.3325023651123,1.6001748275756882,0.011881701156704776,156.4434986114502,161.28350105285645,0.7889253656945046,0.022861748339104527,1.023297999266118,1.0154542367309558,1.004588524838247,0.003844179791311353,68.10842538565888,161.97613453571887,158.2163751602173,154.45661578471572,161.02892848423548,0.8088730642676094,159.03642899649483,2.1937425220323155,160.40024771654765,159.3305528563936,2.7070406074756455,3.212060560432324,5668000,0.958998331657823,0.7269266827493424,51001400.0,-5.821624417186149,87.8223044403071,81.94094994263789,127.4065319729242,30.08458168249153,16.773632667790196,0.17651100644276052,1.8964275053193762,160.7457247314453,159.6171431274414,158.7050018310547,157.79286053466797,156.66427893066407,0.1,0.0,158.16249510882787,0.0017300256022720895,0.010408257752316694,158.8026842389788,156.49808175223214,2.6518416379884435
2024-03-04,0,160.26000213623047,155.84750366210938,161.9025001525879,156.94062423706055,160.6531219482422,0.5498511336089738,2.042918108698905,-1.3136995917268184,2.995649308526102,157.3325023651123,1.832724933624266,0.01289633505680968,156.4434986114502,161.32599983215331,0.8129608714226026,0.029864985329282084,1.0116737792637938,1.0021135429390713,0.9936324850818886,-0.006401397516537899,70.81105863360978,162.49658622502716,158.4107500076294,154.32491379023162,161.1396429879325,0.5841495733378032,159.24803597586495,2.1556539015002985,160.77221963621952,159.5817164101739,2.38569471889628,3.468606314998261,8532900,0.9297462086326592,1.0926895357711792,42468500.0,-35.31703889110412,87.8223044403071,81.94094994263789,47.42881296549909,25.98242733928225,24.473966625973226,0.19605449235597608,2.0373922361197643,160.7457247314453,159.6171431274414,158.7050018310547,157.79286053466797,156.66427893066407,0.1,0.0,158.19504675764944,-0.005908353290512758,-0.012357927692686928,158.7168927873884,156.72166769845145,2.611367065845698
2024-03-05,0,160.25749969482422,155.84750366210938,161.9025001525879,156.94062423706055,160.6531219482422,0.3588093523918633,2.0612656743858815,-1.4855543714191304,2.9956479061133248,157.7487506866455,1.895550079345702,0.012999632942952493,156.4434986114502,161.32599983215331,0.836192081438347,0.026255137633354096,1.0106842112959145,0.9997598156222042,0.9948907512980315,-0.0015108815965237943,59.93054415326191,162.68590644032446,158.56337509155273,154.440843742781,160.9932141985212,0.6652146178127974,159.47517885480607,2.0753950905260328,160.64326587791922,159.5636132190726,0.485940071425503,1.8833723535602882,8298200,0.9814086458199907,1.0682667538630082,34170300.0,-33.63521873531862,87.8223044403071,81.94094994263789,49.10076205915644,24.106727860027654,22.70716455408873,0.20786582841931245,2.0375808855118493,160.7457247314453,159.6171431274414,158.7050018310547,157.79286053466797,156.66427893066407,0.1,0.0,158.2296585235276,-0.006274073191166241,-0.005099816421260433,158.45388793945312,157.0507093157087,2.49888532181044
2024-03-06,0,159.73749923706055,155.84750366210938,161.9025001525879,157.06437301635742,160.6531219482422,0.1923863659865801,2.015324960959327,-1.5591752901192686,2.9956517735394415,158.17000007629395,1.880575046539306,0.012693501124400161,156.5155002593994,161.32599983215331,0.8551230944645208,0.020390941921146197,1.0061048046610381,0.9947224149789,0.9919612158485671,-0.008534409226541917,58.83722821739565,162.798900005842,158.76825008392333,154.73760016200467,160.77107129778182,0.7954955473940237,159.7530356815883,1.7936290032248239,160.55250061042312,159.59547930223377,-0.6355317645255686,2.024478564741747,5773700,0.9691022526996347,0.7601874893023133,28396600.0,-46.811691312895434,87.8223044403071,81.94094994263789,33.81917045203231,22.631868577386875,21.31793111604174,0.14517147217701867,2.013975964863756,160.94160516357422,159.9342038269043,159.12000274658203,158.30580166625975,157.29840032958984,0.1,0.0,158.2492644741176,-0.013679983874636648,-0.010187594461069571,158.2499542236328,157.3863972255162,2.47643028109266
2024-03-07,0,159.36750030517578,155.84750366210938,161.9025001525879,157.07499885559082,160.6531219482422,0.03606138317563485,1.9858892599515054,-1.5338229107042967,2.9956541880164105,158.8474998474121,1.843375015258789,0.012497542969827295,156.5155002593994,161.32599983215331,0.8827449744942704,0.009654890091822303,1.0029271134214883,0.9914259024564688,0.991356516848937,-0.013982782027147755,53.43449296609878,162.8741535504206,158.9023750305176,154.93059651061458,160.6092861720494,0.958313433578688,159.91732161385673,1.626251653991433,160.34801846562402,159.5681758920782,-0.9640871767683074,2.4960268746973404,5188700,0.9513809701049205,0.6992838294236403,23207900.0,-53.62329416916004,87.8223044403071,81.94094994263789,7.558462538485791,20.922806407136235,23.198906390929476,0.17275611817158415,2.021610531797748,160.94160516357422,159.9342038269043,159.12000274658203,158.30580166625975,157.29840032958984,0.02,1.0,158.25914602509738,-0.015553433932335992,-0.016589322549576523,157.95319475446428,157.53688594273157,2.4405293446133505
2024-03-08,0,159.30249786376953,155.84750366210938,161.9025001525879,157.07499885559082,160.6531219482422,-0.04857009266890215,1.9817301742730085,-1.5215132904104216,2.9956545439845965,159.42625045776367,1.8262249755859385,0.012466828487824072,156.5155002593994,161.32599983215331,0.8688308529344256,0.01768868815043029,1.0021530399708083,0.9910939679759517,0.9937462809051635,-0.01605906200563878,53.61512892176908,162.92371044009874,158.96025009155272,154.9967897430067,160.35071454729353,1.0405643596803127,160.11607142857142,1.3203794358375371,160.09964139288593,159.4580559156999,-0.705604926506944,1.464340549112405,5283200,0.8721747552478223,0.7341417897485281,17924700.0,-49.75531194615369,87.8223044403071,81.94094994263789,13.646914662881489,19.566714438919625,21.57661750385343,0.17723612792599583,2.017176949777787,161.123326171875,160.22834545898436,159.5050048828125,158.78166430664064,157.88668359375,0.02,0.0,158.27216915095832,-0.016037407647933266,-0.011525625835365132,157.66768755231584,157.74574279785156,2.3065554345754404
2024-03-11,0,160.2300033569336,155.84750366210938,161.9025001525879,157.24250316619873,160.6531219482422,-0.17225696462100962,1.9067480788270714,-1.374044113629456,2.995660402081107,159.42625045776367,1.6981496429443381,0.011984927773774657,156.5155002593994,161.32599983215331,0.8503995608449271,0.018069975505486703,1.007130957019667,0.9980939083866384,1.0027850143001311,-0.000187188187301901,53.33688080652623,162.9089963407596,159.09550018310546,155.28200402545133,160.1510718209403,0.87578806963088,160.32053593226843,1.057474535343584,159.8989894803546,159.4009629546863,-1.123439448746794,1.7777264233759735,4620800,0.871338008028205,0.650724333580716,22545500.0,-24.63255506064244,87.8223044403071,81.94094994263789,50.51126906035477,21.15659373885917,19.72716671139598,0.1902222795604043,2.047590948307103,161.28616674804687,160.49192639160157,159.85000610351562,159.20808581542968,158.41384545898438,0.02,0.0,158.29311312105762,0.008696111703675014,-0.005489809999075535,157.64658682686942,157.98272705078125,2.22185172889554
2024-03-12,0,162.1400032043457,155.84750366210938,161.9025001525879,157.35000133514404,160.6531219482422,-0.3467222595037263,1.8224822342529614,-1.178951762009843,2.99566672733712,159.61124992370605,1.5675246429443377,0.01144176948526923,157.01274757385255,161.32599983215331,0.8504457796857491,0.018643009897732238,1.0179350482203053,1.0106604488423119,1.0147766797353852,0.011746742043937441,58.18178287414864,162.928214895752,159.2832504272461,155.63828595874017,160.18500082833427,0.955886766449925,160.60696465628487,0.9567862664472846,159.97950510590223,159.49194352578303,-0.8646418854237276,1.8189925151042545,8018700,0.8759141849969221,1.1188566277887,30564200.0,-6.928752264531577,87.8223044403071,81.94094994263789,119.93373603670966,25.98218311971272,18.352453147883907,0.2021752439045918,2.042731236999839,161.84976147460938,161.07012200927736,160.44000244140625,159.80988287353514,159.03024340820312,0.02,1.0,158.35853487111896,0.01731579124823135,0.018143217298555222,157.7337886265346,158.2682364327567,2.268457737539151
2024-03-13,0,161.52999877929688,155.84750366210938,162.1400032043457,157.93937587738037,161.1549997329712,-0.4755755896246491,1.8637890090646345,-0.977969153208917,2.9956638937837416,159.98375129699707,1.5563377380371093,0.011683338809177336,157.01274757385255,161.6550022125244,0.7735996027946684,0.03222933796608994,1.0125661726761908,1.0058299156219312,1.00858227147385,0.011221532519274824,68.12019545154563,163.25295338434017,159.52537536621094,155.7977973480817,160.3664289202009,1.0843814124439193,160.7530359540667,0.92799173616123,160.51255546991018,159.86555485939283,0.14669511065855903,2.5358895270626993,6260000,0.9536826347905508,0.8880919075816945,24304200.0,-41.273029201654346,87.8223044403071,81.94094994263789,66.39385521250603,23.385153222150276,21.0211188889116,0.22961217227208602,2.1064916817802413,161.96068176269532,161.24966247558595,160.6750030517578,160.10034362792967,159.3893243408203,0.02,0.0,158.3940221041233,0.011045605666518243,0.007063875517517605,157.91100202287947,158.31394740513392,2.0682948456813595
2024-03-14,0,160.09500122070312,155.84750366210938,162.1400032043457,159.00937366485596,161.28500080108643,-0.6884338037301488,1.8235867143780433,-0.6364697145381117,2.9956669438622194,160.2437515258789,1.4907002258300792,0.011415396189911428,157.01274757385255,161.6550022125244,0.7302770930197352,0.03646189373368233,1.0021721767050642,0.9966352425581712,0.9973896390385327,0.004564926438164862,65.50902083122466,163.39517376444942,159.74800033569335,156.10082690693727,160.34321485246932,1.0888322074017502,160.66821452549524,0.9301423963068087,160.75786944756607,160.12669806741408,0.7924601436026651,1.2822510964160097,6988300,0.9116005397295716,1.0064817928663552,17315900.0,-80.08209048752977,87.8223044403071,81.94094994263789,-8.448851467186953,21.16871718565505,22.75341381987888,0.19386132385018873,2.159897067572855,161.96068176269532,161.24966247558595,160.6750030517578,160.10034362792967,159.3893243408203,0.02,0.0,158.41356076094792,0.0021402060306827675,-0.0008157973064195768,157.80411420549666,158.1290010724749,1.6854678007726638
2024-03-15,0,158.13249969482422,156.52000045776367,162.1400032043457,159.35124969482422,161.28500080108643,-0.7036587816522684,1.589242644078729,-0.4480615337186853,2.995682802084248,160.2437515258789,1.2705504608154286,0.009935227033297063,157.3375,161.6550022125244,0.7382251347752706,0.019275177998160115,0.9885729480419275,0.9853581882634663,0.9842710753097993,-0.00734450611029247,53.4163405380041,163.13886050178053,159.96037521362305,156.78188992546558,160.1139292035784,1.370261544087658,160.4425002506801,1.1291250612984516,160.59082240092258,160.22539322493955,-0.10139835853581704,-0.7362857042841829,13165500,0.9618302913206934,1.821346084808005,4150400.0,-82.03015708188721,87.8223044403071,81.94094994263789,-104.56236653960808,19.681428102187645,26.449157085387753,0.15996558847992945,2.15631445312393,161.69164190673828,160.81418270874025,160.1050033569336,159.39582400512694,158.5183648071289,0.02,1.0,158.40706670072106,-0.008400313475420695,-0.004343238785941838,157.6409650530134,157.94545963832311,1.5663300466284131
2024-03-18,0,157.63000106811523,156.52000045776367,162.1400032043457,159.35124969482422,161.28500080108643,-0.6666791730620353,1.5071416347633146,-0.32867558224442117,2.9956878217339966,160.2437515258789,1.206650314331057,0.009418833125000917,158.0537509918213,161.6550022125244,0.5888647772141357,0.010302192897678107,0.9851036168790158,0.984539860668475,0.9825744650239376,-0.016226688100520748,43.48736717227612,163.02790860521998,160.01362533569335,156.99934206616672,159.86571502685547,1.6556555164206368,160.23750059945243,1.355686091532213,159.97740839517604,160.0377402662601,-1.004773174678544,-1.9591734621141677,6602300,1.0631247751473996,0.9257907670519279,-2451900.0,-96.06664927641951,87.8223044403071,81.94094994263789,-160.04698339803238,18.248346043861464,26.518210270493142,0.12043814519217654,2.158732383190007,161.5500404663086,160.58498037719727,159.80500030517578,159.0250202331543,158.05996014404298,0.04,0.0,158.39341659428314,-0.02772438610308514,-0.01730206714615529,157.34420340401786,157.64869907924108,1.5424846313520209
2024-03-19,0,156.35000228881836,157.36750030517578,162.1400032043457,159.35124969482422,161.28500080108643,-0.4252275812628351,1.3936312808323768,-0.8346582005667291,2.9956943247428724,160.2437515258789,1.1400502777099633,0.00870643403369629,158.08000106811522,161.6550022125244,0.5572866905684761,0.0016680748085239779,0.976765518841414,0.9781519082469208,0.9777650019105274,-0.035709885291109744,39.92761800751812,162.8563879278757,160.06912536621093,157.28186280454617,159.4439299447196,2.1309182304560697,159.89732224600655,1.6783559779480977,159.39493468765042,159.83566692921977,-1.0902469033732582,-1.788158994018911,7840600,1.0548615243424435,1.112383254805653,-10292500.0,-92.61740567709113,87.8223044403071,81.94094994263789,-206.28320770558875,17.49657147212232,28.30951827070636,0.09641190659709749,2.089943645901139,161.35180133056642,160.26410177612306,159.38500213623047,158.50590249633788,157.41820294189452,0.06,0.0,158.36192102129885,-0.0401253853411645,-0.031135525325533805,156.87867082868303,157.27317919049943,1.7005118892115298
2024-03-20,0,155.7775001525879,156.35000228881836,162.1400032043457,159.35124969482422,161.28500080108643,-0.7008696602965904,1.5054151640329334,-0.1673145357399637,2.9956879213413554,160.2437515258789,1.2011001586914063,0.009407771673884834,158.08000106811522,161.6550022125244,0.5673067737067499,-0.011256553261706059,0.973498333468392,0.9769585075515533,0.9812910411417841,-0.03561257147391417,33.601419939545984,163.02908079345895,160.01825046539307,157.0074201373272,158.80785805838448,2.491236604863827,159.4794649396624,1.9246252108205382,158.63778910126035,159.45111684934167,-1.8533893784114126,-2.9560071197422495,5982300,1.0769299038065727,0.8578102415857939,-16274800.0,-93.03812382420317,87.8223044403071,81.94094994263789,-203.31285517510193,16.73552427504177,28.669486994124895,0.04001593158613507,2.0282626502245535,161.24560205078126,160.09220294189453,159.16000366210938,158.22780438232422,157.0744052734375,0.08,0.0,158.33364053279786,-0.03314721524697628,-0.0428905942041946,156.1093488420759,156.87796783447266,1.9260138701802139
2024-03-21,0,155.8474998474121,155.7775001525879,162.1400032043457,159.35124969482422,161.28500080108643,-0.9395057772998433,1.7243442336634138,0.11855508089288236,2.995673927928493,160.2437515258789,1.3422502136230492,0.010783849213461991,157.50200119018555,161.6550022125244,0.6816132067615409,-0.02324670309794031,0.9746522218936403,0.9798309336675459,0.9888988938382515,-0.026531130521905033,29.20770354922312,163.34931388694352,159.9006254196167,156.45193695228986,157.90892900739397,2.207622186916555,159.04696491786413,2.016387700279665,157.9271310448396,158.97987568252282,-2.7788198908210475,-3.6194349355482505,5915800,1.0252297414287626,0.8615502019963708,-10359000.0,-91.88521420420884,87.8223044403071,81.94094994263789,-159.3222094652321,17.448451169394623,26.782534492768786,-0.019423274706327952,2.0154796572806255,161.21964190673827,160.05018270874024,159.1050033569336,158.15982400512695,156.9903648071289,0.1,0.0,158.307688132388,-0.021732411259620887,-0.033209268505604565,155.1262446812221,156.43001665387834,2.1242647110826938
2024-03-22,0,155.5974998474121,155.7775001525879,162.1400032043457,159.0099983215332,161.28500080108643,-0.8374446650775991,1.937276091001592,-0.4521363515553878,2.995658459924899,160.2437515258789,1.5623751449584944,0.01212929656896659,156.29975204467775,161.6550022125244,0.7675212869772344,-0.03369864264352907,0.9741968270837676,0.9804289074555027,0.9926633550234517,-0.016030859262354924,26.072224795193303,163.59330256347292,159.71875038146973,155.84419819946655,157.06142915998186,1.6555130549207908,158.7139290400914,2.1791003981647137,157.4144204157427,158.57197191958025,-3.8809073840976347,-3.739905374820734,7245400,0.9151781423897145,1.0512112564073919,-17604400.0,-98.37715713896557,87.8223044403071,81.94094994263789,-145.4419001253592,16.650995820579144,25.55847883426105,-0.09146835946067479,1.9606060547468485,161.21964190673827,160.05018270874024,159.1050033569336,158.15982400512695,156.9903648071289,0.1,0.0,158.27186536717852,-0.0186496137771357,-0.02499855680582628,154.30066135951452,156.10583169119698,2.2710644937573887
2024-03-25,0,155.37499618530273,155.5974998474121,162.1400032043457,158.00687503814697,161.1574993133545,-0.6508589013307953,2.097429382623872,-0.879146107631557,2.995645488569686,160.16250228881836,1.7471001434326183,0.013155429838013639,155.8404998779297,161.6550022125244,0.7970925457570712,-0.03530852154307967,0.9745381073761462,0.9813178254497292,0.9944604347015258,-0.014305683356799936,25.23470341420574,163.62935907805291,159.43450031280517,155.23964154755743,156.38714272635323,1.072629340961336,158.36517878941126,2.3003897497264307,156.9619508540292,158.17661153347456,-3.6726917456307984,-2.9093362203096422,7498100,0.9125892992460768,1.0720661017591344,-25102500.0,-96.10222822743569,87.8223044403071,81.94094994263789,-128.9852555627534,15.971788728647567,25.309106621191326,-0.08484310803230485,1.8974959177772597,161.1724390258789,159.97377804565429,159.00499725341797,158.03621646118165,156.83755548095704,0.12000000000000001,0.0,158.23309702522985,-0.009823838090223913,-0.018712812546082435,153.73948887416296,155.7718015398298,2.414455838667014
2024-03-26,0,155.59249877929688,155.37499618530273,162.1400032043457,157.31000137329102,160.6531219482422,-0.4739184817675829,2.2277878111206615,-1.1644842740859285,2.9956340643974357,159.91625022888184,1.9260376930236816,0.013999038945393564,155.7595001220703,161.6550022125244,0.83392106145451,-0.03193146493338861,0.9777167462491807,0.9857140502933833,0.9987354675030456,-0.0048449216401172945,25.137762338766194,163.59420076719985,159.1386251449585,154.68304952271714,156.02428545270647,0.771009345650435,158.06910732814245,2.3756874906720777,156.56739276727268,157.85068459668867,-2.9482525996508193,-3.0466614784451007,6864100,0.9052365634063401,0.969048499719059,-18238400.0,-87.90408350480423,87.8223044403071,81.94094994263789,-104.523909197495,16.03018158578121,23.881211710097126,-0.09842099520398838,1.8668660151191583,161.1393991699219,159.9202982788086,158.93499755859375,157.9496968383789,156.7305959472656,0.14,0.0,158.2011580612498,-0.002816707164252863,-0.00631523267856569,153.4005388532366,155.520751953125,2.4734792201467886
2024-03-27,0,156.90250396728516,155.37499618530273,162.1400032043457,156.2243766784668,160.473126411438,-0.28201806731847323,2.3321478853174233,-1.3953878818011032,2.9956244049188316,159.55249977111816,2.084350433349607,0.01467745093819996,155.59699974060058,161.6550022125244,0.8508701001085859,-0.03426177660891199,0.9874711713434529,0.9981535673910772,1.0081246547328604,0.0072218633216947214,25.862435760409245,163.55754604529307,158.89325027465821,154.22895450402336,155.92035729544503,0.5297908636372342,157.89303616115026,2.363369628147904,156.32816194999236,157.62163122843305,-1.6062485070616257,-2.5948825276225396,8461600,0.8891289248607025,1.1747547677209,-9776800.0,-61.67652852751879,87.8223044403071,81.94094994263789,-46.49148262667236,21.755501803636506,21.419992287030322,-0.08734932114227899,1.9322773105389657,161.1393991699219,159.9202982788086,158.93499755859375,157.9496968383789,156.7305959472656,0.14,0.0,158.18657949370433,0.01412442392874258,0.011202932097999859,153.56931631905692,155.4567598615374,2.393919445449216
2024-03-28,0,158.4099998474121,155.37499618530273,162.1400032043457,156.2243766784668,160.25812530517578,-0.09161174643543255,2.312250819812046,-1.437550612539986,2.995626055662266,159.33499908447266,2.0939752769470203,0.014571532270291029,155.59699974060058,161.6550022125244,0.8601147217751944,-0.029233876677850764,0.998281157448565,1.0107190680722589,1.0163412748795966,0.01644235552388662,37.298830414396434,163.30725215079354,158.68275051116944,154.05824887154535,156.21464266095842,1.087165139012736,157.829286302839,2.334284283819918,156.47336592867254,157.60124116601014,-0.46152197925552974,-1.5467371535415677,6181500,0.9431194973919098,0.8806201594561425,-3595300.0,-58.92209069013534,87.8223044403071,81.94094994263789,-0.47835585522836616,24.28446090649875,20.45629562204846,-0.10605661318381678,1.8783992647060932,161.1393991699219,159.9202982788086,158.93499755859375,157.9496968383789,156.7305959472656,0.02,1.0,158.1896885040525,0.015666163471192984,0.01560097733725847,153.84779139927454,155.3632311139788,2.3069062445408317
2024-04-01,0,157.60499954223633,155.37499618530273,162.1400032043457,156.2243766784668,160.23687744140625,-0.0042317487763737045,2.2115072905289983,-1.3229775450618209,2.9956349539137275,158.85624885559082,1.9603752136230468,0.013950801964758426,155.59699974060058,161.56724891662597,0.8378929021840053,-0.021571626762305784,0.9942160926558116,1.0066651084287703,1.0078624836950418,0.01290187629488182,47.83907017916771,162.9448899625277,158.52187538146973,154.09886080041176,156.4757140023368,1.1801454150919926,157.64178603036063,2.2296973540164133,156.95349838530302,157.7647789369042,1.3175551828828302,-0.5602536233428418,4364700,1.0164434591462599,0.6276242680808476,-7960000.0,-63.83231059927708,87.8223044403071,81.94094994263789,-26.248466402615847,22.946537171991434,24.52826698071453,-0.10846646008050059,1.8455751896419883,161.1393991699219,159.9202982788086,158.93499755859375,157.9496968383789,156.7305959472656,0.02,0.0,158.18506194716244,0.016427240855952263,0.01303369154084292,154.13189261300224,155.12062072753906,2.1468384939724725
2024-04-02,0,157.02000045776367,155.37499618530273,162.1400032043457,156.2243766784668,160.12875175476074,0.08651296780082147,2.0773047658917534,-1.2231095940873147,2.995646208287865,158.27124977111816,1.8260002136230469,0.013122001941080045,155.59699974060058,160.38700180053712,0.8694774398463254,-0.01656684486836105,0.9918702275304611,1.0032665924728001,1.001549977317957,0.010587316575049632,45.531394990885,162.46160988273567,158.30700035095214,154.1523908191686,156.64321408952986,1.159141921942074,157.2760715484619,1.8168094218409545,157.10536684292552,157.76540930494457,1.1731472053784127,-1.6382723333343014,6102300,0.9692967955922936,0.8930905237831106,-14062300.0,-62.49997591730967,87.8223044403071,81.94094994263789,-36.6421590371054,21.27531293945851,25.91854431409877,-0.06675270569539761,1.8480401113898155,160.81087310791017,159.65455337524415,158.7199935913086,157.78543380737304,156.62911407470702,0.02,0.0,158.17463155372684,0.016170583192227195,0.016105142009547345,154.41036769321985,154.768306187221,2.11622407713816
2024-04-03,0,156.08749771118164,155.37499618530273,162.1400032043457,156.2243766784668,159.8268747329712,0.272853637623365,2.0447637273762864,-1.0922638985292046,2.9956487791638735,157.88125038146973,1.776500110626222,0.012929676713925132,155.59699974060058,160.38474960327147,0.8547455971677778,-0.020201857905094392,0.9869897717134714,0.9976972990652773,0.9935170979831842,0.0031813804377993637,42.34332923487393,162.2345277217814,158.14500026702882,154.05547281227624,156.71321378435408,1.0986857821422757,156.88732147216797,1.361881965820132,157.08034711385764,157.71979263458223,0.752338415117047,-3.1577665260862684,8098200,0.9736733562243729,1.1869337910151125,-22160500.0,-99.8629010145325,87.8223044403071,81.94094994263789,-89.8998587077004,18.363967520802525,28.493652224869106,-0.11098012478135037,1.987763847205285,159.81955487060546,158.75521585083007,157.8949966430664,157.03477743530274,155.97043841552735,0.02,1.0,158.13891870809823,-0.009693842066600178,-0.006184776025036261,154.27394321986608,154.2873022896903,2.232537990277662
2024-04-04,0,153.93000030517578,155.37499618530273,162.1400032043457,156.02749824523926,159.46000003814697,0.4791346712099786,2.031285198139073,-0.9135841026276936,2.9956497308682546,157.61750030517578,1.7516501998901362,0.012861404399745018,155.59699974060058,160.36000289916993,0.8435213930118393,-0.02284999792354376,0.9746322106769937,0.9840718869564201,0.9791673293238613,-0.018944909016424316,38.3575824951203,161.99907056412482,157.93650016784667,153.87392977156853,156.5067858014788,1.4662779426584953,156.44696426391602,1.2357846737470342,156.8331953553323,157.5430203670554,0.3149137127846215,-3.3693438427814772,6947400,0.9857507181371837,1.009580068226652,-29107900.0,-98.67262014610631,87.8223044403071,81.94094994263789,-149.83507567123345,16.398844556754504,31.816649081035646,-0.12150890413863678,2.066650871486294,157.5899227294922,156.60004290771485,155.8000030517578,154.99996319580077,154.01008337402345,0.04,0.0,158.08564824570212,-0.034565767327184416,-0.020992495722309986,153.89139229910714,153.81544058663505,2.491011491535477
2024-04-05,0,152.2599983215332,153.93000030517578,162.1400032043457,155.82999992370605,159.3187484741211,0.4551458314955577,2.1638447545244373,-0.6801532284998619,2.995638261891789,157.3125,1.8038502502441418,0.013725962192141002,155.57074851989745,160.36000289916993,0.78400124998256,-0.03411925260537833,0.9658340673317537,0.9745466330012141,0.9722208838929113,-0.038823316279293474,30.43795246292595,161.97381473030134,157.64612522125245,153.31843571220355,156.03071430751257,2.179931218337062,156.0274998801095,1.570876233242543,156.11507952901414,157.09248070226235,-0.9300054163178403,-3.8508391071051755,6778100,1.0791160877804715,0.9737327331274704,-35886000.0,-89.64144879489996,87.8223044403071,81.94094994263789,-167.62641153167027,15.585104322880994,33.07340436671807,-0.09943804273019287,2.018944841246506,157.36291967773437,156.26353985595702,155.375,154.48646014404298,153.38708032226563,0.06,0.0,158.02235762925545,-0.03666482111814373,-0.035262216261817705,153.41601344517298,153.4082761492048,2.7080194462265053
2024-04-08,0,152.0449981689453,152.2599983215332,162.1400032043457,155.73250007629395,158.63312435150146,0.19988250224599624,2.420391332115649,-0.3171802719596397,2.9956139870244494,156.9612522125244,1.94582534790039,0.015388008069369815,155.23049659729003,160.36000289916993,0.7617833033664843,-0.044208343476565264,0.9666493296709827,0.9754102481434419,0.9785333351716884,-0.03527807740515876,25.840086417633458,162.13153278630162,157.2907501220703,152.449967457839,155.33678490774972,2.5906160960746476,155.62857110159737,1.8217440768390412,155.1601651715435,156.4394525940012,-2.1418130590541646,-3.7136587258306815,5935400,1.1205212404480007,0.8486956919620994,-41821400.0,-99.60423783574863,87.8223044403071,81.94094994263789,-153.56829461494775,14.751740202942528,31.48556839725544,-0.14392890549377388,1.9803826679756877,157.35111895751953,156.24443869018555,155.3499984741211,154.45555825805664,153.34887799072266,0.08,0.0,157.96545935640674,-0.03923188475697703,-0.041722068230559205,152.52010672433036,153.04471152169364,2.9126055590993323
2024-04-09,0,151.82749938964844,152.0449981689453,162.1400032043457,155.5962495803833,158.2018747329712,0.1527673192054183,2.6268146441848113,-0.31861739554199353,2.9955922785108453,156.62625312805176,2.044163093566894,0.01673899325971285,153.76300010681152,160.36000289916993,0.7811692548869708,-0.05108284975664075,0.9674985993201191,0.9762398108642169,0.984176940728622,-0.03306904249762721,23.636348709611838,162.18150442569873,156.9278751373291,151.67424584895946,154.39642769949776,2.4815413077312387,155.3055351802281,2.0682679779138655,154.3922338902711,155.79730251786094,-3.095875257256987,-3.543109091749942,6135600,1.0791343839475507,0.867922473174482,-47957000.0,-83.53669088845263,87.8223044403071,81.94094994263789,-142.76453131917012,13.892292697884308,31.922985768294378,-0.14236267780392065,1.9524536725121777,157.20480010986327,156.0076005554199,155.04000091552734,154.07240127563477,152.87520172119142,0.1,0.0,157.90637200858046,-0.034489416726827704,-0.03479538043240692,151.6903032575335,152.769047328404,2.880250854055456
2024-04-10,0,150.82749938964844,151.82749938964844,162.1400032043457,155.53812313079834,157.75562572479248,0.1875092605730598,2.7348014721445884,-0.2460190640330131,2.9955797503270043,156.21875,2.0895258331298834,0.01747390447572795,152.2384983062744,160.2385009765625,0.7470352767678162,-0.0636024646040026,0.9637062666127932,0.9720270914800953,0.9843209592848144,-0.03369903674967034,19.190225382299044,161.97735288325404,156.50774993896485,151.03814699467566,153.42821339198522,2.3391069152486725,154.951963697161,2.3808595097258025,153.75771502252113,155.20121395762953,-4.155356646742152,-2.892550580725739,6809500,0.9305929847158388,0.9715594674435908,-54766500.0,-95.30914485756303,87.8223044403071,81.94094994263789,-172.05399080174064,12.631246013403304,33.258954209416295,-0.20724207281969192,1.9937676862604077,156.92631823730468,155.55683752441405,154.4499969482422,153.34315637207033,151.9736756591797,0.12000000000000001,0.0,157.8278962419832,-0.02631916852189109,-0.047739769659819464,150.6242218017578,152.37805720738,2.777930447052883
2024-04-11,0,149.71249771118164,150.82749938964844,161.52999877929688,155.013747215271,157.61124992370605,-0.09792550521849376,2.6807379037367967,-0.3351529811651184,2.995584412978893,155.96749877929688,2.0341257095336913,0.017190594959924223,152.02324829101562,158.5784999847412,0.7214758823457572,-0.06625703875768348,0.9600516727144373,0.9678133445714029,0.983798568662047,-0.027398834441841657,17.448893229821852,161.30360055570355,155.94212474823,150.58064894075642,152.38428442818778,2.0858899735395044,154.5137492588588,2.7407462259025923,153.0213875224066,154.49821060240865,-4.300307840660599,-3.177609576537565,8374400,0.9361343151637127,1.1770799438615627,-63140900.0,-96.27912654433139,87.8223044403071,81.94094994263789,-180.26288579536802,11.526714571267002,35.18123342336946,-0.2395865263326455,2.028545779818947,156.60299938964843,155.03349938964843,153.76499938964844,152.49649938964845,150.92699938964844,0.14,0.0,157.71747044373504,-0.024327963300268318,-0.03545965256213871,149.36686270577567,151.88861519949776,2.8781320030750357
2024-04-12,0,147.95000076293945,149.71249771118164,160.09500122070312,153.51249980926514,157.16625022888184,-0.500374852394627,2.686339185858049,-0.5802318906941193,2.995582316922256,155.8125,2.15050048828125,0.017292034606320575,151.72749938964844,158.160249710083,0.7361505477728806,-0.06485214048131593,0.9523579697850905,0.9608858831457355,0.9776356490777238,-0.028306827834663206,16.041273129195684,160.7239280665403,155.35124969482422,149.97857132310813,151.2217848641532,1.9405698578921844,153.96749932425362,3.2270825294814767,152.1877591001733,153.76253648725714,-4.653867485211003,-3.9365419029738398,7097500,0.9230876014953311,0.9968377875608408,-70238400.0,-96.91400995447817,87.8223044403071,81.94094994263789,-179.67316440890818,10.743441275343605,37.17917914126801,-0.23886764031050095,2.0207836206609713,156.31035809326173,154.55981729125978,153.1449966430664,151.73017599487304,149.9796351928711,0.16,0.0,157.61042325095866,-0.03195746273514288,-0.03265579325931676,148.4189213344029,151.34643227713448,3.1608042423431844
2024-04-15,0,148.20499801635742,147.95000076293945,158.4099998474121,152.20624828338623,156.93187808990479,-0.7991908539720642,2.9088538966062103,-0.42874316134268,2.9955546820267305,155.6875,2.4655503654480015,0.018797846137964033,150.71599922180175,157.68025093078614,0.7673013163223102,-0.06439219611108218,0.9577431004146102,0.9691256833504486,0.9849307941191149,-0.025255682191669737,13.999651561987458,160.56170746514846,154.74399967193602,148.9262918787236,150.40392739432198,1.811040417526529,153.4553565979004,3.5402750107925796,151.1223165733944,152.9680188749796,-5.21342008012679,-4.914924142079554,8502300,0.9078947770801591,1.2345693353497351,-61736100.0,-96.33025654861368,87.8223044403071,81.94094994263789,-145.46278840147625,11.421358548292389,34.399596838741836,-0.29907191755611623,2.0278796060454316,156.31035809326173,154.55981729125978,153.1449966430664,151.73017599487304,149.9796351928711,0.16,0.0,157.48828153371844,-0.0263869580744861,-0.031498161166438846,147.72835649762834,150.80987439836775,3.384363056339447
2024-04-16,0,144.77499771118164,147.95000076293945,158.4099998474121,151.9906234741211,156.48812770843506,-0.6838361613999228,3.1271190064000707,-0.7738645616899098,2.995525787256009,155.5949993133545,2.7223504638671896,0.020273368972471645,149.5617477416992,157.6074996948242,0.823894522749116,-0.059791936737252645,0.938588183110554,0.9525516979561206,0.9670717889313614,-0.04645075303761237,16.492199652346255,160.50186260081284,154.24762458801268,147.99338657521253,149.33464159284318,2.5792586007636316,152.68267795017786,4.163568315928404,150.3890860795969,152.39176535600959,-3.7192245030001865,-4.614640929995105,12774900,0.9249586113476893,1.7754049935480374,-74511000.0,-93.26985677083334,87.8223044403071,81.94094994263789,-187.7332003588546,9.850198600603497,42.703231516983514,-0.2742278713030665,2.1832007629141623,155.42299938964842,153.12349938964843,151.26499938964844,149.40649938964845,147.10699938964845,0.18,0.0,157.24486179148747,-0.05148064796724805,-0.047100704315426,146.61164202008928,150.01382773263114,3.911436813354495
2024-04-17,0,144.68000030517578,144.77499771118164,158.4099998474121,151.57749938964844,156.15312385559082,-0.8156117643566049,3.6442084142714983,-0.31046791271768104,2.9954489580756705,155.4837474822998,3.1236505889892556,0.023724562309808236,148.17949829101562,157.07850036621093,0.780577115190801,-0.0740326473181288,0.9418971946777065,0.959658279313886,0.9756295032548684,-0.040758476467153915,12.182538538923874,160.89329124870903,153.60487442016603,146.31645759162302,148.2824990408761,2.783465306570777,151.8096419743129,4.480076811165331,148.977878921543,151.43216198053176,-4.915933727087796,-6.952456675600746,9378100,1.1240342545029691,1.2895538724705597,-83889100.0,-91.23806423611111,87.8223044403071,81.94094994263789,-159.47533634890388,9.240680886798893,40.06081006928745,-0.24649369668135643,2.160807272832301,155.42299938964842,153.12349938964843,151.26499938964844,149.40649938964845,147.10699938964845,0.18,0.0,157.07028289870485,-0.0361518189003841,-0.04937935756712359,145.65245056152344,149.08627864292689,4.279507738420804
2024-04-18,0,144.91250228881836,144.68000030517578,158.4099998474121,150.54874897003174,155.9074993133545,-0.6967077340259985,4.0676363097701085,-0.642536143903202,2.9953766868390357,154.65249824523926,3.490987911224366,0.026582144669787557,147.63250045776368,157.07850036621093,0.8369463550820081,-0.07123942698105847,0.9470082394165666,0.9685288904445453,0.9853669877596215,-0.03206142102861187,12.232290369500152,161.15664694052415,153.02137432098388,144.8861017014436,147.2946423121861,2.5313006833923763,150.84553500584192,4.402070556317084,147.89561390872194,150.60974834793026,-4.8439593228748565,-7.789871641983368,9887700,1.1298969303530877,1.3240747064329648,-74001400.0,-82.62315233402752,87.8223044403071,81.94094994263789,-133.1504581909839,8.437848812452408,37.91439783452778,-0.17258564943230642,2.197212391277955,154.60527648925782,152.41235809326173,150.63999938964844,148.86764068603514,146.67472229003906,0.19999999999999998,0.0,156.89588660838587,-0.020498653912559783,-0.029693778363887393,144.73123386928015,148.21076856340682,4.487822137196814
2024-04-19,0,146.68249893188477,144.68000030517578,158.4099998474121,149.3356227874756,155.9074993133545,-0.5153073062152705,4.377033642072101,-1.0090770582955773,2.9953181105885247,153.0949993133545,3.7586252212524416,0.028705977716461252,144.89875183105468,157.07850036621093,0.8703194751453236,-0.07016472878487007,0.961990446054738,0.9863030719876942,1.0039560664847051,-0.008567095806140679,14.039809288362482,161.2321917119396,152.47812442779542,143.72405714365124,146.70249938964844,1.9951652647398856,150.06535639081682,4.067090573331075,147.14778057565377,149.95329932298958,-4.554508984623072,-8.520609539546221,9747700,1.1354171524976302,1.2726744546608828,-64253700.0,-67.96247073779118,87.8223044403071,81.94094994263789,-87.85759862942156,14.747472688161112,33.67765453716323,-0.10095246320353016,2.2967852647976956,154.52888348388672,152.3505637512207,150.59000396728516,148.8294441833496,146.6511244506836,0.19999999999999998,0.0,156.75619982094412,0.0026436987870692708,-0.0059143472764971415,144.4091578892299,147.51668984549386,4.510933383002975
2024-04-22,0,148.79999923706055,144.68000030517578,158.4099998474121,148.14124870300293,155.7199993133545,-0.30256016117719914,4.478868116824109,-1.2466350187450634,2.995296856413313,152.15249824523926,3.860637493133544,0.02946238532975574,144.89875183105468,157.07850036621093,0.9063508925132667,-0.05729527096688512,0.9788193803076886,1.0043077918061682,1.0202192634776843,0.004014717645604904,27.438072729011292,160.9776106156673,152.01987438201905,143.06213814837082,146.572142464774,1.784403346638573,149.47821344648088,3.5457848585576315,147.03220681925023,149.62752978779065,-2.7481728958825067,-6.930300842026561,10118700,1.2497372979047856,1.2967887539104102,-54135000.0,-59.852607443058226,87.8223044403071,81.94094994263789,-47.03226045602936,19.936169481989378,30.628373950293515,-0.046953130575351804,2.3449112614326646,154.52888348388672,152.3505637512207,150.59000396728516,148.8294441833496,146.6511244506836,0.02,1.0,156.64425889758704,0.010366579785815233,0.010845962599273973,144.455570765904,146.91121673583984,4.480862434415102
2024-04-23,0,149.5275001525879,144.68000030517578,158.4099998474121,148.14124870300293,155.71624851226807,-0.12340320031560574,4.452320088499797,-1.2842868299756103,2.995300836233138,151.93624877929688,3.8574999809265136,0.029353376236388572,144.89875183105468,157.07850036621093,0.9240285664572897,-0.04231695645804386,0.9858089450941689,1.011433186056633,1.0243714493745375,0.03282681758964512,39.685583229359864,160.58463952850104,151.67999935150146,142.7753591745019,146.79749952043807,2.064974446020412,149.00964219229562,2.9960183555151847,147.47911850011383,149.65657167536537,-0.6095005347392194,-5.235002672741807,10110400,1.3768201615018418,1.2743925919250068,-44024600.0,-48.01944046972912,87.8223044403071,81.94094994263789,-33.62873113721191,19.21389301208242,28.486656439760157,-0.014963720177729182,2.340986674814976,152.58068115234374,150.77466186523438,149.31500244140625,147.85534301757812,146.04932373046876,0.04,0.0,156.54284614890992,0.03537554888533023,0.013347797139862769,144.74248395647322,146.58070264543807,4.4196799906100095
2024-04-24,0,148.13000106811523,144.68000030517578,158.4099998474121,148.14124870300293,155.71624851226807,0.03576509619358278,4.391660700213919,-1.22677143682291,2.9953115423705126,151.32749938964844,3.780375099182129,0.0290093771751293,144.89875183105468,157.07850036621093,0.9223359021928583,-0.0389800194372609,0.9784815734348387,1.0035415036820825,1.00823234935562,0.023845733727276164,42.95569075435232,160.17094595029351,151.38762454986573,142.60430314943795,146.78678567068917,2.0566324265983758,148.59535653250558,2.6435789531974017,148.00284013350333,149.7479236945915,1.066238176082248,-4.202769379218392,9756300,1.3924282947439452,1.2077446285426736,-53780900.0,-45.50958410127783,87.8223044403071,81.94094994263789,-50.922572150504735,17.647064143915635,30.21078887398025,0.003711759478369727,2.3666482621288334,150.70123602294922,149.25437771606445,148.08499908447266,146.91562045288086,145.4687621459961,0.04,0.0,156.43041419179548,0.025972221270589513,0.0282450959090775,144.87469046456474,146.30152348109655,4.333134354173473
2024-04-25,0,148.0250015258789,144.68000030517578,158.4099998474121,148.0850009918213,154.46937465667725,0.2291840991941555,4.335206880733125,-1.1264971531468082,2.9953210195133044,150.26999855041504,3.6957000732421874,0.028707222752583025,144.89875183105468,157.07850036621093,0.8909226071261539,-0.05591053474200148,0.9802038999892516,1.004666170588809,1.002808073878504,0.021478472788063252,36.75313229286135,159.68491342577292,151.01449966430664,142.34408590284036,147.25107192993164,1.8865920432175045,148.2928567613874,2.425271526330333,148.0485432238301,149.69521944700105,-0.050603521639607636,-3.7679459660635928,7642700,1.3564818535019187,0.950919291243062,-61423600.0,-62.76481574721192,87.8223044403071,81.94094994263789,-55.56906090892641,17.69550310659361,27.322555485603214,-0.0722724117257877,2.4297859302684306,150.70123602294922,149.25437771606445,148.08499908447266,146.91562045288086,145.4687621459961,0.04,0.0,156.33871991304147,0.007410517440924913,0.014160437279030888,145.20801871163505,145.90983036586218,4.100662299456336
2024-04-26,0,146.49249649047852,144.68000030517578,158.4099998474121,148.00625133514404,152.67749881744385,0.4202798272260294,4.160579142036762,-0.8678898271073687,2.9953518832682624,149.61999893188477,3.4876872253417956,0.027632077337035186,144.89875183105468,157.07850036621093,0.8488111991298469,-0.06555771940872746,0.972915513473122,0.9954049109643082,0.98825832513356,-0.0012953313639310071,34.38120327672617,158.89178282630988,150.57062454223632,142.24946625816276,147.50999995640345,1.5732714622010897,147.89624949863978,2.208825221421336,148.0498443630335,149.55472655547547,2.2448653884152354,-2.7814244334293856,6183000,1.278844794699259,0.7692934581439287,-67606600.0,-67.97876105045468,87.8223044403071,81.94094994263789,-72.75430932862497,17.03185612511129,27.456528397121374,-0.06637126907586781,2.3440347773429786,150.31160021972656,148.93920111083983,147.8300018310547,146.72080255126954,145.34840344238282,0.04,0.0,156.2563338137103,-0.011966761487444466,0.0027445809467932228,145.40070016043526,145.52657536097936,3.776046365690831
2024-04-29,0,146.5425033569336,144.68000030517578,157.60499954223633,147.63312530517578,152.09874820709229,0.5191906239638637,3.8358985574506215,-0.6801938141827288,2.9954065494353865,149.16374969482422,3.1804498291015646,0.02557696261171853,144.89875183105468,156.18074798583984,0.8151486083522539,-0.07050856942377509,0.9771145073969221,0.9967318295966167,0.9888491761443127,-0.015171343358210798,30.547252218471613,157.64654648929093,149.97474937438966,142.3029522594884,147.7428572518485,1.2014294582732052,147.5187497820173,1.9177036261384524,147.6590098360691,149.12757715417698,1.2527620828584516,-3.651880525722468,6149600,1.296774317839287,0.7567350725836124,-61457000.0,-57.5373831447495,87.8223044403071,81.94094994263789,-63.52103681346445,16.49694120665067,26.39064688873001,-0.0648690744391748,2.2644158537605352,149.76916674804687,148.50042639160156,147.47500610351562,146.44958581542969,145.18084545898438,0.04,0.0,156.17781609269022,-0.01542373996462243,-0.00736927930445622,145.55259704589844,145.14191545758928,3.337468697293447
2024-04-30,0,145.72000122070312,144.68000030517578,157.02000045776367,146.64750003814697,151.88187408447266,0.6020129565593192,3.4765141224289735,-0.443833726925992,2.9954628115531965,148.50249862670898,2.8442870521545416,0.023266472523953557,144.89875183105468,154.14575004577637,0.7845982157886964,-0.0667271498553357,0.9752269903690676,0.9922594713196253,0.9863039707940435,-0.025463536326089442,31.258553749722147,156.37465280998245,149.42162456512452,142.46859632026658,147.60535757882255,1.3841868909633752,147.15392848423548,1.714933994705997,147.37807808638524,148.68751087233315,1.1248174190426683,-3.4809214759913076,8817700,1.3045001673992924,1.067226158460276,-70274700.0,-81.13703750433713,87.8223044403071,81.94094994263789,-91.14510831249868,15.276707186867398,29.034026035016556,-0.14743964040030805,2.2705326322529475,149.043357421875,147.91331884765626,147.0,146.08668115234374,144.956642578125,0.02,1.0,156.05184800510537,-0.03323078810735147,-0.030378210429589984,145.08565848214286,144.7474081856864,2.849370788449704
2024-05-01,0,149.8474998474121,144.68000030517578,156.08749771118164,146.53000164031982,151.07749938964844,0.5820175675671355,3.092775524583128,-0.4140349429808037,2.99551726480485,148.16749954223633,2.536449432373047,0.020776875284025196,144.89875183105468,152.42699851989747,0.7385294400444802,-0.06642105641069432,1.0066565747193414,1.0197089128580152,1.0194955783749795,0.011594537007443284,29.543753485462457,155.04217565243775,148.85662460327148,142.67107355410522,147.7550005231585,1.5779270304295163,147.16357149396623,1.730734176209921,146.9608267835669,148.11453261243156,-0.6561776068654227,-3.3863176076072037,14470900,1.303039435751247,1.686409168274405,-55803800.0,-7.68363915068752,87.8223044403071,81.94094994263789,52.81300134861271,25.779287734667125,23.30011802574496,-0.03741703904704227,2.627096485531244,149.7920858154297,148.51896563720703,147.49000549316406,146.4610453491211,145.18792517089844,0.02,1.0,155.94269256646038,0.01784150921345229,0.0108318101467337,145.37538582938058,144.9154782976423,2.6064216997795673
2024-05-02,0,150.8574981689453,144.68000030517578,153.93000030517578,146.53000164031982,150.0924997329712,0.2676734428919377,2.6273050649759813,-0.8597625562240983,2.9955760885184595,148.16749954223633,2.1875870132446296,0.017686975009050216,144.89875183105468,152.0664981842041,0.7066428446501065,-0.026521798542648356,1.0155702265455675,1.022984632242172,1.0239741094987491,0.019135258327095617,51.97287818231902,153.79923484003498,148.544624710083,143.29001458013104,147.94500023978097,1.8783929185933363,147.3712498801095,1.9877224920291665,147.68121385240613,148.14425182207998,0.7039654675553715,0.09017425952702263,8459800,1.612805293431971,0.9772754971255754,-47344000.0,-26.195700668899097,87.8223044403071,81.94094994263789,70.1171215172929,24.86205382203568,21.308798652693646,-0.02426755659372037,2.667322137871606,150.15880255126953,148.81560299682616,147.7300033569336,146.64440371704103,145.30120416259766,0.04,0.0,155.8834189281683,0.021114247530333863,0.00935839228154899,145.42601885114397,145.0842514038086,2.458323927790775
2024-05-03,0,149.21750259399414,144.68000030517578,152.2599983215332,146.53000164031982,150.0924997329712,0.02152298186884899,2.386731425575579,-1.1286808947012203,2.9956029293710262,148.16749954223633,2.0185993957519544,0.016084071351743626,144.89875183105468,151.84924926757813,0.6946239173805329,-0.00921121875770797,1.0055697649650743,1.0078007773338566,1.0089626401613387,0.018601677005980477,57.22172854860634,153.16446245442265,148.3909996032715,143.61753675212034,148.1003576006208,1.9401995304501236,147.443571635655,2.0381706765819203,148.47377252610832,148.38016335143428,0.8894671649029127,1.9651891794610719,6532700,1.5964853044381575,0.7557282330614183,-53876700.0,-33.26085406124415,87.8223044403071,81.94094994263789,30.144860942655555,23.44174185470459,23.68235409135237,-0.013631629217602997,2.626781550259909,150.15880255126953,148.81560299682616,147.7300033569336,146.64440371704103,145.30120416259766,0.04,0.0,155.82633997179985,0.021417818203607775,0.016687005301416456,145.53009469168526,145.202392578125,2.2829569572235133
2024-05-06,0,149.10250091552734,144.68000030517578,152.0449981689453,146.53000164031982,149.74624824523926,-0.02791074670087008,2.2268908264187393,-1.0210262070358047,2.995619414435982,148.16749954223633,1.8512621307373052,0.015022313338315654,144.89875183105468,150.95449829101562,0.6641604089536818,-0.018596439271283297,1.0058259083502865,1.0053028705424527,1.0044833826692652,0.017469317774368553,50.69859825525984,152.69265646973201,148.23887481689454,143.78509316405706,148.25428608485632,1.9756433612687316,147.75267900739397,1.9274716921590949,148.66773373013865,148.3958487342935,0.7341534584738414,0.683178429330007,5042800,1.6343782493699741,0.5863983445770538,-58919500.0,-40.76088308612428,87.8223044403071,81.94094994263789,33.32854069360101,22.499881645871902,22.28520028831999,0.008447560213388727,2.591997912557124,150.15880255126953,148.81560299682616,147.7300033569336,146.64440371704103,145.30120416259766,0.04,0.0,155.78198960893508,0.011987408344188877,0.016696353243932458,145.77762712751115,145.49282291957311,2.142772230502292
2024-05-07,0,149.06999969482422,144.68000030517578,151.82749938964844,146.53000164031982,149.57374954223633,-0.1316620671574863,2.06164031318091,-0.953539990900135,2.99563530563882,148.16749954223633,1.7045746994018542,0.013921371810503822,144.89875183105468,150.83049926757812,0.6111107225316388,-0.01794799021966164,1.0066057004586884,1.0048787829699843,1.000812352852732,0.022989283873579458,50.45744833190937,152.21503058058545,148.09174995422364,143.96846932786184,148.62250082833427,1.8271750318902285,148.06625039236886,1.7368032927630976,148.7790748835892,148.42372661774024,0.7279171616560062,2.9891233104895916,7333500,1.6343117985430422,0.8468723980918089,-66253000.0,-39.23915008516729,87.8223044403071,81.94094994263789,47.32779670196207,21.676156700368388,21.469334868139022,-0.040822224382543223,2.4982499444279953,150.15880255126953,148.81560299682616,147.7300033569336,146.64440371704103,145.30120416259766,0.04,0.0,155.7195883067314,0.028563548431149277,0.012940966584819497,146.14048985072546,145.77059500558036,1.908594807153388
2024-05-08,0,149.12499618530273,144.68000030517578,150.8574981689453,146.53000164031982,149.29500198364258,-0.3289772578691997,1.8924610181059762,-1.0010528481872105,2.9956503509627543,148.16749954223633,1.5875998687744128,0.012790885122112029,144.89875183105468,149.94549980163575,0.5836564538909963,-0.011652382370166373,1.007915448081788,1.0055596285535573,0.9966982531761888,-0.004821593038556449,51.36050303120817,151.73879700569438,147.95387496948243,144.16895293327048,148.99142837524414,1.581390260795718,148.3671428135463,1.496704633429561,148.84835278892712,148.42641696594595,1.75947797060939,3.0342821263398836,7735100,1.621854617548792,0.8885006415270756,-58517900.0,-43.33337897926566,87.8223044403071,81.94094994263789,59.41326770122202,21.00960816972324,20.809146172878137,-0.04106239930598361,2.393339796377728,150.48920111083984,149.3504006652832,148.43000030517578,147.50959994506837,146.37079949951172,0.04,0.0,155.65652658633255,-0.01475059589409744,0.030154277098502335,146.44006129673548,145.99632917131697,1.8476412222965035
2024-05-09,0,149.4550018310547,144.68000030517578,150.8574981689453,146.53000164031982,149.1481227874756,-0.43248746927997095,1.7971791206908643,-0.9554395714400234,2.9956582819992965,148.16749954223633,1.527624835968021,0.01215388053939073,144.89875183105468,149.7259979248047,0.5829704561731588,-0.003924198279106176,1.0107274324279854,1.0071091767591285,0.9998695584816958,-0.009296828827957682,52.9070579069139,151.46310805064684,147.86874980926513,144.2743915678834,149.52499989100866,0.6486583237799677,148.5651787349156,1.4389627392487654,148.90708165524956,148.46659678327862,1.7622824567688478,2.906922335857985,6546200,1.603975881833399,0.7599153972775754,-51971700.0,-31.794804579982433,87.8223044403071,81.94094994263789,79.67076147439607,21.367955019679236,20.029918393375088,0.013724599991807659,2.3087897635939068,150.48920111083984,149.3504006652832,148.43000030517578,147.50959994506837,146.37079949951172,0.04,0.0,155.6080004402859,-0.00046686875591472887,-0.008797396006868801,147.17985098702567,146.13275473458427,1.8923188227679393
2024-05-10,0,149.79750061035156,144.68000030517578,150.8574981689453,146.53000164031982,149.1481227874756,-0.43992334581634895,1.7848043279494195,-0.9368935260801092,2.9956592834505162,148.16749954223633,1.5186124801635743,0.01207124389047934,144.89875183105468,149.55950012207032,0.6196172375058367,0.010172362692492987,1.0131318799127353,1.0084453698900402,1.0040450712845246,0.0038869301943453838,56.774705795729304,151.42548367115768,147.8558750152588,144.2862663593599,149.51785714285714,0.6447789045166714,148.6364288330078,1.4757106087487863,149.0285070609068,148.45028259502374,2.5631351764090664,1.8901388504823566,5710600,1.5523072199266887,0.6682945125444191,-46261100.0,-31.025605411781736,87.8223044403071,81.94094994263789,77.12875230917356,20.745691211155194,19.446620024747467,0.0594085540714297,2.2081324785532535,150.48920111083984,149.3504006652832,148.43000030517578,147.50959994506837,146.37079949951172,0.04,0.0,155.56711204779253,0.004287606238802422,-6.668076783989669e-05,147.00123378208704,146.1883098057338,1.9465492938085105
2024-05-13,0,150.74250030517578,144.68000030517578,150.8574981689453,146.53000164031982,149.27687740325928,-0.49710872410947815,1.834406134041384,-1.0034832058044403,2.9956552444207705,148.50249862670898,1.5832749748230015,0.012398971491361252,144.89875183105468,149.80250053405763,0.6326897199736657,0.010745269156296441,1.0188866735321458,1.0125542817030269,1.00959413608752,0.010999140722512513,58.050909551662116,151.61706227571216,147.94825000762938,144.2794377395466,149.50142887660436,0.6052083105522456,148.72321455819267,1.56516078530211,149.20855651212344,148.50920773109868,-0.03336674760103471,0.6703638295735791,5628500,1.5529515724649836,0.6699522516930325,-40632600.0,-14.230771487985663,87.8223044403071,81.94094994263789,115.052422737564,25.3763693231075,18.009501455891574,0.11120163956366702,2.2139812442749442,150.48920111083984,149.3504006652832,148.43000030517578,147.50959994506837,146.37079949951172,0.04,0.0,155.53585351771468,0.01776822313387494,0.01306362828839951,147.18407113211495,146.30504499162947,2.074862959176934
2024-05-14,0,151.53500366210938,144.68000030517578,150.8574981689453,146.53000164031982,149.473126411438,-0.4711937941827791,1.9328849756806203,-1.0641054139107489,2.995646898440966,148.93499946594238,1.6770999145507801,0.01305340768131843,144.89875183105468,149.93699989318847,0.6447523157598799,0.04121915170669861,1.0233656972242082,1.0150140731024353,1.012677287455389,0.016535882285714898,67.959936429433,151.94089507343153,148.07512512207032,144.2093551707091,149.83250045776367,0.9561394708491715,148.96642902919226,1.7225334094217133,149.58387378086124,148.73331265674489,-0.07622946500196175,0.8125596638397773,8254200,1.3220567071887608,1.009649786980555,-32378400.0,-12.179443289167633,87.8223044403071,81.94094994263789,124.96620980880355,24.80452089873193,17.111520149718846,0.12947747138958196,2.1636850689435203,150.48920111083984,149.3504006652832,148.43000030517578,147.50959994506837,146.37079949951172,0.04,0.0,155.49525744291432,0.017886038383084557,0.018845154684255853,147.48083278111048,146.50546373639787,2.012458829490543
2024-05-15,0,152.18500137329102,144.68000030517578,151.53500366210938,146.64750003814697,149.5950002670288,-0.46834498449160816,1.9172365678905223,-0.7659409488984386,2.9956486595775855,149.08625030517578,1.6119998168945302,0.012918241311001385,145.63925132751464,150.75400009155274,0.5961113213920063,0.047380448869741694,1.0254147060309515,1.0154128506151243,1.0136813905681992,0.02051973355416492,70.94068605890718,152.24759855539773,148.4131254196167,144.57865228383568,150.27285766601562,1.2335028750249963,149.26357187543596,1.8975568401465543,150.07533226716828,149.14412644625568,1.5531027043261287,2.2986583200174313,5548000,1.3224565528729797,0.6949067518557881,-26830400.0,-3.3254019024560857,87.8223044403071,81.94094994263789,155.0770237812898,25.915394403939157,16.16314794235095,0.137005509812958,2.126984373867051,150.96287738037108,149.73355764770508,148.73999786376953,147.74643807983398,146.51711834716798,0.06,0.0,155.47420683830848,0.024974795452703313,0.02655997392118767,148.05606733049666,146.9168472290039,2.027124131439685
2024-05-16,0,153.49750137329102,144.91250228881836,152.18500137329102,147.68937587738037,149.8100004196167,-0.30877648074478875,1.8840182348288073,-0.5652556659684187,2.9956519956201624,149.11374855041504,1.5013623428344745,0.012662402078382849,146.41524696350098,150.9252487182617,0.5588842518007384,0.050185449630689404,1.0316498240221892,1.0225753050849926,1.018272820551898,0.027048272006352736,72.85678244092682,152.55641194268006,148.78837547302246,145.02033900336485,150.9053579057966,1.5958404224169906,149.76392936706543,2.0296206358730795,150.6134063844337,149.60802407539464,2.0673700567303257,2.8103359598242093,7591000,1.3236103954934826,0.9646751734979292,-19239400.0,-1.0152897619010737,87.8223044403071,81.94094994263789,196.83811331319504,28.94202893315439,15.047298466355231,0.12252905560740635,2.121484529591917,152.0554034423828,150.61730255126952,149.4550018310547,148.29270111083986,146.85460021972656,0.08,0.0,155.45799580927255,0.02956289319950134,0.035783849714823644,148.83804975237166,147.48926980154855,2.2224220384076263
2024-05-17,0,154.5175018310547,145.72000122070312,153.49750137329102,148.10375118255615,150.07124996185303,0.16628338513972943,1.9294929064896422,-0.27424571673690146,2.9956487252534734,149.17124938964844,1.4486378479003919,0.012930730541817951,146.5375026702881,151.60000343322753,0.6010913675210487,0.04646091040875262,1.0355177639949287,1.0275631785214407,1.019570907167152,0.03150921211282842,75.44262232486759,153.0766112402254,149.2176254272461,145.35863961426682,151.67571585518974,1.8710057995877647,150.33357211521692,2.170211698582633,151.345708451932,150.194305518524,2.970082301959327,4.7818182163806595,6521800,1.3021424239841664,0.8461436165899574,-12717600.0,-2.129730703839217,87.8223044403071,81.94094994263789,192.57376596771746,29.45437860434441,14.444851983992583,0.09572946265614979,2.052078532634283,152.42212017822266,150.91393991088867,149.69499969482422,148.47605947875977,146.96787921142578,0.1,0.0,155.44994616810925,0.031552238457228876,0.03196524609249188,149.63831438337053,148.03918784005302,2.4899122377657634
2024-05-20,0,152.25500106811523,145.72000122070312,154.5175018310547,148.63249969482422,150.77124977111816,0.3910522283719093,2.1569807318395426,-0.010766227836530806,2.9956285272334227,149.3362522125244,1.6105002593994129,0.014417416846971192,146.5375026702881,152.316251373291,0.6992963351308771,0.03842407676955232,1.0176835541609077,1.0089610711729473,0.9984229000975512,0.010033671724148263,76.80113504401972,153.92333703588366,149.60937557220458,145.2954141085255,152.07571574619837,1.5962444154860045,150.80035781860352,1.7668758377553708,152.1474045618788,150.79318552798082,3.6160977593932175,5.442106072595463,7742300,1.2459710504450359,1.020219782826263,-20459900.0,-49.585547155734375,87.8223044403071,81.94094994263789,84.91355447077842,26.14155825778491,20.972849789589997,0.03165754034648369,2.146947941601693,153.15135931396483,152.09431851196288,151.23999786376953,150.38567721557618,149.32863641357423,0.1,0.0,155.41872813491932,0.008416769748292197,0.017228874718539285,150.010005405971,148.59492819649833,2.565775544157374
2024-05-21,0,151.5999984741211,145.72000122070312,154.5175018310547,148.83500003814697,151.02687454223633,0.21053048352560275,2.2225965657382885,-0.3506715656768957,2.9956222816011344,149.4912509918213,1.7195877265930164,0.014838863822294443,146.5375026702881,152.3792510986328,0.7875146847598311,0.01824079793177856,1.0121367806893373,1.0025261389428486,0.9921595611666669,0.0004289095617580063,59.8771130220407,154.22731879523388,149.7821256637573,145.33693253228074,152.3332154410226,1.281917669725747,150.92553629193986,1.756223323381225,152.1645420039147,150.9486600511436,1.873473087388331,4.484627911520804,5492400,1.3652657934150534,0.7464574056242529,-25952300.0,-51.4204342256699,87.8223044403071,81.94094994263789,61.67477282557462,24.557494449439286,21.284207322973508,0.0010895659051887536,2.122161911699317,153.1985621948242,152.17072317504883,151.34000396728516,150.50928475952148,149.4814457397461,0.1,0.0,155.39417691228385,0.007151110021290652,0.008216807280970635,150.36900547572546,148.68511962890625,2.6320116571102736
2024-05-22,0,152.18500137329102,145.72000122070312,154.5175018310547,148.83500003814697,151.5512523651123,0.08956445169988911,2.2563662692448267,-0.5138046444172382,2.995619003790729,149.62625122070312,1.8104001617431664,0.01505390779654543,146.5375026702881,152.3792510986328,0.8020897865868492,0.023425351927259058,1.0153400225475895,1.0047137782066502,0.9959034398877821,0.0,58.0157614487738,154.3984831183236,149.885750579834,145.37301804134438,152.53928702218192,1.0842979112664937,151.02035794939314,1.787820154255283,152.00949328097587,150.95328704785572,1.2032896786830447,1.1695214324520145,6609800,1.3307872064423043,0.9179474573752574,-19342500.0,-19.31820891122801,87.8223044403071,81.94094994263789,90.07199080225291,26.36535720390176,18.73092376460606,-0.0056336939898596824,2.239168593012314,153.1985621948242,152.17072317504883,151.34000396728516,150.50928475952148,149.4814457397461,0.1,0.0,155.37330532864692,0.013563935464051768,0.02220104011864253,150.8641858782087,149.02412850516183,2.8134128175662307
2024-05-23,0,151.16749954223633,145.72000122070312,154.5175018310547,149.09437561035156,151.74624919891357,-0.10576668319487521,2.271624103029369,-0.555397352047569,2.9956176641212138,149.82250022888184,1.8578502273559565,0.015135230840620718,146.5375026702881,152.3792510986328,0.7903834277461943,0.028103359598242093,1.007189084725781,0.9959842292101588,0.9892448758736195,-0.015179412109050272,60.64365050843559,154.63174880115153,150.08850059509277,145.545252389034,152.48678643362862,1.148051494380016,151.15964344569616,1.710862775476074,152.04950337629512,151.06171130630693,0.9569305704727692,0.8799716424164958,8000400,1.3318568423463335,1.108316599743853,-27342900.0,-74.24468960974806,87.8223044403071,81.94094994263789,16.312604851139128,23.095933132691595,19.237444689049784,-0.013810368329723032,2.373533219761607,153.2198013305664,152.20510177612306,151.38500213623047,150.56490249633788,149.55020294189453,0.02,1.0,155.33038666739793,-0.021842898496272745,-0.01152756856431819,150.79809352329798,149.13946315220423,2.702271949970808
2024-05-24,0,148.26749801635742,145.72000122070312,154.5175018310547,149.1193723678589,151.74624919891357,-0.27791856655164293,2.231792630817541,-0.36145866384620007,2.995621785961351,150.29500007629395,1.8086252212524414,0.014854293583930572,146.5375026702881,152.3792510986328,0.757893078072401,0.03191291816138631,0.9868340427681399,0.9757762730294036,0.9732350754592916,-0.04044851709763497,56.686338659427435,154.70921075754572,150.24562549591064,145.78204023427557,151.92714309692383,1.9759828473335737,151.10000038146973,1.8003105787206923,151.82670729159128,151.01988098123695,-0.24252094301096425,1.306815161990704,9517000,1.3008149681451373,1.2886557805019894,-36859900.0,-97.40732647379069,87.8223044403071,81.94094994263789,-93.13095444470576,21.018062386085212,25.23504207607133,-0.040130551572488786,2.4218591311821775,152.94839916992188,151.7657982788086,150.80999755859375,149.8541968383789,148.67159594726562,0.04,0.0,155.2505268525651,-0.0419165457611993,-0.039680980966450057,150.16351100376673,149.1097891671317,2.5719739894429785
2024-05-28,0,145.52749633789062,145.72000122070312,154.5175018310547,149.1193723678589,151.74624919891357,-0.21440816868140647,2.1129061315228084,-0.14949871661818603,2.9956333975874325,150.29500007629395,1.7198751449584961,0.01405471053097895,148.09499855041503,152.3792510986328,0.6619997663925811,0.011771292423074406,0.9680254152384113,0.9587091537117831,0.9631522990954127,-0.04418577178436911,42.97972952253081,154.5601878352502,150.33437557220458,146.10856330915897,150.78857094900948,2.967661173661427,150.84696442740304,2.2899454838878035,150.94080796676016,150.62570587804075,-2.5741717788104768,-0.5600193786440814,10499800,1.4788236237153463,1.3810574497959613,-47359700.0,-97.85237308926885,87.8223044403071,81.94094994263789,-186.72208832372718,19.29003479620283,30.769674116013267,-0.11014184986743408,2.4503019154779864,152.3324390258789,150.7687780456543,149.50499725341797,148.24121646118164,146.67755548095704,0.06,0.0,155.13249157475684,-0.045547635561185795,-0.05880044804846749,148.9352787562779,148.88666425432478,2.6788677074651894
2024-05-29,0,144.34750366210938,145.52749633789062,154.5175018310547,149.1193723678589,151.74624919891357,-0.3785734960009309,2.213184668373077,0.011860303233135916,2.9956236220169847,150.29500007629395,1.7706254959106444,0.014726718663558685,148.012748336792,152.3792510986328,0.5305068238338575,-0.001321060123523729,0.9605005432201698,0.9542138234221498,0.9639264563033206,-0.04783967602248862,35.021684787719465,154.70999455799858,150.28362522125244,145.8572558845063,149.33571406773157,3.307792504045433,150.50571496146065,2.8530355357869803,149.59326028996242,149.9187536980051,-5.192270209023215,-2.3764026056119936,8263800,1.5983087569693144,1.0909263725688214,-55623500.0,-93.45294953238287,87.8223044403071,81.94094994263789,-201.70870527939562,18.30714032290216,30.512904177619525,-0.06328868587848875,2.3974163335390255,152.22860205078126,150.60070294189453,149.28500366210938,147.96930438232422,146.3414052734375,0.08,0.0,155.03621318240218,-0.04496167073684343,-0.045151048607615936,147.6649213518415,148.65161786760603,2.572095929275131
2024-05-30,0,144.88249969482422,144.34750366210938,154.5175018310547,149.1193723678589,151.74624919891357,-0.6506114420852044,2.3693924874907175,0.49407928861326855,2.9956074305920684,150.29500007629395,1.839250373840332,0.015773341424460744,147.99349784851074,152.3792510986328,0.6996008217468171,-0.03670395696226706,0.9645008778330335,0.962322735220661,0.9769620827080819,-0.04798437173552117,26.733985122492463,154.95378531830417,150.21500034332274,145.47621536834131,148.28249958583288,3.395904492797355,150.17910766601562,3.2206149948587637,148.29174402312634,149.26516065113245,-6.58177749991384,-3.2036832492232534,8491100,1.2835643617460029,1.1669946839214738,-47132400.0,-85.91934596551923,87.8223044403071,81.94094994263789,-154.98473359838624,17.998523430082162,29.031640652335074,-0.09970029689371968,2.3397371335834096,152.22860205078126,150.60070294189453,149.28500366210938,147.96930438232422,146.3414052734375,0.08,0.0,154.94321652155207,-0.0535505022237589,-0.03940764060103277,146.8156520298549,148.41282871791296,2.7169588779305522
2024-05-31,0,146.22750091552734,144.34750366210938,154.5175018310547,149.09437561035156,151.74624919891357,-0.5997020488916155,2.6395867140665397,-0.17746455361973323,2.9955768055150123,150.27000045776367,2.0875003814697264,0.017601146308484725,145.46299667358397,152.3792510986328,0.789001911296082,-0.039606904175420524,0.9750661435831884,0.97599028719551,0.9958389758990865,-0.03267897293841748,28.45343242318972,155.24592376382643,149.96675033569335,144.68757690756027,147.51499993460519,3.1168048437443643,149.9241076878139,3.390029661858327,147.43764478101352,148.68867058957778,-4.8422063784904745,-3.0594507244389635,14621200,1.2624633364317641,1.9278728815905888,-32511200.0,-73.45297690242307,87.8223044403071,81.94094994263789,-96.31174746649766,22.456279110001788,26.998744816887502,-0.03894932305633331,2.3361836387494064,152.22860205078126,150.60070294189453,149.28500366210938,147.96930438232422,146.3414052734375,0.08,0.0,154.8101684562452,-0.020240458013307205,-0.04449510997400239,146.16771153041296,148.2683585030692,2.768744811383117
2024-06-03,0,147.66500091552734,144.34750366210938,154.5175018310547,148.86937427520752,151.74624919891357,-0.4033634789874952,2.751954498324489,-0.6193451960780934,2.99556294320151,149.62625122070312,2.21300048828125,0.018378801849470335,145.46299667358397,152.3792510986328,0.8552364204692597,-0.020037875091652564,0.9861739333192747,0.990390537917939,1.012440829435638,-0.004063581761955759,37.17932530984894,155.23915946967145,149.73525047302246,144.23134147637347,146.8692855834961,2.365790646495832,149.704286302839,3.4323933247133485,147.12744498124948,148.32953533011187,-3.5438638605994863,-2.3832171299776137,7329200,1.2734195536950503,0.9613408298995204,-25182000.0,-63.85649340518881,87.8223044403071,81.94094994263789,-52.81595143639709,25.276220088443946,25.15174769106665,-0.060212108975063634,2.3285980686606855,152.22860205078126,150.60070294189453,149.28500366210938,147.96930438232422,146.3414052734375,0.08,0.0,154.75559699232534,0.005239207596396067,-0.013092755500118878,145.35105460030692,148.1076202392578,2.7753831323960085
2024-06-04,0,147.44499969482422,144.34750366210938,154.5175018310547,148.1168737411499,151.74624919891357,-0.3248764460338516,2.787134985141158,-0.7629739109391425,2.9955584855731487,149.62625122070312,2.29062557220459,0.01862340778089193,145.46299667358397,152.3792510986328,0.878951498630806,-0.009641018703062549,0.9852154162641414,0.9934810052712826,1.0117683344956907,0.013176227209196645,44.280321518016926,155.23189535938144,149.6576253890991,144.08335541881678,146.33749989100866,1.4977218056110042,149.41214316231864,3.43864009888811,147.2576212765115,148.2916398031348,-2.9700695975135347,-2.0415605309836904,8876400,1.3223843016232695,1.1357263631844712,-34058400.0,-63.31839841472727,87.8223044403071,81.94094994263789,-59.51042285788559,23.62178094651965,25.296198440478683,-0.01721030325033439,2.313696545760465,152.22860205078126,150.60070294189453,149.28500366210938,147.96930438232422,146.3414052734375,0.08,0.0,154.6871755668035,0.02368741102339289,0.005647397761544553,145.08167157854353,147.93988255092077,2.7647578001937005
2024-06-05,0,146.94500350952148,144.34750366210938,154.5175018310547,147.61000061035156,151.74624919891357,-0.2470223061192571,2.8267703503727675,-0.9012570606928922,2.9955533925397075,149.62625122070312,2.373500633239746,0.018898713480535855,145.46299667358397,152.3792510986328,0.8805725736159866,-0.010900919053643902,0.9824185110603586,0.9933313976126436,1.005690798779042,0.01799476805288136,43.5079942880437,155.2282910288095,149.57475032806397,143.92120962731843,146.1485721043178,1.2814923308773956,149.0378576006208,3.3985514374664363,147.30095531721014,148.3168878295887,-2.4625001132416293,-2.699048977756314,5891300,1.3227249933118246,0.7608053458995636,-39949700.0,-79.73097987480944,87.8223044403071,81.94094994263789,-75.34364301665852,22.05263739334899,24.67121127234667,-0.023769432950109106,2.301288591553729,152.22860205078126,150.60070294189453,149.28500366210938,147.96930438232422,146.3414052734375,0.08,0.0,154.6373498473022,0.01059265993543379,0.011012573887388426,144.9398912702288,147.55170113699776,2.8281883140507618
2024-06-06,0,145.89500045776367,144.34750366210938,154.5175018310547,147.32000064849854,151.74624919891357,-0.1598864565136329,2.883120071757612,-1.0577446991014587,2.995546024198215,149.62625122070312,2.4797504425048826,0.019289148293790494,145.46299667358397,152.3792510986328,0.8793534328853921,-0.014618559809197854,0.9760919521596075,0.9893466975130137,0.9949670232245141,0.006988426932667213,41.59611853432936,155.23474066231407,149.46850051879883,143.7022603752836,146.2010726928711,1.2591402393623863,148.4948218209403,3.2345808524024924,147.20784166249646,148.34159377485767,-0.891965214581307,-3.4431762765612253,5016300,1.3254245387429437,0.6593831271898433,-44966000.0,-75.69513059614684,87.8223044403071,81.94094994263789,-81.04145480828431,20.45275497378446,26.570793538701174,0.018590663481364796,2.304053640502402,152.22860205078126,150.60070294189453,149.28500366210938,147.96930438232422,146.3414052734375,0.08,0.0,154.59239540357265,0.007846890600282652,0.013708029186202921,145.2291216169085,147.08220018659318,2.8715697425692697
2024-06-07,0,147.0999984741211,144.34750366210938,154.5175018310547,146.76562786102295,151.74624919891357,-0.06705244054030474,2.986451831208098,-1.2424897736856986,2.995532118886321,149.62625122070312,2.6560503387451178,0.020002088425580388,145.46299667358397,152.3792510986328,0.8702596177729457,-0.023819887790140836,0.985218360509056,1.001791089432302,1.001801317620802,0.00596671319095976,37.53101165904223,155.279904394838,149.30700073242187,143.33409707000573,146.5942862374442,0.983415478594517,147.9650001525879,2.7421997969134155,146.8764792942795,148.23799786463766,0.25253242797482306,-4.952849947074252,5111600,1.3368255638307402,0.678305721927298,-39854400.0,-67.50244258454873,87.8223044403071,81.94094994263789,-46.412285471875535,23.27041578515131,24.938758692601436,-0.01502411509907784,2.2794771274372354,151.63268298339844,150.11866369628908,148.89500427246094,147.6713448486328,146.15732556152344,0.08,0.0,154.55348793871804,0.0027954590457597295,0.012389955370465772,145.60342407226562,146.63417271205358,2.8979658099122516
2024-06-10,0,146.7050018310547,144.34750366210938,154.5175018310547,146.76562786102295,151.74624919891357,0.032867459771907,3.024479652807354,-1.3190294861948053,2.9955268029245947,149.0324993133545,2.7590003967285157,0.020272771941422386,145.46299667358397,152.3792510986328,0.8887899971445007,-0.018007657839680013,0.9833483396148222,1.0018763313105938,0.997925319515471,-0.006501195804832771,43.28394859860557,155.2382098701899,149.1892505645752,143.14029125896047,146.85464368547713,0.6337952865062851,147.568571635655,2.461064284926192,146.93842143432147,148.2655776096992,1.9068530748233765,-4.800429251725603,5751300,1.3683205505781755,0.7629874221762912,-45605700.0,-67.02025285164389,87.8223044403071,81.94094994263789,-52.85737542792165,21.82666077738112,25.733896104605893,-0.016337639901013473,2.256655228295058,151.63268298339844,150.11866369628908,148.89500427246094,147.6713448486328,146.15732556152344,0.08,0.0,154.5073794345345,-0.004128894005663075,0.0031363482319308553,145.86572047642298,146.34068625313895,2.9205471519964767
2024-06-11,0,146.54249954223633,144.34750366210938,154.5175018310547,146.58562660217285,151.74624919891357,0.1558703364319875,3.0681663059694753,-1.3751545924016344,2.9955205650343126,147.96624946594238,2.8373378372192377,0.02058693604315155,145.46299667358397,152.3792510986328,0.8843070900146719,-0.026784075267076258,0.9832782075110889,1.0018355893180715,0.9981235185758436,-0.006120927494698725,40.650098295939486,155.1709582375493,149.03462562561035,142.89829301367138,146.89964348929269,0.5916262653399559,147.20732171194894,2.178783832831654,146.88900945694695,148.1727111354506,1.2579173744719534,-3.645199959361342,5661200,1.344809238998252,0.750871575786474,-51266900.0,-70.58833916022178,87.8223044403071,81.94094994263789,-55.11663581393145,20.617761461710483,24.823822632809026,-0.008151911442857897,2.218320468949039,151.63268298339844,150.11866369628908,148.89500427246094,147.6713448486328,146.15732556152344,0.08,0.0,154.46072759289532,-0.0070365344516503114,-0.006633329007686574,145.87848118373327,146.02309635707311,2.933070343469371
2024-06-12,0,146.1150016784668,144.34750366210938,154.5175018310547,146.46374988555908,151.74624919891357,0.3225203583792724,3.0877560282155176,-1.3394959004044453,2.9955174964322775,147.55500030517578,2.834550399780272,0.020747614959735688,145.46299667358397,152.3792510986328,0.8763081760467293,-0.03294621044128697,0.9817931750320168,0.9982203361236252,0.9964367976693946,-0.005648384165718889,38.944449326149225,155.0001376438944,148.82462558746337,142.64911353103236,146.67821502685547,0.5457115630995603,146.77375030517578,1.6524195967992916,146.8081579654141,147.9898400366427,0.21541681608232688,-3.336081123211955,6180500,1.3239930074218234,0.8311793453849071,-57447400.0,-81.38007798202703,87.8223044403071,81.94094994263789,-65.43505123981227,19.015361115183286,25.00543216961899,-0.022762079289086256,2.233441855727141,150.68531878662108,149.35234030151366,148.2750015258789,147.19766275024415,145.86468426513673,0.08,0.0,154.406304109016,-0.003836436201026583,-0.016170485439115055,145.54813058035714,145.44959259033203,2.9841785631636313
2024-06-13,0,145.10000228881836,144.34750366210938,154.5175018310547,146.1993761062622,151.74624919891357,0.5229024951575457,3.0758075130051217,-1.175928487672278,2.995518670358566,147.27249908447266,2.7532126617431656,0.0207050316200311,145.46299667358397,152.3792510986328,0.8585921617464347,-0.039885663107728064,0.976751673423579,0.9900905760510991,0.9906364166121371,-0.0054491118026724905,36.3422297363157,154.70524051429152,148.55362548828126,142.402010462271,146.34321539742606,0.6957046928654053,146.34035764421736,1.1219203349818827,146.64176910266835,147.7437156517198,-1.0496727236992558,-3.9885663107728067,6840400,1.3066447943220107,0.9119998293433452,-64287800.0,-71.47552711691002,87.8223044403071,81.94094994263789,-78.04515415355372,17.721349533290883,26.19272958410883,-0.025058731059617898,2.225338092519348,148.3703997192383,147.4798010559082,146.76000213623047,146.04020321655273,145.14960455322264,0.08,0.0,154.34209594061718,-0.006624773087530067,-0.003562480277490703,145.2149440220424,145.14830780029297,2.951148608626547
2024-06-14,0,145.28249740600586,144.34750366210938,154.5175018310547,146.06000137329102,151.27562427520752,0.7317593769458214,3.0450172325084135,-0.8602839748149553,2.9955222154911603,147.0225009918213,2.6094372940063493,0.020546761560467166,145.07825202941893,152.3792510986328,0.8075897429545268,-0.05470772494238036,0.9803178784152067,0.99118872708271,0.9929602504805625,-0.012355547837989866,30.665869702171054,154.28940999907445,148.19937553405762,142.1093410690408,146.10571452549524,0.7384846189255848,146.12714331490653,1.0050610950095982,146.26809149192417,147.372010294291,-1.5904217917592605,-4.013757766577799,4075300,1.2560252915514412,0.5563811537881307,-60212500.0,-64.74005603723272,87.8223044403071,81.94094994263789,-70.5107760063523,16.853277718008567,24.909691276300343,-0.06066034522922925,2.1728117790193586,147.67515692138673,146.91741879272462,146.30500030517578,145.69258181762694,144.93484368896483,0.08,0.0,154.3051641273942,-0.010470578089516236,-0.006010082851927485,145.1539764404297,145.04693385532923,2.7468552243114606
2024-06-17,0,145.5349998474121,144.34750366210938,154.5175018310547,145.8031244277954,148.99249839782715,0.9526829914698964,2.8504940363197795,-0.33146262833752926,2.995547376109602,146.8250026702881,2.32607482910156,0.019287641588417555,145.07825202941893,152.19200134277344,0.740818629848415,-0.05976672102262005,0.9847510220548958,0.9935519937692092,0.9971633878934005,-0.007975201724818803,30.166809801584797,153.4896134083329,147.78862533569335,142.0876372630538,146.0542858668736,0.7675673337764696,146.12767927987235,1.0047186681836855,146.03265313574215,147.04086824820317,-1.1313798113645293,-2.013253511583669,6666600,1.2180672246359465,0.9092601571626435,-53545900.0,-56.840158644757466,87.8223044403071,81.94094994263789,-56.45014010315635,17.438453107582983,23.503416810581886,-0.06842117168561135,2.1383227491973487,147.67515692138673,146.91741879272462,146.30500030517578,145.69258181762694,144.93484368896483,0.08,0.0,154.24790556594516,-0.008020228895917803,-0.0076830163828180325,145.08733912876673,145.1582303728376,2.4092174047664923
2024-06-18,0,145.81499862670898,144.34750366210938,152.25500106811523,145.53312397003174,147.81562519073486,0.9956335039667817,2.4318008438109215,-0.32668847401567014,2.9955968000413824,146.6237506866455,1.9208497428894078,0.016504744755529672,145.07825202941893,151.6584987640381,0.7673098002669559,-0.04413648926840017,0.9896531370925304,0.996913156157744,1.0006862606733444,-0.004964436377159376,34.28070748791414,152.20310192413308,147.33950023651124,142.4758985488894,145.87071446010046,0.6141134487944425,146.23250034877233,0.8725689039818225,145.9119794431739,146.694380426298,-0.2467532192481003,0.005156076831049491,6156600,1.1527280431437563,0.848880609876996,-47389300.0,-64.74117754339036,87.8223044403071,81.94094994263789,-50.144486147422576,16.757235730354726,22.58527711912927,-0.02944141439700331,2.0662970219249224,147.7152764892578,146.98235809326172,146.38999938964844,145.79764068603515,145.06472229003907,0.08,0.0,154.19606720949335,-0.007563371270838504,-0.010059169186170024,144.88459123883928,145.24400765555245,2.238001556875856
2024-06-20,0,146.5349998474121,144.34750366210938,152.18500137329102,145.53312397003174,147.5,1.2483662112471818,2.172111668857223,0.5085504621861703,2.9956237877852296,146.38500022888184,1.6307495689392055,0.014774510974315402,145.07825202941893,151.21074943542482,0.7365538394319667,-0.03815962998442667,0.9967180759661046,1.0029533822264327,1.0066325698592913,0.002874435643983597,37.3174297478026,151.36172345215536,147.0175001144409,142.67327677672645,145.84642846243722,0.5779162221040159,146.35053607395716,0.783082888121176,145.88916179194013,146.48033220596483,-0.8735553098174749,1.0166403487203644,8749700,1.1587562841208852,1.1799244148217074,-38639600.0,-22.310708532174232,87.8223044403071,81.94094994263789,9.993702747578753,20.68481661760395,20.268696806716495,0.03718734017455086,2.137993408748064,147.7152764892578,146.98235809326172,146.38999938964844,145.79764068603515,145.06472229003907,0.02,1.0,154.1337238148461,0.016298709510156995,0.006950105132086359,144.97674778529577,145.42123413085938,2.0151095915807797
2024-06-21,0,148.27249908447266,144.34750366210938,152.18500137329102,145.53312397003174,147.18624877929688,1.5621247242204273,1.9014755688214535,2.0134445399874004,2.995648899426401,146.38125038146973,1.3425250244140643,0.012955985987385494,145.07825202941893,148.55749816894533,0.6066620188934579,-0.03712587623546522,1.0102766777296615,1.0151305029317768,1.0179810268090692,0.02186420913584497,41.9045705462457,150.56720132074838,146.76425018310547,142.96129904546257,146.09357125418526,1.0783992579285424,146.49660737173897,0.9344654231890749,146.04459290045193,146.392514019179,-0.11588015508724932,1.1405795427802965,15176900,1.164587739194839,1.9348838513838265,-23462700.0,-6.346192783175414,87.8223044403071,81.94094994263789,114.7460399808855,22.875413493592937,19.09390787129494,0.06542580907974907,2.107421824347413,147.85280255126952,147.09360299682618,146.4800033569336,145.866403717041,145.10720416259767,0.04,0.0,154.04933688162222,0.022688246433424375,0.022969496936075223,145.25889151436942,145.56868634905135,1.3648385723434213
2024-06-24,0,149.00249862670898,144.34750366210938,151.16749954223633,145.53312397003174,147.18624877929688,1.2857597365097386,1.4905883796520465,2.15443129053431,2.9956807809929753,146.38125038146973,1.1018500518798817,0.010169900815769644,145.07825202941893,148.26799812316895,0.39818735347808276,-0.019150944922223884,1.0166056927729534,1.0184705683454036,1.0185558602452707,0.025605295112096194,54.54779869318837,149.54980182796865,146.56862506866455,143.58744830936044,146.50607081821985,1.5409941444965511,146.59214292253768,1.1141917415710318,146.58533813691088,146.5211680926261,1.1805445844314328,1.398504492069974,6914700,1.2352635950095274,0.8876898458125603,-16548000.0,-10.274083557599353,87.8223044403071,81.94094994263789,171.49336239365775,23.861507453481174,18.071447726817674,0.11775853852401943,2.0676048599154893,148.34176208496095,147.48912261962892,146.8000030517578,146.1108834838867,145.25824401855468,0.06,0.0,154.01572646374473,0.024597995892569502,0.02523200645215506,145.78489685058594,145.66651371547155,1.299819282328535
2024-06-25,0,148.12749862670898,144.34750366210938,149.00249862670898,145.53312397003174,147.18624877929688,0.3369967670458227,1.203677842608651,-0.6241823131867443,2.995698532339342,146.38125038146973,0.9876249313354493,0.008218453915747147,145.07825202941893,148.26799812316895,0.46019363018860737,0.004957260493263834,1.0113827620853784,1.0111747775462805,1.0074507551150624,0.017813575992132513,63.31302740606767,148.86773070810548,146.46037502288817,144.05301933767086,146.9385702950614,1.505024172935792,146.64089284624373,1.1680089163991734,147.17357513822753,146.76292820243,1.9761810321135032,0.9057648751492334,6620300,1.064429946077209,0.8659975329345391,-23168300.0,-43.32192407179996,87.8223044403071,81.94094994263789,89.21889939315788,22.010764099939948,20.891075986681177,0.13994319018283652,2.0813474063099764,148.34176208496095,147.48912261962892,146.8000030517578,146.1108834838867,145.25824401855468,0.06,0.0,153.97619081735536,0.008496115949918837,0.01133710793250005,146.03159659249442,145.62327030726843,1.3047236007883147
2024-06-26,0,146.49750137329102,144.34750366210938,149.00249862670898,145.53312397003174,147.18624877929688,0.32598298409936455,1.193512349772227,-0.6072101066427815,2.9956990954325513,146.38125038146973,0.9806249618530274,0.008149435609367147,145.07825202941893,148.14199867248536,0.675781544244651,0.01786605524210756,1.0003012994399698,0.9990776399909825,0.9928634765960389,0.00468060729698494,61.65519565874943,148.84039975295022,146.45337505340575,144.06635035386128,147.11214229038782,1.3436058625753944,146.60892840794153,1.1651660970673248,147.4039594470749,146.91429025651976,2.0864895176668985,0.46288374193589116,5267800,0.8723190427901661,0.7134933652620643,-28436100.0,-49.65746087320043,87.8223044403071,81.94094994263789,4.422132189995609,20.920532903366624,23.9312578914744,0.2205702364040308,2.0333928924462867,148.34176208496095,147.48912261962892,146.8000030517578,146.1108834838867,145.25824401855468,0.06,0.0,153.93916836072944,0.008033006896985606,0.0059610703801967905,146.21307809012276,145.68352726527624,1.2052945337948013
2024-06-27,0,146.20000076293945,144.34750366210938,149.00249862670898,145.74499893188477,147.18624877929688,0.2426490911928867,1.174459127194387,-0.5177466859754212,2.9957001599327264,146.51625061035156,0.9321247100830078,0.008016683231855492,145.07825202941893,148.14199867248536,0.6244709326233622,0.014894595726534938,0.9979394492964169,0.9970793555919903,0.9899314174321667,-0.0022861369967686063,52.04102332119413,148.85079355956458,146.5018753051758,144.152957050787,147.20714242117745,1.2324169336708368,146.63071414402552,1.1535843966812571,147.18009824111095,146.89240184740052,0.8363044337610134,-0.3045371571286344,5739200,0.912915491896115,0.7908632911113316,-34175300.0,-67.12329840879994,87.8223044403071,81.94094994263789,-47.77962462078567,19.099678339886673,25.094970435809053,0.2233163375370466,2.068151783224614,148.34176208496095,147.48912261962892,146.8000030517578,146.1108834838867,145.25824401855468,0.02,1.0,153.89600981491603,-0.013398212267765719,0.0010299349315885489,146.19181387765067,145.6395765032087,1.110202218533715
2024-06-28,0,146.22999954223633,144.88249969482422,149.00249862670898,145.875,147.18624877929688,0.46889918310856227,1.0692359098060766,-0.41800452976071645,2.9957057032672214,146.51625061035156,0.8506499481201161,0.007293833729351909,145.2642478942871,148.14199867248536,0.5852444042732852,0.009093583220129247,0.997513545067635,0.9972261380057521,0.9905839306634504,-0.013775309344942643,49.372625082055606,148.73297197982944,146.59450016021728,144.45602834060512,147.2664282662528,1.1622714235349567,146.56857136317663,1.1497866270317951,146.93907654528255,146.86216649483407,0.45693538751817214,0.209054665491487,10495700,0.9115947753235674,1.4266063712517552,-23679600.0,-60.958900530400015,87.8223044403071,81.94094994263789,-31.956291055552548,18.141489066640023,23.83601041270655,0.1664286000312721,2.021855029916727,148.34176208496095,147.48912261962892,146.8000030517578,146.1108834838867,145.25824401855468,0.02,0.0,153.8211718377355,-0.01741170196107611,-0.010962183131546406,146.26412309919084,145.57435716901506,1.0675719382602897
2024-07-01,0,146.70750045776367,145.10000228881836,149.00249862670898,146.06000137329102,147.18624877929688,0.6205632999904875,0.9994107246632941,-0.24150208313472454,2.9957090878558827,146.51625061035156,0.7967499542236339,0.006814386653815118,145.50974960327147,148.14199867248536,0.6383858652601612,1.7087255771592383e-05,1.000311091789385,0.9997121022911039,0.9965763589845587,-0.0154024139869956,47.291108711416015,148.66069660191448,146.6618751525879,144.6630537032613,147.29107121058874,1.1458920114966962,146.56874983651298,1.149809626882578,146.76733510025588,146.8108042006417,0.2846078383128194,-0.5914336783883939,5144400,0.8606094945426637,0.7473773366437754,-18535200.0,-56.16439787839992,87.8223044403071,81.94094994263789,18.393033208471703,21.7896674659909,21.335795720672223,0.1293404150373473,2.0974386974921773,148.34176208496095,147.48912261962892,146.8000030517578,146.1108834838867,145.25824401855468,0.02,0.0,153.7880349621678,-0.017971958251839615,-0.01552933345529659,146.07413809640067,145.52544294084822,1.0697893077828502
2024-07-02,0,146.33749771118164,145.10000228881836,149.00249862670898,146.06000137329102,147.18624877929688,0.5616663398523781,0.9944424730486754,-0.24549783074786813,2.995709322095353,146.53874969482422,0.779712505340575,0.006779401712464742,145.50974960327147,148.14199867248536,0.6664761278861244,-0.006484274891322527,0.997625010463959,0.9962234088619792,0.9971720928708216,-0.012084190525881056,48.25547099295973,148.67476007579705,146.6858751296997,144.69699018360234,147.0146424429757,1.1022418605021171,146.5541068485805,1.151473802872331,146.7552994345585,146.75033686436322,0.11771973284961856,0.0017031639533748076,5492000,0.8008440789203548,0.808668597537183,-24027200.0,-63.18501293339952,87.8223044403071,81.94094994263789,-28.242130793963778,20.71827971233132,20.286724628358005,0.11210134789933637,2.0483340473975353,148.34176208496095,147.48912261962892,146.8000030517578,146.1108834838867,145.25824401855468,0.02,0.0,153.7498805354183,-0.007880960714900853,-0.020721488878876516,145.68849400111608,145.47369275774275,1.054788608825682
2024-07-03,1,145.81999969482422,145.10000228881836,149.00249862670898,146.06000137329102,146.9837522506714,0.7553473699923637,0.9708986282678184,0.159164926935492,2.995710384872507,146.51625061035156,0.7349000549316429,0.006621892916494071,145.50974960327147,148.14199867248536,0.6530131980689174,-0.007511288859811059,0.9945471081621161,0.9921583985078432,0.9960756703648159,-0.004624663711775168,45.97953901383109,148.56129722601807,146.61949996948243,144.6777027129468,146.55999973842077,0.743675767290301,146.5330352783203,1.1627711842790724,146.6502487049359,146.59419131462553,-1.3050305250393208,-0.13989240779641682,3246200,0.8032130285287784,0.4986558933316948,-27273400.0,-69.00687168499987,87.8223044403071,81.94094994263789,-75.79014393863304,19.331636980568423,22.433094793087818,0.08144381876551071,2.0384520180343104,148.34176208496095,147.48912261962892,146.8000030517578,146.1108834838867,145.25824401855468,0.04,0.0,153.72566743857178,-0.007696517330620156,-0.010190859656561042,145.20218767438615,145.49354226248605,1.0406679100808742
2024-07-05,1,145.82500076293945,145.10000228881836,149.00249862670898,145.8762502670288,146.76687622070312,0.9592878532211397,0.9664006045653579,0.49534103877970637,2.9957105727145326,146.41749954223633,0.7096500396728516,0.006594869290213424,145.50974960327147,148.14199867248536,0.6514308846107865,-0.007655951463666947,0.9951326755526867,0.9921890495999153,0.9970326689507224,-0.002564979466778916,43.23484740452643,148.47105117861315,146.53824996948242,144.6054487603517,146.23107147216797,0.32765224957840944,146.58482088361467,1.108937939305915,146.44410128193923,146.42487551475568,-2.135869506361618,-0.20189712230352938,4888500,0.8037289329610546,0.7567618611217755,-22384900.0,-61.832101080635624,87.8223044403071,81.94094994263789,-57.07823302028206,17.943517257926917,21.662941916630764,0.15781591928142885,2.0392771071950078,148.4833599243164,147.71831912231445,147.0999984741211,146.48167782592773,145.71663702392578,0.06,0.0,153.69015377310305,0.0046638408186459035,-0.0023158246587208524,145.10152326311385,145.56655992780412,1.0318722334797978
2024-07-08,1,146.08749771118164,145.10000228881836,149.00249862670898,145.82375049591064,146.70562648773193,1.0875118902490895,0.9736313021562136,0.6358765079039199,2.9957102365303063,146.28374862670898,0.7149749374389642,0.006646752785896237,145.50974960327147,148.14199867248536,0.6831454049933775,-0.00047979502110823553,0.9973051197573495,0.9944554740235922,0.9993398598830983,-0.0009745047630498327,45.16661099996851,148.42951243646576,146.48224983215331,144.53498722784087,146.17249952043807,0.30815304580895536,146.64232090541296,1.0558139388252197,146.289983720613,146.33944886630502,-1.554402717332031,0.4996543505754054,5260200,0.7690560433768784,0.8127683211641614,-17124700.0,-81.22613987804664,87.8223044403071,81.94094994263789,-44.60751625735868,19.054856525372873,20.16449194152089,0.10682653302568393,2.034328744253206,148.48808093261718,147.72596075439452,147.11000061035156,146.4940404663086,145.73192028808595,0.06,0.0,153.65297096561045,-0.004652564022457728,-0.0021949409116423188,144.91153390066964,145.5623059953962,1.0602433890803704
2024-07-09,1,146.25749969482422,145.10000228881836,149.00249862670898,145.82375049591064,146.70562648773193,1.0820926475433341,0.9687175259184181,0.6612395142554295,2.9957104607422242,146.28374862670898,0.7063125610351563,0.006612773083397808,145.50974960327147,148.14199867248536,0.7232570516453067,-0.006883077997567618,0.9984000819124729,0.9970957890047137,1.0006978897664285,-0.003067333037065856,44.841479667897374,148.42930974666106,146.49187469482422,144.55443964298738,146.18071365356445,0.30977040026268765,146.69392803737097,1.0143698782264536,146.24153006885575,146.33819170863876,-0.2798707542899606,0.5540931079441254,5890400,0.7182098874693585,0.9046989699572793,-11234300.0,-51.149378248338195,87.8223044403071,81.94094994263789,-0.4159424611929196,17.7463121696321,19.026287028119818,0.1573240880121181,2.0283060380079387,148.48808093261718,147.72596075439452,147.11000061035156,146.4940404663086,145.73192028808595,0.06,0.0,153.61428263437784,0.0041654426687054436,0.006089147039746971,145.08875819614954,145.6402860369001,1.0594649960432188
2024-07-10,1,148.2099952697754,145.10000228881836,149.00249862670898,145.82375049591064,146.58312511444092,1.2314395975458066,0.9596327370523806,0.9986386153437841,2.9957108621325403,146.24374961853027,0.679200134277346,0.006552641698959176,145.50974960327147,148.14199867248536,0.7331500545420134,-0.003050353639242728,1.0120194504726054,1.0123011265734425,1.0146817432438093,0.012795746735326796,47.515615027917235,148.36901522996413,146.4497497558594,144.53048428175464,146.46357018607003,0.8297837327154315,146.86499922616142,1.0558456060449024,146.2425825235062,146.32374012086186,0.03932895457230473,0.4964440500014587,6093200,0.7151362587604497,0.9333960376777538,-5141100.0,-5.555717952165754,87.8223044403071,81.94094994263789,157.9854455618508,24.073564546994398,17.20571306208925,0.17752062863228926,2.082714168954169,148.48808093261718,147.72596075439452,147.11000061035156,146.4940404663086,145.73192028808595,0.02,1.0,153.58615862001506,0.023282793560416737,0.020417755841121252,145.55237906319755,145.9082510811942,1.234957808123827
2024-07-11,0,149.625,145.10000228881836,149.00249862670898,145.82375049591064,146.58374977111816,1.0152776536787715,1.0329075511703165,0.072902832526756,2.9957074854605605,146.24374961853027,0.7722495460510288,0.0070493605541988935,145.50974960327147,148.21624565124512,0.6168127955444791,0.011378922379159082,1.021156803168815,1.0219082841487723,1.0217495315703322,0.026093816439027417,63.15455303421775,148.59081453013607,146.52499942779542,144.45918432545477,146.88035583496094,1.4634668205771475,147.08571352277482,1.280601623662673,146.72991334038264,146.56746689063115,1.3540284030207979,1.6424899123015964,6350400,0.8387649149043359,0.9676873728561741,1209300.0,-14.47376016102033,87.8223044403071,81.94094994263789,190.2047114980849,26.28957502458812,16.05529918141951,0.1580066903533378,2.0725203333786593,149.1451213989258,148.2574411315918,147.54000091552734,146.82256069946288,145.93488043212892,0.04,0.0,153.56355396138028,0.02752411984108094,0.025131789099538542,146.01458304268974,146.0443605695452,1.4087756671961682
2024-07-12,1,150.00000381469727,145.10000228881836,149.625,145.82375049591064,147.0625,1.0103944829835683,1.234353414248749,-0.10258620616103986,2.9956969638124296,146.24374961853027,0.9870245361328103,0.008415331212750475,145.50974960327147,148.3454990386963,0.6008007697569354,0.02402216255150259,1.0226404362341979,1.0222858629634957,1.0190148514745516,0.028630228218170295,70.97922852565837,149.14783127918108,146.6791244506836,144.2104176221861,147.40357099260603,1.842626778821162,147.2091067177909,1.472587788918344,147.44514724176716,146.98199879582134,1.9886505687391636,2.1087113357256144,5336400,0.8791265895992089,0.8184355035738687,6545700.0,-15.673969195446283,87.8223044403071,81.94094994263789,172.80111202003403,25.830740720229667,15.134078832811502,0.17286616319348497,2.0416255841478126,149.37432373046875,148.44284301757813,147.69000244140625,146.93716186523437,146.00568115234375,0.06,0.0,153.54648261188822,0.023211371750044174,0.02875966017786378,146.56044006347656,146.1244670322963,1.525234143338859
2024-07-15,1,149.61000061035156,145.10000228881836,150.00000381469727,145.82375049591064,148.1481227874756,0.8890580386635425,1.4217578941863376,-0.4650645761873222,2.995685553367443,146.29749870300293,1.1997248077392555,0.009680160876468292,145.50974960327147,149.0647487640381,0.6615717083791066,0.0337698239047961,1.018632553797456,1.0169940938990212,1.0106325577543225,0.02411228171033497,74.99553854426671,149.7168903458678,146.8733745574951,144.02985876912243,147.94499969482422,1.8565316678320278,147.25249971662248,1.5370393108536815,148.07638420715017,147.41694765475904,2.5027803268469944,1.1650877545676415,6711400,0.832862927004728,1.0303363860852237,-165700.0,-25.705299913900316,87.8223044403071,81.94094994263789,120.19596074186589,24.55403833667777,15.711280651333974,0.1238835548266058,1.9943663999850796,149.37432373046875,148.44284301757813,147.69000244140625,146.93716186523437,146.00568115234375,0.06,0.0,153.5219694849657,0.025845571652556742,0.01884218347525909,147.06376211983817,146.13297489711218,1.554674973699644
2024-07-16,1,150.23500061035156,145.28249740600586,150.00000381469727,146.0218734741211,148.2256212234497,0.7315378396189275,1.4791074825798274,-0.9394479083341403,2.9956818423187563,146.41749954223633,1.315537471771242,0.010055192385891221,145.7869987487793,149.61150054931642,0.723838226568227,0.029786817280901226,1.0213198513449075,1.018901585953511,1.0100477054578167,0.027195192888068265,70.61769580636013,150.05708943873145,147.09887447357178,144.1406595084121,148.57499967302596,1.7631254406197017,147.40303557259696,1.7214663211654744,148.46043314007642,147.77130322215166,2.599095407666406,0.4077126150511963,6469600,0.845308693290779,0.9752906078380827,6303900.0,-1.0639408014804268,87.8223044403071,81.94094994263789,143.03136881572266,25.841687964595817,14.627996169586,0.1538685509894193,1.9890543247572456,149.52712139892577,148.5664411315918,147.79000091552734,147.0135606994629,146.05288043212892,0.08,0.0,153.50414531066335,0.02692955482230963,0.0380120976213535,147.7060285295759,146.40377589634485,1.7158179656360626
2024-07-17,0,154.26000213623047,145.5349998474121,150.23500061035156,146.171875,148.45499897003174,0.6171631474143201,1.5662834353212367,-1.1889621891560074,2.9956758974520254,146.51625061035156,1.4310499572753883,0.010629933111502714,145.8194995880127,149.66250038146973,0.7298080161777455,0.03229464230506218,1.0469200321665193,1.0437024342990318,1.031591068861459,0.04082050509105484,72.98056426734698,150.47906650443153,147.34649963378905,144.21393276314657,149.74250030517578,2.423559738282082,147.95749991280692,2.487178974082943,148.91081825107045,148.15226094481037,3.024172689415054,1.4227621496219425,13801400,0.8499619507967574,1.9743785987625622,20105300.0,-7.005413989919101,87.8223044403071,81.94094994263789,274.68758957247496,40.485582810536165,11.696731318727519,0.19453776955520963,2.3098402364229345,154.42436419677733,152.5278233947754,150.99500274658203,149.46218209838867,147.56564129638673,0.1,0.0,153.52421597330064,0.04784864053103566,0.06480796171414777,149.27980041503906,147.09566715785436,2.611519442564003
2024-07-18,0,155.6775016784668,145.81499862670898,154.26000213623047,146.2224998474121,149.15437412261963,1.391506154412805,2.1186502557460902,1.7812059204147763,2.99563017644992,146.6212501525879,1.7297751045227046,0.014336248712082621,145.82450065612792,150.02350349426268,0.5720456645384068,0.05791587689234193,1.0534213360063114,1.0476772233314775,1.0327139705014934,0.040451139037372075,83.20065474419032,152.02005025972213,147.78274974822997,143.54544923673782,151.08821487426758,2.7581463874216867,148.63446426391602,3.1685044273667424,150.25578866232175,149.01023764358587,5.594253138078974,5.298725705334582,10166200,1.1977513488248976,1.4137924800402741,30271500.0,-15.935384517797802,87.8223044403071,81.94094994263789,232.14761875402218,37.43147507066654,10.814365914260513,0.17784865137794548,2.3198526154769894,154.42436419677733,152.5278233947754,150.99500274658203,149.46218209838867,147.56564129638673,0.1,0.0,153.5434614716624,0.03820974680170708,0.04008571422986061,150.4665069580078,147.7776325770787,3.0209840147528717
2024-07-19,0,155.4574966430664,145.81999969482422,155.6775016784668,146.25062465667725,149.61375045776367,1.432496366972528,2.677360578675327,1.380158477313521,2.995570620620613,147.41749954223633,2.047888317108158,0.018056616293555646,146.0612480163574,150.63750076293945,0.6850115186839828,0.06239125014893941,1.0484341889538829,1.0393020158624742,1.0230394542666261,0.036383284597186094,85.1044101122362,153.63059605816855,148.27587490081788,142.92115374346722,152.12357221330916,2.856190654047406,149.29357119968958,3.5648160691714526,151.6184289461716,149.88603971283783,6.440696718662649,6.482558731921577,7398000,1.2161807290622164,1.0385861862983274,22873500.0,-21.55505671826931,87.8223044403071,81.94094994263789,173.47692613741705,34.68286491005225,11.556464461410084,0.10296283765157072,2.324863143695827,154.42436419677733,152.5278233947754,150.99500274658203,149.46218209838867,147.56564129638673,0.1,0.0,153.55344392250035,0.03209238549801752,0.033333418918981374,151.21227809361048,148.382328578404,3.3106321858870125
2024-07-22,1,154.4275016784668,145.81999969482422,155.6775016784668,146.25062465667725,149.71875095367432,1.1669109808795244,3.065368581497476,0.2434079783094214,2.9955215139972813,148.1687469482422,2.4091506195068346,0.020611399704442254,146.0612480163574,154.37975158691407,0.8001898693797557,0.04845805933641389,1.0383635369872493,1.0258100853336494,1.0090135208545532,0.03220039468258595,82.59062409748536,154.85273690359557,148.72199974060058,142.5912625776056,152.80964388166154,2.7299974923705097,149.84499985831124,3.7273967741191645,152.5821009682084,150.5664878670071,4.890021998920478,6.3102626887206235,6840600,1.187976611182027,1.0200213827831317,16032900.0,-25.019234993474786,87.8223044403071,81.94094994263789,128.20387412839773,33.02208384914193,12.672743637093566,0.03250081596430781,2.2673727518072364,154.42436419677733,152.5278233947754,150.99500274658203,149.46218209838867,147.56564129638673,0.1,0.0,153.55790454829398,0.0335031229280236,0.029089988114121258,151.85596575055803,148.9352743966239,3.5197858492698884
2024-07-23,1,152.68250274658203,145.81999969482422,155.6775016784668,146.25062465667725,150.05875301361084,0.9088133745992292,3.3044378454221897,-0.5444846217042651,2.9954880551552647,148.1687469482422,2.7054508209228514,0.022173008062470898,146.0612480163574,154.53050117492677,0.8644694510659453,0.03640880590431502,1.0245102261760535,1.0086308432718214,0.991370788558035,0.016291158027670782,73.86570554988221,155.63862556114466,149.0297498703003,142.42087417945592,153.19285801478796,2.4430661714888315,150.29821450369698,3.653118050420637,153.04254752890512,150.96891943645787,3.2096920156837405,5.262172142947574,6261900,1.2249715584747294,0.9382965046323698,9771000.0,-39.56887772182499,87.8223044403071,81.94094994263789,74.04875998736402,30.279285494020293,17.90402537620293,0.011968097103854684,2.296131929662762,154.42436419677733,152.5278233947754,150.99500274658203,149.46218209838867,147.56564129638673,0.1,0.0,153.55210778301574,0.008873716661711883,0.02083895647185986,152.20616585867745,149.38330296107702,3.59191773548079
2024-07-24,1,154.44499969482422,145.81999969482422,155.6775016784668,146.25062465667725,150.84687614440918,0.7346200993197125,3.3989037123310952,-0.9162703739123863,2.99547423888971,148.1687469482422,2.9051259231567372,0.02277875672043102,146.0612480163574,154.53050117492677,0.9014262421406705,0.030750563954043107,1.0350587637925828,1.015961867586803,0.9996375345053798,0.0011992581098914101,63.50554347389556,156.01155750095614,149.21375007629393,142.41594265163172,153.8835721697126,1.8798414476272556,150.91428593226843,3.5660399588935774,152.94883062735215,151.08013372040284,1.788332575776861,4.335870938508995,7168200,1.2824098624189568,1.0697073682843898,16939200.0,-9.31490532859242,87.8223044403071,81.94094994263789,114.6440107731095,35.21483950230343,15.751076474095775,0.1004646388341509,2.4235521113359635,154.42436419677733,152.5278233947754,150.99500274658203,149.46218209838867,147.56564129638673,0.1,0.0,153.56095315472248,-0.0019159832554472844,0.034898452867225135,153.20430428641183,150.134033203125,3.872688352755969
2024-07-25,0,158.17499923706055,145.81999969482422,155.6775016784668,146.25062465667725,153.07687759399414,0.5251533082439477,3.57240408049207,-1.295754912538946,2.9954480328567428,148.90999794006348,3.112375831604004,0.02389094520496137,146.0612480163574,154.54624938964844,0.8704302855299431,0.05425006056097942,1.0578171322228755,1.0362482032527829,1.023534656442349,0.016042764893234418,71.30092349305485,156.67443329068385,149.5296251296997,142.38481696871554,155.0178576878139,1.6980807599498107,151.79642868041992,3.7338267173292228,153.31942384973416,151.42406009865203,3.231735221407466,5.9148265108014115,10019600,1.2452875296597867,1.4440220935553258,26958800.0,-6.103908328420469,87.8223044403071,81.94094994263789,161.21000975055094,42.301136107340106,13.751961940673102,0.12155059192321922,2.5775852478046026,156.94559967041016,154.69719833374023,152.87999725341797,151.0627961730957,148.81439483642578,0.12000000000000001,0.0,153.60460459204234,0.027152274184362835,0.019542675721233225,154.42787606375558,151.06695229666573,4.38322604666399
2024-07-26,0,160.36000061035156,145.81999969482422,158.17499923706055,146.25062465667725,154.30187702178955,0.48147786945266613,3.9621455011802507,-1.1720277657035818,2.9953853460778195,149.61750030517578,3.4452004241943373,0.02639433162624369,146.0612480163574,155.47949714660643,0.7978862856045079,0.0819083338688782,1.0682583550839935,1.0447109695028056,1.0343304078713316,0.03153597654117268,79.13028643704047,158.03779102524868,150.1135000228882,142.1892090205277,155.88928604125977,2.5803521705798556,152.81589317321777,3.994530557515892,154.5327789171809,152.17171997049311,5.2850524807478845,8.469054283906969,8356900,1.4339020073410529,1.182096198348978,35315700.0,-5.731719003973796,87.8223044403071,81.94094994263789,162.05454882726343,42.602794253603314,12.93730834591364,0.13540714423763164,2.5441861410420077,157.70959967041017,155.31519833374023,153.37999725341797,151.4447961730957,149.05039483642577,0.14,0.0,153.65318164106046,0.03846394292959521,0.033586421122741926,155.00350516183036,152.1416527884347,4.797123067693223
2024-07-29,0,159.14500045776367,145.81999969482422,160.36000061035156,146.31749820709229,154.43187618255615,0.5105448240145481,4.436338340894383,-0.9237243251301468,2.995301706084831,149.81250190734863,3.891300430297849,0.029414495549013594,146.0612480163574,155.92725143432617,0.7923756260083014,0.09662860638958011,1.0551877579898277,1.029844757277338,1.020042556938326,0.030548307315876766,82.0644403940613,159.69417669704754,150.82150001525878,141.94882333347002,156.38464300973075,2.851504807621022,153.73642894199915,3.849208064938519,155.98927464290682,153.11417328721018,3.9543617202429755,9.769831862947635,5625000,1.4667883883893544,0.8240520654407214,29690700.0,-20.26847259615335,87.8223044403071,81.94094994263789,116.29807471165924,39.50890633306449,15.979355913521694,0.14224326280197802,2.547458316526401,158.06359967041016,155.88819833374023,154.12999725341797,152.3717961730957,150.19639483642578,0.14,0.0,153.67757931259865,0.02800821520618557,0.02501769883446603,155.44869777134485,152.95760236467635,4.919973308438871
2024-07-30,0,159.94499969482422,145.81999969482422,160.36000061035156,146.61499977111816,154.69812393188477,0.3566954844482676,4.655539056264057,-1.1381395052451662,2.995261504164141,150.1175022125244,4.142475433349608,0.030736275032312684,146.0612480163574,158.27199935913086,0.8451633655534668,0.08477753326307057,1.055970842742394,1.0286745095539254,1.0190078403625507,0.04756600669754718,75.48836877306603,160.77832817356324,151.46725006103514,142.15617194850705,157.02571487426758,3.101779204442717,154.57464354378837,3.8308631790081926,156.77287344916218,153.81207811468914,2.2273602427527246,8.811514479483145,6545700,1.5302686403186918,0.9491900482737319,36236400.0,-1.9319934531081229,87.8223044403071,81.94094994263789,123.885256646724,40.306740880278795,14.575370357681548,0.1991499027424203,2.5933545672646754,158.52616125488282,156.6369208984375,155.11000061035156,153.58308032226563,151.6938399658203,0.14,0.0,153.71403836999943,0.05894321619166365,0.04596731620649178,156.39012363978796,153.80120086669922,5.190441580357128
2024-07-31,0,158.94750595092773,145.81999969482422,160.36000061035156,147.74187088012695,155.5124979019165,0.21244564080080147,4.867937609259229,-1.2549855457862966,2.995221323503899,151.4587516784668,4.328375434875488,0.031998722194233595,146.0612480163574,159.22500038146973,0.8441053113505944,0.09298711674364533,1.0448196946312134,1.015914900122262,1.00336779585244,0.029152813396356336,77.24126670758278,161.8650002414066,152.1291250228882,142.3932498043698,157.67142977033342,2.9368390161636646,155.24053682599748,3.7127309603038054,157.5570299665863,154.57340144418848,2.886643068787613,7.917822548802118,8293200,1.5112210180167323,1.178655941104155,27943200.0,-29.346921772035493,87.8223044403071,81.94094994263789,87.77755472142087,36.427712608815156,14.83470270349207,0.16419400953324345,2.6645436134560576,158.58044024658204,156.72477926635742,155.2249984741211,153.72521768188477,151.86955670166014,0.14,0.0,153.74763501494445,0.010046125782527948,0.03610110525594503,156.9019535609654,154.37895965576172,5.090127851665731
2024-08-01,0,159.43999862670898,145.81999969482422,160.36000061035156,149.25999927520752,156.30187606811523,0.038603186634531036,4.893531891817168,-1.3206312896756722,2.995219242971006,153.47125244140625,4.324375343322754,0.032034196718447566,146.0612480163574,159.22500038146973,0.8535151008077492,0.09002541683978256,1.0437312750199266,1.0160186570062828,1.000787733919925,0.007997467335230102,72.71984986100504,162.54668921850984,152.7596254348755,142.97256165124114,158.63678632463728,1.9775907250165397,155.9148221697126,3.5410110291727612,157.89855054813557,155.18834637932056,2.926942560964322,6.230580418330984,7213400,1.5354509818474122,0.9970820414927895,35156600.0,-6.451667120868514,87.8223044403071,81.94094994263789,95.78634888675029,34.654305044337406,13.616133620606751,0.20805524472285938,2.6956471284214474,158.58044024658204,156.72477926635742,155.2249984741211,153.72521768188477,151.86955670166014,0.14,0.0,153.78304411569016,0.007015747124532679,0.02866643698546771,158.09432983398438,155.15024784633093,5.054896497345268
2024-08-02,0,162.9724998474121,145.82500076293945,160.36000061035156,149.6212501525879,158.36812591552734,-0.1047908671060357,4.82766428798437,-1.3179035727286785,2.9952366390657024,154.34375190734863,4.243312721252442,0.03146275164078798,146.24049949645996,159.4904987335205,0.8411404521826905,0.09336532002425815,1.0621209307655333,1.036045195048421,1.0213389240071096,0.016291464374638576,73.65661547951483,163.09595395743847,153.44062538146972,143.78529680550096,159.85500063214982,1.5440317549909242,156.86928640093123,3.51162771987419,158.28367074966297,155.7820004257473,4.425848252790857,6.293329714626828,11280400,1.5278289398081046,1.4932808056017226,46437000.0,-4.525217357477681,87.8223044403071,81.94094994263789,139.33008287071002,41.35613134370341,12.193043972473765,0.21623171984456308,2.7952450105933884,161.14716552734376,158.85642517089843,157.0050048828125,155.15358459472657,152.86284423828124,0.16,0.0,153.87016807006876,0.021787837714451586,0.02818838148282694,159.20872715541296,156.2065157209124,5.239522700031128
2024-08-05,0,162.8499984741211,146.08749771118164,162.9724998474121,149.90625286102295,158.99687957763672,-0.07819019454307258,4.920792140555792,-1.1531422825988624,2.995223157745936,154.4362506866455,4.17145004272461,0.03189148355681884,148.01474571228027,159.98649978637695,0.7840356284131867,0.11558143168152903,1.0554252039548269,1.0303440444006489,1.0172402869811343,0.023280643474192564,79.11036715561863,164.139584616805,154.29800033569336,144.45641605458172,160.52285766601562,1.6994891695567416,157.77035767691476,3.289821562714652,159.45724406082581,156.7043111309033,5.5213831263153965,8.931554830924846,12032200,1.6465499330526918,1.5244710146901475,34404800.0,-31.54595116125118,87.8223044403071,81.94094994263789,117.63911872331765,38.41780006642156,10.66664049863477,0.17591620729441437,2.967013678988005,162.3910386352539,160.29447854614259,158.5999984741211,156.9055184020996,154.8089583129883,0.18,0.0,153.9537148673444,0.0169652025431708,0.003797328547400281,159.43699428013392,156.93243517194475,4.960145406602211
2024-08-06,0,160.11000061035156,146.25749969482422,162.9724998474121,150.176251411438,159.21875,-0.09298190293483675,4.8783150422676345,-1.1310184969986425,2.9952372326005903,154.9512481689453,4.160874748229981,0.03144538404908645,149.47000007629396,160.60900039672853,0.784816847819162,0.11344716553966944,1.0320613604634343,1.0076386325807845,0.9955170339914475,0.0010316103400680454,78.43506614403022,164.89275545837563,155.13612537384034,145.37949528930505,160.48714338030135,1.7060959615961167,158.18821471078056,3.179319072137951,160.29940425879346,157.4718920347656,2.9555866980305887,8.396843486883393,7607100,1.6545455108539329,0.9534451165250786,26797700.0,-47.924008822398754,87.8223044403071,81.94094994263789,65.62809215638867,36.044204028608014,13.99681191341929,0.09359234850606661,2.936512111409741,162.42644079589843,160.35178204345704,158.6750030517578,156.9982240600586,154.9235653076172,0.02,1.0,153.9891108185466,-0.01462841258946923,0.0025858349227342674,159.2002214704241,157.10186331612724,4.599442242718605
2024-08-07,0,159.1449966430664,148.2099952697754,162.9724998474121,152.0706272125244,159.5662488937378,-0.13689311792277767,4.540231298468473,-1.2248400923908978,2.995307147995372,155.5674991607666,3.9486249732971204,0.029136030971451083,149.62350006103514,160.60900039672853,0.8222385714568408,0.08029151690421078,1.0212813502933167,0.9969054950458436,0.9893139294600576,0.0012424900344119028,65.01576301286282,164.90921301655365,155.8287504196167,146.74828782267977,160.4871428353446,1.706096461751104,158.43589292253768,3.102825457982936,160.24877399435064,157.85612252832317,-0.15589922614646212,3.7922976747756225,5993000,1.8172439268102656,0.7516118958604282,20804700.0,-48.41667149879841,87.8223044403071,81.94094994263789,49.643296962859004,33.887124702745204,15.006252694399123,0.04091794247518364,2.9003320295213824,162.42644079589843,160.35178204345704,158.6750030517578,156.9982240600586,154.9235653076172,0.04,0.0,154.0140358400967,0.006651744323595832,-0.015062404712807571,159.24842616489954,157.3485619681222,4.361699348761425
2024-08-08,0,159.38000106811523,149.61000061035156,162.9724998474121,153.86562728881836,159.5662488937378,-0.243050179159887,4.238203340458499,-1.1402196493741787,2.995364103790707,156.92625045776367,3.733499526977539,0.027102732379591068,149.96250343322754,160.60900039672853,0.8296902418704684,0.06362570855850563,1.0192133714709302,0.9954468584084961,0.9905316056941149,-0.0003763018007433283,60.39619378641568,164.85190716919828,156.37550048828126,147.89909380736424,160.40642874581474,1.7488487250659075,158.71607181004114,2.9881732078585967,159.97147636904856,158.03238162917998,-2.39699472471798e-06,2.2273577923682923,5094800,1.8404415297943917,0.6440350156432703,25899500.0,-39.127381435594124,87.8223044403071,81.94094994263789,51.26541110331613,31.64612451987624,14.410171319824546,0.05814238870750591,2.88387955930874,162.42644079589843,160.35178204345704,158.6750030517578,156.9982240600586,154.9235653076172,0.06,0.0,154.03670208540925,-0.003358963095877132,0.01501422382209445,159.09104919433594,157.74058641706193,4.120656827193315
2024-08-09,0,160.25249481201172,149.61000061035156,162.9724998474121,154.38562679290771,159.5662488937378,-0.3966854965443192,3.9871488290598234,-0.9162969488102446,2.995408077304727,158.56125259399414,3.4974245262145987,0.0254179918833202,150.21150093078614,160.60900039672853,0.8073892242233008,0.06253331343248206,1.0216063626032281,1.0001435104872636,0.9960283512847596,-0.016689963263416097,60.769766455997356,164.8375481998067,156.86325054168702,148.88895288356736,160.5928557259696,1.6331353271654756,159.1321427481515,2.7403604489488806,159.82622296442992,158.2471700036093,-0.353245570531748,2.523200559478311,4579200,1.8412115175066546,0.5816415572934462,30478700.0,-36.31250362409881,87.8223044403071,81.94094994263789,58.52725299639581,30.947111456135197,13.823888410295927,0.08360344980873442,2.7914590600522486,162.42644079589843,160.35178204345704,158.6750030517578,156.9982240600586,154.9235653076172,0.06,0.0,154.05924854739456,-0.02144511179513464,-0.00087087062100841,159.48377990722656,158.192866734096,3.8240712988856274
2024-08-12,0,160.31500244140625,149.61000061035156,162.9724998474121,154.44062519073486,159.98624992370605,-0.5521831646538777,3.7220576178194444,-0.6098275816781058,2.995451313682848,159.04625129699707,3.2211994934082044,0.02365075088957665,152.437752532959,160.60900039672853,0.7505456053971906,0.07113491182569916,1.0186758443639707,1.000600758794493,0.9997973408973192,-0.015566447997957367,63.459506132699076,164.81999032719162,157.37587509155273,149.93175985591384,160.71785627092635,1.5621317157315224,159.67732129778182,2.0241751570326576,159.94265017703992,158.5630057852042,0.8210187717490055,3.7719920805771556,7605400,1.830873265542528,0.9605700724589175,38084100.0,-43.86613557749141,87.8223044403071,81.94094994263789,50.03037191734565,30.551704440193188,12.771584463137236,0.09234579412400619,2.8056398965669462,162.60579949951173,160.64209994506837,159.05500030517578,157.4679006652832,155.50420111083986,0.06,0.0,154.0951490585074,-0.008496126171497309,-0.025953428825615774,159.3590131487165,158.72667149135046,3.307312658887983
2024-08-13,0,158.86750030517578,150.23500061035156,162.9724998474121,155.20437240600586,160.1456241607666,-0.5927276184966814,3.3141670757378567,-0.4483069607403456,2.995511079810895,159.14499855041504,2.819287109375,0.020987546456241905,154.1022521972656,160.60900039672853,0.6950804596801652,0.06709489659602098,1.0060564138274701,0.9908426566539559,0.9939126891169524,-0.007760291677217368,63.218931234561886,164.53945933458118,157.91112518310547,151.28279103162976,160.13142776489258,1.3275694443821986,159.9932141985212,1.3908019269330627,160.0447108565509,158.80230080590664,0.5487981825350362,4.9989354100989685,9711400,1.8341297980542584,1.201953542714563,28372700.0,-75.56237537873942,87.8223044403071,81.94094994263789,-0.15198548029319145,27.579961188449598,17.14767690834839,0.052917839887160964,2.8859510110377116,163.4719190673828,162.04403924560546,160.88999938964844,159.7359595336914,158.30807971191408,0.08,0.0,154.12758913447612,-0.0036485309452485293,-0.017736430921444682,158.5437731061663,158.87625013078963,2.8538792643946884
2024-08-14,0,158.31499862670898,152.68250274658203,162.9724998474121,155.6225004196167,160.1456241607666,-0.41563498878884725,2.8101586297459966,-0.7334141158711716,2.9955743838720634,159.14499855041504,2.3274247360229507,0.01774731477612438,154.41075172424317,160.60900039672853,0.7717385901413745,0.029868391709707922,0.9998247375322945,0.9880607555940403,0.9919983430571957,-0.005215357277105981,53.55016561129136,163.96306742733867,158.34275016784667,152.72243290835468,159.4835706438337,0.7687001957595248,160.00321415492468,1.3771596151022072,159.7518675977692,158.85491308157802,-2.518829585408432,2.8634793091975834,5141200,1.6865040874266568,0.6723449553858085,23231500.0,-78.15852156325866,87.8223044403071,81.94094994263789,-3.0600546878516246,26.085097615388406,16.218254368636924,-0.007115244115659839,2.833383613052392,163.57575964355468,162.21212017822265,161.11000061035156,160.00788104248048,158.64424157714845,0.08,0.0,154.14487034998425,-0.0026430970436635004,-0.003082367919311227,158.15104021344865,158.7940172467913,2.8173017709807597
2024-08-15,0,158.6999969482422,152.68250274658203,162.9724998474121,157.5506248474121,160.1456241607666,-0.5427703757444403,2.6499964086598093,-0.28450408462593213,2.9955921473553278,159.14499855041504,2.0638499641418493,0.01671442209830825,154.44324989318847,160.60900039672853,0.7802292337158194,0.016942055979865485,1.0009744644652736,0.9908547155033789,0.9954461473978967,-0.004266558635436457,49.88656458442781,163.8454928096902,158.5454999923706,153.245507175051,159.28214154924666,0.7619008485593545,159.884642464774,1.4150194601606823,159.38162443351155,158.8278018742818,-2.7847711942918916,0.08850917674961842,7237800,1.6715698565021175,0.9650078330722309,30469300.0,-71.6274632171552,87.8223044403071,81.94094994263789,2.9950533772708963,24.96020893871382,15.518861521283908,0.04067448029003719,2.749570577942579,163.57575964355468,162.21212017822265,161.11000061035156,160.00788104248048,158.64424157714845,0.08,0.0,154.17082172019343,-0.007052819184497294,0.001195813462775456,158.16805376325334,158.68413761683874,2.7164080565857565
2024-08-16,0,159.1624984741211,152.68250274658203,162.9724998474121,158.27999877929688,160.1456241607666,-0.7042054390279644,2.5670148072832144,0.15113571343698196,2.9956009334316276,159.14499855041504,1.8677249908447267,0.016175610610700372,154.44324989318847,160.60900039672853,0.7570147676359805,0.020857793127986798,1.0029356246169596,0.9942017230260473,0.9991995721408305,-0.006801743331167898,51.731554799106206,163.83065437042583,158.69662475585938,153.56259514129292,159.2846418108259,0.7614043383983907,159.88589232308524,1.4143234511703482,159.20364917173728,158.86165701433055,-0.8806468407559386,-1.035173145292579,5012800,1.6701931637384277,0.6791500869124603,35482100.0,-68.415437849,87.8223044403071,81.94094994263789,9.649362802630355,24.96207625961559,14.790590056447225,0.08027633172460649,2.6788875206664713,163.57575964355468,162.21212017822265,161.11000061035156,160.00788104248048,158.64424157714845,0.08,0.0,154.19000836586923,-0.007657821115282126,-0.005180460645109658,158.2375270298549,158.74297659737724,2.5410876038698924
