date,buy?,todays_price,Minimum,Maximum,25th Percentile,75th Percentile,Skewness,Standard Deviation,Kurtosis,Shannon Entropy,Median,Mean Absolute Deviation (MAD),Coefficient of Variation (CV),10th Percentile,90th Percentile,Autocorrelation,Cumulative Return,curr_to_avg_one_month,curr_to_avg_one_two_week,curr_to_avg_one_one_week,momentum,rsi,upper_band_current,middle_band_current,lower_band_current,rolling_mean_7,rolling_std_7,rolling_mean_14,rolling_std_14,ema_7,ema_14,roc_7,roc_14,Volume,Volatility,Relative Volume (RVOL),On-Balance Volume (OBV),Williams %R,Stochastic Oscillator %K,Stochastic Oscillator %D,Commodity Channel Index (CCI),ADX1,ADX2,Chaikin Money Flow (CMF),Average True Range (ATR),Fib_23.6,Fib_38.2,Fib_50,Fib_61.8,Fib_76.4,Parabolic SAR 2,Parabolic SAR 3,VWAP,Adj Close Momentum,Adj Close Return,Adj Close 7d MA,Adj Close 14d MA,Adj Close Volatility
2024-01-02,0,170.5625,156.58500289916992,170.1050033569336,157.83249855041504,167.59249782562256,-0.04128694200949815,4.859439843549127,-1.6390035035018493,2.995288152491227,163.54375076293945,4.50149974822998,0.0297942813141939,156.9600036621094,168.69799880981446,0.8815948943818648,0.08634288218821078,1.0457557393982837,1.0176684238474238,1.0103874769659822,0.01773676070805741,92.13022245560302,172.8186300151622,163.09975032806398,153.38087064096575,168.80499976021903,1.3690119109874281,166.4523217337472,3.334638205555163,168.22742594163168,165.39117944839805,1.7876661907354336,7.739813893220127,9977400,0.750628207169606,1.0738825697236885,144535000.0,-0.6771736896551328,95.95456447167889,96.5727530047212,105.2644798115902,40.264026314702086,3.360750357511903,0.38049840301090226,2.1142322487999143,169.03355975341796,167.09322073364257,165.5250015258789,163.95678231811524,162.01644329833985,0.2,0.0,163.3151383921051,0.027956992439049477,0.027343284666870554,166.3746119907924,164.0485098702567,5.065401900344722
2024-01-03,0,171.39999771118164,156.7349967956543,170.5625,158.54687595367432,167.68750190734863,-0.17538086987645427,4.877321443194868,-1.5670501999910784,2.995288092607786,165.11124992370605,4.4790123748779305,0.02977632710740191,157.53174934387206,169.8552532196045,0.8817161588842514,0.08648912438916186,1.0464068151950534,1.0186736887675885,1.0117854505292023,0.02054180966103014,92.45744757847736,173.55326806949518,163.79862518310546,154.04398229671574,169.4296428135463,1.4194133186621904,167.2794644492013,2.9803335700093507,168.80816115557218,166.04378709232753,1.7676000421983808,7.429101064710605,9852300,0.7494810395402424,1.0590227018660245,154387300.0,-6.7741673496208685,95.95456447167889,96.5727530047212,99.39692185215758,37.26419765307661,3.1103612094362907,0.33914494393675,2.0776411280481573,169.243599609375,167.43320050048828,165.97000122070312,164.50680194091797,162.69640283203125,0.2,0.0,163.6971016588637,0.017459528660227264,0.023476783083714956,166.91227068219865,164.80726623535156,5.083106786136438
2024-01-04,0,171.48500061035156,156.7349967956543,171.39999771118164,159.55687522888184,168.1056251525879,-0.296333425867142,4.882269575253795,-1.4249687876759407,2.99529054882526,166.62749862670898,4.426687622070313,0.029675955064757488,157.66674919128417,170.15075302124023,0.8796082176726395,0.08704612995422242,1.0423392428362914,1.0160553798610017,1.0081807951938702,0.01727744630837158,93.03716402494292,174.2839139979197,164.5193748474121,154.7548356969045,169.98607199532645,1.3392353223832663,168.03946440560478,2.536940385315803,169.45186517989202,166.73632699598807,2.617833272460483,7.245650130440115,11972500,0.7499497029223988,1.2675958664040246,166359800.0,-16.666688514876665,95.95456447167889,96.5727530047212,99.52364934267543,38.35398611534237,2.7480372651499456,0.29506172628166194,2.1426944841940228,170.60296624755858,168.90352633666993,167.5300064086914,166.15648648071289,164.45704656982423,0.2,0.0,164.14323306646068,0.018104974809616925,0.02421147593122604,167.62357439313615,165.60792432512557,5.082391855623336
2024-01-05,0,172.14750289916992,156.7349967956543,171.48500061035156,160.5887508392334,168.88624954223633,-0.44444329360048757,4.841847694765981,-1.2260937072127036,2.995300840637544,167.0724983215332,4.294650115966794,0.02930725355990702,157.85574836730956,170.64624977111816,0.8741627032228473,0.08815458818576562,1.0419928166316779,1.0173480781967852,1.0086216100341459,0.013660918585328696,93.34039620241484,174.89357030560865,165.20987491607667,155.5261795265447,170.5857151576451,1.2090286408408966,168.68625014168876,2.324050985867573,169.95110642138096,167.36033241295917,2.324126951233969,6.615063762565295,10064200,0.7413718010599644,1.0616295119544343,176424000.0,-10.100091497151647,95.95456447167889,96.5727530047212,104.02131609618031,35.376589844239504,2.5258888016754315,0.32524737028673234,2.1276172010686887,170.78636358642578,169.18182278442382,167.88500213623047,166.58818148803712,164.98364068603516,0.2,0.0,164.5087302481652,0.0178055966829338,0.023213083269519406,168.31737409319197,166.26365988595145,4.875579243120746
2024-01-08,0,171.47250366210938,156.7349967956543,172.14750289916992,162.5306272506714,169.89687824249268,-0.5745088217988888,4.7348898485727915,-0.9538672230961143,2.9953228347576633,167.3537483215332,4.042337646484379,0.028534154596280493,158.67925148010255,171.40849800109862,0.8399188464425288,0.09833480982942132,1.0333551750904437,1.0106429439378837,1.0019428698422537,0.008039153923687481,96.33374575793349,175.40740481921586,165.9376251220703,156.46784542492475,171.00000163487024,0.8467998929504947,169.22035762241907,1.9995643440281892,170.49374229851912,168.01710556504565,2.499256991463323,5.552064111565868,11229900,0.6408137592563719,1.1655434070185435,165194100.0,-17.369096964417604,95.95456447167889,96.5727530047212,83.31395473627163,31.394804653219634,10.006651811250157,0.3601213465681889,2.19141873454215,171.5321244506836,170.38894418334962,169.46500396728516,168.5410637512207,167.39788348388672,0.02,1.0,164.8289012291971,0.01752345609340833,0.016328567096204876,168.8340802873884,166.81470598493303,4.539872708127386
2024-01-09,0,171.04249954223633,157.8849983215332,172.14750289916992,163.7693748474121,170.2193775177002,-0.6708886193115262,4.378758068615137,-0.7694494326566832,2.9953850647683837,167.5949993133545,3.608899974822998,0.02627131358659333,159.71474990844726,171.4737533569336,0.8439072755754319,0.08605950840817177,1.0262067626700353,1.0054743519422253,0.9978356346949773,0.0028142149783001447,87.90391052884496,175.43201660262332,166.67450046539307,157.9169843281628,171.1735725402832,0.6731252781259354,169.56428609575545,1.8539841327422986,170.73462936401646,168.5336547313525,1.7203312340099128,4.5595931454778,9923600,0.7152788284818685,1.0164732875642428,155270500.0,-34.73819392883521,95.95456447167889,96.5727530047212,72.38161073843266,29.039960240399342,9.25607832085757,0.3114353870093208,2.168425981650055,171.5321244506836,170.38894418334962,169.46500396728516,168.5410637512207,167.39788348388672,0.02,0.0,165.07005170120556,-0.0021364540457542436,0.009478836957157774,169.0323486328125,167.1995141165597,4.159911407847335
2024-01-10,0,170.26250076293945,158.7675018310547,172.14750289916992,165.6693754196167,170.68249988555908,-0.7895573262782709,3.978935288170628,-0.48904604897467596,2.9954477241786805,167.7750015258789,3.1766502380371096,0.0237786338456792,160.74250106811525,171.4737533569336,0.8326705753301351,0.0773142965003224,1.0175108088156464,0.9988618782915615,0.9927292650515823,-0.006636505037525886,82.5090016505665,175.2902461027695,167.33237552642822,159.37450495008696,171.1960721697126,0.6328841245848676,169.7889289855957,1.7204334016370573,170.80967936587314,168.934746972944,0.7154296653756225,2.896631784866841,9670200,0.7578886259639219,0.9825851310611395,145600300.0,-30.649309986762525,95.95456447167889,96.5727530047212,55.90794333529384,26.651638586771373,12.935187435863988,0.32848452242210513,2.1652138984396014,171.56280200195312,170.43860021972657,169.52999877929688,168.62139733886718,167.49719555664063,0.04,0.0,165.26837827856653,0.004345810507254466,-3.149275477142306e-05,169.30953979492188,167.45392499651228,3.716509640787873
2024-01-11,0,169.90750122070312,159.81999969482422,172.14750289916992,166.8274974822998,170.68249988555908,-0.894186211067844,3.501859099183793,-0.15484832649389846,2.995513390834345,168.26124954223633,2.7849130630493164,0.02085592906982637,162.86775245666504,171.4737533569336,0.8179611047830676,0.06533913833096706,1.0119135846203386,0.9954287886402312,0.9919752206147858,-0.009199051719006257,73.30058284537927,174.91084367139007,167.90712547302246,160.90340727465485,171.10250091552734,0.7747006120686788,169.95375033787317,1.600983312261838,170.6745774128214,169.1889643227363,0.09258834419783672,1.8819097054590568,11919500,0.8145128838448897,1.2007859836607677,133680800.0,-39.99996036684449,95.95456447167889,96.5727530047212,34.67389737069426,24.251595456763322,12.94328254439946,0.33759778481882335,2.1829548983693248,171.56280200195312,170.43860021972657,169.52999877929688,168.62139733886718,167.49719555664063,0.06,0.0,165.4674296772187,-0.006475742189381628,0.00011736860494044789,169.2070792061942,167.7908455984933,3.2595957155021558
2024-01-12,0,172.01499938964844,160.84500122070312,172.14750289916992,167.0949993133545,170.68249988555908,-0.9432309606409827,2.989752150584614,0.15320587881912662,2.995573788885723,169.20000076293945,2.4258505249023443,0.017752660244892936,163.9047492980957,171.4737533569336,0.7848946700344318,0.0563430627698831,1.0213969879050915,1.006988287953563,1.0061327673099552,-0.0007697091580765036,68.65873073545332,174.39100485048561,168.4115005493164,162.4319962481472,171.19035829816545,0.8456834429519288,170.31000055585588,1.4472760751862208,170.48988040861235,169.35572774078963,-0.38402273612128984,1.3767893200313597,19429200,0.8302590017395955,1.8901985811738977,153110000.0,-79.5179695960852,95.95456447167889,96.5727530047212,76.34740737402805,37.2493417573558,9.941536748336308,0.2268108687199175,2.6099228502501304,174.15531640625,172.82233569335938,171.7449951171875,170.66765454101562,169.334673828125,0.02,1.0,165.86790130726678,-0.018691678370223452,-0.013768188687416352,169.03334481375558,167.97280774797713,2.6797782508441395
2024-01-16,0,166.3125,163.09250259399414,172.14750289916992,167.4718723297119,171.13187408447266,-0.7466941444299241,2.5324613253331574,-0.28984093316396065,2.995619528348549,169.8675022125244,2.1557507324218763,0.014987638743400374,166.00425071716307,171.53800048828126,0.763668628840263,0.05470819721165323,0.9842723533730005,0.9723602613995416,0.972929092718245,-0.03009230956513753,74.68422911389194,174.03492310842995,168.97000045776366,163.90507780709737,170.45142963954382,2.007305883567253,170.21875081743514,1.6570344463514168,170.8794370223401,169.79473503617012,0.35881078569388797,2.9860371262874423,17206400,0.8149937152089632,1.6454290820868904,135903600.0,-69.27556928268413,95.95456447167889,96.5727530047212,-85.37651563757642,32.10875374468283,21.934205851093,0.27107344597314503,2.78295899234777,173.47563885498047,171.72217965698243,170.30500030517578,168.88782095336913,167.1343617553711,0.02,1.0,165.91993850209855,-0.02342755421006426,-0.02484474664908886,168.55028424944197,168.08692932128906,2.3575650882289194
2024-01-17,0,167.49750137329102,163.99499893188477,172.14750289916992,167.4718723297119,171.13187408447266,-0.47568806043194517,2.2390412643118927,-0.7338204491960885,2.9956444547647,169.8675022125244,1.9786508750915517,0.013238503053661461,166.30400009155272,171.53800048828126,0.5869163582754513,0.014131535005392494,0.99034181225438,0.9814646941619818,0.9858129175364508,-0.020725832342446182,41.507458624034,173.60908285668776,169.13100032806398,164.6529177994402,169.7871437072754,2.118795198640894,170.18642943246024,1.7083115225194117,169.74315844005434,169.37240858739375,-3.016299146830063,-0.7622748169974118,11107500,1.5932663517879941,1.1110644312340392,147011100.0,-76.76940414464983,95.95456447167889,96.5727530047212,-71.14431918384716,32.5476708637645,20.295835016279284,0.15578535888660247,2.7667021175302353,173.47563885498047,171.72217965698243,170.30500030517578,168.88782095336913,167.1343617553711,0.02,0.0,165.9770356757237,-0.020918884183899866,-0.02865957520489645,167.8186274937221,168.06800079345703,2.1488238618347486
2024-01-18,1,166.82749938964844,166.22750091552734,172.14750289916992,167.56687259674072,171.13187408447266,-0.10593320752886967,1.9486219232051503,-1.4484492579436263,2.9956660105390847,169.8675022125244,1.7860132408142078,0.011509459082028769,166.95599670410155,171.53800048828126,0.6202172253222638,0.007640134458912754,0.9853600922359075,0.9792975443074204,0.985983952907708,-0.02017473817134663,44.44645417169597,173.2033692965446,169.3061254501343,165.40888160372398,169.1235716683524,2.2275741632368593,170.06178665161133,1.8892082842348512,169.18667381004911,169.19132613181165,-2.7011728009801574,-0.2694250595968368,9382300,1.5363902254726838,0.9342310241013342,137628800.0,-74.0216774003382,95.95456447167889,96.5727530047212,-105.22846904124931,30.37867837728284,22.580902360954056,0.20573541823650687,2.7288459934098057,173.47563885498047,171.72217965698243,170.30500030517578,168.88782095336913,167.1343617553711,0.02,0.0,165.99867354868326,-0.021050275841002608,-0.018985212653227394,167.16889299665178,168.0014866420201,2.0039318336185015
2024-01-19,0,168.87750244140625,166.3125,172.14750289916992,167.56687259674072,171.13187408447266,-0.059718310043155,1.9051273737745618,-1.497260166082287,2.9956689697470833,169.8675022125244,1.7530133247375488,0.011250566703168896,167.00749664306642,171.53800048828126,0.6156051808253443,-0.0017353114724536253,0.9972916415122787,0.9939993146536263,1.0021689978526889,-0.006062114808921493,41.030787195879576,173.14638012138946,169.33612537384033,165.5258706262912,168.8142863682338,2.0607920814384806,169.9939294542585,1.9151537235649891,168.59492233657465,168.91893818559117,-2.708891614257892,-1.0351622887835328,13114400,1.5318834384213935,1.2880945739418774,150743200.0,-49.958390876739166,95.95456447167889,96.5727530047212,-7.023657629154872,35.97148634222628,20.354631688543193,0.2076347659058847,2.7888120485651986,173.47563885498047,171.72217965698243,170.30500030517578,168.88782095336913,167.1343617553711,0.02,0.0,166.12693236574913,5.8813347820763084e-05,-0.004151579673087691,167.1194566999163,168.07590266636439,1.9870277212038807
2024-01-22,0,170.56500244140625,166.3125,172.14750289916992,167.59750080108643,171.13187408447266,-0.1229885523750744,1.8401543906554967,-1.3691773642583214,2.995673262237682,169.8675022125244,1.6562132072448719,0.010861229977932754,167.00749664306642,171.53800048828126,0.6147044345512129,0.00762231584213481,1.006733851849716,1.0054749581380344,1.0134219927729498,-0.008429479716228983,49.58665609213036,173.10443426196287,169.42412548065187,165.74381669934087,168.85750089372908,2.099039200318904,170.02678653172083,1.921142527102561,168.66293708261426,168.9691570811642,-1.2657655884498258,-0.5593915855880897,12837500,1.5972823320073057,1.2480095038293355,163580700.0,-51.62364516247886,95.95456447167889,96.5727530047212,42.16645803264231,37.6602551103497,19.039768224723247,0.21375648879969245,2.7482362599558714,173.47563885498047,171.72217965698243,170.30500030517578,168.88782095336913,167.1343617553711,0.02,0.0,166.28986149364084,0.006270452734976839,-0.0011155505572768604,166.99092320033483,168.15023149762834,1.8058762904148837
2024-01-23,0,169.2125015258789,166.3125,172.14750289916992,167.85999965667725,171.13187408447266,-0.3127032862654189,1.8063495945459602,-1.2254721241277229,2.995675472031557,170.00625228881836,1.5924008941650414,0.010652381258118265,167.00749664306642,171.53800048828126,0.5514539746850443,0.021179184152765946,0.9978777559648729,0.9984334279678873,1.00712134789953,0.017437062913965518,56.200875477219235,173.18507467737317,169.57237548828124,165.9596762991893,168.7582152230399,2.0571142667259332,169.9303580692836,1.9260590452694903,169.13555587732563,169.24508059339968,0.17766782298585945,0.2704206668791711,8360800,1.6290466290001264,0.8098148694322685,155219900.0,-60.949170803227595,95.95456447167889,96.5727530047212,-32.64274977661222,35.826671195615056,21.81536872973473,0.1876907615864108,2.6644778690705584,173.47563885498047,171.72217965698243,170.30500030517578,168.88782095336913,167.1343617553711,0.02,0.0,166.3540533884783,0.005952745141811322,-0.00035485033021073563,166.80589294433594,168.00648607526506,1.6777969098849823
2024-01-24,0,169.93249893188477,166.3125,172.14750289916992,168.41687393188477,171.13187408447266,-0.3948734861041925,1.7127808404678129,-0.9720241574575845,2.995681258821656,170.00625228881836,1.461300582885741,0.010094085514095356,167.43050117492675,171.53800048828126,0.5126450176665645,0.009681396404574341,1.0014784935204306,1.0040206208488964,1.0079272194250657,0.014537515715933091,50.39620529665861,173.1071874286163,169.68162574768067,166.25606406674504,168.4607151576451,1.6095066395649027,169.82553672790527,1.879289626673111,169.15421958653707,169.27523740244519,-0.4090459160607875,-0.7914978228632283,9967100,1.6615622486572041,0.9497953343570983,165187000.0,-48.37635483752114,95.95456447167889,96.5727530047212,13.334930926369877,37.26702050173158,20.435884060469196,0.23029310660358487,2.6247606664346197,173.47563885498047,171.72217965698243,170.30500030517578,168.88782095336913,167.1343617553711,0.02,0.0,166.45537985622505,0.020408219813738304,0.014941347128172763,167.01070077078683,168.0220227922712,1.5206623448438188
2024-01-25,0,172.28750228881836,166.3125,172.14750289916992,168.801251411438,171.13187408447266,-0.5571212703385444,1.6444759346974824,-0.6160812172127428,2.995685289257189,170.01875114440918,1.3341252326965332,0.009684852957988105,167.43050117492675,171.53800048828126,0.47844097802021845,0.011804097409583214,1.0146570654882805,1.0186028315265294,1.018952238396786,0.032728434575509224,52.67500790534359,173.08770274677534,169.79875087738037,166.5097990079854,169.31428691319056,1.847180190070982,169.8828582763672,1.944893450099129,169.34980123839532,169.55006520547744,-1.2106505044053695,-0.8561836632983453,8873500,1.666630418739728,0.8290325353344346,174060500.0,-28.059922219525923,95.95456447167889,96.5727530047212,116.77719555888234,40.35570775042817,18.94196486155462,0.253823266056868,2.614417494096266,173.47563885498047,171.72217965698243,170.30500030517578,168.88782095336913,167.1343617553711,0.02,0.0,166.5915203554119,0.03297107978719227,0.035011183244123535,167.70986938476562,168.1300768171038,1.5736610300777316
2024-01-26,0,172.43249893188477,166.3125,172.28750228881836,169.12875175476074,171.41812419891357,-0.6887727512422037,1.6721443212821427,-0.34322630387898423,2.995683796287081,170.18375205993652,1.3173127174377441,0.009835239037015144,167.43050117492675,172.0282497406006,0.41538484581951673,0.02203801927523908,1.0142155932118204,1.0182410190836635,1.0132657404775316,0.02105074056096945,59.635852817048495,173.3599145962386,170.01562595367432,166.67133731111002,170.01928656441825,1.9755089160967922,169.9032151358468,1.9717268397873,170.08563496076505,170.0551121418425,3.592635724204951,0.46797193667698217,7443000,1.7383370112418564,0.6921042647682385,181503500.0,-33.55537570814916,95.95456447167889,96.5727530047212,110.28718488361248,38.99874158835691,18.205209519338435,0.21738161717686358,2.5125364906881216,173.47563885498047,171.72217965698243,170.30500030517578,168.88782095336913,167.1343617553711,0.02,0.0,166.70269464423396,0.011567153054956147,0.029028893480496244,168.44293866838728,168.1307830810547,1.6015839184501983
2024-01-29,0,172.2775001525879,166.3125,172.43249893188477,169.673752784729,171.47562789916992,-0.806083302163793,1.7166101773332416,-0.14998380062334293,2.9956812763156653,170.41250038146973,1.3377622413635266,0.010085330090689244,167.43050117492675,172.16150283813477,0.4767309808290349,0.01533906863368644,1.012154931375735,1.015811100913853,1.0081428515027784,0.010040147079820372,59.160079180098926,173.64184633885836,170.20862598419188,166.7754056295254,170.79785810198103,1.5321347108156695,169.9607148851667,2.0318325049313897,170.67692634960633,170.50906011447717,2.946311149797653,0.16555339340691533,6971200,1.7203075960364271,0.6462764613693789,174532300.0,-29.808521802545336,95.95456447167889,96.5727530047212,94.96964571429982,37.12767199565606,18.827167368384867,0.22783389129410955,2.438647711653401,173.47563885498047,171.72217965698243,170.30500030517578,168.88782095336913,167.1343617553711,0.02,0.0,166.80153867465737,0.015401720102335092,0.014209339100991621,169.19295610700334,168.18092455182756,1.6786636508803443
2024-01-30,0,174.67250061035156,166.3125,172.43249893188477,169.73375129699707,171.61750030517578,-0.8609950963268657,1.7715794015157773,-0.1852642033844374,2.995678021040657,170.56375122070312,1.4045123481750494,0.010400796641638064,167.43050117492675,172.27850036621095,0.5190894491905451,0.012771504381300989,1.0254878534827487,1.0297735104941117,1.0201134754831984,0.03226711404439353,58.23070037958251,173.87428463463556,170.331125831604,166.78796702857244,171.62571498325892,1.8534778222724164,170.22000067574638,2.381950109990328,171.0809409616761,170.78300994031204,3.2668479614444323,0.46946097670841747,10822100,1.7211604883976148,0.9832703841369842,185354400.0,-3.9325085907286264,95.95456447167889,96.5727530047212,202.51379024754016,44.29104025863088,16.58473817957729,0.263501641559362,2.5590031329033,173.8194365234375,172.0002777709961,170.52999877929688,169.05971978759766,167.24056103515625,0.02,1.0,167.02833931169664,0.04307943715572571,0.03621178306388692,170.03478131975447,168.57711900983537,2.09392169421876
2024-01-31,0,175.79999923706055,166.3125,174.67250061035156,169.73375129699707,172.0481252670288,-0.4290039592543639,2.0065290124428214,-0.07647339876416748,2.9956629519765032,170.8037509918213,1.5645999908447266,0.01176439309610487,167.43050117492675,172.302001953125,0.5095984147605325,0.02409674231059912,1.0307253393768967,1.031337576227619,1.0201920203937302,0.034528417707360815,64.93943629575129,174.57255871916055,170.5595006942749,166.54644266938925,172.3735716683524,2.345093843571958,170.61553628104073,2.8107242718443843,171.98477654667008,171.2832661388199,3.4314802653810834,2.122280180557617,11521800,1.794311896492264,1.0395499596244853,196876200.0,-28.142874581473215,95.95456447167889,96.5727530047212,184.02042172842295,43.686381689591315,14.72836994006732,0.16768821002869183,2.664518970165308,174.9960030517578,172.9520030517578,171.3000030517578,169.64800305175783,167.60400305175781,0.04,0.0,167.26736138972737,0.022639296081507165,0.031776999271326,170.63507516043526,168.81299918038505,2.242377384634978
2024-02-01,0,173.40999603271484,166.3125,175.79999923706055,169.73375129699707,172.1800022125244,-0.038651600715240986,2.308835416651525,-0.0650683009322992,2.995640907281369,171.22124862670898,1.7997372817993154,0.013516080219956355,167.43050117492675,172.65649909973146,0.5884611391933827,0.025670954402771635,1.0151539604844182,1.0123855100035994,0.999515809127073,0.006515236038507011,67.23003637312146,175.439046489431,170.82137565612794,166.20370482282488,172.97321374075753,1.895679628496229,170.86571448189872,2.897394929757958,172.94401245233792,171.89064279420444,3.0692092285770416,3.252330048782195,9354800,1.8007529021382311,0.845931776924242,187521400.0,-32.642909458705354,95.95456447167889,96.5727530047212,85.62987288332042,39.57815275862276,21.36836781150839,0.1761568397029939,2.7204474199342665,174.9960030517578,172.9520030517578,171.3000030517578,169.64800305175783,167.60400305175781,0.04,0.0,167.4006440839397,0.0045680094770870205,0.018944285188004565,171.30458068847656,169.05523681640625,2.3216212816197204
2024-02-02,0,174.2775001525879,166.3125,175.79999923706055,169.73375129699707,172.2800006866455,-0.09852101700674319,2.374642782952275,-0.30077064940813303,2.9956357113660332,171.25750160217285,1.8901872062683112,0.013893147234679895,167.43050117492675,173.5362464904785,0.668185177175343,0.011225444881545404,1.0196325050210775,1.0135550680060676,1.0032178562611846,0.010699846213050312,56.80787723764029,175.67116113810917,170.92187557220458,166.1725900063,173.593928200858,1.373548866483989,171.02732167925154,3.026643929440711,173.05717598167598,172.04868393175232,2.4806054333958203,2.061412702116145,8607600,1.8937614367696518,0.7903892719504367,196129000.0,-25.500052315848215,95.95456447167889,96.5727530047212,117.3427089065345,39.48653401057012,19.858538599409133,0.20567508376320698,2.7084542529416535,174.9960030517578,172.9520030517578,171.3000030517578,169.64800305175783,167.60400305175781,0.04,0.0,167.54337671848413,0.0142210004309693,0.010350371118978938,171.9020516531808,169.4563762119838,2.4584520905565936
2024-02-05,0,174.09249877929688,166.3125,175.79999923706055,169.73375129699707,172.32375144958496,-0.1322166405795229,2.4832616733216177,-0.565600404274305,2.9956268287034753,171.25750160217285,2.017749786376953,0.014516777096817892,167.43050117492675,174.31700019836427,0.6749780881818049,0.012373094105614468,1.0177187632532585,1.009309403467195,1.0000287185596797,0.01053532019620329,58.828128413124645,176.02802389595962,171.0615005493164,166.0949772026732,173.8517848423549,1.2514133714061517,171.58303587777274,2.800134153165813,173.37367324302863,172.23104762684866,2.556898326108158,1.3152927192206276,7820200,1.8975083065663618,0.7255618553496757,188308800.0,-29.096506601238463,95.95456447167889,96.5727530047212,95.49084294843796,37.09397965185983,19.60462980102114,0.23194466511353307,2.6683357976453035,175.21784362792968,173.311083984375,171.77000427246094,170.2289245605469,168.3221649169922,0.04,0.0,167.66057120879992,0.010247162195449855,0.012885900461059181,172.12239292689733,169.91613115583147,2.5541635086151966
2024-02-06,0,174.83499908447266,166.3125,175.79999923706055,169.73375129699707,172.67687320709229,-0.15545858235236204,2.560763260058741,-0.7357180962232968,2.995620256537569,171.25750160217285,2.1149995803833006,0.014961334170307823,167.43050117492675,174.31700019836427,0.7066991062079417,0.015279389180379977,1.021478590687159,1.0115453899371483,1.0022040643297512,0.0009303037029486649,58.74472507636575,176.28027686344024,171.15875034332277,166.0372238232053,174.19499914986747,1.1198197683020026,172.10714285714286,2.6597831799040965,173.55514232424724,172.3438117478066,1.0476653654498198,4.677939889844043,6764800,1.8899501520185038,0.6409171117611531,195073600.0,-24.502278303540134,95.95456447167889,96.5727530047212,104.33479115602759,37.08638912720422,18.434960966443807,0.20491452284922468,2.6268638666610533,175.21784362792968,173.311083984375,171.77000427246094,170.2289245605469,168.3221649169922,0.04,0.0,167.76980626656066,-0.0066375129270931366,0.013720868874296206,172.5207061767578,170.48182242257255,2.683241069957047
2024-02-07,0,175.23749923706055,166.3125,175.79999923706055,169.73375129699707,173.58062171936035,-0.194831974800751,2.683292887198669,-0.9204114767280203,2.995609491822936,171.52874946594238,2.2831243515014648,0.015661832887609223,167.43050117492675,174.68875045776366,0.7188155336094557,0.022172849159631396,1.0228255147944971,1.0105866856766614,1.0043242068604987,-0.0031996587169575985,61.4395025577437,176.69346088883827,171.32687511444092,165.96028934004357,174.61785616193498,0.7834034230551046,172.707857131958,2.301175189653703,173.87692012104327,172.5661877546918,1.393298924199283,4.38066099555063,7225500,1.8895418995281414,0.6934281000809024,202299100.0,-25.579412332690527,95.95456447167889,96.5727530047212,96.67263949949385,35.047941221003036,17.42168605704092,0.24232493200885893,2.573767193238574,175.65208276367187,174.0139625854492,172.69000244140625,171.3660422973633,169.72792211914063,0.04,0.0,167.88570053059422,0.00613675747164133,-0.004765382671724153,172.9020712716239,171.0475136893136,2.8102743543948097
2024-02-08,0,174.67000198364258,166.3125,175.79999923706055,169.73375129699707,174.13874912261963,-0.2587460041520038,2.813657982148758,-1.0495001213122093,2.9955975476714394,172.14624977111816,2.443461780548097,0.016402666080913664,167.43050117492675,174.87524909973143,0.7364186476261355,0.02921957830895426,1.0182665182006976,1.0042416086452568,1.0017176261392977,0.00726605143736947,63.55202128680052,177.16394106347963,171.53662509918212,165.9093091348846,174.61749921526228,0.7833749441390384,173.12160709926061,2.068482222503528,174.21117861041358,172.76601805391923,1.7181576711125688,5.041135231410143,6060300,1.8756746237818038,0.5918565160811468,196238800.0,-35.49695520632636,95.95456447167889,96.5727530047212,74.2901986551191,33.13777197521807,17.614959025340408,0.21428186352216144,2.5210387642654437,175.97304290771484,174.53348281860352,173.37000274658203,172.20652267456055,170.76696258544922,0.04,0.0,167.97320650830395,0.006159011274953441,0.002523547117158757,172.69444056919642,171.36461094447546,2.8835758171239547
2024-02-09,1,174.69499969482422,166.3125,175.79999923706055,169.73375129699707,174.37562561035156,-0.4033069155773936,2.8771233840029233,-1.0592454934529267,2.9955916446171056,172.28250122070312,2.4923493957519556,0.016751127356201514,167.43050117492675,174.87524909973143,0.7576364163504323,0.028029961765803107,1.017105559202049,1.0030114185605734,1.0004151804462509,0.002395602082143622,61.09958767077824,177.51124692822316,171.75700016021727,166.0027533922114,174.45964213779993,0.5937628374855937,173.41660690307617,1.9678772566918503,174.31651305661967,172.87221990347743,-0.0014304636964911578,3.4300007156051437,6296700,1.8799479852515788,0.6323044966854399,202535500.0,-33.367224556435076,95.95456447167889,96.5727530047212,68.97405875999368,31.706975818910927,16.85439444405796,0.19229492153160005,2.440638676220001,175.97304290771484,174.53348281860352,173.37000274658203,172.20652267456055,170.76696258544922,0.04,0.0,168.06217594921625,0.001602372592521828,0.007367663827230375,172.78624834333147,171.71066175188338,2.9340401262882203
2024-02-12,1,175.2699966430664,166.3125,175.79999923706055,169.7524995803833,174.67062664031982,-0.5718938310208984,2.9122325387203345,-0.9600487704165541,2.995588451406168,172.36000061035156,2.4749619483947756,0.016931941369690784,167.43050117492675,174.87524909973143,0.7901638510880661,0.01558003845411785,1.019033084607427,1.0050072443960556,1.0032282628415463,0.006763633539790259,59.37667005892453,177.820840161364,171.99637508392334,166.17191000648268,174.72535651070731,0.44272158775246767,173.84928512573242,1.6048636882190819,174.40666749934292,173.06338290542078,-0.6285549186756665,2.421362644330707,8539300,1.8284980597930063,0.9071006093156458,211074800.0,-26.589079623702844,95.95456447167889,96.5727530047212,83.56483217488282,33.84466714595797,15.306513839182228,0.3180382617335739,2.4898538123352907,176.07216247558594,174.69392211914064,173.5800018310547,172.46608154296874,171.08784118652343,0.04,0.0,168.19411557385803,0.00739255139511541,0.006066440257125069,173.07721383231026,172.19089726039343,2.9440094015594194
2024-02-13,1,174.6074981689453,166.3125,175.79999923706055,169.7524995803833,174.67812538146973,-0.6219162056154875,2.9984034758798246,-0.9962510003175167,2.9955800437483004,172.9212474822998,2.588886852264406,0.017416465591411228,167.43050117492675,175.24074897766113,0.7898447496311741,0.05385943114959132,1.0142215710210574,0.9994934000950486,0.9980907837136999,-0.0013012321143859307,70.59610318007013,178.15593189835388,172.15912494659423,166.16231799483458,174.77249908447266,0.4028591029460126,174.18321364266532,1.148751640816521,174.608457555649,173.23331241480676,1.0726028792484732,3.5798153579456913,8397600,1.202888073752459,0.9358325718233891,202677200.0,-54.66859104996583,95.95456447167889,96.5727530047212,50.316351038650154,30.3593071263388,16.811111477603227,0.23855552158064403,2.5720407716286924,176.55596319580079,175.47702328491212,174.6050033569336,173.73298342895507,172.6540435180664,0.04,0.0,168.30094561425835,-0.004797312447382018,-0.0013753357748174436,173.01082720075334,172.45643942696708,2.7706191350056626
2024-02-14,0,175.40500259399414,166.82749938964844,175.79999923706055,170.40687656402588,174.67812538146973,-0.7600747510762337,2.7219444017284014,-0.7577392823566811,2.99560737677487,173.75124740600586,2.325486621856689,0.015772633047816644,168.73950233459473,175.24074897766113,0.7953338451945919,0.042448375273423926,1.0164053089804626,1.0040958597805065,1.0029103207104404,0.0009558647987037983,64.56038494132808,178.01776365849832,172.5738748550415,167.1299860515847,174.9599996294294,0.3330009596991431,174.40589223589217,1.051008323240355,174.60576774047388,173.47883897609748,0.18935204835305394,2.7510919138160026,7056700,1.215879209905855,0.8045619243722965,209733900.0,-32.42863246372768,95.95456447167889,96.5727530047212,78.12036799024602,28.735005600919607,15.91167349295394,0.31480931567551834,2.51843477991652,176.64800305175783,175.6260030517578,174.8000030517578,173.97400305175782,172.9520030517578,0.04,0.0,168.4043296393214,0.0034201556233268704,0.005311240958877258,173.22693525041853,172.67466408865792,2.512744529341222
2024-02-15,0,178.09499740600586,166.82749938964844,175.79999923706055,171.84937572479248,174.72999954223633,-0.9505727307041807,2.5228844037360103,-0.25419898596585844,2.9956253995187083,174.18499946594238,2.134149322509768,0.014585739401425943,169.17900161743165,175.28349723815919,0.707025708137873,0.05141540354993736,1.0296338655131834,1.0197251542169734,1.0180958477125057,0.01960837798973647,68.8102007822876,178.01501872354868,172.96924991607665,167.92348110860462,175.42571367536272,1.2219995055786428,174.8103564126151,1.294514416893737,174.8038052701527,173.77401545469263,0.7539117560493933,1.809475593853397,8723400,1.193498510715428,0.9983388485697102,218457300.0,-3.816065734356751,95.95456447167889,96.5727530047212,174.8630336598748,36.78957862338819,14.070009427256663,0.30902294984299045,2.639891923678736,178.10724584960937,176.8063853149414,175.7550048828125,174.7036244506836,173.40276391601563,0.06,0.0,168.584262994482,0.029004466252893657,0.025309134018320415,173.90067618233817,173.21069117954798,2.5303336693291794
2024-02-16,0,179.19499969482422,168.87750244140625,178.09499740600586,172.28500175476074,174.93562412261963,-0.4979674693546598,2.339906798533772,-0.3827383137716778,2.99564115425764,174.4424991607666,1.926599578857423,0.013483959001961497,169.8604991912842,175.4445022583008,0.6508981380118644,0.05458095265115442,1.0326300307155754,1.0232785247418055,1.0203884122088802,0.02575918033063962,75.20400308019185,178.21243841396208,173.53262481689453,168.85281121982698,175.99107088361467,1.866118420727582,175.30446352277482,1.5486154772274985,175.631687789585,174.42783442953296,1.864614258360315,3.2838928329617985,8148100,1.246014531373538,0.95977431209951,226605400.0,-13.439704417916362,95.95456447167889,96.5727530047212,176.9874451478375,34.89573557166688,13.345717641687706,0.25022283567361336,2.580059013371327,178.13792340087892,176.85604135131837,175.81999969482422,174.78395803833007,173.50207598876952,0.06,0.0,168.7517754089604,0.02297016173486255,0.024199008749130467,174.40916006905692,173.6556156703404,2.628605311543233
2024-02-20,0,179.44750213623047,169.2125015258789,179.19499969482422,172.39624977111816,175.245623588562,-0.09199596146977221,2.3934605069356643,0.03996222696300755,2.995637670174509,174.63875007629395,1.8221997451782244,0.013751687094931473,170.5017520904541,176.02949905395508,0.6903558776212847,0.05059652994395852,1.0310201033999429,1.0218509615599751,1.016616217098983,0.023834686901212487,76.81146540338463,178.8354206934368,174.04849967956542,169.26157866569406,176.67357090541296,2.153889418717405,175.6455350603376,1.8874790547920042,176.51917065413073,175.1279222522233,2.2583639203901114,4.015323844442501,9668000,1.2228676805195164,1.1604675238938318,236273400.0,-8.08427299502696,95.95456447167889,96.5727530047212,180.61299427280372,34.220978371410304,12.561340624308809,0.3215745650441782,2.541437474575398,178.3289234008789,177.01054135131835,175.94499969482422,174.87945803833009,173.56107598876952,0.08,0.0,168.9525908797296,0.022413129370637108,0.02696994903838175,175.10550144740515,173.89997100830078,2.694898133175053
2024-02-21,0,180.0900001525879,169.2125015258789,179.44750213623047,173.16562175750732,175.30374813079834,0.00806479016601725,2.526287775003072,0.11949785310042937,2.99562746132545,174.67125129699707,1.8018500518798817,0.014477905755977988,172.0430000305176,178.2049976348877,0.6748830439367267,0.06048607826287734,1.032078006156705,1.0223919708298275,1.0154496766427286,0.03139900657838801,80.01351567066025,179.5452002143128,174.49262466430665,169.44004911430048,177.44428525652205,2.2889108857314966,175.951963697161,2.2313903049865753,177.24422816009513,175.73997595879786,2.7351577822935456,2.733688193157937,7027900,1.1483077129383559,0.850374131221807,243301300.0,-0.9415426359682347,95.95456447167889,96.5727530047212,180.925019507697,33.31657212936755,11.671262535716954,0.3716958988756822,2.536239861508548,178.73384246826174,177.33808059692385,176.20999908447266,175.0819175720215,173.6861557006836,0.1,0.0,169.10199547029842,0.03810404032907577,0.029068854309830566,175.93744332449776,174.36184583391463,2.659017832728205
2024-02-22,0,182.38750457763672,169.93249893188477,180.0900001525879,173.92187309265137,175.50375175476074,0.3758957905082308,2.501774486477033,-0.10830023796671373,2.9956303033478218,174.6837501525879,1.8248000335693348,0.0142928731564929,172.2865020751953,179.22024993896486,0.6722648818972071,0.05977374124754457,1.0419969834804539,1.032355319917214,1.0220850740818477,0.039807883927944765,80.99120138232809,180.04004856859618,175.03649959564208,170.032950622688,178.4610721043178,2.7051055457537876,176.59321430751257,2.6879515934681235,177.96376136143405,176.3986105768755,3.0882397705648312,2.4402735689107815,9296500,1.1477939525166945,1.129456502590831,252597800.0,-3.2406550539779513,95.95456447167889,96.5727530047212,213.25037938165246,37.875154293901645,10.828240722669102,0.37972749190719146,2.535060149459824,180.87119744873047,179.29439700317383,178.0199966430664,176.74559628295899,175.16879583740234,0.12000000000000001,0.0,169.33597003535613,0.03999317213265763,0.050556675079480265,176.96571568080358,175.02146475655692,2.907923640791373
2024-02-23,0,184.04750061035156,172.2775001525879,182.38750457763672,174.23124980926514,176.37374877929688,0.94732957987074,2.6963642633334746,0.06514416067179818,2.995615019854638,174.76499938964844,2.1059503936767556,0.015349970270323084,172.41799926757812,179.51175193786622,0.7014185693719374,0.05862295381058444,1.0477529691049636,1.0375522358340385,1.0233787236553245,0.03342319150478823,84.0856986732213,181.05197840459664,175.65924987792968,170.26652135126272,179.80964388166154,2.8146404918188193,177.2910714830671,3.2499926190154587,179.0766970736329,177.29579359616477,4.060882108114011,5.177042125777001,7105800,1.143056346797177,0.8726734143356547,259703600.0,-9.618372646744303,95.95456447167889,96.5727530047212,198.2061811659814,40.6940540255493,10.16022715166621,0.3230805739627067,2.505663135245925,182.23111651611327,180.3944362487793,178.90999603271484,177.4255558166504,175.5888755493164,0.14,0.0,169.52970428162334,0.02290550266082869,0.045219541622856414,178.3400399344308,175.67543356759208,3.30347504982955
2024-02-26,0,183.51250076293945,172.2775001525879,184.04750061035156,174.52499866485596,178.36999797821045,1.0434591184153954,3.1423462200306025,0.1419457779454545,2.995574293205574,175.0362491607666,2.5779005813598586,0.01782919293040489,173.31224632263184,180.31975059509278,0.725741845707877,0.06735970162477908,1.0412219253203927,1.029095918609997,1.0136935943290728,0.024093870227785974,86.34489539439039,182.53194223406754,176.24724979400634,169.96255735394513,180.9678579057966,2.3256996337804328,177.963928767613,3.502184749942991,180.32256275790752,178.22135034230536,5.406412977907952,5.606002179977101,7145400,1.1659208261499734,0.8791433230987667,252558200.0,-14.626359857503793,95.95456447167889,96.5727530047212,148.25690898832156,38.32700597859594,11.655029842295185,0.3288040127402033,2.4675587929853657,182.23111651611327,180.3944362487793,178.90999603271484,177.4255558166504,175.5888755493164,0.14,0.0,169.7104535619607,0.024185931280891415,0.01940297636657057,179.37537275041853,176.30115400041853,3.465595774213394
2024-02-27,0,183.1349983215332,172.2775001525879,184.04750061035156,174.65437602996826,179.25812530517578,0.9019682036731982,3.3880674491775515,-0.449307073350218,2.9955496902915835,175.25374794006348,2.9166256141662616,0.019163141953864007,174.02424850463868,182.500004196167,0.7850512189901245,0.06521455558851627,1.0358241157235815,1.0219259038331798,1.0068060312284863,0.02054916419234032,82.48624320027346,183.57738478391423,176.8012498855591,170.02511498720395,181.68785803658622,2.0521387839398564,178.55678585597448,3.631887835906677,181.12236147199977,178.88979407488793,4.6221590314111785,5.410917787781679,5717100,1.1820423367078996,0.708879625243956,246841100.0,-13.910967768541912,95.95456447167889,96.5727530047212,120.30484413557711,36.812979593161984,11.92388357856637,0.32485220511039387,2.3830116869205065,182.23111651611327,180.3944362487793,178.90999603271484,177.4255558166504,175.5888755493164,0.14,0.0,169.84805150807227,0.020697762182459112,0.024688664461548368,179.88103594098772,176.89085606166296,3.573338442914917
2024-02-28,0,183.99250030517578,173.40999603271484,184.04750061035156,174.67187595367432,179.60812664031982,0.7643093317844459,3.488107044535365,-0.9491956935930967,2.9955397911357298,175.33749961853027,3.115700531005859,0.019668579653185397,174.25900001525878,183.17274856567383,0.8597238901934517,0.0484477961992383,1.0374885580161837,1.0222245671846228,1.0074356127324542,0.021669721524134378,78.39553263746922,184.32033888307706,177.34412479400635,170.36791070493564,182.37321526663644,1.874240871922278,179.18214307512557,3.7675971232136694,181.62937487260814,179.41746659871296,2.829950862705917,4.747332788356838,6131600,1.119868912091092,0.7830451742587117,252972700.0,-6.518218967229997,95.95456447167889,96.5727530047212,123.41296441504377,39.36007016201751,11.10952517751508,0.29319777347851345,2.3726652839485913,182.23111651611327,180.3944362487793,178.90999603271484,177.4255558166504,175.5888755493164,0.14,0.0,170.00456013262607,0.019237131495122073,0.025872181261374666,180.63670349121094,177.52293178013392,3.84900338477653
2024-02-29,0,185.5,173.40999603271484,184.04750061035156,174.6887502670288,180.6643762588501,0.5593866938665752,3.7152255417807205,-1.2824695045544179,2.9955148103209406,175.60250091552734,3.3611380958557135,0.020894341907715573,174.25900001525878,183.56050071716308,0.8744401605122778,0.046601257700052176,1.0432476791230032,1.025254133569347,1.0113676584470477,0.017065288708077997,79.65487521223258,185.240575862309,177.81012477874756,170.37967369518614,183.23785781860352,1.6862389769624935,179.95571436200822,3.880031408162994,182.21983804016025,179.9379178879623,2.677251384537451,4.996077384254101,9643000,1.112814144401942,1.2464268472303097,262615700.0,-2.6791830745636713,95.95456447167889,96.5727530047212,128.4327343317858,40.0094088038283,10.241895869143677,0.4149157168545358,2.387649559627572,183.17083325195313,181.15457360839844,179.52499389648438,177.8954141845703,175.87915454101562,0.16,0.0,170.26528506468904,0.016332575109166525,0.02852404903769554,181.53079223632812,178.31814684186662,4.12697453818757
2024-03-01,0,185.63249969482422,173.40999603271484,185.5,174.6887502670288,182.57437801361084,0.42408155862674124,4.040093390077978,-1.408879351094665,2.9954763329821645,176.75,3.6651383209228525,0.022659584182276836,174.25900001525878,183.99800033569335,0.8477603557617424,0.06971918715115076,1.0411529753573745,1.0202937463812685,1.0086667102890674,0.00861190224923658,87.23541245016277,186.37531159705048,178.29512481689454,170.2149380367386,184.02964346749442,1.19004492617541,180.73696436200822,3.8402345631349974,183.03566797801517,180.5582648980757,3.3728515536397268,6.200262147687858,6311800,0.9156132749195045,0.8322120573047315,268927500.0,-8.321335353116014,95.95456447167889,96.5727530047212,117.9559709286908,38.36610438313312,9.813227505528623,0.371906213833515,2.3119938527266064,183.17848071289063,181.16075964355468,179.52999877929688,177.89923791503907,175.88151684570312,0.18,0.0,170.43301196632788,0.007065520995673591,0.012126416254024016,182.15085928780692,179.04415130615234,4.2069060903148765
2024-03-04,0,185.8125,174.09249877929688,185.63249969482422,174.79999923706055,183.22937393188477,0.29267400470890104,4.177021660727739,-1.5251282761623257,2.995460304251546,178.64499855041504,3.7877506256103515,0.023347544653849372,174.57449836730956,184.1927505493164,0.8716802257572719,0.06515470747683728,1.0386026200873362,1.0170695226099968,1.0079086769487786,0.012533201975333919,87.12696226426421,187.2602933214555,178.90625,170.5522066785445,184.51892852783203,1.1032829606771368,181.4900003160749,3.717429440617315,183.68637560224553,181.1429508214524,3.077627595946605,6.260911885919338,7063600,0.9205420427784039,0.9409144463988736,275991100.0,-6.078848282596598,95.95456447167889,96.5727530047212,113.74896782262954,37.991635011621774,8.827418234200413,0.38847661396810873,2.3847287335644505,184.05707604980472,181.87145587158204,180.10499572753906,178.3385355834961,176.15291540527343,0.19999999999999998,0.0,170.62330982058182,0.018106400066390638,0.014620306358507563,182.66075570242745,179.81323569161552,4.374174341258828
2024-03-05,0,187.6425018310547,174.09249877929688,185.8125,175.13687419891357,183.63250064849854,0.1350119025187919,4.292833283056581,-1.5917910189535829,2.9954465133248003,179.32125091552734,3.8763004493713367,0.023917770948998284,174.66375160217285,185.51324996948242,0.8751860961117159,0.0673205411082127,1.0454611402697243,1.0233794203867992,1.0153018414241564,0.0246130098060644,87.83460833365609,188.06866655848376,179.4829999923706,170.89733342625743,185.03250013078963,1.5806947369009268,182.4210720062256,3.486220982375003,184.21972667819108,181.64010635786215,1.877867362840839,6.015007450706567,6617800,0.9077283691729644,0.8886477790855299,282608900.0,-5.040320926684004,95.95456447167889,96.5727530047212,128.6647762759279,39.75518994169753,8.055666137059523,0.38942138261499415,2.424766838906134,185.78832189941406,183.61584118652343,181.86000061035156,180.1041600341797,177.93167932128907,0.2,0.0,170.81863023449736,0.02780047766507754,0.028304985086470367,183.3048379080636,180.8224389212472,4.589854669075544
2024-03-06,0,189.12000274658203,174.6074981689453,187.6425018310547,175.26187229156494,184.00625038146973,0.05686950841706318,4.454818681577142,-1.5040704963346347,2.9954266595129955,179.76875114440918,4.021800479888915,0.024726944463368837,174.69249992370607,185.6504997253418,0.8613989964718876,0.07325479917435755,1.0497306712315666,1.0268480814016827,1.0183290743590148,0.02786799697216802,89.86780697890542,189.07013750811282,180.1605001449585,171.25086278180416,185.83357184273856,2.0370257505183695,183.40071487426758,3.2841486260701167,185.07611832814004,182.37403783890142,1.9533007559358988,7.465317239410344,7572900,0.9472721558771555,1.0114124301330893,290181800.0,-3.8793679885822274,95.95456447167889,96.5727530047212,128.01030728272534,39.16105272850028,7.471820800704231,0.4033025427939048,2.425864661835173,186.78488415527343,184.7525621948242,183.11000061035156,181.46743902587892,179.4351170654297,0.2,0.0,171.0495753925036,0.027931446321835862,0.03314253650419492,184.17632620675224,181.77584947858537,4.813340818415229
2024-03-07,0,188.72750091552734,174.6074981689453,189.12000274658203,175.3712511062622,184.41062545776367,0.01151850519148678,4.683037735041824,-1.3359247717311078,2.995397071425942,181.2387523651123,4.203500556945801,0.02589105293330276,174.69249992370607,185.99550018310546,0.8546952467283354,0.07922107750888006,1.0434154052636997,1.019717335846149,1.0106350224880254,0.017398926768341427,91.19382090612572,190.2408257981476,180.87475032806395,171.5086748579803,186.63250078473772,1.8939094354484676,184.16017941066198,3.1908790795413258,186.07953378182816,183.23255731947063,3.055651228297696,7.819047318926064,7618300,0.9613607477862185,1.0148139958359363,282563500.0,-21.312849783730712,95.95456447167889,96.5727530047212,105.62711182304072,34.847166680843415,9.495195437780621,0.3580708132173666,2.5298582364030624,187.5877608642578,185.7861213989258,184.3300018310547,182.8738822631836,181.07224279785157,0.2,0.0,171.26674412108326,0.009728013430534421,0.018928287352462922,184.8006330217634,182.34083448137557,4.823768678135285
2024-03-08,0,188.76000213623047,174.6074981689453,189.12000274658203,177.42249870300293,185.53312492370605,-0.1129503087657362,4.792728519424758,-1.2741092932607532,2.9953834021661225,182.76125144958496,4.246825523376463,0.026399054298206586,174.69249992370607,187.75100173950196,0.862445118392223,0.08048032731574147,1.039717882105709,1.0164111500933166,1.007327088277363,0.016847817308649038,88.88925519043217,191.13470745083683,181.54925041198732,171.9637933731378,187.3135724748884,1.624346362732218,184.8433938707624,3.0676053354183552,186.73256992493293,183.92309344458639,3.053759600977684,5.970130359856434,6166800,0.9496465940667187,0.820881168039838,288730300.0,-18.858556409576817,95.95456447167889,96.5727530047212,106.06674528908304,32.28399575954213,8.79677972263523,0.309777894860533,2.534187430039458,187.6467608642578,185.88162139892577,184.4550018310547,183.0283822631836,181.26324279785158,0.2,0.0,171.44394947708838,0.015813143442791944,0.011609134289584285,185.343017578125,182.98986053466797,4.721338978513153
2024-03-11,1,187.55749893188477,174.6074981689453,189.12000274658203,178.91999912261963,185.67749977111816,-0.237996779475564,4.765235615858594,-1.1798260208422184,2.99538968230707,183.32374954223633,4.122500686645509,0.026146159433686436,175.21249694824218,188.73075103759766,0.8601760831613585,0.08051176316423761,1.0291009019021933,1.007379806779566,0.9975799343644629,0.009391181604492482,88.9206179621379,191.7842216513339,182.2537504196167,172.7232791878995,187.60750089372908,1.4140193435536452,185.4226793561663,2.715841669540429,187.23511347351035,184.5388563288011,2.591139216624133,5.3377619117139465,5762600,0.949350738820255,0.7698134178321094,282967700.0,-18.447474975194904,95.95456447167889,96.5727530047212,81.23549957158392,30.231395065279898,13.10617470965004,0.3074084795298182,2.5115878964307248,187.67272100830078,185.9236416320801,184.51000213623047,183.09636264038085,181.34728326416015,0.02,1.0,171.59500437533237,0.008624384862688794,0.016190864481437323,185.65799386160714,183.59439304896765,4.539015823351746
2024-03-12,0,189.2150001525879,174.6074981689453,189.12000274658203,179.3843765258789,186.2487497329712,-0.39071553717965707,4.5654805383640085,-1.0236663609413192,2.995419644008211,183.75250053405762,3.8677501678466797,0.024962047759655506,175.39150199890136,188.73075103759766,0.86981388422291,0.07010613638477779,1.034544738711038,1.0140791458048324,1.0045311745467411,0.008380288613658582,77.78463020444379,192.02783645819778,182.89687538146973,173.76591430474167,188.1192866734096,1.2142662781310503,186.07446507045202,2.416004848345781,187.3137286495197,184.95165839306736,1.1091638446818144,4.519425848289302,5708400,1.0438997865920385,0.7772701185226639,288676100.0,-7.127473581351684,95.95456447167889,96.5727530047212,102.89488947701874,33.2302673511677,12.255685540534444,0.3211401064475556,2.4927812168506667,188.31464129638672,186.96268209838868,185.87000274658203,184.7773233947754,183.42536419677737,0.02,0.0,171.7570135628604,0.006841687310629618,0.0169274313439922,186.30066571916853,184.22576250348772,4.417341755103362
2024-03-13,0,190.82749938964844,174.6074981689453,189.2150001525879,179.92937564849854,187.57874965667725,-0.506160114667065,4.4096400993317495,-0.7963514490723438,2.995442600358306,184.02000045776367,3.647212619781493,0.024018416090137922,177.82599792480468,188.79600219726564,0.8157445062935267,0.08365907613834984,1.0393987215590894,1.0193994460631488,1.0114031376643031,0.009028641171047402,82.47350876429591,192.4134057556093,183.5941255569458,174.77484535828233,188.8357151576451,1.1005240050272997,186.67732184273856,2.477461201860101,187.78384325725222,185.55243539503584,1.9298886044486954,5.066910984656842,7795500,1.0190086371870304,1.065823906284608,296471600.0,-3.6880000514519615,95.95456447167889,96.5727530047212,125.12452296969535,35.99367144365717,11.57613724041337,0.36126394055809846,2.4494648111418282,189.49035803222654,188.1048194580078,186.98500061035156,185.86518176269533,184.4796431884766,0.02,1.0,171.99425765884143,0.009761048713231135,0.01500934646449252,186.9645254952567,184.81264059884208,4.1013484447157325
2024-03-14,0,189.43250274658203,175.40500259399414,190.82749938964844,181.8131284713745,187.91375160217285,-0.42801672483555897,4.167171218738058,-0.7599410245210363,2.9954760680813393,184.77375030517578,3.4743749618530275,0.02259791426498031,179.0849994659424,189.1295024871826,0.7766051115364155,0.08792506808572838,1.0272626756536904,1.0082659479185072,1.0021955768155657,0.0037355543184469653,84.69039449103961,192.73946805545708,184.40512561798096,176.07078318050483,189.091429574149,0.9782285739836866,187.06196485246932,2.4556894810731165,188.54361610187897,186.30270286184708,2.698956953729398,4.6275071483414445,10310900,1.0363197341622188,1.3790580691929804,286160700.0,-39.620636206940844,95.95456447167889,96.5727530047212,78.779801796003,31.487188698902063,17.69968546140187,0.2676763950998443,2.598909120915692,189.49035803222654,188.1048194580078,186.98500061035156,185.86518176269533,184.4796431884766,0.02,0.0,172.26574853743767,0.0005323084970894065,-0.008230874553322604,186.88260323660714,185.09372057233537,3.6115884648223937
2024-03-15,1,188.54999923706055,178.09499740600586,190.82749938964844,182.94812488555908,188.73562622070312,-0.3433600987915579,3.7532658288836775,-1.042354707858371,2.9955262054949205,185.5662498474121,3.2056001663208007,0.02027625078643184,179.42225189208983,189.23675041198732,0.8305011726944956,0.06365987537948575,1.0186027967673317,1.0014725890035072,0.9967831134621685,-0.001112539186232664,73.18336919935155,192.6130322833777,185.10650062561035,177.599968967843,189.01000050136022,0.998957989124918,187.4217861720494,2.256585105784225,188.77136132227812,186.75664383191105,0.9539421495983806,2.9258762647535757,17208100,1.048019314979309,2.177963436297028,268952600.0,-15.06843147847989,95.95456447167889,96.5727530047212,79.67241361897389,27.797127308398608,17.254573409994595,0.28499076201330614,2.7325377490524794,189.49035803222654,188.1048194580078,186.98500061035156,185.86518176269533,184.4796431884766,0.02,0.0,172.70880740724957,0.011050854000439925,0.01293443930828811,186.9913613455636,185.58384377615792,3.5291080544311333
2024-03-18,0,191.47000122070312,179.19499969482422,190.82749938964844,183.4181251525879,188.73562622070312,-0.4299800070290333,3.4566692043749643,-0.9537431865873613,2.9955584125568393,185.7224998474121,2.935574989318849,0.018621360540003323,180.02575035095214,189.23675041198732,0.8386146324746971,0.05220569523797116,1.0314646020547666,1.015408522810636,1.0124447159714305,0.020860281839433448,66.63224496046526,192.54258912591297,185.62925071716307,178.71591230841318,189.40178625924247,1.3468993619195497,188.0171435219901,2.1348298830158763,188.7202547024187,187.01661770870447,-0.3013977904205514,2.745043772592097,9013800,1.0905444910740827,1.1346262535733211,277966400.0,-0.4106090988848638,95.95456447167889,96.5727530047212,125.01628895995377,30.36312513059825,15.983619096325175,0.3408086746750697,2.738097368725606,190.4013592529297,188.97932067871093,187.8300018310547,186.68068298339844,185.25864440917968,0.04,0.0,172.9656353657948,0.02320892913024153,0.023589400225695636,187.66792951311385,186.2342812674386,3.4506882789610893
2024-03-19,0,193.20249938964844,179.44750213623047,191.47000122070312,183.8725004196167,188.85000228881836,-0.40897283485478275,3.3477771496367783,-0.7961041001970566,2.9955703022582707,186.68499946594238,2.8872501373291017,0.01797531791999772,182.15775413513182,189.57200241088867,0.7564923828714616,0.06699730529180385,1.0373678396854733,1.021531449563574,1.0173960833431248,0.021073906581639434,73.94869948404158,192.9385550927306,186.24300079345704,179.54744649418348,190.03642872401647,1.9191562112582083,188.67500059945243,2.2166985422347776,189.4102855459403,187.64002451471967,1.4531535106816778,4.5512889265087475,8478700,1.2152068218120884,1.0753187293313422,286445100.0,-1.388884683970072,95.95456447167889,96.5727530047212,149.24288459818305,32.41693235790516,15.313566224974638,0.3697882528939978,2.652851163674705,191.55111584472655,190.07943780517576,188.88999938964844,187.7005609741211,186.2288829345703,0.06,0.0,173.22122674132206,0.02080693651806076,0.029210270375094483,188.45466831752233,186.89884294782365,3.4153916812665983
2024-03-20,0,195.17250061035156,180.0900001525879,193.20249938964844,184.03375053405762,189.1437520980835,-0.15413476985670074,3.293539570967292,-0.691397686639271,2.995576899227465,187.60000038146973,2.8266751480102528,0.017619035709250355,183.06024894714355,190.8917495727539,0.7133307723546132,0.07281081251568937,1.044089856405621,1.0289227601043638,1.0234718529407256,0.022769261425111154,76.94873825716031,193.51782979806256,186.93075065612794,180.34367151419332,191.12428610665458,2.3821932853230496,189.36589350019182,2.621405922458645,190.36030958564612,188.4738137240638,2.3535162127259155,5.005638310907597,9367000,1.2397923342968866,1.170614538265236,295812100.0,-1.8714064538877695,95.95456447167889,96.5727530047212,185.23783312007404,36.90614726435984,14.101883166624303,0.37307350545470447,2.6741643705118494,193.65955914306642,191.86522012329104,190.41500091552734,188.96478170776368,187.1704426879883,0.08,0.0,173.5253760550927,0.025864639705568182,0.03418661606065568,189.5902862548828,187.624140058245,3.629557191224915
2024-03-21,0,197.83499908447266,182.38750457763672,195.17250061035156,185.1368751525879,189.26937580108643,0.3253784300621247,3.3667829003656307,-0.5375589442172797,2.995571670880732,188.09625053405762,2.7628751754760743,0.017938488054432242,183.47475051879883,191.64325103759765,0.7331702978603196,0.07009798210859707,1.0540806677615067,1.0396418052971295,1.0327277010872487,0.044356149108853105,79.24886083648182,194.4184414797474,187.6848756790161,180.9513098782848,192.35571452549524,3.2869046546609733,190.23750059945243,3.2401891223164796,191.56794546770837,189.4289004531527,4.060089157636046,5.214286043316206,11203800,1.2194344945267312,1.38367288717196,307015900.0,-2.440602903802123,95.95456447167889,96.5727530047212,218.7534460032556,41.48175393361231,12.942922802929449,0.38237527440187463,2.704698289209867,195.85223541259765,193.6388771057129,191.8499984741211,190.0611198425293,187.84776153564457,0.1,0.0,173.92299344957652,0.05899873167796832,0.040129491332435006,190.892573765346,188.59661974225725,4.180432136479822
2024-03-22,0,198.16249465942383,183.1349983215332,197.83499908447266,185.59937477111816,189.78125190734863,0.6911185700640265,3.8061539130546143,0.03897783559631973,2.99552923426196,188.63875007629395,2.928275318145751,0.020196378249645736,183.94450035095215,193.39949951171874,0.7435982413029107,0.07491271779512354,1.0514983861551739,1.0364025232911909,1.0254416378776576,0.0509811480310729,82.29745811589055,196.06955823046718,188.45725040435792,180.84494257824866,193.40357099260603,3.840999979295516,191.11964307512557,3.6035791802779764,193.1357439979207,190.53662763639386,4.5556636233561685,6.57347146092903,8105800,1.281131251764465,0.9949252161339954,315121700.0,-27.068738410110466,95.95456447167889,96.5727530047212,178.19281363088524,39.98201920785408,11.634197047355165,0.3411976984176136,2.7932513793034124,197.11463702392575,195.03267782592772,193.3499984741211,191.66731912231444,189.5853599243164,0.12000000000000001,0.0,174.1982704455889,0.033210692403312425,0.04601788918635598,191.63269914899553,189.2986123221261,4.353922114092965
2024-03-25,0,195.68000411987305,183.1349983215332,198.16249465942383,185.76749992370605,190.9881248474121,0.672927429191814,4.210227856967499,-0.2391727147160725,2.995485764458281,188.7437515258789,3.201349639892578,0.022257142541565633,183.94450035095215,195.4387504577637,0.7829042559274039,0.07983104058621687,1.034451790304561,1.0184108387580288,1.0026208385553639,0.021987793765756214,83.44334370071891,197.58345582074656,189.16300010681152,180.74254439287648,194.29607118879045,3.4726683691532396,191.69375038146973,3.646992128921403,194.38608083054902,191.5607347084766,3.8437831513990286,6.646482157779389,8620000,1.2505740005118482,1.0485501847431082,306501700.0,-39.6913785668502,95.95456447167889,96.5727530047212,107.74860570561798,37.320829798156865,16.483838892495513,0.3092342172706884,2.7779684544245686,197.11463702392575,195.03267782592772,193.3499984741211,191.66731912231444,189.5853599243164,0.12000000000000001,0.0,174.45389288920228,0.011211517931804194,0.023752056630655084,192.60023498535156,189.74141911097936,4.261115646778226
2024-03-26,0,195.2599983215332,183.1349983215332,198.16249465942383,187.12124919891357,191.90312576293945,0.5317951452745712,4.2288365050319365,-0.5954412236941673,2.995484920593213,188.94000244140625,3.3950371551513654,0.022283848124678946,185.34925003051757,195.895503616333,0.8238775399983272,0.06850141105368819,1.0289222915675837,1.011947092568433,0.9961711170939487,0.010649442623075212,70.83319705582795,198.22904828472207,189.7713752746582,181.31370226459433,195.25464248657227,2.374740467397412,192.13232149396623,3.6826860331230824,194.70431595533373,192.17837142004004,3.298009202596433,4.283412452076014,5961500,1.4280631922067288,0.7240897864047482,300540200.0,-33.309970755759835,95.95456447167889,96.5727530047212,95.91270951434893,34.806563648118086,16.150679958506352,0.2891664607490514,2.7652174904419593,197.11463702392575,195.03267782592772,193.3499984741211,191.66731912231444,189.5853599243164,0.12000000000000001,0.0,174.62800918053154,0.010010839381956904,0.01593477098142396,193.36720057896204,190.17928096226282,4.1451428355936635
2024-03-27,0,198.00000381469727,183.99250030517578,198.16249465942383,187.6212511062622,193.69499969482422,0.46801771047846136,4.101181941602526,-0.8725342668831888,2.9955009791193894,189.16750144958496,3.4588994598388694,0.021542352656651442,185.6192497253418,195.895503616333,0.8348967863549479,0.06123889831198986,1.0400382057977782,1.0229426077005785,1.0080337460198703,0.014487200786501342,68.42535548867286,198.57998915786325,190.37762527465821,182.17526139145318,196.1875,1.8689699058173648,192.79464312962122,3.8531087029740045,194.8450289534324,192.61281368820198,3.558737264186511,3.246613518284829,8725800,1.4471406956780581,1.0434058907268553,309266000.0,-6.732060483037848,95.95456447167889,96.5727530047212,133.1197895328896,38.81842743902948,14.576561238004237,0.3244395405292111,2.8443581550291968,197.11463702392575,195.03267782592772,193.3499984741211,191.66731912231444,189.5853599243164,0.12000000000000001,0.0,174.91384630628758,0.01624822653613678,0.029568155232118146,194.33614894321985,191.00203922816686,4.311500562331793
2024-03-28,0,199.76250076293945,185.5,198.16249465942383,188.32312488555908,195.19437503814697,0.4343147155603756,4.146770986959677,-1.1402009736546785,2.995497491412773,189.32375144958496,3.6158497619628918,0.021701980223735182,185.79449996948242,197.85149955749512,0.8099303160431189,0.06738546530834105,1.0454500271739633,1.0282381061706198,1.0140871921464023,0.0097429761537986,73.04597007548468,199.37154242405367,191.07800045013428,182.7844584762149,197.12464305332728,1.764512829250087,193.58053588867188,4.082134950946325,195.6373171658802,193.3168999419526,3.410457279136461,4.913169969500209,8628300,1.5128122100025996,1.0380446747921999,317894300.0,-2.896539096174569,95.95456447167889,96.5727530047212,135.95418206728496,39.51944080380119,13.762822820886136,0.31695445523784704,2.796777904186388,197.29800122070313,195.18100122070314,193.47000122070312,191.7590012207031,189.64200122070312,0.14,0.0,175.20567337084844,0.006229266434644165,0.020221084295157378,195.2556610107422,191.85516466413225,4.5429396492089245
2024-04-01,0,199.61000442504883,185.63249969482422,199.76250076293945,188.68312549591064,195.36499977111816,0.38444500595834635,4.347698831718817,-1.2147465798101524,2.9954760409535583,190.13000106811523,3.874599685668943,0.022668926002962886,187.38299903869628,198.01625289916993,0.7933242140216086,0.07611814252000403,1.0407676784671944,1.022018920228103,1.011333891087184,0.007304660592373002,75.82563606567425,200.4865231517189,191.79112548828124,183.09572782484358,197.7585721697126,1.743279060931856,194.4414291381836,3.983922795052017,196.67414724388385,194.10197001324815,3.3954019197551295,5.828829467149689,7309000,1.526738593793773,0.8740805053378825,310585300.0,-13.83125222260091,95.95456447167889,96.5727530047212,113.86022920361864,37.664449516045345,12.918486568304752,0.31204557084396256,2.7662178763721657,197.5274408569336,195.41627987670898,193.70999908447266,192.0037182922363,189.8925573120117,0.16,0.0,175.44395692038307,0.011799427394696194,-0.0006028622466743921,195.6243133544922,192.6072998046875,4.486352389425056
2024-04-02,0,198.7775001525879,185.8125,199.76250076293945,188.7518768310547,196.21875286102295,0.2978293486155534,4.424292976659683,-1.3737267891133507,2.995468694347614,191.14875030517578,4.027499866485596,0.022984534053720536,187.6340015411377,198.30724563598633,0.8083331931360729,0.07425498513312521,1.0326640313996611,1.012025524991724,1.0056409174773084,0.01582939476440992,75.02064235097309,201.33858667811182,192.49000072479248,183.64141477147314,197.89321517944336,1.786038600096221,195.12446485246932,3.8359208478516766,197.41072272298828,194.72721292835976,2.273631685211861,6.426032316383772,7014700,1.5349826910886577,0.8391306402248464,303570600.0,-14.384514974394556,95.95456447167889,96.5727530047212,93.92559243360203,35.96026664836549,13.638150355240144,0.28959334219927796,2.6898840228951566,197.5274408569336,195.41627987670898,193.70999908447266,192.0037182922363,189.8925573120117,0.16,0.0,175.66290679046568,0.02073705467900111,0.011392610132646279,195.5960649762835,193.24431937081474,4.436557499968932
2024-04-03,0,198.64999771118164,187.55749893188477,199.76250076293945,189.03000259399414,197.8762502670288,0.19564790801978235,4.347565057267673,-1.5659563083363661,2.995479262236618,192.33625030517578,4.0079998016357425,0.022510119257996637,188.45924949645996,198.860750579834,0.8490378800489327,0.05934155755159714,1.0285378321376424,1.0076275717800893,1.0018559234476405,0.01736146378566561,70.0953872469312,201.8333808469572,193.13825073242188,184.44312061788656,197.96285847255163,1.807662409959478,195.68321473257882,3.730130988756415,197.75335252990902,195.193296449575,0.4764076490392886,5.053774802361627,9353400,1.5492827037245853,1.1008837412674863,294217200.0,-18.25724871287,95.95456447167889,96.5727530047212,78.99767234469806,34.14014840150475,13.981936203943018,0.246324477815977,2.630480020752564,197.5274408569336,195.41627987670898,193.70999908447266,192.0037182922363,189.8925573120117,0.16,0.0,175.9438233242207,0.013130411162611821,0.017862627142482677,195.83336094447546,193.73303004673548,4.408455669641867
2024-04-04,0,197.50749588012695,187.55749893188477,199.76250076293945,189.19125080108643,198.0406265258789,0.023166159347883606,4.313608054963591,-1.6284880127247212,2.9954842929863053,194.1875,4.002374839782715,0.022270838275813016,188.70975074768066,198.860750579834,0.8717544056166934,0.0503912585987515,1.0197165442385654,0.9990717610526324,0.9926995100364979,-0.002487413763038293,68.64872381465297,202.3158416363554,193.6886255264282,185.06140941650102,198.22392872401647,1.5343124242865438,196.25999995640345,3.2872652670120908,197.980044390055,195.639807428831,0.2460117655440652,4.099251075737536,9243800,1.5421133945352348,1.0773898256488197,284973400.0,-36.583721222264046,95.95456447167889,96.5727530047212,47.909079110091874,30.45423632885124,18.092796223123745,0.1680669595807941,2.737800256258673,197.5274408569336,195.41627987670898,193.70999908447266,192.0037182922363,189.8925573120117,0.02,1.0,176.19602488936948,-0.013676610864433947,0.005422033723904896,196.1117902483259,194.35601261683874,4.328285312334535
2024-04-05,0,196.70999908447266,187.55749893188477,199.76250076293945,189.3781270980835,198.0406265258789,-0.17448605729738387,4.256396619545116,-1.57678807570395,2.9954915211927564,195.21624946594238,3.9229497528076167,0.021927981409988164,188.70975074768066,198.860750579834,0.8735686879035618,0.046522075065940985,1.0134049029350294,0.9938638177215492,0.9891809088022795,-0.015280654110799485,63.41280748604398,202.62079342219573,194.10800018310547,185.59520694401522,198.43107169015067,1.1053980999104038,196.84285708836146,2.42553312425738,197.86318845645843,195.87318395334714,0.9339185004996166,4.262728421187277,6531000,1.5737681267287633,0.7660597188768445,278442400.0,-31.583751396420467,95.95456447167889,96.5727530047212,42.041400287719064,28.07518597628332,17.821352837458477,0.20643782697869723,2.7572785001472906,198.3322017211914,196.71890127563478,195.41500091552734,194.1111005554199,192.49780010986328,0.04,0.0,176.37003337301047,-0.008478507709908989,-0.004602315111465752,196.51741463797433,194.94230760846818,4.1575481824516896
2024-04-08,0,198.17499542236328,187.55749893188477,199.76250076293945,190.47875022888184,198.0406265258789,-0.3618308279719525,4.104709829701415,-1.4100892653228898,2.995509009153427,195.47000122070312,3.7041997528076194,0.021103133511275567,188.73900184631347,198.860750579834,0.8670034171084244,0.0421169572911139,1.0188572543503696,1.0018350531280753,0.9996166272627582,-0.0071890635282479964,59.653613610607444,202.71654475095553,194.50712509155272,186.2977054321499,198.4560704912458,1.0959631013402382,197.32178524562292,1.884706547820018,197.56958814950698,195.93389371255338,0.7426000078888393,4.327764455279943,8001000,1.5964426864182333,0.9284967022178433,286443400.0,-28.73840438654692,95.95456447167889,96.5727530047212,64.30992307469263,29.22893860223821,17.09051482088955,0.24385929505815607,2.669465806808516,198.91984301757813,197.67008337402345,196.66000366210938,195.6499239501953,194.40016430664062,0.04,0.0,176.59421265861852,0.0035074142251312335,-0.003306233534227206,196.53404671805245,195.43509783063615,3.9884045969708555
2024-04-09,0,197.25250244140625,187.55749893188477,199.76250076293945,191.30937576293945,198.1656198501587,-0.5697619684510639,3.9557843804490926,-1.1565640924110676,2.9955256450504915,196.19500160217285,3.4590122222900392,0.020288375721616153,189.14850006103515,198.860750579834,0.8119049912727535,0.056609288090019104,1.0116660810278861,0.9971652681093774,0.9964059363460742,-0.007671882934492058,65.23478202496425,202.88944351675755,194.97787475585938,187.0663059949612,198.09749930245536,1.0040429631227656,197.61107117789132,1.4687047999815357,197.7134436999898,196.17204497637766,0.08837959812858662,3.501851025702696,7358600,1.5646990323535563,0.8461122312349553,279084800.0,-51.705424258761965,95.95456447167889,96.5727530047212,32.507001623661786,26.223825963909416,22.351576916412274,0.218403546327861,2.7625086335562736,199.21012200927734,198.13994174194335,197.2750015258789,196.41006130981447,195.33988104248047,0.06,0.0,176.7835762218479,-0.0028161089471818723,-0.003217049696242087,196.25155421665735,195.75360761369978,3.6735113439363314
2024-04-10,0,195.56750106811523,188.54999923706055,199.76250076293945,192.7693748474121,198.1656198501587,-0.7139718931854722,3.594279485365934,-0.9199238456206831,2.9955624436620547,196.98125076293945,3.0570998382568346,0.018388576775885297,189.4107524871826,198.860750579834,0.8204352621268601,0.042478145402514114,1.0005365534040926,0.9878618342837528,0.9894186601175977,-0.015517224659363227,59.63783814938634,202.65118390206734,195.46262493133545,188.27406596060356,197.51999882289343,1.1421679184347633,197.63928549630302,1.4212840071126744,197.59354814644237,196.3402446722019,-1.2564912393201606,2.0962477527735373,7681400,1.5753731045318502,0.8733225286947288,271403400.0,-79.50577527013361,95.95456447167889,96.5727530047212,-6.713569255131659,24.21781484723478,22.522002359233188,0.1880503409361657,2.7773513731056845,199.3163212890625,198.31184057617187,197.5,196.68815942382813,195.6836787109375,0.08,0.0,176.96402104571928,-0.008521448454786085,-0.011313483129499868,195.9224809919085,195.77339717320032,3.3943977742579126
2024-04-11,0,195.31000137329102,188.54999923706055,199.76250076293945,194.68000030517578,198.1656198501587,-0.8750397373677222,3.296493368811809,-0.42383105684184086,2.99558980538772,196.98125076293945,2.6859743690490716,0.016837721727279407,190.6879997253418,198.860750579834,0.8266097542111994,0.02483919609923852,0.9975980794596198,0.9864079206471376,0.9912074937298355,-0.01112613218573566,51.086526302557026,202.37323671473544,195.78024997711182,189.1872632394882,197.02464185442244,1.2524918345033234,197.4589285169329,1.549006796736887,197.07643470193545,196.28166085478483,-2.0252007751703176,0.20238530352811487,10137700,1.615889092706521,1.1374424067189404,261265700.0,-71.55859674571542,95.95456447167889,96.5727530047212,-26.63125257372989,22.17006554613684,23.00446124880879,0.1759759215311448,2.8168804164763115,199.1228031616211,197.99860360717776,197.09000396728516,196.18140432739258,195.05720477294923,0.1,0.0,177.19075386651264,-0.0011244985966706311,-0.00872441791037342,195.5990208217076,195.59754289899553,3.2016322372902244
2024-04-12,0,185.6449966430664,188.54999923706055,199.76250076293945,195.2381238937378,198.1656198501587,-1.0670126047006823,3.098581326821302,0.2510910943739373,2.9956065956553264,196.98125076293945,2.439436759948731,0.015808735522435103,191.26625137329103,198.860750579834,0.7589227107214556,0.031026875227276873,0.9471472081722911,0.938870603053638,0.9442632958720515,-0.05625033039959826,51.42722436841511,202.20153772993652,196.00437507629394,189.80721242265136,195.1667845589774,4.322528622163765,196.56482151576452,3.498070733356462,196.6252322703324,196.1896841588832,-1.744412107323572,-1.2763149709943402,31506200,1.5743919933183228,3.159314433320498,229759500.0,-98.64130502387087,95.95456447167889,96.5727530047212,-279.7880364413488,16.392153250317815,38.64301686816963,0.043509647676678496,3.537302955794916,196.59760028076172,193.9111989440918,191.73999786376953,189.56879678344725,186.88239544677734,0.12000000000000001,0.0,177.47389727324835,-0.07424668826312619,-0.06572964462660397,193.55889456612724,194.69612775530135,3.8317621245822666
2024-04-15,1,184.26250076293945,185.6449966430664,199.76250076293945,195.2381238937378,198.1656198501587,-1.4432901632453816,3.5737520917034216,1.4730169537957218,2.995564225528969,196.98125076293945,2.647749595642091,0.01825065544458119,191.17800102233886,198.860750579834,0.41715617925515475,-0.015407067651810132,0.9410029925098585,0.9385800326871623,0.9479011335021986,-0.07020307799060432,28.40689300826969,202.962503954525,195.81499977111815,188.6674955877113,193.2746423993792,5.780262163708801,195.74928556169783,4.806464354711087,193.88785627060685,194.92506760417925,-6.546690771687437,-6.316784635695511,14766600,2.725155661272315,1.4990855705932904,214992900.0,-96.31802433751714,95.95456447167889,96.5727530047212,-260.3737027295623,14.70767179144614,35.33623350061668,-0.07351956226216391,3.6604985828753875,196.51736114501952,193.78132034301757,191.56999969482422,189.35867904663087,186.62263824462892,0.14,0.0,177.58960241835888,-0.07854695295404912,-0.07374019098630684,191.74608285086495,193.92893654959542,4.53346323479868
2024-04-16,1,181.62749862670898,184.26250076293945,199.76250076293945,195.2381238937378,198.1656198501587,-1.6470113163887352,4.093867051303234,1.9108035351220476,2.995510649062351,196.98125076293945,2.8914999389648415,0.020929723790488176,190.88750076293945,198.860750579834,0.5815164460675335,-0.03764297494026623,0.9285629775896496,0.9324475712871515,0.9479143467389753,-0.07921320957303779,23.946504698884997,203.7883589500186,195.60062484741212,187.41289074480565,191.1199994768415,6.974064617437468,194.7755355834961,6.115793631520909,191.49856535724484,193.72495423737703,-6.706072120536768,-5.834782868227691,16451800,2.637761500052033,1.6094021847323083,198541100.0,-94.5983621714058,95.95456447167889,96.5727530047212,-251.51597449063757,13.696236867526622,37.90223431832363,-0.1414188575229525,3.649737609360254,195.91556042480468,192.80721917724608,190.2949981689453,187.78277716064454,184.67443591308594,0.16,0.0,177.65772487438394,-0.08293170723241394,-0.08907694598275528,189.380619594029,192.94901711600167,5.4709602817778595
2024-04-17,1,180.76749801635742,181.62749862670898,199.76250076293945,195.2381238937378,198.1656198501587,-1.6240967700131033,5.04250637403395,1.3679843640157774,2.995393459903437,196.98125076293945,3.5696503448486396,0.025844626868278767,185.50674705505372,198.860750579834,0.6811995099127075,-0.059911237170877034,0.9264972990817731,0.9362759457089223,0.9590678089957513,-0.07567721104440073,19.41407442287142,205.19351246578032,195.1084997177124,185.02348696964447,188.6332141331264,7.140705765855553,193.5446423121861,7.0757150132685975,189.0366552483743,192.2396409841078,-7.667378642651935,-6.981716589168295,9017100,2.634009461716352,0.8797835933936469,189524000.0,-95.95214047627904,95.95456447167889,96.5727530047212,-196.62207626554584,12.824910693674763,36.38003682508133,-0.19488334801932697,3.6190109397095482,195.80936114501952,192.63532034301758,190.06999969482422,187.50467904663086,184.33063824462891,0.18,0.0,177.6874729352325,-0.07873330125520717,-0.0865837568544028,186.76653398786272,191.6502903529576,6.315969542373918
2024-04-18,1,181.42000198364258,180.76749801635742,199.76250076293945,195.2381238937378,198.1656198501587,-1.3900069752303894,5.928058030390135,0.3494640293948752,2.995260931703812,196.98125076293945,4.564450454711914,0.030480523948738618,183.9990005493164,198.860750579834,0.7692065609865772,-0.07380651756239336,0.9328142010240581,0.9484401500225371,0.977886794749557,-0.07111770668159911,16.6248259824512,206.34286570982812,194.48674964904785,182.63063358826759,186.37142835344588,6.427371769590679,192.2344638279506,7.520064701399855,186.97039683606317,190.8365221436199,-8.783902009890745,-8.703285589058508,9557700,2.5630076046536385,0.9316623061656575,199081700.0,-90.57036553002521,95.95456447167889,96.5727530047212,-144.2166990700995,13.827579023125956,33.93252947943118,-0.24464246043727675,3.6026375271661566,195.80936114501952,192.63532034301758,190.06999969482422,187.50467904663086,184.33063824462891,0.18,0.0,177.7286417317892,-0.07255791378931609,-0.07274777408940393,184.50762285505022,190.3795885358538,6.876035452972029
2024-04-19,1,183.87250137329102,180.76749801635742,199.76250076293945,192.8562479019165,198.1656198501587,-1.0985491012355735,6.5713412614169675,-0.5257181589084676,2.9951499769168657,196.98125076293945,5.527312755584717,0.033908002788912366,181.60674896240235,198.860750579834,0.8271290075136094,-0.08297317045413746,0.9487788019740517,0.9694145964692205,1.0061725642722255,-0.009547767523103823,16.630260223028156,206.94180724054635,193.7991247177124,180.65644219487845,184.70071411132812,5.000075454666287,191.11035646711076,7.508974243397516,185.58309719777267,189.7084044865823,-8.02651437208849,-9.182153161500585,13380200,2.4590069916553525,1.2905808298561476,212461900.0,-67.93000235035748,95.95456447167889,96.5727530047212,-93.80722627841547,17.483320923675453,30.877153635814143,-0.22099024953314006,3.6760852426482873,194.92311834716796,191.91843807983398,189.48999786376953,187.0615576477051,184.0568773803711,0.18,0.0,177.82676841536377,0.016467041239245805,-0.04927588822655527,183.13380650111608,189.52814374651228,6.94962444200376
2024-04-22,0,187.87750244140625,180.76749801635742,199.76250076293945,185.29937267303467,198.1656198501587,-0.8292337973105083,6.841609903674078,-1.0796421607545033,2.9950982168031963,196.19500160217285,6.101100158691406,0.03543021480790323,181.60674896240235,198.860750579834,0.8687389654380884,-0.0721125019681076,0.9729494026686168,0.9972795937664708,1.030086640080199,0.019618759451862866,26.752465267761558,206.7842196395015,193.10099983215332,179.41778002480515,183.6389285496303,2.5705970495910826,190.33178520202637,7.212067090297857,185.15259525590648,188.98546271630372,-5.980032280900755,-7.884125395962834,11529700,2.5570255041800154,1.0940265827859499,223991600.0,-50.14644119218269,95.95456447167889,96.5727530047212,-42.979732394267494,24.190610165071206,28.309849716112158,-0.1447844917616266,3.7228315909146046,194.84671368408203,191.85663430786133,189.43999481201172,187.0233553161621,184.0332759399414,0.02,1.0,177.961165183547,0.03564983728794813,0.036216461047943675,182.27854701450892,188.93878391810827,6.9387435371754735
2024-04-23,0,191.50500106811523,180.76749801635742,199.76250076293945,185.29937267303467,198.04375171661377,-0.6504571373745658,6.8283587462121735,-1.292673274557425,2.9950986461522944,195.62375259399414,6.263475170135502,0.03545601521583101,181.60674896240235,198.860750579834,0.9053117027717257,-0.039873781245870196,0.994383055158808,1.02212182458461,1.0458296273746608,0.05438329832261268,41.12463873068292,206.24346771367678,192.58675022125243,178.93003272882808,184.47607203892298,3.928378339448846,189.8214282989502,6.820321050734383,185.8309818157802,189.12634588161313,-3.80548813661581,-5.483516848141494,9144400,2.7304317948225756,0.8655375605951541,233136000.0,-36.816381147940994,95.95456447167889,96.5727530047212,-7.892444052020273,26.96100579614164,26.74991331017801,-0.07945578222439481,3.6582943121637017,194.84671368408203,191.85663430786133,189.43999481201172,187.0233553161621,184.0332759399414,0.04,0.0,178.09624090483078,0.06272115984780569,0.05057681191761979,183.60690089634485,188.58289773123605,6.928270718566513
2024-04-24,0,191.75249862670898,180.76749801635742,199.76250076293945,185.29937267303467,198.04375171661377,-0.5729961672139388,6.794336216159449,-1.336417816672335,2.995104177902398,195.43875122070312,6.204649963378904,0.035317636183630034,181.60674896240235,198.860750579834,0.9096113643811691,-0.019230755329796952,0.9967485812216973,1.0265919907171,1.036004385010338,0.06076867097733207,50.38156389881454,205.96667250098346,192.37800006866456,178.78932763634566,185.5460717337472,4.786777169734583,189.4103570665632,6.486707200653715,187.25839348608832,189.79299996064776,3.1565646966051384,-3.5967766047772916,6964900,2.8754340035112835,0.656127342344655,240100900.0,-29.828080185018514,95.95456447167889,96.5727530047212,-0.43965640295553,27.306967217448392,25.131653423967297,-0.05748197589431798,3.615528838533192,194.31191601562497,191.42403619384763,189.08999633789062,186.7559564819336,183.86807666015625,0.06,0.0,178.20130402175445,0.07219012108099632,0.06792032835424427,185.0545937674386,188.40033830915178,6.906624800905517
2024-04-25,0,192.68499755859375,180.76749801635742,199.76250076293945,185.29937267303467,198.04375171661377,-0.5071251594744273,6.762877726172523,-1.3635312997787454,2.9951093439829397,195.43875122070312,6.109362621307372,0.03518618813462917,181.60674896240235,198.860750579834,0.8993133619222271,-0.03155305589708548,1.0025097080461818,1.0336956152440724,1.0288302961429852,0.06209345966144819,49.40246414837278,205.72838053626836,192.20262508392335,178.67686963157834,187.12571443830217,5.092830962166942,189.12285695757186,6.222089201300369,188.39583262791726,190.43952338469734,4.06485195455243,-2.9138120696496723,9802300,2.7941267710208457,0.9187655063881398,249903200.0,-28.361986635830128,95.95456447167889,96.5727530047212,10.39056466798099,27.219154641052455,23.736819081329017,-0.06908965644877724,3.5543805133569175,194.31191601562497,191.42403619384763,189.08999633789062,186.7559564819336,183.86807666015625,0.08,0.0,178.35350773782318,0.06686894197322402,0.07380045598890794,186.84041050502233,188.11051504952567,6.7509411431914215
2024-04-26,0,193.74750137329102,180.76749801635742,199.76250076293945,185.29937267303467,197.67437076568604,-0.45060072905392456,6.633026915610918,-1.342596970945712,2.9951318323954967,193.99749946594238,5.8701873397827145,0.034558377193130305,181.60674896240235,198.860750579834,0.880700347344099,-0.03542958852294636,1.0094334483893832,1.0408613967065616,1.0222065762624697,0.0537056924023247,50.6462385049707,205.20292860234,191.93687477111817,178.67082093989634,188.98000063214982,4.742960896220901,188.8066073826381,5.826550994906836,189.4702386815798,191.00878480993026,6.088009258229536,-2.0461601060505625,6413700,2.7674500092747403,0.6074580470645732,256316900.0,-27.388197238377245,95.95456447167889,96.5727530047212,26.007714834197618,28.130501403011174,22.841499199205202,-0.11087169620035767,3.429706341844126,194.2355230102539,191.36224185180663,189.04000091552734,186.71775997924806,183.8444788208008,0.1,0.0,178.4579968685258,0.04138861681116346,0.0675310970348373,188.74556841169084,187.75605119977678,6.5383558383142635
2024-04-29,0,193.36249542236328,180.76749801635742,199.61000442504883,185.29937267303467,197.31625080108643,-0.4498644476695717,6.403787382909161,-1.3011590637482513,2.995170968425403,193.21624946594238,5.611149749755862,0.0334163894700844,181.60674896240235,198.66274795532226,0.8675277399379586,-0.029369785691072976,1.0090085865726752,1.0342909078571287,1.0096546468352245,0.02919451722362365,53.367538215833704,204.44369956745405,191.63612480163573,178.82855003581741,190.68607112339564,3.574260150753925,188.52874973842077,5.474944037309597,190.53818405508716,191.50380191588948,7.180496217167895,-2.2341335442627894,5387800,2.7857716515535347,0.5149777293494676,250929100.0,-21.208765217153704,95.95456447167889,96.5727530047212,24.882298879818272,27.020785284417286,23.2985127319006,-0.0896946266931468,3.315377538718728,192.85268487548828,190.2436633605957,188.13500213623047,186.02634091186525,183.41731939697266,0.1,0.0,178.54195667566975,0.02043189140016377,0.04025834616142746,190.45467049734933,187.48114667619978,6.383067602128993
2024-04-30,0,192.79500198364258,180.76749801635742,198.7775001525879,185.29937267303467,196.84562492370605,-0.4619501241425696,6.154737556324509,-1.2588444203289648,2.99521212257135,193.02374649047852,5.379374561309811,0.03216922926289186,181.60674896240235,198.2224956512451,0.8624442161129378,-0.02724153752848225,1.0076898588760046,1.0262600148450163,1.0009579081876026,0.0067361212936079,52.850494550295885,203.63322446415052,191.32374935150148,179.01427423885244,191.96071406773157,1.970696490099808,188.33071408952986,5.2461193938954445,191.2455685245473,191.74773807577515,6.582787624375331,-1.9720951424677076,8153700,2.7831327521492333,0.7751291691819205,242775400.0,-27.80655697094315,95.95456447167889,96.5727530047212,22.986495264123075,25.071008135471224,23.318957625121996,-0.12290568101436054,3.317852297946316,192.47068487548827,189.9346633605957,187.88500213623047,185.83534091186525,183.29931939697266,0.12000000000000001,0.0,178.6627099886539,-0.0020817400596692126,0.012301403752358286,191.29856654575892,187.2161865234375,6.198955980530212
2024-05-01,0,192.34500122070312,180.76749801635742,198.64999771118164,185.29937267303467,195.8531255722046,-0.46460662979698003,5.926350296896235,-1.2085489385460093,2.9952485759787275,192.73999977111816,5.16998712539673,0.031024012292524737,181.60674896240235,197.5742458343506,0.8503056613038357,-0.029473927988922878,1.0069120762912038,1.0178142023364232,0.9972857269333755,0.003089934150728224,51.268670679989555,202.87732503684666,191.0246244430542,179.17192384926173,192.5989281790597,0.8088785038396792,188.118928364345,4.996607299033563,191.63428443626032,191.74010897654225,4.852547577104767,-1.4176686153529199,7445300,2.783556397959322,0.7142634437047337,235330100.0,-19.82269277377398,95.95456447167889,96.5727530047212,22.473430328649876,23.104105312750292,23.30655313266656,-0.12299927705623706,3.343018848680101,191.26356347656252,188.95822222900392,187.09500122070312,185.23178021240236,182.92643896484375,0.12000000000000001,0.0,178.76797277028663,-0.006318598228443495,-0.001457194085267883,191.64663914271765,186.96259307861328,6.028148596725551
2024-05-02,1,191.93750381469727,180.76749801635742,198.17499542236328,185.29937267303467,195.37437629699707,-0.4830577100662581,5.674689353391411,-1.1577328992337286,2.9952873294933706,192.51499938964844,4.949312248229984,0.02975569168921196,181.60674896240235,197.27800178527832,0.8472097146676878,-0.026138221419996617,1.0064397945755084,1.0094734881256489,0.9945618321458086,-0.0038793562206065335,50.74856869973376,202.05875332531306,190.70937461853026,179.35999591174746,192.66071428571428,0.7233935776057913,188.56839316231864,5.039780355055629,191.83541333502478,191.53820898855403,2.3778785225709305,-1.5180994991244516,6501700,2.7769188490980317,0.6320528374668503,228828400.0,-21.08929720703463,95.95456447167889,96.5727530047212,15.838676127436141,21.16488703202138,24.028615957027927,-0.07950108282053102,3.3885376608553948,191.26356347656252,188.95822222900392,187.09500122070312,185.23178021240236,182.92643896484375,0.12000000000000001,0.0,178.85318555099929,-0.00884307072472923,-0.007354440517223432,191.57844761439733,187.5926742553711,5.9177737295910084
2024-05-03,1,190.875,180.76749801635742,198.17499542236328,185.29937267303467,194.13812637329102,-0.48280765530826936,5.467104321322824,-1.094950689476139,2.9953181529399426,192.1412525177002,4.7543625259399445,0.028709127765572457,181.60674896240235,196.764249420166,0.8417955440405998,-0.024261579441754513,1.0023322110172819,0.9983628654126729,0.9898230336154792,-0.014826004737767406,50.06720951331822,201.3650836579044,190.43087501525878,179.49666637261316,192.53535733904158,0.9481305190668259,189.0407145363944,4.913470646925209,191.8807478213652,191.30814953247128,0.22584410024268609,3.3895377119854504,8922800,2.774396748212674,0.857447894194151,219905600.0,-28.37244181079916,95.95456447167889,96.5727530047212,5.796682498041736,19.37405931989357,24.199162291589662,-0.09568191657923865,3.4372333036408844,191.26356347656252,188.95822222900392,187.09500122070312,185.23178021240236,182.92643896484375,0.12000000000000001,0.0,178.95869573859423,-0.01540138504778965,-0.014790291284630427,191.21332659040178,188.1339601789202,5.682818349736174
2024-05-06,1,191.4375,180.76749801635742,198.17499542236328,185.29937267303467,193.45874691009521,-0.4551927809178926,5.276609140415057,-1.0238748192080271,2.9953454856336896,191.84500122070312,4.550137557983402,0.02775130651685313,181.60674896240235,195.73600120544432,0.8100514704008055,-0.03683610743527488,1.0068285521906555,0.9976509747202982,0.9957063996391153,-0.009955371222110543,45.44941306742968,200.69234334186527,190.13912506103514,179.58590678020502,192.3571434020996,1.0291004143953941,189.7414289202009,4.452858379686308,191.64729851266443,190.94354889005575,-0.45762043936503816,3.588629921813431,7911100,2.7494019449542884,0.7605558111218945,227816700.0,-18.936060006919263,95.95456447167889,96.5727530047212,24.522053204178302,18.39394031820558,22.974944981458666,-0.07426721199583378,3.3616866133735637,191.26356347656252,188.95822222900392,187.09500122070312,185.23178021240236,182.92643896484375,0.12000000000000001,0.0,179.0573498268665,-0.006622530750781341,-0.0077006925238948185,191.01869201660156,188.92955126081193,5.354729448955114
2024-05-07,1,192.00749588012695,180.76749801635742,197.25250244140625,185.29937267303467,192.93687534332275,-0.5564235777115338,4.958290800285803,-0.989083096729451,2.995389323520109,191.6287498474121,4.314325218200682,0.02612345634844776,181.60674896240235,195.33575134277345,0.7924767339826753,-0.02947999325450177,1.0116186482870542,0.9987684717407515,1.0006748792220628,-0.004084681114204569,48.247412559696315,199.71883189048862,189.802250289917,179.88566868934538,192.10857118879045,0.8277406057468021,190.54428591047014,3.6515837816616226,191.59725644614247,190.61410327860006,-0.6474284840024441,5.401165268180607,7688800,2.7540922544180026,0.738012976273835,235505500.0,-21.571268785220056,95.95456447167889,96.5727530047212,41.827571104942045,19.493803963932,22.32092715034082,-0.10982070528687547,3.2129410846788367,191.4452844848633,189.252363861084,187.4800033569336,185.7076428527832,183.51472222900392,0.12000000000000001,0.0,179.1576539120693,5.209405289186009e-05,-0.00791601363404295,190.771488734654,189.75852857317244,5.092399834802637
2024-05-08,1,193.5749969482422,180.76749801635742,195.56750106811523,185.29937267303467,192.71249866485596,-0.6854613115814818,4.688679448975765,-0.9735481738228611,2.9954245164964277,191.6287498474121,4.130749988555908,0.02473715020533614,181.60674896240235,193.90375137329102,0.788707086250722,-0.01820346002554048,1.0212883665041745,1.0066590430978157,1.0096729184587228,0.006394737163601727,51.84044259784906,198.9173588598046,189.53999996185303,180.16264106390145,192.1389285496303,0.8834170967852439,191.41249983651298,2.612431078314813,191.6889240090818,190.42473664741496,-0.8980789330602074,6.217930760292117,9227600,2.740666346850121,0.8791912385767118,244733100.0,-6.561683994681424,95.95456447167889,96.5727530047212,80.88256885787825,25.017909589970934,19.660492430843597,-0.07668791763401966,3.3870744873041367,193.05335620117188,190.82831762695312,189.02999877929688,187.23167993164063,185.00664135742187,0.14,0.0,179.29724694680843,0.019753929181525853,0.02039214098395183,191.10819353376115,190.78143201555525,5.103638951670375
2024-05-09,0,196.3400001525879,180.76749801635742,195.31000137329102,185.29937267303467,192.71249866485596,-0.7502247531239625,4.579444436641553,-0.9612175759895343,2.9954382680809193,191.6287498474121,4.06101234436035,0.024173539788143343,181.60674896240235,193.59224739074708,0.7647748517916508,-0.008883336300493688,1.0364210924182364,1.0200712592251264,1.0227826252980106,0.022937134485925936,57.360343961798,198.59926362914248,189.44037475585938,180.28148588257628,192.64535685947962,1.830566279989052,192.3030354636056,1.861518827816833,192.13559256153053,190.51980836487496,0.10989800551277404,6.699919982194435,7977300,2.768365866034504,0.7679685315139733,252710400.0,-0.775162214982242,95.95456447167889,96.5727530047212,115.21272832130349,25.699650595816195,18.607872825570933,-0.0572488224198504,3.322977147243226,194.85003619384767,193.15497610473633,191.78499603271484,190.41501596069335,188.71995587158202,0.16,0.0,179.43388731382746,0.03047060965235815,0.029396417227180654,191.92651585170202,191.61254119873047,5.248612822183846
2024-05-10,0,198.72999954223633,180.76749801635742,196.3400001525879,185.29937267303467,192.71249866485596,-0.6868691685617777,4.650405875182278,-0.937769489920623,2.995429376553224,191.6287498474121,4.097062301635742,0.024541452675328347,181.60674896240235,193.59224739074708,0.8593148890439096,0.057609974429229674,1.0487520895673763,1.030531431117684,1.030506053964384,0.04115258437320923,75.9337922747874,198.7926864451888,189.49187469482422,180.19106294445965,193.5574994768415,2.9215997734923853,193.0782138279506,2.118711224521356,193.14260138960327,190.9792804365202,1.8387396625800927,6.780512956630655,7529800,1.6856099727185212,0.8194616983985247,260240200.0,-5.238902656406229,95.95456447167889,96.5727530047212,138.90787919260544,28.536117199022748,17.847446488625927,0.09062687989295777,3.217019410198548,196.77231878662113,195.1838403015137,193.9000015258789,192.61616275024414,191.0276842651367,0.18,0.0,179.5760652556399,0.04335735896425241,0.03709692113318812,192.90821838378906,192.27742876325334,5.378234619194034
2024-05-13,0,198.85499954223633,180.76749801635742,198.72999954223633,186.97375202178955,192.93687534332275,-0.6150817465758989,4.972469763539592,-0.6250252561057104,2.995388414644954,191.84500122070312,4.104924583435059,0.026150781498857256,181.60674896240235,194.00675125122072,0.825983750987256,0.07851569754776014,1.0458009581304468,1.0285222188839815,1.0228219664420206,0.038746324739073135,81.5834915799652,200.09106436686187,190.14612483978271,180.20118531270356,194.54571315220423,3.411197945470689,193.60321371895927,2.5629563862417335,194.51262007625593,191.98742067995641,3.3195551124340588,5.776368623068464,7049200,1.6668448932397062,0.800786563889288,267289400.0,-9.833278630326033,95.95456447167889,96.5727530047212,134.53926301081935,28.52122098039448,17.106852951134464,0.1469562796822488,3.11649203728867,197.16196624755858,195.4990263366699,194.1550064086914,192.81098648071287,191.1480465698242,0.19999999999999998,0.0,179.70783500852582,0.035052099028790584,0.04314739577183903,193.91265215192522,192.74554988316126,5.387807842969191
2024-05-14,0,200.0625,180.76749801635742,198.85499954223633,190.12562561035156,193.415620803833,-0.6710147638427597,5.123912207779068,-0.30313150300545466,2.995369685105909,191.9724998474121,3.8814496231079145,0.026844228319828054,181.60674896240235,196.57900009155273,0.8037703490518484,0.09485073045538259,1.0481294781128625,1.0318363920447957,1.0212402744267939,0.041951508627048106,85.7560533444268,201.1235741943057,190.87574977874755,180.6279253631894,195.85821315220423,3.528924219157777,194.19678524562292,3.0224587977994735,195.5804182111117,192.97292121546036,3.604035475118734,3.838019076852629,8596200,1.4735802354811822,1.0221324092025448,275885600.0,-0.5335926087889102,95.95456447167889,96.5727530047212,159.53165245810771,30.239138695857957,15.77487039875654,0.23655168660654763,3.1381764351299597,198.48368298339844,196.56816369628905,195.02000427246094,193.47184484863283,191.55632556152344,0.2,0.0,179.87885261903784,0.05089963983359902,0.04953125697992107,195.47542245047433,193.34437452043807,5.285544896291694
2024-05-15,0,201.64500045776367,180.76749801635742,200.0625,191.296875,193.6181230545044,-0.6490284167158142,5.034696081867228,0.15123768201083942,2.9953856569463784,192.17624855041504,3.4872495269775414,0.02625006105852615,183.62725143432618,198.74249954223632,0.755833094310223,0.1067393319892971,1.051343216768654,1.036114619049006,1.020922732670924,0.04168928651296433,88.42331869362043,201.86689201114655,191.7974998474121,181.72810768367765,197.31642750331335,3.506644068921188,194.83678545270647,3.575712382190047,196.69606631071355,194.07970878742992,4.81335952848723,4.33371217209971,8370000,1.414242679309141,0.99907970077742,284255600.0,-4.075910085708741,95.95456447167889,96.5727530047212,167.20818584084074,30.75855825649789,14.720954914291326,0.29197533340318643,3.122588676474844,199.33172344970703,197.25414407348632,195.57500457763672,193.89586508178712,191.8182857055664,0.2,0.0,180.05150527090558,0.0330181772896454,0.054028720971981026,196.91174970354353,193.96522086007255,4.918105125720546
2024-05-16,0,202.79000091552734,181.42000198364258,201.64500045776367,191.48812580108643,194.39562606811523,-0.37316464579020425,4.798344064381184,0.34894032276528586,2.9954216414204775,192.51499938964844,3.3586493682861316,0.024882336921423283,187.47700233459472,198.9757495880127,0.7094064360910267,0.11148163517242518,1.0515896858110418,1.037042346936936,1.0183978575311945,0.03285118039078516,89.62643837236398,202.43806309824478,192.84137496948242,183.24468684072005,198.8567853655134,3.134369959825532,195.48267827715193,4.136525468265478,197.9380237290269,195.30059360142633,5.3320276632131485,4.650078113344173,8497900,1.416922504891801,1.0208031020863164,292753500.0,-12.546790794428956,95.95456447167889,96.5727530047212,168.2021279876204,33.13609835184403,13.869982195912792,0.27652682201277795,3.077393389814212,200.6992783203125,198.36035992431638,196.47000122070312,194.57964251708984,192.24072412109373,0.2,0.0,180.2357031907471,0.02516455245810012,0.03485820173860862,198.4347403390067,194.60311453683036,4.458445130420929
2024-05-17,0,204.11499786376953,183.87250137329102,202.79000091552734,191.69062423706055,196.9375,0.17680914733664524,4.506526765807849,-0.0791504011390729,2.9954625161224433,192.73999977111816,3.4963251113891602,0.023240315985755003,190.57525024414062,200.22075004577636,0.7112376602624244,0.10288378849989502,1.0526281756001834,1.0380571730906523,1.018454058276276,0.027097057987909512,90.05290888685121,202.92292844769236,193.90987491607666,184.89682138446096,200.3624997820173,2.6716701622102006,196.2507141658238,4.675668744309326,199.1655205712987,196.49585301068942,5.615668797707806,4.66715672622495,9260500,1.3790845706495853,1.1406333622171434,302014000.0,-1.567268372634611,95.95456447167889,96.5727530047212,159.98320666638296,32.46695543604712,13.02952556021611,0.24788084028918816,3.0418583513511135,201.13476391601563,198.7126244506836,196.7550048828125,194.7973853149414,192.37524584960937,0.2,0.0,180.44382283846275,0.030286209590000057,0.03691133530945185,199.73325892857142,195.4207262311663,4.563354465410704
2024-05-20,0,200.3125,187.87750244140625,204.11499786376953,191.8912525177002,198.76124954223633,0.696663091487828,4.410688173916933,-0.6831430592766208,2.995477556610758,193.07874870300293,3.8083500289917027,0.02262796492846684,191.38125,201.75950050354004,0.7753403169321812,0.08642597017398239,1.0276546529718196,1.011905442908861,0.9941387699489544,0.007329463484040399,90.3242820106653,203.74337608843445,194.9219997406006,186.10062339276675,200.92999976021903,2.016371818659111,196.78767830984933,4.679940394703561,200.42064631656308,197.6107003442527,5.444918549240899,5.560800411641084,17373300,1.187875288954541,2.0655659937117425,284640700.0,-59.12746345817453,95.95456447167889,96.5727530047212,59.48658718798881,25.66409243833087,25.114601263620973,0.0947819616074615,3.573253141577954,201.7688853149414,199.22556558227538,197.17000579833984,195.1144460144043,192.5711262817383,0.02,1.0,180.74035738290283,-0.015850666296073235,-0.01604871458139052,199.46048409598214,195.69349997384208,4.3507645605522365
2024-05-21,0,198.25500106811523,190.875,204.11499786376953,191.98999786376953,199.15687465667725,0.6682684218106273,4.247260858392918,-1.0744296090826935,2.995497494920232,193.46874618530273,3.850000152587893,0.021720258850914637,191.4982509613037,201.75950050354004,0.8876902054414726,0.04599096045931501,1.0138651910627372,0.9970416493156955,0.9825061388013667,-0.009034671324634869,66.323141039273,204.03827133531613,195.54374961853028,187.04922790174444,200.8621428353446,2.1086297673431984,197.20982115609306,4.51190510227646,200.4064895557272,197.93629843260493,2.0232758705942935,3.899218309090416,14420800,1.4124271081568534,1.6623908396048985,270219900.0,-36.50976623918094,95.95456447167889,96.5727530047212,48.46220957155299,23.480077610392915,22.977348146671677,0.10871755146710066,3.6266007879554127,201.7688853149414,199.22556558227538,197.17000579833984,195.1144460144043,192.5711262817383,0.02,0.0,180.97570109038824,-0.009875442631473885,0.003975232006917744,199.56703622000558,196.23762730189733,4.354823890798347
2024-05-22,0,198.98500061035156,190.875,204.11499786376953,192.26062488555908,199.15687465667725,0.5167587563598213,4.180584681322266,-1.1893419024006109,2.9955053300124357,193.6612491607666,3.8173752975463855,0.021342444411926932,191.7209987640381,201.75950050354004,0.9015291708732549,0.033910913745457315,1.0158450642818837,0.9975785637819296,0.9878936695572031,-0.013191499126551709,57.45471165595774,204.2424189811748,195.88124961853026,187.52008025588572,200.8807144165039,2.0884819599711673,197.71321378435408,4.264802398589039,199.8740137109857,197.87487174674376,-0.23901699552922392,3.072603816010158,9425300,1.520620463217766,1.0713301291068005,279645200.0,-43.455844546033454,95.95456447167889,96.5727530047212,48.30322585948451,24.029628194626504,21.49531288120536,0.0383655330842418,3.599696445894222,201.7688853149414,199.22556558227538,197.17000579833984,195.1144460144043,192.5711262817383,0.02,0.0,181.1288179515698,-0.01880168299222995,-0.015880139363908415,199.50736563546317,196.7100088936942,4.329478701342338
2024-05-23,0,197.2750015258789,190.875,204.11499786376953,192.5999984741211,199.25437545776367,0.34752589100164094,4.12017594753989,-1.283399438660903,2.9955123810209585,195.04375076293945,3.766125297546387,0.020995289400782574,191.88750343322755,201.75950050354004,0.9028031998424668,0.03269586699318425,1.0052594358376128,0.9863306226761231,0.9819977521994426,-0.027195617953301943,58.87792872744375,204.48322661279218,196.2428747177124,188.0025228226326,200.48250034877233,2.496404444223018,198.17035675048828,3.7922609455542027,199.6593882191852,197.90946444421743,0.06537480496567674,3.6717664112471633,8069400,1.5171517234663943,0.9263343018283549,271575800.0,-55.79083484401068,95.95456447167889,96.5727530047212,11.531150884106136,22.93177624803296,23.81743190996691,-0.005285026464939804,3.5025602053897478,202.08984545898437,199.7450858154297,197.85000610351562,195.95492639160156,193.61016674804688,0.02,0.0,181.24423997319437,-0.027411508103165616,-0.02567912173938855,198.85526384626115,197.16534314836775,4.279087689544714
2024-05-24,0,199.19499969482422,190.875,204.11499786376953,192.68250179290771,199.25437545776367,0.23231282747622517,4.042711873368529,-1.2498806349363316,2.9955208889699207,196.8075008392334,3.6301252365112306,0.02057649007956145,191.88750343322755,201.75950050354004,0.9148186600750368,0.018206687196401557,1.0138575450106435,0.9954648219933702,0.9970293559530993,-0.02410405026792306,51.63762985728863,204.55779866281372,196.47237491607666,188.3869511693396,200.13250023978097,2.477934684075708,198.72446387154716,3.2625639675137683,199.06557819197144,197.67524433540044,-1.3933138264897689,3.3529804981683857,7355400,1.5721668137160485,0.8398305815296416,278931200.0,-34.74459994913739,95.95456447167889,96.5727530047212,54.26506691602659,26.131133475980622,21.964783450295943,0.0546406936453097,3.5266660972980617,202.36832373046875,200.1958430175781,198.44000244140625,196.6841618652344,194.51168115234375,0.02,0.0,181.36489284050995,-0.01992281653346606,-0.00869266443335586,198.65636553083147,197.7840576171875,4.32382195670588
2024-05-28,0,199.60750198364258,190.875,204.11499786376953,192.68250179290771,199.41187477111816,0.06181625225104362,4.033449973564934,-1.2778638837102865,2.995522193060594,197.76500129699707,3.602775306701659,0.02050092811628237,191.88750343322755,201.75950050354004,0.8945846572614765,0.030163575721966925,1.0145505898070037,0.997294524660378,1.0040391510326303,-0.003519490877291309,57.70374785931887,204.8116497792832,196.74474983215333,188.67784988502348,199.677857535226,2.1835512052996005,199.2673214503697,2.6298959286926773,199.0941048391087,197.70221764197575,-1.2150069465533946,4.052236210159566,6910200,1.611881972031981,0.7821998649584037,285841400.0,-42.87636283091463,95.95456447167889,96.5727530047212,46.88801140608064,25.01255976680014,21.024555223383118,0.05477136051803802,3.4211767111437097,202.36832373046875,200.1958430175781,198.44000244140625,196.6841618652344,194.51168115234375,0.02,0.0,181.47587560928258,0.020042913966761722,-0.025831339837938547,198.23441641671317,198.33457837785994,4.283648979453815
2024-05-29,0,197.99750137329102,190.875,204.11499786376953,192.68250179290771,199.72125148773193,-0.12275445726104608,4.001125300623628,-1.232221545954609,2.995525942806003,198.49250030517578,3.5143501281738283,0.020304405818471365,191.88750343322755,201.75950050354004,0.881826920842182,0.035335459580938706,1.0047727368848052,0.9888787245595153,0.9966475995842334,-0.0012988307656145448,59.37507912300565,205.05925076146454,197.05700016021729,189.05474955897003,198.80392946515764,1.0325135859624455,199.58321462358748,2.1072298545545496,199.214465767096,197.79398364113112,-1.5693569295906473,3.9581819806974714,6120000,1.598700171230484,0.7008197988463957,279721400.0,-72.07796987308856,95.95456447167889,96.5727530047212,13.500445352593825,23.62591329875836,23.61859296858999,0.10498026220374282,3.363228698194928,203.33592517089843,201.76204534912108,200.49000549316406,199.21796563720702,197.64408581542966,0.02,0.0,181.56482114322387,-0.007066995147838151,0.012935852084495072,197.28538949148995,198.50932421003068,4.100643053983921
2024-05-30,0,199.0349998474121,190.875,204.11499786376953,193.26749801635742,199.72125148773193,-0.268752640860831,3.882954335976106,-1.0343313882332927,2.995538280961323,198.49250030517578,3.2744501495361304,0.019678749796419228,191.88750343322755,201.75950050354004,0.8697081167713119,0.029387299470819216,1.0087061612953423,0.995086682560896,1.0021297746742623,0.00025127138682412564,53.68226595500705,205.08303380165194,197.31712512969972,189.5512164577475,198.62142944335938,0.8104495139990684,199.7757146017892,1.901188727985445,198.89730452790047,197.81916698234795,-2.9970832885888457,2.2846465167354806,6829700,1.6497467868367162,0.7848560938191305,286551100.0,-62.499963600255256,95.95456447167889,96.5727530047212,33.68598335136896,24.613462832079676,22.714515227539415,0.13428247075514857,3.2472714314438287,203.40672229003906,201.87664068603516,200.63999938964844,199.40335809326174,197.87327648925785,0.02,0.0,181.67010399137865,0.005143512183452437,-0.0009522683103439578,197.81815229143416,198.63931819370814,3.907416433811895
2024-05-31,0,200.89500427246094,190.875,204.11499786376953,195.64874935150146,199.72125148773193,-0.45068022593014206,3.725170873957223,-0.7225359133572562,2.9955541389286444,198.79249954223633,3.011387710571287,0.018847155305740004,191.88750343322755,201.75950050354004,0.839898477848402,0.03697816159767816,1.0164095752333138,1.0056981993419365,1.0114438651172744,0.018350032789669735,57.135745598457234,205.1019668089496,197.65162506103516,190.2012833131207,198.9985727582659,1.1532695318049686,199.93035779680525,1.8976347152915525,198.91725975509374,198.07725795575377,-0.6377535863153276,1.372618769853198,14417900,1.6488002927634897,1.5847921333617656,300969000.0,-31.01141787198364,95.95456447167889,96.5727530047212,80.37775619012355,29.34551715768731,20.33035365598308,0.18353574296889652,3.3689071037483935,203.40672229003906,201.87664068603516,200.63999938964844,199.40335809326174,197.87327648925785,0.02,0.0,181.91609119466372,0.028996590602648364,0.02178412305125051,198.25999014718192,198.91351318359375,3.773488198770021
2024-06-03,0,201.43500137329102,190.875,204.11499786376953,197.04125118255615,200.125,-0.6561651346909853,3.545380425090525,-0.291019743113059,2.9955714724848974,198.92000007629395,2.718900470733641,0.017896968056903485,191.95049629211425,201.75950050354004,0.7680089176804191,0.052495110792198756,1.0168375048294145,1.0093590032513091,1.0104792668221791,0.011245270623753578,63.06173873856148,205.19026093410437,198.09950008392335,191.00873923374232,199.34857286725725,1.475278693264144,200.11464364188058,1.910403234996246,199.40370961070505,198.5659731929129,1.3316199793813357,1.0894201857855277,6444300,1.643969178883516,0.7181290733457139,307413300.0,-38.740394107318195,95.95456447167889,96.5727530047212,72.12272785441883,27.20819291266447,18.84963148825537,0.20827084767940346,3.373985823732975,203.40672229003906,201.87664068603516,200.63999938964844,199.40335809326174,197.87327648925785,0.02,0.0,182.02250099291376,0.005530436473712097,0.024883294545143445,198.75865827287947,199.1330119541713,3.3717805717307123
2024-06-04,0,199.89500045776367,191.4375,204.11499786376953,197.816876411438,200.45812606811523,-0.7600412416777568,3.199616641965652,0.1808168708133886,2.9956019820140334,199.01000022888184,2.3505004119873063,0.01610862866172947,193.41824684143066,201.75950050354004,0.7162707666367906,0.052223317653495346,1.0063812931452194,1.0029892198757637,1.0005055141137842,0.0014403189823228857,64.03819894961836,205.0267334365192,198.62750015258788,192.22826686865656,199.72285842895508,1.1602399585723966,200.1026793888637,1.9112792116946686,199.90994801995663,199.16698504098284,1.2312489662157982,1.2974286977917804,6848300,1.6439515483878602,0.7676954283879046,300565000.0,-64.12208183245096,95.95456447167889,96.5727530047212,24.305260127017373,25.09138892314882,19.296600286060478,0.15249610897507418,3.397274383186674,203.40672229003906,201.87664068603516,200.63999938964844,199.40335809326174,197.87327648925785,0.02,0.0,182.12648303637664,-0.0017042259327214593,-0.007722582390087447,199.07689557756697,198.96607971191406,2.961681216246382
2024-06-05,0,198.43999862670898,192.00749588012695,204.11499786376953,198.19062614440918,200.45812606811523,-0.7642810488009685,2.7484988833963926,0.8302996297603933,2.99563659523397,199.11499977111816,1.9448755264282227,0.013808056784486888,196.06349983215333,201.75950050354004,0.6393692639802866,0.04107914923572047,0.996933557406114,0.995897255616547,0.9929372417630644,0.0022348628156863004,57.36747015458332,204.54737294226885,199.05037517547606,193.55337740868328,199.61500113351005,1.249173234888041,199.8737506866455,1.9042641028291338,199.906484754284,199.44096548967576,1.3280947467340758,-0.08372360749082318,8351600,1.707288380233201,0.9327504108620592,292213400.0,-82.25192117853688,95.95456447167889,96.5727530047212,-59.55262230618198,23.545188441363134,20.9973774716665,0.15245676806849776,3.3617525340403924,203.40672229003906,201.87664068603516,200.63999938964844,199.40335809326174,197.87327648925785,0.02,0.0,182.23886568056955,-0.004290574405982683,-0.011228094786309957,198.58675275530135,198.6215591430664,2.444261473446099
2024-06-06,0,196.88000106811523,193.5749969482422,204.11499786376953,198.39374923706055,200.45812606811523,-0.29254310365464614,2.233679458022262,0.8828662978173312,2.9956694397946437,199.11499977111816,1.6409504508972161,0.011203576502807441,197.1815013885498,201.75950050354004,0.5350570531747201,0.025132386698513517,0.9875007561704747,0.9879764753572656,0.984695409455835,-0.010827235315140404,50.92658615634989,203.8393592288497,199.37200031280517,194.90464139676064,199.22535814557756,1.6217285088607176,199.45160784040178,1.8626705451565382,199.54394862863577,199.4876486684426,-0.37902611474782516,-1.5894278676777822,7640300,1.733121106096487,0.8609399878526588,284573100.0,-85.0236836586374,95.95456447167889,96.5727530047212,-124.69204486853745,22.17985776694722,23.207301551984155,0.12775490076179896,3.313766741448839,203.39020416259766,201.849903717041,200.6050033569336,199.36010299682619,197.81980255126953,0.04,0.0,182.33226940885328,-0.012140658694411388,-0.006057176730942915,198.21879359654017,198.22660500662667,2.3548687276451945
2024-06-07,0,198.82749557495117,196.3400001525879,204.11499786376953,198.39374923706055,200.45812606811523,0.5759094144717767,1.8953250122205196,0.017520084496593924,2.995687242056482,199.11499977111816,1.4922252655029298,0.009498602427830672,197.23550148010253,201.75950050354004,0.5101415374571662,0.002750335719199734,0.9964429952702952,0.9988043862639916,0.9965840860274199,-0.010291488855072473,43.55216319036398,203.32790054323988,199.53725051879883,195.74660049435778,199.34392874581474,1.5455457288544325,199.0739291054862,1.2934560951739917,198.8825032077883,199.34556823668856,-1.3664320671428756,-2.9143448003996677,6964500,1.6715760881975614,0.7892920567605763,291537600.0,-56.20858975564249,95.95456447167889,96.5727530047212,-17.922906071357772,26.449908289483666,21.23088050637601,0.10643573170228819,3.363500802263487,203.39020416259766,201.849903717041,200.6050033569336,199.36010299682619,197.81980255126953,0.04,0.0,182.43118287134408,-0.013226105378445152,0.0031103880634007234,198.4802028111049,197.88279615129744,2.30460375653776
2024-06-10,0,199.53250122070312,196.88000106811523,204.11499786376953,198.6574993133545,200.45812606811523,0.8064407894108623,1.7580827418133733,0.27209405854981394,2.995693596936947,199.11499977111816,1.3857003021240246,0.008805311182159135,197.9252513885498,201.75950050354004,0.5733474143397316,0.0004905954457777916,0.9993532854947645,1.0015648510147084,1.0021949356053241,-0.009444734726425486,48.500745152429694,203.17779077354373,199.661625289917,196.14545980629026,199.4150003705706,1.540402213870367,199.01821490696497,1.2521411271263947,198.88253051089694,199.38903862053613,0.4191942806870788,-2.5904526096349594,6071200,1.6413192809430033,0.693787996526032,297608800.0,-46.29864336558674,95.95456447167889,96.5727530047212,-3.8270853951285018,25.073579466776827,20.12612534229145,0.10926989830375146,3.294674374886907,201.41908276367187,200.2554625854492,199.31500244140625,198.3745422973633,197.21092211914063,0.04,0.0,182.51817567090777,-0.010950393698572536,-0.014904006260003686,198.51998247419084,198.1690673828125,2.294421421392247
2024-06-11,0,195.9525032043457,196.88000106811523,204.11499786376953,198.73062133789062,200.45812606811523,0.762648503383534,1.7454747862050637,0.2903091532839932,2.995694159473336,199.36375045776367,1.3536002349853504,0.008740408048189596,197.9252513885498,201.75950050354004,0.5699240418833379,0.003407013552721349,0.9812257671128267,0.9834282419424435,0.986098199965842,-0.01972284071332231,50.79940574560697,203.19269994625046,199.70175037384033,196.2108008014302,198.70892878941126,1.850484144552385,198.85375077383858,1.4889221913263513,199.05929875601288,199.4104571697403,0.2499567280490463,-0.38939096626365055,9235300,1.6486421935273985,1.0423465636129594,288373500.0,-92.16500261916383,95.95456447167889,96.5727530047212,-187.24512242827174,21.988027115131356,27.559723081092642,0.08350822979867749,3.488637603211137,201.01080377197266,199.59460421752928,198.45000457763672,197.30540493774413,195.88920538330075,0.06,0.0,182.61577018543773,-0.02410120009475958,-0.03696367022511205,197.34506443568634,197.80252729143416,2.582860531546016
2024-06-12,0,193.88999938964844,195.9525032043457,204.11499786376953,198.39374923706055,200.45812606811523,0.43147322650755493,1.9216176480132596,0.05864228065064392,2.995685972571123,199.36375045776367,1.4747877311706532,0.009629435468004061,197.23550148010253,201.75950050354004,0.48362808651537875,-0.020543564114485706,0.9716039186798119,0.9748653706609528,0.9796060631064504,-0.02292884130492101,39.45711709683595,203.39986085297232,199.5566255569458,195.71339026091925,197.63107136317663,2.1680990838263137,198.48982211521692,1.9920407996720038,198.29419001891256,198.94247536040757,-2.4602409034582258,-1.1613819834882517,12751300,1.80839898427006,1.4062083005251516,275622200.0,-98.16512827430684,95.95456447167889,96.5727530047212,-226.95289401644905,19.644520509479754,29.133863793631996,-0.028455769706063633,3.625885782897398,200.4703617553711,198.71982095336915,197.30500030517578,195.8901796569824,194.13963885498046,0.08,0.0,182.72604928194755,-0.029047885285389596,-0.03831089214555204,195.8831634521484,197.32091086251395,3.0882346179626867
2024-06-13,0,192.86000442504883,193.88999938964844,204.11499786376953,198.19062614440918,200.45812606811523,-0.10216510574938506,2.2781795658117527,0.29621853530017406,2.9956668764823275,199.11499977111816,1.6995503807067878,0.011433889222439526,196.7872512817383,201.75950050354004,0.5220311473445224,-0.03845868258826277,0.9679394719921814,0.9716933917734679,0.9789028042596818,-0.020418511891797442,33.55319757908561,203.8043596580517,199.24800052642823,194.69164139480475,196.62607192993164,2.5420287036390565,198.17446517944336,2.487100618442411,197.20509735313271,198.2761519334654,-3.745626098842918,-2.5604951152474325,8587800,1.800719684920184,0.9459231722428748,267034400.0,-77.61675371057709,95.95456447167889,96.5727530047212,-191.05920969682018,18.21467280465046,27.859202566884424,-0.03242991818608339,3.6311797150345297,200.36888348388672,198.5555637512207,197.09000396728516,195.62444418334962,193.8111244506836,0.1,0.0,182.79800965067304,-0.016504978890538924,-0.018249910239202412,195.10178048270086,197.08933803013392,3.2183418859277118
2024-06-14,0,192.87749862670898,192.86000442504883,204.11499786376953,197.816876411438,199.99937534332275,-0.3392877804624714,2.5981158599773795,0.33789936317417624,2.995646747414476,199.01000022888184,1.8919995117187511,0.013068418017343243,195.746252822876,201.57050132751465,0.5712638234340646,-0.04896689405615654,0.9701660411000016,0.9748143464007709,0.9830031107943538,-0.029925423196809575,30.468266993792497,204.0049824447472,198.80875072479247,193.61251900483774,195.83142907278878,2.7420409198333484,197.7232151031494,2.836293551668414,196.1181559493559,197.5509318377247,-3.5193456647762864,-2.237991162935518,6874000,1.7671659932066148,0.76398532712498,273908400.0,-76.65060930737127,95.95456447167889,96.5727530047212,-153.13315132516857,17.530299176124956,25.96681899713455,0.01050795638549134,3.617523530856817,200.36888348388672,198.5555637512207,197.09000396728516,195.62444418334962,193.8111244506836,0.1,0.0,182.8566300370137,-0.030857723769699197,-0.01589564004811751,194.60737827845978,196.59706551688058,3.2552707762333104
2024-06-17,1,194.1699981689453,192.86000442504883,204.11499786376953,197.176251411438,199.67937660217285,-0.4068583351093207,2.733318804364229,0.11501158560610092,2.9956371032138818,198.90624809265137,2.051749420166016,0.013782843651683916,193.7887493133545,200.94900398254396,0.5784490616950794,-0.05505474538701306,0.9791081531862559,0.9853394048383127,0.9956286931080125,-0.026875336193106447,29.110106694800322,203.77976321908008,198.31312561035156,192.84648800162304,195.4442858014788,2.7605681923431895,197.3348219735282,2.929192837831777,195.3003086824732,196.9180711680861,-2.803114310872262,-3.1715158903556477,8725400,1.7186693973143583,0.9726445801935167,282633800.0,-66.9887967054773,95.95456447167889,96.5727530047212,-105.67125819783257,17.939801566568256,24.438915115809092,-0.00031083244513880877,3.5691269801565757,200.36888348388672,198.5555637512207,197.09000396728516,195.62444418334962,193.8111244506836,0.1,0.0,182.9374343919862,-0.023195260959753106,-0.024856210384620825,194.3331821986607,196.27598789760046,2.932041573550191
2024-06-18,1,195.92250442504883,192.86000442504883,201.43500137329102,196.64812660217285,199.551251411438,-0.7389128396870427,2.529617225293893,-0.591958167238662,2.9956502475084514,198.63374710083008,2.0806122970581074,0.012787736157645349,193.7887493133545,200.3707504272461,0.7284475165060358,-0.03066459572445398,0.9904286185596906,0.9979117280578316,1.0101701657868014,-0.00015309209531044754,37.055947378454235,202.87511007619813,197.81587562561035,192.75664117502257,195.02928706577845,2.355894645834898,197.1866079057966,2.94553341111991,195.0069490804437,196.42688159558597,-1.3764744435532246,-2.7240979225033626,9023000,1.5893529407454843,1.0549163274695044,291656800.0,-50.724669730710595,95.95456447167889,96.5727530047212,-39.38443638923515,21.31034953842527,22.575337405839058,0.12404827157917205,3.5877616800755505,200.36888348388672,198.5555637512207,197.09000396728516,195.62444418334962,193.8111244506836,0.1,0.0,183.03392362320264,0.013582991786940335,-0.013075544326884687,193.91407557896204,196.1971391950335,2.895844168388078
2024-06-20,1,197.65499877929688,192.86000442504883,201.43500137329102,195.94500350952148,199.27937507629395,-0.5786479074853456,2.493665818719363,-0.7339640820167981,2.9956524427149787,198.3474998474121,2.09434959411621,0.01261999775062653,193.7887493133545,199.9950008392334,0.7907239557142232,-0.011765133946179857,1.0002966802006505,1.0087771256173794,1.0191343777221618,0.01941822374284574,45.584464351119806,202.5837074843015,197.5963758468628,192.6090442094241,194.76107243129186,1.7987629147076538,197.08803640093123,2.901683602097467,195.2301298153743,196.3101127652844,-1.4610610778463793,-1.0479914816349776,8731100,1.5982268380647313,1.0559089589783281,300387900.0,-37.27862774077746,95.95456447167889,96.5727530047212,14.473720566240003,22.86745604367717,21.066671097871364,0.08933450476187593,3.570063465985228,200.36888348388672,198.5555637512207,197.09000396728516,195.62444418334962,193.8111244506836,0.02,1.0,183.13781286765956,0.03727871500794544,0.022175293308343176,193.78052847726005,196.15025547572546,2.8749320315631093
2024-06-21,1,196.10000228881836,192.86000442504883,201.43500137329102,195.94500350952148,199.27937507629395,-0.5465581709833318,2.489166865015222,-0.7450026562274275,2.995652717407043,198.21875,2.0703495025634764,0.012599142216317603,193.7887493133545,199.9950008392334,0.7849096215750019,-0.006683930080031863,0.9925778187803094,1.0012419883406145,1.0072060760948096,0.01679973965275261,51.00658625877563,202.54470946245235,197.56637573242188,192.5880420023914,194.78214372907365,1.8158288290856002,196.74553625924247,2.6932665128470257,195.83180347028988,196.59295261421084,-0.9409506871913275,-0.6933459286925396,20972500,1.641471304610916,2.3708026985720356,279415400.0,-53.03291748481062,95.95456447167889,96.5727530047212,-47.89481057955826,20.866628607469185,22.9395606861007,0.16507350765927323,3.63291813189316,199.69655975341797,198.0117207336426,196.6500015258789,195.28828231811522,193.60344329833984,0.02,0.0,183.3460178124815,0.01363208819306072,0.024904707953037522,194.05614362444197,195.70060403006417,2.887813545365797
2024-06-24,1,198.25500106811523,192.86000442504883,201.43500137329102,195.94500350952148,199.27937507629395,-0.39370480973116834,2.486369113826991,-0.8456575125422603,2.995652831291318,197.82625007629395,2.087161922454834,0.01259417658251726,193.7887493133545,199.9950008392334,0.7874856849704993,-0.005956148665427374,1.0042187533354028,1.012648208500891,1.0148967242751665,0.027880403259551656,47.294189146448254,202.39486404399918,197.42212581634521,192.44938758869125,195.40571539742606,2.1727989328358213,196.51839338030135,2.383645965401889,195.8926975004506,196.65346391619644,0.07527287585545124,-2.3868199216837795,9785900,1.6336669429117612,1.095601929470325,289201300.0,-27.927868482876278,95.95456447167889,96.5727530047212,26.803339059910837,23.75481851288313,21.59949268540657,0.21100109398238698,3.5827074837044077,199.36039788818357,197.7397992248535,196.43000030517578,195.12020138549804,193.49960272216796,0.02,0.0,183.45980234121043,0.026318523238770153,0.026954394013388304,195.10035705566406,195.49176025390625,2.896332886080558
2024-06-25,1,198.49250411987305,192.86000442504883,201.43500137329102,195.94500350952148,199.27937507629395,-0.4478487298192849,2.492635583843765,-0.8337210234381871,2.9956524514668375,198.12625122070312,2.1116494750976584,0.012622785097457298,193.7887493133545,199.9950008392334,0.7773905055356956,-0.004718987063676824,1.0051722920113613,1.014157887323501,1.010548813203553,0.022261451262757692,52.78156238297507,202.45639696114455,197.47112579345702,192.4858546257695,196.21035821097237,2.1150965728778504,196.41821507045202,2.2569230806006155,196.48891998714055,197.05145561080272,2.251277369749602,-1.5786731618120011,6915900,1.6494380534140203,0.7761944150455499,296117200.0,-28.3863819775951,95.95456447167889,96.5727530047212,35.89187155189241,24.340713395502203,20.570390077805,0.14371864965004716,3.4932257167500045,198.55055975341796,197.08472073364257,195.9000015258789,194.71528231811524,193.24944329833986,0.04,0.0,183.54037103786126,0.015847833227387698,0.02213857558570402,195.72688511439733,195.4143327985491,2.8121497853989244
2024-06-26,1,197.27499771118164,192.86000442504883,201.43500137329102,195.94500350952148,199.15937519073486,-0.42941980758049525,2.4729682623630564,-0.7999405756833782,2.9956536853376554,198.12625122070312,2.0835496520996117,0.012525417095430404,193.7887493133545,199.9950008392334,0.7651215550384595,-0.005585951693643774,0.9991845291502038,1.008473149126812,0.9999492894799883,0.006903205377563948,53.206797944343,202.3819375394356,197.43600101470946,192.49006448998333,196.83857236589705,1.5332283022788928,196.3350007193429,2.1973348584591936,196.99487293583454,197.35165751112882,2.9205120634606105,-0.7016165160103451,7758600,1.6473198966092848,0.866647379538293,288358600.0,-34.761034133204454,95.95456447167889,96.5727530047212,-4.468607799106238,23.417628662781212,22.883489242711143,0.1612875818821795,3.3715638226981537,198.55055975341796,197.08472073364257,195.9000015258789,194.71528231811524,193.24944329833986,0.04,0.0,183.6213911703114,0.0021827264055842566,0.01256535949512559,196.24543980189733,195.42640904017858,2.775851012038878
2024-06-27,1,198.34249877929688,192.86000442504883,201.43500137329102,195.94500350952148,198.8793716430664,-0.34842468567965,2.4222914495340575,-0.7232795827384813,2.9956568117816262,197.82625007629395,1.9946872901916493,0.012275993878958542,193.7887493133545,199.9950008392334,0.7827988660156999,-0.003649054443102369,1.0051851115687789,1.0132452167479349,1.0039836804476663,0.0034782828880925987,50.26712937299671,202.16395870015458,197.31937580108644,192.4747929020183,197.43464388166154,1.061298874838394,196.43946484157019,2.2591334414821276,197.07189130799497,197.37761160982834,2.2799440659397407,-0.5870796833247612,7913500,1.6301077173924063,0.875183378206734,296272100.0,-17.430290540304355,95.95456447167889,96.5727530047212,39.90223192747594,26.039683080921495,21.43581595704223,0.17756686872121086,3.3421660955129204,198.55055975341796,197.08472073364257,195.9000015258789,194.71528231811524,193.24944329833986,0.04,0.0,183.71161463625714,0.0025167804024146534,0.011015271919421452,196.84071350097656,195.58694784981864,2.7984490829823536
2024-06-28,0,201.04249954223633,192.86000442504883,201.43500137329102,195.94500350952148,198.8793716430664,-0.36451378060120065,2.4282801785015766,-0.73432990596132,2.9956564461891144,197.95499992370605,2.0102121734619147,0.012305268574649956,193.7887493133545,199.9950008392334,0.7690399166518641,-0.003479292931625756,1.0187794529182879,1.024707554638332,1.0169429303785962,0.025203963262267592,53.02815149616234,202.19318602838987,197.3366256713867,192.48006531438355,198.1660717555455,1.5134552850368685,196.59767941066198,2.5035771724173665,197.39472312040837,197.5232535741418,2.148890482411764,0.742837110548194,15307600,1.6311630028190405,1.6171138812592436,311579700.0,-2.9011225363958606,95.95456447167889,96.5727530047212,118.04102713744247,29.97944535661071,19.867349088655235,0.22360875704859634,3.348440669326522,199.83408581542966,198.12296563720702,196.74000549316406,195.35704534912108,193.64592517089844,0.06,0.0,183.9146053476973,0.030361678387816227,0.018070186725057023,197.58800179617745,195.75103868756975,2.9675620186117566
2024-07-01,0,204.5099983215332,192.86000442504883,201.43500137329102,195.94500350952148,199.00374698638916,-0.2979259645283353,2.535531660812905,-0.8381570353025398,2.9956497020096204,197.95499992370605,2.1005496597290034,0.012842231458068945,193.7887493133545,200.90975379943848,0.6913704364495907,0.0007341908292321311,1.0358240737141473,1.0380519988235646,1.0293358871874356,0.031550262135727536,59.67918521165659,202.50806397775375,197.43700065612794,192.36593733450212,199.1453574044364,2.7992405937910063,196.95321491786413,3.207018949975647,198.30723570170076,197.92425216283957,2.6132756582571046,1.1140330269110972,10205800,1.692205733422992,1.1026865952236506,321785500.0,-10.117213165678123,95.95456447167889,96.5727530047212,208.64635400567133,36.26990818933891,17.88302268502051,0.1862053461339438,3.4542689213425333,203.2644383544922,200.8977796020508,198.98500061035156,197.07222161865235,194.70556286621095,0.08,0.0,184.07533476024963,0.03303500947695026,0.046612330557906166,198.55123683384485,196.16588265555245,3.2642591805362065
2024-07-02,0,206.9375,192.86000442504883,204.5099983215332,195.94500350952148,199.00374698638916,0.2618810931255499,2.8809244516752592,-0.07945597161336382,2.995626134933236,197.95499992370605,2.263224391937257,0.014578267622456797,193.7887493133545,201.0817497253418,0.6137967912056617,0.015265454996789413,1.0471604884910772,1.0442080653629449,1.0350368265082874,0.042545666485354294,67.1266845056034,203.37959926193204,197.61775035858153,191.85590145523102,200.69357136317663,3.6896029738233236,197.73785754612513,4.14886309730328,199.86171689252456,198.71304055721933,3.4681640153663276,2.494579615039488,7802900,1.858735804990961,0.8369224498770557,329588400.0,-0.16684530826070978,95.95456447167889,96.5727530047212,239.12087872655056,36.85480372676093,16.390169999889846,0.20436030597232027,3.4996790006018186,204.61672161865235,201.99164224243165,199.87000274658203,197.7483632507324,195.1232838745117,0.1,0.0,184.21056132796363,0.0543241885525696,0.05003018058357769,200.3313729422433,197.19375828334265,4.001249401345572
2024-07-03,0,209.06750106811523,192.86000442504883,206.9375,195.94500350952148,199.00374698638916,0.8387340556072203,3.4406901011118403,0.7446596692867979,2.9955818328309385,197.95499992370605,2.534624481201172,0.017386629488662292,193.7887493133545,201.389249420166,0.6716694791848608,0.03523099390234302,1.056468055061746,1.048203027728568,1.0369305963846405,0.05977697880497912,72.71085356998606,204.77425549214064,197.892875289917,191.01149508769333,202.23821422031946,4.639569724179125,198.82196480887276,4.968133956644716,201.6336768704532,199.6280974023363,5.526515851448104,5.605948694719547,5560900,1.8785709048023527,0.6005969356153044,335149300.0,-8.666679186698719,95.95456447167889,96.5727530047212,221.78030395597062,37.92036224221604,15.46232187429115,0.21802165823879185,3.444701614304477,205.7780048828125,202.9310048828125,200.6300048828125,198.3290048828125,195.4820048828125,0.12000000000000001,0.0,184.31180532706034,0.05703295876610426,0.05361740497173152,201.72508021763392,198.412718636649,4.635762844481257
2024-07-05,0,205.91749954223633,192.86000442504883,209.06750106811523,195.94500350952148,199.00374698638916,1.0651235763129459,4.2037125565414355,0.638362111586221,2.9955093267708484,197.95499992370605,3.0037995910644555,0.02119324809618473,193.7887493133545,204.75274848937988,0.7355551855955771,0.05355524347386205,1.0381444012754073,1.0256502818310427,1.0094984802644773,0.03819151623862749,77.07505482945196,206.75892543351745,198.35150032043458,189.94407520735172,203.29892785208565,4.486733143693426,199.754643031529,4.988400509343207,203.49659375721933,200.73269573226537,5.453834678442794,7.827892994091735,8093100,1.8657207637055424,0.875305401345226,327056200.0,-29.48317308659601,95.95456447167889,96.5727530047212,126.31072134452639,34.68998187322006,20.53933870137954,0.21742654699004127,3.4965094732242927,205.90544329833983,203.13728231811524,200.9000015258789,198.66272073364257,195.89455975341798,0.12000000000000001,0.0,184.43782813683075,0.033914503619439484,0.04302671107424986,202.84100341796875,199.28394426618303,4.894747219541468
2024-07-08,0,205.2699966430664,192.86000442504883,209.06750106811523,195.94500350952148,199.91000080108643,0.8453572599934018,4.5158877667491275,-0.1952518020760312,2.995475669744742,197.95499992370605,3.4757367706298794,0.02272426336308211,193.7887493133545,206.0194995880127,0.8348683991530604,0.04590358809981091,1.032932992401172,1.0182346517975434,0.9989050679963407,0.02102787773956183,66.73826016734226,207.75715089970916,198.72537536621093,189.6935998327127,204.44107055664062,3.63434070017321,200.63982146126884,4.768875481880719,204.1052056247303,201.3403320576957,3.7406931084305324,6.770452565379896,8707000,1.9903971675508483,0.9363004893344868,318349200.0,-29.368687151054225,95.95456447167889,96.5727530047212,105.1290684414032,32.58924872803766,20.43228200432768,0.20053378003389774,3.4560432898474316,206.1933635864258,203.60332278442382,201.51000213623047,199.4166814880371,196.82664068603515,0.12000000000000001,0.0,184.5703990638141,0.02000824289175762,0.03583301806187671,204.10214015415735,200.17378997802734,5.119505240153991
2024-07-09,0,207.11750030517578,192.86000442504883,209.06750106811523,195.94500350952148,201.90937423706055,0.6140903173644742,4.7104771865889585,-0.7120397454772704,2.995453824801862,198.29874992370605,3.8263370323181136,0.023653519495092104,193.7887493133545,206.0194995880127,0.8717640073439606,0.03240246551155009,1.0400342974149548,1.022746915638653,1.0037656262028936,0.012749997579790895,63.68436190769176,208.56582951813644,199.1448751449585,189.72392077178054,205.69464220319475,2.5239254912976743,201.56464304242814,4.672141940638019,204.3970736775626,201.795129913588,4.052717792241346,6.425061556994577,9058900,1.9736781304123447,0.9632941429176789,327408100.0,-16.923076923076923,95.95456447167889,96.5727530047212,121.266042858643,35.34412822496767,18.538334185611077,0.18020306909914266,3.53704123318459,206.5450048828125,204.1725048828125,202.2550048828125,200.3375048828125,197.9650048828125,0.12000000000000001,0.0,184.7214097276237,0.01621076647616615,0.03223823337821939,205.4675031389509,201.15410831996374,5.517238035845618
2024-07-10,0,206.87250137329102,192.86000442504883,209.06750106811523,195.94500350952148,204.6999979019165,0.4597826408496621,5.018952678298605,-1.0992616324716182,2.995417164443784,198.29874992370605,4.294686775207518,0.02515017231690857,193.7887493133545,206.95550003051758,0.864787567712892,0.038013852570729215,1.0366463664152177,1.017086031285074,1.0000507674758876,-0.0003140978638912495,66.78280247170147,209.59728073806693,199.55937538146972,189.5214700248725,206.52749960763114,1.4782061204679242,202.3467856815883,4.570398118040008,205.06448080841005,202.31174999623042,4.424166066216187,6.668127032150961,8328500,2.00112395312313,0.8751228072018872,319079600.0,-15.965354247437826,95.95456447167889,96.5727530047212,97.97686076201333,33.59777616024227,17.622355781064055,0.21639484666267422,3.4551084546293898,206.5662440185547,204.2068834838867,202.3000030517578,200.3931226196289,198.03376208496093,0.12000000000000001,0.0,184.85553433822443,0.0005815377665980836,0.01704279443696577,206.41815621512276,202.0030790056501,5.864407059951268
2024-07-11,0,206.78500366210938,192.86000442504883,209.06750106811523,195.94500350952148,205.4318723678589,0.3225999855243607,5.265857143807409,-1.364553490695869,2.9953863200063533,198.29874992370605,4.732399368286133,0.026338981705434986,193.7887493133545,206.95550003051758,0.8824369450145318,0.05572778091820332,1.0343057701099312,1.0124843989559977,0.9996906142919053,-0.010917514172909204,69.17619200951711,210.45808967671397,199.92637538909912,189.39466110148427,206.8525003705706,1.1809020870236375,202.9989288875035,4.500272216533946,205.49451897214198,202.62346038870191,2.8998852701937694,5.588942924334231,10658100,1.7782452915147005,1.1115978260529469,308421500.0,-18.13123311005399,95.95456447167889,96.5727530047212,84.98574284069993,31.67934294299329,17.035965551598892,0.27509807533882696,3.402600070057447,206.5662440185547,204.2068834838867,202.3000030517578,200.3931226196289,198.03376208496093,0.12000000000000001,0.0,185.02378507438803,-0.00043370720330393464,-0.0011037829270504037,206.8656049455915,202.70842088971818,5.948808577563881
2024-07-12,1,204.62250137329102,192.86000442504883,209.06750106811523,196.05562782287598,206.1343755722046,0.1222964028767168,5.385011594778403,-1.4978260496682085,2.995371814701971,198.41750144958496,4.930799674987793,0.026862200369692505,193.7887493133545,206.95550003051758,0.874746790569409,0.066506804440938,1.0207240105790734,0.9972525032714198,0.9914241121684769,-0.00628891751222771,70.98767989940433,211.23802360154406,200.4680004119873,189.69797722243055,206.52178628104073,1.4472529358863615,203.60767882210868,4.049069968618729,205.8096884134867,202.94671151267087,1.1124176613601942,4.619162145758396,15443400,1.6758217057518257,1.5883867590210328,292978100.0,-38.58156089769257,95.95456447167889,96.5727530047212,50.06061302179554,28.261163808610284,21.81294059472002,0.33642993640864094,3.5417011945463326,207.05240344238283,204.99380255126954,203.3300018310547,201.66620111083984,199.60760021972655,0.02,1.0,185.23968581828566,0.000732502369214183,-0.012527734395620667,206.47428676060267,203.40282985142298,5.591369579838503
2024-07-15,0,208.8925018310547,192.86000442504883,209.06750106811523,196.98124885559082,206.1343755722046,-0.05133548354622092,5.2354438606678535,-1.4655476204288234,2.995392856209223,199.7675018310547,4.809624671936035,0.026046384989169967,194.04074821472167,206.95550003051758,0.8676113566021253,0.060989819964530005,1.0392422627082627,1.0149564553727968,1.0133845355106363,0.017647514236029727,62.86562575230704,211.47551323250514,201.00462551116942,190.5337377898337,206.4967863900321,1.3965731776199655,204.36750030517578,3.964556163265995,205.50707961302183,202.98941456901017,-1.1186945946041604,4.345996422743851,10719700,1.753859537617299,1.0905874178094246,303697800.0,-10.176108103481054,95.95456447167889,96.5727530047212,103.10776526984547,32.577078825893544,19.052779922313672,0.3305586905250416,3.76515363871935,207.99212017822265,205.75393991088868,203.94499969482422,202.13605947875976,199.8978792114258,0.02,1.0,185.42157146342038,0.023785177786052936,0.0256848964210654,206.8328574044364,204.27896881103516,5.60893890968069
2024-07-16,0,211.36000061035156,192.87749862670898,209.06750106811523,197.55999851226807,206.80687808990479,-0.1476102190897739,5.153780844737878,-1.457363910692413,2.995405707322092,202.77624893188477,4.793000030517578,0.025538261748562316,195.74725379943848,207.29500045776368,0.7986777231209203,0.08303199345891975,1.04734120083408,1.0230434049923738,1.0217637164826758,0.020483543394086423,70.87745925822723,212.1138120709455,201.80625038146974,191.49868869199398,207.27428654262,2.2651796739793446,205.28660719735282,3.989245620444598,206.35421786562992,203.77081751781026,-0.08370465814461103,5.36556490662482,11557000,1.9257259446740815,1.1484144586741711,315254800.0,-0.6873443861924485,95.95456447167889,96.5727530047212,123.94555667421443,33.101085046260856,17.07794239178227,0.36514496986513123,3.9005015652328723,209.61944390869144,207.0702829284668,205.01000213623047,202.94972134399416,200.40056036376953,0.04,0.0,185.6335283471433,0.02884934784717541,0.041185343976481964,208.0942862374442,205.46764482770647,5.800411800420427
2024-07-17,0,215.375,194.1699981689453,211.36000061035156,198.10500049591064,206.88875102996826,-0.1089052623791717,5.126892487027061,-1.3992739097058575,2.995412153048174,204.5662498474121,4.731837444305421,0.025289217143073663,196.0822525024414,208.91000175476074,0.7754163985960835,0.08853068240979951,1.062371632713495,1.0390321470836128,1.0369198757122746,0.04110018765310253,73.9321039091597,212.98416045470597,202.73037548065184,192.47659050659772,208.71785845075334,3.6010025287392526,206.57946450369698,4.123778239959477,207.61426497092611,204.84618589367705,2.643049318398948,6.48261079053525,11572500,1.9577715164778309,1.1339146043987753,326827300.0,-3.3397982531422366,95.95456447167889,96.5727530047212,165.96496663358835,37.4649656687094,15.74576694782344,0.37321036509918415,3.92832268803378,212.68423669433594,209.66787615966797,207.22999572753906,204.79211529541018,201.77575476074222,0.06,0.0,185.87498789385765,0.04364769938511781,0.04450219148041778,209.76571437290735,206.93392726353235,6.226029936170488
2024-07-18,0,212.87250137329102,195.92250442504883,215.375,198.32062435150146,206.98250007629395,0.14222712310127125,5.430581901852043,-0.9087187989800505,2.9953775812893784,204.9462490081787,4.723999786376953,0.026647849412130813,197.15749816894532,209.29675102233887,0.7477800571497145,0.09928668292617107,1.044564737831224,1.0227960712533277,1.0165491117927423,0.02943877749050272,78.06291430311249,214.65178937590866,203.7906255722046,192.92946176850052,209.5400014604841,3.8247394898749127,207.61732183183943,3.6976785822349116,209.55967746235154,206.275932234748,4.922786341008556,9.175010771165981,12415100,2.0712330674552746,1.1965900109875283,314412200.0,-41.5115230632573,95.95456447167889,96.5727530047212,104.72530358512431,32.59497089065024,20.56469563902282,0.29756138407452176,4.192729989537402,213.25063885498048,210.58467965698242,208.43000030517578,206.27532095336915,203.60936175537108,0.06,0.0,186.09628947057942,0.012195704104676741,0.010490821192328085,210.10142735072546,207.78446524483817,6.075728376132716
2024-07-19,0,210.5625,196.10000228881836,215.375,198.455002784729,207.5612506866455,0.050449256035878624,5.459086066857838,-0.9613394120581709,2.995376522392824,205.59374809265137,4.5448126792907715,0.0266767790980484,197.61699867248535,211.5112506866455,0.8143927644029052,0.07699022381410209,1.0289504928186535,1.0098509140970249,0.9997056323585707,0.029029058812416242,69.20128416073413,215.55629755333237,204.6381254196167,193.71995328590103,210.0671441214425,3.6459242962878604,208.29732186453683,3.2429679586112936,210.3838319703296,207.1870139410512,2.778616514604304,7.3257131897698935,8095900,2.206435944591714,0.7826935198827492,306316300.0,-50.32343518366807,95.95456447167889,96.5727530047212,75.55559646519762,30.665203897251995,19.8995303458128,0.2564721397473419,4.138249360532255,213.91143957519532,211.6542808227539,209.8300018310547,208.00572283935546,205.74856408691403,0.06,0.0,186.22976478148826,0.023616650142640694,0.011231631069322272,210.38428388323103,208.40122004917689,5.950186351781434
2024-07-22,0,210.65500259399414,196.10000228881836,215.375,200.4050006866455,208.93625164031982,-0.13142270863669897,5.357407912475269,-0.8956230109621224,2.995391260272752,206.35125160217285,4.364150447845458,0.02609760599332828,198.15700073242186,211.5112506866455,0.8085405185198355,0.07375062489739856,1.0261662632445638,1.0080488956518723,0.9945352698033588,0.008437357719832894,63.48841769412158,215.99831630560243,205.28350048065187,194.5686846557013,210.6200011117118,3.346395062170265,208.7362507411412,3.10380107322715,210.41408554087218,207.66266528432547,1.7837066803047774,4.735317397784168,7663200,2.2547764662999796,0.7918021734469567,313979500.0,-47.0892807441081,95.95456447167889,96.5727530047212,75.02840714033077,29.32427804905617,19.029365102592323,0.2084213981754803,4.018372810589221,213.91143957519532,211.6542808227539,209.8300018310547,208.00572283935546,205.74856408691403,0.06,0.0,186.35667725201918,0.0010949570302190015,0.026056388573613715,210.788569859096,208.82708740234375,5.566756725516428
2024-07-23,0,210.54500198364258,197.27499771118164,215.375,203.64312362670898,209.44125080108643,-0.2310187409131014,5.0396447545094905,-0.7914364658091584,2.99543242550896,206.8287525177002,4.037375736236572,0.02446295890335139,198.3337490081787,211.5112506866455,0.8182010589067322,0.06254571869094283,1.022007300459651,1.004932906618078,0.9923644384092842,-0.003855973809403279,62.74229388449338,216.09054000492964,206.01125049591064,195.93196098689165,211.46607262747628,2.0902520645862865,208.9939294542585,3.0927092266507548,210.46481613469962,208.2278706218102,1.8715085056208511,3.00474515813143,5557300,2.234618157979241,0.5870338748957535,308422200.0,-46.76584556043995,95.95456447167889,96.5727530047212,64.38794491831496,28.175441589763878,18.946002549759186,0.17603353931357968,3.883487267823784,213.91143957519532,211.6542808227539,209.8300018310547,208.00572283935546,205.74856408691403,0.06,0.0,186.4466455600632,-0.015401148587836921,0.0013330101177284025,211.5585697719029,209.0164282662528,5.303413366884309
2024-07-24,0,209.56000137329102,197.27499771118164,215.375,204.59437561035156,210.54937648773193,-0.4004420709528348,4.800019147223541,-0.5109096095115051,2.99546154782502,206.9050006866455,3.753350830078125,0.023230498302558522,198.47750358581544,211.5112506866455,0.7998763761530884,0.06072016632170059,1.0142007993868702,0.9985978358563805,0.9884812416713754,-0.02699941324066857,62.284454965638886,216.2257888361341,206.625750541687,197.02571224723994,211.5614297049386,1.964735450271683,209.02910804748535,3.0964092585692153,210.47182367038886,208.56020347684785,2.8943545165383338,1.7432809344089777,7119000,2.239358089642068,0.7511950110268125,301303200.0,-58.0207385415903,95.95456447167889,96.5727530047212,44.49370014146425,26.126132569744694,19.91898312621911,0.17430158505861482,3.888951891354403,213.91143957519532,211.6542808227539,209.8300018310547,208.00572283935546,205.74856408691403,0.06,0.0,186.55698703138157,-0.038179549802740964,-0.023546479235417517,211.3499973842076,209.09142739432198,4.8148736841241995
2024-07-25,0,208.88999938964844,197.27499771118164,215.375,205.10812282562256,210.54937648773193,-0.5566704977575907,4.456115640815162,-0.010636094398131402,2.995499988160457,207.0275001525879,3.427788219451904,0.02150851651737608,200.7724994659424,211.5112506866455,0.7404268762061463,0.06227349539800834,1.0082579457846024,0.9941319984877007,0.9907559699028441,-0.01870839097558641,60.04067189656101,216.09135668598825,207.1791254043579,198.26689412272756,211.2085723876953,2.2130492004737716,209.24142946515764,2.965790492656412,210.2472153117142,208.6879051045995,0.31954212639771035,0.23556999660857006,6403800,2.2298200443772607,0.6805921038647446,294899400.0,-57.503261987433596,95.95456447167889,96.5727530047212,24.541656106219328,25.065143289685015,19.148029498104414,0.14534970203142314,3.764025890572163,213.91143957519532,211.6542808227539,209.8300018310547,208.00572283935546,205.74856408691403,0.06,0.0,186.65281040168287,-0.006238677899077172,-0.03781065676610197,210.64285496303015,209.36857060023718,4.098425039017031
2024-07-26,0,210.81500244140625,198.34249877929688,215.375,205.75562381744385,210.54937648773193,-0.464518514911166,3.8420649611739655,0.3466896045583927,2.995560758812284,208.0037498474121,3.018125534057617,0.018492815093117815,204.16324844360352,211.5112506866455,0.6753597791003314,0.053178217856820295,1.014705086561805,1.0022892282310691,1.0036778336258743,0.0011991804875333134,57.244976134576575,215.44400541062916,207.75987548828124,200.07574556593332,210.55714416503906,1.2390041519597228,209.6375013078962,2.757570067300851,209.9233387165599,208.69270495424328,-1.1686228300389938,1.4435392106159541,8027800,2.246250342248664,0.8526719685603898,302927200.0,-34.41135191366615,95.95456447167889,96.5727530047212,73.40860766107133,28.491311717081466,17.52227807762445,0.14818324008551406,3.8194535617200414,213.91143957519532,211.6542808227539,209.8300018310547,208.00572283935546,205.74856408691403,0.06,0.0,186.78441777496005,0.011726602765668392,0.01076297652923828,209.98142787388392,209.87357112339564,3.5245913223394068
2024-07-29,0,211.91500091552734,201.04249954223633,215.375,206.5681276321411,210.58562564849854,-0.0854520385531345,3.225662044901302,-0.015967114711803454,2.9956123997273343,208.89125061035156,2.637650527954102,0.01547945031400569,204.61125106811522,211.5112506866455,0.620513844826499,0.04860913946763207,1.0169471202507039,1.0045614468195823,1.0086723467494552,0.005981335862038195,60.23338514682916,214.8348247611893,208.3835006713867,201.93217658158412,210.42035838535853,0.962869949493277,209.9801799229213,2.718131475470543,210.1601399183038,209.05991396465532,-2.117236243107951,2.7013230813180034,6533600,2.2137327827019737,0.7278824220784466,309460800.0,-43.40229730770076,95.95456447167889,96.5727530047212,77.09980541911402,27.691054148480497,16.505099303502732,0.05847058321522099,3.7652063965503038,213.91143957519532,211.6542808227539,209.8300018310547,208.00572283935546,205.74856408691403,0.06,0.0,186.8919236469265,0.0027107063321651914,0.005100616505124702,210.10571507045202,210.10357121058874,3.1106796252753597
2024-07-30,0,214.29249954223633,204.5099983215332,215.375,206.8506269454956,210.69500255584717,0.256432560369942,2.8352120260123774,-0.5458759368148223,2.99564029641732,208.98000144958496,2.3456254959106446,0.013570339495025504,205.20524711608886,212.0107509613037,0.6399702539943443,0.03620851134305865,1.0256805993150966,1.0143783506130666,1.018766779807576,0.017799033571382905,60.82058885340498,214.59754979207602,208.92712574005128,203.25670168802654,210.95321546282088,1.7582390566977997,210.5101797921317,2.788064393438607,210.61164590303625,209.5623404706024,-0.449799974908271,2.3163183233105458,8850700,2.1081109098694006,0.99352073656159,318311500.0,-15.329860459974745,95.95456447167889,96.5727530047212,148.04792824671745,29.19800802187131,14.992037062648775,0.07265757965639873,3.849119751963702,213.91143957519532,211.6542808227539,209.8300018310547,208.00572283935546,205.74856408691403,0.06,0.0,187.05340133056407,0.02310654955566105,0.02334983683951205,210.87857273646765,210.63142830984933,3.210842781467632
2024-07-31,0,214.1599998474121,204.62250137329102,215.375,206.92125034332275,210.95125198364258,0.23720518014492883,2.8745425683750185,-0.6853726867069327,2.9956381612179617,209.31375122070312,2.3790002822875977,0.013726454166660622,205.85274925231934,213.01450119018554,0.6459932298877238,0.03554213007423173,1.0226522489452432,1.012345877946238,1.0145219278775812,0.021950746535485344,64.78745654375197,215.16533593783646,209.41625080108642,203.66716566433638,211.4539293561663,2.1208473870989226,211.03696523393904,2.726115134115827,211.5380510438155,210.24581584326967,1.7714453153986718,3.5867493841321614,9071600,2.1055950572920383,1.0111175448109673,309239900.0,-30.7891147331289,95.95456447167889,96.5727530047212,112.95719866443181,28.293663572013823,13.954608385918151,-0.01772594242641262,3.8398969546086406,213.91143957519532,211.6542808227539,209.8300018310547,208.00572283935546,205.74856408691403,0.06,0.0,187.21286091886137,0.020183166919699458,0.011743456469358694,211.2385733468192,211.0135716029576,3.2640502010053245
2024-08-01,0,210.34250259399414,204.62250137329102,215.375,207.0562505722046,211.4987506866455,0.07428806810335341,2.9917438378505667,-0.8583230022913244,2.9956306066492324,210.0525016784668,2.4778751373291015,0.014261518080940163,205.85274925231934,214.17324981689453,0.7143292270216216,0.02435815587444035,1.002693935885124,0.9948717541786967,0.9921137571728226,0.006953435820717724,63.10107481582926,215.76086346915815,209.77737579345703,203.7938881177559,211.4250008719308,2.136633813382413,211.44553674970354,2.0307643613583624,212.1989260515098,210.77470399919315,1.663856642499644,3.5665043667062135,10918600,2.0672886829809496,1.1816999179630596,298321300.0,-85.86759511500057,95.95456447167889,96.5727530047212,-13.581865157972677,24.619381928961474,23.106640140847254,-0.04407068429489266,4.097762411350474,214.92151928710936,213.2892403564453,211.97000122070312,210.65076208496095,209.0184831542969,0.02,1.0,187.36996972077185,-0.003402460637888627,-0.003020229325873129,210.9000026157924,211.22928619384766,3.250552212215238
2024-08-02,1,201.14500045776367,204.62250137329102,215.375,207.0562505722046,211.4987506866455,0.01147782856810371,2.9895216051802787,-0.8557506804616524,2.9956307889915603,210.44375228881836,2.464262733459472,0.014246595336301635,205.85274925231934,214.17324981689453,0.712266048396291,0.02148920349943443,0.9585585267142294,0.9525094830222686,0.9474341134019211,-0.04586961018739755,52.345680375067865,215.82016908011153,209.84112586975098,203.86208265939044,210.22285788399833,4.4623494438886055,210.89214379446847,3.384440625441423,211.72014582931143,210.7000008986279,-0.09617867331952618,2.795392091443637,18041700,2.129802386069616,1.852868954737362,280279600.0,-89.11465796170022,95.95456447167889,96.5727530047212,-234.89882269729497,20.383543072268456,33.88069334764589,-0.04719324539665057,4.595782006021586,212.68187799072265,209.66405825805663,207.2249984741211,204.78593869018556,201.76811895751953,0.04,0.0,187.51880491281833,-0.061722605373460526,-0.045670191512538906,209.5500030517578,210.4500002179827,3.887391101271727
2024-08-05,1,194.00499725341797,201.14500045776367,215.375,207.0562505722046,211.4987506866455,-0.5127769116079535,3.448432287317485,-0.021317121048565202,2.9955965363138035,210.44375228881836,2.7267501831054686,0.016452247813146324,205.20524711608886,214.17324981689453,0.4498459343193037,-0.02009546574152033,0.9255853169977424,0.9228138257996089,0.922204090080203,-0.08451503472964894,33.890639121943266,216.49936549016232,209.60250091552734,202.70563634089237,208.09642900739397,7.627428232508515,209.65250069754464,5.631986373884238,209.06594659677148,209.52383232137257,-4.015556814459851,-3.7088460836937736,13927000,2.9955659731451636,1.392954910748667,266352600.0,-84.99625112323214,95.95456447167889,96.5727530047212,-298.89331576988366,17.912987719249255,38.58502266361406,-0.0020056048779056577,4.856084703326351,211.26823669433594,207.37587615966797,204.22999572753906,201.0841152954102,197.1917547607422,0.06,0.0,187.5760915957,-0.07564624968139966,-0.08170001483173812,207.5828595842634,209.11285727364677,5.003073721099838
2024-08-06,1,198.08499908447266,194.00499725341797,215.375,207.0562505722046,211.4987506866455,-1.5430188630558515,4.774935714019918,2.6573913276455103,2.9954681898344853,210.44375228881836,3.3984001922607434,0.022842292499662544,204.27475128173828,214.17324981689453,0.5080279388862126,-0.06330948873193859,0.9475971531088214,0.9497427614808649,0.9579087821061022,-0.0756326072652358,24.975906565720805,218.58912237408475,209.03925094604492,199.48937951800508,206.27785709926061,8.354176896843203,208.41750063214982,6.1522820015359265,205.28689188279827,207.53358340016464,-7.125761012840568,-8.211110572869488,10605800,3.323817347880576,1.0526310565762644,276958400.0,-63.3255616673691,95.95456447167889,96.5727530047212,-162.37773097868126,24.729616200720624,33.95883132861275,0.022457367904735764,5.123508633204812,210.56535809326172,206.80731729125978,203.7699966430664,200.73267599487306,196.97463519287112,0.06,0.0,187.65245603060663,-0.06900881051646013,-0.049845906859804,205.8828582763672,207.93214307512557,5.357571065120433
2024-08-07,1,202.46499633789062,194.00499725341797,215.375,206.8506269454956,211.4987506866455,-1.2861326250149636,5.330213062657235,1.0554603625638919,2.9954020482300203,210.44375228881836,4.001075210571287,0.02555383158536775,200.83900032043456,214.17324981689453,0.693087239622737,-0.04247786549920308,0.9706472063184878,0.9765773657987578,0.9946818137764749,-0.0546087201991694,34.48807548905969,219.24805201032424,208.58762588500977,197.9271997596953,204.9278564453125,8.049395776114615,207.67410741533553,6.201152913065226,203.48127481455677,206.29030360177828,-6.038471270787173,-8.027858811620357,9204400,3.4904305089484895,0.9095877090434031,286162800.0,-62.730490573853615,95.95456447167889,96.5727530047212,-96.72527492869686,27.193049439880276,31.34680661532589,-0.05513885971856619,5.153972623138445,210.37435809326172,206.65281729125977,203.6449966430664,200.63717599487308,196.91563519287112,0.06,0.0,187.73602931763875,-0.05827071887897217,-0.06872999849957712,204.38999938964844,207.24785723005022,5.661816166396705
2024-08-08,1,203.30749893188477,194.00499725341797,215.375,206.24437808990479,211.4987506866455,-1.1274296951665297,5.485421867619392,0.5018451413479714,2.9953821780089864,210.44375228881836,4.309600563049321,0.026325739054236633,200.83900032043456,214.17324981689453,0.757343406444876,-0.020891298922612996,0.9757171451560737,0.9840086304106581,1.0104319638349821,-0.033445469058093424,42.85431761642185,219.33809436847852,208.36725063323973,197.39640689800095,203.3585706438337,6.909498858029778,207.15589305332728,6.244201488892539,203.23365572082145,205.7612038943513,-4.459337251638755,-4.8890791287080795,7761200,3.654396801448271,0.7781068959588309,293924000.0,-48.37190731230472,95.95456447167889,96.5727530047212,-67.60705734150503,25.47806593712061,29.369858192224793,-0.06612437485123272,5.1079751319107505,210.37435809326172,206.65281729125977,203.6449966430664,200.63717599487308,196.91563519287112,0.06,0.0,187.81287901625066,-0.018753649881534495,-0.04107145379616509,202.7999986921038,206.83928571428572,5.7363036468242505
2024-08-09,1,204.6599998474121,194.00499725341797,215.375,204.29375076293945,211.4987506866455,-1.0096588470999568,5.586993785388601,0.15586243824920087,2.9953688059659505,210.44375228881836,4.553025894165034,0.026835598273682596,200.83900032043456,214.17324981689453,0.7698375216341184,-0.006426480140653264,0.9830283958719469,0.9932383988365026,1.024316641631392,0.017474952803445465,45.05059039007416,219.36736296750573,208.19337539672853,197.01938782595133,202.00142778669084,5.140963508977703,206.72767857142858,6.1911180012062434,203.26175941583494,205.45105384209438,-5.126171300356901,-3.445533306317713,5540200,3.632183052913065,0.5844521301930891,299464200.0,-41.54568087767056,95.95456447167889,96.5727530047212,-46.35862520395854,26.40760206684943,27.871424568712097,-0.056349071032004254,4.9981199685742,210.37435809326172,206.65281729125977,203.6449966430664,200.63717599487308,196.91563519287112,0.06,0.0,187.8723526182936,0.03344382686814229,-0.01038663008451106,201.7999986921038,206.5192860194615,5.714951274293455
2024-08-12,1,205.85000228881836,194.00499725341797,215.375,204.32187461853027,211.4987506866455,-1.0109053856321149,5.585801295847737,0.1595695451272312,2.9953689642561683,210.44375228881836,4.550401000976558,0.026829628856809156,200.83900032043456,214.17324981689453,0.8018233010545976,-0.020261627136170187,0.9887353432510749,1.002006704262767,1.0266602696865392,0.061055154264546774,45.610066155715074,219.36685291213004,208.19525032043458,197.02364772873912,201.3596420288086,4.101459269741579,206.3923214503697,6.094847151524299,203.63186531162907,205.55795068791556,-4.435935752133312,-2.8458867213025547,6936000,3.504935181585515,0.7465996133526801,306400200.0,-40.015671832544896,95.95456447167889,96.5727530047212,-33.72361862744659,26.043882947453984,26.454553343598153,-0.06143104885444604,4.889682229541238,210.37435809326172,206.65281729125977,203.6449966430664,200.63717599487308,196.91563519287112,0.06,0.0,187.94884249349414,0.057927187780817624,0.03540224502041593,201.5471409388951,206.22357177734375,5.710541444864104
2024-08-13,1,207.28999710083008,194.00499725341797,215.375,204.32187461853027,211.4987506866455,-0.9222765109228394,5.606133742702708,0.010976798766841434,2.9953660594796037,210.44375228881836,4.678438320159915,0.026946979062399668,200.83900032043456,214.17324981689453,0.804725922398382,-0.026069257691246173,0.99637994170079,1.0120037713331285,1.021769712742249,0.04646993996971971,46.722382659956814,219.25539282872816,208.04312534332274,196.83085785791732,202.2374986921038,4.66655516905998,206.23017828805106,6.033984926512285,204.19998573869736,205.94437321601865,-2.1358024411486936,-2.229926928015597,6387800,3.464704319601104,0.7072675455010485,312788000.0,-33.1502358856232,95.95456447167889,96.5727530047212,-9.343318610443077,26.42032733322308,25.380490076748686,-0.09303665773557529,4.732561850128483,210.37435809326172,206.65281729125977,203.6449966430664,200.63717599487308,196.91563519287112,0.06,0.0,188.02454435668113,0.03793554079285055,0.06690615163306612,202.80428423200334,206.17714364188058,5.550058524831216
2024-08-14,1,208.9650001525879,194.00499725341797,215.375,204.32187461853027,211.09000205993652,-0.8484592540960958,5.555681798868768,-0.016852897169918446,2.995372178933755,209.95125198364258,4.590951004028318,0.026730618833545924,200.83900032043456,214.17324981689453,0.7791112346180323,-0.037539189317097724,1.0054146315161623,1.0236808754819857,1.0207630689278566,0.032104333747891456,47.623038543895824,218.9509887655842,207.8396251678467,196.72826157010917,204.37464196341378,3.563096717355913,206.2355354854039,6.03656081249443,204.97997212361065,206.55261756367523,3.055008391499509,-1.08322402060752,6999800,3.341841799766903,0.7951584824534748,319787800.0,-24.127079525870112,95.95456447167889,96.5727530047212,29.84583510114881,29.041898639713814,23.962741397052977,-0.11164042341951276,4.654521492409962,210.37435809326172,206.65281729125977,203.6449966430664,200.63717599487308,196.91563519287112,0.02,1.0,188.11641244343133,0.04910185577032755,0.04941603941419775,204.9957144601005,206.28928702218192,5.151925304001458
2024-08-15,0,212.38500213623047,194.00499725341797,214.29249954223633,204.32187461853027,210.69500255584717,-0.9447074827223519,5.290284468243058,0.17166250306418318,2.995404603418789,209.26250076293945,4.334551010131838,0.025492997157585583,200.83900032043456,213.00125122070312,0.7830046246755752,-0.018356063819868266,1.02344784827249,1.0430894264664101,1.0309225927413086,0.044649131252098906,52.0822466131962,218.09969411196218,207.51912517547606,196.93855623898995,206.41749954223633,3.4536778040604608,206.34767832074846,6.14184401042746,205.9630905148614,207.00450199308347,7.711143068973888,0.03590442968002124,7001000,3.335377636081345,0.8205271250961051,326788800.0,-18.98781990921354,95.95456447167889,96.5727530047212,73.16645852093133,32.26824135282208,22.599497561677673,-0.0847716730727968,4.582769365915532,210.37435809326172,206.65281729125977,203.6449966430664,200.63717599487308,196.91563519287112,0.04,0.0,188.21953678014685,0.036704918076917004,0.055638769934458626,206.59714399065294,206.24000113351005,5.206835052936414
2024-08-16,0,212.83499908447266,194.00499725341797,214.29249954223633,204.32187461853027,210.69500255584717,-0.9566866309099481,5.266632862680087,0.19423732956508521,2.9954074292277033,209.26250076293945,4.315051040649417,0.025382005362824388,200.83900032043456,212.56250190734863,0.7729964714017973,0.008655397500649302,1.0257367902819308,1.0442519763742573,1.0240821766441206,0.03994429416180778,59.190609546930986,218.0280159389832,207.49475021362304,196.96148448826287,207.89892850603377,3.6915881545380684,206.41339247567313,6.210530851486262,207.55725402399185,207.74320576888934,7.219124677714554,0.7447286372612799,7931200,3.3900724643024445,0.93044590709736,334720000.0,-9.49390995460677,95.95456447167889,96.5727530047212,84.76808229322654,31.270727746272218,21.675376628860676,-0.01912222921286307,4.4368564954256655,210.37435809326172,206.65281729125977,203.6449966430664,200.63717599487308,196.91563519287112,0.06,0.0,188.34030879891355,0.039698727151576296,0.0485641663269344,208.5357164655413,206.46285792759485,5.39028587133014
