date,buy?,todays_price,Minimum,Maximum,25th Percentile,75th Percentile,Skewness,Standard Deviation,Kurtosis,Shannon Entropy,Median,Mean Absolute Deviation (MAD),Coefficient of Variation (CV),10th Percentile,90th Percentile,Autocorrelation,Cumulative Return,curr_to_avg_one_month,curr_to_avg_one_two_week,curr_to_avg_one_one_week,momentum,rsi,upper_band_current,middle_band_current,lower_band_current,rolling_mean_7,rolling_std_7,rolling_mean_14,rolling_std_14,ema_7,ema_14,roc_7,roc_14,Volume,Volatility,Relative Volume (RVOL),On-Balance Volume (OBV),Williams %R,Stochastic Oscillator %K,Stochastic Oscillator %D,Commodity Channel Index (CCI),ADX1,ADX2,Chaikin Money Flow (CMF),Average True Range (ATR),Fib_23.6,Fib_38.2,Fib_50,Fib_61.8,Fib_76.4,Parabolic SAR 2,Parabolic SAR 3,VWAP,Adj Close Momentum,Adj Close Return,Adj Close 7d MA,Adj Close 14d MA,Adj Close Volatility
2024-01-02,0,59.29249954223633,57.84500026702881,59.66499996185303,58.50874972343445,58.87812566757202,0.36733429661261985,0.42003923716986014,0.27163703738436995,2.9957066893740945,58.63499975204468,0.30760019302368136,0.007156242589009749,58.21574954986572,59.256999778747556,0.6522155323697001,0.006158067227448698,1.0101711289924205,1.0132698656959576,1.0127592958774725,0.018246608420962263,53.84650958696458,59.53557851439405,58.69550004005432,57.85542156571459,58.55214296068464,0.46431034476890426,58.771964345659526,0.5315997512495,58.60361689041631,58.633837312330314,-0.16548537631679855,0.3454605574589362,16322600,0.3536757364922409,1.0381012133737273,-9413100.0,-8.560359798726456,97.4757252269488,97.9254675000122,138.1281708673564,31.819028381695315,19.541272799344775,0.21419368160635607,0.6865508524726481,59.433480987548826,59.05826103210449,58.755001068115234,58.45174110412598,58.07652114868164,0.02,1.0,58.737233761951664,0.025720154286906105,0.03155713574816624,57.81113542829241,57.90746825081961,0.5268956101838258
2024-01-03,0,59.96249961853027,57.84500026702881,59.66499996185303,58.581249475479126,58.93375039100647,0.17842607871991964,0.4356004246288399,-0.12233773939000514,2.9957047856850445,58.65624952316284,0.33355018615722687,0.007416100541449367,58.21574954986572,59.30874967575073,0.6189421116902027,0.011127219634710207,1.020862011937989,1.023508468852233,1.020499326588231,0.027678971597250968,60.211891321394326,59.60832586451647,58.73712501525879,57.86592416600111,58.85464286804199,0.5974970478360504,58.82392862864903,0.6101037972646973,58.774861808922815,58.757556847290616,2.0744565209717725,0.7262359843372868,14830600,0.3664848876558186,0.9435463373528393,5417500.0,-8.791271747620705,97.4757252269488,97.9254675000122,189.88340158630302,34.271999788514066,18.369510522192556,0.2337467891422918,0.6642329088969513,59.55572087097168,59.157140937805174,58.83500099182129,58.512861045837404,58.114281112670895,0.04,0.0,58.79042105025005,0.023907102649946665,0.028120729484098588,58.08818108694894,57.945439202444895,0.5834365941145749
2024-01-04,0,59.932498931884766,57.84500026702881,59.96249961853027,58.581249475479126,59.04562497138977,0.4143663254975,0.5098830153652616,-0.11544781882041244,2.995694724098939,58.68624973297119,0.39657513618469264,0.008671000584724838,58.21574954986572,59.47600078582764,0.5767095792822203,0.022988993477332978,1.0192038519073194,1.021287997599552,1.0144123996895826,0.022215569075583863,67.82777639337819,59.823016057433406,58.803250026702884,57.78348399597236,59.0978570665632,0.6454376704208392,58.84303569793701,0.6418340531394382,59.0697476529387,58.93608415550993,3.660643688696502,1.2281589703208855,12912900,0.39249737132314655,0.818878553212457,-7495400.0,-17.921165575807958,97.4757252269488,97.9254675000122,149.13478225175672,31.498334809791317,18.231680625682777,0.19925624007160872,0.6585272465629819,59.60155900573731,59.194219429016115,58.864999771118164,58.53578011322021,58.12844053649902,0.06,0.0,58.83024890835027,0.017884483492507597,0.020491755005499573,58.29069137573242,57.933485303606304,0.6139403462153113
2024-01-05,0,59.6274995803833,57.84500026702881,59.96249961853027,58.581249475479126,59.24937462806702,0.35866731396414314,0.5635862186194395,-0.5120642799146187,2.9956864978878577,58.760000228881836,0.4489499282836917,0.009573545024926397,58.21574954986572,59.6917498588562,0.6643429633384045,0.024049539897969475,1.0128823826723883,1.0143361959112778,1.0048195591904074,0.015800677583166944,67.66381371798612,59.99629742198009,58.86912498474121,57.741952547502336,59.28071403503418,0.5748867554087409,58.85535703386579,0.6559854102825744,59.28490093251938,59.08282743780906,2.9237496188086918,0.44833481974820155,10411400,0.39142987791980255,0.6697092206108908,-17906800.0,-21.146980848559096,97.4757252269488,97.9254675000122,89.48870189861648,28.000397296570853,23.567406378826607,0.18988329323314285,0.6761172259672101,59.60155900573731,59.194219429016115,58.864999771118164,58.53578011322021,58.12844053649902,0.06,0.0,58.85117812076929,0.01565947348182295,0.016351493820090005,58.44679260253906,57.97778402056013,0.6311443973628903
2024-01-08,0,59.84749984741211,57.84500026702881,59.96249961853027,58.61312508583069,59.33312487602234,0.16367975077018815,0.580883937103892,-0.7725790788948541,2.9956837064039106,58.84250068664551,0.47584983825683624,0.009858147320892812,58.21574954986572,59.6917498588562,0.7299703773919209,0.016276789454927724,1.0156684194511973,1.0154185483000155,1.0053841145179983,0.017468534301007477,61.12809867741983,60.08601785704165,58.924249982833864,57.76248210862608,59.454642568315776,0.5274195510690063,58.94446420669556,0.7017613982272555,59.373210563012535,59.163572331120314,2.1937508234680747,0.29013321075999976,11554600,0.39991200933324234,0.743324722562375,-6352200.0,-5.376267636156805,97.4757252269488,97.9254675000122,116.67724598388506,28.216670821932674,21.314700823079683,0.2053138248270928,0.6833264731631128,59.60155900573731,59.194219429016115,58.864999771118164,58.53578011322021,58.12844053649902,0.06,0.0,58.88320881056332,0.020023790798787022,0.023148898728391383,58.643677847726,58.083961486816406,0.67658971516608
2024-01-09,0,59.9375,57.84500026702881,59.96249961853027,58.61312508583069,59.4981255531311,0.027210880388624986,0.6110852551411632,-0.9882643296586338,2.9956786081096984,58.89125061035156,0.5153498077392584,0.010360362396287175,58.21574954986572,59.85599975585937,0.7313391460802052,0.02098348677157293,1.016182629024513,1.013502090980814,1.0034319758525527,0.010878280773172877,63.96499182913416,60.20517050265293,58.98299999237061,57.76082948208828,59.63142830984933,0.4308753713424872,59.012678486960276,0.7504678800846399,59.49303226314653,59.257007568973364,2.076581495130023,2.1288403273003778,10493700,0.4008158081631452,0.676563752192899,4141500.0,-9.318945939257379,97.4757252269488,97.9254675000122,104.84429375312793,26.36009293670504,19.91225322647614,0.211897058105671,0.6694906950794879,59.60155900573731,59.194219429016115,58.864999771118164,58.53578011322021,58.12844053649902,0.06,0.0,58.911102573671755,0.0030090880912287954,0.018157219172569433,58.81946836199079,58.152871540614534,0.7009085365259368
2024-01-10,0,60.202500343322754,57.84500026702881,59.96249961853027,58.62249994277954,59.63687467575073,-0.11102708066573681,0.6387043159603278,-1.0885707896854062,2.995673749465916,58.950000286102295,0.5513998222351078,0.01081651367860418,58.21574954986572,59.93299903869629,0.7608631091082431,0.018219642605997784,1.0195346299964105,1.0150523388753816,1.0056964952429206,0.004002513676369723,64.30764231912306,60.32640860903248,59.04899997711182,57.77159134519116,59.82892826625279,0.29114323569103023,59.10446419034685,0.8138370226447612,59.60601371692432,59.34861260257343,2.108177503843088,1.6191241850900877,12258000,0.39857265301297434,0.7961317014083958,16399500.0,-7.142829338928225,97.4757252269488,97.9254675000122,119.71928160070856,28.37657606504764,18.8100850151424,0.1752094382235272,0.6494688038856129,59.71616017150879,59.28692037200928,58.94000053405762,58.59308069610596,58.163840896606445,0.08,0.0,58.9502733471929,0.004002684871887041,0.0063524329324519575,58.9980719430106,58.24920490809849,0.7409181263192421
2024-01-11,0,60.0024995803833,57.84500026702881,60.202500343322754,58.62249994277954,59.7106249332428,-0.14394216730671863,0.6843290938226748,-1.1473251890988407,2.9956652309403866,59.108749866485596,0.5998748779296875,0.011576063017056343,58.21574954986572,59.939999961853026,0.7754058576577342,0.016333260610333213,1.0149980800076852,1.0085258863206619,1.0015523387807508,0.0011679914861899565,66.34891027977994,60.48453314568367,59.11587495803833,57.747216770392995,59.93035684313093,0.17269589544353353,59.241249901907786,0.7903555714682309,59.75852714674623,59.44426815344584,2.3503904787180736,2.1810155498726544,13754200,0.39489789084530746,0.8908327941392682,2645300.0,-20.408120897414438,97.4757252269488,97.9254675000122,80.80117006771415,26.29855518723482,21.15837784892364,0.10716521538963991,0.6429049275553768,59.71616017150879,59.28692037200928,58.94000053405762,58.59308069610596,58.163840896606445,0.08,0.0,58.982331120841536,0.0008367402638000954,-0.00250165380973394,58.996665954589844,58.40390069144113,0.7527376338538575
2024-01-12,0,60.19999980926514,57.84500026702881,60.202500343322754,58.62249994277954,59.86874961853027,-0.193721842522646,0.7109355066924627,-1.2642347871300235,2.9956599943050843,59.13749980926514,0.6382498741149902,0.012018333547337992,58.21574954986572,59.96649961471557,0.8096815019496232,0.005656576196196341,1.0176783554157267,1.0095166230003798,1.004614215450755,0.00960127848577752,60.607836705137345,60.57612096760856,59.15424995422363,57.7323789408387,59.96428544180734,0.2010635705179399,59.40946415492466,0.7175893905541837,59.8216138646297,59.47345333563022,1.1974533771193308,3.296750547758352,13216900,0.38806630731071473,0.8643742297204545,15862200.0,-2.8688415664656652,97.4757252269488,97.9254675000122,107.4877659096139,26.667454361962136,19.41257591875325,0.10075388171968304,0.6434842968008002,59.88415940856934,59.527919609069826,59.239999771118164,58.9520799331665,58.59584013366699,0.1,0.0,59.02105357335712,0.012066415452129275,0.010542188108211578,59.057137625558035,58.57265935625349,0.7823128417541589
2024-01-16,0,60.16499996185303,57.84500026702881,60.202500343322754,58.62249994277954,59.933749198913574,-0.15588939157456622,0.7391549851252688,-1.3108753667904265,2.9956542227597223,59.13749980926514,0.6649998664855957,0.01248973464105528,58.21574954986572,60.02224960327148,0.8180812640172311,0.012530467090922206,1.0166269582492145,1.0063981963451474,1.0021153277250057,0.0053051525168206215,64.41016352101789,60.65930991684478,59.18099994659424,57.702689976343706,59.997499874659944,0.21374162862071358,59.54767847061157,0.6567051650112942,59.9146852211956,59.51578823957656,0.3960812044957985,4.071224014806789,11826900,0.3861417613526081,0.8013812033964973,4035300.0,-19.583243926280904,97.4757252269488,97.9254675000122,83.1906753425956,24.708345843781874,18.2397732016752,0.1274391641888102,0.6383514159769305,59.89359962463379,59.54319995880127,59.260000228881836,58.976800498962405,58.626400833129885,0.1,0.0,59.049714534800714,-0.001996316030745904,0.0053629162533424465,59.08948353358677,58.6900874546596,0.7999067469500152
2024-01-17,0,59.97000026702881,57.84500026702881,60.202500343322754,58.62249994277954,59.94374990463257,-0.17486760173534457,0.7679510539634267,-1.3968535236471413,2.9956481147850087,59.13749980926514,0.7004998207092286,0.012968531663466655,58.21574954986572,60.16849994659424,0.8553562939806784,0.02670649401602723,1.012724500223299,1.0008845660788763,0.9978120400976752,0.0005422359462574633,68.92199938627749,60.752402008744724,59.21649990081787,57.68059779289102,60.046428544180735,0.14213304247556113,59.663571289607454,0.5654334608991792,59.974934841254566,59.56324850284554,0.38793815394299963,3.323030113048813,8982100,0.3247271193910468,0.7517260339779397,-4946800.0,-22.81543509821931,97.4757252269488,97.9254675000122,68.4475345306986,23.46030217862254,17.706994795124906,0.10680108576658488,0.6184584110837795,59.97383966064453,59.673080017089845,59.43000030517578,59.18692059326172,58.88616094970703,0.1,0.0,59.06881206901053,-0.0001666915638375288,-0.0019963160307458583,59.134486607142854,58.79063960484096,0.8006819199281006
2024-01-18,0,59.902499198913574,57.84500026702881,60.202500343322754,58.68249988555908,59.96437478065491,-0.3678048259936841,0.7710000414831002,-1.3136022673966599,2.99564756996331,59.459999561309814,0.7004998111724852,0.01300497667584129,58.21574954986572,60.16849994659424,0.8912902005249346,0.01674225727050448,1.010415775604791,0.9986288082325052,0.9965811407219818,-0.004983200742466387,62.13870913620775,60.82700002574575,59.28499994277954,57.74299985981334,60.05428559439523,0.1303339991103729,59.7544640813555,0.4827366825301809,59.97261515318792,59.599185046924944,0.5744005518523977,2.78075229215674,10397700,0.3222296588748907,0.893838756223332,-15344500.0,-15.54399946238472,97.4757252269488,97.9254675000122,59.75047578774432,21.373501128891892,19.817043904819542,0.15123747693183817,0.6249338048453579,60.00451901245117,59.72273896789551,59.494998931884766,59.26725889587402,58.98547885131836,0.1,0.0,59.08923631516773,-0.0006644867279348432,0.0026666129326949066,59.14151818411691,58.89259801592146,0.817960624092274
2024-01-19,0,60.0024995803833,57.84500026702881,60.202500343322754,58.68249988555908,59.96437478065491,-0.5061384739504753,0.7789833285173722,-1.2644543526150278,2.9956458870815883,59.737499713897705,0.7108998250961307,0.013129448852111397,58.21574954986572,60.16849994659424,0.8960945392121328,0.01671827037318558,1.0113178554653874,1.0003959707135746,0.9992422697960851,0.0,60.73819018084556,60.88896655594525,59.33099989891052,57.77303324187579,60.0635712487357,0.12271991178961095,59.84749977929251,0.3780413991347914,59.95254922921506,59.61242603440226,0.09189916310905524,2.1703890192543804,14193100,0.3222779325723238,1.2223123613465063,-1151400.0,-34.426116738201,97.4757252269488,97.9254675000122,50.23506766659633,20.281440801532153,18.221200876802534,0.14690661590338214,0.6261207094160048,60.0281195526123,59.76093984222412,59.545000076293945,59.32906031036377,59.06188059997559,0.1,0.0,59.11397719249325,0.0003343774123878429,-0.00614619647809804,59.11761038643973,58.96853937421526,0.8133958386779285
2024-01-22,0,59.709999084472656,57.84500026702881,60.202500343322754,58.68249988555908,59.97812509536743,-0.6615443833777415,0.7860461003475415,-1.1491679280952407,2.9956444121184793,59.87499952316284,0.7129498481750488,0.013236386178243159,58.21574954986572,60.16849994659424,0.8619967573131282,0.032967505477583516,1.0054685167131845,0.9954030626729915,0.9943711584008227,-0.008139546949252119,68.77531004758644,60.957342053829244,59.385249853134155,57.81315765243907,59.99321392604283,0.16402335835748308,59.91107109614781,0.24249861184325794,59.96217533661998,59.63610491165247,0.1084455981368939,2.218909327683812,14314300,0.24629351074546296,1.250993568189038,-15465700.0,-49.72061086271785,97.4757252269488,97.9254675000122,23.786805527804887,18.686225543879694,19.284987424049167,0.18406848849771137,0.6264241820911158,60.037558868408205,59.776218734741214,59.564998626708984,59.353778518676755,59.092438385009764,0.1,0.0,59.13093690719693,-0.013578382901286101,-0.0040127233164589686,59.02901186261858,59.013541902814595,0.695892240435103
2024-01-23,0,59.709999084472656,57.84500026702881,60.202500343322754,58.790000438690186,59.97812509536743,-0.87636682780099,0.7296249243077876,-0.6898052092006419,2.9956567285740325,59.87499952316284,0.6399623060226431,0.012269537641018064,58.33575067520142,60.16849994659424,0.8093124468669982,0.03224131400872138,1.0040968405885253,0.9952661818859827,0.9959966549527144,-0.007562550946046076,61.18045985394132,60.92562467504685,59.46637482643128,58.00712497781571,59.95142814091274,0.1955010796038889,59.94089249202183,0.17755199999765142,59.89780129417456,59.653181461143376,-0.8180744255495404,1.5130881097615894,14481600,0.25018388740098685,1.2505515894844377,-15465700.0,-44.52562671069815,97.4757252269488,97.9254675000122,26.13728995223617,17.421370650864763,17.979602842890163,0.1725416172765897,0.619710754136025,60.13667933654785,59.93665949249267,59.77499961853027,59.613339744567874,59.4133199005127,0.1,0.0,59.149318703334444,-0.002333747989323287,-0.008941866605750777,59.03463690621512,59.015651430402485,0.6003845971395623
2024-01-24,0,59.35249996185303,58.22999954223633,60.202500343322754,59.17437481880188,59.97812509536743,-0.9577064363761817,0.6286349056168541,-0.5834503192314728,2.995676382335675,59.87499952316284,0.5337748146057123,0.010554715683198136,58.601750183105466,60.16849994659424,0.8092901351425972,0.025416444339190332,0.9965223957293272,0.9895340594213867,0.9915384572760354,-0.010296820117162486,59.22180383643753,60.81689457853718,59.55962476730347,58.302354956069756,59.83035673413958,0.2657201295083971,59.89732108797346,0.23680268080492992,59.8496607580436,59.67786867642881,-0.4874805182387304,0.7041355069521519,16370500,0.24157413956167206,1.3702293494664473,-31836200.0,-98.72608524513686,97.4757252269488,97.9254675000122,-61.94597661872736,15.42270285034317,22.728695132084457,0.0879673883804898,0.6459803782463489,60.08947915649414,59.86025920104981,59.67499923706055,59.48973927307129,59.26051931762695,0.02,1.0,59.15101971239993,-0.01800304190152824,-0.018003041901528224,58.82650102887835,58.94181932721819,0.5469436221327438
2024-01-25,0,58.999999046325684,58.347500801086426,60.202500343322754,59.33749985694885,59.97812509536743,-1.0201268745403158,0.552975314887305,-0.28196646585599794,2.9956891172569886,59.87499952316284,0.4551997852325428,0.009275658141533192,58.692999839782715,60.16849994659424,0.753431743545213,0.01722437374297767,0.9896713411448257,0.984617427800742,0.9876873828242448,-0.015066151907803138,48.38577664607345,60.721700418058916,59.615749788284305,58.50979915850969,59.66392803192139,0.3668017931523478,59.83071395329067,0.33636288159902683,59.72474693515262,59.6503668284849,-1.4078070599622727,-1.0173019146265498,14899700,0.2600533677520019,1.2043928080943294,-46735900.0,-72.22221044846025,97.4757252269488,97.9254675000122,-105.45138497894985,14.472770697518678,24.106496099712537,0.12883460512324008,0.6355430361141552,60.03519926452637,59.772399375915526,59.55999946594238,59.34759955596924,59.084799667358396,0.04,0.0,59.146718869267104,-0.016622312330788813,-0.013835639391655868,58.70977619716099,58.89962986537388,0.49996831393068175
2024-01-26,0,59.3100004196167,58.63000011444092,60.202500343322754,59.33749985694885,59.97812509536743,-0.883637369058983,0.49320582732701046,-0.5621035788589963,2.9956980048463024,59.87499952316284,0.4116124200820927,0.008268554337030304,58.808000564575195,60.16849994659424,0.708120035180863,0.006310744178109471,0.9943271835548192,0.991781156969051,0.9958861735445793,-0.011541171877996304,39.00368822477231,60.63478635520028,59.64837470054626,58.66196304589224,59.56964233943394,0.35977245858825746,59.80803544180734,0.3609246607897476,59.54475842996439,59.58889969033968,-1.9363432498396078,-1.555916910154036,13025100,0.26904629430369637,1.0341993809937449,-33710800.0,-60.55558969946531,97.4757252269488,97.9254675000122,-64.15223936006909,17.8012831973811,23.02826349489518,0.12082503922882896,0.6145057571050494,60.03519926452637,59.772399375915526,59.55999946594238,59.34759955596924,59.084799667358396,0.04,0.0,59.15107707066382,-0.007688498360343132,-0.013131678915316842,58.6225836617606,58.87853513445173,0.45372838874580895
2024-01-29,0,59.50749969482422,58.69999980926514,60.202500343322754,59.341875076293945,59.97812509536743,-0.8665155012013539,0.4426810419367325,-0.396164477734545,2.995704705918372,59.87499952316284,0.3674124002456665,0.0074172826407241125,58.981999206542966,60.16849994659424,0.6711859698010212,0.01039183325951699,0.997069905113301,0.9962373768283725,1.00153156406406,-0.0033913815567465644,46.65778605581156,60.56773679967852,59.682374715805054,58.79701263193159,59.51321383884975,0.3284803701342019,59.78374971662249,0.36940420696419,59.486834673416325,59.57672967860653,-1.1005500157967714,-0.532471029308522,14547100,0.2766485636002597,1.127530959026425,-19163700.0,-40.55554731392217,97.4757252269488,97.9254675000122,-34.094181830390696,20.144203056350015,21.26424401193329,0.15383648686262044,0.6149233898013846,60.03519926452637,59.772399375915526,59.55999946594238,59.34759955596924,59.084799667358396,0.04,0.0,59.161742225507226,0.0026858617082727854,-0.001671457742760665,58.56211144583566,58.85181481497629,0.3953285262464044
2024-01-30,0,59.80500030517578,58.820000648498535,60.202500343322754,59.46874976158142,59.97812509536743,-0.8107632386245707,0.3842035990532014,-0.27143134926152435,2.995711544671776,59.87499952316284,0.3174750328063965,0.006433119722689798,59.263249492645265,60.16849994659424,0.6003668241891507,0.011688184949777504,1.0013772071026878,1.0023800458589427,1.0072251526938178,0.0015910437474420114,50.498318692157596,60.49115690818941,59.72274971008301,58.954342511976606,59.484999656677246,0.28506217038696435,59.77428545270647,0.3668505786149432,59.49333303143264,59.59290905205772,-0.6594040471962802,-0.5681108708881056,22061500,0.2784796660238903,1.629029608147548,2897800.0,-31.11098866398649,97.4757252269488,97.9254675000122,5.083452700782101,21.568672361875553,19.765216972803167,0.169339958515228,0.611525767276089,60.03519926452637,59.772399375915526,59.55999946594238,59.34759955596924,59.084799667358396,0.04,0.0,59.185460565594624,0.0008354819822651294,0.005539748333411394,58.57195608956473,58.84478323800223,0.34597378189780426
2024-01-31,0,59.83250045776367,58.999999046325684,60.202500343322754,59.59749960899353,59.97812509536743,-0.7302940572184368,0.32369323336512745,-0.30402283422337995,2.995717590392685,59.87499952316284,0.26660011291503877,0.005415466021349891,59.30825033187866,60.16849994659424,0.6195252118879663,0.008643601920920523,1.0010121924171456,1.0034464386035518,1.007365949542008,0.008087283538505519,54.32950819123603,60.419386159647125,59.77199969291687,59.12461322618662,59.502499852861675,0.3042890380587601,59.74785688945225,0.3463850614428868,59.57255013120812,59.655895248207074,-0.32915174632506183,-0.22106309876824817,22837000,0.2665344347623251,1.6466878586604339,25734800.0,-53.88876761914047,97.4757252269488,97.9254675000122,-11.44613762402237,23.642986322567705,17.12015841762721,0.058407960935058886,0.6528338000094855,60.03519926452637,59.772399375915526,59.55999946594238,59.34759955596924,59.084799667358396,0.02,1.0,59.20644208949702,0.009845617129243811,-0.006014965253752077,58.56070600237165,58.79485893249512,0.35299314599381515
2024-02-01,0,60.22999954223633,58.999999046325684,60.202500343322754,59.68937420845032,59.97812509536743,-0.9481620297437341,0.304524718629973,0.4233662876282698,2.9957192858568296,59.87499952316284,0.23755012989044105,0.005092471779806857,59.348250007629396,60.16849994659424,0.7456992727072689,-0.002168007698038455,1.0072074751321334,1.0103458520065909,1.0124220395973285,0.020847466369361634,51.2852543823807,60.40804917595319,59.79899973869324,59.18995030143329,59.576785632542204,0.40888509787351973,59.76410688672747,0.36413181300068215,59.638916483442934,59.703440152028556,0.20516056802766158,-0.6145922236602253,15870900,0.21939656976188304,1.1401131859148332,41605700.0,-1.2765446287404347,97.4757252269488,97.9254675000122,163.449940829504,25.394606481108813,14.207656354323994,0.11796524922100353,0.7276439635448012,60.455398681640624,60.11229890441894,59.834999084472656,59.55769926452637,59.21459948730469,0.04,0.0,59.23811761217805,0.03076397556415289,0.03513833573240645,58.71962029593332,58.87712860107422,0.43868512687139233
2024-02-02,0,60.614999771118164,58.999999046325684,60.22999954223633,59.68937420845032,60.0024995803833,-0.8481973551040252,0.3170297221572139,0.21407647431421672,2.995718205151584,59.87499952316284,0.24765007019042998,0.005300403529578363,59.348250007629396,60.2002498626709,0.6862440213990848,0.004963928013241724,1.0134190464731974,1.0162458514903223,1.0146977532511063,0.02200302381164443,59.904686688668306,60.44643417919297,59.81237473487854,59.17831529056411,59.75714274815151,0.5481796924039343,59.79374974114554,0.41560058316430976,59.78589180403354,59.7884289631513,0.8708766801821906,0.37915080778968785,17543500,0.2370763747693605,1.239648982227941,59149200.0,-19.99990260341083,97.4757252269488,97.9254675000122,161.59887800998098,23.44241083234574,13.11545101006456,0.1445136779955821,0.7293151720885701,60.455398681640624,60.11229890441894,59.834999084472656,59.55769926452637,59.21459948730469,0.04,0.0,59.27395229123462,0.01970693109838595,0.02332652012538224,58.94885090419224,58.8876759665353,0.46398323818201537
2024-02-05,0,60.17000102996826,58.999999046325684,60.614999771118164,59.68937420845032,60.04312467575073,-0.3105147469526628,0.36170731613669066,0.17216076319887952,2.9957139973044455,59.87499952316284,0.2763500356674193,0.006043917647405446,59.348250007629396,60.20525026321411,0.6624853592035869,0.016561153791190306,1.00540551668576,1.0077503367718723,1.0028667801572697,0.011133072949486733,68.07287968243138,60.56991440911359,59.84649977684021,59.12308514456683,59.924285888671875,0.44807615064732664,59.79410696029663,0.4159462336679124,59.99276577289393,59.92111247363925,2.1271215367112912,0.689368709581219,12759600,0.2380218614062032,0.8941931685985395,46389600.0,-41.27651216321071,97.4757252269488,97.9254675000122,54.321845979945465,21.850528188184303,15.825897990675552,0.11450317814363822,0.7241507328018121,60.455398681640624,60.11229890441894,59.834999084472656,59.55769926452637,59.21459948730469,0.04,0.0,59.29008380146797,0.005190083903545251,0.011285215878983157,59.07260731288365,58.89119175502232,0.462485979416286
2024-02-06,0,59.90749931335449,58.999999046325684,60.614999771118164,59.709999084472656,60.166250228881836,-0.4810311771689676,0.36459705391865976,0.20717259821408396,2.995713714421202,59.91999959945679,0.2787625741958621,0.006089443470914287,59.348250007629396,60.20525026321411,0.7431180923851899,0.005388716042915831,1.0005657660467406,1.002581439205337,0.9962913844541886,0.0017138869267732115,56.012258861714116,60.60281895715677,59.873624849319455,59.14443074148214,60.00964287349156,0.35976100128871785,59.78964260646275,0.41424508213407313,60.038400327342096,59.97410803981976,1.983054241617724,0.008312254829893208,12775200,0.25873248381617925,0.8914735984893685,33614400.0,-45.531931471759854,97.4757252269488,97.9254675000122,5.3875657381716735,20.990004889514726,17.331423641763916,0.09919718999353404,0.697845102456769,60.455398681640624,60.11229890441894,59.834999084472656,59.55769926452637,59.21459948730469,0.04,0.0,59.30158864209456,0.0006677499975578094,0.00351589258835907,59.15276827130999,58.8876759665353,0.4600752392511672
2024-02-07,0,60.052499771118164,58.999999046325684,60.614999771118164,59.709999084472656,60.166250228881836,-0.5055791616942806,0.3646165932398481,0.22272051936574888,2.995713713366043,59.922499656677246,0.2785500526428223,0.006089464700457284,59.348250007629396,60.20525026321411,0.747481094239671,-0.0005005328324589416,1.002937288950782,1.004676021232138,0.9983624503045246,0.003676919929324951,50.21873049276287,60.60585800909627,59.87662482261658,59.14739163613688,60.087500027247835,0.2839673265666366,59.800356933048796,0.41929766995369944,60.00671657772541,59.97191611381937,1.0074167754350092,-0.10422036584295148,10259900,0.2653836618860203,0.716536510894115,43874300.0,-43.404140653660974,97.4757252269488,97.9254675000122,39.89258675161557,22.138847039439863,16.811132562078104,0.059808965165006944,0.6661560176205258,60.455398681640624,60.11229890441894,59.834999084472656,59.55769926452637,59.21459948730469,0.04,0.0,59.31288997509731,0.008404726500832904,0.001502469840465197,59.18933323451451,58.87572234017508,0.45996129532565405
2024-02-08,0,59.77500057220459,58.999999046325684,60.614999771118164,59.709999084472656,60.166250228881836,-0.5398759253802958,0.3664334976662046,0.1943011782188382,2.9957135301280338,59.93874979019165,0.2831500434875494,0.0061192212035959155,59.348250007629396,60.20525026321411,0.7355376591870005,-0.0024916003712332005,0.998206914149506,0.9988637039750807,0.9930226876957723,-0.0075543578530608,51.758573082948786,60.6152418065049,59.88237481117248,59.14950781584007,60.0832143511091,0.2891210538385234,59.78410700389317,0.4152498247829767,60.01869055131718,59.97744942719445,0.9158510760641952,0.250407869806057,12874800,0.2603443442163539,0.8972248665117725,30999500.0,-50.212649219690995,97.4757252269488,97.9254675000122,-26.811112060398475,20.70118472021786,21.653441734791798,0.08111768367430218,0.6597916431830823,60.455398681640624,60.11229890441894,59.834999084472656,59.55769926452637,59.21459948730469,0.04,0.0,59.32080541158851,-0.01885860122392491,0.005715187965458222,59.17948859078543,58.87572234017508,0.4545027451004465
2024-02-09,0,59.410000801086426,58.999999046325684,60.614999771118164,59.709999084472656,60.08062481880188,-0.42958999449169627,0.35954006955984097,0.2920098013459782,2.995714220168902,59.90499925613403,0.274649977684021,0.006006248987241275,59.348250007629396,60.20299978256226,0.7382567551172233,-0.0037914921839870734,0.9924658956103878,0.9914803900851276,0.988453359353634,-0.01987955084684989,47.26947375394936,60.58007996173626,59.86099982261658,59.141919683496894,60.022857257298064,0.38000089448155283,59.762678555079866,0.42694409561691044,59.95819653586217,59.93596790004374,-0.05016258309189424,-0.37914921839870735,15235300,0.2639048975552648,1.0562732625998925,15764200.0,-61.70203786130076,97.4757252269488,97.9254675000122,-95.71603430606211,18.88001206650426,23.927270933528064,0.15727718788768894,0.6701240822742249,60.455398681640624,60.11229890441894,59.834999084472656,59.55769926452637,59.21459948730469,0.02,1.0,59.32230174727229,-0.016187567604484587,-0.023286245186853106,59.18933268955776,58.8750193459647,0.4595873188961512
2024-02-12,0,59.519999504089355,58.999999046325684,60.614999771118164,59.65937423706055,60.08062481880188,-0.2438831788335341,0.37089125280745056,-0.1008575409810537,2.9957130500702243,59.86749982833862,0.29023749828338624,0.006198942503472246,59.348250007629396,60.20299978256226,0.684928578692493,-0.013122907154181176,0.9947957843160402,0.9931503888515298,0.9942702371790227,-0.01080275078531523,40.10529950437236,60.57315738926664,59.83137488365173,59.089592378036826,59.92142868041992,0.4091348146069231,59.74910715648106,0.4317402909954672,59.82183698867995,59.84548369648081,-0.7061373892864341,-0.5024255367376882,13516800,0.2702206992821821,0.9361553000527059,29281000.0,-55.74461315698057,97.4757252269488,97.9254675000122,-70.42691548333383,19.193257078156662,21.856556232148414,0.1619919434194002,0.6796732112205789,60.455398681640624,60.11229890441894,59.834999084472656,59.55769926452637,59.21459948730469,0.04,0.0,59.325144822652085,-0.005662898479018574,-0.01387508537871537,59.00932366507394,58.86447198050363,0.44390901675365235
2024-02-13,0,59.57499980926514,58.999999046325684,60.614999771118164,59.51687455177307,60.01499962806702,-0.054820933536543145,0.3666849259680423,-0.06258444929233287,2.9957134696278422,59.81875038146973,0.2881375646591188,0.006132124140483978,59.348250007629396,60.176000881195066,0.6944818027394879,-0.010720526189190185,0.9962811902760409,0.994047390624993,0.9973548928879237,-0.005550215046536522,42.70349481069571,60.530744720329025,59.79737486839294,59.06400501645686,59.772857257298064,0.2854252995323128,59.76500000272478,0.41995199093327923,59.747058515876,59.76657128283432,-1.1788146165418525,-0.31820395795770395,24195700,0.2723379506253924,1.6069328229197315,53476700.0,-70.63833724542967,97.4757252269488,97.9254675000122,-37.26858765870022,24.369266955926257,17.946793264903384,0.1434272120631517,0.7670093101349066,60.455398681640624,60.11229890441894,59.834999084472656,59.55769926452637,59.21459948730469,0.06,0.0,59.334104596824034,-0.009843224840015208,-0.011492377473125138,58.841971261160715,58.89541108267648,0.4541233561082066
2024-02-14,0,59.27250003814697,58.999999046325684,60.614999771118164,59.51687455177307,59.97812509536743,0.12328208427446707,0.3595868564910047,0.12902468059327266,2.9957141792119777,59.790000438690186,0.28158763408660903,0.0060163901983917864,59.348250007629396,60.176000881195066,0.7149821996385244,-0.0065866342505394495,0.9917116875282815,0.9893796812908667,0.9933966287145851,-0.012988630547338675,44.791659081196926,60.487048573745554,59.76787486076355,59.04870114778154,59.64464282989502,0.2787971797156818,59.78446435928345,0.38677179380740023,59.70502170530921,59.719921455060174,-1.7157468708736456,0.37487864463184234,15872500,0.2702703911997988,1.030575414616283,37604200.0,-77.47745116064877,97.4757252269488,97.9254675000122,-93.89444246124272,23.062550271632706,16.984459263177765,0.13927258343423257,0.7511178121225597,60.486078933715824,60.16195931243897,59.89999961853027,59.63803992462158,59.31392030334472,0.06,0.0,59.33353014677331,-0.011668610756880193,-0.010844181447580037,58.73649706159319,58.90455218723842,0.4647695287974167
2024-02-15,0,59.385000228881836,58.999999046325684,60.614999771118164,59.48312497138977,59.931249380111694,0.26739164482800415,0.3719052536454444,-0.06490647474561317,2.9957129016136834,59.74249982833862,0.2962501049041748,0.006226127175658357,59.306250381469724,60.176000881195066,0.6884203157256201,-0.010517076402348629,0.994174080971733,0.992184990894191,0.9978911298716872,-0.006524472431441608,39.851760283237006,60.47681035661034,59.732999849319455,58.98918934202857,59.57000010354178,0.2663604067445101,59.78982148851667,0.380157380776764,59.5967534063613,59.65196677382852,-1.4916087360116213,0.4618660952982837,13695800,0.27740790442056534,0.8798255483973753,51300000.0,-72.52246292264576,97.4757252269488,97.9254675000122,-70.99357034110582,22.000019304511937,16.201956299959292,0.11872984493865542,0.7298377083504118,60.486078933715824,60.16195931243897,59.89999961853027,59.63803992462158,59.31392030334472,0.06,0.0,59.33423647329015,-0.007187002746664839,-0.009834956236330919,58.66055570329939,58.90666198730469,0.4614632686355346
2024-02-16,0,59.32999897003174,58.999999046325684,60.614999771118164,59.40375065803528,59.931249380111694,0.41865420569245976,0.37717726607620133,-0.10478360263187092,2.995712337738161,59.709999084472656,0.30316246032714816,0.0063171232361757,59.306250381469724,60.176000881195066,0.7053507312796611,-0.01029122712920021,0.993683736548819,0.9926674929703273,0.9982753357820952,-0.0013466054532224048,41.97332759370314,60.46147943297028,59.707124900817874,58.95277036866547,59.46678570338658,0.17122564340931412,59.77714286531721,0.3930390401995201,59.5428436100086,59.60605993296424,-0.8721764227541067,0.12645390108668864,13943300,0.2777375408232778,0.8964443562928005,37356700.0,-72.97301012614291,97.4757252269488,97.9254675000122,-73.68439742611214,20.537965870684275,16.837013668616148,0.15094260553553246,0.7247412292773376,60.486078933715824,60.16195931243897,59.89999961853027,59.63803992462158,59.31392030334472,0.06,0.0,59.33404297993819,-0.002854300611445315,-0.0073541679512242894,58.57617623465402,58.88275473458426,0.46632523081027516
2024-02-20,0,60.16249942779541,58.999999046325684,60.614999771118164,59.376875162124634,59.85125017166138,0.6054987257931789,0.3793164057677388,0.02841753066223962,2.9957120963251116,59.6424994468689,0.3072500228881836,0.006356530228529899,59.306250381469724,60.176000881195066,0.735460599738207,-0.006364095130923147,1.0081945848418135,1.008765117626202,1.0125554302483726,0.01079468966833419,42.275206583250295,60.432132681835775,59.67349987030029,58.914867058764806,59.522142682756694,0.30096504242769406,59.80267851693289,0.40637521528886034,59.48722914621011,59.56379849571614,-1.2031152805297667,-0.29828294870859606,18339300,0.27101776905289693,1.164011626596967,55696000.0,-13.963870307014755,97.4757252269488,97.9254675000122,126.43669302062,29.17938056927392,14.549346911138931,0.22164170081042547,0.7775859121881443,60.486078933715824,60.16195931243897,59.89999961853027,59.63803992462158,59.31392030334472,0.02,1.0,59.357214395419184,0.016750455074519,0.01914035916393735,58.69852665492466,58.93900762285505,0.5142019820426627
2024-02-21,0,61.08500099182129,58.999999046325684,60.614999771118164,59.376875162124634,59.94374942779541,0.4632555812201939,0.394028505329943,-0.4067660694231332,2.99571051158053,59.6424994468689,0.3298750400543213,0.006600570909296521,59.306250381469724,60.176000881195066,0.6274089236792926,0.007578300958983347,1.0232657665296203,1.0242458986907226,1.0258628147600937,0.025346222197071944,58.45969156625793,60.484181898126316,59.69612488746643,58.90806787680655,59.76142842429025,0.6548061253098602,59.89214284079416,0.5319223534174804,59.654398556318085,59.6556820610074,0.6482624038167011,0.5977746355578388,14378300,0.3313006543093516,0.9129027199209655,70074300.0,-1.606310648376531,97.4757252269488,97.9254675000122,216.47705309873106,31.760594446788588,13.744874006924235,0.23881310374615805,0.7632096624052573,60.69235928344727,60.32881959533692,60.03499984741211,59.7411800994873,59.37764041137695,0.04,0.0,59.38812322877179,0.031845045679842254,0.02579566965860908,58.934788840157644,59.0620607648577,0.6093865333442064
2024-02-22,0,60.972500801086426,58.999999046325684,61.08500099182129,59.376875162124634,60.079999685287476,0.9046530065707716,0.4969618741863262,0.4592763004757314,2.9956977869085613,59.67500019073486,0.39862513542175293,0.008315283422395974,59.306250381469724,60.268499565124515,0.5209755033339787,0.029190026217628118,1.0202062803377308,1.0203449951580283,1.0188063039257156,0.028681104421871106,70.55065123255129,60.75879873120651,59.76487498283386,58.77095123446121,59.96892860957554,0.7831177498238705,59.94517864499773,0.6007613817302467,60.009493141526164,59.85421845688255,2.8193909580021965,2.093344795011148,12982800,0.37426740291752447,0.833261396066481,57091500.0,-5.220777708667184,97.4757252269488,97.9254675000122,160.13832711576984,29.489890473416896,15.90796290293109,0.322212809834277,0.7622498205508392,60.69235928344727,60.32881959533692,60.03499984741211,59.7411800994873,59.37764041137695,0.04,0.0,59.41277156448416,0.03137120752489664,0.030328586951142166,59.138705662318635,59.07401466369629,0.6366194243489798
2024-02-23,0,61.22749996185303,58.999999046325684,61.08500099182129,59.40375065803528,60.16437482833862,0.7605158862963625,0.5521099940646385,-0.1762371788163044,2.9956898161742895,59.790000438690186,0.44280004501342773,0.00922553131416136,59.306250381469724,60.65074987411499,0.6151392708347011,0.03343223367193567,1.0230863854273173,1.023037237114822,1.0172877843467667,0.03102634884010813,69.99933293624674,60.95009501292481,59.84587502479553,58.74165503666625,60.20500005994524,0.886787676752182,59.98892865862165,0.671437941349905,60.24836356617993,60.019894536841186,2.4403583822228954,1.2327764643753951,13612900,0.3629589588082018,0.8773253271626441,70704400.0,-14.84093510022686,97.4757252269488,97.9254675000122,170.49956639153893,31.29629413827755,14.956037731178208,0.2618532926922219,0.7519263061663963,60.952119400024415,60.53893968963623,60.204999923706055,59.87106015777588,59.457880447387694,0.06,0.0,59.4427427831832,0.03030299076577836,0.03221451533852289,59.39887564522879,59.12042345319475,0.6671847292387673
2024-02-26,0,60.97000026702881,59.27250003814697,61.22749996185303,59.48312497138977,60.18500065803528,0.8189665639990467,0.5933718138837633,-0.4477826881219489,2.995683432672505,59.81875038146973,0.48570007324218806,0.009896581534098756,59.327999114990234,60.98375082015991,0.6656244801276926,0.032330121879448136,1.0168912049045755,1.0162682970422747,1.0068449643104647,0.027642024700277767,71.62769719704082,61.14399369833943,59.9572500705719,58.770506442804376,60.44750009264265,0.8187774898197917,60.04607146126883,0.7202977972141813,60.49466643301557,60.21698309919164,2.7738147845212295,1.0104762732783303,10336100,0.36151942609292265,0.6719644465594824,60368300.0,-32.15549417887573,97.4757252269488,97.9254675000122,104.58988411432424,29.430313466399337,17.38756348986559,0.22193928524057718,0.7416381616205582,60.952119400024415,60.53893968963623,60.204999923706055,59.87106015777588,59.457880447387694,0.06,0.0,59.46010963631107,0.022225957276359898,0.022053839655290515,59.59857341221401,59.167535236903596,0.6637954011467638
2024-02-27,0,60.44499969482422,59.27250003814697,61.22749996185303,59.51687455177307,60.32624959945679,0.619260986728543,0.6128112705117953,-0.8916911431060268,2.995680293304414,59.86999988555908,0.5122750997543335,0.0102066741872221,59.37950010299683,60.98375082015991,0.7435474091756469,0.024576743766833036,1.0067413048989202,1.0049044005789562,0.9927977104961984,0.004695620523011312,65.57614680331929,61.265872603966095,60.040250062942505,58.814627521918915,60.59892858777727,0.6749031578110448,60.084464345659526,0.7266403841322964,60.61562744071847,60.34222535802787,2.8638917335853016,1.3295649382856074,9931100,0.3693145619225899,0.6554699109603485,50437200.0,-45.22967054741618,97.4757252269488,97.9254675000122,40.85815355124845,27.51853409774196,21.572956497264105,0.1756808516298295,0.7357265012502341,60.952119400024415,60.53893968963623,60.204999923706055,59.87106015777588,59.457880447387694,0.06,0.0,59.471049421528676,-0.005930863305356859,0.01599593482275432,59.73076738630022,59.195661544799805,0.659716636518544
2024-02-28,0,60.33000087738037,59.27250003814697,61.22749996185303,59.56124973297119,60.487499713897705,0.4564693508589121,0.6060860938267694,-0.9935901135501202,2.9956814782625525,59.97999954223633,0.509337592124939,0.0100867880297465,59.37950010299683,60.98375082015991,0.7891033913848664,0.010701436107058246,1.0040420608272314,1.0014524772092654,0.9899901630701382,-0.012359828144097196,55.00185002166437,61.29929725059604,60.087125062942505,58.87495287528897,60.74178600311279,0.4187775235438195,60.104285853249685,0.7294806997064595,60.574565636544406,60.37653614380062,1.7849616264324828,0.8972171892174237,8076500,0.38862828286422135,0.5588552065771442,42360700.0,-43.109479192361974,97.4757252269488,97.9254675000122,25.484984963196897,26.318975482436564,21.240791580634845,0.15623702149355664,0.7136097742323024,60.952119400024415,60.53893968963623,60.204999923706055,59.87106015777588,59.457880447387694,0.06,0.0,59.478868941618536,-0.013716486214004675,-0.004942311608603751,59.872806549072266,59.22449139186314,0.659736076140778
2024-02-29,0,60.22749996185303,59.27250003814697,61.22749996185303,59.56124973297119,60.487499713897705,0.33769270990750444,0.6046660262019439,-1.0456950081695198,2.9956817398455486,60.10749959945679,0.5073751449584961,0.010058760222347137,59.37950010299683,60.98375082015991,0.7928558199638749,0.008314885986887502,1.0018984938065194,0.9984996159713003,0.9907631256375047,-0.012218636753375978,53.024259697558485,61.32270714395662,60.11337509155273,58.904043039148846,60.751071793692454,0.4042609099533449,60.13660723822458,0.723770825365171,60.51517866382862,60.35937945637565,1.685491192834413,0.46209751021167195,18152700,0.3900476731406265,1.2767721810566444,24208000.0,-56.537088184270225,97.4757252269488,97.9254675000122,6.4544481999290095,24.35167204575251,21.26926117197858,0.168294672273155,0.7155169898948964,60.952119400024415,60.53893968963623,60.204999923706055,59.87106015777588,59.457880447387694,0.06,0.0,59.49328011095434,-0.018479122626169797,-0.019921622067463642,59.77717644827707,59.23785155160086,0.6422857218509149
2024-03-01,0,59.667500495910645,59.27250003814697,61.22749996185303,59.56124973297119,60.487499713897705,0.2497696101850381,0.6016125314752168,-1.0472917495054785,2.9956822668287546,60.166250228881836,0.4970626592636108,0.01000467763495299,59.37950010299683,60.98375082015991,0.8083630206777699,-4.1500587785127725e-05,0.9922567707843283,0.987651772850692,0.9839627365727218,-0.025478738588286642,49.81552179258311,61.33635012970763,60.1331250667572,58.92990000380677,60.548571722848074,0.5410076088601732,60.15500007356916,0.7069622322168141,60.4458234969338,60.307254584643594,0.10804161176120715,0.7570044087274338,10924800,0.38086700348490415,0.7819992992299045,13283200.0,-73.8516472629191,97.4757252269488,97.9254675000122,-64.49135406635905,22.674407224488267,25.476519883968557,0.10396909052759634,0.7129521718487604,60.952119400024415,60.53893968963623,60.204999923706055,59.87106015777588,59.457880447387694,0.02,1.0,59.494450928461035,-0.0272876069436776,-0.02649226191611561,59.53669466291155,59.2357417515346,0.630343660440628
2024-03-04,0,59.55250072479248,59.27250003814697,61.22749996185303,59.56124973297119,60.487499713897705,0.35620659454470627,0.6095225212689517,-1.0767379997843902,2.9956809142258045,60.10749959945679,0.5155001640319824,0.010140961984999761,59.37950010299683,60.98375082015991,0.7730246837977612,-0.015631432463668573,0.9908077632710013,0.9852874971682105,0.9871452802799292,-0.023249131310942084,40.10776705738106,61.324045156978826,60.10500011444092,58.88595507190301,60.3457145690918,0.6165116642649484,60.15732158933367,0.7047665768014238,60.25181971229976,60.18338748381821,-2.3205377308587334,0.43342819618260275,10150200,0.3889431097841396,0.7463009202481052,3133000.0,-63.957555734383654,97.4757252269488,97.9254675000122,-50.38021014567087,21.00203697099788,24.809892374862308,0.13181256853737752,0.7141822717022246,60.952119400024415,60.53893968963623,60.204999923706055,59.87106015777588,59.457880447387694,0.04,0.0,59.496292151107085,-0.014824556980285175,-0.022712393056322402,59.34824752807617,59.24347659519741,0.625764046852683
2024-03-05,0,59.739999771118164,59.27250003814697,61.22749996185303,59.5443754196167,60.35875058174133,0.5526772054382212,0.6090593071803447,-0.9144827780678475,2.995680935516973,59.97999954223633,0.5123751163482666,0.010142219631544247,59.37950010299683,60.98375082015991,0.7978156231528165,-0.010262594226452301,0.9948065669862184,0.9880259237648932,0.9949287515417029,-0.011663494536611307,40.02894735099704,61.26999377648532,60.05187516212463,58.83375654776394,60.13321454184396,0.5088829104982961,60.1691073008946,0.6955994240471639,60.07551786543718,60.045356809571736,-2.3289188693874983,0.05460554599112855,12310000,0.37812840097659894,0.9066002857521616,15443000.0,-78.94731558590742,97.4757252269488,97.9254675000122,-43.5372118303108,21.154713479264505,23.077308119107656,0.11675501931574403,0.7124387809176581,60.99223896789551,60.60387899017334,60.28999900817871,59.97611902618408,59.58775904846191,0.04,0.0,59.498781455165016,-0.013589634398953887,-0.01960137640415372,59.11198534284319,59.25543049403599,0.6377915873858508
2024-03-06,0,59.61250019073486,59.27250003814697,61.22749996185303,59.5443754196167,60.35875058174133,0.6429495001331847,0.6120919979051771,-0.869276418332988,2.995680402250431,59.84124994277954,0.5199125862121583,0.010196371368559321,59.37950010299683,60.98375082015991,0.813003803897619,-0.002795969522282987,0.9930389422395437,0.9866066414944873,0.9951421841178381,-0.011892933469432765,44.593484895307895,61.25455909499249,60.03037509918213,58.80619110337177,59.939285959516255,0.37891202141916375,60.19339302607945,0.6672452556105193,59.99156409749436,59.973426049793765,-2.4294641977242746,0.2769617496958287,12378800,0.3770719280257318,0.9129999306701833,3064200.0,-77.8195418634367,97.4757252269488,97.9254675000122,-46.05718123386485,19.815645269759017,22.024892484964024,0.07721018948422968,0.7057778965959198,60.99223896789551,60.60387899017334,60.28999900817871,59.97611902618408,59.58775904846191,0.04,0.0,59.50069048234693,-0.014072896542945745,-0.01309244168822806,58.948851994105745,59.27371270315988,0.6470421457407374
2024-03-07,0,59.53499984741211,59.27250003814697,61.22749996185303,59.5443754196167,60.35875058174133,0.6800163916191522,0.6183972038358825,-0.8830439579004508,2.995679310012609,59.75750017166138,0.5331875467300413,0.010303936722510055,59.37950010299683,60.98375082015991,0.8128958140859425,-0.00732691531676947,0.9919916639292945,0.9877311230474521,0.9962349333900942,-0.011498071726031012,41.95743465371142,61.252419550722905,60.015625143051146,58.77883073537939,59.809285981314524,0.3293546310310932,60.2041072845459,0.6543456234004738,59.89656691330313,59.91903210035933,-2.2265049538273507,0.5736220884374224,13686900,0.3761298580248771,0.9968804921873918,-10622700.0,-81.95490339206916,97.4757252269488,97.9254675000122,-60.154852018449596,18.724519422980865,22.266630938580764,0.08754474905071487,0.6931198305087697,60.99223896789551,60.60387899017334,60.28999900817871,59.97611902618408,59.58775904846191,0.04,0.0,59.50044068323065,-0.00966346883899949,-0.015894103976464357,58.82228306361607,59.27652522495815,0.6601437560359583
2024-03-08,0,59.39500045776367,59.27250003814697,61.22749996185303,59.53124976158142,60.35875058174133,0.7534984634718674,0.6270786498638748,-0.8664614700423687,2.9956777812745092,59.703750133514404,0.550200080871582,0.010453096542803929,59.37950010299683,60.98375082015991,0.8168932791052917,-0.004015068548641402,0.9900858115320348,0.9877641685937174,0.9962010390975164,-0.004566975922942307,41.8082238783842,61.243907446593596,59.989750146865845,58.73559284713809,59.67571449279785,0.2665976781959454,60.20875024795532,0.6478647321623506,59.80514849764879,59.86235431386804,-1.5055006237183104,0.2525883942950989,13237500,0.37163635923952226,0.9628767812311221,-23860200.0,-79.24529388309166,97.4757252269488,97.9254675000122,-63.648296209349105,17.150975215541003,23.162483060518703,0.0804560396241901,0.7022512821625958,60.9945994720459,60.607699806213375,60.295000076293945,59.982300346374515,59.59540068054199,0.06,0.0,59.49942790428508,-0.00016794254177909806,-0.008330574359048524,58.698526109967915,59.28566632952009,0.6678530994431063
2024-03-11,0,59.972500801086426,59.27250003814697,61.22749996185303,59.49249982833862,60.35875058174133,0.763109647449139,0.6389421910792552,-0.8981983007988608,2.9956756688204975,59.640000343322754,0.5654000854492182,0.010654230430259364,59.37950010299683,60.98375082015991,0.8065208535339836,-0.0002524885224791917,1.0000291918966915,1.0004170411127926,1.0068074706023773,0.007052601841774475,40.98073089945119,61.2486345233023,59.970750141143796,58.69286575898529,59.639286041259766,0.18292603991490722,60.195178917476106,0.6508910681616553,59.699794554393705,59.80677510030305,-1.5498100547305984,0.10955922612566804,14114300,0.36372002227447486,1.0308567563905882,-9745900.0,-52.07541303130502,97.4757252269488,97.9254675000122,3.8228442447723747,20.893721770959942,21.348252126442286,0.07347862444460362,0.7071245061471706,60.9945994720459,60.607699806213375,60.295000076293945,59.982300346374515,59.59540068054199,0.06,0.0,59.50717836071803,0.007189405918046177,0.011926784602689281,58.729464939662385,59.25332069396973,0.6622206659333286
2024-03-12,0,60.44499969482422,59.27250003814697,61.22749996185303,59.53124976158142,60.35875058174133,0.7129238828328481,0.6258867869175161,-0.8897477212794564,2.9956779967920992,59.703750133514404,0.5429000854492188,0.010431642017373734,59.37950010299683,60.98375082015991,0.8043961603571569,0.00760250841342801,1.0074355486270523,1.0099794797585462,1.0133107488283128,0.011801137033932374,52.0720713091284,61.25064871497883,59.9988751411438,58.74710156730877,59.75035735539028,0.3565557915212006,60.14946453911917,0.6044030245639782,59.76437358123644,59.86317058027098,-0.4233932355288087,-0.3158090646433548,12684600,0.38554096686354916,0.9292607693437571,2938700.0,-42.26414714091792,97.4757252269488,97.9254675000122,52.341115938891036,24.48448761017869,20.155917331980834,0.03505945146319302,0.6951092720253261,60.9945994720459,60.607699806213375,60.295000076293945,59.982300346374515,59.59540068054199,0.06,0.0,59.51971499084254,0.016465039915514623,0.011536506646892982,58.865878513881135,59.20128658839634,0.6656009305074224
2024-03-13,0,61.0024995803833,59.27250003814697,61.22749996185303,59.54812550544739,60.44499969482422,0.5409555286525338,0.6229610491334078,-1.0478812854219848,2.995678553284448,59.856250286102295,0.5458875322341917,0.010374881350819322,59.37950010299683,60.98375082015991,0.7786464697724403,0.014603439166503852,1.0159442490510306,1.0192947820536113,1.0202451728994368,0.023317246973386885,58.991544360827504,61.29104724894735,60.04512515068054,58.79920305241373,59.95750004904611,0.5760712385631116,60.15160730906895,0.6075901339880974,59.93226680476887,59.975772980765775,1.3030530731999754,-1.0477224958754776,13909500,0.39837597630059546,1.0588924469935241,16848200.0,-18.867940824637493,97.4757252269488,97.9254675000122,106.06401503129744,27.438275219678527,18.678743742403448,0.10307049601859024,0.6961792663877816,60.9945994720459,60.607699806213375,60.295000076293945,59.982300346374515,59.59540068054199,0.02,1.0,59.54080318374719,0.026364369253438324,0.02688170047859294,59.05010659354074,59.19917706080845,0.6824437179904588
2024-03-14,0,60.570000648498535,59.27250003814697,61.22749996185303,59.54812550544739,60.576249837875366,0.3334340362666673,0.6463462522877553,-1.30934518403978,2.9956745427091866,60.06750011444092,0.5702499866485595,0.010751561564474746,59.37950010299683,61.0107497215271,0.7144417100064167,0.02918722073681596,1.0075436944634457,1.0109321621337315,1.0083236319555444,0.01738474517072519,66.91576370317046,61.40919264381196,60.11650013923645,58.82380763466094,60.07607160295759,0.6083563307593343,60.104643072400776,0.5396426206836782,60.19795835747063,60.14124292611213,2.43482446235405,0.04920050662632567,13996600,0.4050328657621123,1.0731860666610438,2851600.0,-33.47829187751169,97.4757252269488,97.9254675000122,45.50779005649156,25.40495741514901,21.411497096427333,0.08251367515159057,0.6978901182603312,60.72720063781738,60.39140074920654,60.1200008392334,59.84860092926026,59.512801040649414,0.02,0.0,59.554894683749204,0.02597441374280174,0.02407923080041534,59.255980900355745,59.18398312159947,0.6749471918950795
2024-03-15,0,59.9975004196167,59.32999897003174,61.22749996185303,59.59750032424927,60.6700005531311,0.2022701771799481,0.6230738602484187,-1.345960181649746,2.9956787143156434,60.19499969482422,0.546125078201294,0.010353267244075263,59.39400043487549,61.0107497215271,0.7273367971499894,0.01995454096235526,0.9969446568873066,1.0008048507393534,0.995363076865175,0.010143950790630463,58.61337691289445,61.42752289025086,60.18137516975403,58.93522744925719,60.131071635655,0.5760041236099729,60.03517879758562,0.47885010757754587,60.2921864895554,60.24015027394766,1.3893553407438117,-1.073862747563004,36848900,0.42146325279968766,2.5950377312848003,-33997300.0,-59.37496806890985,97.4757252269488,97.9254675000122,-29.750813014996126,23.194017468229262,27.238952915875114,0.014537910737757126,0.7095298102070474,60.681359588623046,60.35431990051269,60.09000015258789,59.82568040466309,59.498640716552735,0.02,0.0,59.570080427315645,0.01409548043443487,0.015460352097231846,59.369747161865234,59.15929957798549,0.6466202753146758
2024-03-18,0,60.05500030517578,59.32999897003174,61.22749996185303,59.6537504196167,60.6700005531311,0.19208300294024516,0.5977148048862303,-1.2591279220827762,2.9956830324030506,60.19499969482422,0.5155000686645508,0.009926838555544406,59.520999908447266,61.0107497215271,0.6782784226641815,0.011250656685871907,0.997392548434739,1.0012128603260737,0.9943292367662879,0.0013756222099690074,50.20658836684016,61.40742978906323,60.21200017929077,59.01657056951831,60.20535741533552,0.5168076904801796,60.00732169832502,0.46429781593714714,60.222127349462276,60.24953661540301,0.645838083707272,-1.5950464870475245,15856700,0.444272425304516,1.1092150110962073,-18140600.0,-48.21424313949884,97.4757252269488,97.9254675000122,-20.988048114729445,21.77049105025669,25.56716970165735,0.0052084360513355256,0.7016685545924579,60.681359588623046,60.35431990051269,60.09000015258789,59.82568040466309,59.498640716552735,0.02,0.0,59.57806929278886,0.0061580685647746325,0.018329319939163338,59.53442219325474,59.178352628435405,0.6154157405787576
2024-03-19,0,60.22000026702881,59.39500045776367,61.22749996185303,59.721874952316284,60.6700005531311,0.22537417601231136,0.5641675832650871,-1.1877366563046767,2.995688460528532,60.19499969482422,0.48132503032684326,0.009364049262195695,59.55075063705444,61.0107497215271,0.7542627237951177,-0.0017868127760989217,0.9995311070627978,1.0031233097877197,0.9967888260625946,-0.0037223828096847322,48.11136858487473,61.37658541257815,60.248250246047974,59.119915079517796,60.323214530944824,0.3761305292402083,59.99946451187134,0.45932124087753134,60.18533673637813,60.27128074488465,0.8734365652077438,-0.6452136514475528,15030600,0.4028368620787523,1.0637374831829323,-3110000.0,-43.75002128739344,97.4757252269488,97.9254675000122,-5.725128644320358,21.096543213947278,24.775688303226307,-0.03679341465446581,0.6721313554341438,60.681359588623046,60.35431990051269,60.09000015258789,59.82568040466309,59.498640716552735,0.02,0.0,59.58685596247923,0.00350015951739846,0.00783133719778708,59.70202200753348,59.2002740587507,0.6157648604570848
2024-03-20,0,60.47500038146973,59.39500045776367,61.22749996185303,59.721874952316284,60.6700005531311,0.21060467088192433,0.5638697004318175,-1.1883817806756174,2.995688508926187,60.22375011444092,0.4787374925613406,0.00935865841071737,59.55075063705444,61.0107497215271,0.7675402053337892,-0.014160607526359802,1.003715699788011,1.0065661930037948,1.0017558703457143,-0.00864717351816846,47.11667278585166,61.37886468887328,60.251125288009646,59.123385887146014,60.3950001852853,0.3446765665286444,60.01714311327253,0.4733226875982401,60.19727773133497,60.27204064012098,1.3890054767350353,-0.1823315245347613,15258800,0.3418769359937317,1.0765333605192318,12148800.0,-20.53569299832085,97.4757252269488,97.9254675000122,51.56473473679018,24.550257339517067,23.05305828820994,-0.03449412332290745,0.6705440617248689,60.681359588623046,60.35431990051269,60.09000015258789,59.82568040466309,59.498640716552735,0.02,0.0,59.600515808311805,0.0018966297178386604,0.012163994261857177,59.842080797467915,59.285772868565154,0.6154638806241742
2024-03-21,0,60.58500099182129,59.39500045776367,61.22749996185303,59.721874952316284,60.49875044822693,0.23303484337497643,0.533626606914155,-1.0043677595038187,2.995693039181246,60.22375011444092,0.4458749294281006,0.008861193397319738,59.55075063705444,60.975500679016115,0.7416669384175294,-0.008159422905085019,1.0060506800248457,1.0069515263800144,1.005334913924783,0.0002476530157198287,51.785776431994265,61.287878471320376,60.22062525749207,59.15337204366376,60.41500037057059,0.3520444850521776,60.08267886298044,0.48457199935257445,60.268333218572884,60.26561537759956,0.8378833193065676,0.41094254248219064,13067100,0.3478837809425616,0.9216312614480087,25215900.0,-33.03565042353398,97.4757252269488,97.9254675000122,60.01311721165585,24.716157255288344,21.40127762378112,-0.09350706950157515,0.6705051919760513,60.681359588623046,60.35431990051269,60.09000015258789,59.82568040466309,59.498640716552735,0.02,0.0,59.612150838106295,-0.0004958189934702872,-0.0027211548550772646,59.905883244105745,59.38588087899344,0.6038159019433845
2024-03-22,0,60.5575008392334,59.39500045776367,61.22749996185303,59.721874952316284,60.49875044822693,0.2365261474432694,0.5125959495420297,-0.8476453504382047,2.9956960468401963,60.22375011444092,0.42837493896484347,0.008514706044614653,59.55075063705444,60.973250198364255,0.6707960049862657,-0.010493633913389222,1.005917660690175,1.0047410351082322,1.0048285592149357,0.009333729167050553,52.55437524906044,61.22644216611287,60.20125026702881,59.176058367944755,60.35142912183489,0.25510581239679775,60.1544645854405,0.4743215952906477,60.34859681134563,60.26091133495741,0.2316176651566074,1.53768883946048,11501400,0.343190527851589,0.8172871430444362,13714500.0,-32.142771993283404,97.4757252269488,97.9254675000122,67.17484420258094,23.73220559338597,20.549291513349335,-0.10428905659128232,0.6482465926325908,60.681359588623046,60.35431990051269,60.09000015258789,59.82568040466309,59.498640716552735,0.02,0.0,59.62193018701663,0.010187065353879365,-0.0001652094557249548,59.88532911028181,59.467717851911274,0.5892197949630648
2024-03-25,0,60.427499771118164,59.39500045776367,61.0024995803833,59.721874952316284,60.495625495910645,0.0175455371941484,0.4640244197556657,-0.9999320711683333,2.995702535459121,60.22375011444092,0.39822497844696014,0.0077121783240683955,59.55075063705444,60.62350091934204,0.6528979179912905,-0.006765613022614345,1.0043170877900232,1.0006540931633328,1.0008115341341766,0.006202638648730163,53.23544559602701,61.095799150409164,60.16775031089783,59.239701471386496,60.331071853637695,0.23999519298898506,60.20357172829764,0.46357794585329687,60.39937193066018,60.256915997670646,-0.7294762414833924,1.687586754895959,13144700,0.3391193085432935,0.9248308864683494,569800.0,-36.16063977983726,97.4757252269488,97.9254675000122,46.56011474647129,22.174182127619584,22.649657313450977,-0.07520906110495332,0.64407225334337,60.681359588623046,60.35431990051269,60.09000015258789,59.82568040466309,59.498640716552735,0.02,0.0,59.63101966122708,0.004490276799601567,0.008684014665594013,59.87115369524275,59.563567297799246,0.5961591252517495
2024-03-26,0,60.53250026702881,59.39500045776367,61.0024995803833,59.721874952316284,60.452499866485596,-0.10053114801051526,0.4310175572503442,-0.9558417761088114,2.995706585220431,60.22375011444092,0.37381245613098174,0.0071668286653139715,59.55075063705444,60.57150068283081,0.716028218319279,-0.00028951813705697097,1.0065159778280037,1.0016381638766063,1.0013150681736651,0.005189305855435089,53.2024786978337,61.00266040060298,60.14062528610229,59.27859017160161,60.407500403267996,0.19748434439350562,60.2692860194615,0.4378382141183862,60.40488936532299,60.256278420876804,-0.2352664286852761,1.1508202253666195,13277400,0.3191477408237979,0.9232983783483074,13847200.0,-29.9106610672307,97.4757252269488,97.9254675000122,68.1878377303494,21.33068317755049,21.78807143608398,-0.06422285717214912,0.621568902138925,60.681359588623046,60.35431990051269,60.09000015258789,59.82568040466309,59.498640716552735,0.02,0.0,59.64152597723095,0.005147004946077782,0.006818592152391941,59.96471350533621,59.66723033360073,0.6151691291786275
2024-03-27,0,60.98750019073486,59.39500045776367,61.0024995803833,59.721874952316284,60.4893753528595,-0.10883935471289623,0.43451479236302204,-0.9960473498585576,2.995706169891,60.22375011444092,0.3777499818801878,0.007224454070818786,59.55075063705444,60.57150068283081,0.7196221631168949,0.003356528869608569,1.0140078123138068,1.0090210050166213,1.007799650289425,0.008474573063784074,55.83012432676336,61.01402989943857,60.145000314712526,59.27597072998648,60.54071467263358,0.2316324462920755,60.37303604398455,0.4222730059102587,60.436104829920986,60.28018355460925,0.8917035604323053,1.5433006053266227,12551200,0.31878953729778253,0.8594278264340887,26398400.0,-16.260230680722128,97.4757252269488,97.9254675000122,139.12926960672567,27.257253812077934,19.620335270622107,-0.08343611083221565,0.6407976349223545,60.84944052124023,60.490280654907224,60.20000076293945,59.90972087097168,59.55056100463867,0.04,0.0,59.6567297528813,0.004609042925133311,0.01328245134280406,60.09229496547154,59.81335857936314,0.6652176648684683
2024-03-28,0,61.144999504089355,59.39500045776367,61.0024995803833,59.721874952316284,60.538750410079956,-0.011760741268295455,0.47063933437414457,-1.0577876778468205,2.995701689528035,60.22375011444092,0.40733745098114016,0.007820803446139396,59.55075063705444,60.62525091171265,0.6853811495158927,0.012618824114618834,1.0160710928925805,1.0116518919960584,1.0086937722874447,0.009243187308747736,63.806015710760754,61.11915394912853,60.17787528038025,59.23659661163197,60.672857420785085,0.27748634422656926,60.49803597586496,0.3657145381102263,60.573240949646944,60.35914651688946,1.552743120173984,2.439741911557075,13683500,0.33239048833470414,0.9515200086226828,40081900.0,-13.513524659460662,97.4757252269488,97.9254675000122,131.94894279341423,26.429978689652266,19.02484552044616,-0.023788286135155275,0.6135250815403293,60.993400665283204,60.72330088806152,60.505001068115234,60.286701248168946,60.016601470947265,0.04,0.0,59.674019417527404,0.011741348186673717,0.007078188883749097,60.22696467808315,59.96449334280832,0.7114423353633696
2024-04-01,0,60.947500228881836,59.39500045776367,61.144999504089355,59.721874952316284,60.56062579154968,0.05310068792706204,0.5157908513039094,-1.1020574841559536,2.995695602287953,60.323750019073486,0.4489999294281006,0.008564575422463716,59.55075063705444,60.989000129699704,0.7181905315484912,0.024762207163009493,1.01201768352677,1.0074258335235968,1.0035814278615356,0.006440150010215806,69.52920858429147,61.25533196009988,60.223750257492064,59.19216855488425,60.740357398986816,0.27880087339214166,60.56767879213606,0.3504548465158003,60.71355244024585,60.44455031881433,1.536033266288435,2.9463743292166886,11668700,0.30139125092940117,0.8093220427150474,28413200.0,-41.89941991057843,97.4757252269488,97.9254675000122,83.68213570689117,24.37677572411726,21.836953301293523,-0.04597538476924579,0.6175688695618359,61.00756008911133,60.74621995544434,60.53499984741211,60.32377973937988,60.06243960571289,0.04,0.0,59.68573845125197,0.0031409600433376372,0.00347277253136484,60.217041560581755,60.02956117902483,0.6874846356643969
2024-04-02,0,60.36000061035156,59.39500045776367,61.144999504089355,59.91437554359436,60.573750734329224,-0.12478099201965792,0.5221725913806288,-1.1021925664697199,2.995694749760724,60.43624973297119,0.4509749412536621,0.008661338153539389,59.55075063705444,60.989000129699704,0.7393832134719035,0.023424700677743313,1.0011984253172221,0.9961505668824603,0.9926325585108003,-0.0011170271982502422,64.842037491178,61.33209542690189,60.287750244140625,59.24340506137936,60.708214487348286,0.3108276768185929,60.56160742895944,0.3534669823296444,60.7698927499418,60.5072970823361,0.781314335562847,1.6257441573584466,13017300,0.3047130374703709,0.8939701158384683,15395900.0,-71.50827511838342,97.4757252269488,97.9254675000122,-1.398476634098681,22.62519779808075,26.294384177209835,-0.10593867136795265,0.6177428447825473,61.00756008911133,60.74621995544434,60.53499984741211,60.32377973937988,60.06243960571289,0.04,0.0,59.69270482947308,-0.0041390474519885645,-0.005620782411284822,60.17167936052595,60.03878130231585,0.6633365358450929
2024-04-03,0,60.01249980926514,59.39500045776367,61.144999504089355,59.99125051498413,60.573750734329224,-0.2280092299692631,0.49423222073435585,-0.8457104148803598,2.9956986941280883,60.43624973297119,0.40974998474121094,0.008192401450917547,59.60475015640259,60.989000129699704,0.7417276895064537,0.010378320080495605,0.9947681876752165,0.9899173097534605,0.9871369885616089,-0.008590434154706617,51.02877620782769,61.31658967988729,60.32812523841858,59.33966079694987,60.630357197352815,0.40795323963922936,60.49089315959385,0.35748394015529755,60.66490399035001,60.491249334528746,-0.3713796777854318,-0.14062219356737718,13672900,0.33688520926166377,0.9346198776844116,1723000.0,-89.38534389797927,97.4757252269488,97.9254675000122,-59.72293564734465,21.024522117865658,28.261462794372527,-0.11463729471264723,0.6171886468027166,61.00756008911133,60.74621995544434,60.53499984741211,60.32377973937988,60.06243960571289,0.04,0.0,59.69615575194992,-0.011727771976689838,-0.00943704855766948,60.078119550432476,59.981724330357146,0.6171015089206308
2024-04-04,0,59.677499771118164,59.39500045776367,61.144999504089355,60.00874996185303,60.573750734329224,-0.2545581475769312,0.4814210627372737,-0.6851977947219896,2.9957004250551336,60.43624973297119,0.39339998245239227,0.007978241612480503,59.60475015640259,60.989000129699704,0.6848888536060064,0.0067099956762498355,0.9889918594246566,0.9847284707964981,0.9833087501931886,-0.021479818249965144,45.62241330689616,61.304592365800474,60.34175024032593,59.378908114851384,60.52321434020996,0.545433172027476,60.42714309692383,0.4169288631303886,60.50098204617699,60.43279876359053,-0.8999727901835272,-1.6228839439827156,14320700,0.34585154261640083,0.9724465443675723,-12597700.0,-94.24774578611384,97.4757252269488,97.9254675000122,-134.41857212321554,18.73170108092539,31.96749656529756,-0.13062283848990996,0.6431553762263845,60.896639801025394,60.566679489135744,60.29999923706055,60.03331898498535,59.7033586730957,0.02,1.0,59.694340388163425,-0.028346697246348418,-0.020482341762168718,59.92218671526228,59.89667020525251,0.5980172299330714
2024-04-05,0,59.33749961853027,59.39500045776367,61.144999504089355,60.00874996185303,60.573750734329224,-0.2389480644595502,0.47668315455254884,-0.6708973808101915,2.995701053709943,60.43624973297119,0.38950000762939396,0.007899298248734386,59.663249778747556,60.989000129699704,0.6161380113599759,0.0023935487372349247,0.9833043235205451,0.9804083459505611,0.9819455990718547,-0.02956087824382425,40.95370164800665,61.298366528450195,60.345000219345096,59.391633910239996,60.35249996185303,0.7055510199853576,60.380000182560515,0.4985672949286585,60.296884786796795,60.34135426044756,-1.2411567627996896,-1.473503166294741,10156200,0.3543877976343355,0.6980239767476545,-22753900.0,-76.19054106626825,97.4757252269488,97.9254675000122,-159.6852003775662,17.14922676143007,32.11943571366246,-0.10118042049536416,0.652232421127278,60.835280197143554,60.467360130310055,60.170000076293945,59.872640022277835,59.50471995544434,0.04,0.0,59.69166092336961,-0.0272965180649275,-0.024905790161107094,59.77617645263672,59.87044497898647,0.5503997236372925
2024-04-08,0,59.30250072479248,59.33749961853027,61.144999504089355,60.00874996185303,60.573750734329224,-0.3559150745668931,0.49505268092262744,-0.5292382887524183,2.9956985784323265,60.43624973297119,0.4013500213623047,0.008205049367458665,59.64924983978271,60.989000129699704,0.5549989284585611,-0.0009681090797244426,0.9828851853783293,0.9818538649944101,0.9872725575983516,-0.026990434355990578,37.00798626586784,61.32523056974626,60.335125207901,59.34501984605574,60.11178575243269,0.7394235641863279,60.32625021253313,0.5715252770331312,60.05925513328142,60.21089196927351,-1.9741471824672587,-1.1000471627491881,10284500,0.36151133900875243,0.7140883249041124,-33038400.0,-85.7142640890217,97.4757252269488,97.9254675000122,-170.60219296738347,16.301729774122393,30.53212653756747,-0.11791002757494332,0.6370469497235268,60.835280197143554,60.467360130310055,60.170000076293945,59.872640022277835,59.50471995544434,0.04,0.0,59.68819802925857,-0.023236645804112777,-0.031219359672610185,59.52668380737305,59.80948938642229,0.5274525736405868
2024-04-09,0,59.51750087738037,59.30250072479248,61.144999504089355,60.00874996185303,60.573750734329224,-0.41486677060457133,0.5041623798459179,-0.4433583910536507,2.9956973151506348,60.43624973297119,0.4069000053405759,0.00835667494877356,59.643499755859374,60.989000129699704,0.6718898783713178,-0.011171788191994289,0.9865242399633597,0.9874653796627165,0.9963088950243245,-0.013957914586679165,33.41925749492278,61.33882498094428,60.33050022125244,59.322175461560605,59.87928594861712,0.6038396570182765,60.2760716847011,0.6110439302321571,59.87277952524771,60.09912598365435,-2.7628603577333797,-1.253017361684115,10792100,0.334615607392186,0.7580760836657612,-22246300.0,-67.85709420029882,97.4757252269488,97.9254675000122,-116.57189189053663,18.222993966654755,28.434164058304415,-0.12645766736884548,0.635112002130819,60.835280197143554,60.467360130310055,60.170000076293945,59.872640022277835,59.50471995544434,0.04,0.0,59.68684636169044,-0.007148794095569233,-0.015820662664788276,59.319718497140066,59.773341587611604,0.5294936513651062
2024-04-10,0,59.07999897003174,59.30250072479248,61.144999504089355,60.00874996185303,60.573750734329224,-0.3948465959630326,0.5294358887913899,-0.7090645908081945,2.9956936933221017,60.43624973297119,0.43420000076293946,0.008778902990337848,59.49950075149536,60.989000129699704,0.76656349620209,-0.015344508596684922,0.9796418992508681,0.9816888573451898,0.9917826876359715,-0.015538443527550405,35.83764297381805,61.36662200264992,60.30775022506714,59.24887844748436,59.612500054495676,0.44483871998497226,60.17642872674124,0.6853346260792255,59.784763789892466,60.02569240958127,-2.6617035569689356,-1.166554942765526,11861900,0.31860750828829815,0.8356372492212947,-34108200.0,-91.60586126483588,97.4757252269488,97.9254675000122,-161.44216763865822,16.19894868123088,30.020747294550766,-0.1444590945876955,0.6633600387770195,60.783359909057616,60.38331966400146,60.05999946594238,59.736679267883304,59.33663902282715,0.06,0.0,59.68045605579841,-0.015209805880045502,-0.020448910319236405,59.070225851876394,59.643633706229075,0.6037649164625583
2024-04-11,0,59.09000015258789,59.07999897003174,61.144999504089355,59.917500257492065,60.573750734329224,-0.3826866469454466,0.5916680481978379,-0.8609211117870434,2.9956839763160548,60.39375019073486,0.49555009365081804,0.0098219282421532,59.333999729156496,60.989000129699704,0.7299695804528762,-0.03151511206222417,0.980917835761645,0.9842304941981629,0.9950659306565791,-0.009844574936676564,27.24397487515095,61.4228362852232,60.23950018882751,59.05616409243183,59.43107141767229,0.33444569451031403,60.069642952510286,0.7316807350725407,59.607919259778384,59.908761088182,-3.064114609847649,-2.3067406409896174,11109000,0.2955864554247273,0.7903943149097724,-22999200.0,-86.86129964150221,97.4757252269488,97.9254675000122,-132.76944725609675,15.176712884610728,28.126285923651135,-0.17774499208129965,0.6573974616140206,60.783359909057616,60.38331966400146,60.05999946594238,59.736679267883304,59.33663902282715,0.06,0.0,59.675182921499506,-0.0042158905206513,-0.013037004005894632,58.91429247174944,59.542985916137695,0.6431106696046102
2024-04-12,1,58.59249973297119,59.07999897003174,61.144999504089355,59.637500047683716,60.56062579154968,-0.29332507675145075,0.6147243749803358,-0.9998521913139182,2.9956799861586454,60.290000438690186,0.5224876308441161,0.010220897352522214,59.281250667572024,60.951500225067136,0.8041828585126741,-0.024434546476223822,0.974205594853044,0.9790382092139631,0.9886443152438834,-0.012555296235071345,28.663081045152012,61.37332396739842,60.143875217437746,58.91442646747707,59.228214263916016,0.35313119787610947,59.92928573063442,0.8146628255875741,59.47608284872641,59.80065237925328,-2.104043149306845,-2.4676088384239145,12246700,0.28583606619514085,0.8767987720077624,-35245900.0,-95.45461376181255,97.4757252269488,97.9254675000122,-171.7138611910465,13.69989595454151,32.37018076436073,-0.1827008075277713,0.6761784835503568,60.651200485229495,60.16940059661865,59.78000068664551,59.390600776672365,58.90880088806152,0.08,0.0,59.663846066580874,-0.020668828844099818,-0.017200732192672784,58.69456808907645,59.386343819754465,0.7513569497876403
2024-04-15,1,58.40000057220459,58.59249973297119,61.144999504089355,59.47250056266785,60.538750410079956,-0.3481110245945781,0.6923647399008993,-0.8255141770628325,2.9956657021218587,60.137500286102295,0.5797501468658446,0.011530764225522731,59.08900003433227,60.951500225067136,0.8070697318402902,-0.023417653682554593,0.9726038871720554,0.9800014351584788,0.9878798724850335,-0.015218585077485303,24.89569992316934,61.42972965146318,60.04500017166138,58.66027069185958,59.045714378356934,0.40807410520504367,59.78446435928345,0.8954866491031267,59.2542516291676,59.65850812137608,-2.3661738484600106,-3.244851717838959,12425000,0.2794243299385467,0.9747911554079922,-47670900.0,-97.0501919727052,97.4757252269488,97.9254675000122,-153.87287114260587,12.595200111103598,30.70249214369449,-0.17739592567511514,0.6828879577807845,60.62996044921875,60.13502053833008,59.73500061035156,59.33498068237304,58.840040771484375,0.1,0.0,59.65120194717231,-0.0190652994711773,-0.023021336978104885,58.53012956891741,59.226158142089844,0.8564599963486381
2024-04-16,1,58.15500068664551,58.40000057220459,61.144999504089355,59.328749895095825,60.538750410079956,-0.4045157549280667,0.7798572250356279,-0.8879818361123282,2.9956475528368425,60.137500286102295,0.672350101470947,0.01300517963906386,59.031249046325684,60.951500225067136,0.8323342698471164,-0.027558067181102933,0.96981371276666,0.9800798928896629,0.9867483478081167,-0.022892429464434705,22.73251032043176,61.52483962936203,59.96512517929077,58.40541072921952,58.876785959516255,0.5012686291481726,59.61464296068464,0.9654212408878584,59.04130825115951,59.5322954341414,-2.140671448725537,-3.3552591230700473,11236800,0.2788102398730059,0.8978432441826321,-58907700.0,-96.28568376813617,97.4757252269488,97.9254675000122,-144.82779151548266,11.986871489305367,30.40024269945846,-0.205959450841708,0.6662349400915623,60.60400030517578,60.09300030517578,59.68000030517578,59.267000305175785,58.75600030517578,0.12000000000000001,0.0,59.63821497968092,-0.027796415264123797,-0.020415051742017132,58.32458169119699,59.05037907191685,0.9465126687192086
2024-04-17,1,58.36249923706055,58.15500068664551,61.144999504089355,59.24937558174133,60.538750410079956,-0.4058292303794376,0.8732559487889581,-0.981318300629455,2.995625682654895,60.11625003814697,0.7678625679016114,0.014585838026823046,58.57324981689453,60.951500225067136,0.8453271569464518,-0.03429092612465353,0.9748183930414613,0.9872455092347402,0.9948690278331467,-0.012144545454971012,19.53279750053885,61.61663709594217,59.870125198364256,58.123613300786346,58.74250003269741,0.4940732455715165,59.427142892565044,0.9326321442162012,58.81945136457898,59.38675855393183,-1.9928357943742674,-3.9276414651556877,13805100,0.27429279057787287,1.1084827827092392,-45102600.0,-82.78937091433907,97.4757252269488,97.9254675000122,-107.40671829985749,13.298841205336766,28.739313912570775,-0.17400215736348032,0.6543489415505506,60.50467948913574,60.01265964508057,59.614999771118164,59.21733989715576,58.72532005310059,0.12000000000000001,0.0,59.62531477031741,-0.006958620959638839,-0.020261284719931206,58.2168459211077,58.871764864240376,0.9822826531122559
2024-04-18,1,58.76249980926514,58.15500068664551,61.144999504089355,59.08749985694885,60.538750410079956,-0.25375595484947133,0.9281575031645578,-1.2329062849264634,2.995611563771213,59.84499979019165,0.8257501125335693,0.015526935429183866,58.39625043869019,60.951500225067136,0.8804281428819556,-0.03493180869919392,0.9830244727700324,0.9967939708920541,1.0041438778649185,-0.005542398755746358,23.912176680821453,61.633565153194965,59.777250146865846,57.92093514053673,58.63464273725237,0.3612458858995018,59.256964342934744,0.8034877846656487,58.70476364428453,59.27462199151404,-1.58509586652043,-4.304162238925646,11125900,0.27116519131765415,0.9084291733636636,-33976700.0,-70.91988567224156,97.4757252269488,97.9254675000122,-67.707298050532,17.285210416547198,27.23310640052406,-0.19676216704983107,0.6411688146789433,60.50467948913574,60.01265964508057,59.614999771118164,59.21733989715576,58.72532005310059,0.12000000000000001,0.0,59.61857995535903,-0.00237083422740636,-0.00016970495739433405,58.10202244349888,58.71087047031948,0.96642828775045
2024-04-19,0,59.65749931335449,58.15500068664551,61.144999504089355,59.00062417984009,60.538750410079956,-0.054538958969255404,0.9387693263228792,-1.3283435202001208,2.9956085606222382,59.59750032424927,0.8330376148223877,0.01572698556058869,58.39625043869019,60.951500225067136,0.9023800174858019,-0.03008172241842799,0.9994282982774633,1.0135490872356552,1.0205800974359218,0.018176380684164606,33.87597513841796,61.56916377090137,59.691625118255615,57.81408646560986,58.71714278629848,0.5136862101561488,59.164821420397075,0.6549431148411138,58.71917010990738,59.23169360511015,-1.2685362405768832,-3.8964751233089436,21206200,0.2906473298004888,1.6758018580157352,-12770500.0,-20.000054495690073,97.4757252269488,97.9254675000122,17.344784997144547,28.83606371485329,23.19437464495638,-0.10154419783968796,0.6989931736895728,60.06919972229004,59.6603998336792,59.329999923706055,58.99960001373291,58.59080012512207,0.02,1.0,59.62206372224375,0.03242962670675609,0.018966934228864633,58.27921840122768,58.674722126552034,0.9550110604307543
2024-04-22,0,60.260000228881836,58.15500068664551,61.144999504089355,59.00062417984009,60.453749895095825,0.046939406535509716,0.9161273959392119,-1.2079485366746208,2.9956143348831223,59.58750009536743,0.7852499961853028,0.015359603579696316,58.39625043869019,60.951500225067136,0.898352186729472,-0.014861933095095994,1.0103067753793589,1.0232289652427362,1.0271445060254272,0.03184930887761861,50.68730604145046,61.477504826210705,59.64525003433228,57.81299524245385,58.884285654340474,0.7777178622102114,59.15767853600638,0.6413090772367409,58.95524784229322,59.30460054795807,0.9774887498147897,-2.1165772356255514,15624500,0.36544810357981,1.2149202423075591,2854000.0,-2.9630299425393725,97.4757252269488,97.9254675000122,57.2631964364911,28.912070908179604,21.081352411679834,-0.02004097864509526,0.7140773474683555,59.992800888061524,59.59860077667236,59.28000068664551,58.96140059661865,58.56720048522949,0.04,0.0,59.6297187073238,0.04145168954003453,0.038949958110487126,58.49185453142439,58.703073501586914,0.9579741517413265
2024-04-23,0,60.49499988555908,58.15500068664551,61.144999504089355,59.00062417984009,60.37687540054321,0.06261177616571409,0.9035230780617955,-1.1445865459130082,2.995617509237343,59.58750009536743,0.7703749656677246,0.015152060975702316,58.39625043869019,60.951500225067136,0.8787882199587942,-0.0027719091948329453,1.014499739129413,1.02555191422953,1.0246529871372765,0.04023728262891968,58.818589557352375,61.43742115993829,59.6303750038147,57.82332884769111,59.15607139042446,0.9679238387372122,59.19214282717024,0.7009710453110951,59.28371833206833,59.455969548501834,1.980030586008899,-0.16567326119704642,13689100,0.3923449190196635,1.0621804374469215,16543100.0,-1.4545787464488635,97.4757252269488,97.9254675000122,72.02604127668482,27.802535142094403,19.90128204547027,0.027977863974876012,0.7023486244235567,60.03100030517578,59.62950030517578,59.30500030517578,58.98050030517578,58.57900030517578,0.06,0.0,59.638080715180024,0.04443678733847789,0.04299965709453942,58.82640184674944,58.760484967912944,0.969640133394816
2024-04-24,0,60.84000015258789,58.15500068664551,61.144999504089355,59.00062417984009,60.39375042915344,0.06019041118856346,0.9066151203795257,-1.1592679532738184,2.9956167341919895,59.58750009536743,0.7737499713897705,0.015203053979240584,58.39625043869019,60.951500225067136,0.8625241635813259,-0.0006195082196225172,1.0202276419453455,1.0296942616703395,1.0223921432524843,0.04245021971153218,61.09518226590744,61.44698025029579,59.63375000953674,57.82051976877769,59.50464275905064,1.0827987152337126,59.27517856870379,0.8213974304348498,59.58965262065789,59.61954364631882,3.2470028779422684,0.8039992965256443,19548300,0.3953917797663593,1.480788226596209,36091400.0,-2.6882326882531973,97.4757252269488,97.9254675000122,110.86092019182148,32.07169938629333,16.60673829874537,0.09469508004641838,0.7815222019848667,60.77208123779297,60.22896105957031,59.790000915527344,59.35104077148438,58.80792059326172,0.08,0.0,59.65705354369288,0.05195694492517333,0.0601102093559301,59.30979374476841,58.919961656842915,1.042365047399437
2024-04-25,0,61.892499923706055,58.15500068664551,61.144999504089355,59.00062417984009,60.39375042915344,0.07210634012285318,0.9241639222373799,-1.2012126156888105,2.9956122878916043,59.58750009536743,0.7891249656677246,0.015493335772792601,58.39625043869019,60.951500225067136,0.8216832143252633,-0.0024185290048891143,1.0376095193307175,1.0443964453753345,1.0314900929890234,0.05326526483046945,63.52000540174094,61.497452848289456,59.649125003814696,57.800797159339936,60.038571221487864,1.2192545017657754,59.457678590502056,1.0795732117595547,59.905226131505344,59.802374192179855,4.178081432322135,1.9479709872703754,19048500,0.3894184417407955,1.4082726453102492,55139900.0,-18.240311200721028,97.4757252269488,97.9254675000122,169.7544494873665,36.8966327749203,14.82525249096212,0.06916644968467572,0.8128625408138002,61.490240188598634,60.809880210876464,60.260000228881836,59.71012024688721,59.02976026916504,0.1,0.0,59.686805864764004,0.04803941843118098,0.0552043278991492,59.831460680280415,59.0780211857387,1.100564794892248
2024-04-26,0,61.642499923706055,58.15500068664551,61.892499923706055,59.00062417984009,60.39375042915344,0.35623981784748926,1.0070280722925162,-0.7248313593786393,2.9955902494668267,59.58750009536743,0.8397500419616705,0.016869731401884993,58.39625043869019,60.967250156402585,0.7312546174310723,0.012225045803896141,1.0326349833389499,1.0352819655300274,1.0167164232388155,0.03327327885343023,71.74780773436895,61.70843113504829,59.69437499046326,57.680318845878226,60.50714274815151,1.0913252109304568,59.62482139042446,1.2250421727192606,60.402562145802825,60.072350532464334,6.426789085944955,4.305877938237037,10994300,0.45514452746617434,0.8209795854666534,44145600.0,-18.240311200721028,97.4757252269488,97.9254675000122,145.47142231867778,34.975674605841924,14.232933792691702,0.06436562029470821,0.7962195691613744,61.490240188598634,60.809880210876464,60.260000228881836,59.71012024688721,59.02976026916504,0.1,0.0,59.70189939951416,0.02609285501256209,0.04803941843118105,60.289337158203125,59.253091539655415,1.1454791010381504
2024-04-29,0,61.88499927520752,58.15500068664551,61.892499923706055,59.00062417984009,60.39375042915344,0.43359792585425283,1.0478696176127302,-0.6902028540422589,2.995578704365293,59.58750009536743,0.8696000671386713,0.01754659707568205,58.39625043869019,61.01700019836426,0.7906168494661765,0.011403251851416735,1.0362655134374328,1.0340578110393603,1.0140759553632412,0.0269664626643471,68.44118342344223,61.814989246669555,59.71925001144409,57.62351077621862,60.95321410042899,0.8763367276871412,59.79392841884068,1.3645510386974877,60.71055267672488,60.24714273176453,5.620048369283485,3.945869348365094,13409300,0.4567306141229047,0.9948500283595283,57554900.0,-11.802559121670019,97.4757252269488,97.9254675000122,147.53099578681054,34.40616666255855,13.551718199069438,0.14860486236396506,0.7764785481206352,61.490240188598634,60.809880210876464,60.260000228881836,59.71012024688721,59.02976026916504,0.1,0.0,59.72183711480747,0.024607753162497525,0.031078685356454572,60.73303713117327,59.41752978733608,1.2394562692301279
2024-04-30,0,62.05250072479248,58.15500068664551,61.892499923706055,59.00062417984009,60.39375042915344,0.524671355020028,1.1202352602038528,-0.7037432774491208,2.9955571638588245,59.58750009536743,0.9258500099182129,0.01874364886268125,58.39625043869019,61.6667498588562,0.8297741009107021,0.025265053834251025,1.038255378986315,1.0308537780974525,1.0114342210323932,0.02574594333713187,72.64277158514643,62.00659548416809,59.766124963760376,57.525654443352664,61.29535715920584,0.7436304555060721,60.006249972752165,1.4719511226076099,61.002573441366714,60.403847410471045,5.313762137549594,3.977818898519841,19349200,0.4340825535116848,1.4025926202455763,76904100.0,-21.632674351073486,97.4757252269488,97.9254675000122,138.45701078907862,37.1320875169196,11.941877756680865,0.14709653143723098,0.8181804383513034,61.67360147094727,60.95820124816895,60.380001068115234,59.80180088806152,59.0864006652832,0.12000000000000001,0.0,59.75193112164772,0.0186345696619048,0.02014862286242338,60.95984922136579,59.61953381129673,1.3128426768590078
2024-05-01,0,61.8774995803833,58.15500068664551,62.05250072479248,59.00062417984009,60.581249952316284,0.5190442493840957,1.2212726716264428,-0.93571650670527,2.9955247908732767,59.58750009536743,1.027400016784668,0.020405302728022007,58.39625043869019,61.88574934005737,0.8577999234745252,0.03399293350570266,1.03386339539495,1.0213336590942717,1.003486715270761,0.017052916258930573,75.3677965317127,62.29329531273532,59.85074996948242,57.40820462622953,61.526428495134624,0.6070537614146344,60.20535707473755,1.526014714712545,61.263848306227466,60.558763026767394,4.014585658138475,5.031316531113246,16729800,0.42244867995866636,1.1994274511575187,60174300.0,-18.36737235949073,97.4757252269488,97.9254675000122,112.46764621709369,32.92055375483619,12.755772748896561,0.18999028690820396,0.8569006254867749,61.67360147094727,60.95820124816895,60.380001068115234,59.80180088806152,59.0864006652832,0.12000000000000001,0.0,59.77598230009991,0.00617385965536843,0.021273086067619053,61.15547398158482,59.82366425650461,1.3887771665530637
2024-05-02,0,62.07250118255615,58.15500068664551,62.05250072479248,59.00062417984009,61.04062509536743,0.40566856434854853,1.29880288220606,-1.2371992765402924,2.995498201108685,59.58750009536743,1.1393000030517584,0.021666937193301095,58.39625043869019,61.88574934005737,0.8912543969277794,0.0368648119928419,1.0355081613840884,1.0186423785910963,1.0032730127262266,0.0029082887114268985,73.50193440523121,62.541605722450456,59.94399995803833,57.34639419362621,61.75178582327707,0.42621093004719945,60.45392860685076,1.5265159135490953,61.41742233603456,60.67363975461309,2.684200705870921,4.717379286845931,10991300,0.4150770511460177,0.7975294748066002,71165600.0,-17.14285491854456,97.4757252269488,97.9254675000122,104.26394767298711,31.02573494672166,12.021584670025215,0.22224672814386798,0.844259205175868,61.67360147094727,60.95820124816895,60.380001068115234,59.80180088806152,59.0864006652832,0.12000000000000001,0.0,59.7924652614242,0.00404921372178535,0.007148705899106295,61.346846444266184,60.08662414550781,1.446573709944365
2024-05-03,0,62.03250026702881,58.15500068664551,62.07250118255615,59.00062417984009,61.701249837875366,0.2640960034710435,1.3767801578618362,-1.4556650330128924,2.9954700597300787,59.58750009536743,1.2443750619888305,0.022921981348251366,58.39625043869019,61.908500003814694,0.8943145132565236,0.04609229545580273,1.0327776776754831,1.0124862324677384,1.0020434227606223,0.006326809324823879,76.6335720618086,62.81731034433391,60.06375002861023,57.31018971288655,61.92214298248291,0.14957222288807542,60.713392870766775,1.4577122513736052,61.58177537253481,60.80223668841074,2.607655673991727,5.939329206715332,11628700,0.4011139768124813,0.8392955480606352,59536900.0,-13.469458297586776,97.4757252269488,97.9254675000122,92.98331195309095,29.189797657741806,11.996307774990095,0.223100994684591,0.8332362633394828,61.67360147094727,60.95820124816895,60.380001068115234,59.80180088806152,59.0864006652832,0.12000000000000001,0.0,59.80972095952945,0.00696462767638284,0.006964627676382949,61.43473597935268,60.37226486206055,1.5071521937382086
2024-05-06,0,62.232500076293945,58.15500068664551,62.07250118255615,59.00062417984009,61.879374504089355,0.0892128007931946,1.429962560349095,-1.583566927275622,2.9954503061321174,59.958749771118164,1.3065000534057618,0.02375412275886041,58.39625043869019,62.03450031280518,0.9068683293574133,0.04603515043835247,1.0337882175336017,1.0118283059995021,1.0040090970165598,0.005615267110872235,75.9199561664245,63.05842518173335,60.198500061035155,57.33857494033696,61.97071443285261,0.18848501857624994,61.00464282717024,1.3067508065692668,61.695733549196376,60.89572709724373,1.9600593547832097,6.220033663070035,9310700,0.4012329626413277,0.6743649061102572,68847600.0,-10.148055312264606,97.4757252269488,97.9254675000122,90.78325972990362,28.392881743831815,11.48707078642917,0.25339087195246335,0.8079952846751505,61.713721038818356,61.02314054870605,60.46500015258789,59.90685975646973,59.216279266357425,0.12000000000000001,0.0,59.82434270250791,0.004996718343665663,0.009880041630980522,61.52120699201311,60.67633383614676,1.5566966284418562
2024-05-07,0,62.61249923706055,58.15500068664551,62.232500076293945,59.00062417984009,61.88687443733215,-0.07654988063070907,1.4798809905113701,-1.6220984666754237,2.995431338451418,60.37750005722046,1.3572500705718995,0.02452367204921273,58.39625043869019,62.05450077056885,0.9121912544344805,0.045616821252409304,1.0375755937919509,1.0147522843399592,1.0090083374435068,0.009024592171582357,77.00132568791054,63.30476200963297,60.34500002861023,57.38523804758749,62.10928576333182,0.2526224088927126,61.30821425574167,1.1270407346655675,61.82978942611501,61.02134750551366,0.5493398279387707,7.0114338259904425,9807000,0.40110659795829223,0.7128545328265987,78654600.0,-4.895171430146594,97.4757252269488,97.9254675000122,96.64551864843577,30.905642692621115,10.895588790975678,0.22827732122849928,0.7909894784923558,61.81756161499023,61.19122148132324,60.685001373291016,60.17878126525879,59.5524411315918,0.12000000000000001,0.0,59.841805103654174,0.013760678239263413,0.009348754804751362,61.64595249720982,60.96764482770647,1.6215739898066655
2024-05-08,0,62.78749942779541,58.15500068664551,62.61249923706055,59.00062417984009,61.92750000953674,-0.20301595214964227,1.5456196491092788,-1.593427576620102,2.995405320735855,60.667500019073486,1.414250087738037,0.025547537807572174,58.39625043869019,62.08850107192993,0.8966362071884336,0.059791813280509115,1.0378141973019834,1.0141082694217587,1.0100055393818732,0.014706474139763115,82.11435583723865,63.590989244812796,60.499749946594235,57.408510648375675,62.238214356558665,0.33571311157453104,61.595714228493826,0.9225093672797392,62.02278569961418,61.17745975497845,1.5735885380298413,7.282073344284105,10484400,0.37982182545227894,0.7659281630041005,89139000.0,-3.0227382791781015,97.4757252269488,97.9254675000122,96.05367491122405,30.89230236176659,10.399834711213716,0.26381994459754193,0.7694831617177419,62.03308093261719,61.453460754394534,60.98500061035156,60.51654046630859,59.936920288085936,0.14,0.0,59.861605601991656,0.014855448106710245,0.017484175649450914,61.76077542986189,61.24690628051758,1.6502398302708423
2024-05-09,0,62.89750099182129,58.15500068664551,62.78749942779541,59.0081250667572,62.03750038146973,-0.35420332500375273,1.586026936488217,-1.4635917734601733,2.995389631033457,61.24125003814697,1.4391125106811522,0.02613534926863551,58.39625043869019,62.2704999923706,0.8967124107018676,0.06257402717311696,1.0364566444157681,1.0126995154539853,1.0088215398105425,0.0132909064972071,83.06212295426718,63.85717884245885,60.68512496948242,57.513071096505996,62.35892868041992,0.40298582237539415,61.827142919812886,0.796697428181924,62.20984903867341,61.35449338768975,1.4583504292767309,6.849605839770023,9113700,0.37757999118325386,0.6706810241578957,98252700.0,-7.871732762129735,97.4757252269488,97.9254675000122,95.055261378246,31.434907693002803,9.999837202791342,0.2582486645110967,0.7430834228066012,62.34052145385742,61.83974140930176,61.435001373291016,61.03026133728027,60.52948129272461,0.16,0.0,59.879536954782544,0.014357167725073117,0.015339942486389153,61.918126242501394,61.438987731933594,1.6641634807618002
2024-05-10,0,63.082499504089355,58.15500068664551,62.89750099182129,59.43374943733215,62.0575008392334,-0.5158871905731133,1.6114428351020236,-1.2687652856291551,2.9953802465759516,61.75999975204468,1.4354500484466555,0.02647112278008535,58.39625043869019,62.629999256134035,0.8797198372321792,0.07347358925578637,1.036254314005312,1.0140372924357863,1.0091181684317434,0.016926598678767668,87.03675485022264,64.09838568164815,60.87550001144409,57.65261434124003,62.531071526663645,0.42006628050954314,62.02875001089914,0.7233679970171535,62.37656936630377,61.538873626493185,1.36175054535908,5.431004845591162,8371700,0.3416284347539934,0.6249881018814891,106624400.0,-2.840973744699251,97.4757252269488,97.9254675000122,98.62249528504474,31.736266324083413,9.442503068745077,0.312398244799863,0.7307167353750381,62.52928050231934,62.01536043548584,61.60000038146973,61.184640327453614,60.670720260620115,0.18,0.0,59.89694701021283,0.017532578514678043,0.02048714352814287,62.106663295200896,61.631068638392854,1.6171285828300777
2024-05-13,0,63.40500068664551,58.15500068664551,63.082499504089355,60.109375,62.1125009059906,-0.6814323144565188,1.5903727834666628,-0.9372611013385437,2.9953914354391005,61.88124942779541,1.3867500114440916,0.02602901445935618,58.39625043869019,62.798499584198,0.8575646966153702,0.08017977544530017,1.0377250521545909,1.016867615713571,1.0108812761113437,0.018840647714845726,89.25042202474633,64.28074556693333,61.1,57.91925443306667,62.72142859867641,0.4758411486062482,62.236607210976736,0.6644377741997699,62.54994224542648,61.744528953755,1.9473959547131887,4.683868676546623,10137600,0.32735719639321503,0.7633387183791702,116762000.0,-1.0581247022920486,97.4757252269488,97.9254675000122,109.87467846141112,32.94754025547543,9.024382448470083,0.3809451446664053,0.7099455976484975,62.7279192199707,62.17603939819336,61.72999954223633,61.283959686279296,60.732079864501955,0.19999999999999998,0.0,59.919861327304496,0.01972744026541995,0.02267980574830287,62.332057407924104,61.839451926095144,1.5330946240168488
2024-05-14,0,63.30999946594238,58.15500068664551,63.40500068664551,60.43624997138977,62.327499866485596,-0.806335397855064,1.538769666907511,-0.503386741402954,2.995415522549549,61.88874959945679,1.291925072669983,0.025081717951662662,58.722499752044676,62.916000843048096,0.8134809561700101,0.09027598552166452,1.0319436263102033,1.0128749072427465,1.0056069936088294,0.011139951884702626,92.20104592098077,64.42778933953706,61.350250005722046,58.272710671907035,62.90392848423549,0.4076760875755274,62.4130357333592,0.5886810259139174,62.76198657271725,61.98668400398652,2.146682474048298,4.810316235377131,10852200,0.30637141175125354,0.8183314324495009,105909800.0,-25.8823547011296,97.4757252269488,97.9254675000122,97.00619037200138,29.842586774078036,11.904250956912204,0.38404176946165436,0.7278110004339357,63.15819850158692,62.78589861297608,62.48499870300293,62.18409879302978,61.81179890441894,0.2,0.0,59.94242551102373,0.007665326872065892,0.01202891947199644,62.46389171055385,61.94931384495327,1.3498087306076922
2024-05-15,0,63.14500045776367,58.36249923706055,63.40500068664551,60.75375008583069,62.65624928474426,-0.888473195665432,1.4081644234772488,-0.1297047923239174,2.995469220812621,61.96250009536743,1.127050104141236,0.022856843668704257,59.56799936294556,63.10524950027466,0.7903338130523488,0.0847719047943057,1.0249480670441622,1.0082068051836572,1.0007686708849644,0.005693824936910952,88.95291822250148,64.42432879164139,61.60799994468689,58.79167109773239,63.03428568158831,0.2844724214528123,62.50250005722046,0.5985784614561457,62.89749223719787,62.20071392401135,2.059403044233869,4.059827921038274,9838900,0.317202392251605,0.7531846469415868,96070900.0,-24.705782035612827,97.4757252269488,97.9254675000122,95.76745124425454,28.66090694687511,11.43287716749381,0.3359664909720151,0.7036760306594343,63.15819850158692,62.78589861297608,62.48499870300293,62.18409879302978,61.81179890441894,0.2,0.0,59.96233027850307,0.004455102862316096,0.008144421312360244,62.574462890625,62.04783494131906,1.156244856494223
2024-05-16,0,63.34000015258789,58.76249980926514,63.40500068664551,61.441874980926514,62.81499981880188,-0.9054500714002648,1.2317471475232673,0.08973300850645272,2.9955327165442447,62.042500495910645,0.9425250720977771,0.01991599686176693,60.199750137329104,63.16150035858154,0.7649182598668631,0.07457988789999609,1.02413814945687,1.0092777389515217,1.002722896573154,0.007035242319470614,83.08266299952798,64.31061930076858,61.84712500572205,59.38363071067551,63.1382143838065,0.23291509840182406,62.62375007356916,0.5826883662646009,62.96097503039843,62.36441354875061,1.466276271001561,2.023670938484559,10228000,0.32898556736599305,0.78567110431036,106298900.0,-17.25485326874775,97.4757252269488,97.9254675000122,106.91111436263793,30.199181189402626,10.663353875823327,0.298466234248251,0.7005556347008975,63.15819850158692,62.78589861297608,62.48499870300293,62.18409879302978,61.81179890441894,0.2,0.0,59.984036600469494,0.006997439214198264,0.007478182161935979,62.6736935206822,62.15982300894601,0.9515904211680805
2024-05-17,0,63.16999912261963,59.65749931335449,63.40500068664551,61.81874966621399,62.943750619888306,-0.7153688483078262,1.049049780527383,-0.32362969235590233,2.99558888406882,62.062500953674316,0.8128499794006345,0.016899442298804458,60.47149991989136,63.31299953460693,0.7784858780290825,0.06172737512665169,1.0176235437097763,1.004540055113669,0.9986325368821687,0.001387066448192975,82.91864669728443,64.17409958394296,62.07600002288818,59.97790046183341,63.192857197352815,0.17445395196006913,62.71553577695574,0.5580546695719371,63.05814522050967,62.53274051467973,1.161910040953506,2.7537822622100094,11539000,0.2893305238527573,0.9205564344413677,94759900.0,-28.627441593975465,97.4757252269488,97.9254675000122,76.94552917862151,28.837326296575796,11.545852161808718,0.22226145672437814,0.6812264083162587,63.15819850158692,62.78589861297608,62.48499870300293,62.18409879302978,61.81179890441894,0.02,1.0,60.00634258623786,-0.0036357957150614517,0.002385444788428569,62.699210030691965,62.229992730276926,0.8459651743064761
2024-05-20,0,62.742499351501465,60.260000228881836,63.40500068664551,61.883124351501465,63.098124742507935,-0.6523027575700512,0.9149020287217883,-0.4345800098757877,2.995623919812197,62.15250062942505,0.7485373926162723,0.014696837689386651,60.80550012588501,63.31299953460693,0.7974981843031153,0.04829072158454902,1.00788532569302,0.9959403545159321,0.9916000153964881,-0.010448723727931153,75.74206704931548,64.08142907079502,62.25162501335144,60.42182095590786,63.17071410587856,0.22164527733917383,62.76482139314924,0.5244506086203012,63.08770806837484,62.64222544568376,0.6091972101295212,2.076431869535318,11000900,0.28325752843024815,0.8941182399015575,83759000.0,-46.666626774395745,97.4757252269488,97.9254675000122,30.30599772743023,27.093167614236275,15.940804023375934,0.1472830428939013,0.6732801750263168,63.15819850158692,62.78589861297608,62.48499870300293,62.18409879302978,61.81179890441894,0.04,0.0,60.0243893416351,-0.015885567417100677,-0.010907387145184192,62.655264718191965,62.28669548034668,0.7400256117346029
2024-05-21,0,62.78749942779541,60.49499988555908,63.40500068664551,61.89062476158142,63.098124742507935,-0.6657000327420458,0.7970935541777747,-0.22035538559456747,2.995650385608842,62.422499656677246,0.673499870300293,0.012778901328925998,61.562249946594235,63.31299953460693,0.7729859842442666,0.03715182197196581,1.0066011143515619,0.9958484769818443,0.9943935401611775,-0.008253041266064964,62.33777258137542,63.969937077837976,62.37574996948242,60.781562861126865,63.12857123783657,0.2650155020756608,62.8298213822501,0.45822853259970364,63.00343798409216,62.670098752748736,-0.24643529214297313,1.1119594192813926,9796200,0.31050269984110634,0.8090025712311973,93555200.0,-40.09428784784389,97.4757252269488,97.9254675000122,32.76533570192152,25.518493832224728,15.229579787178672,0.13131105240261065,0.6637585944871293,63.2596785736084,62.95015872955322,62.69999885559082,62.44983898162842,62.14031913757324,0.06,0.0,60.04083353053492,-0.003011101854065945,-0.010537956050704084,62.60564967564174,62.356156485421316,0.6198190894817668
2024-05-22,0,62.84749984741211,60.84000015258789,63.40500068664551,61.99750018119812,63.098124742507935,-0.5186946534386777,0.6736728327950015,-0.4040017795305393,2.9956740535050383,62.677499294281006,0.5885873413085939,0.01078042551946181,61.853999614715576,63.31299953460693,0.7359888005828829,0.03201017867066328,1.0057148785092598,0.9965235244889776,0.9969938313064394,-0.004711388204843736,61.69278547221766,63.83772061218424,62.49037494659424,61.14302928100423,63.04892826080322,0.2515240736833881,62.88517842973982,0.4032112493204515,62.95156392030903,62.69607356913355,-0.46764170508941516,1.4706474139763104,7419400,0.30617017047809586,0.6450227514966259,100974600.0,-35.84899549253704,97.4757252269488,97.9254675000122,40.31420785549779,24.941397880192767,14.619540291084734,0.09131746978692733,0.6420581388046828,63.2596785736084,62.95015872955322,62.69999885559082,62.44983898162842,62.14031913757324,0.06,0.0,60.05368332977295,-0.002059283769693221,-0.0015848128951484791,62.52342987060547,62.42774363926479,0.5838916580153122
2024-05-23,0,62.37750053405762,61.642499923706055,63.40500068664551,62.04750061035156,63.098124742507935,-0.1540366380443777,0.5603124215907386,-1.4135939199289844,2.995692185129997,62.76499938964844,0.5038498497009272,0.00895200045063246,61.8842493057251,63.31299953460693,0.8861283863623258,0.0154299781861012,0.9965929566667314,0.988977024660356,0.990472802980057,-0.015195762807255875,57.79073247668388,63.71137477451693,62.59074993133545,61.47012508815397,62.91571412767683,0.3260933248553851,62.90982130595616,0.35471614309584976,62.92792787030494,62.73037875609694,-0.879269510600006,1.2485378389645914,9834300,0.20882186666720917,0.8906404101494045,91140300.0,-89.78500247135382,97.4757252269488,97.9254675000122,-37.31006463124937,22.392365207485106,19.687783722298512,0.08882440010562159,0.664057294612107,63.32103907775879,63.049479545593265,62.829999923706055,62.610520301818845,62.33896076965332,0.08,0.0,60.06725384484006,-0.01942517321040005,-0.01647396568290708,62.38025501796177,62.42207336425781,0.5619598933485361
2024-05-24,0,62.15250015258789,61.642499923706055,63.40500068664551,62.067501068115234,63.098124742507935,-0.20207186513181727,0.5396832936297172,-1.2714566624345558,2.9956951069779296,62.76499938964844,0.47499988555908174,0.008619073607897609,61.8842493057251,63.31299953460693,0.8251475125645047,0.01192360159405055,0.9926135940342264,0.9862227963892728,0.9899259455674444,-0.01610731334753801,47.09425371118651,63.69436654911247,62.61499996185303,61.53563337459359,62.773928369794575,0.4137676646239537,62.90410702569144,0.3669018090662407,62.789631652158896,62.67988280420186,-1.4729093978059555,0.5561605054506908,8200700,0.23015927993731422,0.7522094265809955,82939600.0,-98.32408782768623,97.4757252269488,97.9254675000122,-73.37087783409703,21.282797952600344,19.59312487897709,0.03997906546845318,0.6487651694528768,63.337559005737305,63.07621942901611,62.864999771118164,62.653780113220215,62.39244053649902,0.1,0.0,60.07741326372078,-0.016341402839619823,-0.020846506616749902,62.22006934029715,62.39726611546108,0.5436054478341763
2024-05-28,0,61.785000801086426,61.8774995803833,63.40500068664551,62.132500410079956,63.098124742507935,-0.07944652806916765,0.5039992999083353,-1.384385744598108,2.995699897826268,62.76499938964844,0.4469498729705812,0.00804590161514011,62.01775016784668,63.31299953460693,0.8193347076155447,0.004322547960140928,0.9863427148158878,0.9818402990690168,0.9872726115012853,-0.015260765196025372,40.898564635765375,63.64849857311379,62.64049997329712,61.632501373480444,62.55178560529436,0.47246352590577667,62.844999994550435,0.4697358383000052,62.62982909019058,62.61362608299303,-1.5717797101603368,-0.12855007208127386,12347000,0.23203659236143284,1.1380735705986753,70592600.0,-82.20344325387653,97.4757252269488,97.9254675000122,-122.02431232743758,19.58719698219594,24.252950666706823,-0.01067392409243664,0.654568364802988,63.20303907775879,62.85847954559326,62.579999923706055,62.30152030181885,61.95696076965332,0.12000000000000001,0.0,60.08997020725033,-0.011986563331243927,-0.019197209807732703,62.007433210100444,62.340563365391326,0.5579713487206178
2024-05-29,0,61.53000068664551,61.785000801086426,63.40500068664551,62.132500410079956,63.098124742507935,-0.11916554995404711,0.5119034787076477,-1.3343066329606454,2.995698865275869,62.76499938964844,0.4524497890472411,0.008172737158677635,62.01700019836426,63.31299953460693,0.7904005465637566,-0.004310864519263083,0.982350274811085,0.9803117266018199,0.9862157482955751,-0.020027851922913453,33.581180611927614,63.65930700700636,62.635500049591066,61.61169309217577,62.31750011444092,0.5191273652761785,62.75517865589687,0.5871338135718425,62.41765688327148,62.51117388528268,-2.455003706592085,-1.321618600211253,11861800,0.24386986265260888,1.1324276241770024,58730800.0,-76.57987398729664,97.4757252269488,97.9254675000122,-144.18419138067685,17.884563641023263,25.68617913796723,0.07201503409943874,0.6656720375809909,63.12515864562988,62.73241884613037,62.41499900817871,62.09757917022705,61.70483937072754,0.14,0.0,60.10022237638185,-0.01923382815033592,-0.013904411006645467,61.81889615740095,62.25905309404646,0.5636750294651353
2024-05-30,0,61.875,61.53000068664551,63.40500068664551,62.132500410079956,63.098124742507935,-0.29419869106577407,0.5526976453959285,-1.1048984845572547,2.995693274594262,62.76499938964844,0.4814997100830084,0.00882771382041412,61.86824970245361,63.31299953460693,0.7652150658259417,-0.005615916869529724,0.9882705258258143,0.9886119879241931,0.9957594663108504,-0.015473962365619154,30.644973004032344,63.71477033847557,62.60937504768371,61.50397975689186,62.193571635655,0.5040888567621142,62.682142870766775,0.6300927374828319,62.194694964513346,62.39971225701188,-2.596166627754278,-2.0027851922913498,9436800,0.2472786528283595,0.9334110780251068,68167600.0,-66.54267712470947,97.4757252269488,97.9254675000122,-98.23387252119811,19.1345123966747,24.336147711681285,0.09502530623209567,0.6524085303427827,63.12515864562988,62.73241884613037,62.41499900817871,62.09757917022705,61.70483937072754,0.14,0.0,60.1101281219827,-0.01634918469174096,-0.014941977149196185,61.733842032296316,62.19455337524414,0.5612204124476106
2024-05-31,0,62.40999984741211,61.53000068664551,63.40500068664551,62.132500410079956,63.098124742507935,-0.2944485185650843,0.5528633847142178,-1.105328057825378,2.995693251006241,62.76499938964844,0.48164968490600585,0.00883037864385668,61.86600008010864,63.31299953460693,0.8301724948622821,-0.0031817822512951173,0.9968175593696791,0.9991874871785708,1.0075229143946967,0.000521010189190596,38.72845786553678,63.71497683809299,62.60925006866455,61.503523299236114,62.13964312417166,0.446909090528559,62.63410718100412,0.6228156634444983,62.11456335065862,62.35601323140888,-1.3826343554493818,-1.625662348579234,19816600,0.25619579053209757,1.8781228438634934,87984200.0,-30.854960597986008,97.4757252269488,97.9254675000122,-11.418183522940236,26.197320255698422,21.01545674337618,0.18166513080741706,0.7015272335146416,63.12515864562988,62.73241884613037,62.41499900817871,62.09757917022705,61.70483937072754,0.02,1.0,60.13826286182893,0.01352877972271771,-0.001111062837047209,61.73667744227818,62.17116355895996,0.545327885457487
2024-06-03,0,62.795000076293945,61.53000068664551,63.40500068664551,62.21250009536743,63.098124742507935,-0.3611040974638962,0.541251533930611,-0.9456679581804615,2.9956948866152526,62.76499938964844,0.46276234149932877,0.008642583808500472,61.86600008010864,63.31299953460693,0.8350532283081918,0.006085512896599259,1.0026965595329658,1.006850497241586,1.013631847599155,0.010337475115702155,50.18721840230795,63.708628069768565,62.62612500190735,61.54362193404613,62.13214315686907,0.43328286731916754,62.59053570883615,0.5849209453692708,62.18775429661781,62.38567030976279,-0.6012336592850287,-1.066063745038592,9369000,0.2834251794860126,0.8975603774371198,97353200.0,-30.854960597986008,97.4757252269488,97.9254675000122,23.959864382183504,25.09411116140596,19.637243113945697,0.17620175455702541,0.6971319707513461,63.12515864562988,62.73241884613037,62.41499900817871,62.09757917022705,61.70483937072754,0.04,0.0,60.152821964585286,0.01500001209093349,0.013528779722717783,61.72675486973354,62.125092370169504,0.5356358250681772
2024-06-04,0,63.51249980926514,61.53000068664551,63.40500068664551,62.3412504196167,63.098124742507935,-0.540667324854087,0.5246962276678659,-0.6298087756973683,2.9956971649836035,62.78749942779541,0.4338998603820798,0.008373135044810204,61.86600008010864,63.31299953460693,0.8324141978474064,0.009038685563176845,1.0135364233513975,1.018967511527888,1.0230915369200388,0.027959844392335675,55.724758724489206,63.71364244770633,62.66424999237061,61.61485753703489,62.294285910470144,0.6816104210042689,62.605000019073486,0.6061976916189128,62.34040573112959,62.479374088477606,-0.08353517840109571,-0.9620701896467956,11895600,0.29247936672584585,1.1256735247749239,109248800.0,-1.0345716623389607,97.4757252269488,97.9254675000122,132.40904897385906,31.221915893587273,17.615560322976773,0.18850532560257335,0.7216247662572179,63.2856008605957,62.86220063781738,62.52000045776367,62.17780027770996,61.754400054931644,0.06,0.0,60.176505725410316,0.0342930933742529,0.03129028179749646,61.98900549752371,62.18463025774275,0.59444210176327
2024-06-05,0,63.832499504089355,61.53000068664551,63.51249980926514,62.401875019073486,63.15125012397766,-0.6213565761395953,0.5457711252249824,-0.4943085962558733,2.995694354238806,62.79124975204468,0.4355248594284049,0.008700563548441531,61.86600008010864,63.34650020599365,0.7783530311457046,0.014374135886143904,1.0176037036811887,1.0228378815463433,1.022555237419172,0.03742075071914597,63.78236893862226,63.81979222946914,62.72824997901917,61.6367077285692,62.534285817827495,0.8879146698740725,62.654107093811035,0.677017030923832,62.63509437838703,62.65749166823274,1.8195651725221325,0.3198552282908942,9632500,0.32198130472429026,0.912270931918023,118881300.0,-5.000050862630209,97.4757252269488,97.9254675000122,138.30437161168066,29.98631164057307,16.35983242523581,0.2014184872143111,0.7215087892352641,63.36199969482422,62.92399969482422,62.56999969482422,62.21599969482422,61.77799969482422,0.08,0.0,60.19634705537175,0.03598050038041101,0.03396954311942991,62.26117869785854,62.24062401907785,0.6440525901663504
2024-06-06,0,64.06750011444092,61.53000068664551,63.832499504089355,62.401875019073486,63.20499920845032,-0.4677326121180531,0.5953516259053603,-0.510113232733914,2.995687253676334,62.82124996185303,0.4655749702453612,0.009481744502087542,61.86600008010864,63.41575059890747,0.7762305059074353,0.01664344154198525,1.0203577861214401,1.0248873209504288,1.0188041706273054,0.035434345283893665,66.68066295451665,63.97995324418133,62.78924999237061,61.59854674055988,62.86035714830671,0.981106112250274,62.70607137680054,0.7569169912260145,62.935098986579845,62.85234252734566,2.703027790317319,1.0887624377887792,8658500,0.32660120652284885,0.827177784231604,127539800.0,-6.382949119605219,97.4757252269488,97.9254675000122,157.8605464408131,31.340731467940273,15.500427321363876,0.1855781500877073,0.7071142441425363,63.58356039428711,63.10322026062012,62.71500015258789,62.32678004455566,61.84643991088867,0.1,0.0,60.215654647118285,0.03517832493992068,0.03970828453454307,62.59147317068918,62.29945319039481,0.7060305904694709
2024-06-07,0,64.00749969482422,61.53000068664551,64.06750011444092,62.401875019073486,63.31749963760376,-0.27285737589268133,0.6573002126718395,-0.5597973146524877,2.995677537395721,62.8725004196167,0.5229999542236328,0.010457696497676553,61.86600008010864,63.54449977874756,0.7914758925753052,0.018601678988355463,1.0183642002224382,1.021933055882645,1.0108016743535164,0.02559685709530335,68.70532959010798,64.16785045204657,62.85325002670288,61.538649601359204,63.21428557804653,0.8606824418515472,62.76589284624372,0.8263166421215155,63.219308652685285,63.05059944525091,3.6942612021692436,1.1485632461327107,9523100,0.3288937842259187,0.9080004843635434,118016700.0,-13.67783093359182,97.4757252269488,97.9254675000122,122.37614477607798,30.0024706881571,15.15098248732732,0.1771687156323482,0.6858902909902483,63.58356039428711,63.10322026062012,62.71500015258789,62.32678004455566,61.84643991088867,0.1,0.0,60.235935473647935,0.015572853363750472,0.03130549207154859,62.90475681849888,62.36182648794992,0.7398295395102554
2024-06-10,0,63.72249984741211,61.53000068664551,64.06750011444092,62.401875019073486,63.356250286102295,-0.23875152393100188,0.7039034267561072,-0.7451720898516085,2.9956696148947803,62.96499967575073,0.5784998893737793,0.01118927696358526,61.86600008010864,63.84999952316284,0.8317735420739174,0.014663340831555028,1.0129354006565467,1.014742001421018,1.0012491555682406,0.014770280595449936,66.97162837856501,64.31655681536523,62.908749961853026,61.50094310834082,63.47821412767683,0.635299604271196,62.83589288166591,0.8647960693032806,63.41850517151131,63.19696744847902,4.026489485667157,1.3257884816159533,15687100,0.32860480604932835,1.445314803349254,102329600.0,-23.404262720098696,97.4757252269488,97.9254675000122,77.89440469542755,28.05178740349203,18.78004942837242,0.1251841521199729,0.6811837297159764,63.58356039428711,63.10322026062012,62.71500015258789,62.32678004455566,61.84643991088867,0.1,0.0,60.26596820861989,0.01048784999411101,0.010487849994111072,63.13440377371652,62.43412290300642,0.7502452479382888
2024-06-11,0,63.46500015258789,61.53000068664551,64.06750011444092,62.401875019073486,63.431875467300415,-0.2807597330751447,0.7252972023531881,-0.8827428444380909,2.9956658033961485,62.99625015258789,0.610499906539917,0.011523491578904931,61.86600008010864,63.84999952316284,0.8621556703350928,0.005007478232446008,1.0083292648044944,1.0081210430535295,0.9943050574180565,-0.0007478788714015971,60.13410427182024,64.39134438372554,62.94074997901917,61.490155574312794,63.62892845698765,0.43238152910781275,62.88428579057966,0.8806897183613767,63.495778674314664,63.262059359631166,2.985858339251894,1.5619404805989652,8396000,0.3299590486665362,0.779813275773033,93933600.0,-24.620095680465276,97.4757252269488,97.9254675000122,53.22629501303182,26.327313144513635,20.805258138223945,0.11322254157339,0.673956011893168,63.58356039428711,63.10322026062012,62.71500015258789,62.32678004455566,61.84643991088867,0.1,0.0,60.28076398579624,-0.006099469530309154,0.009852163484446634,63.22229276384626,62.479485103062224,0.7490291888519524
2024-06-12,0,63.23749923706055,61.53000068664551,64.06750011444092,62.401875019073486,63.4768750667572,-0.28506242476366567,0.7273324605359932,-0.8965448178897963,2.9956654348980236,62.99625015258789,0.6134998798370361,0.011555276911321487,61.86600008010864,63.84999952316284,0.8801061711429022,0.002448281281835904,1.0046668538968015,1.0018337461146498,0.9908882836324346,-0.009321274768359866,55.70451734156987,64.39841487338826,62.94374995231628,61.4890850312443,63.69214262281145,0.30318608011207515,62.91214288984026,0.8855910334915358,63.487861316457966,63.261564091399315,1.690434718402788,1.0790375966024817,9569600,0.3348140443991109,0.8941420502590504,84364000.0,-44.98477599964752,97.4757252269488,97.9254675000122,16.857973065520696,23.63009003298765,22.56686377516225,0.10519501420415049,0.6972461827890628,63.58356039428711,63.10322026062012,62.71500015258789,62.32678004455566,61.84643991088867,0.1,0.0,60.295671092823056,-0.016270241574256494,-0.016577974475166887,63.21520505632673,62.47097996303013,0.7487627465656156
2024-06-13,0,62.83500099182129,61.53000068664551,64.06750011444092,62.401875019073486,63.4768750667572,-0.27514330926892017,0.7256768318226735,-0.884832112675972,2.9956657338701134,62.99625015258789,0.6098748683929444,0.01152963761200658,61.86600008010864,63.84999952316284,0.8914697791824121,0.001464863071126992,0.9983297785133146,0.992771673772435,0.9864207406588087,-0.01923750919605216,52.384826771557506,64.39147860451754,62.940124940872195,61.488771277226846,63.59535707746233,0.44504287015229543,62.94482149396624,0.8726919964769624,63.426093814720325,63.212393422504654,0.7046726016864067,0.6205487737703486,9668900,0.33680031596922866,0.9041382825028871,74695100.0,-41.64129333274586,97.4757252269488,97.9254675000122,-10.466516195667054,22.185900473617945,23.6737290793999,0.15815708726049213,0.6895853505349697,63.58356039428711,63.10322026062012,62.71500015258789,62.32678004455566,61.84643991088867,0.02,1.0,60.30918468163314,-0.01808257741314112,-0.014549329241731048,63.08053643362863,62.53477096557617,0.7478270868540188
2024-06-14,0,62.427499771118164,61.53000068664551,64.06750011444092,62.401875019073486,63.4768750667572,-0.21363623285246466,0.7244449381658392,-0.8917363477070426,2.9956659426837366,62.8412504196167,0.6033372926712033,0.01151290037150232,61.86600008010864,63.84999952316284,0.8828049768095837,-0.007972831694822293,0.9920996716831754,0.9848395188795852,0.983830675788258,-0.024684606198323578,45.24381354642011,64.37351484390675,62.92462496757507,61.47573509124339,63.39464282989502,0.6074577668282481,62.96446432386126,0.8564297113146857,63.27948513628867,63.11352951538547,-1.066717291050501,0.7334382651544049,8179200,0.3453649902710907,0.7722338719042714,66515900.0,-55.01522400035248,97.4757252269488,97.9254675000122,-49.234023616992694,20.16166503048893,25.163333537461185,0.19198477037053852,0.7046158088626363,63.58356039428711,63.10322026062012,62.71500015258789,62.32678004455566,61.84643991088867,0.04,0.0,60.318780461797616,-0.013685720587896522,-0.017375742169514864,62.95513098580496,62.608154841831755,0.7433795323668578
2024-06-17,0,62.517499923706055,61.53000068664551,64.06750011444092,62.401875019073486,63.4768750667572,-0.04920478180787682,0.7255816094003796,-0.9353843763813483,2.995665679814901,62.81500053405762,0.598299789428711,0.011539331255182762,61.86600008010864,63.84999952316284,0.8715320186176329,-0.011753987047873712,0.994250862369128,0.9862321098703943,0.9901801611357126,-0.01891011693815381,40.37885063146611,64.33016316730235,62.87899994850159,61.427836729700836,63.17321423121861,0.6038015696689928,63.01678568976266,0.7993002552389588,63.06708484402625,62.96422166274682,-2.2010727198316613,0.44245946318351453,10532700,0.35450675179909386,0.9991846352843744,77048600.0,-52.88757429381741,97.4757252269488,97.9254675000122,-32.066026084619814,20.81795598624555,23.32948373414541,0.2358240161121004,0.7057148165183037,63.58356039428711,63.10322026062012,62.71500015258789,62.32678004455566,61.84643991088867,0.04,0.0,60.33172097998681,-0.0076130254373469874,-0.012581936424799186,62.80712073189871,62.699296951293945,0.7440156177357328
2024-06-18,0,62.60499954223633,61.53000068664551,64.06750011444092,62.401875019073486,63.4768750667572,0.07641621037251728,0.7264326337094702,-0.9416418352605662,2.9956654865047816,62.79124975204468,0.5921498298645019,0.01155886292314793,61.86600008010864,63.84999952316284,0.8881412193155032,-0.0035860769035498392,0.9961592781387386,0.9880449735484496,0.9953653943708832,-0.013550785602834292,43.427331027964364,64.29924025597485,62.84637498855591,61.393509721136965,62.9728570665632,0.5055183407814929,63.09357132230486,0.6895899223461395,62.930191335204896,62.85647709592055,-2.41932366327103,1.1855614034510924,10651700,0.3433213382850781,1.0121500384603141,87700300.0,-62.68109431969903,97.4757252269488,97.9254675000122,-24.397276308785525,19.989931531375674,22.401564438700433,0.2675755884000753,0.6824485724166593,63.70864010620117,63.30567979431152,62.97999954223633,62.65431929016113,62.25135897827148,0.04,0.0,60.34502363053206,-0.006829721720689186,-0.007454513941303713,62.69456100463867,62.79965891156878,0.7394293061956557
2024-06-20,0,62.317501068115234,61.53000068664551,64.06750011444092,62.401875019073486,63.4768750667572,0.10256729322701978,0.7280320760308798,-0.9557480268216816,2.995665184233188,62.79124975204468,0.5976498222351069,0.01158558034441677,61.86600008010864,63.84999952316284,0.891255759878252,-0.0029066277080990284,0.9916931399837163,0.9849182484812655,0.9935113261043721,-0.014548300929745572,44.87114055676808,64.2955641501544,62.83949999809265,61.383435846030885,62.772142955235076,0.4318211168254152,63.12517854145595,0.6376234804501201,62.84857733338458,62.79856081494018,-2.1911497235085715,1.747113348926288,13306300,0.3438224728039881,1.243656150753224,74394000.0,-81.64789084544772,97.4757252269488,97.9254675000122,-58.538750746018245,18.355389327332748,25.641502272715773,0.20330045954426054,0.6901311820080687,63.72988014221191,63.3400598526001,63.02499961853027,62.70993938446045,62.320119094848636,0.06,0.0,60.35898601133724,-0.0034593779257892088,-0.013965716856126083,62.56307765415737,62.84874071393694,0.7426219889625865
2024-06-21,0,62.55749988555908,61.53000068664551,64.06750011444092,62.36250066757202,63.4768750667572,0.1768737292899697,0.7368632157760994,-1.0229492232297506,2.9956635156839555,62.69999980926514,0.6183498477935793,0.011730502019173217,61.86600008010864,63.84999952316284,0.8813756705257338,-0.008433092495066038,0.995884803326861,0.9910844752917313,1.0002718178794405,-0.004416346015468808,40.384902097313635,64.28972651166085,62.816000080108644,61.34227364855645,62.64250005994524,0.30745906257597144,63.13571425846645,0.6260101135803134,62.71324163763991,62.719381351082,-2.2048707798049993,0.7151532413983586,28282200,0.3488392859837613,2.4085372084942875,102676200.0,-65.97511424306745,97.4757252269488,97.9254675000122,-13.736253122985406,20.28765816763,23.25657748905492,0.19119252175087442,0.7065508466287908,63.791240646362304,63.43938066864013,63.15500068664551,62.87062070465088,62.51876072692871,0.06,0.0,60.39391816255222,0.00423958970082472,0.005996381421237954,62.521550859723774,62.871921811785015,0.7454440718810431
2024-06-24,0,63.482500076293945,61.53000068664551,64.06750011444092,62.36250066757202,63.4768750667572,0.23210919270142655,0.7389510501929792,-1.0285421739554383,2.995663108694875,62.581249713897705,0.6267998695373536,0.011766455406764834,61.86600008010864,63.84999952316284,0.8899876405658997,0.002885645464476196,1.010843689933976,1.008150804793714,1.0159638319202688,0.016899608490549722,46.78140875492952,64.27940218240195,62.80150008201599,61.32359798163003,62.677500179835725,0.38948414578603263,63.18482140132359,0.6241896715410848,62.67023564888196,62.68964498829911,-1.4299224215660917,0.23634039177631705,13212500,0.33731658336453424,1.1092324237557498,115888700.0,-16.1825483129065,97.4757252269488,97.9254675000122,81.66205411923997,26.95401137222712,20.39248043937009,0.2725644104905865,0.7482269793566987,63.791240646362304,63.43938066864013,63.15500068664551,62.87062070465088,62.51876072692871,0.02,1.0,60.41659633654633,0.02270187051898853,0.023438064529988808,62.746429443359375,62.98081724984305,0.7843178147227006
2024-06-25,0,63.839999198913574,61.53000068664551,64.06750011444092,62.38687515258789,63.49000000953674,0.04985404214401435,0.7464551985131687,-1.12485974739459,2.995661770636134,62.69999980926514,0.6473497962951654,0.011875497823399977,61.86600008010864,63.84999952316284,0.8269860191265331,0.0213989770393923,1.0156426977032833,1.0146741392172165,1.0182467637157346,0.021154065290861723,61.08741866570029,64.34966045615414,62.856750059127805,61.36383966210147,62.821071352277485,0.5905500390312316,63.208214214869905,0.6432602879099886,62.86895544958336,62.81356519517212,0.3874296773105393,1.0948323897837553,10546800,0.38902526731573295,0.8768033440036512,126435500.0,-21.576783845943204,97.4757252269488,97.9254675000122,87.22721136251522,25.583875942217407,19.282318774866916,0.3072782455214173,0.7347818737317703,63.791240646362304,63.43938066864013,63.15500068664551,62.87062070465088,62.51876072692871,0.04,0.0,60.435358879247104,0.01948261324677092,0.02062351608731955,62.93714305332729,63.00883974347796,0.7863427734855382
2024-06-26,0,63.69750118255615,61.53000068664551,64.06750011444092,62.42312479019165,63.56499981880188,-0.13826552926707367,0.7573749255225957,-1.139040937560598,2.995659832760722,62.81500053405762,0.6697372531890871,0.012033069402316658,61.86600008010864,63.85674924850464,0.7774681396874934,0.03326047375872193,1.012017201328615,1.0122202372216311,1.0117057715372078,0.017450709181505042,66.43261169021719,64.45587486248928,62.94112501144409,61.4263751603989,63.002500125340056,0.6423021033283037,63.198571477617534,0.6341291566510283,63.10828219146437,62.98797563513219,1.599424192295465,0.5156455668285036,9402500,0.37968534237826224,0.7913583083574676,117033000.0,-12.862970050667414,97.4757252269488,97.9254675000122,77.86861029727929,23.42569684741634,20.33979164933692,0.3374290669760622,0.7451549738470143,63.791240646362304,63.43938066864013,63.15500068664551,62.87062070465088,62.51876072692871,0.06,0.0,60.45186239768796,0.022672871777508208,0.022836220764368607,63.15142931256975,63.05328014918736,0.7686009775546992
2024-06-27,0,63.96249961853027,61.53000068664551,64.06750011444092,62.49499988555908,63.70375084877014,-0.2960240726029082,0.7254286454642543,-1.0008720155027433,2.995665978072958,63.03625011444092,0.6497498512268066,0.011508027382646745,62.27325096130371,63.85674924850464,0.7328492302839233,0.03522672634036033,1.0146858711396847,1.0160559401348417,1.0124012620133582,0.02639705575833351,64.89018922415046,64.48760732144609,63.03675003051758,61.58589273958907,63.20892865317209,0.6908203605448442,63.191071442195344,0.623594971870133,63.254227257714,63.130004019897896,2.034362125816785,-0.21148838378881687,8494100,0.37482183465608043,0.7251804285549025,125527100.0,-15.517130816395994,97.4757252269488,97.9254675000122,84.30811084825034,23.5004742488166,19.060778285943815,0.3102448211781942,0.7383578436614221,63.722477615356446,63.38375821685791,63.10999870300293,62.836239189147946,62.49751979064941,0.08,0.0,60.467236249209584,0.02782244345039553,0.020437470181499308,63.33571515764509,63.0714179447719,0.6990475199272791
2024-06-28,0,63.78250026702881,61.875,64.06750011444092,62.547499895095825,63.74999976158142,-0.22188236415706244,0.6639201968221705,-1.327857445217708,2.9956769779237913,63.35124969482422,0.6085373687744138,0.010511989851904373,62.40074996948242,63.96699962615967,0.707260256058692,0.03373736757220644,1.00988190861692,1.0120310854889867,1.004322294430484,0.019581990707919994,66.76350236569347,64.48621537075616,63.15837497711182,61.83053458346748,63.37714304242815,0.6620143607677988,63.175000054495676,0.6035112557970944,63.4328904769809,63.29680762816133,2.311352335886177,-0.16389042138851498,17358800,0.3726471717929415,1.4335233956703115,108168300.0,-26.72397492160948,97.4757252269488,97.9254675000122,57.13366376946168,22.248777786455022,19.031886363530866,0.24182522300445558,0.724188865234145,63.722477615356446,63.38375821685791,63.10999870300293,62.836239189147946,62.49751979064941,0.08,0.0,60.4965369135084,0.014019452950416511,0.02364106165147066,63.48142950875418,63.08799525669643,0.6164977291100012
2024-07-01,0,63.68249988555908,62.317501068115234,64.06750011444092,62.59312462806702,63.795000076293945,-0.23878552046933743,0.607303619994532,-1.5515302760432357,2.9956861470402627,63.47375011444092,0.5581249570846559,0.009601069028889115,62.42574977874756,63.96699962615967,0.7556063035660973,0.021991674779239904,1.0067782525962568,1.0089275785686804,0.998894166815216,0.0031504715319146115,61.63638797759253,64.46835723045233,63.253749990463255,62.03914275047419,63.57214287349156,0.47148793415005036,63.17214291436331,0.600808534466985,63.52354469958458,63.418808550570546,1.8808413599589313,-0.3515204138080152,10033400,0.36381259105418395,0.8634576947984192,98134900.0,-43.40439485162466,97.4757252269488,97.9254675000122,31.475128438573122,19.770668114197182,20.68773656505903,0.14799750097154157,0.7567478529335789,63.74540251159668,63.4023021774292,63.12500190734863,62.84770163726807,62.504601303100586,0.1,0.0,60.51232634931355,-0.010786344040008222,0.00812487363093725,63.63857214791434,63.10082490103586,0.5975582241273087
2024-07-02,0,63.16250038146973,62.317501068115234,64.06750011444092,62.74749994277954,63.795000076293945,-0.42856806008334364,0.581691631728569,-1.3700759632411788,2.9956900174532066,63.49749994277954,0.5246499443054204,0.009186919574582168,62.50849990844726,63.96699962615967,0.7870684853220358,0.01413328781251457,0.9975539950776617,0.998703449575915,0.9901164759652904,-0.010612450281098695,58.34464494911212,64.48075825582774,63.3173749923706,62.15399172891346,63.65857151576451,0.2645191987889678,63.15053578785488,0.5948763996886909,63.56694253816468,63.49050598901257,2.1903940210180375,-0.06277211651898465,8878200,0.3579397831569971,0.7656600823510186,89256700.0,-48.936187481636715,97.4757252269488,97.9254675000122,-27.28062968965797,18.778077037798113,22.159347279811357,0.13252840852217362,0.7398369604673232,63.74540251159668,63.4023021774292,63.12500190734863,62.84770163726807,62.504601303100586,0.1,0.0,60.524184867470474,-0.010808249139407478,-0.012818503660725828,63.692858014787944,63.10720443725586,0.574447620486227
2024-07-03,0,63.27999973297119,62.317501068115234,64.06750011444092,62.77750062942505,63.795000076293945,-0.5133302695384458,0.5705988458146971,-1.21453540485872,2.9956916279627275,63.49749994277954,0.5025999259948734,0.00900911169041123,62.50849990844726,63.96699962615967,0.8239618089444799,-0.005510717242219973,0.9991197660933756,0.9995419233030951,0.9940698184428529,-0.006554439998963324,46.20879322084726,64.47694769925879,63.33575000762939,62.194552316,63.62964289528983,0.2961643199644019,63.153571537562776,0.595462480411061,63.46965861644865,63.44798766905879,0.9671110530590501,-0.47664030629617693,9154200,0.34219867446829416,0.7989063059768737,98410900.0,-41.27660748751297,97.4757252269488,97.9254675000122,-1.4233852237626772,20.236317303258616,20.576185452717954,0.08846916418905228,0.7398484537902078,63.74540251159668,63.4023021774292,63.12500190734863,62.84770163726807,62.504601303100586,0.1,0.0,60.537136921803175,-0.011241236321586134,-0.007988695493643875,63.60142953055246,63.17392948695591,0.5721657241207428
2024-07-05,0,63.47000026702881,62.317501068115234,64.06750011444092,62.77750062942505,63.795000076293945,-0.4572681410021352,0.5692462403641172,-1.2378202669092224,2.995691812522331,63.47375011444092,0.49771245002746556,0.008989405543776962,62.50849990844726,63.96699962615967,0.8145958425745923,-0.008655461957631297,1.0023036285650266,1.0014753124129252,0.9983641156743251,-0.0076998140228838885,46.93130632385959,64.46261748454293,63.3241250038147,62.18563252308647,63.57678590502058,0.2851779534669135,63.19892862864903,0.5935111029197315,63.42503537083237,63.398484258990706,-0.31898608762948344,0.06720774291108744,11735500,0.33456069062318944,1.0148686845276522,110146400.0,-22.978902309756364,97.4757252269488,97.9254675000122,29.061920249633037,19.8532949728418,19.014362080694347,0.11025805544009386,0.7434308390166835,63.74540251159668,63.4023021774292,63.12500190734863,62.84770163726807,62.504601303100586,0.1,0.0,60.5547905672365,-0.0023470744208581307,-0.004527786360763497,63.590000697544646,63.263571875435964,0.5845864766912099
2024-07-08,0,63.24499988555908,62.317501068115234,64.06750011444092,62.77750062942505,63.737499952316284,-0.42375935572945705,0.5584393574247095,-1.1928467768360667,2.995693316750791,63.46750020980835,0.4813999843597415,0.008821270607123404,62.50849990844726,63.96699962615967,0.7811154260644314,-0.009326098979120803,0.9990364237771752,0.9961136657307563,0.9963686741992647,-0.008427082337936764,49.40404650626099,64.42287875681109,63.30600004196167,62.18912132711225,63.51214286259243,0.30392365126802645,63.25732149396624,0.5504267215365702,63.438444447100395,63.37628869503867,-0.5795722689969305,1.010582104216362,11235100,0.33283767868111114,0.9608895354630083,98911300.0,-57.02138987953684,97.4757252269488,97.9254675000122,-18.815270736042446,18.127645789110474,18.873287405389146,0.06925224052494665,0.7560430086531422,63.74540251159668,63.4023021774292,63.12500190734863,62.84770163726807,62.504601303100586,0.02,1.0,60.56931563180732,-0.01084057226810442,-0.014864665392076686,63.43428584507534,63.29285757882254,0.5761187215992911
2024-07-09,0,62.892499923706055,62.317501068115234,64.00749969482422,62.77750062942505,63.70375084877014,-0.4094578249287547,0.5304292434334742,-1.1552855144675562,2.9956970846516486,63.37249994277954,0.4478874588012694,0.008384261301039586,62.50849990844726,63.852249240875246,0.7580870208024162,-0.011912663561310677,0.994114030785141,0.9894903261402314,0.9924962109174579,-0.01240529130094925,45.75961562010825,64.32573351738452,63.26487503051758,62.20401654365063,63.35928576333182,0.3087060709188523,63.28410720825195,0.5199348083844567,63.39003239793614,63.31244313654988,-0.7103909707544224,1.309519230208113,11657500,0.33561036990364296,0.9879978286507082,87253800.0,-68.51075987072247,97.4757252269488,97.9254675000122,-55.36561003925325,17.019387179996365,20.107585019949937,0.05533322700192314,0.7477540459901801,63.74540251159668,63.4023021774292,63.12500190734863,62.84770163726807,62.504601303100586,0.04,0.0,60.58250786844842,-0.009323643551979899,-0.015082527512267263,63.25999995640346,63.29785755702427,0.5816999694169066
2024-07-10,0,62.67500114440918,62.317501068115234,63.96249961853027,62.77750062942505,63.68625020980835,-0.3128822289047572,0.5075487291603055,-1.2241447027750536,2.9957000080994023,63.26249980926514,0.43579988479614257,0.00802967496897587,62.50849990844726,63.78825016021729,0.7498610528940045,-0.01302522540222914,0.9915498925638045,0.9869845769080062,0.9915361668499458,-0.007718175089907686,41.343631575509285,64.22422250028228,63.20912504196167,62.19402758364106,63.20107160295759,0.33806052443489387,63.28910732269287,0.513194491813034,63.264264147916265,63.2162244652092,-1.672854721447181,0.5998320477588444,11930400,0.33852822497572055,1.0274836193770196,75323400.0,-62.55318250954891,97.4757252269488,97.9254675000122,-74.76147829908375,16.076682037412983,21.909085649349272,0.12180650162534114,0.7350571178237186,63.74540251159668,63.4023021774292,63.12500190734863,62.84770163726807,62.504601303100586,0.06,0.0,60.59480519249262,-0.005067295124182691,-0.007111203491195572,63.142857142857146,63.312143325805664,0.5853129296670126
2024-07-11,0,62.89999961853027,62.317501068115234,63.96249961853027,62.65750074386597,63.53250002861023,-0.11532269608805888,0.5059143316743738,-1.304155518907939,2.9957001793939817,63.241249561309814,0.4426498603820804,0.0080104554274684,62.50849990844726,63.78825016021729,0.7536833093104238,-0.012447790219480483,0.9959347102590455,0.9923483377991601,0.9966329875767497,-0.0060050587238376085,39.12209888651244,64.16857877016027,63.15675010681152,62.14492144346278,63.0892858505249,0.27601578350914807,63.33071436200823,0.4478101997472834,63.11607234527476,63.11417670618689,-1.7363683110304948,0.1118147155733547,11431600,0.3373141633620317,0.9718219578919091,86755000.0,-56.603916177534344,97.4757252269488,97.9254675000122,-22.22227497745639,20.123425678124402,19.721401328829636,0.11243896586600477,0.7582674697825733,63.799682403564454,63.49016200256348,63.2400016784668,62.989841354370114,62.68032095336914,0.06,0.0,60.60829490502024,-0.0036318229951607384,-0.0007918139437783104,63.117142813546316,63.37785748073033,0.5852167147495009
2024-07-12,0,63.66499996185303,62.317501068115234,63.96249961853027,62.65750074386597,63.53250002861023,0.03349169854561342,0.5036828199476246,-1.288910703344853,2.995700446053403,63.19999980926514,0.44289988517761214,0.00797869138833431,62.50849990844726,63.78825016021729,0.7775249854273959,-0.005337017159155476,1.0084985368108474,1.005682781269514,1.0099704106721161,0.003072312809261346,44.712862312619684,64.13586572000389,63.128500080108644,62.12113444021339,63.161071504865376,0.35287447856478577,63.40982151031494,0.3954760264890208,63.060249036116154,63.07700848794018,-1.2287524334550373,0.9347270677274873,9201500,0.3393147841246057,0.783462775194333,95956500.0,-29.850828414719782,97.4757252269488,97.9254675000122,82.88320575325311,24.2344074610259,17.888510140938855,0.1324332935532375,0.7762487479272672,63.82564254760742,63.53218223571778,63.29500198364258,63.05782173156738,62.76436141967773,0.02,1.0,60.62241724523124,-0.0009409905924273598,0.005842395723780508,63.195714133126394,63.44428607395717,0.5741788508281787
2024-07-15,0,63.62249946594238,62.317501068115234,63.96249961853027,62.65750074386597,63.66937494277954,-0.03766528097984563,0.5167562832524841,-1.4016510424944202,2.9956987886613935,63.203750133514404,0.46213741779327366,0.008183013541996792,62.50849990844726,63.78825016021729,0.7208935124810736,0.013209182094860989,1.007484169188353,1.0054839449478095,1.0086721366965712,0.005968844668612139,58.84993940814594,64.18338768285324,63.14987511634827,62.1163625498433,63.21000003814697,0.3935175167583339,63.4198214667184,0.39920753123408675,63.20727924909838,63.14937899763173,0.7955663207575002,1.7703713836390114,8207500,0.36853292841062796,0.7032035494750712,87749000.0,-44.278719325881085,97.4757252269488,97.9254675000122,52.94458638796391,22.89575338196434,17.27489081312286,0.0708532639574428,0.7629451184467667,63.82564254760742,63.53218223571778,63.29500198364258,63.05782173156738,62.76436141967773,0.02,0.0,60.634237610479225,0.007147407393314875,-0.005489311219176919,63.20714242117746,63.40428597586496,0.5540087387102071
2024-07-16,0,63.849998474121094,62.317501068115234,63.96249961853027,62.65750074386597,63.66937494277954,-0.21545673588740671,0.5212466544167891,-1.39805067979044,2.9956982299695962,63.26249980926514,0.46482491016387967,0.008248976749785477,62.50849990844726,63.78825016021729,0.7036702174376941,0.019142200139450092,1.010456658903974,1.0093345418027166,1.0110686838051586,0.01522436779546954,59.967921662156726,64.2317433488879,63.18925004005432,62.146756731220734,63.26428549630301,0.4565277863456742,63.420535700661794,0.40002521825944154,63.30759071252922,63.21380357967322,0.541244839469771,0.22053225610236638,9025100,0.3537291222796008,0.7704620501490539,96774100.0,-1.9802466338073386,97.4757252269488,97.9254675000122,104.0836658095491,24.366098187299592,15.808511077260947,0.08715062854381779,0.7741633174995717,63.83327835083008,63.53835884094238,63.29999923706055,63.061639633178714,62.766720123291016,0.04,0.0,60.64898704808068,0.02520335062958945,0.020806823024824738,63.27999932425363,63.43500001089914,0.5776859235015759
2024-07-17,0,64.8700008392334,62.317501068115234,63.96249961853027,62.838125228881836,63.68625020980835,-0.3761389202086131,0.5093678134564965,-1.2590990702253888,2.9956998234650696,63.375,0.44708734035491915,0.008051925295355082,62.55349988937378,63.840999126434326,0.6728056646580539,0.021314008910163856,1.0254444565758556,1.0251871904001384,1.0241149483001397,0.03502193306333945,62.709419731095146,64.27911060211747,63.26037497520447,62.24163934829148,63.49642848968506,0.7584219318580351,63.50428567613874,0.5551371812752938,63.442297510471505,63.320770661473006,0.5987052237176141,0.01566302527098042,12508200,0.35561113924859566,1.0588813437791926,109282300.0,-5.806464315335337,97.4757252269488,97.9254675000122,217.28952661296552,31.582655835800313,14.225396566497123,0.11001009212784386,0.7988663874484482,64.65839974975586,64.20579997253418,63.84000015258789,63.4742003326416,63.02160055541992,0.06,0.0,60.67535114294294,0.03787994881517931,0.04019780687457264,63.6014278956822,63.517856870378765,0.6945308493858378
2024-07-18,0,65.13000106811523,62.317501068115234,64.8700008392334,62.89812469482422,63.718750953674316,0.2685561445646429,0.5895519671684298,0.16760381000622848,2.9956890425757656,63.47625017166138,0.47669990062713624,0.009302154800928759,62.6002495765686,63.86124858856201,0.5430781212017269,0.03617923989391601,1.0276436783513903,1.0265260948287735,1.0211425162957175,0.035453123419860955,72.54834171151984,64.5571039553177,63.378000020980835,62.19889608664398,63.81607151031494,0.916501590476098,63.587678636823384,0.6984562034983006,63.79842577934431,63.55929775995,2.569374585524124,1.8407310097092795,11128200,0.4141518270212092,0.940161264159615,120410500.0,-17.61351444492851,97.4757252269488,97.9254675000122,218.86904990937478,32.24276362233068,12.874161382240283,0.10331944913583868,0.819661582130846,64.97927835083007,64.46535884094239,64.04999923706055,63.63463963317871,63.120720123291015,0.08,0.0,60.69980763866955,0.03312209220008655,0.037561682979055655,63.95857129778181,63.60928562709263,0.7702350368570026
2024-07-19,0,65.34749984741211,62.317501068115234,65.13000106811523,63.09687519073486,63.796875,0.5618864904987227,0.6747083345260959,0.4017476215347062,2.995675941042971,63.552499771118164,0.5059998989105224,0.010624616990084736,62.66325101852417,64.05324974060059,0.5845348976303417,0.045131784038096104,1.0290256124167103,1.0269597023638095,1.0174380115406063,0.026427391605547967,75.85265659659763,64.85366676632697,63.50425009727478,62.15483342822259,64.19785703931537,0.918582316462725,63.699464321136475,0.8424325840759537,64.13190929212831,63.80525839840913,3.557659732278823,1.8252905320271906,13775700,0.40376816336857535,1.1615310351224077,134186200.0,-14.772645993588702,97.4757252269488,97.9254675000122,193.96596202617013,29.93880655344688,11.954218058832968,0.13504747955657556,0.819685733251283,64.97927835083007,64.46535884094239,64.04999923706055,63.63463963317871,63.120720123291015,0.08,0.0,60.72978782930621,0.024960755628639753,0.0347068541103757,64.30999973842076,63.72642844063895,0.7901141109727885
2024-07-22,1,64.90749931335449,62.55749988555908,65.34749984741211,63.22437500953674,63.842499017715454,0.8359273968657963,0.7292043090459195,0.22828503536337896,2.9956668649095337,63.643749713897705,0.5269999980926514,0.011455435033453833,62.87075004577637,64.89600086212158,0.6440101224663018,0.04459896842036485,1.0196643551666933,1.0170440857270078,1.005320292650926,0.020197255030824035,76.91825100497174,65.11415865433146,63.655750036239624,62.197341418147786,64.48464271000454,0.742315853566405,63.78696428026472,0.9020437441956256,64.43862598263382,64.05050641962191,4.2640584829751145,2.4536504116824323,11794200,0.4035296051585345,1.068746007222114,122392000.0,-29.545508731546928,97.4757252269488,97.9254675000122,121.32112428474552,27.440860144572067,15.257588414709645,0.10506514878447391,0.8304226420304234,64.97927835083007,64.46535884094239,64.04999923706055,63.63463963317871,63.120720123291015,0.08,0.0,60.75258187866053,0.021447670697475996,0.016797423348689736,64.54857090541294,63.832856859479634,0.7903803062510723
2024-07-23,1,65.31999969482422,62.67500114440918,65.34749984741211,63.271249771118164,63.87812376022339,0.7591483292509259,0.7320989168267686,-0.29094675314436325,2.995666569118943,63.673749923706055,0.5503998565673826,0.011479717855671232,62.89924964904785,64.92974948883057,0.8035049753144865,0.022447119054038005,1.02425389465034,1.0208483063462674,1.0076981192373111,0.023022729143821863,65.92910327417799,65.23744784128293,63.77325000762939,62.30905217397586,64.72107124328613,0.7001089030498439,63.941071374075754,0.968965919304896,64.56033061959619,64.17940675246996,3.191573461047862,1.923604491024694,11810300,0.3793815186091867,1.0770475238567718,134202300.0,-28.800048828125004,97.4757252269488,97.9254675000122,146.79803285709133,30.768554001710587,13.651575635199372,0.011023825495228458,0.8618215695532669,65.15500091552734,64.60750091552734,64.16500091552734,63.72250091552734,63.17500091552734,0.1,0.0,60.7778892160219,0.010735996226019617,0.024444082018457935,64.72857066563198,63.96214239937918,0.8303890093641974
2024-07-24,1,65.42499923706055,62.67500114440918,65.34749984741211,63.271249771118164,64.18937492370605,0.5938745008783421,0.8018246476081704,-0.7769501014981661,2.9956536512451217,63.69000053405762,0.6346750450134266,0.012554968736878705,62.89924964904785,65.14900093078613,0.8055289760799659,0.02318296545241547,1.0244245078794436,1.0186248260373543,1.0047607937302652,0.008555547874935288,68.98322257541118,65.46877428377225,63.865124988555905,62.26147569333956,64.97857121058873,0.5424367697552558,64.09428562436786,1.0243953594885153,64.7518090809773,64.3237069374664,2.599544072823119,3.4157914907172477,13244600,0.38172861236031025,1.1931717345340183,147446900.0,-6.1334228515625,97.4757252269488,97.9254675000122,142.06187748270682,27.92690739829235,12.552777078731031,0.04531827778988262,0.8816915546605466,65.15500091552734,64.60750091552734,64.16500091552734,63.72250091552734,63.17500091552734,0.1,0.0,60.807512803045235,0.009201019514566422,0.0239614282863586,65.07142748151507,64.13928495134626,0.9369566794943724
2024-07-25,0,66.21500015258789,62.67500114440918,65.42499923706055,63.271249771118164,64.87937545776367,0.47728515934403964,0.8707875866144337,-1.1105153302464668,2.995639745571978,63.69000053405762,0.7351874685287484,0.01361789190596208,62.89924964904785,65.322749710083,0.8309372197406482,0.02712034259481246,1.0355093808089182,1.026529471652754,1.0151626701465608,0.016658975382756847,70.63026264217578,65.68595016369213,63.94437499046326,62.20279981723439,65.31642859322685,0.45119706064139586,64.29035704476493,1.1506352078243556,64.91979905054212,64.44654340904235,2.833116878853614,3.389695817226327,16328600,0.37819207586787673,1.4264978310219554,163775500.0,-17.826086235406706,97.4757252269488,97.9254675000122,165.45971854997308,32.85747234107354,11.471839538009377,-0.033764485918867,0.8958566676180315,65.80439974975586,65.13279997253417,64.59000015258789,64.04720033264161,63.37560055541992,0.12000000000000001,0.0,60.84914098158347,0.013498960277059657,0.013188170869892556,65.32857077462333,64.30428504943848,1.048698649182878
2024-07-26,0,66.56000137329102,62.67500114440918,66.21500015258789,63.271249771118164,64.96312475204468,0.5249184750250875,0.9985820526294578,-0.9312108629088431,2.995611137116339,63.732500076293945,0.8723250579834001,0.01558573680578327,62.89924964904785,65.35524978637696,0.7984272078249103,0.03521595540342291,1.0388597115931024,1.0266020655895673,1.0170683148729938,0.018554673533189847,76.06773179091405,66.06741404422377,64.07024993896485,62.073085833705925,65.55785724094936,0.6000880076263254,64.5271428653172,1.2552985057074586,65.24403416624313,64.6359316089438,3.7039964526003093,4.324877696565957,13530100,0.4079124512357435,1.1565735074819836,177305600.0,-1.2447627052378487,97.4757252269488,97.9254675000122,160.9690319514707,31.747870706007152,10.481807523578102,0.022392101126495246,0.9104383143274779,65.97248068237305,65.2687607269287,64.70000076293945,64.1312407989502,63.42752084350586,0.14,0.0,60.88597934091912,0.026956687265291546,0.028531991727157226,65.5914284842355,64.59642818995884,1.241312713041277
2024-07-29,0,66.78249931335449,62.67500114440918,66.56000137329102,63.271249771118164,65.17750072479248,0.5392376651515806,1.1356325026510434,-0.9333631585622175,2.995576304943849,63.732500076293945,1.0174001312255854,0.01768894534362196,62.89924964904785,65.50399932861328,0.8205235657721582,0.043546444473547635,1.040223820211838,1.0254549824470682,1.016700784189743,0.028887262948585457,79.01482088500133,66.47139003200498,64.20012502670288,61.92886002140079,65.79392841884068,0.7173113915909716,64.80499996457782,1.2955182394648312,65.57307475676495,64.83595872098091,2.6052112104113068,5.241523430674964,12140200,0.40452036748033143,1.0614377873496013,189445800.0,-5.809103672714783,97.4757252269488,97.9254675000122,137.39488919569376,30.070987516173524,9.928171438874191,0.0821528823285237,0.8925500233834637,65.97248068237305,65.2687607269287,64.70000076293945,64.1312407989502,63.42752084350586,0.14,0.0,60.918791542846776,0.03180492967045412,0.02358708675038629,65.82571411132812,64.89214270455497,1.3617411520078868
2024-07-30,0,67.0875015258789,62.67500114440918,66.78249931335449,63.271249771118164,65.32687473297119,0.4653966408462284,1.2616947020598581,-1.0730278181792658,2.995540623069118,63.76624917984009,1.1406376028060918,0.01960671719707185,62.89924964904785,66.2495002746582,0.8442590116727388,0.04867898454624548,1.0425387914592588,1.0251640086073484,1.015546379036897,0.02705912185107895,80.72746433841331,66.87351438313888,64.35012497901917,61.82673557489946,66.04250008719308,0.8295311515899941,65.12017856325421,1.2740296558180446,65.87573634292173,65.04343641052175,2.5372304900026292,6.185156249739376,13258000,0.4005812070025405,1.1430556866761763,202703800.0,-2.7624588848720215,97.4757252269488,97.9254675000122,144.48694619381823,32.80912583144557,8.81179964390754,0.15802253670748287,0.9337967547986106,66.5485217590332,65.75574171447754,65.1150016784668,64.47426164245606,63.68148159790039,0.16,0.0,60.957487728674145,0.041871940564009114,0.04492826637224922,66.16714259556362,65.23857116699219,1.5203538495681819
2024-07-31,0,67.11499977111816,62.67500114440918,67.0875015258789,63.271249771118164,65.36687469482422,0.37427187919365706,1.3839305565936,-1.1814003472792087,2.9955028166311353,64.35999965667725,1.2441251754760743,0.02144951196090267,62.89924964904785,66.58225116729736,0.8458277792005119,0.062141319939903385,1.040214036381973,1.0205353880855186,1.010554995141106,0.02583111278204342,85.02489957934884,67.28823617422236,64.52037506103515,61.75251394784795,66.35785729544503,0.7410138575603968,65.42125000272479,1.2051833972212165,66.17781007668265,65.28480235205713,2.6626905123068827,7.0402876759473925,15576800,0.36752615916795783,1.3052821576607019,218280600.0,-24.33042746716212,97.4757252269488,97.9254675000122,115.44163651221126,30.15147010585213,8.098012574519434,0.10099949488577642,0.9435255838269136,66.77272103881836,66.11864054870605,65.59000015258789,65.06135975646973,64.40727926635742,0.16,0.0,61.00020628842624,0.01413159610510184,0.027401459427088368,66.44857134137835,65.49857112339565,1.5513863617517367
2024-08-01,0,67.4424991607666,62.67500114440918,67.11499977111816,63.422500133514404,65.62249946594238,0.2349665786726414,1.4562351609369153,-1.2888581389496574,2.9954795305347433,64.88875007629395,1.2862001800537115,0.02250123860827331,62.89924964904785,66.81299953460693,0.8682265665619755,0.06060366710382266,1.042098011819962,1.0220263836125731,1.0103442403089193,0.018538080576153915,85.01955658350404,67.63047035239141,64.71800003051757,61.805529708643725,66.66107150486538,0.6770446565601921,65.69107137407575,1.204601919910739,66.41039358299896,65.5075149148938,3.400994463068902,6.701113160811778,16495900,0.36921983779667883,1.3410483100623947,234776500.0,-3.151291146219845,97.4757252269488,97.9254675000122,130.99820154576312,30.69888449757799,7.263089043743471,0.14775396396295631,0.9768455979341377,66.98664010620118,66.29167979431152,65.72999954223633,65.16831929016114,64.47335897827148,0.18,0.0,61.04928367879251,0.028606014808207902,0.03266983141831389,66.87714276994977,65.80285671779087,1.6645546555315645
2024-08-02,0,68.80500030517578,62.67500114440918,67.4424991607666,63.58437466621399,66.30125045776367,0.11479897361285009,1.531358015939506,-1.312205304754608,2.9954543277433867,65.01875019073486,1.3163751125335694,0.023586160669445758,62.89924964904785,67.09025135040284,0.8732674847526959,0.06258860685402287,1.0597429047729936,1.0390326277625546,1.0269786196517636,0.03372894960284101,86.21566610952574,67.98884103378636,64.92612500190735,61.86340897002835,67.1439288003104,0.8353476997706863,66.06125000544957,1.311574737362755,66.6668418190499,65.74659530457713,3.249386827707784,5.933400143213676,22514800,0.3702628486247183,1.7535280183399709,257291300.0,-5.413955477371794,97.4757252269488,97.9254675000122,170.72074942751505,37.1854669981505,6.283393351850697,0.15688853810557227,1.048499480891986,68.18791845703124,67.2710386352539,66.52999877929688,65.78895892333985,64.8720791015625,0.19999999999999998,0.0,61.128248640092444,0.03400445451936629,0.04934163994684944,67.38000052315849,66.22571400233677,1.8938711593280524
2024-08-05,0,68.59250068664551,62.67500114440918,68.80500030517578,63.654374837875366,66.61562585830688,0.22620539752304933,1.7088506453764891,-0.8986193897349919,2.9953893302812076,65.22500038146973,1.4171250343322754,0.02621223017509962,62.89924964904785,67.147749710083,0.810945856818828,0.08791209470594419,1.052147196800753,1.0304434801906202,1.0169912548631501,0.027102929538443732,91.35731234233157,68.61057629456766,65.19287500381469,61.775173713061726,67.48357173374721,0.8770010926218035,66.40000016348702,1.3089643908364799,67.19886996158948,66.1176472906132,5.166222556408688,8.14570455850706,25484300,0.43613825623679675,1.8804583028185513,231807000.0,-29.34579705804759,97.4757252269488,97.9254675000122,131.2400192761142,32.80516724387129,5.543234666832162,0.12103332368830724,1.1036068548953395,68.40739852905273,67.62629875183106,66.99499893188477,66.36369911193847,65.5825993347168,0.19999999999999998,0.0,61.210815054691,0.01900339081655189,0.01565988627252947,67.67000034877232,66.49928556169782,1.9093774352499169
2024-08-06,0,68.20249938964844,62.67500114440918,68.80500030517578,63.80374884605408,66.8587498664856,0.1455164877851023,1.7991228366934175,-0.9404308478242767,2.9953549890453353,65.33374977111816,1.4918001937866223,0.02748420355082225,62.89924964904785,67.5574993133545,0.8334304322624807,0.09063085057604704,1.041891825099074,1.0189438819333174,1.0058104676854214,0.016620053488493935,88.72061772431539,69.05849571725587,65.46025004386902,61.86200437048218,67.71821430751255,0.8055288429041372,66.63803577423096,1.3123347747887344,67.54325587440225,66.41973064735389,3.590576951716124,7.427568247235883,12969100,0.4262471623027133,0.9523669650393916,218837900.0,-30.28029120052479,97.4757252269488,97.9254675000122,106.87236714082547,30.5283364687389,5.158508468382981,0.1271813991307157,1.1012063347300873,68.40739852905273,67.62629875183106,66.99499893188477,66.36369911193847,65.5825993347168,0.19999999999999998,0.0,61.25075599810368,0.005466943630520804,0.018255292342910165,67.81285749162946,66.70214298793248,1.8624829188967167
2024-08-07,0,68.38000106811523,62.67500114440918,68.80500030517578,64.61500024795532,67.09437608718872,0.025592998781161495,1.7923956832777008,-0.9932790248290231,2.9953604185403333,65.38624954223633,1.5270751523971555,0.027270828903581415,63.55024948120117,68.24149951934814,0.8388558510197502,0.08819302982545425,1.0403837316463618,1.0172151685997137,1.0051226447476216,0.01884826493795866,81.92857939299945,69.31054138372153,65.72575001716613,62.14095865061074,67.94642884390694,0.7177611422991692,66.87017863137382,1.3125050452383817,67.70595829308682,66.64774738930079,2.467695286161034,5.1371951708062,13365300,0.43882479881533926,0.976317615690858,232203200.0,-22.61681176780965,97.4757252269488,97.9254675000122,107.24318486571543,30.067913779361046,4.713969747953069,0.08427197321159667,1.1189772618519218,68.40739852905273,67.62629875183106,66.99499893188477,66.36369911193847,65.5825993347168,0.19999999999999998,0.0,61.293019947458625,0.02577167029903138,0.011524804606675291,68.04571424211774,66.93571417672294,1.8119606035545288
2024-08-08,0,68.36000061035156,62.89999961853027,68.80500030517578,64.89812469482422,67.19687461853027,-0.019839428567896444,1.7373007002101415,-1.078826224468469,2.995385808460238,65.81999969482422,1.5072502613067627,0.026318351484733663,63.66074991226196,68.40125102996826,0.8298810501319357,0.08712244010841867,1.0355849872979506,1.0124670045842301,1.0011056753457415,0.013604203002588244,82.45454880628354,69.48560141377173,66.01100001335143,62.53639861293114,68.12821442740304,0.6182030173742534,67.08535725729806,1.290423201131603,67.87444352962238,66.8833101695917,2.3920963893025338,4.990019878244799,15240900,0.43932821338095707,1.098050319291151,216962300.0,-17.57000149735823,97.4757252269488,97.9254675000122,98.21640349613875,28.115781238740993,4.407919457666742,0.11067645401781516,1.1111932998946055,68.40739852905273,67.62629875183106,66.99499893188477,66.36369911193847,65.5825993347168,0.02,1.0,61.340550570942284,0.011330257251826126,0.02981728434013566,68.19571467808315,67.18142863682338,1.7580513512077494
2024-08-09,0,68.60499954223633,63.62249946594238,68.80500030517578,65.07437562942505,67.63249921798706,-0.04671008611589505,1.6539826822794723,-1.217237787731332,2.995420769449015,66.38750076293945,1.4487502574920654,0.024952970259925017,63.83149862289429,68.40125102996826,0.8553196829204233,0.07374539623516373,1.035015983903956,1.0128778060491455,1.002000922028169,-0.002906776572231262,81.13568073359147,69.59196542750149,66.28400006294251,62.976034698383536,68.34107153756278,0.4428342211898588,67.3494644165039,1.1844248088874412,67.99843125298415,67.09507395012606,1.8967751899089453,4.6099709552373245,12080400,0.4293654724055058,0.8614145413083798,229042700.0,-20.454516794138602,97.4757252269488,97.9254675000122,94.11515263963868,27.102629891418047,4.249080210074629,0.13962014586906352,1.0703937250482223,68.52775903320313,67.8211195678711,67.25,66.6788804321289,65.97224096679687,0.02,0.0,61.378267171299605,-0.009375472504138282,0.010594485438532461,68.47285788399833,67.46071461268834,1.7104439548937147
2024-08-12,0,68.24749946594238,63.62249946594238,68.80500030517578,65.27250003814697,68.24187469482422,-0.15028255642307217,1.6127751164727537,-1.210386336118357,2.9954380528797477,66.67125034332275,1.4091502285003656,0.0242409570794902,64.76800060272217,68.59375057220458,0.8319716087081154,0.07831349158108943,1.025799994331937,1.0045667042452577,0.9973621793304966,-0.005029722159849648,82.60983088268641,69.75655027490717,66.53100004196168,63.305449809016174,68.45607158115932,0.21808302348597253,67.55857154301235,1.04927764497917,68.15072877127434,67.29653359198147,2.220069695596365,5.69656860608877,11012300,0.42392415400793876,0.7774769400211097,218030400.0,-30.99175898661387,97.4757252269488,97.9254675000122,69.87463815448459,25.54238099954423,6.8490061586326165,0.15967473846201433,1.0546511645527485,68.52775903320313,67.8211195678711,67.25,66.6788804321289,65.97224096679687,0.04,0.0,61.41044700724177,0.0010278956885854118,-0.016731626012878302,68.5028577532087,67.69000026157924,1.563764453189882
2024-08-13,0,68.29000091552734,63.849998474121094,68.80500030517578,65.34062480926514,68.27562475204468,-0.21488280106511806,1.507287878079295,-1.2733392079733696,2.995476964387249,66.9350004196167,1.3235250377655035,0.022576948457128522,64.90374946594238,68.59375057220458,0.8296114640444041,0.06887237426643997,1.0228834539369995,1.003029368424583,0.9989906362042154,0.0012829665578528715,74.46419301670375,69.77682579812024,66.76225004196166,63.747674285803086,68.38250023978097,0.15984380210637839,67.7632145200457,0.8642178393853958,68.17685808884976,67.40425512718566,1.1936098382962579,4.481781666863864,9877600,0.44599843217606305,0.6952739098071167,227908000.0,-31.758526504653734,97.4757252269488,97.9254675000122,72.38867777352651,24.960607974018277,6.561845378767993,0.14757602258173186,1.0221758908301952,68.77083874511719,68.2145791015625,67.76499938964844,67.31541967773437,66.75916003417969,0.04,0.0,61.439813728515084,0.0060249230613995675,0.005286352693361183,68.37857164655414,67.8792860848563,1.4756452700483167
2024-08-14,0,68.45750045776367,64.8700008392334,68.80500030517578,65.40562438964844,68.3075008392334,-0.22979768424364677,1.3839340194063046,-1.4842232910696898,2.995518482665786,67.10125064849854,1.230075063705445,0.020660588362448,65.10775089263916,68.59375057220458,0.8703369891426042,0.05272082676196804,1.0219939805271236,1.0037167961684161,1.0011846195249758,0.0011333633875092453,72.84760185929929,69.7521182028446,66.98425016403198,64.21638212521935,68.36321449279785,0.1367610514658136,67.92339311327252,0.7562664799156306,68.20582682035527,67.52288428508615,-0.7484912250043217,4.379062608905454,14328000,0.4067178778584159,1.0021146661733495,242236000.0,-29.78135298912081,97.4757252269488,97.9254675000122,74.80506795585883,25.603375515159463,6.206853503856568,0.12819401177546974,1.0034491504071534,68.8062391052246,68.27187968444824,67.84000015258789,67.40812062072754,66.87376119995118,0.04,0.0,61.483029324104635,0.0017528885215725154,0.007788372601449641,68.4471435546875,68.05857195172992,1.4432880251766036
2024-08-15,0,68.67250061035156,64.90749931335449,68.80500030517578,66.01749992370605,68.36500072479248,-0.39723159537035213,1.3297062823481602,-1.3608205687420323,2.9955357579496686,67.27874946594238,1.1746250152587892,0.019798012383611962,65.30099983215332,68.59375057220458,0.8652697228010489,0.05109011722828658,1.0224656644446524,1.0048911180685873,1.0041013628958613,0.004571386735076732,73.74595500070782,69.82303770965483,67.1636251449585,64.50421258026218,68.43035752432687,0.1583733787283354,68.07428591591972,0.6690274760042295,68.26709494211742,67.64652615216568,-0.1968148522512164,3.3866953107424216,11285100,0.4062845192561154,0.7888583569662531,253521100.0,-30.815631281001643,97.4757252269488,97.9254675000122,77.1385061062138,25.02754155970864,6.013247523225036,0.12220697493049816,0.9617739900681552,68.88883874511718,68.4055791015625,68.01499938964844,67.62441967773438,67.14116003417969,0.04,0.0,61.51744627587529,-0.0011640015589584607,0.0027753789650479892,68.53285762241909,68.17285755702427,1.3903331581284908
2024-08-16,0,68.98999977111816,64.90749931335449,68.80500030517578,66.47375106811523,68.39937591552734,-0.5791975664769274,1.2821074268588926,-1.1188877542240805,2.995550342745395,67.82249927520752,1.130675086975097,0.01903910224544252,65.34474983215333,68.61174964904785,0.8560567932978398,0.050881835888188606,1.0244911089653472,1.0077233393136322,1.0078227080937288,0.005611839245692529,75.12610242924401,69.90496497578812,67.34075012207032,64.77653526835252,68.51750019618443,0.26076794199730197,68.2319645200457,0.5974635215565176,68.36678122821574,67.78327224286907,0.6891260949513829,3.1738269132732375,12651200,0.4062711886560731,0.887841826156006,266172300.0,-14.803571757850676,97.4757252269488,97.9254675000122,91.31510048306143,26.65955222814708,5.7117392204039135,0.14386441004533343,0.9402189233053713,68.88883874511718,68.4055791015625,68.01499938964844,67.62441967773438,67.14116003417969,0.04,0.0,61.557504572424634,0.007280139746334902,0.0065473145098688705,68.63571493966239,68.34071459089007,1.348357063883749
