date,buy?,todays_price,Minimum,Maximum,25th Percentile,75th Percentile,Skewness,Standard Deviation,Kurtosis,Shannon Entropy,Median,Mean Absolute Deviation (MAD),Coefficient of Variation (CV),10th Percentile,90th Percentile,Autocorrelation,Cumulative Return,curr_to_avg_one_month,curr_to_avg_one_two_week,curr_to_avg_one_one_week,momentum,rsi,upper_band_current,middle_band_current,lower_band_current,rolling_mean_7,rolling_std_7,rolling_mean_14,rolling_std_14,ema_7,ema_14,roc_7,roc_14,Volume,Volatility,Relative Volume (RVOL),On-Balance Volume (OBV),Williams %R,Stochastic Oscillator %K,Stochastic Oscillator %D,Commodity Channel Index (CCI),ADX1,ADX2,Chaikin Money Flow (CMF),Average True Range (ATR),Fib_23.6,Fib_38.2,Fib_50,Fib_61.8,Fib_76.4,Parabolic SAR 2,Parabolic SAR 3,VWAP,Adj Close Momentum,Adj Close Return,Adj Close 7d MA,Adj Close 14d MA,Adj Close Volatility
2024-01-02,0,474.5499954223633,451.01500701904297,492.6375045776367,460.5387477874756,490.64437675476074,-0.17762507981397968,15.449943044270695,-1.5505977360450147,2.9952004163401984,472.6125030517578,13.99386211395264,0.03257901661333706,452.9290023803711,491.38149337768556,0.9145494435628209,0.03868549765959186,1.0006750277605307,0.9728526736961429,0.9681868183356224,-0.032631255733719944,64.83167303000522,505.1297631789955,474.2298770904541,443.32999100191273,488.0892868041992,6.107233427066378,482.9255365644182,10.156105327422505,488.1362442078416,480.48819097347695,-0.6213005428642031,7.766817716974149,5049400,5.582907475227702,1.2448719971598754,11712100.0,-77.69252279119078,77.78309058422582,77.02796724212243,-12.789523316083356,26.275669462595427,26.078221826393584,0.05508653381265936,11.198811610971934,491.05117407226567,484.96443371582035,480.0450134277344,475.12559313964846,469.0388527832032,0.08,0.0,472.5364526376505,-0.03751337291331147,-0.04700877939864459,486.74857439313615,483.0371420724051,16.46113276202962
2024-01-03,1,469.5999984741211,451.01500701904297,492.6375045776367,460.5387477874756,490.64437675476074,-0.22490809450267876,15.414729984760909,-1.5249838738733954,2.9952031114547877,474.2387466430664,13.782624435424804,0.032488099157796047,452.9290023803711,491.38149337768556,0.901866618670491,0.03880608595950083,0.9897293906549577,0.9617910234056004,0.9643868846227368,-0.04086928254911559,50.20131929119309,505.30258657169463,474.47312660217284,443.64366663265105,484.9807161603655,9.012062145815229,483.37839344569613,9.318590973726119,484.68000885354735,478.9943944303953,-3.6715656009139583,2.7659422959681854,3443700,5.641125102189451,0.867330233776439,8268400.0,-78.47804737688203,77.78309058422582,77.02796724212243,-23.771134418056317,24.273640105083274,24.091236651287904,0.08475146606684596,11.025117705079694,491.678927734375,485.9805434570313,481.375,476.7694565429687,471.071072265625,0.08,0.0,472.4521484324655,-0.04261078721421652,-0.033897607997716885,483.6985778808594,483.55571419852123,15.792305744395755
2024-01-04,0,473.7300033569336,451.01500701904297,492.6375045776367,462.8893756866455,490.64437675476074,-0.29523254582964764,14.927018495237396,-1.3801884431374785,2.995237072192695,474.2387466430664,13.199950218200684,0.03141789399268654,452.9290023803711,491.38149337768556,0.8707426643200064,0.0367475722219196,0.9970912162647838,0.9727979876588009,0.9809303296537867,-0.03630167055300315,45.813037018569446,504.96603840954214,475.1120014190674,445.25796442859263,482.57678767613004,9.507273264682576,483.5521430969238,9.096029519818366,480.86807679956155,477.5376199329463,-4.428523855762767,1.3685611338460055,3636500,5.694534722656909,0.9129479696227955,11904900.0,-67.17904570674374,77.78309058422582,77.02796724212243,-11.467894350508827,26.033748376812266,21.40215088344579,0.06414684948106515,11.30801603301273,491.678927734375,485.9805434570313,481.375,476.7694565429687,471.071072265625,0.08,0.0,472.5121867415995,-0.03481159604653439,-0.03363258399308022,481.971435546875,483.17642865862166,15.08741355717279
2024-01-05,0,475.4774932861328,451.01500701904297,492.6375045776367,468.01499938964844,490.64437675476074,-0.3803985412516442,14.045844361631877,-1.163760779697841,2.9952954406028844,474.2387466430664,12.26507514953613,0.029498733998677123,453.18550567626954,491.38149337768556,0.8506675301391512,0.045207831646446685,0.9985860398054311,0.9798422016903787,0.9918789153505009,-0.03184576887558477,50.535096567723656,504.24244021862506,476.1507514953613,448.05906277209755,480.55785696847096,9.262205375423683,483.66285705566406,8.97854432652507,479.0603421001838,477.1038117584046,-3.43028071030062,0.5161273027461255,2612500,5.738088573631741,0.6690252206502797,14517400.0,-68.74198552546804,77.78309058422582,77.02796724212243,-12.87405897581657,24.431990112353024,20.085357329226124,0.09775313354719363,10.997377308549467,491.678927734375,485.9805434570313,481.375,476.7694565429687,471.071072265625,0.08,0.0,472.58424288656033,-0.033536547429259156,-0.036051995116343646,479.5242919921875,483.4785723005022,13.44603313254596
2024-01-08,0,479.45249938964844,451.01500701904297,492.6375045776367,469.8362445831299,490.64437675476074,-0.4611872509594316,13.031769982806813,-0.8859565426753102,2.995357820757096,475.01374435424805,11.264388198852538,0.027305238826613357,460.86924743652344,491.38149337768556,0.8030478867209581,0.05423874125336361,1.0045884035033708,0.9915400517271492,1.0067402649250738,-0.01722336331382779,53.09748609586806,503.3261658506234,477.26262588500975,451.1990859193961,478.8260716029576,7.8907284061412755,484.3441074916295,8.1816458761859,478.1684544111022,477.0486007249411,-2.8864840823868634,0.32705327910912385,3675800,5.6860496939253125,0.939287931946471,18193200.0,-40.63541881689154,77.78309058422582,77.02796724212243,16.279243067390567,26.65542042032515,18.274546213977217,0.1154518501714622,11.048308245497584,491.678927734375,485.9805434570313,481.375,476.7694565429687,471.071072265625,0.08,0.0,472.9086578341905,-0.003799716737106329,-0.011172067597451433,478.55857631138394,484.40500095912387,12.131738670973236
2024-01-09,0,479.1274948120117,452.69500732421875,492.6375045776367,470.9518795013428,490.64437675476074,-0.4460303308390909,11.55846892739809,-0.7850431187561373,2.9954396406197796,477.4649963378906,10.061500930786133,0.024146319580515874,463.1117515563965,491.38149337768556,0.750219444239378,0.05910710662259647,1.000925441095347,0.9933140056340655,1.0096204433678824,0.009645979209365052,56.82415102900525,501.80143835833627,478.68450050354005,455.56756264874383,477.1132125854492,5.803099968073955,484.1110714503697,8.287365306419455,478.4832357255759,477.7648094372336,-2.466052511590642,2.02962370636857,3526800,5.7173948979158595,0.9004001863706862,14666400.0,-48.16808659698374,77.78309058422582,77.02796724212243,1.146727146666101,24.352239032001762,16.69552048276069,0.12471452428320202,11.06878331615551,491.678927734375,485.9805434570313,481.375,476.7694565429687,471.071072265625,0.02,1.0,473.16425259397573,0.029007462834345077,-0.009838170590050798,477.35571725027904,484.1171439034598,10.583566657534208
2024-01-10,1,479.9700012207031,461.7774963378906,492.6375045776367,473.1218795776367,490.64437675476074,-0.20817379269821062,9.903970788053337,-1.2580668487102296,2.9955190817068655,479.2899971008301,8.795239105224606,0.020633009194563956,468.965998840332,491.38149337768556,0.7682110022849427,0.037572204387859125,0.9999247433410652,0.9974242010994114,1.0094484037144082,0.022082629429892364,53.94667866220156,499.8140664540363,480.00612487792966,460.198183301823,475.9867837088449,3.784818218148933,483.3300001961844,8.111224465209949,478.63731541946026,478.5387657128506,-2.441373587552081,-0.6763209398546102,4342400,5.431567098692621,1.1169988373169804,19008800.0,-57.80171955437958,77.78309058422582,77.02796724212243,-13.30377395808934,23.235761798835053,14.962823860339766,0.15069574980070977,11.318018167230104,491.678927734375,485.9805434570313,481.375,476.7694565429687,471.071072265625,0.04,0.0,473.4191181981738,0.01716066992526688,0.020981828329275615,476.134286063058,482.9250008719308,9.44204118872339
2024-01-11,1,493.00000762939453,463.26000213623047,492.6375045776367,473.87812423706055,490.64437675476074,-0.1659799191422998,8.98037524879836,-1.2663594911959513,2.9955577261157837,479.7112503051758,7.976576385498049,0.018673489580074847,469.8834938049316,491.38149337768556,0.7248781344502037,0.036070455052061155,1.0251275977221725,1.0265583086663548,1.0323494099958734,0.04067718771433171,54.537634917206425,498.87650061966707,480.91575012207034,462.9549996244736,478.62249973842074,7.356465731328234,483.35589327131,8.143735345244966,478.9606869957742,479.53787051004826,-1.6162593561557668,-2.2275180708660804,7993300,5.429916052686035,1.9391376704535805,27002100.0,-26.907311068364486,77.78309058422582,77.02796724212243,92.73660939718405,30.253795067679413,12.474139936684784,0.12097499159264423,12.454712161308883,493.6041993408203,487.5378966674805,482.63499450683594,477.7320923461914,471.6657896728516,0.06,0.0,474.79446388733123,0.036994116042401215,0.04671883801400177,479.52428763253346,483.1364310128348,8.684347993438873
2024-01-12,1,496.0175018310547,469.5999984741211,493.00000762939453,474.39437103271484,490.95812606811523,-0.12427988176252656,8.37562904626204,-1.5812628163003535,2.9955814293456213,481.1800003051758,7.699276962280271,0.01736231611319362,471.1592567443848,491.68124771118164,0.6736691225437204,0.04604840681357584,1.0282227898226728,1.0325351618418595,1.0303527952748932,0.04319869780368624,65.52280496298549,499.1540084892526,482.4027503967285,465.6514923042044,482.3964287894113,8.623498069251587,483.6885724748884,8.579343675262272,482.4851215222389,482.27761932788314,3.8878964039627064,0.07358413608168239,4996600,5.872693056910256,1.224383777147744,31998700.0,-27.075800342413686,77.78309058422582,77.02796724212243,94.75842159136761,28.20328679718542,11.62868147270526,0.017708419479835036,12.268905727562064,493.6041993408203,487.5378966674805,482.63499450683594,477.7320923461914,471.6657896728516,0.06,0.0,475.6179371557322,0.03818083406473982,0.03684662974194334,482.6528581891741,483.17571803501676,8.899876988965588
2024-01-16,1,485.8524932861328,469.5999984741211,496.0175018310547,475.24561882019043,491.178129196167,-0.24068993578880865,8.46907429270554,-1.4444756618666377,2.995578725569837,485.122501373291,7.824752426147461,0.017511157431801205,473.3485023498535,492.6737548828125,0.6759153568237152,0.04661051335247681,1.0045772660058558,1.0103446059280439,1.0006982139711633,0.013348546320296029,67.346171405987,500.57689866170506,483.63875007629395,466.70060149088283,484.12821306501115,7.767799219541007,483.35250037057057,8.379397446884715,485.88142729608535,484.7283681744809,5.6255331011014515,0.9478811699425763,4679000,5.87849439090919,1.1535882289129298,27319700.0,-53.35740952515257,77.78309058422582,77.02796724212243,2.698721107005155,25.279651708977642,18.514448387275063,0.006537410942753293,12.581095268092918,493.6041993408203,487.5378966674805,482.63499450683594,477.7320923461914,471.6657896728516,0.06,0.0,475.95097132421733,-0.007813967289570511,0.015145746767831437,483.59142630440846,482.78143092564176,8.330467864448874
2024-01-17,1,481.5749969482422,469.5999984741211,496.0175018310547,478.214994430542,491.178129196167,-0.4016009697055947,8.17920030070176,-1.2258645499198435,2.99558928636717,486.8537483215332,7.390251998901368,0.01689097298476797,473.3485023498535,492.6737548828125,0.6348371385143875,0.033915708644553934,0.9945067933957519,1.0018666311879432,0.9892798428692363,0.005108248144245486,55.18794718703702,500.5934004488156,484.2349998474121,467.8765992460086,484.99928501674106,6.933070792960695,482.77857099260603,8.190883793294368,485.89723195361466,485.3813875768056,2.558944935574512,-0.9591147692383349,4894600,6.308383518307573,1.2521825445047208,22425100.0,-55.5475497443649,77.78309058422582,77.02796724212243,-41.76189494820275,23.498781144350993,18.985799732038902,-0.06504199328850918,12.450443020632502,493.6041993408203,487.5378966674805,482.63499450683594,477.7320923461914,471.6657896728516,0.06,0.0,476.12700935412016,-0.003650790887582356,-0.00969014745244633,484.4871390206473,482.0057155064174,7.9013817815025975
2024-01-18,1,482.2824935913086,469.5999984741211,496.0175018310547,479.37124824523926,491.178129196167,-0.4060101654548658,7.52728900208596,-1.0910903903687554,2.995611482476276,486.8537483215332,6.748951797485352,0.01552600976368894,474.46799621582034,492.6737548828125,0.713832722594156,-0.001689509406159839,0.9947701891451032,1.0018742866366068,0.9897379826714294,0.0048179935511054595,47.49482991807,499.8725780346895,484.81800003051757,469.7634220263456,485.40356990269254,6.631676820314097,482.11482075282504,7.789927357032871,484.86163385497986,485.4004373601593,1.2823958543164986,-1.6411043802783996,4054400,5.767984298694398,1.0694690638980333,26479500.0,-43.56196901824517,77.78309058422582,77.02796724212243,-15.945982966070131,22.301311098608924,18.018305872084397,-0.04539248218968768,12.077174176653969,493.6041993408203,487.5378966674805,482.63499450683594,477.7320923461914,471.6657896728516,0.06,0.0,476.33704249280345,0.01459245956195887,0.006679253345149829,484.52713884626115,481.5428575788225,7.894187747405449
2024-01-19,1,482.4150085449219,469.5999984741211,496.0175018310547,479.37124824523926,491.178129196167,-0.40381479959775746,7.529059112315631,-1.0939388555465486,2.995611424297211,486.8537483215332,6.754864616394042,0.015529833028469628,474.46799621582034,492.6737548828125,0.733768342250721,-0.017564508834559296,0.9950545508237093,0.9995162318106385,0.9890711649272426,-0.02147058604597385,45.83937581940159,499.8707429652319,484.8126247406006,469.7545065159693,485.8732147216797,6.216553725709992,481.49321365356445,7.351142181155281,484.23901302866216,485.180702403618,0.5902553861462375,-1.8903531332192631,5665600,5.41071295764444,1.459502765419759,32145100.0,-49.24183499068301,77.78309058422582,77.02796724212243,-26.60573928431374,20.88040516081015,18.169753623618654,-0.053048133315053037,11.882805255037415,493.6041993408203,487.5378966674805,482.63499450683594,477.7320923461914,471.6657896728516,0.06,0.0,476.5499558585452,-0.018852972334420626,0.009658657756067094,484.6499982561384,481.00285775320873,7.487401891295231
2024-01-22,1,485.739990234375,469.5999984741211,496.0175018310547,479.37124824523926,491.178129196167,-0.2807026059604354,7.4120245804377625,-1.0769436985818175,2.9956150240905997,484.13375091552734,6.570126724243164,0.015301829657643757,474.46799621582034,492.6737548828125,0.7137165064727721,-0.02075054363041058,1.0027908714831817,1.0045975450393045,1.0002295816541023,-0.020720058382496798,45.447090749421626,499.21217438975737,484.38812522888185,469.56407606800633,486.69749886649,5.661079844194018,481.3421412876674,7.231097431549935,483.79198664440224,484.714934110247,0.6861459149197919,-1.7719790577712082,5212300,5.38843559452935,1.3316046291801855,37357400.0,-42.59928858452117,77.78309058422582,77.02796724212243,15.912979219496753,22.25601088911875,16.970205850458473,0.009046357292397566,11.727734779892906,493.6041993408203,487.5378966674805,482.63499450683594,477.7320923461914,471.6657896728516,0.06,0.0,476.860344763593,-0.013105518853700815,-0.013245879742653675,485.70428466796875,480.9192853655134,7.391177842018235
2024-01-23,1,491.1374969482422,469.5999984741211,496.0175018310547,479.37124824523926,490.6975040435791,-0.24053031970122374,7.176902750378851,-0.9595919444357364,2.99562221485273,484.07749938964844,6.225251007080078,0.01482698655051711,474.46799621582034,491.7174980163574,0.6976161783290199,-0.011437648214879876,1.01465622636754,1.0136092045787264,1.0156429339141515,0.010877794670484331,50.29362907618347,498.3970550124764,484.0432495117187,469.68944401096104,486.43142591203963,5.350753102039062,482.5269628252302,7.389787801880871,484.3133613436289,484.31622151944663,1.2021561762187465,-0.4335331416107602,15506000,5.452814935059734,3.4065719200578233,52863400.0,-29.808705776284512,77.78309058422582,77.02796724212243,79.79326298624497,25.60528289642634,15.069785047480938,0.03863841738014109,12.180789582572386,494.5269602050781,489.03151806640625,484.5899963378906,480.148474609375,474.6530324707031,0.06,0.0,478.21865687600354,0.02275374538532904,6.0953305985161996e-05,485.69856916155135,482.6114283970424,7.425400089594485
2024-01-24,0,545.5475006103516,469.5999984741211,496.0175018310547,479.37124824523926,490.6975040435791,-0.2417107858245001,7.165716287433029,-0.9546518876280858,2.9956225522007873,484.07749938964844,6.214126205444336,0.014804216335279447,474.46799621582034,491.7174980163574,0.6649549352058334,0.001182316442848855,1.1270894487367216,1.123191897848733,1.1256989944951328,0.13284016833827628,56.81178013455052,498.363557284949,484.032124710083,469.70069213521697,493.50714002336775,23.180957261900783,487.9517844063895,17.764261130375175,486.0553578373688,484.65131307160834,-0.3777912073689984,3.4954170658279216,26432800,5.59635381914418,4.606321476027621,79296200.0,-18.370328913791102,77.78309058422582,77.02796724212243,442.18272680782644,46.695470119012114,10.16250568726869,-0.0406787689215493,16.66825596688917,539.851079711914,525.8394595336914,514.5149993896484,503.19053924560546,489.1789190673828,0.08,0.0,488.149121438585,0.13436597828399743,0.132220942095488,493.2285679408482,487.94071306501115,15.596353491049287
2024-01-25,0,556.4675140380859,469.5999984741211,545.5475006103516,479.37124824523926,491.1225051879883,2.739932078140008,15.19426819333348,8.352089542447208,2.9952581738899666,484.07749938964844,9.16070266723633,0.031213725879067136,474.46799621582034,493.30175704956054,0.2402446391661799,0.11424907871412363,1.1431563680975194,1.1302189027154403,1.1186974431121142,0.1538206786117402,82.00269688897394,517.1701609899385,486.7816246032715,456.3930882166045,503.59500013078963,32.70372380948222,493.8616065979004,24.9701034002623,500.9381043055496,492.5061309275582,9.985534501596472,16.172807151407138,9451900,13.357332761832248,1.547146987884755,88748100.0,-1.5928664938025958,77.78309058422582,77.02796724212243,331.1089334565023,43.171378204567155,9.300177505037713,0.009331618558577672,16.815762047828272,541.82825390625,528.4458889160156,517.6300048828125,506.81412084960937,493.43175585937496,0.1,0.0,491.52345955088646,0.15802271296120818,0.17002897114658305,504.76571219308033,494.1785692487444,22.995543346187063
2024-01-26,0,567.5749969482422,469.5999984741211,556.4675140380859,479.37124824523926,491.2468719482422,2.2005164421200574,21.4964448768468,3.8408702805033146,2.9947994405190266,484.07749938964844,13.399102668762215,0.04385915187168049,474.46799621582034,500.97050170898444,0.5632131729854246,0.13200939326187142,1.1580220884120918,1.135142047070752,1.1079790197954937,0.17652848044712166,83.92879832626714,533.1173896468821,490.1244998931885,447.1316101394949,515.8807144165039,38.663482620494705,500.4399997166225,31.126804600137636,514.8146574216189,500.8915407753685,14.534250976945355,17.4651193918181,12770600,13.47196835505231,1.929178166415145,101518700.0,-8.64188914359137,77.78309058422582,77.02796724212243,259.1594942371037,46.29780621215479,8.422090652731333,0.019951838956388537,17.151257650080055,554.4611740722656,538.8844337158204,526.2950134277344,513.7055931396485,498.1288527832032,0.12000000000000001,0.0,496.30260735227944,0.18111599232267594,0.17537241305499127,517.6357116699219,501.0614253452846,29.19391887583917
2024-01-29,0,572.0924835205078,469.5999984741211,567.5749969482422,479.37124824523926,491.6031246185303,1.786635963124715,27.340097292469927,1.7249327727539603,2.9942473833890255,484.07749938964844,18.990951385498033,0.055352786303133866,474.46799621582034,546.639501953125,0.6914483075797039,0.15568064216488492,1.1582589720579224,1.1273624659073473,1.080860588283041,0.1777751369502576,85.77874308698316,548.6046944781283,493.92449989318845,439.2443053082486,528.710712977818,40.51306339045011,507.0571414402553,35.81577317008127,527.9701648890822,509.52943081331307,17.858069988056908,19.369476991561186,6905400,13.544302100168233,1.0037713743312515,108424100.0,-3.6086198640853695,77.78309058422582,77.02796724212243,193.6370968728423,43.024529472548714,7.826644870568079,0.0549893045447301,17.053913980683227,554.4611740722656,538.8844337158204,526.2950134277344,513.7055931396485,498.1288527832032,0.12000000000000001,0.0,498.7418197319009,0.18546043556239433,0.19223514540571904,530.5614231654575,507.5442810058594,34.41956089680605
2024-01-30,0,565.4674987792969,469.5999984741211,572.0924835205078,479.37124824523926,493.75438117980957,1.4313021471366254,32.190158065923185,0.38199760737100474,2.9937028272393866,484.07749938964844,24.978950042724602,0.06464234404506033,474.46799621582034,557.5782623291016,0.773235575233571,0.17266909139792674,1.1355379034651762,1.0978491240681651,1.0345860693735702,0.1513425513077611,87.13233999424843,562.3535648043317,497.97324867248534,433.59293254063897,540.5753544398716,36.67476622517614,513.2242845807757,38.00327761319857,538.9582614553443,517.5908027169326,18.621863974458336,19.322035915714636,6181800,13.434985222860378,0.8766558369270957,102242300.0,-15.73721874429709,77.78309058422582,77.02796724212243,138.36520194675114,40.1415268354547,8.13475805169817,0.028278008928096152,16.896303333899404,554.4611740722656,538.8844337158204,526.2950134277344,513.7055931396485,498.1288527832032,0.12000000000000001,0.0,500.5872922462083,0.1435623901217764,0.15881901852536592,541.9757036481585,513.3128509521484,37.17991384996153
2024-01-31,0,565.2874908447266,469.5999984741211,572.0924835205078,479.37124824523926,508.4000015258789,1.1085746026119285,35.2675739618656,-0.5430707837725768,2.9933224689486297,484.07749938964844,29.788062667846667,0.07027458754052805,474.46799621582034,565.6782485961915,0.8299164023278398,0.19158677533231114,1.1263985808575243,1.080793631318729,1.0068708335390288,0.03618381573060114,84.02163337270878,572.3890213673347,501.8538734436035,431.31872551987226,551.9392830984933,28.195836756109127,519.3183909824917,39.08573873942981,545.5418425476505,523.6704004065401,17.21598390665353,18.020256591862072,4857600,13.048016382755872,0.6898059920647318,97384700.0,-14.878356553355765,77.78309058422582,77.02796724212243,116.90898649640917,38.859883107992914,7.756729636526785,0.022910465192699438,16.38520001240451,555.0063334960937,539.7668527832031,527.4500122070312,515.1331716308594,499.89369091796874,0.12000000000000001,0.0,501.9935372475282,0.03531115753627967,0.14612239694713855,553.1757027762277,519.4399937220982,38.75255236940225
2024-02-01,0,567.7550048828125,469.5999984741211,572.0924835205078,479.84062576293945,548.2775039672852,0.8407496154441199,37.244256517569475,-1.1172055874668096,2.9930789999712544,485.7962417602539,33.40929954528808,0.07354845373631713,475.30274429321287,565.6782485961915,0.84738807327052,0.2037638259828032,1.1211796559957508,1.068411125593447,1.004204281153466,0.020284186515790115,85.02144996343318,580.8792612498606,506.39074821472167,431.9022351795827,562.8846413748605,8.988001670512237,524.65803364345,40.30109555472554,550.4398251103911,529.1679759931133,16.376559931161733,17.775587934045102,3174000,12.903378310583236,0.4515902764389816,100558700.0,-11.621004325905966,77.78309058422582,77.02796724212243,102.80310845114586,37.4743487177472,7.431889899970041,0.01998734023031646,15.81838343421365,555.0063334960937,539.7668527832031,527.4500122070312,515.1331716308594,499.89369091796874,0.12000000000000001,0.0,502.9065107918084,0.009804287839190406,0.041551222954694385,563.9357038225446,524.817136492048,40.00346570060473
2024-02-02,0,564.8325042724609,473.7300033569336,572.0924835205078,481.1737480163574,558.6725082397461,0.6214910305054917,38.51816800986753,-1.4881455210825953,2.992935078544963,488.4949951171875,36.11029998779296,0.07533401353655465,478.76249465942385,567.5929977416993,0.8612693230020586,0.19847803782661286,1.1047020593463053,1.0460858874592918,0.9950619882876064,-0.004831947655423829,85.28796237907902,588.3348345548912,511.2984985351562,434.2621625154212,565.639641898019,4.739770897698459,529.5733909606934,40.73344462183616,554.7549638680189,533.0510126624874,15.600011892931184,15.163285212282174,4030800,12.914858235651248,0.571889884098232,96527900.0,-14.370568402291713,77.78309058422582,77.02796724212243,84.99653095510517,36.463073978796345,7.956931069436101,0.011486890365728409,15.041807164699462,555.0063334960937,539.7668527832031,527.4500122070312,515.1331716308594,499.89369091796874,0.12000000000000001,0.0,503.97728186514877,-0.010132829204598792,0.004697534961632562,566.759992327009,529.9942801339286,40.674130923582965
2024-02-05,0,564.3699951171875,475.4774932861328,572.0924835205078,482.105619430542,564.9462509155273,0.4114479174431831,39.187051428628884,-1.7294065741227078,2.9928735478273776,492.06875228881836,37.819600524902356,0.07596544763338431,479.4199989318848,567.5929977416993,0.8751481043308128,0.18792689927082643,1.0940506556869094,1.0295148391733018,0.99520884562733,-0.013498671326352962,82.03448729743054,594.2277264381904,515.8536235809327,437.4795207236749,566.7685677664621,2.6881011616025656,535.1817839486258,39.6413783433981,557.2949647662091,535.9216843421643,3.534981580986726,13.873502887977708,4143100,13.017473632954326,0.5815089392735735,92384800.0,-16.842322540203796,77.78309058422582,77.02796724212243,75.62125658597395,37.04055709081135,7.238307944378947,0.005164335283056259,15.303189275311288,555.0063334960937,539.7668527832031,527.4500122070312,515.1331716308594,499.89369091796874,0.12000000000000001,0.0,505.0411923386058,-0.023845466216325772,-0.014655842365324771,566.7685634068081,535.7671377999442,40.63642254827042
2024-02-06,1,560.1775054931641,479.1274948120117,572.0924835205078,482.38187980651855,564.9462509155273,0.21225059280533784,39.39607376298568,-1.8686329750583714,2.9928779556378418,494.5087547302246,38.671075096130366,0.07571825172101342,479.91825103759766,567.5929977416993,0.8834610769362969,0.17711346970897127,1.0766469172679873,1.0074170178978086,0.9905135453167304,-0.009355079288469459,81.26940446401993,599.0903961984567,520.2982486724853,441.506101146514,565.7117832728794,3.613159898993827,540.7962488446917,36.93913169880029,559.099580997635,538.3375709423652,1.4201154388611261,16.160769557852905,2840300,13.068147212162787,0.40100438163960994,89544500.0,-22.938796915833606,77.78309058422582,77.02796724212243,58.64646528453944,34.85312929091772,8.207057640557284,-0.034804684511596726,15.055609537402674,555.1951306152343,540.0724481201172,527.8500061035156,515.627564086914,500.5048815917969,0.12000000000000001,0.0,505.67685962037945,-0.012383354366977017,-0.034578533674279655,564.691423688616,541.163567679269,40.46102829248881
2024-02-07,1,560.0599822998047,479.1274948120117,572.0924835205078,484.9087448120117,564.9462509155273,0.015707747497670465,39.13896148235465,-1.9144299677056442,2.9929446114866685,520.7825012207031,38.622750473022464,0.07464502442365925,481.4144973754883,567.5929977416993,0.8862469208852212,0.16916167733799697,1.068134908902238,0.9948534863815931,0.9921618435558304,-0.00924752206547197,76.5855482706578,602.6124219423705,524.3344989776612,446.0565760129519,563.9928545270648,2.8541213794274305,546.3517837524414,33.112429896916524,559.3948027070853,540.0052025252392,-1.3033504814083117,16.32196626548902,4373600,13.17095547217989,0.6138123210164337,85170900.0,-19.637018246314938,77.78309058422582,77.02796724212243,56.05678991313943,33.3567671729388,7.683693565315643,-0.05620064753588589,14.89002562961648,555.1951306152343,540.0724481201172,527.8500061035156,515.627564086914,500.5048815917969,0.12000000000000001,0.0,506.65953270764254,-0.008526701677858184,-0.006307165225108423,562.335710797991,546.4485669817243,39.91817850429316
2024-02-08,1,559.6300048828125,479.9700012207031,572.0924835205078,485.82436752319336,564.9462509155273,-0.17891795471928895,38.43325361894595,-1.8821417804377578,2.9930727535839723,551.0075073242188,37.74401199340821,0.0727377491745453,482.211743927002,567.5929977416993,0.8817248395900659,0.1668645558585109,1.0591407984685728,0.9915336272274966,0.9932397410527113,-0.014310750112501491,76.3766255247428,605.2476305899426,528.3811233520507,451.51461611415885,563.1589268275669,3.1850663672522828,551.8671406337193,27.618501113560818,559.5900050915272,541.9923103732516,-2.10324406757772,16.126956657565426,3175500,13.185824423403345,0.4493445555090166,81995400.0,-21.165009985371515,77.78309058422582,77.02796724212243,48.9054304358064,31.992572756134443,7.369452925391071,-0.05618769037052023,14.378093013410492,556.1013697509766,541.5393267211914,529.7700042724609,518.0006818237305,503.4386387939453,0.12000000000000001,0.0,507.33375922791987,-0.01582347502990944,-0.009891610146219944,561.7185756138393,551.8471396309989,38.67550002046226
2024-02-09,0,562.6049957275391,481.5749969482422,572.0924835205078,489.81624603271484,564.9462509155273,-0.3782925679038222,37.32148825844128,-1.7668285841214286,2.9932506178566745,558.0487594604492,36.0892999267578,0.07010519042982925,482.40175704956056,567.5929977416993,0.8965387627533585,0.13515212215474465,1.0568048650453166,0.9962463997036893,1.0014079345062377,-0.003943662108807033,74.53423057126723,607.0071000520388,532.3641235351563,457.72114701827377,562.7757132393973,3.0445572445523066,557.3574981689453,20.070349348940457,559.6203790377324,543.9848070525819,-1.0323305776346239,16.005927462909867,3055700,13.054131346320613,0.44804459771732885,85051100.0,-18.648211985291674,77.78309058422582,77.02796724212243,49.22993865161284,31.872003539402236,7.060817242848468,-0.05407556008438579,13.900712107595453,556.4553697509766,542.1123267211914,530.5200042724609,518.9276818237305,504.5846387939453,0.12000000000000001,0.0,507.996669979051,-0.005879865468418677,-0.010907300901992281,561.3200073242188,557.2478550502232,38.015840702553376
2024-02-12,0,560.9124908447266,481.5749969482422,572.0924835205078,489.81624603271484,564.9462509155273,-0.5925468585062436,36.72914627921948,-1.557687490405335,2.993348524131915,559.8449935913086,34.58906291961669,0.06854442844607009,482.40175704956056,567.5929977416993,0.8930062243802532,0.13424424269441265,1.0467824599279072,0.9941242596497818,0.9991876889030071,-0.00612630774558276,75.53819475409702,609.3026654985026,535.8443729400635,462.3860803816245,561.7982112339565,2.1449807349354897,562.3414263044085,6.302880018587256,560.3338414930901,545.993500659442,-0.47453643688080993,15.824310750299937,3608500,13.05421865313298,0.5345391386787247,81442600.0,-51.1863643727947,77.78309058422582,77.02796724212243,44.25647944261155,31.22561504587511,6.627933388177695,-0.05164855922150891,13.71978732686553,569.5934929199219,563.378271850586,558.3550109863281,553.3317501220703,547.1165290527343,0.12000000000000001,0.0,508.74896485973454,-0.0074903426519290495,-0.01202543016142363,559.9400024414062,561.9378531319754,36.89939296895863
2024-02-13,1,553.3800048828125,481.5749969482422,572.0924835205078,489.81624603271484,564.9462509155273,-0.8198129388234211,35.92510725175383,-1.2406668915956363,2.9934683107192637,560.1187438964844,32.55322547912597,0.06664038608761669,482.40175704956056,567.5929977416993,0.8705821133480625,0.15449132935577778,1.026509313392725,0.9827214100305615,0.9869853926221112,-0.012134547609810253,76.69409583944632,610.9393368942548,539.0891223907471,467.2389078872394,560.1621398925781,3.428503366578274,562.9008908952985,4.885858555784188,560.2954943906785,547.7957231971876,-1.2051877974194638,14.206814655782129,3511500,12.720090649500163,0.5247074996637927,77931100.0,-80.56446766486641,77.78309058422582,77.02796724212243,26.311389094435064,29.489633703012515,10.619824904398074,-0.028937590019644834,13.461535805718437,572.2815363769531,567.729257446289,564.0500183105469,560.3707791748047,555.8185002441406,0.02,1.0,509.3676062537288,-0.0024465448291294267,-0.013414898872175512,558.4942888532366,562.6271405901227,34.44565472647951
2024-02-14,0,573.0450134277344,481.5749969482422,572.0924835205078,531.9449996948242,564.9462509155273,-1.0797929907684747,33.87798623284601,-0.7078470861970656,2.993735225911457,560.1187438964844,28.917750358581543,0.06245187271741157,482.40175704956056,567.5929977416993,0.8423837311099489,0.149104518277737,1.0563713555452916,1.0198327028143508,1.0245433368436636,0.02318507220353183,67.59517630860194,610.221470436273,542.465497970581,474.7095255048891,561.4014282226562,5.888397461447884,564.0849979945591,5.205147815854071,558.4323404126255,548.950845174966,-2.027592127404205,1.4357144453412456,5634200,12.850998323912508,0.8372663940272956,83565300.0,-5.9534353803294575,77.78309058422582,77.02796724212243,73.73655543465476,36.67772642825934,9.179570973272394,0.006268637069967327,14.433174859161133,573.639,568.9305,565.125,561.3195,556.611,0.02,1.0,510.7685481973856,0.035812676084465256,0.04218538533684954,560.9614345005581,563.8649989536831,32.08808863540237
2024-02-15,0,587.3650054931641,482.2824935913086,573.0450134277344,551.4218788146973,565.3324928283691,-1.3817200860219434,31.4352306170664,0.10959747269736031,2.9940344736541094,560.5449981689453,24.807250404357887,0.05746433195135347,485.40749206542966,568.188752746582,0.7807796636580165,0.18819368532447484,1.0737168772015706,1.0438764446940887,1.0452924839127256,0.049559531062240536,76.58537692508087,609.9094600286885,547.0389987945557,484.16853756042286,565.2853567940848,11.365550271046196,565.4985700334821,8.105175853038546,561.9973862052722,553.1302785156345,1.5371154359022166,2.9790596883817075,5220900,13.301806403564587,0.7691814712258594,88786200.0,-0.6924222098615974,77.78309058422582,77.02796724212243,118.42394673968121,40.336113984727234,8.508271421202343,0.016580163020190594,14.433673939587395,583.204294921875,576.6678720703125,571.385009765625,566.1021474609375,559.565724609375,0.04,0.0,512.2900755256615,0.06253914891515167,0.06107640787636174,566.3300083705357,565.5107160295759,30.134872366910184
2024-02-16,0,588.8400115966797,482.4150085449219,587.3650054931641,555.6956367492676,565.9943733215332,-1.6381223108821619,28.847997862677442,1.299055884780877,2.994326349804321,561.7587432861328,20.433250122070284,0.05223312872952748,490.59774627685545,572.1877365112305,0.696186584368294,0.2175512682841197,1.0661729896554841,1.042863342633528,1.0376739381320206,0.046631324052170076,80.79197158708415,609.9891201150034,552.2931243896485,494.59712866429356,569.3967895507812,14.048988497730324,566.694822038923,10.134971132133487,568.3102372305361,558.9606740576728,4.853372320986883,3.486765388068451,4323600,13.417834302955596,0.6433445105687742,93109800.0,-27.187474568684895,77.78309058422582,77.02796724212243,122.41968696347759,38.043436496026686,7.688867840807837,-0.012344109758911705,14.806310953011877,585.672,578.664,573.0,567.336,560.328,0.06,0.0,513.4579314614732,0.040315692630819466,0.0455122940160569,569.8514404296875,566.0935756138393,25.998505522176288
2024-02-20,1,577.7424926757812,485.739990234375,588.8400115966797,558.8393821716309,567.6199989318848,-1.9116006500696123,25.03053079789455,3.127516130462947,2.9946937292145024,563.4874954223633,15.579936599731457,0.04488860391815208,540.1065002441406,574.4770126342773,0.595687100098257,0.21225351718016416,1.0360968422847219,1.018877010433655,1.0087897898854652,0.03000468362847286,80.96254345981212,607.6754361380255,557.6143745422363,507.55331294644714,571.9842878069196,13.61150931000237,567.5716073172433,10.543359150217979,573.5062420755803,564.5315091218292,5.138740528950846,2.927416206049756,3124200,13.440129707372495,0.4722117259412645,89985600.0,-45.562489827473954,77.78309058422582,77.02796724212243,87.22321685456323,35.0072535286713,10.884949513835524,-0.027185307043220933,14.918062301017397,585.672,578.664,573.0,567.336,560.328,0.06,0.0,514.1750647916931,0.03097612270884298,0.024602717484497372,572.2228655133929,566.970720563616,19.92551001620055
2024-02-21,1,572.4900054931641,491.1374969482422,588.8400115966797,559.9524879455566,568.8393745422363,-2.29716515991375,19.165777361845645,6.85431075513614,2.9951348527195933,564.6012496948242,11.040349731445303,0.03408979557320091,552.5967544555664,578.7047439575196,0.3616969209316596,0.17633553997744505,1.0182768424417954,1.0072386176845871,0.9937777143631064,0.03453323293529276,69.26574204351449,600.546054387998,562.2144996643067,523.8829449406154,573.3964320591518,12.974106808831138,568.0860726492746,10.598909583548686,574.6885073918007,568.0128350680179,3.23651120113932,2.170769128726765,2281100,13.93749327335178,0.3830655826212393,87704500.0,-49.270884195963546,77.78309058422582,77.02796724212243,48.3784700747856,33.51582803898247,11.599584082857593,-0.05185983279190743,14.448183311324538,585.672,578.664,573.0,567.336,560.328,0.06,0.0,514.6494106672735,0.03395721595516954,0.027785248146187658,573.9414324079241,567.6307198660714,11.293196928245106
2024-02-22,1,585.239990234375,545.5475006103516,588.8400115966797,560.1481246948242,572.1918640136719,0.4807466076524226,10.171712270528912,0.2984642023417696,2.9955713879654637,565.0599975585938,7.66480133056641,0.01796226972356653,556.1587631225586,578.7047439575196,0.6082727666584967,0.04938617600240047,1.03347777424505,1.0274452200935937,1.009214548534443,0.02128101025379303,57.423683040398664,586.6255496326106,566.2821250915528,545.9387005504949,576.8717891148159,12.31421279305576,569.3350001743862,11.544859994659697,574.3049791139689,570.5208861196922,1.7570071081295833,1.2741330323221127,3526600,7.658895127497544,0.7332502346895601,91231100.0,-17.770894368489586,77.78309058422582,77.02796724212243,147.8004750728849,38.07502450794086,10.594134613015555,0.06408431568033102,14.669934730848837,585.672,578.664,573.0,567.336,560.328,0.06,0.0,515.5415465053659,0.015776765131546355,0.06122403155178016,578.3157174246652,569.1278599330357,11.136972710421466
2024-02-23,1,585.5525054931641,553.3800048828125,588.8400115966797,560.7287445068359,572.6287574768066,0.7579819491318237,9.797897534823267,-0.3326190715781374,2.9955842632001977,565.3774948120117,7.894775543212904,0.017241722381592314,559.3137557983398,585.4524917602539,0.5772477504753568,0.05170558113536131,1.0304183835028289,1.0234695283923505,1.0055243144003105,-0.0030858154351197653,63.49468754798186,587.8625446424005,568.266749572754,548.6709545031074,581.4678606305804,6.897618152523411,570.8150002615793,12.230978027615867,577.0926141955867,573.2268316412128,4.337129193363399,3.079670844147202,2568900,7.78819648833244,0.575290651778846,93800000.0,-28.00000508626302,77.78309058422582,77.02796724212243,122.09822640767618,36.46506245718949,9.926447637105936,-0.027910817598960403,14.520438884125467,585.672,578.664,573.0,567.336,560.328,0.06,0.0,516.17029193117,-0.016681872489329397,0.007301504054629376,582.4642857142857,570.4792872837612,11.509514729603177
2024-02-26,1,586.3075103759766,553.3800048828125,588.8400115966797,562.1818695068359,574.2193832397461,0.5893107618972024,10.092706485869492,-0.7587192838566064,2.99557588770345,566.5212478637695,8.459951477050776,0.017715173744704812,560.0169845581055,585.733755493164,0.6740714425809361,0.031674243301033335,1.0291133927928686,1.0201668885996713,1.0074479559518417,-0.004300830736410188,62.10640414969746,589.9064121172469,569.7209991455078,549.5355861737687,583.3625030517578,5.955571374699951,572.381965637207,12.73657107929138,579.2419480433399,574.798876813575,5.813816966004153,3.6683443434955576,2393700,7.454235351300819,0.6065297538356286,96193700.0,-19.47911580403646,77.78309058422582,77.02796724212243,117.46317423068143,35.053783446750764,9.5422720384788,-0.047520327092105866,14.010078491453184,585.672,578.664,573.0,567.336,560.328,0.06,0.0,516.7623119009784,0.006336179689502952,-0.009790040345567618,583.6528581891741,572.307146344866,12.198242570427409
2024-02-27,0,598.5899963378906,553.3800048828125,588.8400115966797,562.1818695068359,579.6168670654297,0.4177669102230125,10.700972293675063,-1.1302578453078627,2.9955568947783164,566.6112518310547,9.275639495849612,0.018752000899153246,560.0169845581055,586.4132598876953,0.7162064832763305,0.024847428108114942,1.0489476882569626,1.0372603689603799,1.0294488082430109,0.03608442156566216,61.87911890944383,592.0595694042447,570.6576248168946,549.2556802295444,584.9660731724331,8.27314378432986,575.125714983259,13.981803934226477,581.0223787199213,575.6170373184294,2.3143900806170605,3.8870803636954316,4489400,7.406555255769045,1.173469254394563,100683100.0,-6.547202626808259,77.78309058422582,77.02796724212243,169.86443364969114,39.31495953947627,8.68519956809183,-0.0824371341948649,14.277997404811748,592.0590288085938,583.8304709472657,577.1799926757812,570.5295144042968,562.3009565429687,0.08,0.0,518.0397606206807,0.04614605011392414,0.030345012985191332,584.8257097516741,575.577859061105,14.028459126612255
2024-02-28,0,595.1124877929688,553.3800048828125,598.5899963378906,562.1818695068359,585.3181190490723,0.5334242826980743,12.31517115311898,-0.909996019335201,2.9955013389631033,566.6112518310547,10.733002700805661,0.021530678199530612,560.0169845581055,587.5125061035156,0.6851099423140871,0.05857542233655683,1.040438277948528,1.0245452444537693,1.0161815294489682,0.039515942781074065,70.64468932935567,596.6128427640016,571.9825004577636,547.3521581515257,585.8621412004743,9.064502319653268,577.6294653756278,14.212976189147668,585.4070139123448,577.868213535325,1.9110758624957276,6.85719981042604,2605200,7.616278275198022,0.7143562238820703,98077900.0,-15.755867975161413,77.78309058422582,77.02796724212243,120.32115809593934,36.96112687270845,9.35647472594658,-0.015007190838608879,14.088605299606456,592.0590288085938,583.8304709472657,577.1799926757812,570.5295144042968,562.3009565429687,0.08,0.0,518.7198352867,0.04034186076170099,0.03712199920831419,586.615705217634,578.2335728236607,14.893476870473888
2024-02-29,0,601.7124938964844,553.3800048828125,598.5899963378906,562.1818695068359,585.7412567138672,0.3706668742579192,13.194465902770684,-1.18709527931347,2.9954682925222387,570.1225051879883,11.703200073242192,0.023008329465546328,560.0169845581055,589.4672592163085,0.754810366270378,0.05276075878430243,1.0492580302321055,1.0285182550088336,1.0195743291661175,0.028146579073505373,66.83431686815297,599.8536817139886,573.4647499084473,547.0758181029059,589.2864270891462,9.968417337687551,580.6353574480329,14.55924042445831,587.8394828846892,579.9147928166834,1.0652258801640904,6.258705603143802,3572100,7.695287582972566,0.9970566439041546,101650000.0,-4.3293170255208455,77.78309058422582,77.02796724212243,132.77915291896343,38.48081846026073,8.896028364012453,0.05756477899618886,13.746845749054899,592.0590288085938,583.8304709472657,577.1799926757812,570.5295144042968,562.3009565429687,0.08,0.0,519.7046747728974,0.02455522444036662,0.05157409711930231,590.5857020786831,581.4042837960379,16.09400540614182
2024-03-01,0,609.7325134277344,553.3800048828125,601.7124938964844,562.1818695068359,586.5718841552734,0.2903989791412351,14.398970521256057,-1.22952685876674,2.9954197437290926,572.7675094604492,12.888849334716792,0.025029238534795554,560.0169845581055,595.460238647461,0.7631200809893022,0.05981010950432902,1.059877197364519,1.0371448204268305,1.0274283891481568,0.041294346293003104,69.88892719201263,604.0839411035473,575.2860000610351,546.4880590185229,594.6067853655134,9.433939157129474,584.0016087123325,15.488300147275012,591.3019215030964,582.7612677554132,4.148907432736588,7.519698487661329,4264200,7.775570243722178,1.1723998564812332,105914200.0,-1.3187458684833353,77.78309058422582,77.02796724212243,164.13704821006337,42.41389695734206,7.959529930784361,0.11728242089924613,14.25474326899226,603.4579423828125,593.0510581054688,584.6400146484375,576.2289711914062,565.8220869140625,0.1,0.0,521.02160683402,0.06131336871369841,0.052458167262909104,597.1557094029018,585.5485709054129,18.719053680212294
2024-03-04,0,619.2225036621094,553.3800048828125,609.7325134277344,562.1818695068359,587.733757019043,0.30855758956904566,16.106439511893754,-1.0884707261377258,2.995344215250864,575.3937530517578,14.234625244140625,0.02789549951108938,560.0169845581055,598.90224609375,0.7620502824953118,0.07949260854438152,1.0724605543892138,1.0492949084163932,1.0349854891400445,0.05613947067644709,74.19014104011012,609.5977545120688,577.3848754882813,545.1719964644938,599.461430140904,12.160173745226578,588.1666096278599,16.601852443598606,595.8974129776232,585.9174676547799,6.505355128861724,8.37666178901448,3020300,7.810567356578275,0.8420996868927099,108934500.0,-11.389509104696115,77.78309058422582,77.02796724212243,161.0334851396072,42.5065645320924,7.573609627725587,0.09280130908334572,13.900103997246305,606.6208669433594,595.6095494384765,586.7099914550781,577.8104334716797,566.7991159667969,0.12000000000000001,0.0,521.9855843484779,0.04795369948955441,0.05529854627845674,601.0642874581473,589.6900024414062,20.238416628667903
2024-03-05,0,602.8774871826172,553.3800048828125,619.2225036621094,562.1818695068359,590.408130645752,0.38471918467630906,18.211616322278054,-0.8132546160744316,2.995241301930866,581.4912414550781,15.663126373291016,0.03139368895107396,560.0169845581055,602.5144958496094,0.7638532870752065,0.0971924606543481,1.0392569211478246,1.0163650102894595,0.9966992930030988,0.007162650346576038,77.69410383415321,616.5276081023197,580.1043754577637,543.6811428132077,601.9364275251116,10.508337400825098,591.702144077846,13.627973364065106,601.7398154576458,590.068998212553,5.806594558605807,10.395563259710748,3849600,7.936220582422317,1.0777291427243625,105084900.0,-43.14247980901102,77.78309058422582,77.02796724212243,77.34321982456169,37.509497214548865,18.069251281454253,0.10394757342215774,14.616102073186989,610.24111328125,601.4694396972657,594.3800048828125,587.2905700683593,578.518896484375,0.12000000000000001,0.0,522.9630848330687,-0.005268640617276055,0.018463328741891667,603.1985735212054,592.8314296177456,20.128093397493206
2024-03-06,0,600.5424957275391,553.3800048828125,619.2225036621094,562.1818695068359,595.9818649291992,0.17894191046410032,18.479937671796385,-0.9883085702429772,2.9952290014791934,585.3962478637695,15.82252548217773,0.0317508472201953,560.0169845581055,603.5629898071289,0.8157600452258043,0.07622580569682336,1.0318072154637499,1.0081565870193185,0.9914334957173349,0.009124338752675154,63.25887156122123,618.989625404628,582.0297500610352,545.0698747174424,603.9699968610491,8.075509214808891,593.6662499564035,12.680805848926004,601.9771600319693,591.5654701123843,2.9587409373070104,8.944573685904428,2469600,8.910863163532923,0.6949924298281656,102615300.0,-46.812595267261415,77.78309058422582,77.02796724212243,68.59792226039322,34.84897919048109,16.78761403527244,0.11959700197184672,14.598368487705857,610.944388671875,602.6077922363281,595.8699951171875,589.1321979980469,580.7956015625,0.12000000000000001,0.0,523.5715610715382,0.002028604500196929,-0.00661488952714516,604.6328560965402,594.1428571428571,19.39173259521396
2024-03-07,0,603.5700225830078,553.3800048828125,619.2225036621094,570.0187530517578,599.0781211853027,-0.007017833132573099,18.185016448572615,-0.97609230243881,2.9952473496905974,585.9300079345703,15.251900634765615,0.03113616768121014,560.0169845581055,603.5629898071289,0.8142123575760263,0.07228246028487668,1.0334253743263135,1.0084897536686461,0.9946483478099728,0.003087070162852479,61.409112945106685,620.4180324698993,584.047999572754,547.6779666756086,604.6814291817801,7.734723832990902,594.8237511771066,12.80041641181737,601.5565595823433,592.4443148256909,2.4279043163602236,4.798485573641998,2742800,8.955482505716311,0.7900042628201436,105358100.0,-27.86336242926439,77.78309058422582,77.02796724212243,85.56645130312104,33.61676878282319,15.576286930240322,0.17153491081346023,14.600646662645932,610.944388671875,602.6077922363281,595.8699951171875,589.1321979980469,580.7956015625,0.12000000000000001,0.0,524.2819871332617,0.009271589952097647,0.02016837059212126,605.6100027901786,595.2178562709263,19.15417252981872
2024-03-08,0,607.5050201416016,553.3800048828125,619.2225036621094,572.9062614440918,600.8349952697754,-0.18747037723850632,17.78331337820712,-0.8781374001544191,2.9952711330709656,586.8362579345703,14.54140106201172,0.03033538118152458,560.7842422485352,604.1862716674805,0.7923165800640039,0.07851619340781492,1.0363027386262718,1.011965276091721,1.0005204567649435,-0.003653230288820475,63.0280218357599,621.7901283433283,586.223501586914,550.6568748304998,606.4517909458706,6.499031694688991,596.1569660731724,13.097808271918657,602.0177031877529,593.8594536438169,0.8319594840515969,2.7589347234327786,2774600,8.93671024945502,0.8038043533367035,108132700.0,-34.32571622808987,77.78309058422582,77.02796724212243,87.35343857275252,33.829737822674545,14.409152320115412,0.16707127030225863,14.647380150566105,610.944388671875,602.6077922363281,595.8699951171875,589.1321979980469,580.7956015625,0.12000000000000001,0.0,525.0080083508019,-0.02344434220564018,0.0031513707754244912,606.8014351981027,596.7085702078683,18.324012849344577
2024-03-11,0,605.0950012207031,553.3800048828125,619.2225036621094,576.5681228637695,602.0037422180176,-0.34720476040427045,17.256901235290464,-0.6966495559297035,2.995300908004399,588.1025085449219,14.153250885009765,0.029317695270395447,562.4357452392578,607.7277694702149,0.7767745709986636,0.07980736885565604,1.0279939957673137,1.004278297583335,0.9972830287876968,-0.022814904752097354,64.63203855250684,623.1310548204344,588.6172523498535,554.1034498792726,606.9350062779018,6.207118765950133,598.110716683524,12.145082010028807,603.4014365372932,595.59191759422,2.0823848604810324,3.1697928431035853,2500900,8.943023906982193,0.7303827726742395,105631800.0,-41.13835425204645,77.78309058422582,77.02796724212243,65.40866224582153,32.0282217564542,13.87729853064724,0.14399944552131438,14.358408818647142,610.944388671875,602.6077922363281,595.8699951171875,589.1321979980469,580.7956015625,0.12000000000000001,0.0,525.6269574443794,-0.02419502784952543,-0.02972524523105581,606.5171508789062,598.5514264787946,17.259755725244762
2024-03-12,0,605.7150115966797,553.3800048828125,619.2225036621094,583.3656158447266,603.0506210327148,-0.5387015516598644,16.523651971971237,-0.339816513175367,2.995338981113093,591.9762496948242,13.654249572753907,0.027971024391895367,571.3322540283203,607.7277694702149,0.750538836342069,0.07876898998886316,1.0253465391698584,1.0021823595699157,1.0029755798131599,0.004706635219243083,62.80584182277161,623.7890565684543,590.7417526245117,557.6944486805692,606.361077444894,6.089971550002007,600.4839314052036,9.766873395497921,603.8553727748299,596.6414536447476,0.5621467658606836,4.734377147548954,2821600,8.961565821481788,0.8336213900583499,108453400.0,-29.299308410738874,77.78309058422582,77.02796724212243,75.9378122596832,31.14999962572543,12.585218131866942,0.21425276734465662,14.694267330389525,613.6749104003907,607.0275350341797,601.6549987792969,596.2824625244141,589.6350871582031,0.02,1.0,526.3439423823385,0.0210192432578844,-0.007713167380905728,605.3371494838169,601.2464294433594,15.897063738414868
2024-03-13,0,611.2200012207031,553.3800048828125,619.2225036621094,585.4743766784668,603.9512672424316,-0.7018616825543273,15.321017953208553,0.20796084214551191,2.9953963519588442,596.8512420654297,12.687436828613283,0.025837244786933392,572.9895126342774,607.7277694702149,0.6482488390172675,0.09457336053359934,1.030756627166656,1.0100998374009875,1.0111408641771549,0.017779766742782366,64.96180619547766,623.6239145685264,592.9818786621094,562.3398427556923,605.2178628104074,3.4537612080580438,602.3396464756557,9.092547928232552,604.3325048208003,597.6261984689066,-0.6588957850499869,5.803595833065134,2192100,8.669717501467117,0.6605138032650553,110645500.0,-33.56497510694843,77.78309058422582,77.02796724212243,87.2690852520097,29.944574886881327,12.098202611411747,0.20049493984204222,14.187338453011238,613.894388671875,607.3827922363281,602.1199951171875,596.8571979980469,590.3456015625,0.02,0.0,526.9123089131086,0.019675767902405106,0.018295759744413116,604.4257202148438,602.7450038364956,13.270901822453734
2024-03-14,0,614.0399932861328,572.4900054931641,619.2225036621094,586.1187591552734,605.2500038146973,-0.26879440249054815,12.829106109280062,-0.8755949187571654,2.9955000198418253,599.5662460327148,11.116988372802734,0.021529901834305875,577.2727447509766,609.8812622070312,0.7003808349575255,0.06661778202138204,1.0304865097518603,1.012066104972092,1.0122300114812248,0.017346737431256587,65.36424971927374,621.5320906975641,595.8738784790039,570.2156662604438,606.812506539481,4.584815637634242,604.3744670322964,8.189536706652461,606.1120114875052,600.1057280184325,-1.2923468372158788,4.439206380261837,3120500,7.743119980781563,0.9772650046428308,113766000.0,-27.727784444104948,77.78309058422582,77.02796724212243,99.9112118454586,30.921555532314777,11.271267465881715,0.1324583213238167,14.134376466523536,614.7085915527343,608.7006968994141,603.8450012207031,598.9893055419922,592.9814108886719,0.02,0.0,527.7389036831872,0.007395112533536086,0.02563202874674255,606.4985787527902,604.8485761369977,13.099085011976028
2024-03-15,0,613.8849945068359,572.4900054931641,619.2225036621094,587.1006317138672,606.1625137329102,-0.32878688289370256,12.28116545821391,-0.7763391083957676,2.9955208260161017,601.1274948120117,10.473901062011715,0.020539689174250912,584.4902404785156,611.5020004272461,0.7696076475651571,0.04541466982795794,1.026694658484058,1.0097589767828885,1.0084932833378788,0.01050192863220678,64.93778844647484,622.4859583883516,597.9236274719239,573.3612965554961,608.7185777936663,4.3088765680253065,606.3442873273577,6.688699834565173,608.1102742481928,602.2964422346796,1.8515380555476602,4.865061207273977,6670900,7.186623968421996,2.0427824025943204,107095100.0,-53.87966433298509,77.78309058422582,77.02796724212243,75.88130659570037,27.99518841247535,11.953635580095847,-0.026842540991353758,14.490911341813018,616.2992292480469,611.2753731689453,607.2149963378906,603.154619506836,598.1307634277343,0.02,1.0,529.3974357820468,0.0017525834889016156,-0.0043220404604773525,607.6685791015625,606.1507175990513,13.152348523174858
2024-03-18,0,617.4524993896484,572.4900054931641,619.2225036621094,588.2068862915039,608.0618934631348,-0.49706588198435003,12.499311478855734,-0.6767870222237664,2.9955139508679536,602.2949905395508,10.412201538085947,0.020858271607184516,584.4902404785156,613.9004943847656,0.7857113641037058,0.042532746445414056,1.030376109803389,1.0149338187260568,1.0122321460791355,0.020422409942266295,64.49497360554605,624.2482498803187,599.2496269226074,574.2510039648961,610.7017887660435,4.719470115590862,607.6916089739118,6.9029127575668845,609.501609856999,603.7725100734973,2.2217409882264603,4.703587049938179,3344200,7.194987806506378,1.0396611355069367,110439300.0,-24.117559701090638,77.78309058422582,77.02796724212243,117.11172118664028,27.25937735597674,10.721856748155504,-0.00799841950302983,14.99613436732685,618.5835817871093,613.1231871337891,608.7099914550781,604.2967957763672,598.8364011230469,0.04,0.0,530.2822170590608,0.02905500172309816,0.022436439204869815,609.0800083705357,607.3450055803571,13.343628915474694
2024-03-19,0,616.4100036621094,572.4900054931641,619.2225036621094,592.9112434387207,610.1043853759766,-0.623364196892438,12.858278463389892,-0.5432182542232162,2.9955020981698124,603.2237548828125,10.38645263671874,0.021406194785494423,584.4902404785156,614.3812438964844,0.7408866493160091,0.06873305532704123,1.0261865648412611,1.0135150981790106,1.006445298548253,0.017656805363363004,70.71806656131469,626.3968082390355,600.6802513122559,574.9636943854763,611.9739292689732,4.910471574075583,609.2128601074219,6.231618539593142,611.4503576021375,605.4449657708159,2.300060686783263,3.1511557438574953,2142600,6.582195272193464,0.6764229079618442,108296700.0,-18.83645289120014,77.78309058422582,77.02796724212243,96.50988237904572,25.513013213382525,11.216884110089385,0.03924570170301925,14.873004777506452,619.0532194824219,613.8833634033203,609.7049865722656,605.5266097412109,600.3567536621093,0.04,0.0,530.8268455120691,0.015808033112480357,0.03296556637219105,611.3542916434152,609.077863420759,12.63427006680828
2024-03-20,0,623.8725128173828,572.4900054931641,619.2225036621094,597.7206192016602,611.8862495422363,-0.7751594181693549,12.151608984554663,-0.07353277222110188,2.995527862627312,604.3325119018555,9.536152954101567,0.020164842683429787,585.5212539672851,616.5142532348633,0.6652065827942205,0.0767174933143348,1.0352778048955305,1.0235077699655821,1.015084594535215,0.020700421405403402,71.1007964378686,626.9168448306816,602.6136268615722,578.3104088924629,614.6564309256418,5.605983706092263,610.7957186017718,6.952606900091634,612.6774805276164,607.2298757760362,1.4658287956916267,3.578737853094713,2639500,6.399622366834229,0.8286074403580012,110936200.0,-4.8520577189682434,77.78309058422582,77.02796724212243,148.64847531785705,28.154833094515148,10.601663269394365,0.0517184933153578,14.607400232262167,620.6576474609375,615.1811860351562,610.7550048828125,606.3288237304688,600.8523623046875,0.06,0.0,531.5539694546882,0.02992860754620641,0.02718135904797624,615.1771501813616,610.847150530134,11.75428676043119
2024-03-21,0,627.5125122070312,585.239990234375,623.8725128173828,600.054370880127,613.9237442016602,-0.36718792477036366,10.875963366660818,-0.6431938481312844,2.9955704126177065,605.4050064086914,8.722753143310547,0.017971370344948695,586.2320098876953,617.6294998168945,0.678784239318623,0.06601141963579144,1.0368975485455398,1.0255541861962996,1.016820569120204,0.02194078409909128,73.83396363189821,626.9346789611049,605.1827522277832,583.4308254944616,617.7703595842634,5.8596971528441255,612.0657185145786,8.246882121761429,615.4811999884798,610.0249049016566,3.103233634189411,3.6828251275617916,2507700,6.044782377304683,0.8000267983614716,113443900.0,-27.502283776112137,77.78309058422582,77.02796724212243,144.7665116639067,28.882175081371305,9.967581512764085,-0.018780434134445204,14.422585282972372,624.3630288085938,618.1784709472656,613.1799926757812,608.1815144042969,601.9969565429687,0.08,0.0,532.2438312293715,0.01582357882009111,0.021757337763610628,616.8385794503348,611.0878644670759,11.616025632431208
2024-03-22,0,625.5549926757812,585.5525054931641,627.5125122070312,601.419994354248,614.632495880127,-0.2177995307350071,10.90249444431784,-0.4040022575297635,2.9955708946041897,606.6100158691406,8.78887710571289,0.017952510229622763,594.2319900512696,619.6875045776367,0.649297887602102,0.07165882874760758,1.0300654095775807,1.018370136587096,1.0092420832562612,0.019010072364320285,75.85178132425638,629.1013672150518,607.2963783264161,585.4913894377803,619.8182155064175,5.691420807839981,612.5180391584124,8.823135975435912,618.4581605911189,612.5363583712588,3.598639656113659,2.9160325860504015,2134100,6.040591579452771,0.6855929426429108,111309800.0,-14.990504678499075,77.78309058422582,77.02796724212243,128.79318016059943,27.68876352773281,10.238409130824786,0.023297829024232143,13.965764022670731,624.3630288085938,618.1784709472656,613.1799926757812,608.1815144042969,601.9969565429687,0.08,0.0,532.8203206331625,0.03652539232928276,0.024469420989936232,619.490007672991,611.9578639439175,11.0654914095626
2024-03-25,0,627.2450103759766,586.3075103759766,627.5125122070312,602.586238861084,616.6706275939941,-0.10643241765347565,10.38715250994725,-0.4738242162188806,2.9955868543856194,608.618766784668,8.59375,0.017047779634651827,598.2422454833984,624.0407608032226,0.6334223264267624,0.06694009816561411,1.0294577559715499,1.0181296830409792,1.008172338474827,0.01585953736685508,72.42893128151094,630.0708077054414,609.2965026855469,588.5221976656524,621.7046465192523,5.645244327687261,614.2585765293667,9.17165920658576,620.2708787363249,614.4733632140817,2.3453079785427304,1.022651627843183,1803300,6.104965960642306,0.5848679644272621,113113100.0,-16.91168000813802,77.78309058422582,77.02796724212243,125.46867120911588,27.36397968846371,9.841284033187408,0.02208601119543931,13.488053165045878,624.7311882324219,618.7743900146485,613.9599914550781,609.1455928955078,603.1887946777343,0.08,0.0,533.307155980214,0.014667130951936835,0.03561764196859028,621.5542951311384,614.0264369419643,10.481011216757464
2024-03-26,0,627.0025024414062,595.1124877929688,627.5125122070312,603.3968887329102,617.8950004577637,0.21638736357199043,9.66364310415461,-1.0888897670563944,2.995607471889553,610.4762573242188,8.310462341308597,0.015807226277218697,600.3472457885742,625.7239944458008,0.7171094189973715,0.0478708535281148,1.0256142870397034,1.0140900526538021,1.0046201062047833,0.017184177278704915,71.52684115092981,630.6706638938562,611.3433776855469,592.0160914772376,623.5785762241909,4.717904427443949,616.1485770089286,8.848375224750106,622.0710026912852,616.4736180003232,2.1505141740320526,4.041869817901863,2804500,5.610112133860984,0.9351403710885073,110308600.0,-13.380165551362152,77.78309058422582,77.02796724212243,115.6698185201121,25.173091710315855,11.14838340321284,0.005345115166514239,13.611431857970917,625.306376953125,619.6868383789063,615.14501953125,610.6032006835937,604.983662109375,0.1,0.0,534.0589641246607,0.013693333978354705,0.017545521966595545,624.8914358956473,616.280007498605,10.916410899845777
2024-03-27,0,621.1549987792969,595.1124877929688,627.5125122070312,604.7137565612793,620.3850059509277,0.08693023351507663,9.772194963405626,-1.1655809680346676,2.995605157382367,612.5524978637695,8.45574951171875,0.01594773014685978,601.5954940795898,627.0267532348632,0.7006447460055073,0.05358653246666803,1.0136936826373941,1.0011854825941462,0.991884057925814,-0.0043558803798131596,72.71216883035972,632.3083929175339,612.7640029907227,593.2196130639115,624.1075047084263,4.08122297801375,617.4046467372349,8.145668715795965,623.3231548879211,617.8207824535662,2.1368021782497313,4.406017376307681,2628300,5.504309123576134,0.8760503571464283,107680300.0,-54.721899327204206,77.78309058422582,77.02796724212243,38.87675899581416,22.538521719701848,14.270474772026596,-0.05199654755521637,14.113482840918454,625.3936958007813,619.8281765136719,615.3300170898438,610.8318576660156,605.2663383789062,0.02,1.0,534.6854936620416,-0.02255886359421988,-0.01161510624565643,624.1971522739956,616.6385803222656,10.206493289347494
2024-03-28,0,609.7275085449219,600.5424957275391,627.5125122070312,605.5600090026855,621.8343772888184,0.08677564946470968,9.04112296863583,-1.3605611652168226,2.995623924487573,613.9624938964844,7.883237915039058,0.014723370250255257,602.7609878540039,627.0267532348632,0.7483929908569756,0.03231195143865052,0.9929346046077605,0.9811952864980897,0.9744819437826291,-0.028342070183680512,60.46368992926505,632.1483744773107,614.066128540039,595.9838826027674,623.1528625488281,6.33892290682178,617.5633959089007,7.957376696912215,622.8064046136242,618.4173864954267,0.5996411696945687,2.9134939672837437,3708800,5.6191109949485485,1.2333867087018477,103971500.0,-70.98636155489162,77.78309058422582,77.02796724212243,-54.64844245218511,20.999297189884917,17.95061047081584,-0.0998434585863484,14.063098018585844,625.3936958007813,619.8281765136719,615.3300170898438,610.8318576660156,605.2663383789062,0.04,0.0,535.4445403648785,-0.024698502256460975,-0.032436370298032695,622.2814418247768,616.817866734096,10.00502527874866
2024-04-01,0,610.7474975585938,600.5424957275391,627.5125122070312,607.0575180053711,621.8343772888184,0.09907143536094323,8.654008904099737,-1.2826297600139502,2.9956331377975673,613.9624938964844,7.5225622558593725,0.014083767890543145,603.5007690429687,627.0267532348632,0.7559976309153876,-8.208325293929368e-06,0.993946977714615,0.9835192323718003,0.9816929310458097,-0.02367097264118878,43.400537816891614,631.7748970806604,614.4668792724609,597.1588614642615,621.2778603690011,7.851299399071748,617.9671456473214,7.399955202351415,619.5562188735987,617.1012009777123,-1.084099070016159,0.3658386893333456,2115900,6.009097896827132,0.7297238575108894,106087400.0,-52.67581233448294,77.78309058422582,77.02796724212243,-21.716434578623492,20.01253125215028,17.058103839329483,-0.14005375630242187,13.73921740073941,625.3936958007813,619.8281765136719,615.3300170898438,610.8318576660156,605.2663383789062,0.04,0.0,535.8922553830547,-0.021814958350973024,-0.013489463984299505,620.3700125558036,617.7735813685825,9.926826379890691
2024-04-02,0,611.4375152587891,600.5424957275391,627.5125122070312,607.0575180053711,621.8343772888184,0.08654408227706552,8.629036658246365,-1.2677115102344878,2.9956337194553773,613.9624938964844,7.476887969970699,0.01404196764803012,603.5007690429687,627.0267532348632,0.7873342172949716,-0.013686527949798436,0.9949877544964195,0.9851281385068342,0.9875027544904325,-0.02520146809571644,41.58267463318014,631.7757017954966,614.5176284790039,597.2595551625111,618.9814322335379,8.071594706132306,618.3758959089007,6.80527843948347,617.3476494999697,615.8477014812418,-2.1037976492211574,0.9341502287223368,2029200,5.587938401026288,0.7119912562477303,108116600.0,-61.52439081122824,77.78309058422582,77.02796724212243,-19.834655954721093,18.99744582735512,16.224840920476566,-0.06854478205892339,13.43715276904532,626.6492175292968,621.8604193115234,617.9900207519531,614.1196221923828,609.3308239746094,0.04,0.0,536.3162637771285,-0.021116883205313464,-0.021974152606451195,619.1557268415179,617.9971531459263,9.915611122451319
2024-04-03,0,621.1849975585938,600.5424957275391,627.5125122070312,607.0575180053711,621.8343772888184,0.2135235856064095,8.583491182863591,-1.207946148728456,2.9956346908943607,612.6612548828125,7.317799987792978,0.013976704994512607,603.5007690429687,627.0267532348632,0.8424879837491646,0.014198619550673258,1.0114904615067133,1.0018038260681172,1.0083942783834112,-0.009278280166602926,47.60192224759659,631.2953614245652,614.1283790588379,596.9613966931107,618.3571472167969,7.635658969373554,619.0876813616071,6.51415543947794,615.8140976040273,614.68919979287,-2.561701421969203,0.9447518309022447,2931200,4.14548827387353,1.0453208944711612,111047800.0,-13.14024134947292,77.78309058422582,77.02796724212243,79.70705766877681,25.098905673996633,14.636724872511895,0.002227639741134502,13.828903499807529,626.6492175292968,621.8604193115234,617.9900207519531,614.1196221923828,609.3308239746094,0.04,0.0,537.0200692558016,0.0013349864415894697,0.0041755570481615085,619.4514421735491,619.47072492327,9.886401223956213
2024-04-04,0,626.2325134277344,600.5424957275391,627.5125122070312,609.1718864440918,621.856876373291,0.058559291469375975,8.306568086635732,-1.197816091110657,2.9956410912552927,613.9624938964844,7.199623870849609,0.013505653906428208,604.9425033569336,627.0267532348632,0.7579911276021788,0.03437309096011086,1.0181918095530962,1.009166970531914,1.018511833075134,0.008174311819780788,60.70858964220129,631.6568907509081,615.0437545776367,598.4306184043653,618.2125047956195,7.4464819298499645,619.9585756574359,6.601840933631416,617.1423095440268,615.4607843788689,-0.6985788888831431,1.6303452632421958,3064300,4.573994858909849,1.0813204650916597,114112100.0,-57.291954786008006,77.78309058422582,77.02796724212243,71.21110113070088,26.201349501633818,13.075475844551352,-0.03050786253479706,14.372198739989486,629.4072463378906,624.091390258789,619.7950134277344,615.4986365966797,610.1827805175781,0.02,1.0,537.7431048020761,0.005883958696691005,-0.01922950825396616,617.9771554129464,619.7657252720425,8.983155658052457
2024-04-05,0,630.4299926757812,603.5700225830078,627.5125122070312,610.4925003051758,624.2931327819824,0.021581422115094985,7.943187123109305,-1.3748203480122942,2.995649228318481,615.2249984741211,7.03399887084961,0.012887916548863652,605.6530105590821,627.0267532348632,0.7237811738714621,0.03754740957435446,1.0228802380681856,1.0155449397807046,1.0236479787048784,0.033953665925725796,64.69801550625837,632.214629708865,616.3282554626464,600.4418812164279,618.702146257673,8.19578416981278,621.140361240932,6.904878399936274,619.4181378120004,616.9778713381922,-0.16141968951419594,1.9856231312151753,3372800,4.64086351176416,1.1770987837436961,117484900.0,-4.998650553775851,77.78309058422582,77.02796724212243,132.4150241080137,23.57538822912346,11.76502070233452,-0.01935935207619845,14.830022976195414,629.4072463378906,624.091390258789,619.7950134277344,615.4986365966797,610.1827805175781,0.02,0.0,538.60102405106,0.047502963420412714,0.036917448694180184,618.9685843331473,621.9300101143973,9.82367705291521
2024-04-08,0,632.9774932861328,605.0950012207031,630.4299926757812,611.1018753051758,625.7243728637695,-0.0035278565384062005,7.943229884633115,-1.3808989304439725,2.9956495792781324,616.9312515258789,7.114874725341792,0.012859963667750397,607.3260192871094,627.271760559082,0.7208498703929882,0.03773626846546251,1.0247805595946649,1.01916966968838,1.0209207321556817,0.0363980136085722,67.3772572564857,633.5577137365514,617.6712539672851,601.7847941980189,620.3910740443638,9.838927590261477,622.249289376395,7.489000969727134,622.1663436743027,619.0208858695412,0.5466469784457202,2.6951299212382156,2145700,4.649388822029528,0.7571531155772688,119630600.0,-28.308031162050824,77.78309058422582,77.02796724212243,115.80469958395196,22.848803152123885,11.13489348016305,-0.03194450935385805,14.548112717955446,630.1712463378906,624.7093902587891,620.2950134277344,615.8806365966797,610.4187805175782,0.04,0.0,539.1363049478252,0.022952541293441486,0.034709228033379246,621.0942905970982,622.6457214355469,9.621364169407313
2024-04-09,0,624.4524993896484,605.0950012207031,632.9774932861328,611.3831367492676,626.4250106811523,-0.056853153945611176,8.247376332764842,-1.2376485121284013,2.995643470069455,619.3037490844727,7.371875,0.013324896337163298,609.3262588500977,627.8042602539062,0.6957495032166631,0.04607952802317035,1.008898404307464,1.0042432244790813,0.9999999951129064,0.02128587763436607,70.33433868766373,635.4396302900415,618.9448776245117,602.450124958982,622.4946441650391,8.68557686305967,622.8237533569336,7.313020603005618,624.8654507629669,621.3827984137555,1.9033082773333034,2.514362467044967,2146600,4.577659081932384,0.7622355025761756,117484000.0,-55.60011420646897,77.78309058422582,77.02796724212243,21.541525669401572,21.02680487972741,16.32994771227726,-0.018559291094264317,14.67773760147389,630.1712463378906,624.7093902587891,620.2950134277344,615.8806365966797,610.4187805175782,0.04,0.0,539.6091610430159,0.00649613339352606,0.006332331662999616,622.6471470424107,622.4642944335938,8.661263263272597
2024-04-10,0,614.7575073242188,605.7150115966797,632.9774932861328,613.2731246948242,626.4250106811523,-0.13887798993193765,7.6816779150911785,-1.1989567893229869,2.9956554507496405,621.1699981689453,6.857974777221682,0.012391546848655555,610.6454986572265,627.8042602539062,0.6892218382725676,0.030934494662062727,0.9916839181196452,0.9890959523224733,0.9803877137546455,-0.010347143378601542,57.46563344100619,635.2761083631414,619.912752532959,604.5493967027766,623.0675027029855,7.87618919522082,622.1726815359933,7.612102811918774,624.7552723720236,622.3482827333903,2.4150117287420523,1.3047315390338194,2806200,5.093206733123712,0.9967251777709898,114677800.0,-54.584329240934856,77.78309058422582,77.02796724212243,-42.14083538571341,19.898737440468476,18.57841323008329,-0.011010924393346834,14.400347304129546,630.1712463378906,624.7093902587891,620.2950134277344,615.8806365966797,610.4187805175782,0.04,0.0,540.1753634911687,-0.018251650089007976,0.007114822228319234,623.2571498325893,621.8135811941964,8.429841333252467
2024-04-11,0,625.5249938964844,609.7275085449219,632.9774932861328,614.0012435913086,626.4250106811523,0.014996665547011422,7.074870602503628,-1.322089842759289,2.9956672450712447,621.1699981689453,6.360637512207029,0.011404370010557194,611.1727508544922,627.8042602539062,0.6553147094121429,0.005787615091866538,1.008317873506066,1.0084066666576963,0.9996084706461786,-0.0011298032537105929,45.63613698008948,634.5146185243432,620.364877319336,606.2151361143287,625.0799996512277,5.981050418901557,622.0307159423828,7.522864977980618,622.2534532060388,621.878314941351,0.6565740803940484,-1.4610365588958343,2662700,5.498240272262346,0.9379171876926329,117340500.0,-27.318839988579352,77.78309058422582,77.02796724212243,53.48886919103645,24.195040121265624,17.24788585892413,0.033212755984914195,14.401751766409589,630.1712463378906,624.7093902587891,620.2950134277344,615.8806365966797,610.4187805175782,0.04,0.0,540.7738429979921,0.0188612217197881,-0.002063210636282381,625.3385794503348,622.2471531459263,8.259676895276813
2024-04-12,0,625.7749938964844,609.7275085449219,632.9774932861328,614.5781288146973,626.4250106811523,-0.15713969952005283,6.833162826616638,-1.2159861890533223,2.9956717137968356,622.5287551879883,6.018349609374991,0.011002063228360805,611.3685134887695,627.8042602539062,0.5971762826911946,0.01870399442369829,1.0075591968565976,1.00809949941634,1.0002341590619035,-0.007383847268337185,55.03238630346851,634.7464526063584,621.080126953125,607.4138012998917,625.7357134137835,5.729165684040719,622.0464303152902,7.531018425984989,623.073754436554,622.5074445816485,2.3039931777383384,-0.31672967022706083,2956500,5.9651837907465035,1.0444228561335336,120297000.0,-43.22372231512828,77.78309058422582,77.02796724212243,39.132845495226235,23.21293224721366,16.03038883863048,0.018574923740183148,14.387323491906386,630.1712463378906,624.7093902587891,620.2950134277344,615.8806365966797,610.4187805175782,0.04,0.0,541.4214368661101,-0.020984588857922648,0.009219953829517341,624.3028651646206,621.8771536690848,8.04928252038852
2024-04-15,0,617.8399963378906,609.7275085449219,632.9774932861328,615.9968795776367,626.4250106811523,-0.35439056911593964,6.706098216927612,-1.0475648677336244,2.995674014433475,624.1625061035156,5.8244370269775345,0.01078728570752542,611.3685134887695,627.8042602539062,0.5772345663664719,0.019368447666977526,0.9938441619017564,0.9927500769881706,0.9890226849835269,-0.023914747536528003,55.277604319766354,635.0790734174979,621.6668769836426,608.2546805497874,624.5367824009487,6.441706884114129,621.374643598284,7.450667443398992,623.7497706595293,622.9084760425524,0.7389097218912906,0.03516896568310972,3085400,5.9631550982572925,1.163654192477772,117211600.0,-85.13765958314639,77.78309058422582,77.02796724212243,-90.66170086036466,20.348052486759588,21.114436098604894,0.07482171502491809,15.239231744891859,630.1712463378906,624.7093902587891,620.2950134277344,615.8806365966797,610.4187805175782,0.02,1.0,541.9973141352907,-0.03383133565510599,-0.04563169008132169,622.8757237025669,620.4264395577567,7.923725243396812
2024-04-16,0,613.7425079345703,609.7275085449219,632.9774932861328,617.1918754577637,626.4250106811523,-0.40020767329331336,6.52970246076118,-0.8798735736980228,2.9956770670855732,624.1625061035156,5.606911926269527,0.010500199201669037,611.3685134887695,627.8042602539062,0.5491198057140189,0.0006275736977746922,0.9869390880474651,0.9850436175158683,0.987248073322302,-0.017151010630186092,46.97538957065349,634.9240319967178,621.8646270751954,608.805222153673,622.1528560093471,6.963933564123416,620.4275011335101,7.522680502876972,622.2853808814032,622.1418247322085,-1.3401599102395096,-1.4994163177876032,3519100,6.212444997955057,1.3228605152957273,113692500.0,-57.41779173634621,77.78309058422582,77.02796724212243,-62.95526358098265,18.8876438233264,19.599022993494533,0.10109790123759267,15.24357621537269,630.1712463378906,624.7093902587891,620.2950134277344,615.8806365966797,610.4187805175782,0.02,0.0,542.6618871117223,-0.0010999557786380842,-0.01732937744254516,620.2100132533482,619.5892987932477,7.944338640325487
2024-04-17,0,615.8349914550781,609.7275085449219,632.9774932861328,615.9968795776367,626.4250106811523,-0.3616495031386361,6.702812959170621,-1.0367735035381476,2.995674072305828,624.1625061035156,5.810961456298832,0.010781788647302299,611.3685134887695,627.8042602539062,0.5327164155657886,-0.004327469884802963,0.9905994333912388,0.9880364883334535,0.994038996746589,0.0017526978003883364,43.82343004985268,635.0847534207826,621.6791275024414,608.2735015841001,619.7039271763393,5.350079399119436,620.0475006103516,7.616882423447981,620.1766229306481,620.8230248582945,-2.6470004497062387,-2.1148232192382825,3312200,6.277071891743913,1.2183028653400523,117004700.0,-67.65574907207244,77.78309058422582,77.02796724212243,-78.51961970190492,17.701859038612547,18.368577127491868,0.056751191574943544,15.101744459795357,630.1712463378906,624.7093902587891,620.2950134277344,615.8806365966797,610.4187805175782,0.02,0.0,543.2622665154847,-0.007905225699729068,-0.0072953893182949765,618.107160295759,619.6007254464286,8.134209105355882
2024-04-18,0,612.3549957275391,609.7275085449219,632.9774932861328,615.5656204223633,626.4250106811523,-0.35377067018021857,6.7265435383112475,-1.060825971687254,2.9956736554466104,624.1625061035156,5.842587127685545,0.01082046080618541,611.3685134887695,627.8042602539062,0.5930882142490088,-0.012883275344200643,0.9850472524266412,0.9832972452692099,0.9880781306849434,-0.02105431165413152,44.10409560153771,635.1034639687124,621.6503768920899,608.1972898154673,617.9757123674665,5.5119698211587975,620.2351782662528,7.371457149502766,619.1539427172861,620.2769022639848,-2.708232443156639,-0.8564701780833621,8468400,6.044984233201391,2.813286403146692,108536300.0,-80.95644317806696,77.78309058422582,77.02796724212243,-85.51362948948041,16.37436328584845,18.066450408180067,-0.028195534666225187,15.158818293027121,630.7093188476563,625.5803381347656,621.4349975585938,617.2896569824219,612.1606762695312,0.02,0.0,544.7169723669522,-0.02897679775016959,-0.012965209527751617,617.0157296316964,619.8314383370536,8.309577579235533
2024-04-19,0,563.5199890136719,609.7275085449219,632.9774932861328,614.5037574768066,626.4250106811523,-0.18535405762486173,6.999147528035117,-1.2923673409828953,2.995668727162052,622.8187484741211,6.215348815917968,0.01126941698031717,611.3685134887695,627.8042602539062,0.5845756195516951,-0.02415492310453144,0.907330743851547,0.9069007169007496,0.9131604548122281,-0.09948464782073208,40.21150609276935,635.0727960936679,621.0745010375977,607.0762059815274,610.6560668945312,21.456620428182443,616.8617847987583,16.81043308032357,617.4833404308571,619.4005004553982,-1.9372976605800605,0.43092810243833807,16425000,6.002032982985245,4.431990199702645,92111300.0,-96.68355136784353,77.78309058422582,77.02796724212243,-402.3030642247965,12.62840667848834,34.80078643157756,-0.16524900997964548,18.25018360342662,618.5057536621093,605.827109741211,595.5799865722656,585.3328634033203,572.6542194824219,0.04,0.0,545.3968688049714,-0.10884195880482306,-0.11727479855234921,607.9385811941964,615.5978655133929,16.75754850656593
2024-04-22,0,551.4699859619141,563.5199890136719,632.9774932861328,613.3956298828125,625.8893737792969,-2.653316378575976,14.223366404698002,7.809669347133475,2.9954616562565914,621.1699981689453,9.09113647460938,0.0230198167671214,610.6454986572265,627.563508605957,0.24729429820539964,-0.099167945885553,0.892526963603861,0.8971689060115604,0.9120354539373092,-0.10742265112224858,20.13262782391584,646.3216076873257,617.8748748779296,589.4281420685336,600.0767800467355,29.61074516599183,612.5783898489816,24.279587227925365,603.9963906462511,611.7002003910873,-8.334590094484941,-7.732738772358371,8597700,12.30112835886019,2.1338532062275544,83513600.0,-87.01931427161811,77.78309058422582,77.02796724212243,-330.4934156728535,11.801930256116897,36.52486892389795,-0.11648899202364998,18.132215654509146,616.1103623046876,601.9498237304688,590.5050048828125,579.0601860351562,564.8996474609376,0.06,0.0,545.5243695603813,-0.08655199986006601,-0.10954841550943427,597.3414306640625,611.3400050571987,21.55255372726716
2024-04-23,0,567.1825103759766,551.4699859619141,632.9774932861328,612.1256256103516,625.8893737792969,-2.1669454004079505,20.152268717461624,3.7791180623819915,2.995180501321743,619.4974975585938,12.619437179565443,0.032812166378816704,605.1067565917969,627.563508605957,0.5492497822816824,-0.12080610154019757,0.9234933871979278,0.9351311322431639,0.959075721654246,-0.07586242920550224,17.418829627437002,654.4751619771596,614.1706245422363,573.866087107313,591.7064252580915,29.416470111154293,608.7210693359375,26.949933498926328,590.8368705003995,603.4646110511951,-11.838856745478884,-9.807630019478593,4975500,12.392113945120013,1.1880939872964325,88489100.0,-63.15084665127835,77.78309058422582,77.02796724212243,-177.17945757158293,18.60433329396592,33.06946555805538,-0.06375547739617533,18.595267565579647,616.1103623046876,601.9498237304688,590.5050048828125,579.0601860351562,564.8996474609376,0.06,0.0,545.814388550733,-0.06440280197140624,-0.048422997993676026,590.9014282226562,607.6021466936384,22.664271920960314
2024-04-24,1,564.4099884033203,551.4699859619141,632.9774932861328,611.2650108337402,625.5874938964844,-1.6609640401001011,22.337017260452548,1.4624570665827052,2.9950501771014264,616.8374938964844,15.319000625610352,0.036548110423383025,566.816258239746,627.3452514648437,0.7167919577224738,-0.09540630513036892,0.923494768334479,0.9394303531679308,0.9696558310688083,-0.08350451625077715,29.228513615780255,655.8415340631414,611.1674995422363,566.4934650213313,584.0735669817243,28.42029947096632,604.3051746913364,28.857348570592663,584.8730698725276,598.5799912179364,-9.363187102711262,-8.693462880600777,5355300,13.135757241238812,1.240991439840198,83133800.0,-86.48315633408933,77.78309058422582,77.02796724212243,-167.7699451506683,16.76823637749376,31.29083463131683,-0.11589963868453423,19.156714494438997,616.1103623046876,601.9498237304688,590.5050048828125,579.0601860351562,564.8996474609376,0.06,0.0,546.0013762610735,-0.09543907688118303,-0.10104939506484244,583.4685668945312,603.1721452985491,25.380067535408752
2024-04-25,1,556.6275024414062,551.4699859619141,632.9774932861328,610.4925003051758,624.7206230163574,-1.2895334330104897,24.205860026328168,0.15537618363862338,2.994925611681597,615.2962493896484,18.55690216064452,0.03980978992878413,564.3209884643554,626.6522613525391,0.7646580067217346,-0.09135402675257015,0.915448735003593,0.9343063786546426,0.9734866683568586,-0.09100520723264938,28.849309215612305,656.4495938929883,608.037873840332,559.6261537876758,575.9142804827009,26.62487320906357,599.033568246024,30.416723636427662,579.6963685254124,594.0538550840685,-8.647871334207046,-9.872135939736419,3807100,13.12043973866889,0.8703375184030286,79326700.0,-76.50275252912999,77.78309058422582,77.02796724212243,-139.1886358632065,15.473126195209224,30.946775766847516,-0.056207803220359336,19.276309629444846,616.1103623046876,601.9498237304688,590.5050048828125,579.0601860351562,564.8996474609376,0.06,0.0,546.1135142611989,-0.07494760539275835,-0.07966565277899473,575.9371337890625,598.0735735212054,27.011888231677567
2024-04-26,1,558.8874969482422,551.4699859619141,632.9774932861328,599.0912590026855,624.7206230163574,-0.9952933012776618,26.43979067978138,-0.6470073613018426,2.9947621343642727,614.2500076293945,22.084751892089855,0.043715753953872484,562.8307403564453,626.6522613525391,0.7955801412601099,-0.08708809322091372,0.9240689005593532,0.9490754214240289,0.996870554996033,-0.008220634859001041,27.425455139167653,657.6910803830002,604.8114990234375,551.9319176638747,567.7789241245815,20.356257317535633,593.7414256504604,30.501858916952425,573.8844905106705,589.1621269525477,-9.30602080754898,-11.706690844629641,4332600,13.02189516159123,0.9834591995859693,83659300.0,-78.90464955189965,77.78309058422582,77.02796724212243,-115.1712436113245,14.787568362443334,29.57563691241352,-0.01766049101342727,18.728383713702822,611.6180385742188,598.3159807128907,587.5650024414062,576.8140241699218,563.5119663085937,0.06,0.0,546.2397414019431,0.011152354220332006,-0.08079470860701071,568.4428449358259,593.2750026157925,28.683147592486982
2024-04-29,1,558.1374969482422,551.4699859619141,632.9774932861328,566.4893798828125,624.7206230163574,-0.7625088084327497,28.22840953883408,-1.1622198527927026,2.9946200200319684,614.2500076293945,25.151951751708975,0.046870063338393324,558.6614974975586,626.6522613525391,0.832835110039468,-0.0849123423635088,0.9267238310932098,0.9586911084274402,0.9971807107595241,0.012090433126107802,28.94791022835609,658.7263175212717,602.2694984436035,545.8126793659354,560.0335671561105,5.358176747235433,589.0046397617886,30.514906681454956,570.1610951022465,585.6396679232744,-9.247200191122943,-11.704996958619947,2508900,13.043939039805549,0.5669676754528691,81150400.0,-80.81441852800143,77.78309058422582,77.02796724212243,-101.14501365602177,14.374623480237954,28.74973318019721,-0.010707024092599333,17.889455981702984,611.6180385742188,598.3159807128907,587.5650024414062,576.8140241699218,563.5119663085937,0.06,0.0,546.3043227521118,0.008817192325461631,0.008017462494948467,561.1471296037946,589.0814296177456,30.06214480007671
2024-04-30,1,555.0050048828125,551.4699859619141,632.9774932861328,564.1874885559082,624.7206230163574,-0.5514844535869659,29.72728425253854,-1.5054740111626306,2.9944914440588635,614.2500076293945,27.72380187988282,0.04957530169186841,557.9864974975586,626.6522613525391,0.851875880984354,-0.08717165201743927,0.9255652256634491,0.9631879118990327,0.9892273328155915,-0.021470171012663575,28.571642052822607,659.0935669181631,599.6389984130859,540.1844299080087,558.817140851702,5.401138750560568,584.7366038731167,30.81310041882841,567.2147584159442,583.7476561450242,-8.85393263018636,-10.619703261052486,3361500,13.028024091670805,0.7483745145250109,77788900.0,-90.5279263853328,77.78309058422582,77.02796724212243,-96.82110407416441,13.746534767317451,29.49309779637807,-0.05778475622447386,17.369937905815405,611.6180385742188,598.3159807128907,587.5650024414062,576.8140241699218,563.5119663085937,0.06,0.0,546.3566382284457,-0.04692338442503241,-0.0071402111644817195,560.5185634068081,584.2285723005023,31.746048569753764
2024-05-01,1,551.0475158691406,551.4699859619141,632.9774932861328,562.3618659973145,624.7206230163574,-0.35824379814928375,31.11911434147824,-1.7241962697088478,2.9943636240329177,614.2500076293945,29.92990081787109,0.05214177025471793,556.4652526855468,626.6522613525391,0.8546252065323027,-0.10653829847128395,0.9233101127683601,0.9661686380393839,0.9864557836791072,-0.023675117040329652,25.475800140159134,659.0556015772435,596.8173728942871,534.5791442113308,558.7567879813058,5.498404146192386,579.4167840140207,29.63608529329173,564.1955356372197,581.7948629946595,-1.511034976019775,-9.71968649906917,3473200,12.68787902494607,0.7686051825304531,74315700.0,-89.35351359172961,77.78309058422582,77.02796724212243,-87.93286298051717,12.829080682993698,29.646020231906537,-0.09164433161515229,17.282043690817595,611.6180385742188,598.3159807128907,587.5650024414062,576.8140241699218,563.5119663085937,0.06,0.0,546.4005541746833,-0.006142767643978253,-0.04507135963192341,560.105712890625,578.7235717773438,32.20210250612479
2024-05-02,1,560.5550231933594,551.0475158691406,632.9774932861328,558.6999969482422,624.7206230163574,-0.16374609911857663,32.11161854484669,-1.8282078466053049,2.9942624614504507,613.0487518310547,31.35069984436035,0.05412278833639865,554.6515029907226,626.6522613525391,0.850910498703299,-0.12005923669958077,0.9447920175318609,0.9941311663724953,1.0082994773672445,0.007055922919235513,23.084837187669933,657.5337358995077,593.3104988098145,529.0872617201212,557.8100040980747,4.2300658561497775,574.7582146780832,26.776451783936665,560.9199808697333,578.6255504356004,-0.07660799382155575,-11.90639522865632,3068200,12.527544200654965,0.6789510138237631,77383900.0,-73.75224399115766,77.78309058422582,77.02796724212243,-59.87871514507733,14.216365858895708,27.935489629827863,-0.027693653833898796,17.02964138440223,609.3642292480469,596.4928731689453,586.0899963378906,575.687119506836,562.8157634277344,0.06,0.0,546.5053628503138,0.0006197532377107962,0.018068218376384785,558.3057163783482,574.6035723005023,32.20433152295716
2024-05-03,1,572.6900024414062,551.0475158691406,632.9774932861328,558.6999969482422,619.4931221008301,0.03435996123955991,31.934704015833752,-1.8525829404374323,2.994267649528752,589.7687530517578,31.34237289428711,0.05412417457233178,554.6515029907226,626.2404937744141,0.8565160120196855,-0.11083700060945119,0.9706172210833479,1.0250691710074256,1.0286738544977343,0.024696393403916606,30.908743087868586,653.8960323297632,590.0266242980957,526.1572162664282,558.9928632463727,6.77521476165466,571.5332151140485,23.734667426536088,560.8471532888245,576.8484916675294,-1.1684928680582778,-10.422271797251407,3307500,12.763357155183591,0.7324340394152485,80691400.0,-53.5927200934193,77.78309058422582,77.02796724212243,-27.537525453517908,19.568363314120006,26.14990441227633,-0.024398347900423247,16.892465831909366,603.4661716308593,591.721931274414,582.2300109863281,572.7380906982422,560.9938503417968,0.06,0.0,546.708819929788,0.03226849423046296,0.02574369578037199,561.7657209123884,572.6171439034598,30.35765494395746
2024-05-06,1,589.0950012207031,551.0475158691406,632.9774932861328,558.6999969482422,616.3362426757812,0.19860392575059327,30.73917481740829,-1.7859601355308221,2.994365795749028,569.9362564086914,29.900335617065434,0.052354113944519304,554.6515029907226,625.5499938964844,0.8464698465016107,-0.09524428827910007,1.0033303431616245,1.0527049364692496,1.0529198928573043,0.05546573101024199,39.85258509494424,648.6179744211936,587.139624786377,525.6612751515604,563.6310773577009,13.07270552391221,569.7726789202009,21.13463580006307,563.8153406153804,576.7539747048343,1.4670211740067831,-7.307716263773944,3686300,13.182146837646895,0.8026267229432187,84377700.0,-30.71109951761301,77.78309058422582,77.02796724212243,15.967365028001007,25.276623968338953,24.168103552950875,0.03647668863228136,16.971606092920425,602.6104953613282,591.0297742919922,581.6700134277344,572.3102525634765,560.7295314941406,0.02,1.0,547.0635971904738,0.06698954605613117,0.06368154139685174,566.3614327566964,571.1492832728794,28.880154403489154
2024-05-07,1,599.9125061035156,551.0475158691406,625.7749938964844,558.6999969482422,615.0268783569336,0.2676971793020245,28.900144482345713,-1.715919922238618,2.9945165217169762,569.9362564086914,27.48679855346679,0.04940655919790665,554.6515029907226,624.5597488403321,0.8423354061279293,-0.05662159764514418,1.025587009243981,1.064875937711425,1.0605184676557544,0.08091368694987744,50.893511711367886,642.7457891477968,584.9455001831054,527.145211218414,569.4917929513114,18.61351831394708,568.6353585379464,18.760249249348536,570.1145997119254,578.4251526790072,5.832895183384258,-4.015936063612984,3614100,13.809904207830858,0.7745324323803033,87991800.0,-19.326797370533072,77.78309058422582,77.02796724212243,43.98644794645743,27.396148803867156,22.655001073126453,0.0901418730042446,16.811432322797604,602.6104953613282,591.0297742919922,581.6700134277344,572.3102525634765,560.7295314941406,0.04,0.0,547.4799819084258,0.10053752702100249,0.08312929735551046,572.7571498325893,570.5999973842075,28.274670959038577
2024-05-08,1,607.7374877929688,551.0475158691406,625.7749938964844,558.6999969482422,613.9962577819824,0.2999945410574619,27.692476178919772,-1.6383083723869194,2.9946116991475247,569.9362564086914,26.13709892272949,0.04744149132553994,554.6515029907226,618.60849609375,0.8390201860290014,-0.024147734747180526,1.0411482371259817,1.0725345358712493,1.057560083293136,0.1028767398296202,57.517168444317484,639.1034528766384,583.7185005187988,528.3335481609593,576.5775059291294,22.58738667748585,568.30553654262,17.955837395112386,577.5666662804986,581.294542115875,7.340477176406168,-2.585511634202741,3093900,13.956285219819382,0.6610113544227126,91085700.0,-11.48143876779559,77.78309058422582,77.02796724212243,67.88358493245168,30.639990283209507,21.056065391530876,0.0667347291066632,16.79560799783491,600.234419921875,589.107765625,580.114990234375,571.12221484375,559.995560546875,0.06,0.0,547.8880328263189,0.10469258565205375,0.10683923160260732,579.8971470424107,570.5221383231027,27.771546507334016
2024-05-09,1,611.9900054931641,551.0475158691406,625.7749938964844,558.6999969482422,612.7018737792969,0.31103301464608396,27.339067751936653,-1.6048229501361122,2.994638929862677,569.9362564086914,25.750997848510746,0.04686422842100287,554.6515029907226,618.60849609375,0.7983468598946006,-0.028436123699414013,1.0490642793323035,1.0718435948629748,1.0443551021653357,0.09175724089812065,59.800513474963495,638.0456350461096,583.3674995422364,528.6893640383631,584.7182203020368,23.755399147633,571.7676805768695,21.319868738268788,585.2589066578496,584.9326681061575,8.886697474354804,-0.7540573632594032,2065400,13.843139786243093,0.4441061433894755,93151100.0,-8.043494278501774,77.78309058422582,77.02796724212243,75.86530631296475,29.301574825548634,20.13629475397338,0.05600697063794008,16.307911113865593,600.234419921875,589.107765625,580.114990234375,571.12221484375,559.995560546875,0.06,0.0,548.1636269972081,0.08305759606057306,0.10944155893148709,588.6757202148438,574.5971418108259,26.593304356493103
2024-05-10,0,614.7274932861328,551.0475158691406,625.7749938964844,558.6999969482422,612.0812530517578,0.2814131411858816,26.43986217062051,-1.6347431666398118,2.994706713969165,569.9362564086914,25.006573486328126,0.04537546231012165,554.6515029907226,616.0354919433594,0.7714669560164541,-0.022028666114454268,1.0549806962910446,1.0662989726046224,1.0309289897564147,0.07340357028325739,61.59535852057298,635.5704744633114,582.6907501220703,529.8110257808293,593.8153599330357,20.710095822027974,576.2860739571707,23.298572485498028,592.0418712936399,588.1894705970514,10.267475087433448,8.601294971688436,2653600,13.889962856824527,0.5724461740744616,95804700.0,-16.442980763930994,77.78309058422582,77.02796724212243,85.31657345289732,30.478128479009527,18.48601642694179,0.059474129460799614,16.494541456475364,605.163705078125,593.5231279296875,584.114990234375,574.7068525390625,563.066275390625,0.08,0.0,548.5259785539337,0.05442394241747217,0.08089882107061157,597.1271449497768,578.6164289202009,25.785922933605192
2024-05-13,0,613.9850006103516,551.0475158691406,617.8399963378906,558.6999969482422,612.0812530517578,0.23358700226554052,25.637204137238108,-1.7151073884551955,2.994765452382534,569.9362564086914,24.398960952758785,0.04403970814191068,554.6515029907226,614.8382431030274,0.773422192941385,-0.005037716998262468,1.0547062809830916,1.0547943795320216,1.0153673178513272,0.04225124867478458,64.14967044315442,633.412783366029,582.1383750915527,530.8639668170764,601.4482138497489,15.632176252650975,579.6291089739118,25.174127554062895,597.7097895254369,590.8194883949525,11.556168131264114,11.47070718887455,2086200,13.802576864805241,0.45494740583807736,93718500.0,-9.268726230502121,77.78309058422582,77.02796724212243,86.85590139164887,28.940438975999975,17.553355701669652,0.10160990293039183,16.129830439281715,605.163705078125,593.5231279296875,584.114990234375,574.7068525390625,563.066275390625,0.08,0.0,548.8105439491164,0.03286606883966847,0.06429730084797501,604.4757167271206,581.3907165527344,26.33262713996736
2024-05-14,1,614.677490234375,551.0475158691406,615.8349914550781,558.6999969482422,612.0812530517578,0.22312300483766787,25.381276038847073,-1.7278691420468688,2.9947838659619332,569.9362564086914,24.18693618774414,0.04361451471610767,554.6515029907226,614.0592498779297,0.7810669754460893,0.00039510490579723964,1.0562455726203535,1.0459488814932727,1.008212619092077,0.02461189586921475,64.35438212370921,632.70817738287,581.9456253051758,531.1830732274816,607.4464263916016,9.680898380633359,583.2196448189871,26.391807012895264,601.7593786316593,592.658475586745,9.531620484393002,8.251751310764211,2792400,13.772551078508302,0.613815464087487,96510900.0,-12.943697293722098,77.78309058422582,77.02796724212243,89.04675465777291,28.70453440434277,16.522439114777715,0.0832459277506777,15.911928121590451,605.163705078125,593.5231279296875,584.114990234375,574.7068525390625,563.066275390625,0.08,0.0,549.1912514161554,0.012640219710447598,0.027957859290222556,609.3785661969866,585.5721435546875,26.082587676914805
2024-05-15,1,616.3224945068359,551.0475158691406,615.8349914550781,558.6999969482422,612.0812530517578,0.22492053641566534,25.440590592991207,-1.7263687212651477,2.994779610997538,569.9362564086914,24.2383602142334,0.04371292771376506,554.6515029907226,614.6824905395508,0.7754360576695448,-0.0018795639039090855,1.0589872335026258,1.0382061096310222,1.0060379646727697,0.014126175999186863,64.43933781899823,632.8735556061484,581.992374420166,531.1111932341836,611.3360682896206,5.750700558139566,587.4835728236607,26.58654760920826,604.9580750591672,593.8560646788895,7.331625768561348,8.906203444991863,5670600,13.764970289221273,1.2149975252669176,102181500.0,-13.249792472761573,77.78309058422582,77.02796724212243,91.47358346330005,27.944544682939846,15.405069893128786,0.059673862952507,15.846775364999504,605.2553813476562,593.5972849121093,584.1749877929688,574.7526906738282,563.0945942382813,0.1,0.0,549.9632729121827,0.006645198324459756,0.012409273153877888,611.7428588867188,589.0521458217075,26.07216825954101
2024-05-16,1,613.4250183105469,551.0475158691406,616.3224945068359,558.6999969482422,612.0812530517578,0.22632699496299585,25.473216845184705,-1.7245816520298938,2.994777268042789,569.9362564086914,24.265172882080083,0.043767154233763976,554.6515029907226,614.6824905395508,0.7808558067242466,0.006479082896324034,1.0539645444239347,1.0220867160579805,0.9985098190330044,0.0023448304784428053,66.0320950247843,632.9631832631234,582.016749572754,531.0703158823845,613.2664271763393,2.7750460238136285,591.3791100638254,26.064636774048964,607.7070335601552,594.6667345789165,4.621918914557567,10.72440578368898,3056400,13.745528350636128,0.695178286709867,99125100.0,-17.00683807983416,77.78309058422582,77.02796724212243,83.35204924732041,26.743455587490356,14.747564826438472,0.07349650669991405,15.375476142909624,605.2553813476562,593.5972849121093,584.1749877929688,574.7526906738282,563.0945942382813,0.1,0.0,550.3537734860035,-0.002564994127227438,0.0017228885402074757,612.3885759626116,592.5728628976004,26.06996408127062
2024-05-17,1,619.6499938964844,551.0475158691406,616.3224945068359,558.6999969482422,612.3487586975098,0.22751233064783236,25.537921261113556,-1.724581256519622,2.994772609303355,569.9362564086914,24.324024124145513,0.043874293919536345,554.6515029907226,614.6824905395508,0.9025794283240764,0.0885594659813642,1.0645622124636391,1.0234430545501585,1.0081716072122116,0.00800761420973295,76.50782898914122,633.1460932241315,582.0702507019043,530.9944081796772,614.9682137625558,2.4533478105123714,595.7728598458426,25.200299574251616,609.0097847400738,594.8187912969923,2.252413821941503,9.758228920865506,3782700,7.550314843747819,1.004846651108859,102907800.0,-5.751782812393568,77.78309058422582,77.02796724212243,93.56098874620517,28.308358601295094,13.700675048122216,0.2648872658095649,15.36793766829721,606.5465432128906,594.6417064208985,585.0199890136719,575.3982716064453,563.4934348144532,0.12000000000000001,0.0,550.8906974275314,0.016746575458805202,0.014719973100617512,614.0500052315848,596.9735761369977,26.492047785070582
2024-05-20,0,631.2775115966797,551.0475158691406,619.6499938964844,558.6999969482422,613.565013885498,0.04696491639368223,26.414299597224012,-1.7807429512123678,2.9947127617595175,580.8925018310547,25.27549819946289,0.04516216374560722,554.6515029907226,614.8869934082031,0.8769929545712747,0.12363321607729165,1.079334253884397,1.0346229362929613,1.0254470544716254,0.02816438670185417,83.11812516442214,637.7053501404929,584.8767509460449,532.048151751597,617.7235717773438,6.325780316750994,601.2208960396903,23.92093258200269,611.6708042886936,597.1285227834586,1.9601400839656162,11.021029277656009,3857900,6.739930305780515,1.093674919524361,106765700.0,-3.545733086396573,77.78309058422582,77.02796724212243,118.85022516376605,33.44893531661301,12.184773801802109,0.2587540087285074,16.0453512409192,620.7416762695312,606.1241569824218,594.3099975585938,582.4958381347657,567.8783188476563,0.14,0.0,551.5411570292653,0.03929674404939676,0.04902845523012753,618.1542881556919,603.4150041852679,27.99506974042367
2024-05-21,0,643.1174926757812,551.0475158691406,631.2775115966797,560.1381416320801,614.1581230163574,-0.05642784239518782,27.085845980044198,-1.6797555158103208,2.9946730243931805,594.5037536621094,25.526160354614262,0.04599653254131634,556.4652526855468,616.6552444458008,0.8887420729286766,0.11300595495833525,1.0921266665086116,1.0467909713830792,1.0388437034237838,0.046268169720290464,85.30802688130412,643.0388191878715,588.8671272277832,534.6954352676948,621.7792859758649,11.260742932453185,607.7973229544504,21.610553798374504,616.6171935546218,601.1691577071092,3.1516047534098277,13.742670073753997,2920200,6.406663751717751,0.8526878266709493,109685900.0,-0.28336613864316046,77.78309058422582,77.02796724212243,129.6508386914894,33.86516962241384,11.283402686469415,0.24399345626489305,16.089264698493533,628.3915700683593,614.4792332763672,603.2350158691406,591.9907984619141,578.0784616699219,0.16,0.0,552.0870635209548,0.060212518045932084,0.05517435737582595,623.8314296177456,610.4792872837612,30.8016892955195
2024-05-22,0,643.7449951171875,551.0475158691406,643.1174926757812,560.1381416320801,614.6899909973145,-0.09331647247350805,29.03225319836684,-1.4598046631019466,2.994529890729778,603.8249969482422,26.751985473632818,0.04898603467705821,556.4652526855468,620.8127456665039,0.8673455099808054,0.13945094149577228,1.086189020140095,1.0404951685474921,1.0303901313117736,0.044493752629123584,88.77399517405078,650.728382739507,592.6638763427734,534.5993699460398,626.0307137625558,13.266781916304863,613.7394638061523,18.886874110637972,623.2090950530549,606.0488860900384,4.6183064365455255,16.708173824433832,2176200,6.4991226875369925,0.6663716854806484,111862100.0,-12.144225764487834,77.78309058422582,77.02796724212243,112.74429368172528,31.95656010926913,10.647480588687138,0.29415257368009845,15.832132705009185,630.6500773925782,618.134952758789,608.0199890136719,597.9050252685547,585.3899006347656,0.16,0.0,552.4784255747011,0.04392676736525347,0.04368868548035374,627.2428501674107,615.8592834472656,30.972755520420545
2024-05-23,0,637.6800079345703,551.0475158691406,643.7449951171875,560.1381416320801,615.1262435913086,-0.1969308748009152,30.293341564209932,-1.3343332946019473,2.994438047316392,609.8637466430664,27.099996948242186,0.05077403037932793,556.4652526855468,632.4615097045898,0.8668276345860605,0.15650950104635142,1.0688020014738961,1.0247283663528908,1.0118002192612465,0.039540268003455115,91.66817551285345,657.2173098068868,596.6306266784668,536.0439435500468,629.3167877197266,12.827492677514204,618.3816070556641,15.747235745868172,628.2827945538627,610.6162869748032,4.847023050604177,14.840643376971817,2313900,5.93367158456269,0.7251138719275733,109548200.0,-21.534788221935322,77.78309058422582,77.02796724212243,90.84748421877308,30.097622130640072,13.744438964098851,0.24744029646647758,15.609091803665809,634.2113237304687,623.8993430175781,615.5650024414062,607.2306618652344,596.9186811523438,0.16,0.0,552.8611753823486,0.04119433036481923,0.03610308168237048,630.3871372767857,619.8828517368862,30.93790031438687
2024-05-24,0,643.9375,551.0475158691406,643.7449951171875,569.6562576293945,617.154369354248,-0.36299615462533596,30.091574554154736,-1.1858263350055074,2.9944689140439027,612.7075119018555,26.013596801757807,0.050095577754684865,557.8242477416992,638.2237564086914,0.883608113836933,0.14098098707981116,1.0720084135960735,1.0305296022973047,1.0139247099680675,0.039195523832399104,82.62601716105455,660.8664010614348,600.683251953125,540.5001028448153,633.2617885044643,12.404567461819429,622.2989283970425,14.687104048305372,630.5635030664137,614.1613111711134,3.7422092179468796,11.348199761844699,2613300,6.379786431752179,0.8416099860874942,112161500.0,-8.651945671864581,77.78309058422582,77.02796724212243,108.83289787332306,32.093364859195106,12.72058725781116,0.22015723769047663,15.660593540879836,637.6795217285156,628.8202427978515,621.6600036621094,614.4997645263672,605.6404855957031,0.18,0.0,553.3371927752407,0.041297738564334274,0.05934282138129876,635.13427734375,623.4385681152344,30.873235262905826
2024-05-28,0,647.2075042724609,551.0475158691406,643.9375,584.9937515258789,622.5568733215332,-0.5117753376552103,29.893500020641827,-0.9397826207011151,2.994499957069628,613.7050094604492,24.81077140808104,0.04941599156040279,557.8242477416992,643.1802429199219,0.8643192358424738,0.15372556676605856,1.0698780854323866,1.0309434827773676,1.0113383635963167,0.02523453217189653,84.5724997998692,664.7227521469966,604.9357521057129,545.1487520644292,638.0878579275949,9.671165713141853,625.6771425519671,14.580693098437429,633.8307499970857,618.3165131307353,4.480609703408736,9.309618765335653,2609500,6.2879219270733415,0.8390270565728342,114771000.0,-5.955926723876781,77.78309058422582,77.02796724212243,110.94359683266867,31.06774779934991,12.314071725391921,0.21429541998166132,15.021896163139678,640.1126811523437,632.7586618652343,626.8150024414062,620.8713430175782,613.5173237304688,0.18,0.0,553.8169036762599,0.012764883402965665,0.04492034376227754,640.6314174107143,626.5099966866629,30.168643430712795
2024-05-29,0,651.7225036621094,551.0475158691406,647.2075042724609,597.2081298828125,632.8781356811523,-0.6520811408737396,29.21692823082936,-0.5946038123511701,2.9945698535999297,614.3312454223633,22.96822257995607,0.04794460701811518,560.0000213623047,643.7642456054688,0.8381198477249879,0.16612913141047564,1.0694683258991937,1.0326705309738182,1.013348628655784,0.013380153835539144,86.44351990470365,667.8231089335826,609.3892524719238,550.955396010265,642.6696450369699,6.585185393148968,628.8189293997629,15.1456874393305,637.1161224524228,622.4331935515693,5.5071907655405825,7.883649313485807,3695900,6.035507120029672,1.181980702747476,118466900.0,-16.26964772023028,77.78309058422582,77.02796724212243,126.33706105046471,34.85896447368014,11.151310220573787,0.25733950179709375,15.403233410514696,650.2811594238282,641.6394190673828,634.6549987792969,627.6705784912109,619.0288381347656,0.19999999999999998,0.0,554.5382309317359,0.00616346176036342,0.02153488910340269,645.4199916294643,629.7349984305246,28.099166482239465
2024-05-30,0,650.5999908447266,551.0475158691406,651.7225036621094,605.7812423706055,639.039379119873,-0.7338459549265803,27.78427788057492,-0.19503375824519775,2.9946968428491667,614.7024917602539,20.758858566284175,0.045234681292985426,571.4765045166016,644.264500427246,0.7881466616408332,0.18269747144069592,1.0592207348910763,1.0248759879440836,1.0089034860018091,0.010648619840984086,88.8287196297481,669.7936831720385,614.2251274108887,558.6565716497389,645.4299992152622,4.829782499498395,631.576785496303,15.359324901166492,640.7507928300768,626.6410293974043,5.175907380220659,7.237502499454916,2393400,5.670027678051399,0.7788784462784099,116073500.0,-28.02842738837806,77.78309058422582,77.02796724212243,100.55721848523449,32.925079229631315,10.532664353922723,0.24659434735224423,15.142974528855628,650.2811594238282,641.6394190673828,634.6549987792969,627.6705784912109,619.0288381347656,0.19999999999999998,0.0,554.9784294547462,0.01122613513559867,-0.004534225224713061,646.3971296037946,632.2757088797433,24.455361801007644
2024-05-31,0,640.6275024414062,560.5550231933594,651.7225036621094,610.9268760681152,643.2743682861328,-0.6585467651802376,24.7744901793379,-0.15954551542944406,2.9949242004018997,615.5249938964844,19.611273956298827,0.04001030378650487,587.4545013427735,647.5467529296875,0.7767713447530921,0.16063537730587213,1.0346005427812024,1.0037466543203888,0.9913312547791039,0.004622215641325811,86.55183986831129,668.7517315183437,619.202751159668,569.6537708009922,645.0742863246372,5.111936376407404,633.4267861502511,14.720255520924198,643.2509809264436,630.2551635375238,3.0608534112319083,6.308924166245028,4071000,5.750997173656813,1.3035459266991565,112002500.0,-39.4113751622343,77.78309058422582,77.02796724212243,57.9827247292963,29.84968015791037,17.11619398262114,0.21703877397018023,15.509944486261508,650.6988840332032,642.3155665283203,635.5400085449219,628.7644505615234,620.3811330566406,0.02,1.0,555.6387700650603,0.009360222075913471,0.0017955945893918688,645.1128452845982,634.4721374511719,20.988822052948716
2024-06-03,0,638.2649993896484,572.6900024414062,651.7225036621094,613.0662651062012,643.2743682861328,-0.5144226441267589,21.183001614679124,-0.397763642897226,2.995150935950112,617.9862442016602,18.105763244628907,0.03399034807776142,598.8307556152344,647.5467529296875,0.7847909884753945,0.11862875152417368,1.0241631422089168,0.9958008057434989,0.986775278940069,-0.008809085680445028,71.05264808252804,665.5723783514286,623.2063751220703,580.840371892712,644.2914297921317,5.731501898775796,635.1610717773438,13.644479929989673,642.6566531612149,632.125083960326,-0.3871750127671141,4.213250495243092,2323500,6.342915036085986,0.7558998249734857,109679000.0,-54.53900678217269,77.78309058422582,77.02796724212243,37.52069636685697,27.215947434335998,16.071776267590348,0.1607334258719036,15.795690530139943,651.0694057617187,642.9153093261718,636.3250122070312,629.7347150878907,621.5806186523438,0.04,0.0,555.9952770865742,-0.02003868878648052,-0.002957517160407139,644.1585606166294,635.70070539202,18.105978631087552
2024-06-04,1,631.7675018310547,589.0950012207031,651.7225036621094,613.8450050354004,643.2743682861328,-0.2552727526279835,17.936339360265542,-1.0736891556336932,2.99532132386156,625.463752746582,16.33287582397461,0.02863011210543788,606.9549896240235,647.5467529296875,0.8227776373202463,0.0834670096793503,1.0084317674132002,0.982809288245254,0.9784461323008613,-0.02385634026101513,65.63771092197999,662.3578036900135,626.4851249694824,590.6124462489513,643.4467860630581,7.132608165860344,636.3817868913923,12.376500661073461,641.6226679843571,633.5582108395906,-0.8512680904868989,3.95449379954894,3008200,5.696493709921145,0.9895671425023397,106670800.0,-59.15522256929806,77.78309058422582,77.02796724212243,10.817288508028255,26.09865926224406,15.799637501904218,0.11335774912433266,15.295238429364185,651.2322463378906,643.178890258789,636.6700134277344,630.1611365966797,622.1077805175781,0.06,0.0,556.4244505061288,-0.026779668540543144,-0.023393900089389255,643.5799909319196,636.9835641043527,16.618516470267053
2024-06-05,1,640.947509765625,599.9125061035156,651.7225036621094,614.5043678283691,643.2743682861328,-0.11562137162550333,15.768767277238007,-1.4029587811456643,2.9954172931156187,631.5225067138672,14.514125976562502,0.025084786728423243,611.5647537231446,647.5467529296875,0.8488904707296028,0.053099402668632556,1.0196124594845843,0.9970141723687539,0.997433864222566,-0.016533100876428786,55.793033110746144,660.156284554476,628.61875,597.081215445524,643.0196446010044,7.187640184475837,638.1407165527344,10.977136857408825,639.1985659221245,633.5355080225087,-0.9271901314055753,2.780321691975951,2682600,5.692049859611205,0.8961895407805328,109353400.0,-25.3444294327689,77.78309058422582,77.02796724212243,61.22779942424827,30.6146186764213,14.161414199515173,0.0961532686671947,15.84562354148778,651.2322463378906,643.178890258789,636.6700134277344,630.1611365966797,622.1077805175781,0.06,0.0,556.8647087014996,-0.006645039287501153,0.0019568867969953774,644.0828508649554,639.6085641043527,16.29367818469288
2024-06-06,0,648.9100036621094,607.7374877929688,651.7225036621094,614.7149925231934,643.2743682861328,-0.15786504391528094,14.520393815786164,-1.5475219888228948,2.9954668719936355,634.7237548828125,13.284901733398442,0.023023740307451183,613.2815170288086,647.5467529296875,0.8430602269729769,0.054645340528951446,1.0289208128074936,1.0097409198185123,1.013222913874754,-0.0025975825490297533,61.52171733264358,659.7112878146779,630.6705001831054,601.629712551533,643.2628587995257,7.379217638581841,640.6753583635602,8.689684487227817,639.6692549944291,634.5479587913871,-0.46432926089488497,3.9954756605944284,2466700,5.7765002824057925,0.8327875272621692,111820100.0,-31.7520941573042,77.78309058422582,77.02796724212243,89.10247418284668,31.766269881761676,13.275223164318717,0.0843193777085567,15.695924780423997,652.5585651855469,645.3257283935546,639.4800109863281,633.6342935791016,626.4014567871094,0.02,1.0,557.2980652648114,0.0013279288861145488,-0.009318345958628267,644.0142822265625,642.3228498186384,15.843805587708228
2024-06-07,1,645.3724975585938,611.9900054931641,651.7225036621094,615.9237442016602,643.7931213378906,-0.29013377013246133,14.03359248025095,-1.5084792326732077,2.9954857513853153,637.9725036621094,12.67396240234375,0.022179463381887657,613.9290023803711,649.0790023803711,0.818564579111166,0.06032777960024661,1.019982281616193,1.0034298974994162,1.0082314721173842,0.007406792713557486,66.03727168696142,660.7963109370645,632.7291259765625,604.6619410160605,642.355715070452,6.504379729865159,642.5126800537109,6.290252936575004,641.9819579345934,636.3226664618155,0.26305309787194936,5.784730699327004,1876600,5.918814051132696,0.6355883408861522,109943500.0,-50.92787669064591,77.78309058422582,77.02796724212243,52.99922175450912,30.259458033782867,14.513008970708897,0.05099650838821737,15.300476144951697,653.693724609375,647.1631474609375,641.885009765625,636.6068720703125,630.076294921875,0.02,0.0,557.6032087780798,-0.00023382128861970664,-0.009557488030875878,642.1357073102679,643.777849469866,15.099926146738314
2024-06-10,1,641.4725036621094,613.4250183105469,651.7225036621094,618.8181190490723,644.2962493896484,-0.47942880745948957,13.44034699281718,-1.3261083187551042,2.995507062494843,639.4462509155273,11.935350036621093,0.021185977389648898,614.6082412719727,649.0790023803711,0.8270415100019545,0.04985136439667394,1.011151123250749,0.996174699610128,1.0006551744499923,0.005025348837125909,61.58990706807554,661.2789445654685,634.398250579834,607.5175565941995,641.0517883300781,5.3967913115323425,643.2408937726702,5.419363357870881,642.7981865347665,637.4673217507719,-0.9743420041250924,4.151134336395466,2066800,6.03912312843089,0.7070333880678709,107876700.0,-52.234861875866656,77.78309058422582,77.02796724212243,35.16011844216578,28.921658513679567,16.10594466782129,0.10214399902098024,14.864695833985513,655.3268405761719,649.8065809326172,645.3450012207031,640.8834215087891,635.3631618652344,0.02,0.0,557.927503303864,0.016898376976535623,0.0044886457790120566,641.6842825753348,644.0407060895648,14.116900108641103
2024-06-11,1,644.9949951171875,613.4250183105469,651.7225036621094,628.3706321716309,644.2962493896484,-0.6876784912001805,12.728315149520824,-0.9767339521984728,2.995530897977341,640.7875061035156,10.90434967041017,0.0200214006100409,614.6082412719727,649.0790023803711,0.805099622873076,0.044769013940785155,1.0145650101379475,1.0020285306997692,1.0051441836830861,0.02093728032511244,57.589111767521956,661.1921313976743,635.7355010986328,610.2788707995912,641.6757158551898,5.588619404883191,643.3750010899136,5.439268520821725,642.4122959687888,638.2739200629849,-1.4029338012695378,1.6149778628488862,2167400,6.144182188893971,0.7404193682829677,110044100.0,-41.523441472592296,77.78309058422582,77.02796724212243,59.76970655439681,30.204717054844217,15.338347555177583,0.10103060190827855,14.493622354631063,655.3268405761719,649.8065809326172,645.3450012207031,640.8834215087891,635.3631618652344,0.02,0.0,558.2842269587982,0.026804079678700132,0.02328848716031323,642.6742815290179,643.8935634068081,13.524420704144202
2024-06-12,1,650.2900085449219,613.4250183105469,651.7225036621094,631.6450042724609,645.0893707275391,-0.9152147364106369,11.842240288335763,-0.47391187886010133,2.995558618314139,641.2100067138672,9.6595994567871,0.01858230099676506,616.1579940795898,649.0790023803711,0.7612040822701696,0.049322620991460925,1.0204052932343308,1.010601937847807,1.0092350485633113,0.014576074697151276,60.10577581693485,660.9704814006461,637.2860008239746,613.6015202473031,643.393574305943,6.182121928783916,643.8425020490374,5.746128991353119,643.028511760417,639.6316109170231,0.6817522911734053,0.29193770388590046,2094400,6.158379039221273,0.7241145638855467,112138500.0,-37.52976291367423,77.78309058422582,77.02796724212243,78.16243104885764,31.08153911465791,14.371858041077076,0.11521241708807349,14.363359401335396,655.3268405761719,649.8065809326172,645.3450012207031,640.8834215087891,635.3631618652344,0.02,0.0,558.6387472657774,-0.00032297655796531544,0.0291947730976835,644.9985700334821,644.5785653250558,12.449465356313604
2024-06-13,1,648.7149963378906,613.4250183105469,651.7225036621094,636.2018814086914,645.8312492370605,-1.1253332308442998,10.952899145064563,0.21613761781780028,2.995584434785799,642.2949981689453,8.507885971069323,0.01713890021287125,619.3172439575195,650.3210067749023,0.7004246262791564,0.055113214819890344,1.0150975957665234,1.0083787310303436,1.0038795474866857,-0.00030051520722174097,63.508446719563366,660.972425029631,639.066626739502,617.160828449373,645.8146449497768,3.684034904553445,644.6307155064175,5.590520269796317,644.8527652438095,641.7617499823345,1.8840151295735397,1.016709019468636,1863600,6.213604014427527,0.6897087723583555,110274900.0,-29.06636060302286,77.78309058422582,77.02796724212243,80.61805782554777,29.072890891141185,13.823816295580677,0.1902665359225294,14.258829994997328,655.3268405761719,649.8065809326172,645.3450012207031,640.8834215087891,635.3631618652344,0.02,0.0,558.9540852928155,0.007308934329893324,0.004598074868237579,648.0900006975446,645.8349958147321,11.088020528761238
2024-06-14,0,663.1625061035156,613.4250183105469,651.7225036621094,638.1187515258789,647.5843772888184,-1.3970820077914163,9.804722764529066,1.3662759962522948,2.9956143205252403,643.4312438964844,7.211122741699205,0.015303469891085652,630.1147598266601,650.3210067749023,0.5849442345684249,0.05752940779060004,1.0350815304811438,1.0311384317326924,1.0262988565730549,0.02756548909694856,62.49216510675724,660.2956973601129,640.6862518310547,621.0768063019966,648.9882158551898,6.930501361549229,646.0039302280971,7.456786135521121,645.8252084120807,643.1762357944932,2.682552435463511,1.7304899426065379,4447100,6.167970589054273,1.6045563034336443,114722000.0,-12.617033697258758,77.78309058422582,77.02796724212243,218.41083047305105,35.63122890532341,12.301368505174645,0.26044495654982147,14.878943921494454,663.9829736328124,656.8085314941407,651.010009765625,645.2114880371093,638.0370458984376,0.04,0.0,559.8247592087898,0.04350949452722608,0.03216552261045093,650.8199986049107,647.4514247349331,10.042570964657719
2024-06-17,0,673.1900024414062,619.6499938964844,663.1625061035156,640.0368766784668,648.7637481689453,-0.48406397882665686,8.834500660049677,1.248769495303442,2.995637715595221,643.8412475585938,6.375311279296875,0.013735805026496307,631.7185028076171,650.7122421264648,0.3877923680978103,0.070221112943802,1.046669978885907,1.0430751342882238,1.0361120907977501,0.04944482982236109,70.16394796840804,660.8421275408025,643.1731262207031,625.5041249006038,652.456787109375,11.472391103098452,647.8598229544504,10.422832833826126,650.1913590275389,646.306664634908,3.4659618766619396,2.985539140602252,3631200,6.722744676252754,1.3137624503883907,118353200.0,-12.226768250882932,77.78309058422582,77.02796724212243,265.90193345034817,36.03825581758543,11.275362803231879,0.2649920270781463,15.073316469960817,669.4302973632813,661.2148745117188,654.5750122070312,647.9351499023437,639.7197270507812,0.06,0.0,560.582604571112,0.04861135312621223,0.05356454386953793,654.7214268275669,649.3678545270648,10.630504808674003
2024-06-18,0,680.75,631.2775115966797,673.1900024414062,640.8675079345703,649.2550048828125,1.13508071101647,9.394989399156223,1.779695200254257,2.9956270351135115,644.4662475585938,6.699650268554683,0.014546702108610721,637.0887573242187,652.86650390625,0.46651451867646687,0.06639313150680436,1.054037108474664,1.049111756986201,1.037617143625157,0.0554345462422019,73.4181093234655,664.6401054462616,645.8501266479492,627.0601478496368,657.5107160295759,15.06219273687451,649.933215550014,13.640772658941598,655.9688901374108,650.4042897431079,3.741658880626471,4.01455452809571,2943800,6.61440182723805,1.0829702034201962,121297000.0,-2.2929969653583675,77.78309058422582,77.02796724212243,258.87876603884683,35.9777993655136,10.603271409842243,0.260788198540405,14.883784690635666,672.7536787109375,663.9031594238281,656.75,649.5968405761719,640.7463212890625,0.08,0.0,561.231794016689,0.057235364761176966,0.06387894943391195,661.0357142857143,651.585710797991,13.453324302584642
2024-06-20,0,681.1074981689453,631.7675018310547,680.75,641.3412551879883,650.367504119873,1.4590473754927717,11.507780436124554,1.6904976388968889,2.9955760634488535,645.1837463378906,8.075000305175786,0.017750052218764856,638.2065002441407,664.1652557373047,0.6376838628471164,0.058515757622519926,1.0505669382724583,1.0417984258518949,1.0269683588529226,0.04739037847587446,75.30160959199365,671.3393119403643,648.3237510681153,625.3081901958662,663.172858101981,15.472463721661171,652.1123232160296,15.989975195916292,662.1826452362777,654.817737382817,5.481718321626233,4.453965633345716,2585100,6.350063483865279,0.9569092840670588,123882100.0,-17.10273513302373,77.78309058422582,77.02796724212243,192.10772512543284,34.54963612389166,9.785925880925685,0.1937078561209253,14.974948920833146,674.9081643066406,665.6459239501953,658.1600036621094,650.6740833740234,641.4118430175781,0.1,0.0,561.7888470791358,0.04456516605710692,0.046997212362350924,665.9685756138393,653.8264290945871,14.943340752520017
2024-06-21,0,683.5950012207031,631.7675018310547,681.1074981689453,641.3412551879883,650.8806190490723,1.2105867027747652,13.461216759594812,0.4599517705538996,2.995519716247909,646.2900009155273,9.925975036621093,0.020702453706163394,638.2065002441407,673.9460021972657,0.7466646854826361,0.05803929092288528,1.0513235258951656,1.039219576290773,1.0212284419241464,0.053767841162476904,75.38377374577871,677.1456848619631,650.2232513427734,623.3008178235838,668.6871446881976,14.777012173710126,655.1814302716937,17.653103977250968,666.933931250338,658.2807597934003,6.178751899818509,4.689134299649834,4557100,6.353377053904193,1.615674929224922,128439200.0,-5.926875190614594,77.78309058422582,77.02796724212243,164.47283090810024,33.05534572109077,9.362679306809783,0.274281806274671,14.533868668554838,674.9081643066406,665.6459239501953,658.1600036621094,650.6740833740234,641.4118430175781,0.1,0.0,562.7813479905947,0.050301541285761475,0.0554717990555071,671.3357195172991,657.0050005231585,16.58434380906763
2024-06-24,0,676.0050048828125,631.7675018310547,683.5950012207031,641.3412551879883,654.5825042724609,0.980135092092145,15.192748055970931,-0.3229853774510967,2.9954629675881916,647.9612503051758,12.072624969482423,0.02329405264681743,638.2065002441407,680.7857498168945,0.7827564460399203,0.07200318767221563,1.0364745150278187,1.0222906156334866,0.9994736587365824,0.019365538101293378,78.37060664495482,682.6012477598911,652.2157516479492,621.8302555360074,672.3607155936105,12.455193895626362,657.8771449497768,17.752435108046534,671.1210427204707,661.4633963308046,5.984543507427137,6.707095561078696,3916300,6.064827040468998,1.3501340205297043,124522900.0,-32.88143844387296,77.78309058422582,77.02796724212243,92.47992967668966,29.661165246326277,14.860458948461135,0.2325586747850051,15.040037564615773,674.9081643066406,665.6459239501953,658.1600036621094,650.6740833740234,641.4118430175781,0.1,0.0,563.5471292978824,-0.0005377892212742319,0.024125171493781378,674.0442940848214,659.5214320591518,16.354322579978675
2024-06-25,0,670.4549865722656,631.7675018310547,683.5950012207031,643.3212509155273,665.6693801879883,0.7434821134955747,15.648629851302399,-0.8461113657545583,2.995447763508478,648.8125,13.301800384521494,0.0239227400823217,640.3912521362305,680.7857498168945,0.8559878522508214,0.04979909522711831,1.024953656203319,1.0092224512642933,0.9875178280605762,-0.004062769588410009,67.88146107285175,685.4292611979662,654.1320014953614,622.8347417927565,675.4664284842355,7.162224118426166,660.6405367170062,16.329577550508642,672.396350402762,663.4609873813613,3.954388964921985,5.9129053808768415,2278800,6.383148371078923,0.7901662650184642,122244100.0,-28.346633707882972,77.78309058422582,77.02796724212243,65.57705282321707,28.031037039168698,15.10715707980714,0.25238826462542,14.777883496500168,675.3353237304688,666.3373430175782,659.0650024414062,651.7926618652343,642.7946811523437,0.1,0.0,563.9735616857238,-0.00506050909079081,0.004526529384828581,676.7800031389509,662.4350019182477,16.649073991814795
2024-06-26,0,675.7700042724609,631.7675018310547,683.5950012207031,644.114372253418,671.1387405395508,0.5317755131856814,15.850781448934704,-1.126186867617475,2.9954410712661663,649.6000061035156,14.005986862182624,0.024182761445971982,640.3912521362305,680.7857498168945,0.8864304907414954,0.03591967359206945,1.0309892202042,1.0128045039192504,0.9961489367671839,-0.007315454612617067,61.21197497949503,687.1594387218441,655.4578758239746,623.7563129261051,677.2674996512277,4.721994225674336,663.1278577532087,15.740655576218623,671.9157057243638,663.9283711257443,3.3512390428926477,6.123690222919479,3545800,6.569205350412521,1.2098547648822064,125789900.0,-22.453504098429768,77.78309058422582,77.02796724212243,87.95720213697962,30.79276296350651,14.153779894175596,0.2249944517474993,14.646602474970342,677.0675700683594,669.1412332763672,662.7350158691406,656.3287984619141,648.4024616699219,0.1,0.0,564.6765603116361,-0.011638223442246853,0.0027521496597201845,677.9671456473214,664.393572126116,17.18531583535314
2024-06-27,0,682.6000061035156,631.7675018310547,683.5950012207031,644.114372253418,673.8350028991699,0.3266236055156325,16.322788612695955,-1.3773682993003886,2.9954243277215435,650.4449996948242,14.89469970703126,0.024848738734302794,640.3912521362305,680.7857498168945,0.8836941456650335,0.03689837388647113,1.0391453086947906,1.018343923403931,1.0076965027906435,0.0021912957038099368,63.923104269833836,689.5315780493665,656.8860008239747,624.2404235985828,678.6117858886719,4.707144922953553,665.5342864990234,15.973371325904306,672.8500737614713,664.7576720919621,1.9011174565676303,5.432971339504769,2404800,6.592689332915727,0.8390173783498069,128194700.0,-10.204421200084992,77.78309058422582,77.02796724212243,102.54474759182548,31.915441637674913,13.388711586942179,0.2345024150113139,14.377552551995294,677.0675700683594,669.1412332763672,662.7350158691406,656.3287984619141,648.4024616699219,0.1,0.0,565.1769447553017,0.007819974565914434,-0.0019396445634718195,679.182861328125,666.952144077846,18.13158876597672
2024-06-28,0,678.4900054931641,631.7675018310547,683.5950012207031,644.114372253418,675.8287544250488,0.17768572575129946,17.198177110699632,-1.5461109952834475,2.9953916183487124,650.4449996948242,16.076612625122074,0.026119982915399995,640.3912521362305,681.2567489624023,0.869231461158867,0.049185391498762325,1.0304666150184882,1.0073567147636313,1.0011878747236362,-0.0074678657954242444,68.14691114260326,692.8262301674441,658.429875946045,624.0335217246458,678.2889295305524,4.6126004458281775,667.8998227800641,15.190948581607948,675.253475782663,666.1569486441713,1.3978228476333339,5.1917834909737035,3412400,6.679652967987066,1.1697678564082876,124782300.0,-27.62940886151231,77.78309058422582,77.02796724212243,72.36169367706435,29.703234386032577,14.980306671920214,0.20762573973115103,14.344868189698332,677.0675700683594,669.1412332763672,662.7350158691406,656.3287984619141,648.4024616699219,0.1,0.0,565.8479987748279,-0.016381959882185382,-0.006111694969307595,677.6414358956473,669.3385750906808,18.214284019231698
2024-07-01,0,671.8250122070312,631.7675018310547,683.5950012207031,644.114372253418,676.6262550354004,0.005138262655183261,17.63200920132573,-1.641374453851099,2.9953751920394223,656.7262573242188,16.68812484741211,0.02672227614578997,640.3912521362305,681.2567489624023,0.8764827846193768,0.05910221292009054,1.0181876207559581,0.9930710972697845,0.9928487561812996,-0.006183375338331798,66.24000054381213,695.0883950811182,659.8243766784668,624.5603582758155,676.9628601074219,4.986401080745884,670.0678591047015,13.15921005264099,676.03687615011,666.9634006338752,-0.3319859723593004,5.131533813394884,2212800,6.256040755505013,0.7835000442595379,122569500.0,-32.96196183075846,77.78309058422582,77.02796724212243,37.854479020136566,28.014652566177094,18.832347945884184,0.22119975352233492,14.123086048519882,678.2310483398437,671.0244904785156,665.2000122070312,659.3755339355469,652.1689760742188,0.02,1.0,566.250112820927,0.006860730152034034,-0.018232976526924162,676.8671439034598,671.4178597586496,17.832560117050306
2024-07-02,0,676.2324981689453,631.7675018310547,683.5950012207031,645.2781219482422,676.6262550354004,-0.18078769220244584,17.240339340265056,-1.562519593002476,2.995391938451846,666.8087463378906,16.172325363159178,0.026067054490312273,640.6792587280273,681.2567489624023,0.8737150147089202,0.05258006133733659,1.0224502563427436,0.9983078093848231,1.0005985180216037,0.008617299762684327,59.68616325897193,695.8649308472782,661.3842521667481,626.903573486218,675.9110739571707,4.041235959910965,672.2991093226841,11.062056077095411,674.9753130241027,667.1333751813678,-1.3628518239585712,4.731692842895386,2411400,6.483326759935014,0.8524929780866811,124980900.0,-21.670484839456964,77.78309058422582,77.02796724212243,58.76027660790368,29.781815469002073,17.706840404443675,0.2613224148798829,13.947860621639347,678.66291796875,671.7235336914063,666.114990234375,660.5064467773437,653.5670625,0.02,0.0,566.7111278661698,0.010663202854921616,0.015784277376322205,675.932861328125,673.6342904227121,16.865625856310487
2024-07-03,0,679.8099975585938,631.7675018310547,683.5950012207031,647.8793716430664,676.796875,-0.3743624125283592,16.67105279150414,-1.4168012664947796,2.995415366455863,671.1399993896484,15.391112136840821,0.025134161683458563,641.4200042724609,681.2567489624023,0.8204522346056958,0.07038189873492624,1.0249175385838152,1.0031386294834685,1.0041751272928439,0.005978355447253447,64.23272923973222,696.6247326887211,663.2826271057129,629.9405215227047,676.4546443394253,4.30337134135851,674.4076799665179,9.201028551587143,675.2792579206339,668.3123684845715,-1.0770270465129952,4.843061308728815,1403500,6.202984292915126,0.5106588900491557,126384400.0,-15.505976382118625,77.78309058422582,77.02796724212243,69.90097517174826,29.546021799101304,16.936239799139994,0.2770340836216873,13.540862437156038,678.66291796875,671.7235336914063,666.114990234375,660.5064467773437,653.5670625,0.02,0.0,566.9860351348212,0.0071124073054855685,0.015020652614447162,677.8600027901786,675.9521484375,15.37041935085173
2024-07-05,0,686.9700012207031,640.947509765625,683.5950012207031,648.8612518310547,678.8200035095215,-0.457265632691326,15.36721641476619,-1.4859917387403383,2.9954648451405887,672.5075073242188,14.161299438476567,0.023084825619165267,644.6427459716797,681.2567489624023,0.8332528284710857,0.06063287118032423,1.0319749690346876,1.0138446753645338,1.0135417709746368,0.006401985171568869,65.0685426685056,696.4191847216223,665.6847518920898,634.9503190625574,678.8139321463449,4.945152403047283,677.1401803152902,6.162742598505688,676.4378552375747,670.3057279232526,0.5628645717557752,4.539511391190726,2659100,6.000701301032703,0.9679186527544968,129043500.0,-15.250768213254368,77.78309058422582,77.02796724212243,102.29899877441844,33.4963270408215,15.188150732068042,0.24820758419432737,14.02081044549474,686.9053959960937,680.3572995605468,675.0650024414062,669.7727053222657,663.2246088867188,0.02,1.0,567.5390890245801,0.009220558948726199,0.0191238205167071,680.4657244001116,678.6228637695312,15.660199802046659
2024-07-08,0,685.7724914550781,641.4725036621094,686.9700012207031,649.9450073242188,680.0449981689453,-0.5923405684689866,14.930261236389065,-1.248983244651857,2.9954813470132406,674.4800033569336,13.29836242675782,0.022351163044649864,645.3347473144531,682.6995056152343,0.8344868569129117,0.05865219729053796,1.026627232127071,1.0112024726134285,1.0104720049784628,0.010733372493262783,68.20028362257914,697.8463989376219,667.9858764648437,638.1253539920656,680.2428588867188,5.347747548928752,678.7551792689732,5.086622492220607,679.0432526658421,672.7268197081503,2.4632548014701676,5.897043400995611,1930800,5.961601571731966,0.7097381305965211,127112700.0,-33.3901653447298,77.78309058422582,77.02796724212243,81.89963527566353,31.89348520437642,14.461378409182473,0.27320558212985757,13.67360615320571,689.1851496582032,684.0474093017579,679.8949890136719,675.7425687255859,670.6048283691406,0.02,0.0,567.9273287870939,0.016091727822708624,0.002045713130852595,681.61572265625,679.7914341517857,15.260500493639567
2024-07-09,0,688.9324951171875,641.4725036621094,686.9700012207031,659.9443817138672,680.8393745422363,-0.7969131269799241,14.735648290874122,-0.8843203160715811,2.995488836784321,675.8875045776367,12.496649780273447,0.021999119584365633,645.3347473144531,683.8127502441406,0.8166213285103372,0.06259949726602107,1.0285199569417347,1.0155359714964678,1.0129542861332759,0.02546419469253758,67.78321322421552,699.3002974362404,669.8290008544922,640.357704272744,681.1475001743862,6.269176273418888,679.879643031529,5.486088498155819,680.6642240677929,674.3857898793444,1.4801614631276718,3.409418527656209,2596100,5.8693239127451795,0.9418393093928163,129708800.0,-33.3901653447298,77.78309058422582,77.02796724212243,95.8710526551022,33.51068830527368,13.651154733453764,0.2574526147079016,13.450491342884549,689.1851496582032,684.0474093017579,679.8949890136719,675.7425687255859,670.6048283691406,0.02,0.0,568.4595038994398,0.018007460023743205,0.016091727822708644,681.8157174246652,680.499289376395,13.865882508063029
2024-07-10,0,680.7624969482422,641.4725036621094,688.9324951171875,668.6318664550781,681.4806251525879,-0.9816344117953705,14.16816128025111,-0.3418314672813172,2.9955084416861366,676.1187515258789,11.313399658203139,0.02108335369246035,648.3429962158203,685.8922424316406,0.7566419021513852,0.07398601059925915,1.0130288764942592,1.0015841837667447,0.9959314955532914,0.006698877666428071,70.94548813925698,700.3433232929241,672.0070007324218,643.6706781719196,681.4721418108259,6.166625644573024,679.8805356706891,5.486242021605519,682.6833170216869,676.5957502270405,0.9277012828962031,2.3384917510196477,2651900,5.696993952633408,0.951979236592992,127056900.0,-56.37955227012954,77.78309058422582,77.02796724212243,35.813606220017235,31.016636880599137,18.754358686407866,0.20279285078418002,13.494028148521707,689.1851496582032,684.0474093017579,679.8949890136719,675.7425687255859,670.6048283691406,0.02,0.0,568.956875658871,-0.002839978556235412,0.00599759378624928,682.2114345005581,679.9264351981027,12.09394798715704
2024-07-11,0,661.2924957275391,644.9949951171875,688.9324951171875,671.4825057983398,681.4806251525879,-1.1765668611976796,12.413407882791974,0.286771815055642,2.995561399285383,677.3612518310547,9.516799545288086,0.0184182979183614,650.1325073242188,685.8922424316406,0.7281984202944423,0.05545392150609817,0.9811876249044269,0.9714653529001126,0.9661669694372015,-0.02723923139929796,60.18469610844404,698.7983161623124,673.9715003967285,649.1446846311446,679.9674965994699,9.36720286435382,678.4651783534458,7.375893964147651,682.1974802616321,677.8482532172809,0.33493366691913945,0.0018357617689588688,5106600,6.165343298325519,1.7413038808168777,121950300.0,-89.39061168094887,77.78309058422582,77.02796724212243,-131.65207804965928,26.45983929918956,28.506970820895607,0.11805799991784643,14.688044193679934,685.6781931152344,678.370894897461,672.4649963378906,666.5590977783203,659.2517995605468,0.02,1.0,569.7156306531168,-0.04360377040601149,-0.039480291378692335,679.2314365931919,678.0492902483259,11.636745087644403
2024-07-12,0,649.9949951171875,648.7149963378906,688.9324951171875,671.4825057983398,681.4806251525879,-1.0938231346668221,10.93090293656036,0.38075326082211935,2.9956002741216152,677.3612518310547,8.457462005615241,0.016199056967680144,660.1922470092774,685.8922424316406,0.5976992098199949,0.016919354500365413,0.963260401791068,0.9569040164400137,0.9548274963745397,-0.053823319850667906,42.79549049757325,696.6481813003668,674.7863754272461,652.9245695541254,676.2192818777902,14.79033340644298,676.0651779174805,10.417609996740069,676.9809449289373,676.2380129747064,-1.567747000798842,-2.9092327561619706,3355200,7.726313570629843,1.1200165572309366,118595100.0,-92.76690980115329,77.78309058422582,77.02796724212243,-195.33994111437306,24.869533691202708,28.629682185288022,0.09186167624111996,14.511035977355055,684.7979177246094,676.9460423583985,670.6000061035156,664.2539698486328,656.4020944824218,0.04,0.0,570.1596579708909,-0.06233265374115937,-0.05114948305545828,674.662859235491,675.2978602818081,11.926914009484952
2024-07-15,0,654.5299987792969,648.7149963378906,688.9324951171875,671.4825057983398,681.4806251525879,-1.1002729697978009,10.96409817488078,0.39517567052269076,2.995599458173513,677.3612518310547,8.476637878417955,0.016248605858089727,660.162745666504,685.8922424316406,0.46790094644563723,0.0019731296278376353,0.9700022567133195,0.9682278283482838,0.9720487587646641,-0.0455581013602494,36.67011179749317,696.6998211056209,674.7716247558594,652.8434284060979,672.6078534807477,16.7270172196557,674.5312489100864,11.902375197664433,670.2782683857162,673.2080886288819,-3.8799529929132177,-4.915191896300547,3208800,8.1617220605841,1.047624333562961,121803900.0,-76.31090042229816,77.78309058422582,77.02796724212243,-145.16887887984322,27.93312280341496,25.772879678215105,0.0656271523824858,14.968108359490321,684.7979177246094,676.9460423583985,670.6000061035156,664.2539698486328,656.4020944824218,0.04,0.0,570.6211843713809,-0.042712950162543284,-0.04951858538779615,670.9400024414062,674.4000026157925,11.636233285979118
2024-07-16,0,657.7324981689453,649.9949951171875,688.9324951171875,671.4825057983398,681.4806251525879,-0.9743290220226644,10.327908308950452,0.1291685660658506,2.995614644885919,677.3612518310547,8.098662719726576,0.015299191146326337,660.6162460327148,685.8922424316406,0.6154415424935683,-0.013017182432312101,0.9743284808131721,0.9764259778488862,0.9859541851209032,-0.04528745148381341,37.55297250958377,695.7181914958305,675.0623748779296,654.4065582600288,668.4310673304966,16.18458495263076,673.6224997384207,12.696715264241506,666.4263029520949,671.1658054598859,-3.718685937259691,-3.176752531179615,2685700,7.517209270849539,0.9027987871698164,124489600.0,-76.5526351927239,77.78309058422582,77.02796724212243,-136.10153758456417,25.98973538667277,23.97978656748957,0.03270059107453914,14.938242274569202,684.7979177246094,676.9460423583985,670.6000061035156,664.2539698486328,656.4020944824218,0.04,0.0,571.0015097760439,-0.0429025335099692,-0.04290253350996923,666.0357142857143,673.2507193429129,12.333418852089533
2024-07-17,0,646.8450012207031,649.9949951171875,688.9324951171875,671.4825057983398,681.4806251525879,-0.943192508215826,10.701769249412934,-0.11790733642852258,2.995605870983119,677.3612518310547,8.451613235473634,0.015859386447157817,657.4122482299805,685.8922424316406,0.7204089379104436,-0.022961577290812992,0.9585858755396127,0.9622762830198655,0.9787890888161007,-0.04982280292992958,38.247304611835446,696.194412980027,674.7908744812012,653.3873359823754,662.8699972970145,15.918540032198694,671.5564280918667,14.539990061833409,664.2938372469995,669.5713293379114,-4.256008704864052,-1.897590242167437,4017300,7.162446681613543,1.341709625221055,120472300.0,-86.22880286135073,77.78309058422582,77.02796724212243,-171.206354178058,23.914690200083406,26.642455815226487,0.04980879306457423,15.0748004154248,683.797265625,675.3263427734375,668.47998046875,661.6336181640625,653.1626953125,0.06,0.0,571.4944029128802,-0.04455102391165755,-0.0558228611527166,660.5671473911831,671.0914350237165,13.74482659373624
2024-07-18,0,648.9624786376953,646.8450012207031,688.9324951171875,668.164363861084,681.4806251525879,-0.880433453636142,12.317189995879103,-0.4780438282957289,2.9955641073534327,677.3612518310547,10.164038314819322,0.0182890458501381,654.0764984130859,685.8922424316406,0.7016242965851235,-0.04980535994020841,0.9636048912775554,0.9696655415545185,0.9921775210911417,-0.018645330424139406,30.840426723810225,698.1080044119243,673.4736244201661,648.8392444284078,657.1599949428013,11.592640589164459,669.1537475585938,15.332350783644612,659.931893362568,666.442624783391,-5.676443823487044,-4.280302894310719,7575800,7.211719827117899,2.348528178587095,128048100.0,-93.36420673668127,77.78309058422582,77.02796724212243,-140.09385082130007,24.99793357724168,24.416026289822394,-0.05574910256978454,15.274459083006331,683.7264685058594,675.2117474365234,668.3299865722656,661.4482257080078,652.9335046386718,0.08,0.0,572.4140889723519,-0.014875560279825728,-0.05107362966104031,654.4671456473214,668.1414315359933,14.970052114015932
2024-07-19,0,650.5175018310547,646.8450012207031,688.9324951171875,660.4024963378906,681.4806251525879,-0.6626410881459142,13.288325116741508,-0.9670690105777147,2.9955358141578454,676.1187515258789,11.343652038574215,0.019777700026952786,649.8917434692382,685.8922424316406,0.7644824703819796,-0.0471952219255654,0.9681987685030525,0.9764898296628327,0.9983187987913819,0.0008038626724702347,32.88845871323584,698.4608985855338,671.8842483520508,645.3075981185679,652.8392813546317,5.207375337331526,667.1557115827288,15.836439530715012,657.1825927898622,664.0624353155179,-5.801731920439213,-4.927853378999123,9815600,7.249839582428457,2.7362159178655756,137863700.0,-93.82765534640154,77.78309058422582,77.02796724212243,-116.60382170475708,28.809494406965207,19.516430188508238,-0.15142606914726334,17.744160693167277,681.3546713867188,671.3726520996094,663.3049926757812,655.2373332519531,645.2553139648437,0.1,0.0,573.5840056137824,-0.0220196869488245,-0.029735692293422062,648.1371459960938,665.1742902483259,17.043588466385515
2024-07-22,0,643.9724884033203,646.8450012207031,688.9324951171875,656.9318733215332,681.2218742370605,-0.44578063473762913,13.885736952129168,-1.2937560450827015,2.9955170516041947,675.8875045776367,12.2608270263672,0.020714012964735407,649.8917434692382,685.8922424316406,0.7902017870489959,-0.04838756768346986,0.9606443302005605,0.9719837019314231,0.9881160052093236,-0.016129910616268783,33.871766393243625,698.1262224394145,670.3547485351562,642.5832746308979,650.364994594029,4.600888802074872,665.1662455967495,16.917343038034314,655.5232075163801,662.7069137322316,-4.442811590352194,-4.122758395206929,5219100,7.224493235607297,1.4415850226080615,132644600.0,-73.11685506001746,77.78309058422582,77.02796724212243,-108.12106981415958,26.12632294468603,17.698768004380888,-0.18323048356518332,18.16886716585526,681.3546713867188,671.3726520996094,663.3049926757812,655.2373332519531,645.2553139648437,0.1,0.0,574.1774046353572,-0.013633958474523755,-0.00015437861288837107,647.3871459960938,663.3092912946429,17.170664925944404
2024-07-23,0,645.2924957275391,643.9724884033203,688.9324951171875,653.5268745422363,680.0481224060059,-0.29913947286693127,14.660313769601,-1.4072543150405687,2.995491159503734,673.7975082397461,13.31415252685547,0.02193430929562542,648.7507308959961,685.8922424316406,0.8036359025390768,-0.04738502858428559,0.9654667294217883,0.9801599984098607,0.9933598243135774,-0.018913467824743124,31.416388495926537,697.6942504334891,668.3736228942871,639.0529953550852,649.6932089669364,4.990713714000117,662.9562454223633,17.37522776418754,652.6148780272034,660.8005594029112,-2.6191144517924205,-4.1458003643257975,2463600,7.183617679663839,0.694410972572796,135108200.0,-80.04970656344462,77.78309058422582,77.02796724212243,-98.17712902518433,25.176581219270147,17.055383992868656,-0.1765512977848331,17.507512545480157,681.3546713867188,671.3726520996094,663.3049926757812,655.2373332519531,645.2553139648437,0.1,0.0,574.4505998307546,-0.020660649389429908,-0.020854600025643225,646.6957223074777,660.6792907714844,17.98581854146824
2024-07-24,0,639.2049865722656,643.9724884033203,688.9324951171875,650.3868751525879,680.0481224060059,-0.13418564109229045,15.371781818912897,-1.5447607479478642,2.9954662736917856,671.1399993896484,14.240202331542969,0.023051748517639237,646.6897506713867,685.8922424316406,0.8431262781080398,-0.03753047012651967,0.9585611333330053,0.9773922339122699,0.9877719261782438,-0.011811198407685852,33.63543427858923,697.5815610743491,666.8379974365234,636.0944337986978,647.5039215087891,5.809485871414321,660.0558874947684,17.730862464438047,650.7740392580247,659.2995565008653,-0.7234670151268818,-4.575349827933944,4888200,7.1528544180223115,1.3289562220908182,130220000.0,-89.95173964044871,77.78309058422582,77.02796724212243,-102.5607018731049,23.166289451117525,19.061311007687824,-0.23850795105085695,17.667691355959462,681.3546713867188,671.3726520996094,663.3049926757812,655.2373332519531,645.2553139648437,0.1,0.0,574.95435819415,-0.017715428519176846,-0.03097576923295106,643.7728620256696,657.3564322335379,19.071103828135175
2024-07-25,0,636.6925048828125,639.2049865722656,688.9324951171875,649.7368659973145,680.0481224060059,-0.060144841538575,16.47347273616182,-1.5778416287629733,2.995425501313676,666.5587539672852,15.44100341796875,0.02476188105474848,645.1604949951172,685.8922424316406,0.8338056675889509,-0.05410867228349605,0.9570358555758501,0.9797764057514513,0.9862180555985195,-0.01890706190077429,28.826322170321944,698.222442908847,665.2754974365234,632.3285519641998,644.4982081821987,5.025327805182432,656.4646377563477,16.93404484457444,647.8753722824903,657.1843311650487,-2.341376596277101,-5.972994091312746,4554500,7.048205595936119,1.2214843938573108,125665500.0,-83.15887805497229,77.78309058422582,77.02796724212243,-110.47838946227252,20.62656943117037,21.22423322811212,-0.25165902850793365,18.42571612320561,677.9074978027344,667.1662767333985,658.4850158691406,649.8037550048828,639.0625339355469,0.12000000000000001,0.0,575.3807598645484,-0.01391818779188625,-0.020649916077370017,640.597150530134,653.3164324079241,19.87247752000117
2024-07-26,0,638.2825012207031,636.6925048828125,688.9324951171875,648.4331092834473,680.0481224060059,0.0547608962972046,17.404031603984595,-1.5525160994069684,2.995388172886787,659.5124969482422,16.150040206909182,0.02623769678916107,643.4957382202149,685.8922424316406,0.8304174015449818,-0.06725388340201875,0.9622519146093688,0.9859555886360573,0.9924533935329691,-0.018808103665024944,25.47170235417278,698.1296856750101,663.321622467041,628.5135592590719,643.2749938964844,5.387908073353205,653.0724955967495,15.288133595691836,645.0722737397336,655.0895226473419,-3.1988678292019674,-7.3187324407980885,3120700,6.739428155514214,0.8289911819904874,128786200.0,-86.85607999528776,77.78309058422582,77.02796724212243,-98.84556722141134,19.243180217562983,19.800759711935086,-0.28904619557474737,18.33959092406917,677.9074978027344,667.1662767333985,658.4850158691406,649.8037550048828,639.0625339355469,0.12000000000000001,0.0,575.6732545512496,-0.0031105435544038773,-0.018148145230342135,638.2985752650669,649.432861328125,20.20922887170822
2024-07-29,0,630.0274963378906,636.6925048828125,688.9324951171875,646.4568748474121,678.8200035095215,0.22310356225729192,17.62825257456295,-1.4756407151149673,2.995377408918577,656.1312484741211,16.013576889038085,0.026664800069601202,639.1127380371094,685.8922424316406,0.8565874846679702,-0.059260274944265244,0.9529904996053055,0.9749680161496022,0.9833593223847636,-0.02165463947070967,28.162906659373984,696.3622523720263,661.1057472229004,625.8492420737745,640.5699964250837,6.6596665342305075,648.8649956839425,12.513810902431198,643.3447119163518,653.1070104201631,-1.3237328855971913,-6.925035755460287,2400500,6.784069639340811,0.6463625446301153,126385700.0,-91.97189698168292,77.78309058422582,77.02796724212243,-119.58238705719528,18.418119521153763,21.29630712217014,-0.2729039960915126,17.792473659081786,671.7572604980469,662.1913465576172,654.4599914550781,646.7286363525391,637.1627224121094,0.12000000000000001,0.0,575.8684604345981,-0.03172197378740349,-0.01007358545533464,636.0014386858259,645.2342921665737,21.044773439815735
2024-07-30,0,626.1100006103516,630.0274963378906,688.9324951171875,644.9624938964844,677.1268730163574,0.31055785426351507,18.38657156654665,-1.284614340249126,2.9953437131252763,652.5237503051758,16.213651428222647,0.0279141592004877,638.123501586914,685.8922424316406,0.8537936054303299,-0.06221488499189756,0.9505488378188921,0.9725935338262599,0.9815174848811807,-0.029726821936089776,24.851888093992237,695.4557648982301,658.6826217651367,621.9094786320433,637.0832105364118,6.965891118025102,644.9612459455218,10.087046409717942,640.0254072746275,650.2360233675743,-2.91773144412803,-8.550184408020575,3496600,6.849159807276078,0.9255038975132674,122889100.0,-90.99561121857629,77.78309058422582,77.02796724212243,-121.89709502487102,17.109571104763052,22.566504583920672,-0.30728647622742195,17.785154247826142,664.3450576171875,655.2974418945313,647.9849853515625,640.6725288085937,631.6249130859375,0.14,0.0,576.1301920184999,-0.0313958435017444,-0.038486460092905406,634.4642944335938,641.3007202148438,21.942560095125682
2024-07-31,0,627.7749938964844,626.1100006103516,688.9324951171875,642.7806129455566,677.1268730163574,0.36681688006498575,19.423028069197354,-1.1481091962068317,2.9952959452516215,650.2562484741211,16.633000488281255,0.029590372717840357,636.0260040283204,685.8922424316406,0.8482504339843064,-0.07412021411912606,0.9563954696536963,0.9799938545208654,0.9900822172402265,-0.017881576201516425,21.61818065277132,695.2429273236972,656.3968711853028,617.5508150469083,634.769282749721,6.986209621858765,642.567138671875,9.88839107102401,636.6306626499667,647.4860392929514,-3.752012997652133,-8.028129719673117,3134900,6.676566484961711,0.821896977760882,126024000.0,-81.68471687632226,77.78309058422582,77.02796724212243,-99.87101699502729,16.3311783577618,21.539850941597376,-0.32234223501901593,17.301923615658936,664.3450576171875,655.2974418945313,647.9849853515625,640.6725288085937,631.6249130859375,0.14,0.0,576.3788150570091,-0.012012790713297195,-0.022418996142809122,631.7285766601562,639.557861328125,21.789439862352715
2024-08-01,0,629.6049957275391,626.1100006103516,688.9324951171875,638.974365234375,665.9218711853027,0.5132446047362484,19.81594517455924,-0.9621605354339655,2.995275442627054,649.4787368774414,16.401050720214833,0.03030081516485461,629.80224609375,685.8922424316406,0.8521004181241091,-0.07654345162469371,0.9627370501055887,0.9857852197457369,0.9965612835781454,-0.011131761566092191,22.80850737227213,693.605886320798,653.9739959716796,614.3421056225612,632.5282113211496,5.379247009241091,641.110710144043,10.20667630373235,634.5057142926058,645.0442804228322,-2.5152463495756416,-5.068483620728145,3720600,6.596031380478196,0.9466982860399789,129744600.0,-87.33261368874321,77.78309058422582,77.02796724212243,-88.63080614156776,19.6212884942552,19.07232585972314,-0.3491096067745926,18.1446498016935,664.3450576171875,655.2974418945313,647.9849853515625,640.6725288085937,631.6249130859375,0.02,1.0,576.6795431028412,-0.0145721441407205,-0.017516021980679575,629.1700003487723,637.932861328125,21.270875663646727
2024-08-02,1,617.0599975585938,626.1100006103516,688.9324951171875,637.8850021362305,658.6224975585938,0.7086995175094063,19.562407504803495,-0.6214665300916256,2.995284461971475,647.9037399291992,15.574625625610338,0.030028390111524472,629.4219955444336,685.8922424316406,0.8262464278379774,-0.08350438212910316,0.9471900799712903,0.9690803911909078,0.9789009454097479,-0.033249389763187476,22.933808874511545,690.5885608897339,651.4637458801269,612.3389308705199,629.3646414620536,7.050376819659421,638.4342814854214,11.274084709514883,633.3235564996617,643.098629323917,-2.431068097624943,-3.1369471369502357,3523000,6.274587978397541,0.8866740912723131,126221600.0,-92.50914835986373,77.78309058422582,77.02796724212243,-145.051139662617,18.308021779094858,21.458788555889598,-0.3727941529973247,18.05717758580775,662.3036518554687,651.9931325683593,643.6599731445312,635.3268137207032,625.0162944335938,0.02,1.0,576.8870140515226,-0.028081759674783324,-0.03225096018059991,625.9771466936384,634.875004359654,20.193517066601277
2024-08-05,1,594.2974853515625,617.0599975585938,688.9324951171875,635.026252746582,655.330623626709,0.7006869805992507,19.14720481864029,-0.16784203442587886,2.9952985212138565,646.0687484741211,14.678324050903324,0.029549603619917486,627.608494567871,681.2634963989258,0.7639447952834909,-0.10019721518821731,0.9171706936229178,0.938262358582796,0.9491818815603552,-0.056711827966260286,18.01905474682563,686.262655334302,647.9682456970215,609.673836059741,623.3082101004464,14.2448365457713,633.9032091413226,15.039874672294426,629.2467871889523,639.4250494728847,-3.4644581126352434,-5.7247186974752795,4044200,6.604159496504093,0.9914818660217286,122177400.0,-87.47959242614267,77.78309058422582,77.02796724212243,-206.3360649964892,16.444588468274535,27.428717137092878,-0.3512027234608465,18.667384192901167,657.2744924316406,643.8527135009765,633.0049743652344,622.1572352294922,608.7354562988281,0.04,0.0,577.0071484662003,-0.045313948551773175,-0.051982209446185486,620.8999982561384,630.7485743931362,20.28065242020965
2024-08-06,1,608.3150024414062,594.2974853515625,688.9324951171875,629.9218711853027,651.5206260681152,0.03763176877547305,20.451546065006283,0.6946671482848386,2.995226954395972,644.6324920654297,15.149549636840822,0.03178694597402595,625.2050003051758,663.2394958496094,0.6372192215440299,-0.1373647061741914,0.9454774742375205,0.9679843556041428,0.9827867249033206,-0.028421520422287072,11.71186548159224,684.2975875218583,643.3944953918457,602.491403261833,619.0271388462612,13.476931482249656,631.1510663713727,15.9850845727732,620.505552388517,632.9979087076891,-6.658633360079068,-9.644500308860955,4319100,7.657015550990627,1.036975147025458,126496500.0,-75.49218852183104,77.78309058422582,77.02796724212243,-130.0220741889583,21.681294990705055,24.969571151079336,-0.3281340340490268,19.041145568210045,657.2744924316406,643.8527135009765,633.0049743652344,622.1572352294922,608.7354562988281,0.04,0.0,577.2249014736186,-0.020896927958655498,-0.027737039107727884,617.7857142857143,628.0421447753906,18.37014172158694
2024-08-07,1,617.5475006103516,594.2974853515625,680.7624969482422,629.1474952697754,650.1256217956543,-0.31362129118937027,18.969998852648487,0.37609758324822984,2.995290529609755,641.588737487793,14.626624298095702,0.029670125475948807,616.185498046875,658.0884979248046,0.6948160344179696,-0.1064211010912137,0.9658783836937126,0.9884919639938915,1.003472488091467,-0.01629165447105918,27.139783348020803,677.3036184633535,639.3636207580566,601.4236230527598,617.2442823137555,12.574428519291041,628.9071393694196,15.489737921543686,617.4048620164228,629.2259657550535,-4.695021204871606,-5.956604550794149,3187800,8.702155504600658,0.7604684283223081,129684300.0,-73.41454977854586,77.78309058422582,77.02796724212243,-88.2173973815047,23.417406168652917,22.894971093998084,-0.3496410668206457,19.28320689347177,657.2744924316406,643.8527135009765,633.0049743652344,622.1572352294922,608.7354562988281,0.04,0.0,577.4176429799933,-0.02684808748732137,-0.01782909235182201,615.5742797851562,625.787859235491,16.433213413486026
2024-08-08,1,625.1624908447266,594.2974853515625,661.2924957275391,627.3587455749512,649.2206077575684,-0.7050533703934646,16.969806259616686,-0.09704087501973646,2.9953741778397043,638.7437438964844,13.888549499511715,0.026673576990485007,616.185498046875,654.8502487182617,0.7917577310508378,-0.06615075083992938,0.9826464472250761,1.0041621629489772,1.0192340524439334,-0.007056019111917888,37.118436695766704,670.1424834603955,636.2028709411621,602.2632584219288,617.1089237758091,12.467733871941476,627.0960671561105,14.196994867279074,617.377325197093,627.300277921929,-1.9808652479583058,-4.840800363880851,3283500,8.336690846181417,0.8007101166010483,132967800.0,-37.458487280009024,77.78309058422582,77.02796724212243,-41.01369579843673,21.72925211655341,21.14005261598185,-0.29105794059679674,19.392263711588026,639.9469780273438,629.8364780273438,621.6649780273438,613.4934780273437,603.3829780273437,0.04,0.0,577.6538722831748,0.00880211285091681,0.003182939568247769,616.6842738560268,625.5742841448102,15.783481871077587
2024-08-09,1,629.1349945068359,594.2974853515625,657.7324981689453,625.8731231689453,647.3743705749512,-0.692287398606794,16.103754760753002,-0.0902164183299643,2.9954080996876193,637.4875030517578,13.366737289428716,0.025384374035840637,616.185498046875,650.9187515258789,0.8380292302626619,-0.03820414689190628,0.9917064844106773,1.0124179618008242,1.0271985933691712,0.01956859461967575,44.43407177548406,666.6038802185274,634.3963706970214,602.1888611755155,617.3032095772879,12.670592093566139,626.0362461635044,13.36996969537792,619.3174970104578,626.9717596433712,-0.15133279530774751,-3.8976677668102235,1980800,8.33232158263913,0.491268013635862,134948600.0,-28.265492640867222,77.78309058422582,77.02796724212243,-11.068669608068046,22.2441830448244,20.055717040790828,-0.26601877431702053,18.980672596574667,636.9903017578125,627.4448210449219,619.72998046875,612.0151398925781,602.4696591796875,0.04,0.0,577.8097281529497,0.03308126476171691,0.01454753494539998,617.4828491210938,624.605712890625,15.368107477484756
2024-08-12,1,632.5525054931641,594.2974853515625,657.7324981689453,625.8731231689453,645.6806221008301,-0.5941094693419701,15.73090328339342,-0.036056859028667176,2.995422209862404,633.3600006103516,12.849874877929688,0.0248374825365485,616.185498046875,650.9187515258789,0.8168361899979579,-0.03879883935010282,0.9987355160477048,1.0194181173617358,1.0287221581253778,0.06437015313798855,46.50930860088368,664.8151772332908,633.3533706665039,601.891564099717,617.7242824009487,13.186036751003622,625.1262468610491,12.35343076505663,621.7860387697466,627.3753912017179,0.21663822604820365,-2.304057108599901,2331700,8.312487767131964,0.5846555805183342,137280300.0,-29.489089663233088,77.78309058422582,77.02796724212243,6.339338843432942,22.138366351345315,19.130765785119685,-0.2659860705572522,18.477051240305013,636.9903017578125,627.4448210449219,619.72998046875,612.0151398925781,602.4696591796875,0.02,1.0,577.998479255743,0.05778970438711806,0.0317775887075614,618.6671404157366,623.9185703822544,14.21105558119094
2024-08-13,1,643.2624969482422,594.2974853515625,657.7324981689453,625.8731231689453,644.302490234375,-0.6115261126767886,14.962064794791512,0.20905835573791887,2.995450829866971,631.2900009155273,11.751000213623048,0.02366462380164635,616.185498046875,649.1179809570312,0.7769359602867969,-0.03828302956882862,1.0174107120086129,1.0362565973806757,1.033282865361921,0.05744966730489631,48.41798608063805,662.1786255917802,632.2544960021972,602.3303664126142,621.4674965994699,16.314139835086923,625.4160690307617,12.750357372306366,624.4879368375739,628.2904031981057,0.4681522201422512,-1.9742969767548928,2639600,8.318803401373156,0.6622418527517935,139919900.0,-4.614346175253884,77.78309058422582,77.02796724212243,85.40288560650738,25.24757050243551,17.808828694419297,-0.24526241697739026,18.4308300395517,635.8824924316406,626.5487135009765,619.0049743652344,611.4612352294922,602.1274562988281,0.04,0.0,578.2559021322763,0.0630772704448046,0.08264979157495587,623.5785696847098,624.7778581891741,13.51421115610654
2024-08-14,1,655.6625061035156,594.2974853515625,650.5175018310547,625.8731231689453,643.4399948120117,-0.8613714638001045,14.03361340162209,0.42849863222382645,2.9954837274781463,631.2900009155273,11.02750015258789,0.02222157501661179,616.185498046875,647.0567489624024,0.7821023500624601,-0.0055384277001447975,1.0382111255305697,1.0533217557612422,1.0415078320389148,0.06171995750204351,57.31406427407174,659.5982227444063,631.5309959411621,603.463769137918,630.2339281354632,15.75882748385869,626.7710691179548,14.872316997445074,629.1743817599768,630.8603732030483,4.246345492062195,0.6347745185366821,4014300,8.409606828665702,1.007174389474384,143934200.0,-2.46963795232034,77.78309058422582,77.02796724212243,156.3158662746919,28.647153682831753,16.723479381917837,-0.23066372628587634,18.22505511355326,645.5089204101563,634.3355361328125,625.3049926757812,616.27444921875,605.1010649414062,0.06,0.0,578.7202128519832,0.08209592106114205,0.085486465418969,632.5971418108259,626.7485700334821,14.802200623575132
2024-08-15,0,666.1749877929688,594.2974853515625,655.6625061035156,625.8731231689453,643.4399948120117,-0.6832183949738128,14.633471405513768,0.28664098822201955,2.9954626962505895,631.2900009155273,11.468375396728515,0.02315525749281812,616.185498046875,649.1179809570312,0.7263935086902179,0.010324213935888924,1.0541212642004398,1.0654367629372303,1.04554620001298,0.06560293931394634,63.424423536334146,661.2388139963302,631.9718711853027,602.7049283742751,638.4996403285435,17.431343136751234,628.7633895874023,18.05973109368692,635.8042696689608,634.4468392694005,10.325640317265021,2.9794604263787714,3210200,8.859421420296172,0.8520939368401494,147144400.0,-11.572871634211419,77.78309058422582,77.02796724212243,179.88188077202773,30.957895313966972,15.828896659919273,-0.20787390762406724,17.87969433255949,652.8585966796875,640.2806931152344,630.114990234375,619.9492873535156,607.3713837890625,0.08,0.0,579.1220404492404,0.05214562765173958,0.08461436496205815,640.2614222935268,629.0235682896206,16.308796347246545
2024-08-16,0,672.2724914550781,594.2974853515625,666.1749877929688,625.8731231689453,643.4399948120117,-0.25439235848909403,16.045448931122284,0.2804974822207362,2.9954100309535034,631.2900009155273,12.356999969482422,0.025354969942658182,616.185498046875,651.0320022583007,0.7061410018634875,0.024069277026124433,1.0623229606905868,1.0689367514520078,1.0417055560096504,0.0685663606775786,67.67383869124437,664.923394505311,632.8324966430664,600.7415987808218,646.3174961635044,18.694435744171447,631.78088923863,21.49055294186916,643.4113669351361,638.4949952756001,9.511517079037624,4.369928130400218,3511000,9.14460278626579,1.0170340899051182,150655400.0,-6.610122312642249,77.78309058422582,77.02796724212243,193.08606782083356,31.669087449237054,14.749503961564432,-0.10004011178813298,17.817573881454717,658.2371398925782,644.6313995361328,633.6349792480469,622.638558959961,609.0328186035156,0.1,0.0,579.5967062063856,0.06330252820182558,0.06935834604838621,649.2028547014509,632.3885672433036,18.881643034184318
