date,buy?,todays_price,Minimum,Maximum,25th Percentile,75th Percentile,Skewness,Standard Deviation,Kurtosis,Shannon Entropy,Median,Mean Absolute Deviation (MAD),Coefficient of Variation (CV),10th Percentile,90th Percentile,Autocorrelation,Cumulative Return,curr_to_avg_one_month,curr_to_avg_one_two_week,curr_to_avg_one_one_week,momentum,rsi,upper_band_current,middle_band_current,lower_band_current,rolling_mean_7,rolling_std_7,rolling_mean_14,rolling_std_14,ema_7,ema_14,roc_7,roc_14,Volume,Volatility,Relative Volume (RVOL),On-Balance Volume (OBV),Williams %R,Stochastic Oscillator %K,Stochastic Oscillator %D,Commodity Channel Index (CCI),ADX1,ADX2,Chaikin Money Flow (CMF),Average True Range (ATR),Fib_23.6,Fib_38.2,Fib_50,Fib_61.8,Fib_76.4,Parabolic SAR 2,Parabolic SAR 3,VWAP,Adj Close Momentum,Adj Close Return,Adj Close 7d MA,Adj Close 14d MA,Adj Close Volatility
2024-01-02,0,186.27999877929688,189.22749710083008,197.97750091552734,193.05499649047852,195.82749938964844,-0.26504604759823414,2.1686447226940624,-0.2281920358193097,2.9956698433670743,194.00500106811523,1.7281754684448232,0.011168261918847172,191.90624809265137,196.5990005493164,0.7220544099013257,0.013379481716363578,0.9593197976777182,0.9560272581076316,0.9629660226157571,-0.041227042557445026,48.335850761653845,198.51653939961173,194.17924995422362,189.8419605088355,192.6914280482701,2.96517825038838,194.48357146126884,2.911916284882165,193.92245405739465,193.9322882234155,-1.7024225895155496,-0.8992168706534951,82488700,1.4138850285868299,1.5003616821704058,-107365300.0,-88.8747585802823,78.30330443471131,85.07633588200967,-268.7185036019939,15.844566804603007,44.638460495975075,0.13600164641515544,3.1255832540211004,195.9077161254883,193.6111367492676,191.75499725341797,189.89885775756835,187.60227838134765,0.06,0.0,193.96346246431474,-0.041115741808062656,-0.046435116168630414,191.59154401506697,193.71064976283483,2.8990424102236396
2024-01-03,0,184.44499969482422,186.27999877929688,197.97750091552734,193.05499649047852,195.82749938964844,-1.0717746028832893,2.6706464391559503,1.4839176371124951,2.99563700378662,194.00500106811523,1.9380006790161133,0.013768791543428416,191.76999778747557,196.5990005493164,0.421649983510799,-0.015576479986746458,0.9509251074164577,0.9521535681191956,0.9614422316510032,-0.04603171258469496,30.313712242225876,199.30504276387097,193.96374988555908,188.6224570072472,191.1349994114467,4.016321866781788,193.83267838614327,3.963432744520588,192.01528715262708,193.00032532683724,-4.9882683367748495,-3.381742989400583,58414500,2.0909639414282073,1.0481610953866163,-165779800.0,-94.93510067594823,78.30330443471131,85.07633588200967,-278.10205276577824,14.697863805237967,42.766720102326666,0.09647966175678183,3.064429517751296,195.79915454101564,193.4354141845703,191.52499389648438,189.61457360839844,187.2508332519531,0.08,0.0,193.50517113917667,-0.04558415182350717,-0.04829551972554009,190.107177734375,192.96632930210657,3.496343641753517
2024-01-04,0,182.00749969482422,184.44499969482422,197.97750091552734,193.05499649047852,195.82749938964844,-1.4933128685066992,3.237884716449663,2.1070836882391486,2.9955914010133644,194.00500106811523,2.193413124084472,0.016713852026786113,191.47524795532226,196.5990005493164,0.5998106326228461,-0.039611555452622196,0.9395165931047141,0.9450860161219693,0.957621728136189,-0.05478882565250032,24.348658428524384,200.20039444815814,193.7246250152588,187.24885558235945,189.38035637991769,4.97645890560543,192.79928534371513,4.97777172512908,190.12587797796226,192.03591160261675,-5.577454924364263,-4.707904846080025,71983600,1.9982665451790909,1.2854622879084372,-237763400.0,-94.50373897523433,78.30330443471131,85.07633588200967,-262.0171371121999,13.274741107881923,45.95233329672779,0.05979554519014932,3.0915715660520804,195.197357421875,192.46131884765626,190.25,188.03868115234374,185.302642578125,0.1,0.0,192.85369518030697,-0.05819311734591648,-0.05770532259147102,188.44349016462053,191.82423400878906,4.383912973652445
2024-01-05,0,181.52499771118164,182.00749969482422,197.97750091552734,193.05499649047852,195.82749938964844,-1.5068726561243944,4.117814140376432,1.404145171925192,2.995502679602177,194.00500106811523,2.810425872802739,0.021311269660670217,186.09649887084962,196.5990005493164,0.6921197501212561,-0.058955070376835325,0.9394615794927287,0.9497201502538707,0.9658050926419874,-0.0637612172167461,19.72289136919337,201.4580033875644,193.2223751068115,184.98674682605863,187.69178444998605,5.394753383274771,191.6241065434047,5.568301492532282,188.09218316727197,190.83479957718112,-6.321736148451234,-7.363533490498147,62303300,2.0022344113594723,1.0919120417673667,-300066700.0,-94.45971067722088,78.30330443471131,85.07633588200967,-204.74533727808287,12.289847786848075,44.57687546884814,0.07696809457977127,3.0477806759456847,194.09771490478516,191.43613552856448,189.28499603271484,187.13385653686524,184.47227716064452,0.12000000000000001,0.0,192.31894840919023,-0.06405617755271586,-0.06197252971469784,186.75418526785714,190.61951991489954,5.137508277659501
2024-01-08,1,183.6875,181.52499771118164,197.97750091552734,192.7393741607666,195.82749938964844,-1.2619552282415105,4.841790149300563,0.2973083072659506,2.995412925656651,194.00500106811523,3.6325630187988223,0.025135426871338556,184.2012496948242,196.5990005493164,0.7779174357915235,-0.06489460816232118,0.9535860871822326,0.9683983864309204,0.9903385640594952,-0.04894116077207311,18.36128869248882,202.3117052986011,192.628125,182.9445447013989,186.42464174543107,5.094764412270397,190.628570829119,5.658088028396816,186.44760381697347,189.71428749489039,-6.113425966482041,-8.31028936533835,59144500,1.9786436277254513,1.0260617907978593,-240922200.0,-69.21758377740113,78.30330443471131,85.07633588200967,-123.76961153560602,18.52514881106805,39.22793568263186,0.12795105063195045,3.1657132705793485,193.54763397216797,190.99117477416993,188.92499542236328,186.85881607055663,184.3023568725586,0.12000000000000001,0.0,191.97609180684435,-0.03620214150465395,-0.04142991652490406,185.6739981515067,189.76490565708704,5.354686761914961
2024-01-09,1,184.2349967956543,181.52499771118164,197.97750091552734,190.9881238937378,195.82749938964844,-0.9709879239540724,5.201517994584968,-0.5384628994857499,2.995362386645072,193.72250175476074,4.258687877655035,0.027076238341617483,183.5194999694824,196.5990005493164,0.8471107871869721,-0.057493242304251915,0.9590259399851014,0.9772884466441546,1.0035187163856671,-0.010978108208307913,27.312076784082528,202.5094109205054,192.10637493133544,181.7033389421655,185.04571260724748,3.905763002990522,189.80607060023718,5.69317500426899,185.76072570267237,188.9716151267055,-4.606415736123804,-7.052498418722328,42841800,2.054693886065429,0.7500910655283993,-198080400.0,-71.61620342734645,78.30330443471131,85.07633588200967,-102.48686520660442,17.109537072800624,36.23030652528035,0.1308773483285471,3.137274267974421,193.54763397216797,190.99117477416993,188.92499542236328,186.85881607055663,184.3023568725586,0.12000000000000001,0.0,191.7489007222702,-0.002693374672888549,-0.03838361450529584,184.47284153529577,188.9999509538923,5.508407509751738
2024-01-10,1,185.2150001525879,181.52499771118164,197.97750091552734,185.8212490081787,195.82749938964844,-0.7173647563879285,5.429699618461345,-1.0490079999928217,2.9953277914528638,193.45125198364258,4.7261005401611325,0.028342644611824223,183.5194999694824,196.5990005493164,0.8828926267212505,-0.04442428669761043,0.9668090861334524,0.9877553915380775,1.0111092989783392,0.0041746887095757135,30.52159010586329,202.4328989164881,191.57349967956543,180.71410044264275,183.91357040405273,1.686659793158493,189.00107056753976,5.468487431275997,185.37933801897535,188.39631928693046,-4.978404450675234,-5.882504829806234,46792900,2.0375649477654028,0.8295447847088863,-151287500.0,-65.61961073082739,78.30330443471131,85.07633588200967,-75.17976417718259,19.349045177463225,33.79327246361293,0.12913227676574943,3.082324424575876,193.54763397216797,190.99117477416993,188.92499542236328,186.85881607055663,184.3023568725586,0.12000000000000001,0.0,191.55233138935398,0.010529321593168772,0.0029628441521700475,183.57055446079798,188.23499734061105,5.627312491636131
2024-01-11,1,185.6999969482422,181.52499771118164,197.97750091552734,185.02250003814697,195.82749938964844,-0.5265276394848086,5.593220733391678,-1.3543669852702016,2.9953020723740598,193.45125198364258,5.0964755249023455,0.02925412632140644,183.5194999694824,196.5990005493164,0.9005359955518182,-0.04310090012329144,0.9712635040803146,0.9946544587090678,1.0129053972092723,0.020287610453466165,33.897965505096806,202.38069119212514,191.1942497253418,180.00780825855844,183.83071299961634,1.5605664913463988,188.26107052394323,5.130293499551157,185.34783283434354,188.26461359358908,-4.10323889610314,-5.735807019749642,49128400,2.0451011822917904,0.8737121973341395,-102159100.0,-67.94797755668112,78.30330443471131,85.07633588200967,-67.51521309530335,19.31276628252578,30.71588938655674,0.08949093055789605,3.111041892138055,193.08924096679686,190.6203804321289,188.625,186.6296195678711,184.16075903320314,0.12000000000000001,0.0,191.35617466450506,0.020229803413202685,0.007272789242320301,183.56343950544084,187.5774917602539,5.706791503683608
2024-01-12,0,185.97750091552734,181.52499771118164,197.97750091552734,185.02250003814697,195.82749938964844,-0.3416047928766782,5.6885727222062,-1.5429513750540524,2.995286227064647,193.24249839782715,5.331600570678711,0.029814107676312637,183.5194999694824,196.5990005493164,0.8971975762218183,-0.05484160944167802,0.9747178261468443,0.9998131967320312,1.0103491972530656,0.024528319848431845,32.88728407883556,202.17851987983715,190.8013744354248,179.42422899101246,184.04964174543107,1.7563242053250112,187.5923205784389,4.731247377437251,185.44748097702404,188.2140299826589,-0.31136022914723616,-5.284097082198224,40444700,1.9021069967103157,0.7389653403591441,-61714400.0,-62.27035480676706,78.30330443471131,85.07633588200967,-54.02840357741809,18.493197457891963,29.412410382365614,0.027110017681871393,2.983529487603565,191.81336236572264,189.58832156372068,187.79000091552734,185.99168026733398,183.76663946533202,0.12000000000000001,0.0,191.21746461923718,0.026161800318980744,0.0220438769188383,183.80111040387834,186.95414406912667,5.553365724618737
2024-01-16,1,182.74499893188477,181.52499771118164,197.97750091552734,185.02250003814697,195.44250011444092,-0.15545229418450066,5.624797855388324,-1.6107947109834102,2.995294583624122,192.84874725341797,5.341600360870362,0.029561180041190783,183.5194999694824,196.5990005493164,0.8811101959334879,-0.060612948160812155,0.9604181259380938,0.9866308551897585,0.9880084122610467,-0.005131002752583824,32.44935572792539,201.5260950775369,190.27649936676025,179.0269036559836,184.15499877929688,1.6310577482750994,186.7676775796073,4.473152587249454,185.58587648161205,188.1460499112768,0.8308716545521668,-4.792924761824063,65603000,1.8509362316604372,1.1999796232291164,-127317400.0,-76.12142579587345,78.30330443471131,85.07633588200967,-82.92829299196686,16.121308335491406,36.58949257311275,0.05666464782732392,3.14576329644277,191.24036236572263,189.12482156372067,187.41500091552734,185.705180267334,183.58963946533203,0.12000000000000001,0.0,190.88673801941437,-0.010400921576823485,0.013522444894828152,184.04589625767298,186.24469321114677,5.420132447540013
2024-01-17,1,181.7949981689453,181.52499771118164,197.625,184.39249897003174,194.55250072479248,-0.004356010648669419,5.561401066242007,-1.677284148434652,2.9953015953981352,189.41874885559082,5.333125305175781,0.029345459493537184,182.6712490081787,196.10249786376954,0.8427032067332002,-0.07529412305181649,0.9592650649271305,0.9870413284329044,0.9838749362059699,-0.013243947508058573,26.051980924470623,200.63767640006213,189.51487426757814,178.39207213509414,184.1935702732631,1.560148455051332,185.9426773616246,4.224979035912655,184.87699979774914,187.56492592702432,0.4052026637897489,-5.942149327932769,47317400,1.9377646120198193,0.9346992175315908,-174634800.0,-82.67775324156999,78.30330443471131,85.07633588200967,-87.14826069963581,14.760744934575815,35.0981512142456,0.12256867445984643,3.160520808691509,191.24036236572263,189.12482156372067,187.41500091552734,185.705180267334,183.58963946533203,0.12000000000000001,0.0,190.63697028841662,-0.013287233793481956,-0.015520572703602223,184.2593710763114,185.50677817208427,5.28120550228678
2024-01-18,0,187.42250061035156,181.52499771118164,196.48500061035156,184.09812259674072,193.98812580108643,0.12961427710681764,5.476662012923316,-1.6873733952830232,2.9953116578515675,186.1287498474121,5.234462814331056,0.029019521491890788,181.98624954223632,195.78099975585937,0.8518363166318855,-0.07128991995430237,0.9931069822625125,1.020079390807294,1.0170169904118436,0.011918583570148522,25.21591570825401,199.67669820187206,188.7233741760254,177.77005015017875,184.72714178902763,1.9485624305299616,185.57589176722936,3.808961004407197,184.10711241591443,186.82216241091382,0.14874009704892577,-5.973778985148675,78005800,1.9212713277756668,1.5077714523736696,-96629000.0,-41.61488263162927,78.30330443471131,85.07633588200967,-6.094159289885682,26.957048053699562,29.837349615984866,0.1538088537387167,3.422537662026891,191.24036236572263,189.12482156372067,187.41500091552734,185.705180267334,183.58963946533203,0.02,1.0,190.5146896837448,0.013104781572851776,0.01885059955075782,184.696284702846,185.18514142717635,5.012682236126106
2024-01-19,0,190.41500091552734,181.52499771118164,196.48500061035156,184.09812259674072,193.4806261062622,0.26566043727522176,5.2379765908957525,-1.546473879758052,2.9953462853107813,186.1287498474121,4.864900207519531,0.02781615454001538,181.98624954223632,195.41199989318847,0.8367364337627838,-0.046123113580419296,1.0111944947233333,1.0346898183324702,1.0307858138873525,0.025390436428490037,45.93368969119212,198.7829523883345,188.30699920654297,177.83104602475143,185.60999952043807,2.8703903220370015,185.32785606384277,3.3059296427857197,184.93525098651187,186.91491004838295,2.033345007336679,-2.6667350531747696,68741000,2.375200307943731,1.2936518824769931,-27888000.0,-19.957815815745132,78.30330443471131,85.07633588200967,41.83494713339311,31.37562609849214,27.5517233826167,0.1607282191900973,3.414458862637964,191.04171490478518,188.96413552856447,187.28499603271484,185.60585653686525,183.52827716064454,0.04,0.0,190.52449837369835,0.032167609279873055,0.02884134537115393,185.6099591936384,185.04140036446708,4.667176996624924
2024-01-22,0,193.44499969482422,181.52499771118164,196.05999755859375,184.09812259674072,193.19124698638916,0.2800182711355624,4.921634356415891,-1.468417767733388,2.995390396539034,186.1287498474121,4.500700225830076,0.026178418895328494,181.98624954223632,194.3950008392334,0.8028593412448121,-0.02879218970396735,1.028943612728201,1.0463740437404605,1.0418697577446678,0.04015269988324377,53.809921046070464,197.84676793463353,188.00349922180175,178.16023050896996,186.78571374075753,4.102639787219532,185.34964207240515,3.3619027648300537,186.30230790982517,187.29986501112623,3.3544137798789917,-1.7909869557078013,60133900,2.498523783463198,1.1233320054603135,32245900.0,-9.498694548507034,78.30330443471131,85.07633588200967,91.88560479230772,36.36747709958437,25.191821139508317,0.21181582986525968,3.442265136491938,191.75224096679688,189.5388804321289,187.75,185.9611195678711,183.74775903320312,0.06,0.0,190.62922399776548,0.042867869154332716,0.044722195468837884,186.70579746791296,185.13817596435547,4.601289986278872
2024-01-23,0,194.94499969482422,181.52499771118164,195.3400001525879,184.09812259674072,193.19124698638916,0.2266761552400689,4.737143369272566,-1.5263152223407859,2.995414940832781,186.1287498474121,4.343800354003906,0.02521463802601143,181.98624954223632,193.92775077819823,0.7596321373098486,-0.009701036430241687,1.037643832814948,1.0477322982808037,1.0415703835100805,0.06675969703273132,60.453881765962315,197.34703606715837,187.87274932861328,178.3984625900682,188.1064284188407,5.069107002921544,185.96857070922852,4.231506184814193,188.10116614485509,187.9921511099551,4.443484348166244,0.15791867394689102,42355600,2.6032414306689953,0.7942859478919794,74601500.0,-3.658583165777224,78.30330443471131,85.07633588200967,109.25776488392863,35.717203008186985,24.061475769824355,0.24362185638718206,3.324014229978266,192.0731195678711,189.7984393005371,187.95999908447266,186.12155886840821,183.84687860107422,0.08,0.0,190.72297729229518,0.06289819184140799,0.0498063499679366,188.07061767578125,185.81702859061105,4.639724817484694
2024-01-24,0,195.1599998474121,181.52499771118164,194.94499969482422,184.09812259674072,193.19124698638916,0.21365330030604757,4.7066954178436085,-1.546222747864895,2.9954189044684845,186.1287498474121,4.320100326538085,0.025055205055223014,181.98624954223632,193.92775077819823,0.749663027675782,0.0033712428648433267,1.0388974387882681,1.0425798487367715,1.029300465104376,0.07351688337457163,63.83629926721994,197.2663901414123,187.8529993057251,178.43960847003788,189.4182139805385,5.587935559561198,186.73392786298479,4.8574580139489685,189.8241261901968,188.76483546903376,4.978461442386978,4.651600264284719,53631300,2.6164899731365647,0.9904063291395206,128232800.0,-11.597804467312223,78.30330443471131,85.07633588200967,109.15248124005065,35.48110255159662,22.886453879767604,0.2147326080659043,3.2248913870979847,192.55444329833983,190.18778231811524,188.2750015258789,186.36222073364257,183.99555975341798,0.1,0.0,190.8400972474895,0.0647032940276473,0.0591950942548271,189.2916979108538,186.54640415736608,4.698969508794127
2024-01-25,0,194.69250106811523,181.52499771118164,195.1599998474121,184.09812259674072,193.19124698638916,0.2348251182859588,4.769586236831995,-1.520912136719225,2.9954106861830816,186.1287498474121,4.372300262451171,0.025384114423691803,181.98624954223632,193.99325065612794,0.7673576752838777,0.009387357393518363,1.0361688580832462,1.0340473411910305,1.0125599766671132,0.03878936858748827,64.9337352728035,197.43567172598333,187.89649925231933,178.35732677865533,191.125,5.004075314012314,187.63999938964844,5.085726060540637,191.1706201918913,189.54195475947768,4.937424627538973,5.809319943786239,54822100,2.6064371389994885,0.9887485910827203,73410700.0,-13.633595302441122,78.30330443471131,85.07633588200967,97.94167072267673,32.80840909043916,24.094508166995347,0.2086996586935973,3.2199109109803583,192.55444329833983,190.18778231811524,188.2750015258789,186.36222073364257,183.99555975341798,0.1,0.0,190.93856547942082,0.029369753436430335,0.0628969507308629,190.7917218889509,187.41880907331193,4.76565238911773
2024-01-26,0,193.3474998474121,181.52499771118164,195.1599998474121,184.09812259674072,193.21624660491943,0.24751157402856552,4.854831287493028,-1.5243133634529504,2.995399373371052,186.1287498474121,4.4531502532959,0.02582853384461019,181.98624954223632,194.71775093078614,0.7929259254920906,0.011087608366712864,1.0286418101582318,1.021760585609924,0.998017873209857,0.015400566750440436,64.0108848981662,197.67353681967603,187.96387424468995,178.25421166970386,192.7753573826381,2.8597620373354107,188.4844638279506,4.972528822975036,192.05763001925683,190.1600563614719,6.537799778960685,6.969493781608024,44594000,2.6017063715049606,0.8068207600116227,28816700.0,-24.626904620243135,78.30330443471131,85.07633588200967,74.85999209555628,30.593641301494504,25.268770409851246,0.1518852146651683,3.1893776661939515,192.5851244506836,190.23744418334962,188.34000396728516,186.4425637512207,184.09488348388672,0.1,0.0,190.98337080769042,0.004489463457624021,0.020092205458192205,192.17788914271765,188.21863010951452,4.729031642456993
2024-01-29,0,191.37999725341797,181.52499771118164,195.1599998474121,184.09812259674072,193.37187480926514,0.2424404524793987,4.895092278964603,-1.5461051642146304,2.9953939620479284,186.1287498474121,4.500550308227536,0.026037257562205547,181.98624954223632,194.71775093078614,0.7996078464048985,-0.0027851249482429867,1.0179604380809397,1.0072923020622075,0.9848804394001678,-0.010674881463278774,58.85736456191317,197.7935588483955,188.0033742904663,178.2131897325371,193.3407140459333,1.8314834893051903,189.03392791748047,4.824497251535022,192.37377634323542,190.34601184938052,6.354686209645247,6.512878273129553,47145600,2.6043822166607904,0.8429989998398778,-18328900.0,-28.917964090607768,78.30330443471131,85.07633588200967,50.60674070566191,28.506546345451696,29.213923434097378,0.19082286734515655,3.1628334883672546,192.5851244506836,190.23744418334962,188.34000396728516,186.4425637512207,184.09488348388672,0.1,0.0,190.9874848933962,-0.01114036714083444,0.0008874502193518839,192.61907087053572,188.65767778669084,4.6362960406190545
2024-01-30,0,189.5625,181.52499771118164,195.1599998474121,184.09812259674072,193.1918716430664,0.264319609684989,4.773378405222749,-1.4713481995485054,2.9954101906202664,186.1287498474121,4.350100097656252,0.025406798175986615,181.98624954223632,194.71775093078614,0.8111120176536867,-0.00911255235506209,1.0089659294486033,0.9948972583463338,0.9776050150718757,-0.027610350115418347,53.444924955395,197.4247559254357,187.87799911499025,178.3312423045448,193.218928200858,2.071121762902819,189.41446386064803,4.622748105158365,192.10557698047745,190.1053592912539,2.111537638319094,4.187817490802569,55859400,2.6361649425523326,0.9871318924693274,-74188300.0,-51.86573785441333,78.30330443471131,85.07633588200967,22.552548401507046,25.635098028056042,31.17974521432928,0.1673244727073836,3.2511075596328194,192.5851244506836,190.23744418334962,188.34000396728516,186.4425637512207,184.09488348388672,0.1,0.0,190.93952574106677,-0.03658160768129182,-0.03017172563554711,192.1181161063058,188.8640376499721,4.519371558996802
2024-01-31,0,185.7224998474121,181.52499771118164,195.1599998474121,184.09812259674072,191.8718729019165,0.33329209199401816,4.6379512758676915,-1.324314495892983,2.9954277803398237,186.1287498474121,4.13545036315918,0.024709498737774095,181.98624954223632,194.71775093078614,0.890831916634416,0.017621329408490104,0.9894691864129869,0.9712681705239833,0.9631486021491669,-0.04835775777505025,53.034651660427336,196.97502688797806,187.69912433624268,178.4232217845073,192.11571393694197,3.4967372862386137,189.45071383884974,4.589151979275341,191.4419056819034,189.58358831111042,-0.44770680431082926,2.8916890368309045,55467800,2.1506134068985796,1.0041869031237118,-129656100.0,-74.50254740140367,78.30330443471131,85.07633588200967,-39.01620331916488,23.465827416030148,35.6962501997797,0.14026436658226388,3.284161544294709,192.5851244506836,190.23744418334962,188.34000396728516,186.4425637512207,184.09488348388672,0.02,1.0,190.80008695925656,-0.05192799343862875,-0.05523104088602341,190.7675279889788,188.73666272844588,4.559884850959448
2024-02-01,0,185.40500259399414,181.52499771118164,195.1599998474121,184.09812259674072,191.8718729019165,0.34669136146003643,4.648061034006386,-1.3295442380734555,2.9954263964051786,185.85000038146973,4.1577503204345705,0.024767038366947453,181.98624954223632,194.71775093078614,0.868048831882861,0.006926184796018296,0.9879243794506368,0.9676203143225697,0.9710067663792492,-0.04770342166836594,44.15517333611028,196.96737145766122,187.67124938964844,178.37512732163566,190.75285720825195,4.028857767860383,189.4296428135463,4.608335199190599,189.99947560628272,188.78890798464195,-3.992090702574377,0.274005720058375,64885400,2.291140860677239,1.1678421960373524,-194541500.0,-59.203999927881355,78.30330443471131,85.07633588200967,-30.95141954558013,21.782066035382062,34.34991100373083,0.21186152386290205,3.272595114303786,192.5851244506836,190.23744418334962,188.34000396728516,186.4425637512207,184.09488348388672,0.04,0.0,190.66208496414404,-0.037647409434755974,-0.03928010763420906,189.58345249720983,188.82703508649553,4.489415634684999
2024-02-02,0,183.07250213623047,181.52499771118164,195.1599998474121,184.09812259674072,191.8718729019165,0.3331485061413601,4.619364321441369,-1.311141923083711,2.9954302770088628,185.85000038146973,4.119350204467776,0.024607835013690307,181.98624954223632,194.71775093078614,0.845394292508808,0.018666829140923238,0.9752462924825415,0.9564541727114079,0.9682098238337704,-0.053142645854177384,44.81948256408298,196.9579781774897,187.71924953460694,178.48052089172418,189.0260718209403,4.398533900734936,189.22214290073939,4.835533221086506,188.8433080493988,188.14272366794694,-4.893686483759226,-0.15885533607750513,102518000,2.2168608446522855,1.7958268632877359,-297059500.0,-61.471078679389315,78.30330443471131,85.07633588200967,-62.815223538031844,18.15960088606801,38.04347263350596,0.26737220562138037,3.631969156053369,192.33732373046874,189.83634301757812,187.81500244140625,185.79366186523438,183.29268115234376,0.06,0.0,190.38563514215903,-0.03414399616644903,-0.04284910469107845,188.35241045270647,188.82205418178015,4.293642088441616
2024-02-05,0,187.72999572753906,181.52499771118164,195.1599998474121,184.09812259674072,191.8718729019165,0.35690915907641607,4.5589582051503825,-1.3065602027821532,2.995438337557453,185.85000038146973,4.076750106811522,0.024279158095493057,182.6499988555908,194.71775093078614,0.8071705006639381,0.008525021041515233,0.9997736413520836,0.9845638836713424,1.0037507404484052,-0.01907201159087546,39.70862708761522,196.89041606697802,187.77249965667724,178.65458324637646,188.031428200858,3.6223561431141698,189.578214100429,4.49332030157199,187.41085825191908,187.40098212275151,-6.193634823033602,-1.56201624658692,69668800,2.2833978082750117,1.2125788028802331,-227390700.0,-50.788147852546516,78.30330443471131,85.07633588200967,-10.56343624647807,20.84018440795708,35.37004274063283,0.28239130682846597,3.615431293429486,192.33732373046874,189.83634301757812,187.81500244140625,185.79366186523438,183.29268115234376,0.06,0.0,190.30732247283984,-0.02112342219618979,-0.024633589818801833,187.42876979282923,189.11024584089006,3.974278699813885
2024-02-06,0,188.06000137329102,181.7949981689453,195.1599998474121,184.9699993133545,191.8718729019165,0.35193207451248043,4.328553016494259,-1.2649070873072144,2.995468124178439,186.70000076293945,3.828550186157224,0.023014088355673794,183.0397518157959,194.71775093078614,0.8190034655559799,0.022007462279899626,0.9998790522562138,0.9892597073384374,1.0094552629875106,-0.007926138485771062,50.9406056303664,196.73985559048361,188.0827495574951,179.4256435245066,187.27607127598353,2.783134750975912,190.02571432931083,3.9359485671631496,187.50557576338554,187.48021886521676,-3.5761548608080522,2.727843073567432,43490800,2.4639077130007516,0.7674072654609472,-183899900.0,-41.330997156681796,78.30330443471131,85.07633588200967,1.3469311106570245,19.854151450706045,33.48261463393955,0.2731970516353937,3.5355500825879713,192.33732373046874,189.83634301757812,187.81500244140625,185.79366186523438,183.29268115234376,0.06,0.0,190.27557394544405,0.006700685838161524,-0.012674037340358405,186.9847412109375,189.58131517682756,3.9176164223968866
2024-02-07,0,189.9275016784668,181.7949981689453,195.1599998474121,185.35750198364258,191.8718729019165,0.2835196283158306,4.209832447534479,-1.19523892476486,2.995482849062999,187.5762481689453,3.6536501312255836,0.022356886432148386,183.0397518157959,194.71775093078614,0.8129390589124912,0.020761552604900865,1.0086357683555711,1.0027149722053088,1.0211265784346144,0.022641316127606892,51.4036515027452,196.72103952122862,188.30137462615966,179.8817097310907,187.06857190813338,2.4617580807857156,190.20464297703333,3.86479865340947,187.6376807276059,187.6267614231195,-2.734712617589539,3.446191186472317,53439000,2.462830983798401,0.9342115855767549,-130460900.0,-40.68884549879229,78.30330443471131,85.07633588200967,20.148535851673472,22.546237431972852,31.730914367274647,0.21744750217881267,3.4544063717242843,192.33732373046874,189.83634301757812,187.81500244140625,185.79366186523438,183.29268115234376,0.06,0.0,190.26346388242797,0.027169184811491,0.007285691559928102,186.6545671735491,189.6368190220424,3.8312799962047595
2024-02-08,0,188.6500015258789,181.7949981689453,195.1599998474121,185.62624835968018,191.8718729019165,0.14672534673685658,4.1166880782010935,-1.141938161353016,2.9954942350993385,187.89499855041504,3.560100116729737,0.021829234837328,183.0397518157959,194.71775093078614,0.8057108837837097,0.025443411829476823,1.0003393764946635,0.9987294265100581,1.009692841522226,0.01750221885323544,55.185238011152535,196.81937602670249,188.5859998703003,180.3526237138981,186.93821498325892,2.3282256800449654,190.07857159205847,3.886137452238418,188.19732825679517,188.06491543545621,-0.7589589276813676,1.3365530072203509,40962000,2.4854688577958366,0.7197592016966933,-171422900.0,-47.051927969272214,78.30330443471131,85.07633588200967,-8.056165644756137,21.460996154430674,32.972936878485925,0.1803046981985871,3.361001309403644,192.33732373046874,189.83634301757812,187.81500244140625,185.79366186523438,183.29268115234376,0.06,0.0,190.2344369140048,0.007813265895963317,0.0212581382379526,186.69441659109933,189.40626634870256,3.7821866616267306
2024-02-09,0,188.87250137329102,181.7949981689453,195.1599998474121,185.71687412261963,191.8718729019165,0.056309357465289436,4.043469488307252,-1.0482058172069333,2.9955028917432283,188.35500144958496,3.4055250549316414,0.021421475354599828,183.0397518157959,194.71775093078614,0.802288334039701,0.015885862283880038,1.000607929657793,1.0031162803043172,1.0073844773073695,0.031681433144692406,51.5017864325199,196.84468891557935,188.75774993896485,180.67081096235034,187.38821520124162,2.3583118283060447,189.7519645690918,3.7719123185743015,188.29189378527693,188.3668852780035,-0.4813707743467689,-0.9269224489468839,45155200,2.507684350144782,0.7962189334046175,-126267700.0,-43.95794882027253,78.30330443471131,85.07633588200967,-0.6526691723506862,21.51284586984653,31.489675141310745,0.16869467751499176,3.2599700815634605,192.33732373046874,189.83634301757812,187.81500244140625,185.79366186523438,183.29268115234376,0.06,0.0,190.21265905591824,0.017438693265815264,0.011939247349374954,187.36202348981584,189.06477573939733,3.6973449783970613
2024-02-12,0,187.75749588012695,181.7949981689453,195.1599998474121,185.91375064849854,191.8718729019165,-0.03797656152907045,3.9821664039847278,-0.9460690655011126,2.9955100184767574,188.76125144958496,3.262762355804443,0.021078990111934495,183.0397518157959,194.71775093078614,0.7973366587613486,0.015566401545951557,0.9938656493958901,0.9995700850562955,0.9952795446864967,0.0001464877921151242,51.89097737726729,196.88070796818673,188.91637516021729,180.95204235224784,187.72428567068917,2.190222231052454,189.23857143947058,3.4892744392775517,188.4199616719278,188.65395603632916,1.6960796502668867,-2.3637200903340507,41781900,2.5075733074063735,0.7358701912153987,-168049600.0,-53.882127001546195,78.30330443471131,85.07633588200967,-33.10836173334509,20.4855216644985,32.79088296765684,0.14786192598017356,3.1717426860725553,192.33732373046874,189.83634301757812,187.81500244140625,185.79366186523438,183.29268115234376,0.06,0.0,190.17143023172855,-0.001551500538752859,0.008279831367231198,187.4372798374721,188.51036616734095,3.6441442281019407
2024-02-13,0,185.13249969482422,181.7949981689453,195.1599998474121,186.9975004196167,191.8718729019165,-0.08766695375539994,3.935102194584748,-0.856348580068059,2.995515370651063,188.76125144958496,3.182662582397461,0.020820054437557033,183.0397518157959,194.71775093078614,0.7554810269921473,0.027428914484880183,0.9795091794849801,0.9874997305461579,0.981336149795515,-0.015566849181585574,50.96720380848063,196.87557929761675,189.00537490844727,181.13517051927778,188.01857103620256,1.4862972945724007,188.52232142857142,3.1972317732203903,188.24361627022722,188.80568015470462,1.2688402433694728,-3.686939303880023,56529500,2.399379895852106,1.0036267054414785,-224579100.0,-65.98124657641098,78.30330443471131,85.07633588200967,-94.85955132236377,18.77904904991907,37.56563491886999,0.11954236344524098,3.2060994281565502,192.2532832641602,189.76836264038087,187.76000213623047,185.7516416320801,183.26672100830078,0.06,0.0,190.06419927515128,-0.021256622466454878,-0.012808387357559788,187.35560607910156,187.854008265904,3.5284720173081547
2024-02-14,0,184.36000061035156,181.7949981689453,195.1599998474121,186.9975004196167,191.8718729019165,-0.02019351800086541,3.776390026826129,-0.7983803029369714,2.995532862574469,188.76125144958496,3.0752250480651866,0.01996771986687369,184.92649993896484,194.71775093078614,0.6733124148056556,0.018358599298630356,0.9748063152094679,0.9857084066975506,0.9802837302488232,-0.029313822479172136,44.65106813212354,196.67753000024652,189.12474994659425,181.57196989294198,187.53714316231864,2.0385423777376985,187.7842856815883,2.8354598903606085,187.4750600347515,188.5511157887033,1.1252359226842465,-5.13809190429801,54630500,2.4720295689533947,0.9636558825687659,-279209600.0,-68.40750720882095,78.30330443471131,85.07633588200967,-120.22964344894565,17.450147707735457,37.35772570516867,0.0901180613458223,3.1975972789150444,191.09963580322264,188.8351766052246,187.00499725341797,185.1748179016113,182.91035870361327,0.06,0.0,189.94762163705977,-0.026529873895461242,-0.02596417884652434,186.8866686139788,187.157719203404,3.3781479103369847
2024-02-15,0,183.31250381469727,183.07250213623047,195.1599998474121,186.9975004196167,191.8718729019165,0.18369389880278236,3.5628011868001663,-0.9910132314438767,2.9955552552454376,188.76125144958496,2.9597999382019053,0.01882559951761671,185.05524978637695,194.71775093078614,0.7776152947574606,-0.016340087182845187,0.9686108212191512,0.9808223179925415,0.9805193455853468,-0.028293123074528248,38.26177048005346,196.37860244226488,189.25300006866456,182.12739769506425,186.85892922537667,2.558916048311907,187.0675002506801,2.577601277913743,186.72230302580124,188.26770947891046,-1.7951287454768414,-5.307087022395761,65434500,2.1167039525031766,1.1671744201073395,-344644100.0,-64.40153129937751,78.30330443471131,85.07633588200967,-125.13378680622654,16.195907514098998,37.167653517039696,0.07793700570240285,3.1933870068018644,189.14379766845704,187.25309811401368,185.7249984741211,184.1968988342285,182.30619927978515,0.06,0.0,189.79551936999732,-0.022437260290372962,-0.028062836844287776,186.14585440499442,186.56529780796595,3.5776182925509006
2024-02-16,0,183.0625,183.07250213623047,195.1599998474121,185.64312553405762,191.8718729019165,0.12875933119316946,3.774686806390659,-1.0913188570222954,2.9955330812163306,188.76125144958496,3.144749794006347,0.019966869711689417,184.25525093078613,194.71775093078614,0.8025647814341245,-0.03730009225471115,0.968341288715081,0.9805825222681618,0.9848052834760643,-0.030761499588592978,33.06275114316104,196.59687384166315,189.04750022888183,181.4981266161005,185.87821469988143,2.501747361134486,186.4733933040074,2.4631637291355033,185.89157203528706,187.68838595325627,-2.524458961993822,-5.190134881823846,49701400,1.9882426842268242,0.9018526198398177,-394345500.0,-75.61755526294353,78.30330443471131,85.07633588200967,-116.5391354860322,15.84152049435779,34.465849071504756,0.005516279547281297,3.1924106572870126,188.83820233154296,187.00590188598633,185.5250015258789,184.04410116577148,182.21180072021485,0.06,0.0,189.6796102282307,-0.03463073755287405,-0.03067852159448458,185.16850934709822,185.91153826032365,3.8196490825086014
2024-02-20,0,181.44499588012695,183.0625,195.1599998474121,185.33687686920166,191.8718729019165,0.21576920372590097,3.976257133617571,-1.1655234418690794,2.99551052144321,188.35500144958496,3.3213623809814465,0.021074092452938023,183.2885036468506,194.71775093078614,0.8056575048346177,-0.053671584746069874,0.9616552677069699,0.9719234958981653,0.9822438537292026,-0.033620495258576466,29.13578717840713,196.6323894503406,188.67987518310548,180.72736091587035,184.8489281790597,2.649120950274433,185.8935715811593,2.6298402625389983,185.20385073514166,187.10601587780212,-3.6145379778062563,-4.346064046810629,53665600,1.8205293442060457,0.9795330710322829,-448011100.0,-80.42375456632075,78.30330443471131,85.07633588200967,-134.10281682146,14.947361498249277,36.399539837569634,0.01605938005702804,3.136858493395101,188.26520233154298,186.54240188598632,185.1500015258789,183.7576011657715,182.03480072021483,0.06,0.0,189.5298413514804,-0.029869085965607445,-0.03860208887182453,184.23941693987166,185.46691676548548,3.914934632879045
2024-02-21,0,181.9525032043457,181.44499588012695,195.1599998474121,184.93937492370605,190.2906255722046,0.28581553114326,4.114908736483344,-0.9739773329458088,2.9954933992615134,187.90874862670898,3.381862735748291,0.021878516968656343,183.0715019226074,194.71775093078614,0.7635260170993872,-0.06925032104352913,0.9674214384272988,0.9779343163168506,0.9917694526366189,-0.01717686789580697,24.239858669946546,196.3096924653373,188.0798749923706,179.85005751940392,183.8603570120675,2.1395590112003573,185.62428610665458,2.833811330805891,184.28245132574796,186.2809559920472,-3.819244944328068,-4.282230989712125,41529700,1.7684354240558937,0.7585939515714726,-406481400.0,-73.9829955064171,78.30330443471131,85.07633588200967,-110.76333061034985,15.247509247466196,34.47634680358557,0.01889629472929113,3.070876285396312,188.26520233154298,186.54240188598632,185.1500015258789,183.7576011657715,182.03480072021483,0.06,0.0,189.42615804589462,-0.014699470600810782,-0.025808122221742696,183.30890110560827,185.33546229771204,3.7319853581725244
2024-02-22,0,183.81750106811523,181.44499588012695,195.1599998474121,184.098126411438,189.6537504196167,0.37002891603854515,4.003897961908051,-0.8161657524572417,2.9955046682518387,187.743745803833,3.3407243728637694,0.021362069134104548,182.95150032043458,193.48199996948242,0.7520801384902761,-0.06767522368002063,0.9807248344571051,0.9912117904424177,1.005420441579346,-0.0029426097875910884,26.645784251494188,195.43804609166278,187.43025016784668,179.42245424403058,183.29750061035156,1.295039931609394,185.51089314052038,2.874726769245992,183.70744358355597,185.59896540819713,-3.6638463082926527,-2.0299084096777724,52292200,1.7776746604941889,0.956354644324743,-354189200.0,-56.61022209291049,78.30330443471131,85.07633588200967,-63.062825511138826,19.233671537784023,32.30053570390075,0.08551595669326804,3.0395678638823767,188.26520233154298,186.54240188598632,185.1500015258789,183.7576011657715,182.03480072021483,0.06,0.0,189.33301612021796,0.0011946995611378242,-0.0036208431069394958,182.91275460379464,185.17501722063338,3.39706021173499
2024-02-23,0,183.6999969482422,181.44499588012695,194.69250106811523,183.69125175476074,189.04500102996826,0.43421815949188514,3.657145675307315,-0.6882581529746683,2.995541271166097,186.7262477874756,3.1348743438720703,0.019571253936954174,182.95150032043458,191.57674751281738,0.7325962041639394,-0.05585731314939175,0.983072485399325,0.99385264873607,1.0053743810162152,0.0021138390752473146,35.936948080375,194.17741657949648,186.86312522888184,179.5488338782672,183.09285736083984,1.0459764331142498,185.5557141985212,2.838447182740464,183.73955031414653,185.28991847192597,-2.098448742907816,-0.8562344616748386,45119700,1.8674288231190443,0.8325658680783968,-399308900.0,-77.19453776928967,78.30330443471131,85.07633588200967,-71.5759196877213,17.936146103694522,30.673704597648655,0.06989241781981541,3.0229073539121987,188.44220233154297,186.82890188598634,185.5250015258789,184.22110116577147,182.60780072021484,0.06,0.0,189.24554246616134,-0.0072881625556942,-0.008851426208943832,182.55365862165178,184.95463235037667,3.074239238979464
2024-02-26,0,181.70249938964844,181.44499588012695,193.3474998474121,183.60312366485596,188.70562648773193,0.38612109578921844,3.2415951856680003,-0.8224727774333371,2.995581240288525,185.56375122070312,2.846599445343017,0.017398606033753743,182.95150032043458,190.0727512359619,0.6978585645049196,-0.04989722084218122,0.9752513874052429,0.9856855128195784,0.9940206403659575,-0.007429160042890071,36.489123579420266,192.79669039422419,186.31350002288818,179.83030965155217,182.71321432931083,0.9901970885751118,185.12517874581474,2.938640248757973,183.71372976706886,185.00035690513002,-0.7737716224560219,0.3427575439728128,40867400,1.8608028160244812,0.7567025297728711,-440176300.0,-89.50223220142173,78.30330443471131,85.07633588200967,-107.19151675498158,17.008300070083685,32.96060074540277,0.07781950112391361,2.956731060178354,188.44220233154297,186.82890188598634,185.5250015258789,184.22110116577147,182.60780072021484,0.06,0.0,189.14604058057378,-0.006307828508891,-0.014685067645011122,182.1275896344866,184.5071291242327,2.92899618565108
2024-02-27,0,181.8025016784668,181.44499588012695,191.37999725341797,183.25250339508057,188.207501411438,0.2448012977863432,2.9594142873226463,-1.2075974091656503,2.9956054852088365,185.26875114440918,2.6089994812011694,0.01593385220485323,181.92750282287597,189.59900016784667,0.6604701270892896,-0.0505669244573923,0.9788471335785809,0.9900789357938133,0.9960498367475884,0.0019703260296912717,32.61983113509754,191.65007857464528,185.73125,179.8124214253547,182.49749973842077,1.002285870513726,184.67821448189872,2.933795191650194,183.1928072537213,184.509560083844,-1.4414738619576193,-3.2107262957799243,54318900,1.862052875104525,0.9991357631720701,-385857400.0,-73.2810630417432,78.30330443471131,85.07633588200967,-88.17856884749034,17.999049420656924,29.558003603457266,0.06989847020857934,3.0583457624057906,188.3383617553711,186.66082095336915,185.30500030517578,183.9491796569824,182.27163885498047,0.06,0.0,189.02633345003107,0.005893404598806828,0.0017553444238322632,181.9523162841797,184.04908534458704,2.6561495124278527
2024-02-28,0,181.7949981689453,181.44499588012695,189.9275016784668,183.07000160217285,187.83312225341797,0.2562212835317042,2.7758147925134575,-1.3436935162542738,2.995620150711404,184.7462501525879,2.4416123008728023,0.01498396330518418,181.79250144958496,188.9415012359619,0.6820559332044095,-0.04093635777927176,0.9813369353662652,0.9932592444717363,0.9956187064990129,-0.0008656381892339082,34.26225450634493,190.80400480627932,185.25237522125244,179.70074563622555,182.3164280482701,0.9976836721544767,184.09732137407576,2.600692362582729,182.82455355961775,184.12314849159182,-0.8237311175220567,-3.3273953254968616,48953900,1.84025300785923,0.9062078343802485,-434811300.0,-82.1668341767356,78.30330443471131,85.07633588200967,-94.11919388687998,16.72400966214498,27.46413581656212,0.10222209533224347,3.0534008130588415,187.52852362060548,186.00574246215822,184.7750015258789,183.54426058959962,182.02147943115236,0.06,0.0,188.91467658971897,-0.004936425120383836,-0.0007710933677629218,181.82549394880022,183.49700164794922,2.708928901880342
2024-02-29,0,181.03000259399414,181.44499588012695,189.9275016784668,182.78500080108643,187.73687076568604,0.40615643772717525,2.6875875007653693,-1.2000182317926902,2.995626795457843,184.0887508392334,2.3481498527526865,0.014538187526396544,181.78574829101564,188.67225151062013,0.7822145063936292,-0.02114715062361101,0.9792604426334188,0.9908864638791182,0.9916002001423965,-0.01516448900634415,37.14451292244868,190.23917513123044,184.86400012969972,179.488825128169,182.25714329310827,1.067952082919628,183.55303573608398,2.3609141302638483,182.55467517783012,183.8511336998425,-0.6923874802620348,-4.281898849640644,136682600,1.6536409011298925,2.3532958514221862,-571493900.0,-88.33651589261675,78.30330443471131,85.07633588200967,-99.80397180994159,15.520191345761077,26.9079245380833,0.11786593535592134,3.0524328785097166,187.52144390869142,185.99428292846682,184.76000213623047,183.52572134399415,181.99856036376954,0.06,0.0,188.59558124048442,-0.019634426061527877,-0.00861128674777709,181.71006992885046,182.97474343436105,2.858709794348884
2024-03-01,0,179.28000259399414,181.03000259399414,189.9275016784668,181.91500282287598,187.73687076568604,0.47977325680679095,2.8046752958250107,-1.189626202607604,2.9956171650832983,183.7587490081787,2.4499997711181662,0.01519083998290423,181.6767490386963,188.67225151062013,0.7876695293990253,-0.02359699004228336,0.9710264270498782,0.9830995619919598,0.9850224873601868,-0.024060938637322837,34.817869990179474,190.23872585867886,184.62937526702882,179.02002467537878,181.87535749162947,1.5595602093560343,182.8678572518485,2.0727244369628486,182.1727094677443,183.58354424118917,-0.22871575163581861,-4.039225481182654,73488000,1.6582315415415232,1.2559586597365167,-644981900.0,-79.8051360925313,78.30330443471131,85.07633588200967,-132.75626357902493,14.292034733449215,29.82715084621467,0.09285094132392901,3.075365462645132,186.00555975341797,184.35722073364258,183.0250015258789,181.69278231811523,180.04444329833984,0.08,0.0,188.39725253542704,-0.015669459079229675,-0.025546367554431404,181.33102416992188,182.31996263776506,3.0306395302437847
2024-03-04,0,175.4849967956543,179.28000259399414,189.9275016784668,181.80062580108643,187.73687076568604,0.409037430047307,3.0287165540447734,-1.078390138085501,2.9955975663114813,183.50625038146973,2.5904995727539073,0.01643156033545478,181.40349655151368,188.67225151062013,0.7877729746102029,-0.0207158338799248,0.9520508972568107,0.9644218629139583,0.9688773088757215,-0.03421803560699044,31.205768592874083,190.38055837511837,184.32312526702881,178.26569215893926,180.68499973842077,2.6375334237456656,181.99125017438615,2.4129510935058827,181.45532358953184,183.063772127882,-1.4687902410169937,-5.078822332287582,81510100,1.6241150661601573,1.4185269909191587,-726492000.0,-89.45240417810255,78.30330443471131,85.07633588200967,-197.30522591549754,12.444737793750445,33.87684337963771,0.026846980928224844,3.277020745554968,183.27888354492188,181.46556158447265,180.0,178.53443841552735,176.72111645507812,0.1,0.0,188.09709510623736,-0.03345111884413643,-0.040653078232977286,180.01006208147322,181.46140834263392,3.6467335931350955
2024-03-05,0,170.63499450683594,175.4849967956543,189.9275016784668,181.7718734741211,187.73687076568604,-0.18155247041530936,3.58561308628989,-0.3209435636222433,2.9955420285500036,183.50625038146973,2.893999786376952,0.019492986776065455,180.85500259399413,188.67225151062013,0.7482421102912786,-0.06522665109765666,0.9276476885288897,0.9416890340831194,0.9486125032143566,-0.06142658692002789,16.31033005942329,191.11497617257976,183.94375,176.77252382742023,178.81857081821985,4.267454236207903,180.95571408952986,3.7187128998540375,179.98512674211435,182.17457810404116,-4.533030981295547,-6.536356392560745,95132400,1.3706028554917542,1.6197086998534842,-821624400.0,-96.85732316208839,78.30330443471131,85.07633588200967,-253.94393070783298,11.013548263006468,38.73204900213756,-0.02595111700766307,3.435867732331273,181.77523791503907,179.4523773803711,177.5749969482422,175.69761651611327,173.3747559814453,0.12000000000000001,0.0,187.64234678604478,-0.06849912750928511,-0.06094059697300779,178.24307904924666,180.39836883544922,4.6554743487190615
2024-03-06,0,170.02499771118164,170.63499450683594,189.9275016784668,181.63812351226807,185.7887487411499,-0.8369890627993095,4.501709602041156,1.0194816201417538,2.9954278000625063,183.18750190734863,3.270000457763672,0.02458754815167411,178.90050201416017,188.67225151062013,0.6955267040110743,-0.09265663479320724,0.9286467115329798,0.943954019538383,0.957105456013288,-0.06474325793510338,11.27092071552709,192.09241914304712,183.08899993896483,174.08558073488254,177.1503562927246,5.144516498353479,179.9317853110177,4.582475859431658,177.65788568007312,180.67123442766302,-7.112140804818488,-7.830880699977709,68587700,1.6386309612927474,1.1433358487898888,-890212100.0,-97.31049862475038,78.30330443471131,85.07633588200967,-226.46160891822296,10.411186992291169,38.62193129889328,-0.09888761558573385,3.372756765230691,181.17903314208985,178.7904730529785,176.85999298095703,174.92951290893555,172.5409528198242,0.14,0.0,187.3120829394951,-0.06779854379226335,-0.07397479932881078,176.5273917061942,179.3274906703404,5.359440629102917
2024-03-07,0,169.34249877929688,170.02499771118164,189.9275016784668,181.34124755859375,184.55312538146973,-0.8737148386553317,5.172049970345548,0.5068705459133263,2.9953257888212512,182.50750160217285,3.672000503540039,0.028388649465186894,174.99999656677247,188.67225151062013,0.7460625444859375,-0.10479000561476674,0.9294969818482076,0.9464321370166688,0.9660649999122117,-0.06456114261297041,8.303049534898065,192.53134969655048,182.18724975585937,171.84314981516826,175.3703558785575,5.415066511592944,178.93392780848913,5.260533479413478,175.75864264838023,179.2500663353179,-6.426714942112713,-7.775549387997253,71765100,1.5049803384500497,1.1783040966061884,-961977200.0,-96.91845992144714,78.30330443471131,85.07633588200967,-188.49433593011744,9.900923882170973,37.144722666774925,-0.11438492408716483,3.2911848821241816,181.13419616699218,178.71789794921875,176.76499938964844,174.81210083007812,172.3958026123047,0.16,0.0,186.97411642806532,-0.06500692710083289,-0.06845994281984491,174.5851331438337,178.2687247140067,5.809276568149612
2024-03-08,0,170.59249877929688,169.34249877929688,188.87250137329102,180.59250259399414,183.95312595367432,-0.8910843058942014,5.562782705272431,-0.011517938831892671,2.9952562919307457,181.87750244140625,4.115050468444826,0.03070680134037923,170.5739948272705,187.84674644470215,0.7911973461709395,-0.10234562730143121,0.9416779780396282,0.9611941633940192,0.9863489358449449,-0.04845774034470196,8.100978212458035,192.28356502144572,181.15799961090087,170.03243420035602,173.76999882289343,4.822889225904508,178.04321343558175,5.555170030877514,174.15385578005913,177.84580504908678,-6.8535926536404315,-7.620868595806246,76114600,1.5060587035131143,1.2146648794357184,-885862600.0,-86.46530582139367,78.30330443471131,85.07633588200967,-131.785994027577,15.194904250752128,33.39871476012106,-0.12250150794238489,3.3968940436928285,181.13419616699218,178.71789794921875,176.76499938964844,174.81210083007812,172.3958026123047,0.16,0.0,186.66302617276338,-0.04970515952106214,-0.055435764151893656,173.06181989397322,177.44365692138672,5.981845473309503
2024-03-11,0,173.03000259399414,169.34249877929688,188.87250137329102,178.33125114440918,183.72937297821045,-0.7604110870070419,5.73623166102107,-0.5549443481523517,2.9952216284831534,181.79874992370605,4.617075767517088,0.031822849296371,170.53574867248534,185.3949993133545,0.8238420500009376,-0.09678488112922916,0.9599172456224014,0.9821819019136262,1.0105948352256444,-0.013989766911634671,15.276182114829536,191.72758779561394,180.25512447357178,168.78266115152962,172.62714168003626,3.6115242726492576,177.44214248657227,5.613726542881431,173.26539378573085,176.82135964237756,-6.162160401815762,-6.8118818549419595,60139500,1.5667890462396146,0.9483891600772469,-825723100.0,-74.25983293688112,78.30330443471131,85.07633588200967,-88.99230916451998,15.459011630468504,30.831084110122454,-0.13479292381319274,3.4151007099979074,181.13419616699218,178.71789794921875,176.76499938964844,174.81210083007812,172.3958026123047,0.16,0.0,186.45530535876014,-0.01342088684977083,-0.038461577759280476,171.92183140345983,176.81595066615515,5.823075525998135
2024-03-12,0,172.85499572753906,169.34249877929688,187.75749588012695,174.87124824523926,183.4093770980835,-0.6882911486433859,5.583372800298877,-0.9312676844120311,2.995244689628853,181.74874877929688,4.7851004981994665,0.031111553995965623,170.53574867248534,184.43725051879883,0.8563634529698152,-0.07843890981340912,0.963179018381482,0.9860426167980645,1.012476188446069,0.013010234079587901,28.135372349229996,190.62974513520467,179.46299953460692,168.29625393400917,171.70928355625696,2.1661317215408045,176.79232052394323,5.577894802067674,173.20026302479,176.266927038266,-4.4191569824710415,-4.637765425998435,59825400,1.7398043941930998,0.9302017501980698,-885548500.0,-71.35955449834965,78.30330443471131,85.07633588200967,-80.70519003148358,14.467934152588146,31.062279969915235,-0.0909907668009352,3.3866955268630368,181.13419616699218,178.71789794921875,176.76499938964844,174.81210083007812,172.3958026123047,0.16,0.0,186.25033060552352,0.018281071747883404,-0.010679714195381478,171.00556073869978,176.16829245431083,5.664177210905571
2024-03-13,0,171.9625015258789,169.34249877929688,185.13249969482422,172.98625087738037,183.12500095367432,-0.6078511283860722,5.418689212765533,-1.2801612017523765,2.9952696811985815,181.5737476348877,4.906013679504395,0.030319794408407534,170.53574867248534,183.87175102233886,0.882852760271813,-0.0663173888297496,0.9622009101273252,0.9859839495223118,1.0046357857647066,0.011395405621404286,29.02661448045656,189.55525295250857,178.71787452697754,167.8804961014465,171.20606994628906,1.4252661227278303,175.9455348423549,5.323411149791288,173.10082880733125,175.85767252972366,-3.5837833408589628,-4.999935321906227,52488700,1.687940162481266,0.8186981628123547,-938037200.0,-84.04833029079309,78.30330443471131,85.07633588200967,-83.383071756309,13.69462976799362,29.943002432554533,-0.12562423523286884,3.3208211081518706,181.13419616699218,178.71789794921875,176.76499938964844,174.81210083007812,172.3958026123047,0.16,0.0,186.06170073929235,0.011885157600131313,0.005936960227806627,170.4398411342076,175.2249516078404,5.684363960099853
2024-03-14,0,173.06750106811523,169.34249877929688,184.36000061035156,172.63187217712402,182.23000240325928,-0.42848226288374136,5.399347467251623,-1.5309681838738642,2.9952704260295673,181.23749923706055,5.054751052856443,0.030323297938224497,170.53574867248534,183.71174736022948,0.8806838112255989,-0.06724614365062306,0.9719651180337485,0.9979457940773665,1.008807603276375,0.02199685439668131,27.60815073122696,188.85806955303354,178.05937461853028,167.26067968402702,171.55357088361467,1.553587326010046,175.18607085091728,4.871262508918615,172.8089946703186,175.54113775532448,-2.0072914118562535,-6.449331251567473,72913500,1.6886253071563573,1.121288236980759,-865123700.0,-70.77124661300212,78.30330443471131,85.07633588200967,-57.26962791737689,15.179750831072944,27.877120503742116,-0.13727478087536507,3.310705431986859,180.27851989746094,178.0257409667969,176.2050018310547,174.3842626953125,172.13148376464844,0.02,1.0,185.83286480398348,0.023668707074009587,0.02294241182643643,170.85023716517858,174.5466581072126,5.584960221932623
2024-03-15,0,171.67499542236328,169.34249877929688,183.81750106811523,172.63187217712402,181.84000205993652,-0.2578727262670787,5.300490297138931,-1.656852350972832,2.995285145600365,180.15500259399414,5.045775928497315,0.02986280049323814,170.53574867248534,183.35125312805175,0.8969240302173782,-0.05588818293016315,0.9672116824254664,0.994482318336951,0.9963639056141502,0.006345511384219016,33.732321943063766,188.0957302356963,177.49474964141845,166.8937690471406,171.7892848423549,1.4006594851442413,174.46982056753976,4.567116467892391,172.8728597653854,175.39501639060694,1.4255613675903078,-5.787967368950299,121664700,1.7300225178638713,1.7934579639702228,-986788400.0,-73.23401435889322,78.30330443471131,85.07633588200967,-66.80874068422271,14.27581031940457,30.08447039702549,-0.07078809206595663,3.2675746762812667,180.27851989746094,178.0257409667969,176.2050018310547,174.3842626953125,172.13148376464844,0.02,0.0,185.4319384752395,0.011070178478661985,0.021420113372859775,171.34898376464844,173.9381877354213,5.458749090491604
2024-03-18,0,175.1300048828125,169.34249877929688,183.81750106811523,171.890625,181.79687404632568,-0.06462727249150417,5.268565474926284,-1.725782822260328,2.9952884642164905,177.38249969482422,5.045875930786133,0.029780565705585123,170.53574867248534,183.12624969482422,0.8833474555258483,-0.062205555903785424,0.9899223312784234,1.018985649509464,1.015140481725522,0.012136636752794194,30.642110523777397,187.45000517165434,176.91287422180176,166.37574327194918,172.61607142857142,1.423592749364114,173.99321365356445,4.063426554750987,172.57367790136425,175.0744673178864,0.9704441896152598,-5.518638434236322,75604200,1.738758654196847,1.0936019953945424,-911184200.0,-64.25154178543603,78.30330443471131,85.07633588200967,-20.7367699442825,23.49131328612214,26.850336283551663,-0.09744478411766995,3.3983787179602096,179.66731756591798,177.53133908081054,175.80500030517578,174.07866152954102,171.94268304443358,0.04,0.0,185.24911398211594,0.0056150135598016515,0.01751312575005246,172.0215781075614,173.30335562569755,5.337522022340308
2024-03-19,0,175.01499938964844,169.34249877929688,183.81750106811523,171.890625,181.72562408447266,0.07205047134337426,5.0861092457817,-1.6530207415429767,2.995317365156568,175.3075008392334,4.787875633239747,0.028813830234723125,170.53574867248534,182.12725257873535,0.9035484051567466,-0.03480388625039018,0.9914951168471116,1.0185268725850392,1.0120100826169223,0.01249604417285144,45.85020342557849,186.6884679575058,176.5162494659424,166.344030974379,173.24785723005022,1.3555831401494511,173.5089280264718,3.4142395060600155,173.21263025759197,175.17572346668842,3.4176335800137503,-3.670189757594852,55215200,1.9397400178974447,0.7977844458242894,-966399400.0,-46.09378301961426,78.30330443471131,85.07633588200967,-13.565591645795937,21.722527759435295,25.85922128724814,-0.08026598061493911,3.411410075889441,179.24712689208985,177.19144662475586,175.5300064086914,173.86856619262696,171.81288592529296,0.04,0.0,185.12282368451557,0.01645220925062585,0.019276383169729613,172.78394862583704,172.92288425990515,5.195215998660442
2024-03-20,0,177.0374984741211,169.34249877929688,183.81750106811523,171.890625,181.72562408447266,0.22162176549959822,4.966206364184733,-1.5340139318348314,2.9953358017498686,175.07250213623047,4.552200851440432,0.028185893020601767,170.53574867248534,182.12725257873535,0.8906393831673988,-0.03812810317265024,1.0047830530388546,1.0276775569529788,1.0211541674261626,0.029512230301432574,45.069374095752956,186.12716236978795,176.19474964141847,166.26233691304898,173.82035664149694,1.9598156793734187,173.2237491607666,2.85935814770751,173.66945458431468,175.18283637485231,2.5924355654542284,-3.7294748742185426,53423100,1.9305125507409588,0.7653153207680586,-912976300.0,-15.448518667313857,78.30330443471131,85.07633588200967,24.218931695735073,24.40916232264722,23.919643238274528,-0.05585652446851918,3.423502560910234,177.68856036376954,175.93072134399415,174.51000213623047,173.0892829284668,171.3314439086914,0.06,0.0,185.03060511373508,0.044060106716381275,0.031403488864447875,173.6275416782924,172.7746865408761,5.0263651488723555
2024-03-21,0,174.1875,169.34249877929688,183.81750106811523,171.890625,181.19812679290771,0.31396523421227596,4.793822842795156,-1.3669000357124736,2.9953620982690667,175.07250213623047,4.257300567626953,0.027245524890785234,170.53574867248534,181.99225120544435,0.8509031389338658,-0.03688442370610701,0.9899885795834875,1.007034428295274,0.9988674493357518,0.0064714572347350785,50.50392039843659,185.53664509049753,175.94899940490723,166.36135371931692,174.01071439470564,1.914614191543367,172.85999897548132,2.2985829830523152,174.52007755008412,175.41393628380598,2.3160699416564956,-2.205437807360172,106181300,1.9403837489057143,1.4645736953757114,-1019157600.0,-71.70931536252391,78.30330443471131,85.07633588200967,-37.80785482875972,20.744326992000694,28.477761878179848,-0.1343780937481553,3.739470915638744,176.26751989746094,174.78124096679687,173.5800018310547,172.3787626953125,170.89248376464843,0.06,0.0,184.75442794659227,-0.009421995969504993,0.0014024268805427997,173.36249651227678,172.18402862548828,4.703677912859071
2024-03-22,0,171.7874984741211,169.34249877929688,183.6999969482422,171.890625,179.71750259399414,0.4387625876777883,4.450659864913734,-1.1696585253820198,2.9954117234955535,174.60124969482422,3.8092501831054677,0.02536458250879866,170.53574867248534,181.79574851989747,0.8088217777731657,-0.051782782287810004,0.9790274501489961,0.9903851205754233,0.9838410324462911,0.0006553257885986152,42.37214183410003,184.36881908132892,175.46749935150146,166.566179621674,173.98571395874023,1.946690479406846,172.59589195251465,2.1833002010909848,174.44660789070042,175.16447022314395,0.7708798156816271,-2.840530187589778,71106600,2.0170622594141023,0.9635152277170691,-1090264200.0,-62.77017669030931,78.30330443471131,85.07633588200967,-58.067934665625835,19.53797002941433,28.338722816746248,-0.08439003328534408,3.685745297571002,176.26751989746094,174.78124096679687,173.5800018310547,172.3787626953125,170.89248376464843,0.02,1.0,184.55442227610507,-0.0019696149715551226,-0.004161891458882311,173.52636936732702,171.9831052507673,4.4195441005724385
2024-03-25,0,170.7025032043457,169.34249877929688,181.8025016784668,171.75937271118164,177.59812450408936,0.560839419654656,4.091701806372628,-1.0254789280590295,2.995459682459409,173.62750053405762,3.4430634117126457,0.023398284142382722,170.53574867248534,181.7117492675781,0.7909368751681914,-0.05456722361460373,0.9761575654341645,0.9834523941094334,0.9775012123568655,-0.025281228544642875,37.91772406036431,183.05527804054066,174.8718744277954,166.68847081505015,173.64785712105888,2.304884313133236,172.6007140023368,2.1787059252616308,173.79717944884482,174.55499232094795,-0.10176814724428512,-2.107016775820899,54288300,2.034708223942952,0.7289937087578264,-1144552500.0,-76.81726612666303,78.30330443471131,85.07633588200967,-72.86408326853721,18.44465234459286,27.959102677263925,-0.0649172336583619,3.6244168529307514,176.26751989746094,174.78124096679687,173.5800018310547,172.3787626953125,170.89248376464843,0.04,0.0,184.39360092824768,-0.016520804047216564,-0.010253677652916552,173.2199968610491,172.03511701311385,4.227768144435101
2024-03-26,0,170.1775016784668,169.34249877929688,181.8025016784668,171.4318723678589,175.873122215271,0.7546786707550175,3.8698623791490805,-0.6428045081497404,2.995487193371078,173.0487518310547,3.200000762939453,0.02219952250753112,170.53574867248534,181.10650215148925,0.7428163009977783,-0.06105525705995172,0.9762257436186214,0.981744192741687,0.9794614078490392,-0.027640474976727947,35.540313397982665,182.06159937682847,174.32187461853027,166.58214986023208,173.43392944335938,2.5724754109065713,172.61160714285714,2.1651764170598833,173.0361059842906,173.9361911200069,-1.366517601036329,0.03956321955228305,57388400,2.032852005158684,0.7690375432511924,-1201940900.0,-88.01569647878458,78.30330443471131,85.07633588200967,-80.17443964956472,17.74921037526784,26.904925397954187,-0.11266068197346892,3.4965635086650098,176.26751989746094,174.78124096679687,173.5800018310547,172.3787626953125,170.89248376464843,0.04,0.0,184.22141677508512,-0.03617666286583043,-0.023083036905878544,172.80532836914062,172.07715606689453,3.8453510717437536
2024-03-27,0,171.85750198364258,169.34249877929688,181.7949981689453,170.68562602996826,175.21875286102295,0.9189970940931448,3.5635355426706736,-0.16189220727676412,2.9955232104987215,172.9424991607666,2.9035005950927713,0.02051066381564399,170.1622512817383,179.45500259399415,0.6794056779329054,-0.06390437914954167,0.989161299269976,0.9929697894086015,0.99466948503074,-0.029259318139516766,34.458356713239304,180.86769570387162,173.74062461853026,166.6135535331889,172.96642902919226,2.509459889332853,172.79125022888184,1.9684757492959801,172.32554030113351,173.19576836499627,-0.872284132125518,0.08969502681259373,60273300,2.0284045852859913,0.8016171377876751,-1141667600.0,-55.087389146338595,78.30330443471131,85.07633588200967,-25.24038581997505,20.77647222617728,24.77790225191268,-0.07392906040242063,3.5247468700001314,176.3737191772461,174.9531398010254,173.80500030517578,172.65686080932616,171.23628143310546,0.04,0.0,184.07155856337587,-0.029999559929170805,-0.015731552370092848,172.7469024658203,172.38424028669084,3.3744915097366603
2024-03-28,0,171.49249649047852,169.34249877929688,181.03000259399414,170.68562602996826,175.04375076293945,1.016940156394103,3.0635864385087874,0.3151387763576192,2.9955768281476955,172.40874862670898,2.4458756065368616,0.017683676564849708,170.1622512817383,177.2617488861084,0.6002845541430826,-0.05066840014869375,0.9898913910561583,0.9909209527522136,0.9985443057130188,-0.01547185366069026,41.13775376297081,179.3709226862827,173.24374980926513,167.11657693224754,172.46321432931083,2.3800418408341155,172.85553577968054,1.9048128228202614,172.19888781980313,172.754384194385,-1.868613491651361,1.4851577261910447,65672700,2.0911668956278704,0.9167153597879595,-1207340300.0,-77.98266257559058,78.30330443471131,85.07633588200967,-46.27297624638392,19.576765699116837,23.347139091791988,-0.05290188900251234,3.472841276223214,176.49407788085938,175.14795770263672,174.05999755859375,172.97203741455078,171.62591723632812,0.04,0.0,183.8998680993806,0.000641897395499802,-0.040241823201458776,172.0914088657924,172.43767874581474,2.879788633149466
2024-04-01,0,170.48749923706055,169.34249877929688,179.28000259399414,170.68562602996826,174.3943748474121,0.9189444679898986,2.506034636127664,0.2374836007029164,2.9956275274357638,171.91000175476074,2.0185630989074697,0.014505295898423785,170.1622512817383,175.64024696350097,0.4879535856731683,-0.043437672862776416,0.9868066417617872,0.9860112010818611,0.995817835922637,-0.007567484529477531,41.29852013498829,177.77894377634468,172.76687450408934,167.754805231834,171.5275001525879,1.3440016449251804,172.6739283970424,2.005444044203988,171.99953390003975,172.265921625818,-2.0126862905775984,0.5275716796586747,46240500,2.0697523377771065,0.6579770710845896,-1253580800.0,-93.70930852208221,78.30330443471131,85.07633588200967,-82.40959761079766,18.744185713355336,24.54444911111296,-0.08978434793554378,3.3673776264733633,176.49407788085938,175.14795770263672,174.05999755859375,172.97203741455078,171.62591723632812,0.04,0.0,183.77084161045445,-0.013060133030692977,-0.00781934752482097,170.86021859305245,172.24388013567244,2.425565186969066
2024-04-02,0,168.87249755859375,169.34249877929688,177.0374984741211,170.62437057495117,173.34750080108643,0.6578142255948971,2.0556446711163594,-0.5261594308326205,2.9956613082547987,171.82250022888184,1.7189504241943383,0.011928726762796592,170.1622512817383,175.16550407409667,0.4997871640384438,-0.028478204119142723,0.9799523767079455,0.977342094687216,0.9878848686617522,-0.010720438256029974,41.08834901555063,176.43853867847542,172.3272493362427,168.21595999400995,170.76821408952986,1.0626911464434203,172.38946424211775,2.2458284175306984,171.59836613932617,171.82020620918183,-3.699780720759568,-1.4694002882837869,49329500,1.9177694434758359,0.7183795999678743,-1302910300.0,-94.15708364269888,78.30330443471131,85.07633588200967,-130.3790859075353,18.002129453310147,26.321972859269497,-0.07897797125543025,3.2551647276515716,176.20615759277345,174.68191723632813,173.4499969482422,172.21807666015624,170.69383630371092,0.06,0.0,183.62137930454176,-0.011764809111723729,-0.019967567653000347,170.49969482421875,171.93109566824776,2.43749750936562
2024-04-03,0,169.42499542236328,168.87249755859375,177.0374984741211,170.5662488937378,173.0393772125244,0.7275024737697976,2.0529391588345147,-0.07962408725106984,2.995661241674422,171.7312469482422,1.6346131515502946,0.011935927035206384,169.95674781799318,175.02649993896483,0.6328599531649476,-0.01032904741103138,0.9850483754470167,0.98410358728194,0.9932435170441062,-0.004421890371415271,39.86686647947433,176.1025026920587,171.99662437438965,167.89074605672062,170.43071365356445,1.0601748878991266,172.20821380615234,2.3812495554219035,170.903440074014,171.3758589798738,-3.0513110535522068,-2.303953178896076,47691700,1.624089049564829,0.7193784815606442,-1255218600.0,-86.3984881525177,78.30330443471131,85.07633588200967,-92.15881772475842,20.172601721454225,25.074772849854288,-0.039018399410615426,3.172476062256974,176.20615759277345,174.68191723632813,173.4499969482422,172.21807666015624,170.69383630371092,0.06,0.0,183.4876584504278,-0.0003536980419244218,-0.0070238053881138875,170.12492152622767,171.82564544677734,2.457663198891603
2024-04-04,0,169.9625015258789,168.87249755859375,177.0374984741211,170.4099998474121,173.0393772125244,0.679700355194787,2.1092323067764243,-0.2042812333291124,2.9956572312771748,171.7312469482422,1.6796008300781238,0.01226753431769826,169.41674575805663,175.02649993896483,0.6618771240225392,-0.0035289063190435815,0.9885211854056679,0.990441599953456,0.997274512737873,-0.011026579787852597,42.70735745034375,176.15458903371885,171.936124420166,167.71765980661317,170.3249991280692,1.0654380060085586,171.98642812456404,2.43895859546264,170.53102895496272,171.22476436175867,-1.375247368255794,-1.4756159517333793,53704400,1.625347644801973,0.8192699072569392,-1201514200.0,-94.34854924612246,78.30330443471131,85.07633588200967,-84.19290719248635,21.56152220381759,23.318296968929456,-0.04609257181126075,3.167288279131673,176.20615759277345,174.68191723632813,173.4499969482422,172.21807666015624,170.69383630371092,0.06,0.0,183.34241558581587,-0.025907218692365896,-0.0052442675273198834,169.83564976283483,171.52782331194197,2.476136703678415
2024-04-05,0,169.62749862670898,168.87249755859375,177.0374984741211,170.4099998474121,173.0393772125244,0.6776144734716728,2.112105646285122,-0.21086267064829567,2.9956570235903133,171.7312469482422,1.6821006774902343,0.012284469247119506,169.41674575805663,175.02649993896483,0.6602270257918306,0.003661235372403931,0.9865907010904862,0.992581707601184,0.997527172180821,-0.010875098922319748,45.58567915235507,176.15721090347114,171.93299961090088,167.70878831833062,170.24642726353235,1.0979135936224778,171.84017835344588,2.5191399555751204,170.39377583773597,171.19799104310513,-0.43350370649278097,-1.794097403078741,42055200,1.6224602523211098,0.6564351409888921,-1243569400.0,-87.06891007839859,78.30330443471131,85.07633588200967,-93.75290952246091,20.76806598587231,22.460192075082226,-0.020758966256176375,3.0529856252480227,176.20615759277345,174.68191723632813,173.4499969482422,172.21807666015624,170.69383630371092,0.06,0.0,183.22905543376464,-0.011080100867838838,-0.021522135266685467,169.81712123325892,171.31122480119978,2.4441854130527565
2024-04-08,0,168.72999954223633,168.87249755859375,177.0374984741211,170.4099998474121,173.0393772125244,0.7013482744184503,2.09547589112005,-0.1841354671914388,2.9956582217235836,171.7312469482422,1.6707006835937477,0.012186736897245384,169.6072483062744,175.02649993896483,0.6822963043785197,-0.005656756067782057,0.9812893194368726,0.9899715007913696,0.9944305351973887,-0.010308671912539702,42.98381907980761,176.1382013855116,171.94724960327147,167.75629782103135,169.79964120047433,0.9608288376452164,171.3830351148333,2.4561288174204106,170.20200713019165,171.10732353214203,-0.3231937514260773,-1.1926587157418844,37425500,1.5982904515025678,0.6023586876143591,-1280994900.0,-97.89270910674719,78.30330443471131,85.07633588200967,-122.08000625828912,20.088575275120057,23.458890714072385,-0.023162426549146485,2.9304200842162795,176.20615759277345,174.68191723632813,173.4499969482422,172.21807666015624,170.69383630371092,0.06,0.0,183.1223589122764,-0.009292471422053916,-0.01766971313611984,169.12457929338728,170.9357408796038,2.5515208767276767
2024-04-09,0,169.20000076293945,168.72999954223633,177.0374984741211,170.12375164031982,173.0393772125244,0.5934444013262681,2.192741288833177,-0.33706690534312944,2.995651073098824,171.7312469482422,1.7455383872985835,0.01275931720235655,169.36974563598633,175.02649993896483,0.7161462420218893,-0.024851199140576475,0.9845559489246072,0.9945131395837181,0.9992706400866672,0.0019393519316670549,36.77528182350002,176.2396072190848,171.85412464141845,167.4686420637521,169.4721418108259,0.6167348162427663,170.96767807006836,2.2800568114384934,169.83476674405853,170.89096824844194,-1.8198230541625853,-3.6544310866996823,42451200,1.4951860880740349,0.6931128409688154,-1238543700.0,-86.20687639214493,78.30330443471131,85.07633588200967,-84.88495994373004,21.427779061873,22.438183314504773,0.014328491517341281,2.844539396732628,176.20615759277345,174.68191723632813,173.4499969482422,172.21807666015624,170.69383630371092,0.06,0.0,183.00926353888954,0.004915951623825077,-0.0021172947461598956,168.86665562220983,170.4790322440011,2.5824038389602113
2024-04-10,0,168.19499969482422,168.72999954223633,177.0374984741211,169.87875080108643,172.9081220626831,0.7173157954123266,2.2482273694706723,-0.2961887887699759,2.995646772769218,171.5837459564209,1.794875144958496,0.013096778494246964,169.1672504425049,175.02649993896483,0.7471288989335984,-0.021144861617773306,0.9797997679219089,0.9894798481876458,0.9929511391707299,-0.00725982446965856,39.548806434800404,176.15907928880705,171.6626245498657,167.16616981092437,169.1446418762207,0.5960311558813345,170.3360710144043,1.5894510140882139,169.6671683915544,170.72234422607636,-1.3367906902366102,-3.322571577858099,49709300,1.5032661931170375,0.8183764062595564,-1288253000.0,-93.54530005997671,78.30330443471131,85.07633588200967,-120.08051654449639,20.03835426490604,24.12405367576853,-0.021933840743746245,2.824185029126153,175.04032434082032,173.5248436279297,172.3000030517578,171.07516247558593,169.5596817626953,0.08,0.0,182.8660773032335,-0.011022620248262283,-0.00627805591458952,168.54603358677454,169.7031260899135,2.688877071402636
2024-04-11,0,171.75,168.19499969482422,177.0374984741211,169.57687282562256,172.238751411438,0.7581472199411596,2.351674095782087,-0.26692259225071346,2.9956384998237295,171.0974998474121,1.8916250228881837,0.013718014603577836,168.858247756958,175.02649993896483,0.7531823906396424,-0.021908856859050228,1.0018688441524652,1.0115734660077345,1.0154129935558198,0.010517016742360275,36.7863521432893,176.13297293979412,171.42962474822997,166.72627655666582,169.55571365356445,1.1300801751286313,170.16196387154716,1.2273772106821716,169.3014680163476,170.47960473002996,-1.3446731006644885,-4.994703865288432,91070300,1.5062310102808276,1.4531618532467736,-1197182700.0,-5.0300972541509354,78.30330443471131,85.07633588200967,47.913925525263274,30.933755097239228,19.94563022754526,0.07216233218428475,3.171504083093369,173.4894052734375,172.2703043823242,171.28500366210938,170.29970294189454,169.08060205078124,0.02,1.0,182.69473230988726,0.03684387172631309,0.03177132057471922,169.42952619280135,169.96461050851005,2.8106437767131616
2024-04-12,0,175.84500122070312,168.19499969482422,177.0374984741211,169.57687282562256,172.16000175476074,0.7731477726136033,2.3497217479130814,-0.24408121798414317,2.9956386499899796,171.0974998474121,1.8809999465942382,0.013707475556443628,168.858247756958,175.02649993896483,0.736935974327022,-0.007612642812683228,1.0258197840218275,1.0357577923296672,1.037430576934239,0.0366538600423314,51.895219659664946,176.11844316776222,171.41899967193604,166.71955617610985,170.47285733904158,2.6240068051497345,170.45178549630302,1.9227886670185774,169.92621145220153,170.7396789768733,1.7039497153216687,-1.3993541442411195,101593300,1.7041529212054152,1.584809225757937,-1095589400.0,-16.0888671875,78.30330443471131,85.07633588200967,147.27184733400745,34.49979741303662,18.119320075242808,0.08972706207649028,3.241485001410523,175.70500061035156,174.06250061035155,172.73500061035156,171.40750061035158,169.76500061035156,0.04,0.0,182.57592911601623,0.0411016561953772,0.04578839415775313,170.4127698625837,170.26884569440568,3.0111034121360527
2024-04-15,0,174.29500198364258,168.19499969482422,177.0374984741211,169.57687282562256,172.44000148773193,0.7191365921025505,2.5190281196715207,-0.6230655927810749,2.995624844885589,171.0974998474121,2.026412773132324,0.014683255574111905,168.858247756958,175.20150451660157,0.6513550475175189,0.024290117428461787,1.0159545419246394,1.0240027885628848,1.0207972270441392,0.03298170127721245,64.89309039554495,176.59593091890846,171.55787467956543,166.5198184402224,171.09178597586495,2.971511632898141,170.70839255196708,2.1811800690909777,171.4173823664136,171.45328988642683,3.7892908200087425,2.3619313294752198,73531800,1.908219340611671,1.1918060598280749,-1169121200.0,-50.39998372395833,78.30330443471131,85.07633588200967,64.86137391434464,31.41677836036935,20.200160320814483,-0.0594776011579947,3.3050255663738546,175.70500061035156,174.06250061035155,172.73500061035156,171.40750061035158,169.76500061035156,0.04,0.0,182.4600336443886,0.025170634517028834,0.018339467507220333,170.9642377580915,170.39994376046317,3.01223325245017
2024-04-16,0,170.79000091552734,168.19499969482422,177.0374984741211,169.57687282562256,174.21437549591064,0.5696435478840595,2.5888702192770356,-0.9375627955708095,2.995618904455646,171.0974998474121,2.170513134002687,0.01507884665888802,168.858247756958,175.20150451660157,0.7045819711214155,-0.00476790313418115,0.9947645175491883,1.0011709419627857,0.9937913508769082,0.009397163980014334,56.77277251532652,176.8666154461835,171.6888750076294,166.51113456907532,171.25785773141044,2.9078390112621566,170.7521424974714,2.1758485951390347,172.1523164720225,171.9034914764988,2.549091957854006,2.1045378432420185,73711200,1.7848579296222185,1.1965493966703646,-1242832400.0,-79.82218424479167,78.30330443471131,85.07633588200967,-32.964621023332946,27.853533615063554,26.64789918675407,-0.03969799034863203,3.4612653943787355,175.70500061035156,174.06250061035155,172.73500061035156,171.40750061035158,169.76500061035156,0.04,0.0,182.30087413405175,-0.0017091323130951075,0.005520966523305824,170.9357408796038,170.37643105643136,3.0175098954769286
2024-04-17,0,169.06499862670898,168.19499969482422,177.0374984741211,169.57687282562256,172.44000148773193,0.7821516944940952,2.470524219057188,-0.47192936546450337,2.995628862813247,170.74625205993652,2.0020624732971184,0.01440775183571795,168.858247756958,175.0979995727539,0.6483330592472619,-0.02414077929809134,0.9859634346143739,0.9899462393982957,0.9819369703937885,0.005172561214443316,46.02849146610899,176.4129232473795,171.47187480926513,166.53082637115077,171.30571474347795,2.8616923392105353,170.55267797197615,2.194639481634539,171.80999395297226,171.73703660585804,0.6853265527287069,0.3599178687073467,50901200,1.945272750202436,0.8291793891388858,-1293733600.0,-92.08889431423611,78.30330443471131,85.07633588200967,-77.68462463901317,26.30277716581578,25.731535919739276,-0.11295325926818955,3.4032585046416837,175.70500061035156,174.06250061035155,172.73500061035156,171.40750061035158,169.76500061035156,0.02,1.0,182.1789984932853,0.0013112642449093492,-0.009842589788500174,170.87161690848214,169.9980981009347,2.9132745281949304
2024-04-18,0,167.56499862670898,168.19499969482422,177.0374984741211,169.36874675750732,171.80499935150146,1.032507830309566,2.382635033435181,0.1516974232763082,2.995635853863082,170.59500122070312,1.885750045776365,0.013919344157798538,168.858247756958,174.45000190734862,0.5131718409597646,-0.04503283155335314,0.9789140392699821,0.9813699784603631,0.9722423576153056,-0.02436682022294623,40.227362502770696,175.9396448379885,171.17437477111815,166.4091047042478,171.07214300973075,3.1174972248198944,170.27214241027832,2.31308847996112,171.12054426804033,171.32809842305886,0.19854150736769224,-1.6248946509180522,43122900,1.897047134759962,0.7084143018440368,-1336856500.0,-95.8510555828316,78.30330443471131,85.07633588200967,-127.59760880707856,25.11513881217688,27.702285016299264,-0.1766023542215367,3.30936549693921,175.57284118652345,173.84858154296876,172.4550018310547,171.06142211914062,169.33716247558593,0.04,0.0,182.06621495171217,-0.04570379662451962,-0.0044105414996169325,170.49684579031808,169.68175070626395,2.4503914503551534
2024-04-19,1,165.42250061035156,167.56499862670898,175.84500122070312,169.16625022888184,171.75937461853027,0.8574761379433087,2.0940864115194415,0.11685610546648562,2.995657284734183,170.33250045776367,1.6400756263732916,0.012267587659888285,168.6764995574951,174.19825019836426,0.4992236111895853,-0.038019383556747846,0.9690789338931589,0.9701843809851637,0.9644951976855558,-0.059270951906504776,38.4115750293842,174.88892260178645,170.70074977874756,166.51257695570868,170.67607171194894,3.6709474698054323,169.91035679408483,2.648586291782657,170.22116224523342,170.7153638940038,-0.9663133149279451,-2.290186418732082,67772100,1.8287397093790974,1.1496155259951448,-1404628600.0,-93.55743524096707,78.30330443471131,85.07633588200967,-194.04524906512296,23.49696909356652,31.29387020854036,-0.11854548975202421,3.284388330707068,174.9899208984375,172.90504107666015,171.22000122070312,169.5349613647461,167.45008154296875,0.06,0.0,181.86572026609068,-0.06542059637737352,-0.057358276998713056,170.10069928850447,169.32336643763952,2.731301276331589
2024-04-22,1,165.8474998474121,165.42250061035156,175.84500122070312,169.01687335968018,171.5568723678589,0.45297800751316397,2.231201295731177,0.8091341825890477,2.9956465704699546,170.07000160217285,1.6645005226135254,0.01310447866224599,168.1319995880127,172.10125198364258,0.5458689478908715,-0.03705157779411047,0.9740694517771155,0.9750816847031027,0.9788700163671682,-0.04846669175874163,35.10543388558288,174.72490240072747,170.26249980926514,165.8000972178028,169.8328574044364,4.042273363277799,169.6942855290004,2.855105564252699,169.01922717644618,169.8559828922392,-1.648383774489803,-2.9708915019430093,48116400,1.8143840071937365,0.8324282392133484,-1356512200.0,-87.67510744197278,78.30330443471131,85.07633588200967,-144.43768220796548,24.10589614965639,29.568021874618175,-0.15658182612775032,3.2275994210332253,174.9899208984375,172.90504107666015,171.22000122070312,169.5349613647461,167.45008154296875,0.06,0.0,181.73288858238786,-0.03966652537887494,-0.06066283407053768,168.78970990862166,169.1096180507115,2.8505096236014746
2024-04-23,1,166.05500030517578,165.42250061035156,175.84500122070312,168.8368730545044,170.96562480926514,0.41352056973478535,2.3975780382766922,0.5361913052701586,2.9956329621046063,169.79500007629395,1.77080078125,0.0141062629768903,167.39324874877929,172.10125198364258,0.6469241239495398,-0.02844131319575164,0.9769923921292119,0.9779590399230773,0.9899664988081305,-0.027724109051872947,37.283570145108555,174.76065595448307,169.9654998779297,165.1703438013763,168.43428584507532,3.226818810355373,169.45357159205847,3.017026505658917,168.2262550573517,169.12323748911479,-3.436681311550446,-1.791290917653454,49537800,1.8128619187367554,0.8605551278742867,-1306974400.0,-80.25215471644081,78.30330443471131,85.07633588200967,-117.55975654227737,22.940397108249652,28.138433821255045,-0.12613156645892734,3.1491405557874077,174.9899208984375,172.90504107666015,171.22000122070312,169.5349613647461,167.45008154296875,0.06,0.0,181.60127152367426,-0.014641770938735865,-0.0335283459185766,167.41459437779017,168.91368212018693,2.915922561528353
2024-04-24,1,167.7675018310547,165.42250061035156,175.84500122070312,168.5962495803833,170.96562480926514,0.44051428766754896,2.5361040774976567,0.21789970770852296,2.9956208777957043,169.52624702453613,1.9059382438659669,0.014941715599047181,166.0342502593994,172.10125198364258,0.7000190704791306,-0.024224714387217093,0.9884193323783506,0.9898780505997805,1.0058546458148576,-0.007674544146888396,38.409626560351455,174.8053328879665,169.7331247329712,164.66091657797588,167.50178582327706,1.9357974687062438,169.296785899571,3.0454444311298823,167.68371074119847,168.60573399525882,-5.567403592690082,-1.9890778859319815,48251800,1.8145092942452201,0.8449203488716707,-1258722600.0,-65.40614241110259,78.30330443471131,85.07633588200967,-49.55891090802021,26.443160646569737,26.16225659836362,-0.0494055044155254,3.1449130040319124,174.9899208984375,172.90504107666015,171.22000122070312,169.5349613647461,167.45008154296875,0.06,0.0,181.49074377697653,0.006071428864103945,-0.002125419818731511,166.8916255405971,168.92793164934432,2.919708826497017
2024-04-25,1,169.5449981689453,165.42250061035156,175.84500122070312,168.08812522888184,170.96562480926514,0.541885145249651,2.569165967757135,0.1609746693259897,2.9956178540267926,169.31249809265137,1.95938793182373,0.015147256707372605,166.0342502593994,172.10125198364258,0.7272786836308993,-0.02379878739874374,0.9996012881012915,1.0006181988752467,1.018095663105099,0.0118163074536064,43.4256226061498,174.75095667611484,169.61262474060058,164.47429280508632,167.32392828805106,1.6137325323521188,169.29089300973075,3.044835039575754,167.7069345370232,168.50789796491196,-3.745087396826497,-1.2914611606195987,50558300,1.8163112456077415,0.8929035184071733,-1208164300.0,-59.313739108878096,78.30330443471131,85.07633588200967,0.5712668779268703,27.965706932840078,24.67641973743938,-0.07569635786928094,3.095959247333185,174.9899208984375,172.90504107666015,171.22000122070312,169.5349613647461,167.45008154296875,0.06,0.0,181.38861459421094,0.017061785589412626,0.01124997643962539,166.96429879324776,168.95001983642578,2.7922838842557316
2024-04-26,1,169.92499923706055,165.42250061035156,175.84500122070312,168.08812522888184,170.56312465667725,0.6786875044398623,2.51704182742208,0.5114628267954422,2.9956223676884126,169.31249809265137,1.832200222015382,0.014850067164059566,166.0342502593994,172.00450019836427,0.7215225646052511,-0.011356172202212536,1.0025251165998894,1.004167651958753,1.017956891954487,0.027218175339487338,49.744469816503646,174.5310832047099,169.49699954986573,164.46291589502158,167.44678551810128,1.7913394886055949,169.37625013078963,3.044651715954131,168.16484257397886,168.65697859897085,-0.7289670003560742,-0.04863625204143736,44838400,1.8692500110759944,0.806726946649049,-1163325900.0,-63.44536647810449,78.30330443471131,85.07633588200967,17.815678825016,28.26285576693706,23.418761253318845,-0.12052586236091747,3.0290648266774918,174.9899208984375,172.90504107666015,171.22000122070312,169.5349613647461,167.45008154296875,0.06,0.0,181.30242650826884,0.026060631682314206,0.013529717850344507,167.14954703194755,169.01058197021484,2.7526715384349787
2024-04-29,1,174.0,165.42250061035156,175.84500122070312,168.08812522888184,170.09375095367432,0.7805250218680159,2.4777844390716868,0.8111082827553471,2.995625717667646,169.31249809265137,1.7466249465942383,0.014625218706895602,166.0342502593994,172.00450019836427,0.7266811403939017,-0.0032993621380876226,1.0270417453881706,1.031858635273584,1.0367757473518098,0.04915660567743618,51.76792950992658,174.3741935653382,169.41862468719484,164.46305580905147,168.36607142857142,3.062363536851386,169.71910721915108,3.2841230907762937,168.60066270433126,168.87597528356503,0.5086804586030376,0.7082319078209253,68169400,1.859614607102401,1.2027682792790066,-1095156500.0,-34.03362062885877,78.30330443471131,85.07633588200967,151.23394310019745,34.3124864705293,19.998744103512088,-0.1464714949056801,3.293565550087022,174.9899208984375,172.90504107666015,171.22000122070312,169.5349613647461,167.45008154296875,0.02,1.0,181.22216896963468,0.046189178541638176,0.05151512454493234,168.07008797781808,169.28346688406808,2.900831003729764
2024-04-30,1,172.16250228881836,165.42250061035156,175.84500122070312,168.08812522888184,170.16937637329102,0.6803478918790533,2.6647508176475285,0.07902274006124532,2.995609256528895,169.31249809265137,1.944100570678711,0.015712506891967726,166.0342502593994,174.02950019836425,0.6491612967965624,0.030363158687974984,1.0151435120449888,1.0211405069494777,1.0159567232203282,0.03677999441400881,63.78612157699587,174.92375136063686,169.5942497253418,164.26474809004674,169.32892881120955,3.0421220754234843,170.00250026157923,3.313538095910134,169.95030187644574,169.67987747751783,3.8403016298329202,2.836878968922505,65934800,2.0304972862822495,1.1465456154735003,-1161091300.0,-56.23248925580272,78.30330443471131,85.07633588200967,62.451070431908185,30.72916299831534,24.398002724343478,-0.1983520425852989,3.414803043693772,174.9899208984375,172.90504107666015,171.22000122070312,169.5349613647461,167.45008154296875,0.02,0.0,181.11987101247283,0.020551370957534232,0.027074446148537355,168.82960728236608,169.46515328543526,2.9008511763100335
2024-05-01,1,170.1750030517578,165.42250061035156,175.84500122070312,168.08812522888184,171.0300006866455,0.5037294701662919,2.7161712656459724,-0.2519322233360062,2.995604599635155,169.4849967956543,2.066000747680664,0.016000184180528728,166.0342502593994,174.02950019836425,0.6994959660198687,0.01615763281935282,1.0024520273034427,1.0085311217729802,0.9970412628748826,0.014350223937455553,57.174755175817246,175.19109249314496,169.75874996185303,164.3264074305611,169.9471435546875,2.6282823300224223,169.89000047956193,3.2761699769595487,170.49764387508156,170.14888624294264,4.074416511416846,2.358870716247714,50383100,2.082457339692419,0.8740704681592841,-1211474400.0,-63.44536647810449,78.30330443471131,85.07633588200967,16.63101975255598,28.422996876712546,24.422330372351485,-0.23776714595159007,3.4280382414677684,174.9899208984375,172.90504107666015,171.22000122070312,169.5349613647461,167.45008154296875,0.02,0.0,181.03169523597566,0.0016566052155189137,0.014379983782614071,169.3226558140346,169.05618286132812,2.901721383640677
2024-05-02,1,172.46249771118164,165.42250061035156,175.84500122070312,168.08812522888184,171.0300006866455,0.4624124117534591,2.7164818778747137,-0.27985016567734444,2.9956045987456785,169.58624839782715,2.0738757133483885,0.01599847978021936,166.0342502593994,174.02950019836425,0.7065338105549914,0.0012502847626454253,1.015702628076108,1.021415885469683,1.0076009917983302,0.01720781841838326,50.89934180047972,175.22921409907218,169.79625034332275,164.36328658757333,170.86250032697404,2.111882625831067,169.6483930860247,2.907169343010722,170.4014184276245,170.25598624805394,2.609326766051475,-0.9170287908251455,94214900,2.1330633356663333,1.579000072820279,-1117259500.0,-28.685300622388226,78.30330443471131,85.07633588200967,72.68025768990435,27.47559244261714,22.354639218953068,-0.13008287482167147,3.4774859625776973,173.66820416259765,171.83590371704102,170.3550033569336,168.87410299682617,167.04180255126954,0.02,0.0,180.90196401053694,0.01848248352801085,0.023724914477212717,170.19617353166853,168.80538395472936,2.9926666627060516
2024-05-03,0,184.92250061035156,165.42250061035156,175.84500122070312,168.08812522888184,171.8531255722046,0.3414463881752711,2.778076784225207,-0.5443705691526723,2.9955988595326613,169.58624839782715,2.21137550354004,0.01634920165506384,166.0342502593994,174.02950019836425,0.6821718246683133,0.01671308666003206,1.0882835457265803,1.0920431997111453,1.0767271251999477,0.0882595347396069,56.766823391894505,175.4774037210383,169.9212501525879,164.3650965841375,173.31321443830217,5.366918483361896,170.40750013078963,4.910829586800595,170.9086913746879,170.5790129698239,3.858659717702065,-1.9235710347410462,163224100,2.1902774958742675,2.4834064628109256,-954035400.0,-15.79404627567681,78.30330443471131,85.07633588200967,293.1464312291939,43.94306381645917,17.075562133940217,-0.19706407612475405,4.227264335864704,181.5908804321289,178.24456069946288,175.54000091552734,172.8354411315918,169.4891213989258,0.04,0.0,180.98984521793858,0.08316591981897115,0.07940428463057048,172.2424534388951,169.5670394897461,4.25339740554072
2024-05-06,0,182.17000198364258,165.42250061035156,184.92250061035156,168.08812522888184,172.23750114440918,1.6941043793316641,4.2872402745509754,3.527196470026727,2.9954210913581445,169.73499870300293,3.0739502716064466,0.02511770308184087,166.0342502593994,174.45000190734862,0.3845055916718468,0.0959669360045363,1.0672814508215853,1.0635413038645867,1.0424934760184015,0.046954034388750454,74.73380780489221,179.26048080087196,170.68600025177003,162.1115197026681,175.11678641183036,5.976286650408171,171.2203573499407,5.834058100523087,174.41788149098502,172.4749567749184,10.225459991990768,6.097420181736688,78569700,3.4960001730771535,1.1591340614400936,-1032605100.0,-23.080251783354473,78.30330443471131,85.07633588200967,193.1569447502617,41.11389501737146,19.791468915441182,-0.19395266733938468,4.19530440730642,181.5908804321289,178.24456069946288,175.54000091552734,172.8354411315918,169.4891213989258,0.04,0.0,181.0034343633957,0.04732001488983473,0.07330191013142556,173.92679050990515,170.44554465157645,4.8974945254141415
2024-05-07,0,183.01749801635742,165.42250061035156,184.92250061035156,168.08812522888184,172.84687328338623,1.3351195847859496,4.932713538993237,1.3531617688282411,2.9953230244949802,170.05000114440918,3.6743502807617174,0.028786012489827525,166.0342502593994,176.47750129699708,0.6147716406143409,0.0766548532046106,1.06804174661866,1.058403221559631,1.037640624252418,0.06305087102723927,68.03085261830785,181.2234274518268,171.35800037384033,161.49257329585384,176.98714338030135,6.127464894912706,172.2169644492013,6.581400585664968,176.37007264899643,173.7679725498696,7.446402990972884,6.66315417009909,77305800,3.587403313763035,1.1119004260718641,-955299300.0,-20.069836260930515,78.30330443471131,85.07633588200967,168.77068481700792,39.78531641754647,18.571918609665794,-0.22720149679659946,4.151337307537578,181.5908804321289,178.24456069946288,175.54000091552734,172.8354411315918,169.4891213989258,0.04,0.0,181.02549080422742,0.07086228065157152,0.0512967504928158,175.79352024623327,171.4715336390904,5.481867772964282
2024-05-08,1,182.52750396728516,165.42250061035156,184.92250061035156,168.08812522888184,174.07375049591064,1.052762393697284,5.5153151251453725,0.16084428709475374,2.995223969471739,170.48250198364258,4.2484001922607435,0.032056676438968916,166.0342502593994,182.25475158691407,0.6809160365891133,0.08812686672271701,1.0609049534114607,1.0453154940474985,1.0222795565739904,0.0725870468283194,69.51619521349687,183.07950548680196,172.04887523651124,161.0182449862205,178.20535823277064,6.280382075720798,173.28571483067103,6.971193990805374,178.04859726059155,174.8852856751562,7.704869111714204,8.252742733849473,45057100,3.5653171859364883,0.650238219554525,-1000356400.0,-18.586364952715602,78.30330443471131,85.07633588200967,136.96616921078788,38.62542834798323,18.030478984097037,-0.19710388804687298,3.970467787757576,181.5908804321289,178.24456069946288,175.54000091552734,172.8354411315918,169.4891213989258,0.04,0.0,181.0350125304674,0.07938572055637971,0.07285855555303092,177.11020987374442,172.59014892578125,5.905920617851388
2024-05-09,0,183.47500228881836,165.42250061035156,184.92250061035156,168.7406244277954,174.68250179290771,0.7948726948376044,5.886647127371099,-0.5477376727005128,2.9951567598537223,171.27000045776367,4.741900463104249,0.034073047639914526,166.0342502593994,182.57650337219238,0.7568641136853178,0.06275111480224255,1.061988659835331,1.0419343535317027,1.0135620474248508,0.06385448850496811,67.27394221500238,184.53879470487647,172.76550045013428,160.9922061953921,179.82142966134208,5.910871714964048,174.5751792362758,7.073686212513526,179.192469378396,175.8862839765831,4.900864349014458,8.92937395231848,48983000,3.513660643472024,0.7290345995626805,-951373400.0,-10.931143242510458,78.30330443471131,85.07633588200967,130.38825761161567,39.74280560349526,17.181378930044463,-0.22937166246042723,3.8689745211768414,181.75372100830077,178.50814163208008,175.88500213623047,173.26186264038085,170.01628326416017,0.04,0.0,181.055238278134,0.06669374297656638,0.09019493818153956,179.13939121791296,173.98449925013952,6.4715951278331305
2024-05-10,0,183.79249954223633,165.42250061035156,184.92250061035156,168.7406244277954,177.426251411438,0.6052612950747682,6.323925571109464,-1.0237039321936532,2.9950714792310063,171.47625160217285,5.34385055541992,0.0364803098354276,166.0342502593994,183.06324844360353,0.7915153253193586,0.04339049171229393,1.0602286907611693,1.0355454997664075,1.0031109616159208,-0.006110673738380035,67.20305295317846,185.99960170679412,173.35175056457518,160.70389942235624,181.766786302839,4.200305326423802,175.85696492876326,6.9959682811311374,180.2717485552282,176.84069451803103,6.570826892967811,10.912966260248355,50759500,3.4162805308531032,0.7851775093308423,-900613900.0,-17.889477448714093,78.30330443471131,85.07633588200967,112.6326441896256,38.34089678727309,16.226162329328496,-0.2632793036131446,3.8040284422469344,181.7891195678711,178.56543930053712,175.95999908447266,173.3545588684082,170.13087860107422,0.04,0.0,181.07318278421707,-0.0004456183379869527,0.059343974723905346,181.1341269356864,175.22839137486048,6.829058085267126
2024-05-13,0,185.86000061035156,165.42250061035156,184.92250061035156,168.7406244277954,182.25937747955322,0.5156721677619677,6.706248938416893,-1.2877905248084716,2.994992028649522,171.47625160217285,5.820700454711914,0.038597310460498864,166.0342502593994,183.50675201416016,0.8200739315826076,0.05449093462522282,1.0697032292749487,1.0390757538405675,1.0156478371582915,0.02025579725821336,68.75149063861912,187.16162335748564,173.74912548065186,160.33662760381807,183.6807152884347,1.3164432541357984,177.27160780770438,6.862560904556033,181.14114795532873,177.5198730032835,8.002054500528981,10.820181016496784,72044800,3.3854435910338827,1.1157140973333748,-828569100.0,-3.925358296683621,78.30330443471131,85.07633588200967,120.21654356803874,39.19567027292777,14.997552951924408,-0.1929891641412408,3.821602760251496,182.16996624755856,179.1200263366699,176.6550064086914,174.1899864807129,171.14004656982422,0.06,0.0,181.12560771899675,0.026540349473526792,0.01719200886698743,183.05824061802454,176.62720707484655,7.428932027729448
2024-05-14,0,187.38249588012695,165.42250061035156,185.86000061035156,168.7406244277954,182.65000247955322,0.41121605808887857,7.208201412520417,-1.4893405507246147,2.994881901366492,171.47625160217285,6.547337913513184,0.041348648744841704,166.0342502593994,183.90549964904784,0.8267765960481561,0.0882370139589017,1.0748885276181468,1.0406872000292775,1.0198547087103706,0.023850166847868337,74.1860075073831,188.74377823702812,174.3273754119873,159.91097258694649,184.0321431841169,1.9015246010510123,178.67267881120955,6.774679532558192,182.30266771083578,178.09057100245542,7.768357223728931,11.926771412350224,52393600,3.2650257912348706,0.8250059619473055,-776175500.0,-4.317667397927077,78.30330443471131,85.07633588200967,114.21653121155309,39.985498331211886,14.411432621376685,-0.15612076879846104,3.6928851684642297,183.54460089111328,180.60269955444335,178.2249984741211,175.84729739379884,172.9053960571289,0.08,0.0,181.17332741639964,0.02897061433244441,0.032877676183895366,183.67158726283483,177.95702035086495,7.9302585754839825
2024-05-15,0,188.9124984741211,165.42250061035156,187.38249588012695,168.7406244277954,183.13187408447266,0.26290628238392366,7.691946956789115,-1.6056806701874549,2.9947713119919386,172.3125,7.189150161743163,0.04391458491383867,166.0342502593994,185.01625061035156,0.8308075472410525,0.10834588709791147,1.078532392660993,1.0403902339380424,1.0233197351444685,0.034980999400399115,77.36480376898587,190.54089407379556,175.15700016021728,159.773106246639,184.995356968471,2.434153076396791,180.05607169015067,6.74478811215303,183.55626406095135,179.00935911182557,1.3302844497862503,11.691772145969585,70400000,3.213321056642753,1.091779666766824,-705775500.0,-4.317516089385205,78.30330443471131,85.07633588200967,114.55507407108765,42.01076466734029,13.489561338379271,-0.09065763208356414,3.6633864768719384,185.56655548095705,182.42171646118166,179.87999725341797,177.3382780456543,174.19343902587892,0.1,0.0,181.25577703424406,0.03960447011551982,0.041542474981910084,184.84966823032923,179.3882293701172,8.41825465008794
2024-05-16,0,190.2675018310547,165.42250061035156,188.9124984741211,169.10062408447266,183.55437660217285,0.12042850249496122,8.110875564299574,-1.6234597828634427,2.9946736291213005,173.23124885559082,7.6715624999999985,0.04604544045230702,166.0342502593994,186.0122501373291,0.8287932094154128,0.12739832317230376,1.0801486049339495,1.0371500045707185,1.0235791714050122,0.037021389603494104,80.25718305277216,192.37112628118703,176.14937515258788,159.92762402398873,186.031071799142,2.9418037590424673,181.50910758972168,6.583630379898204,184.8827928335783,180.08554990237525,3.701211185738439,11.423221277148373,52845200,3.161849819569035,0.8134036469344365,-652930300.0,-5.729920194956925,78.30330443471131,85.07633588200967,109.1168988262849,41.69489466788684,13.093561372180144,-0.10285602308305773,3.5045392964932094,185.91036480712887,182.69982400512694,180.1050033569336,177.51018270874022,174.29964190673826,0.12000000000000001,0.0,181.32382178372333,0.029947876737476564,0.040262012389084056,185.94655282156808,180.87003653390067,8.689311629805069
2024-05-17,0,189.8424949645996,165.42250061035156,190.2675018310547,169.82999897003174,184.07499980926514,-0.009911182262225307,8.41304298804852,-1.572708927160514,2.994605502943479,178.0850009918213,7.948250007629395,0.04745503962954651,166.0342502593994,187.53549613952637,0.8161733766086223,0.15019118396248213,1.0708352655174975,1.0248862290075087,1.013883006078677,0.03291753165897271,83.52429533969917,194.1105862889022,177.28450031280516,160.45841433670813,187.07607051304407,2.784871599363903,182.64071437290735,6.555125007959999,186.21188818937713,181.31348013385485,3.961371941632208,11.971459576477345,41282900,3.066725129551367,0.6486582375301936,-694213200.0,-5.593500132187171,78.30330443471131,85.07633588200967,97.75679691208659,40.25436994744345,13.658609085254783,-0.09895503816550047,3.370617336384613,185.91036480712887,182.69982400512694,180.1050033569336,177.51018270874022,174.29964190673826,0.12000000000000001,0.0,181.3748052180813,0.03725759952330465,0.03011065315279864,186.99926539829798,182.0547376360212,8.64537182256744
2024-05-20,0,190.3249969482422,165.8474998474121,190.2675018310547,170.1125020980835,185.15687561035156,-0.13987679412745269,8.374858902976994,-1.5413642797295244,2.9946286915855533,182.34875297546387,7.8609497833251964,0.04691653143205792,167.59625167846679,189.00549812316893,0.8218048948291794,0.14468107833560398,1.0662136287996948,1.024769166190451,1.0099335039111148,0.02402343873468138,81.65242961064378,195.25521783647153,178.50550003051757,161.7557822245636,188.05464117867606,2.497254684048495,183.93803542000907,6.1035822642789945,187.11986653766553,182.42139771971782,4.007610271504911,9.104882163562994,44361300,3.08541754201653,0.6990900355405004,-649851900.0,-3.857978855771315,78.30330443471131,85.07633588200967,96.53368222561231,40.122940292665255,12.807855905648001,-0.0801049881623647,3.3377102801800786,186.5368387451172,183.2065791015625,180.51499938964844,177.82341967773436,174.49316003417968,0.14,0.0,181.4333601669606,0.025552873347169713,0.04364925668652464,187.9581538609096,183.54877253941126,8.560397687288797
2024-05-21,0,191.77249908447266,166.05500030517578,190.3249969482422,171.66562747955322,186.2406244277954,-0.2667099914144275,8.222783526373556,-1.4723749114810347,2.994680877224681,182.7725009918213,7.574249649047852,0.04575091596245373,169.36724853515625,189.8849956512451,0.8111990206457953,0.14615637348145508,1.0670069887383846,1.028048905547864,1.0128151716716942,0.023428032504989593,82.07175236858534,196.1749419383062,179.72937488555908,163.28380783281196,189.19464111328125,1.9990457250203522,185.48071370806014,4.984113891409247,187.93081112891247,183.49758918685845,3.733475718202126,10.549622837703986,42309400,3.0810746788984558,0.6705734609696858,-607542500.0,-1.739879522617807,78.30330443471131,85.07633588200967,103.16732557528488,40.30831142099935,12.294887291004828,-0.0948405995464992,3.2285692197179445,187.57575659179685,184.38711712646483,181.80999755859375,179.23287799072264,176.04423852539063,0.16,0.0,181.4965566692627,0.026249854208229007,0.03258538755177575,189.28519112723214,185.20965903145927,8.458872104909599
2024-05-22,0,191.56500244140625,167.7675018310547,191.77249908447266,172.38749885559082,187.7649965286255,-0.35580544414498866,7.99143983135916,-1.3854236654775147,2.994752132849959,183.2462501525879,7.106924648284914,0.04414788167906327,169.88699913024902,190.27325134277345,0.8035826315382678,0.14308490614345257,1.058281015699557,1.0221392977722725,1.0070496056920841,0.014040913061390325,83.06478240498289,196.99812948724218,181.01524982452392,165.03237016180566,190.00964137486048,1.518020115248973,186.8451783316476,3.556337965206898,188.89804000711376,184.63519413532842,4.341852666518902,12.691344583755395,34648500,3.0796728371602713,0.5551381825190714,-642191000.0,-15.483967823667367,78.30330443471131,85.07633588200967,93.67297770207139,37.99924350744446,13.050767156309407,-0.1415652924965887,3.1800924855266377,189.89360516357422,188.0832038269043,186.62000274658203,185.15680166625975,183.34640032958984,0.18,0.0,181.54448446998612,0.006219686346410569,0.018513578419997984,189.94442749023438,186.50133405412947,8.250176458675565
2024-05-23,0,188.87250137329102,169.5449981689453,191.77249908447266,173.6156244277954,189.14499759674072,-0.4820306216706477,7.696559663832398,-1.2316714280979222,2.9948335795621452,183.63375091552734,6.499587154388427,0.04224118103129984,170.15000267028807,190.4489974975586,0.8078476423345539,0.12987705040120864,1.0365926947639588,1.0029365103936558,0.9901339276924119,-0.007331785219960141,81.61917016222189,197.5982441827063,182.2051248550415,166.8120055273767,190.22249930245536,1.1474860110326321,187.12732124328613,3.5487473496889304,189.53949609315595,185.58160738494539,3.0695156635746534,11.076323829088377,51005900,3.094096730644183,0.8169234793006727,-693196900.0,-47.903210126906274,78.30330443471131,85.07633588200967,57.058692937756035,34.36598853229109,19.767116720049568,-0.19447486270409964,3.265098104554276,189.89360516357422,188.0832038269043,186.62000274658203,185.15680166625975,183.34640032958984,0.18,0.0,181.59168346589067,-0.015592055022261908,-0.014969424149788451,189.86594717843192,186.76876722063338,7.7924247411083245
2024-05-24,0,189.35499954223633,169.92499923706055,191.77249908447266,180.12750148773193,189.14499759674072,-0.6744104411500093,7.246509836124691,-0.926979835153928,2.99494232823461,184.35750007629395,5.893199386596677,0.03956133915768027,171.9637523651123,190.4489974975586,0.7988591110632763,0.1115050888409716,1.0337579783233877,1.002624972986863,0.9941173566875013,-0.0025678940979688702,69.58323283313132,197.6645196875082,183.1715000152588,168.6784803430094,190.28571374075753,1.0730661738190517,187.64053535461426,3.286534239539674,189.36299208872376,186.02805622181194,0.7951679190553927,2.136030364018526,36294600,3.20874872982906,0.5853082227237234,-656902300.0,-24.695753014606225,78.30330443471131,85.07633588200967,67.49540125968834,31.610156932548716,18.181978412687258,-0.1482384650577168,3.2961665750209512,190.10600732421875,188.42700732421875,187.07000732421875,185.71300732421875,184.03400732421875,0.18,0.0,181.63173776153047,0.0005792934454393883,0.0007374283514005205,189.90304565429688,187.37635694231307,7.243522017742195
2024-05-28,0,190.9000015258789,170.1750030517578,191.77249908447266,182.4381284713745,189.47687339782715,-0.8691509005096824,6.686283474552234,-0.4955637665028907,2.9950657451329286,185.39125061035156,5.350449142456054,0.03631027773765026,172.4324981689453,190.4489974975586,0.8164730840806388,0.08824712380595591,1.036694316342416,1.0078372805700946,1.0027419221143405,0.0030211721363804234,68.63921832200013,197.51556697962206,184.14300003051758,170.7704330814131,190.37607084001814,1.0976256991004538,188.20357131958008,3.1037261417718915,189.35850369353005,186.51042707834253,0.23423599374810666,3.9441167482881765,52280100,3.1266120782569495,0.8540418621834238,-604622200.0,-26.06055161498692,78.30330443471131,85.07633588200967,75.54621075198152,34.149941770408425,16.66500961396961,-0.13289700668590498,3.339302599638607,190.27419927978517,188.58789883422853,187.2249984741211,185.86209811401366,184.17579766845702,0.19999999999999998,0.0,181.69711909721292,-0.005496132028715128,0.000632073514912564,189.92445155552454,187.9355021885463,6.921468951914621
2024-05-29,1,190.41499710083008,170.1750030517578,191.77249908447266,182.89499950408936,189.94874668121338,-1.1261876028977642,6.413360472684762,0.19659724782991583,2.995123079281536,186.62124824523926,5.0186991500854505,0.03466906214987841,172.4324981689453,190.96650161743165,0.7589400001920349,0.10883612277908622,1.0293370218116042,1.002608989052505,0.9995905167523108,-0.007078710399683663,73.4503211486276,197.81472105218106,184.9880001068115,172.16127916144197,190.45785685947962,1.072278137118279,188.76696368626185,2.681265738630958,189.73991365119304,187.10438571598223,0.33242655142749383,4.306967145194486,53068000,3.066625357267279,0.8761205235293947,-657690200.0,-24.885278840724297,78.30330443471131,85.07633588200967,70.76394073609629,32.12219853206117,15.675480531053262,-0.10594562174353474,3.2964905931553794,190.42996014404298,188.8400202331543,187.55500030517578,186.26998037719727,184.68004046630858,0.19999999999999998,0.0,181.76243126304058,-0.010709716791213242,-0.003925865709564143,189.98438153948103,188.49182346888952,6.115911704302508
2024-05-30,1,191.21499633789062,170.1750030517578,191.77249908447266,183.36062622070312,190.28187561035156,-1.4215571784590197,5.79191278768301,1.3882660684893962,2.995239400240925,188.12749862670898,4.470311584472657,0.031155961914797397,181.1992515563965,190.96650161743165,0.6563565092511172,0.11893635190896033,1.0285871631407402,1.0052162373468971,1.0052228372665029,-0.00182708792866626,73.45596762259765,197.48445042277814,185.9006248474121,174.31679927204607,190.5849996294294,1.1061294277910227,189.31982040405273,2.273058228310098,189.91577986792274,187.66137915351138,0.3015669048898797,4.321262802650616,49947900,3.007730549702106,0.8249059059883173,-607742300.0,-15.731439576852674,78.30330443471131,85.07633588200967,77.79392033299015,30.76520516806973,15.013274205518439,-0.07489129006499805,3.1960158863112116,190.43468115234376,188.8476618652344,187.56500244140625,186.2823430175781,184.69532373046874,0.19999999999999998,0.0,181.82768477831118,0.002042915223779529,-0.005510879119796765,190.02005440848214,188.98910413469588,4.831084639135724
2024-05-31,1,191.5425033569336,172.46249771118164,191.77249908447266,183.71312522888184,190.34749698638916,-1.438077272564715,4.63539843167417,2.1534818960975404,2.9954210666702292,188.89249992370605,3.7393491363525415,0.024794508468553803,182.4917537689209,191.2499969482422,0.5148416876569553,0.1087337761865962,1.0245510265352127,1.0057205937790747,1.0073152417253388,0.014136531068466907,73.89756160595726,196.22342137506706,186.95262451171874,177.68182764837042,190.55214309692383,1.0677262005862584,189.87339210510254,1.693134985428332,190.26321489785738,188.3462588898622,0.467620861116035,4.218555090621176,75158300,2.9942267029968614,1.2611090980525272,-532584000.0,-8.94987545339335,78.30330443471131,85.07633588200967,79.92677030579817,28.9138744515529,15.73866145777668,-0.08287902878005388,3.157725388746552,191.02231884765624,189.79883813476562,188.80999755859375,187.82115698242188,186.59767626953126,0.19999999999999998,0.0,181.92634518808114,0.028734981045037467,0.007071740422289288,190.0057830810547,189.64548710414343,3.69890648093499
2024-06-03,1,193.6100006103516,182.17000198364258,191.77249908447266,184.64000034332275,190.53624820709229,-0.511726750011698,3.336459611274785,-1.3202004022565992,2.9955741452683835,189.1337490081787,3.010549545288086,0.01775594455454882,182.9684986114502,191.54475326538085,0.8746157826882769,0.03579879530469348,1.0303521806248055,1.0158961769667736,1.0153367772806545,0.022471025736852335,67.26082137659115,194.57954401655593,187.90662479400635,181.23370557145677,190.84428569248743,1.5581726949770518,190.42696353367396,1.540028278596226,190.60419583560252,189.00685592711432,-0.1199315483904463,4.216713866996668,50080500,1.2855418282217679,0.9284516323334873,-482503500.0,-11.034544446861194,78.30330443471131,85.07633588200967,118.88313178891168,32.63138088117071,14.753785494112138,0.019865781900804354,3.127885423827031,192.93680261230472,191.66660083007815,190.63999938964844,189.61339794921875,188.3431961669922,0.2,0.0,182.00618959544488,0.021318039834565816,0.03825979252539481,190.45240783691406,190.19841766357422,3.7864134085775603
2024-06-04,1,194.33500289916992,182.17000198364258,193.6100006103516,185.34312534332275,190.97875022888184,-0.5751884329648409,3.4820189581610284,-1.05763609107546,2.9955607484717914,189.59874725341797,3.0161996269226123,0.018487843655759537,182.9684986114502,191.58575210571288,0.8015412672638291,0.06279847670933349,1.0318252696530197,1.0176885301290501,1.0146108084668675,0.017993721036326793,77.23263404573656,195.3050377103284,188.34099979400634,181.37696187768427,191.62464305332728,1.760770798330111,190.92357117789132,1.6024801100896469,191.3420099498774,189.62562289138606,1.0675218035041876,4.169805216049476,47471400,1.1125244167270685,0.906204059987527,-435032100.0,-11.162266377294412,78.30330443471131,85.07633588200967,122.09207340883904,31.659849878025128,13.96711852356907,0.051187538049056874,3.0680318052161955,193.26916674804687,192.00042639160156,190.97500610351562,189.94958581542969,188.68084545898438,0.2,0.0,182.08333254943327,0.02294852610681719,0.023002486142397475,191.51831708635603,190.69213213239397,3.6598906671775104
2024-06-05,1,195.75999450683594,182.52750396728516,194.33500289916992,187.0018720626831,191.29687309265137,-0.584765194981102,3.4127453566396753,-0.7285118839916431,2.995568566369023,190.05499839782715,2.775399856567385,0.018061703656053002,183.42925186157225,191.95624923706055,0.7973612326398803,0.06183837614150415,1.036045364947616,1.023002635474363,1.0183978256804078,0.028070254377996928,78.30044006214284,195.77474055306206,188.9492498397827,182.12375912650336,192.53964233398438,2.0285942183725876,191.41267803737097,1.9489774924515724,192.0841555390996,190.34515148236716,2.89216348921155,3.7103289644997863,54156800,1.1114380984710626,1.0571834157631144,-380875300.0,-10.029210137671225,78.30330443471131,85.07633588200967,154.52388391106757,33.48084461891639,13.127730468940221,0.08149182905630643,3.0310256358296703,194.47627648925783,192.97685809326174,191.76499938964844,190.55314068603516,189.05372229003908,0.2,0.0,182.18192675102506,0.029323657578533613,0.030948902409705704,192.35877336774556,191.1309095110212,3.6090093435857225
2024-06-06,1,195.20999908447266,182.52750396728516,195.75999450683594,188.5,191.54812812805176,-0.48905341373419775,3.4352483154053433,-0.30417289954721527,2.995567602436129,190.29624938964844,2.6513495635986333,0.01811970043463306,183.76074981689453,193.68250083923343,0.7459020249405549,0.07249587186554894,1.0296625980117164,1.0180071607062051,1.0099201963178988,0.020892727155785273,81.78881076955943,196.4568712951173,189.58637466430665,182.71587803349598,193.15535627092635,2.100786545048791,191.76571355547225,2.1616235702280338,192.9964080973529,191.1215575607294,3.3825327982274644,3.624691901289355,41181800,1.095126587663668,0.8069534478949438,-422057100.0,-23.563785372348026,78.30330443471131,85.07633588200967,130.18815914365723,31.6114409000847,14.072181742549118,0.026030056178179172,2.980948705038689,194.47627648925783,192.97685809326174,191.76499938964844,190.55314068603516,189.05372229003908,0.2,0.0,182.25147552985504,0.016676240569811984,0.02201899469245891,192.9994572230748,191.46195438929968,3.3513450148845445
2024-06-07,1,195.65499877929688,183.47500228881836,195.75999450683594,188.90249919891357,191.61687660217285,-0.3990545390218336,3.2386249532158686,-0.1802356849123914,2.9955869892558016,190.36999702453613,2.427150268554688,0.017025635844127793,185.65325050354005,194.4225025177002,0.7573480716430541,0.06395964926699702,1.0285694726682792,1.0183920027287063,1.0080554722231867,0.021470406569239486,77.33493574627079,196.69774932659777,190.22049942016602,183.74324951373427,193.90392793927873,1.8839653277528456,192.1808923993792,2.316472038413006,193.55199490787095,191.78047580226988,2.2577252614686203,2.597657091123522,53103900,1.127626956720932,1.0363815415072526,-368953200.0,-0.48499576720203175,78.30330443471131,85.07633588200967,145.29398449405207,30.540140396126116,13.123861010868794,0.03146961546422369,2.968023104291621,194.50684301757812,193.00158337402343,191.78500366210938,190.56842395019532,189.06316430664063,0.2,0.0,182.34656249015654,0.024135283326323753,0.02927498067982884,193.9412253243583,191.96280343191964,3.36711424190351
2024-06-10,1,194.86749649047852,183.79249954223633,195.75999450683594,189.24437427520752,192.23187446594238,-0.2613786374003734,3.0527714274231252,-0.14984265625284454,2.995604121483072,190.6574993133545,2.3270006179809584,0.015997376922887212,187.23024635314943,195.25449905395507,0.7201829192804363,0.06454289085031183,1.0211602360314895,1.0107248433817908,0.9997614194683632,0.006494994453606129,78.11846868178338,196.9350420995362,190.82949924468994,184.7239563898437,194.42571367536272,1.4769473502408363,192.50535665239607,2.35434410362729,194.08169763661715,192.39303868456534,2.7518849661258926,3.061750645334248,97262100,1.1261993393977845,1.8157821780514647,-466215300.0,-39.17533881810862,78.30330443471131,85.07633588200967,86.24106136755557,26.943609723501407,16.128840860854282,-0.008557314803784535,3.123889454157765,194.78188348388673,193.2240637512207,191.96500396728516,190.7059441833496,189.14812445068358,0.02,1.0,182.49481602077515,-0.004690011564218111,0.0045253258929928595,194.20235116141183,192.11120278494698,2.8563478313717896
2024-06-11,1,200.39749908447266,185.86000061035156,195.75999450683594,189.7206211090088,193.79125118255618,0.04493522780181059,2.7114714348145514,-0.7314777295194692,2.9956319245421534,191.05749893188477,2.1868255424499536,0.01416775735430049,188.7235008239746,195.25449905395507,0.760284471329988,0.048463875231609554,1.0471005170783392,1.0364440838122402,1.0268080207649413,0.031196110298504776,70.96619960789225,196.80619196173117,191.38324909210206,185.96030622247295,195.69071306501115,2.207411602374407,193.1214280809675,3.1438999046944476,194.28314909654705,192.8319615283386,1.9101536085243338,2.3867067463931892,172373300,1.1140199454006443,2.9424641235616673,-293842000.0,-0.0487567765227407,78.30330443471131,85.07633588200967,264.76301399461215,38.06409936436953,11.985058397417681,0.11825345843192238,3.9036596457839514,202.3149239501953,199.31754412841795,196.89500427246094,194.4724644165039,191.47508459472655,0.02,1.0,182.93217625780926,0.06586048509235343,0.06761839466483908,196.32846069335938,193.16712188720703,4.334791426990801
2024-06-12,0,211.8849983215332,187.38249588012695,200.39749908447266,190.16125011444092,194.46812629699707,0.8779625227385944,3.0596162576036092,0.4593469086023534,2.9956060218965206,191.3787498474121,2.5064123344421416,0.015926366573746232,188.9084987640381,195.66549835205078,0.6070396718609055,0.06945687825970527,1.102935097288771,1.0905001632921696,1.0789650618847215,0.08237129274201216,81.2358437471512,198.2293565310153,192.1101240158081,185.99089150060092,198.3014270237514,6.317313708160558,194.57285635811942,5.874648773322669,195.81702044494494,193.8641575353123,4.622992585117283,4.49751661013753,198134300,1.5760992488373875,3.0080367934140106,-95707700.0,-21.239175779746123,78.30330443471131,85.07633588200967,358.0856701425429,50.520231734454484,9.496143205937036,0.08897304059838987,4.5748649177852805,212.27747882080078,207.37625997924806,203.41500091552734,199.45374185180663,194.5525230102539,0.04,0.0,183.67350624620784,0.08781342872373732,0.09632110682778351,199.04531860351562,194.74886322021484,6.183841055776841
2024-06-13,0,214.33250427246094,188.87250137329102,211.8849983215332,190.3106231689453,194.95312213897705,2.362768151287912,5.1278727928802645,5.856561027171582,2.9953875346468526,191.55375289916992,3.5037996673583978,0.026523217135760307,189.3107494354248,196.2237449645996,0.4776697491125898,0.12160391733191273,1.1086054158681027,1.0910407750721005,1.0737940113225701,0.09795863571370367,89.69448967561215,203.59099472363894,193.3352491378784,183.07950355211787,201.15821293422155,8.402232363823298,196.3914279937744,7.6475148118058796,199.84582566988692,196.25656950390515,9.439077348055397,10.6073633602997,97862700,2.8833380912981137,1.4553925781934043,2155000.0,-18.532309628123905,78.30330443471131,85.07633588200967,267.0330046436853,46.49393392173137,8.739331542436801,0.06632973485537877,4.615947712383992,212.61023608398438,207.9148755493164,204.1199951171875,200.3251146850586,195.62975415039062,0.04,0.0,184.03609131391786,0.10160434948418007,0.09378674192452698,201.88346208844865,196.70088958740234,7.620072446529178
2024-06-14,0,213.2025032043457,188.87250137329102,214.33250427246094,190.3924970626831,195.3212490081787,1.9692712107559338,6.763566931038819,2.8679905301249233,2.9951414170609123,191.66875076293945,4.586374454498288,0.03475513736545393,189.7937454223633,201.54624900817873,0.673282400472261,0.12647983607192376,1.0955583586407385,1.0726657265820982,1.0480515360215585,0.08968594993498114,90.56648609497852,208.13338328987302,194.6062494277954,181.07911556571779,203.64999989100866,9.09254458727234,198.0948211124965,8.560991707036868,203.4741494778407,198.60069482048036,10.290221048683986,13.479994554024735,70122700,2.8965380507095584,1.029621474504488,-67967700.0,-24.790976606944646,78.30330443471131,85.07633588200967,190.8646592712909,43.67696899502012,8.679512914542656,0.07476552620042923,4.5626627908317925,212.86039910888672,208.31980044555664,204.6500015258789,200.98020260620115,196.43960394287106,0.04,0.0,184.28043326760928,0.07923208853808417,0.09260602613916495,204.2550048828125,198.306889125279,8.463770781875777
2024-06-17,0,215.42749786376953,188.87250137329102,214.33250427246094,190.7787504196167,195.68124771118164,1.528574884702114,7.796191256077649,0.9081834602293481,2.9949545058528284,192.6912498474121,5.681250190734856,0.03982667584216832,189.7937454223633,212.01674880981446,0.7818364407900554,0.12304941653923213,1.100506752989322,1.072175996368064,1.0410293837150546,0.10550759743709026,86.73420059126609,211.34538200861527,195.75299949645995,180.16061698430462,206.5382140023368,9.175416267061493,199.84678513663155,9.439941697984288,205.90473609765644,200.48265234065866,8.910149768573207,12.594071305093848,93728300,2.9223701223762597,1.3252013818087114,25760600.0,-11.502113061204186,78.30330443471131,85.07633588200967,172.01013189963027,45.13423710431797,7.827025273198648,0.0942311946884228,4.698192391790314,212.9571563720703,208.47641601562498,204.85499572753906,201.23357543945312,196.7528350830078,0.04,0.0,184.63553860639144,0.12194495683682538,0.10046215744078119,207.4213409423828,200.2103990827288,9.49403757869555
2024-06-18,0,215.87749862670898,188.87250137329102,215.42749786376953,191.1362476348877,196.91937065124512,1.2176985173243862,8.760805229952982,-0.12728741071079996,2.994760705681623,193.97250175476074,7.008375453948967,0.04446381364419726,190.2279972076416,213.31550331115722,0.8113802861995167,0.1318928218470106,1.0956455048327736,1.0628744134469024,1.022878564053016,0.07724647070426327,87.86935190940606,214.55386010132437,197.03224964141845,179.51063918151252,209.42714255196708,8.32151917814166,201.66553524562292,9.923467571758776,208.2871383558782,202.43148554302297,10.356794669389972,12.848347900387845,79943300,2.924830044919415,1.1025644668098902,105703900.0,-19.511406312576018,78.30330443471131,85.07633588200967,133.89388415620257,41.32476625143915,7.166399846561195,0.049964467755316586,4.764753220061691,213.05155853271484,208.62921951293944,205.05500030517578,201.4807810974121,197.0584420776367,0.04,0.0,184.9246128935698,0.03446777549935898,0.10962096094988664,209.9041791643415,201.9227022443499,10.082405282878817
2024-06-20,0,211.67499923706055,188.87250137329102,215.87749862670898,191.46062660217285,203.2693738937378,0.9493602351397246,9.51983145614853,-0.8021351503194416,2.994596612608775,194.60124969482422,8.126325302124018,0.048004828147531486,190.3089973449707,214.4420036315918,0.8496122034590752,0.12569580965630775,1.0673951538229218,1.0312455099672186,0.988465753506161,-0.0009910993517058264,87.920026893519,217.34953763763886,198.30987472534179,179.2702118130447,211.82821437290735,5.294645622525575,203.12696402413505,9.771435928291947,210.18325209731785,204.209985789788,10.335795136123014,13.372109294729448,86172500,2.931037364632213,1.1535833842760985,19531400.0,-34.730956105154156,78.30330443471131,85.07633588200967,85.57893835572936,37.988332062174614,12.746970404373185,-0.007846829900681548,4.812986096883684,213.05155853271484,208.62921951293944,205.05500030517578,201.4807810974121,197.0584420776367,0.04,0.0,185.1860868566983,-0.015910322139732647,0.012213418115489967,212.26715959821428,203.23475537981307,10.266006956655382
2024-06-21,1,209.22000122070312,188.87250137329102,215.87749862670898,191.46062660217285,211.7274990081787,0.7007059937078859,9.819948106780476,-1.242758866766406,2.9945315942155086,195.0387477874756,8.766250247955323,0.04927095717587236,190.3089973449707,214.4420036315918,0.8899858529408126,0.10497740474179419,1.0497478813929206,1.01144291709574,0.9771932228621277,-0.023853139163898196,73.58954697210582,218.94489594653217,199.3049997329712,179.66510351941022,213.0885718209403,2.3530707303848644,204.3896424429757,9.289600718365042,210.5497213837229,205.02047392423125,8.625092973061964,10.69999910624982,246421400,3.163470429728274,2.889269114742212,-226890000.0,-45.31190756601936,78.30330443471131,85.07633588200967,61.852507815937656,35.29205972915867,14.425903206581742,-0.11809078070458277,4.8106297746525994,213.58019622802735,209.48489578247072,206.17499542236328,202.86509506225588,198.76979461669924,0.04,0.0,185.84707181131554,-0.0315066813080247,-0.026188569053971388,212.315678187779,204.3220694405692,10.213666027277919
2024-06-24,1,208.7874984741211,188.87250137329102,215.87749862670898,191.46062660217285,211.7274990081787,0.49426160087356774,9.877860000350973,-1.4763635008549028,2.994524071211521,195.43249893188477,9.051550445556641,0.04934297936081816,190.3089973449707,214.4420036315918,0.8924328814977189,0.10773140451609176,1.0429584168675563,1.0025617695928086,0.9798526774820706,-0.020708034210991433,68.39503005632425,219.943469672638,200.18774967193605,180.4320296712341,212.64607184273856,2.854868657937663,205.473749433245,8.807965309827138,210.20607026967264,205.13530899177923,4.402501117297656,9.229021002627315,80727000,3.14906072953576,0.9303073844985301,-307617000.0,-42.994639024960804,78.30330443471131,85.07633588200967,56.88768683949141,33.33076703784466,13.14188995108537,-0.1129562709397362,4.903445095723594,213.58019622802735,209.48489578247072,206.17499542236328,202.86509506225588,198.76979461669924,0.04,0.0,186.05848860875585,-0.020471622388637534,-0.02847278276122702,211.6122044154576,205.3287615094866,9.852433231120239
2024-06-25,1,209.5525016784668,189.35499954223633,215.87749862670898,193.0931262969971,211.7274990081787,0.3289335531243719,9.688995932642001,-1.6147234178178287,2.9945780942762488,195.7074966430664,9.093950500488278,0.04815999301842726,190.85150108337402,214.4420036315918,0.8913749713413087,0.10262469424553153,1.0415988496629518,0.9999296264033565,0.9875352093336739,-0.0272713383554124,67.003889865995,220.56149139226153,201.18349952697753,181.80550766169353,211.96321432931083,2.9541979075035694,206.5607136317662,8.248855197270297,209.84923400406177,205.27646494495366,-1.4618778450335057,7.839211722495094,56713900,3.164649004743173,0.64597722594242,-250903100.0,-39.67910307705284,78.30330443471131,85.07633588200967,54.53109088329589,31.718530610157398,12.506205999265728,-0.14411857566671013,4.784624274133054,213.58019622802735,209.48489578247072,206.17499542236328,202.86509506225588,198.76979461669924,0.04,0.0,186.20817909471495,-0.03507633078638861,-0.016094875174743856,210.8744877406529,206.37897491455078,9.62180437462894
2024-06-26,1,212.5625,190.41499710083008,215.87749862670898,194.15375232696533,211.7274990081787,0.16510813510366854,9.453207588301767,-1.702265445153852,2.9946416378999716,198.0787467956543,9.021963119506834,0.046753300425512644,191.18349685668946,214.4420036315918,0.8908791814849163,0.09770822421947079,1.0512832103672607,1.0072345552836457,1.0072978007259958,-0.015355924761946693,67.56845742328457,221.09978981039256,202.19337463378906,183.28695945718556,211.87178530011857,2.919146655783901,207.7608925955636,7.764647939981791,209.77222764307783,205.61858876533526,-2.230180909899587,7.830549593370178,66213200,3.162666670487597,0.7482379937252072,-184689900.0,-24.77717002532254,78.30330443471131,85.07633588200967,70.91563155094146,34.135855531541026,11.441155261287156,-0.11806132476987152,4.856438426928169,213.58019622802735,209.48489578247072,206.17499542236328,202.86509506225588,198.76979461669924,0.04,0.0,186.40427470003422,-0.0048531909384670335,-0.015784373530839297,210.9829319545201,207.6189684186663,9.467737343477149
2024-06-27,1,214.2200050354004,190.41499710083008,215.87749862670898,194.73437309265137,212.0543737411499,-0.021299154978611616,9.337499576570774,-1.7387201280717106,2.9946764497783906,204.59249877929688,8.975750732421874,0.04593496836524252,191.5097526550293,214.4420036315918,0.8655703237532036,0.11631175714296389,1.053835566343024,1.0092708310173184,1.0183519399460916,0.01202317613092152,71.98880342032072,221.95149871063666,203.27649955749513,184.6015004043536,211.69928632463728,2.701581512186073,209.11875016348702,7.028235221925003,210.46856331828195,206.30754056169414,-0.300185595725528,8.583217186684852,49772700,3.1736294216733114,0.5635023786503396,-134917200.0,-21.746845565296038,78.30330443471131,85.07633588200967,72.57762773845828,33.71914985003328,10.858106266942698,-0.10443009868442081,4.751689963527365,213.58019622802735,209.48489578247072,206.17499542236328,202.86509506225588,198.76979461669924,0.04,0.0,186.55608889050126,0.02107979767299306,-0.0008865460576217868,210.616215297154,209.01877811976843,9.226198452160787
2024-06-28,1,213.19000244140625,191.21499633789062,215.87749862670898,195.12437343597412,212.72250080108643,-0.19038780952871137,9.137248254844241,-1.7207593585167347,2.994730494781992,209.0037498474121,8.760825843811032,0.04468818649922251,193.40325088500978,214.4420036315918,0.8532670609091914,0.12030964693197109,1.042663428108167,1.0033143468534547,1.0110092363039382,0.018975247096548964,73.72000606575332,222.74124646391206,204.46674995422364,186.19225344453523,211.31535829816545,2.1418149388992527,210.37125042506628,5.919258473912378,211.40936159556753,207.22749498569587,-0.5605100743140627,9.738233717577955,82542700,3.1742057162957584,0.9175780821844715,-217459900.0,-34.15330049475466,78.30330443471131,85.07633588200967,54.24874221497218,30.838505197885077,12.965721427628901,-0.13920860721842251,4.824428516879805,213.58019622802735,209.48489578247072,206.17499542236328,202.86509506225588,198.76979461669924,0.04,0.0,186.78858056790895,0.015084951463458562,0.004482976862165229,210.09253583635603,209.99835750034876,8.760727842946705
2024-07-01,1,214.56749725341797,191.5425033569336,215.87749862670898,195.54374885559082,213.1931276321411,-0.3705133509817587,8.792403621302162,-1.6262486168173707,2.9948123382074407,209.38625144958496,8.314650726318359,0.04277178617135261,194.2625026702881,214.4420036315918,0.8463834667483279,0.11301668666266308,1.043791380278593,1.0103403538948157,1.013724659335484,0.02768364399946721,70.31417120278248,223.15030750200376,205.5655002593994,187.98069301679507,211.72857230050224,2.4757514984411757,211.7783933367048,3.971150350679688,211.86119507040263,208.0762420616584,-1.2449172342643726,8.962205806910788,60402900,3.208377421691451,0.6770155404594316,-157057000.0,-12.984561454690802,78.30330443471131,85.07633588200967,74.73870997637572,29.854702647055795,11.682300338669895,-0.14769901904327998,4.971972715882227,213.9294788208008,210.05025997924804,206.91500091552734,203.77974185180665,199.9005230102539,0.04,0.0,186.97616077034704,0.041366419638408924,0.04462860018859779,211.1013684953962,211.68426404680525,8.511204074420602
2024-07-02,1,217.97500228881836,193.6100006103516,215.87749862670898,195.73374557495117,213.45687866210938,-0.5465506703240617,8.378577502639821,-1.4730144940974201,2.994904447588416,210.61375045776367,7.7182258224487255,0.0405316816585749,194.81424713134766,214.65349731445312,0.8392861871686634,0.1082459406900382,1.0544622162310882,1.0257261001985916,1.0242295710947313,0.04019279437319656,71.4826091828207,223.47390495950333,206.71674995422364,189.95959494894396,212.9792867388044,3.123860469181449,213.03392927987235,2.657565077875523,212.53235521998317,209.1325473836479,1.3664807023894376,10.109433906491441,58046200,3.201563881954689,0.6477094273444223,-99010800.0,-0.7976834096454688,78.30330443471131,85.07633588200967,99.10976665615107,31.70508992407952,10.80003922135954,-0.12222811986332024,4.993975051457963,217.12556286621094,215.11222161865234,213.48500061035156,211.8577796020508,209.8444383544922,0.06,0.0,187.17409563987653,0.053570529566803415,0.05827811332376066,212.92497035435267,212.62032427106584,8.463556095532585
2024-07-03,1,220.53250122070312,194.33500289916992,217.97500228881836,199.23812294006348,214.24812984466553,-0.7054690587968183,8.152576038534006,-1.1615065670493068,2.994956207256641,211.77999877929688,7.13850093841553,0.03920732939158086,195.17574882507324,215.47249794006348,0.8063951653800985,0.1216456070032529,1.060583841971025,1.0365183782041099,1.0281091629368104,0.03749486019736836,75.35365083968802,224.24015211521498,207.93500003814697,191.62984796107895,214.6571442740304,3.6130445190427327,213.65160805838448,3.29780390373899,213.85885743037966,210.52245422562635,4.184590869435906,8.771318646514814,37369800,3.2406887510810236,0.4193549563571696,-61641000.0,-0.0,78.30330443471131,85.07633588200967,117.300622326792,32.255248582113765,10.396480037863954,-0.10602415155454792,4.817259318592801,218.01944146728516,215.83528048706054,214.06999969482422,212.30471890258792,210.1205579223633,0.08,0.0,187.30875799594483,0.03892146034419541,0.059692873715335305,214.83847045898435,213.225337437221,8.322396652243258
2024-07-05,1,224.0224952697754,194.86749649047852,220.53250122070312,206.68999862670898,214.3912525177002,-0.8076461694903427,7.964645595475543,-0.7256001892633339,2.9950000153345866,212.2237491607666,6.481663703918457,0.038063754714269406,195.61049880981446,216.08724899291994,0.786115672350938,0.1265452973488009,1.0706235711569263,1.0506229561043803,1.0366756297467647,0.0457589861075538,77.5935666858358,225.17416614517472,209.24487495422363,193.31558376327254,216.72428621564592,4.283017565086968,214.3437502724784,4.3124726773834565,215.49992416140577,212.08728024501264,5.625338122453633,4.0812247056997535,60412400,3.253853981473063,0.6755623167500985,-1228600.0,-0.5538801962281863,78.30330443471131,85.07633588200967,153.70680615086292,37.17132629262026,9.642031867162208,-0.07297589352658168,4.823169041052905,221.76303680419923,218.8634767150879,216.5199966430664,214.17651657104494,211.2769564819336,0.1,0.0,187.55064670419983,0.05716945714588251,0.061383323660038534,217.30275835309706,214.088623046875,8.490596408411557
2024-07-08,0,226.50250244140625,194.86749649047852,224.0224952697754,209.11187553405762,214.78249740600586,-0.7852042832604013,7.953958773064111,-0.16306037306347454,2.9950119130131654,212.87625122070312,6.091600513458252,0.03775768674036675,195.61049880981446,218.23075218200685,0.7381704918730826,0.147597440297281,1.0752143400659337,1.0561378975660787,1.0387283297222107,0.062444297797964676,81.01262019240511,226.56591753849884,210.6579999923706,194.75008244624237,218.7157151358468,5.173618347290914,215.2937502179827,5.3756164483412086,217.61823013314296,213.8481182659135,6.905187709718238,4.521008621723782,59085900,3.2577638305659224,0.6541799563687382,57857300.0,-0.1411042592527462,78.30330443471131,85.07633588200967,166.2315823297082,36.710889527994404,8.982992051042476,-0.023238900018162433,4.807228556332834,222.83264379882812,219.72868237304687,217.22000122070312,214.71132006835938,211.60735864257813,0.12000000000000001,0.0,187.7935858331036,0.08166373919988157,0.06408217574325174,219.38178144182476,215.18235669817244,8.35203931085147
2024-07-09,0,228.0949935913086,194.86749649047852,226.50250244140625,209.46937656402588,215.5399980545044,-0.6315309202216354,7.8382258539862395,0.3523096367633376,2.995044377463351,213.19625282287598,5.574100799560545,0.03693397840154308,199.9232490539551,220.88150062561036,0.7030761843201613,0.15766274235040648,1.074791122855579,1.0550611689758504,1.0334133468044642,0.06304541233434713,82.7151578066013,227.89907686818978,212.2226251602173,196.5461734522448,220.69785635811942,5.785833692205385,216.19857134137834,6.373360448903153,219.83796399318953,215.74582316111332,6.558072304101735,6.238200319962028,48076100,3.2542277418544283,0.5337686580213851,105933400.0,-3.1565159919619994,78.30330443471131,85.07633588200967,176.57130901654898,37.378821411156416,8.56758830441049,-0.03772557423807,4.6802815394119115,224.01683447265629,220.6865748291016,217.99499511718753,215.30341540527346,211.97315576171877,0.14,0.0,187.99837486153672,0.05504033018277821,0.0857468645086365,221.46222795758925,216.03922162737166,8.21911952762834
2024-07-10,0,231.1525001525879,194.86749649047852,228.0949935913086,211.1443748474121,216.40187454223633,-0.36922078125844254,7.594681900206002,0.6646678195370854,2.995098363512788,213.71125411987305,5.310624885559082,0.03551495345617618,207.94849853515626,224.27049598693847,0.6461406829147952,0.17051328569027732,1.080936685969065,1.0597395036870427,1.0345842405010621,0.06045417009015219,84.38959563425955,229.03398870122984,213.84462490081788,198.6552611004059,223.2639274597168,5.8835064548913545,217.28964287894112,7.518731399505663,221.9153854683619,217.6931024228841,6.476980781330543,5.880166577225736,62627700,3.2044345844818634,0.7089597899871459,168561100.0,-0.37752390629537935,78.30330443471131,85.07633588200967,192.0117250098289,40.49846013057468,7.989784658182594,0.02944531632563394,4.66026178571752,226.82836053466798,222.96081973266604,219.83499908447266,216.70917843627933,212.84163763427736,0.16,0.0,188.28582507766814,0.057701874446257184,0.07487885439656962,224.65282113211495,217.37267848423548,7.642191410387937
2024-07-11,0,229.28000259399414,200.39749908447266,231.1525001525879,211.83249855041504,218.61437702178955,0.4176031379767429,7.166536582606317,0.05315334810895367,2.9951823735784133,214.27625465393066,5.45453680038452,0.033230891053370605,209.17675094604493,226.6617515563965,0.6568593460393921,0.15346998444901358,1.0631605237891097,1.0408476526713861,1.0142395374686328,0.03966536145407762,85.42083442806421,229.99194824913593,215.65887508392333,201.32580191871074,225.36571393694197,4.7842903713752385,218.5471431187221,7.966339720643968,224.26835630540916,219.84688000557713,8.425581643359896,7.075772891130321,64710600,3.096629466072487,0.7800751534142618,103850500.0,-20.80027695070821,78.30330443471131,85.07633588200967,129.6656307536095,36.19129373172094,12.27334582060753,-0.09017989380656269,4.84238784822162,226.82836053466798,222.96081973266604,219.83499908447266,216.70917843627933,212.84163763427736,0.16,0.0,188.55737418934964,0.027172224453988703,0.03314116690391287,226.1967490059989,218.64905875069755,7.7282756747425
2024-07-12,0,230.19499588012695,208.7874984741211,231.1525001525879,212.3931245803833,221.4049997329712,0.7831237113741493,6.848724328649879,-0.7192318227257659,2.9952386134436844,214.45000076293945,5.783899574279784,0.03154596813709103,209.51925163269044,228.21349449157714,0.8512812101749374,0.08209644104234413,1.0603031538259948,1.0371304636337373,1.0104670201012254,0.027553039273660485,76.69472651478296,230.80044891669914,217.1030002593994,203.40555160209968,227.1114273071289,3.7572894789310607,220.04535702296667,8.049200917848488,225.56670152432355,221.28655582730397,6.856819196245627,8.316997009749496,53046500,2.147137918800303,0.7007470615063357,156897000.0,-9.588554240116505,78.30330443471131,85.07633588200967,128.78293688789583,33.8612556865353,11.358532308791183,-0.09149954152012432,4.858645500750262,226.82836053466798,222.96081973266604,219.83499908447266,216.70917843627933,212.84163763427736,0.16,0.0,188.78848849178434,0.018556157326527822,0.040577715315905705,227.66219438825334,220.29358237130302,8.202168093037622
2024-07-15,0,235.29999542236328,208.7874984741211,231.1525001525879,213.0331268310547,224.6424970626831,0.5754898054182928,7.2990085051896,-1.1109701200543658,2.995175262159208,214.99749755859375,6.3650490188598665,0.03347884927468072,209.51925163269044,229.37150192260742,0.8778895410513743,0.07400880077200754,1.0792661873838625,1.0525550456331398,1.0273090288792495,0.03884059949065177,77.0344620825762,232.6165171477083,218.0185001373291,203.42048312694993,229.2210693359375,3.589791040113664,221.93910680498396,8.31135385935626,226.73880795822961,222.31241884008597,5.606144495008203,10.025329575109605,62631300,2.116641489529943,0.8470745663735689,219528300.0,-9.888198161693953,78.30330443471131,85.07633588200967,144.29110467147677,37.18927971716217,10.270674247759109,-0.11090030309706954,4.989458268173475,230.4756768798828,226.29715759277343,222.9199981689453,219.54283874511717,215.3643194580078,0.18,0.0,189.08574335992978,0.02888242926544704,0.03561018199724802,229.49578639439173,222.16712842668807,8.906195671408724
2024-07-16,0,234.6050033569336,208.7874984741211,235.29999542236328,213.0331268310547,226.90062522888184,0.5065518075554971,8.15043628492173,-1.136695777721547,2.9950442155327126,215.65249824523926,7.254498901367185,0.03720524290254229,209.51925163269044,230.29074630737304,0.8415407270531403,0.10364555709197304,1.0709287001229881,1.0391684384784026,1.016466342162137,0.028540783219860533,82.58122233791443,235.36774726466766,219.0668746948242,202.76600212498076,230.73285620553153,3.2476318222567087,223.72857121058874,8.134391507478167,228.88125568881756,223.75143393410218,6.696289263450215,12.698316298630482,43234300,2.2647237664155835,0.5955635274489529,176294000.0,-8.949086738845063,78.30330443471131,85.07633588200967,121.07291169254155,35.05961120285404,10.787125399323232,-0.08649863850292126,4.914496308985618,230.87451745605466,226.9427385253906,223.76499938964844,220.58726025390624,216.65548132324218,0.18,0.0,189.28679286953025,0.02684982642977074,0.03072603708807328,230.70581708635603,224.00428771972656,9.413342895306368
2024-07-17,0,229.10750198364258,208.7874984741211,235.29999542236328,213.0331268310547,228.39124584197998,0.34640992932418446,8.696928973477435,-1.3251698508736727,2.9949551018132796,216.92625045776367,7.845199260711669,0.03950689336746012,209.51925163269044,231.49775047302248,0.8842539427485262,0.08902069458789051,1.0407496345153875,1.005889828887649,0.9870792179268487,-0.00884696539122598,79.71628810824244,237.53085764940846,220.1369997024536,202.74314175549875,231.10499899727958,2.800569177042972,224.9103570665632,7.5696119614505415,230.30646115528594,224.91416763790264,4.723859572412311,11.955238652749113,57345900,2.286415263209855,0.8102585644342554,118948100.0,-31.006287098755426,78.30330443471131,85.07633588200967,67.07604553095301,31.08019068203003,17.45809054444079,-0.10932929866497741,5.1477495338122585,230.87451745605466,226.9427385253906,223.76499938964844,220.58726025390624,216.65548132324218,0.18,0.0,189.5187232725479,-0.017598015700556746,0.000874648325305438,230.8570709228516,225.11942618233817,9.563235681552342
2024-07-18,0,226.79249954223633,208.7874984741211,235.29999542236328,213.0331268310547,229.15062713623047,0.15745243691348387,8.836472286400513,-1.4641528036166604,2.9949329714712856,219.25375175476074,8.08709915161133,0.04001644902461327,209.51925163269044,231.49775047302248,0.9225803116465299,0.061284772341237144,1.0270422633547753,0.9908827486265308,0.97883015436763,-0.01084919322930511,63.440047872290016,238.4939444812483,220.82099990844728,203.14805533564626,230.9189284188407,3.0646992641222566,225.80839238848006,6.921847340163984,229.98867643961586,225.13342435553787,1.1500974665435377,7.78359399406884,66034600,2.7095409182579786,0.9422828797857515,52913500.0,-48.45899220571998,78.30330443471131,85.07633588200967,35.374652592551875,27.698583084611272,21.378276025410624,-0.10459982643575327,5.363626494086344,230.87451745605466,226.9427385253906,223.76499938964844,220.58726025390624,216.65548132324218,0.02,1.0,189.75998935611506,-0.01489656996459332,-0.03777148191152233,230.21495710100447,225.83859252929688,9.4609081094336
2024-07-19,0,224.8025016784668,208.7874984741211,235.29999542236328,213.0331268310547,229.15062713623047,-0.004482966489613549,8.851351846105157,-1.490679768879795,2.994932504023736,222.27749824523926,8.138499069213868,0.03998501061218781,209.51925163269044,231.49775047302248,0.9171085658524855,0.07141844979172662,1.0155206313728402,0.9795091948224224,0.9723291627175392,-0.023425766407486392,60.349280638501554,239.06945364643394,221.36674995422362,203.6640462620133,230.01178577968054,3.8286214973135535,226.63785661969865,5.916154652363309,229.17165730169165,224.9720764576636,-0.5710314060667293,5.868963780837509,49151500,2.558502510317179,0.7203972308863488,3762000.0,-51.04701467882381,78.30330443471131,85.07633588200967,24.020939156462095,26.367473037953822,20.35090080153319,-0.07867617129137733,5.23193802693385,231.2568363037109,227.56157666015622,224.5749969482422,221.58841723632813,217.89315759277343,0.02,0.0,189.93336463553018,-0.027023495346725435,-0.014325305762283731,228.97781808035714,226.81531960623605,9.068938063647085
2024-07-22,0,225.45999908447266,208.7874984741211,235.29999542236328,213.96250438690186,229.15062713623047,-0.15957123573830262,8.591235015993147,-1.3654068068373124,2.994981764986054,224.4124984741211,7.760061607360839,0.03869522606278484,209.51925163269044,231.49775047302248,0.8963616247085511,0.07447901905576379,1.015479801966564,0.982040281310318,0.9797433038450581,-0.041818939776126385,57.11408139212474,239.20559510828025,222.02312507629395,204.84065504430765,229.46607099260603,4.2041384076515556,227.415892464774,4.821670095228409,228.06986974908907,224.80487594152495,-2.7471035225357054,5.447018670705329,48201800,2.529348789476414,0.8265430442226884,51963800.0,-59.963828447829336,78.30330443471131,85.07633588200967,20.058376572930637,26.01448379087361,19.038112046662395,0.059642125361339685,5.193228024095026,232.0073181762695,228.7763396911621,226.16500091552732,223.55366213989254,220.32268365478512,0.02,0.0,190.10243988406717,-0.04453919667505202,-0.028541598511609517,228.46270098005022,227.32972499302454,8.398066707832099
2024-07-23,0,224.74999618530273,208.7874984741211,235.29999542236328,214.48062419891357,229.15062713623047,-0.2910110750257312,8.095960807576422,-1.1820021433640135,2.9950696871141824,225.13125038146973,7.129349136352539,0.036331618763806535,212.2615001678467,231.49775047302248,0.870772986485722,0.0798539219646721,1.0085932198349903,0.9793924360959121,0.9850823900268748,-0.0420068073170512,58.504862504392854,239.02704658463526,222.83512496948242,206.6432033543296,228.68821389334542,4.53731339253546,227.89982060023718,4.08494909193589,227.41001611445623,224.86899000243275,-1.6660866478992038,5.076491999247185,39960300,2.5125927702111235,0.7100390793975339,12003500.0,-67.14287510846748,78.30330443471131,85.07633588200967,13.501332128502304,24.470387878639944,18.47936348803344,0.10046760773664036,5.126569068323837,232.93479644775388,230.27759689331052,228.12999725341797,225.9823976135254,223.32519805908203,0.02,0.0,190.24110778595806,-0.04177675226388389,-0.04005975542819121,227.67361450195312,227.66790444510323,7.65205984345438
2024-07-24,0,221.11750030517578,209.5525016784668,235.29999542236328,217.12312602996826,229.15062713623047,-0.3611315224549854,7.431293571503196,-0.9914266985195388,2.995177747617739,225.13125038146973,6.283273906707765,0.03322982417113798,213.12725219726562,231.49775047302248,0.8487921189656207,0.07252356514528599,0.9887505567642718,0.9649697055907126,0.9776065814265809,-0.03487446552071982,56.39638365162517,238.4958369980479,223.6332498550415,208.7706627120351,226.66214316231864,4.250266421634939,227.94160624912806,4.006019962953834,226.74001150895901,224.79371317107035,-2.365385778264128,3.108151772150213,61777600,2.5375322517362626,1.0927860582110727,-49774100.0,-92.98512912661232,78.30330443471131,85.07633588200967,-48.49813988524132,21.882978070233015,23.972583912078516,0.09896783130493778,5.323243358952437,232.48639788818357,229.5517992248535,227.18000030517578,224.80820138549802,221.87360272216796,0.04,0.0,190.4244020159494,-0.04517659157614029,-0.06932979047023259,225.4105181012835,227.4531522478376,6.958658468379285
2024-07-25,0,217.9724998474121,212.5625,235.29999542236328,219.89312648773193,229.15062713623047,-0.28927528784360806,6.7299946130774995,-0.916083264850434,2.9952803390341107,225.13125038146973,5.550449447631837,0.030016277574922198,214.11700477600098,231.49775047302248,0.8432945671857354,0.040246987616234194,0.9721735952664818,0.9554288805013478,0.9705589676465357,-0.03889017367252767,46.76738144685365,237.67148901253196,224.21149978637695,210.75151056022193,224.286071232387,3.6807933040968943,227.50946371895927,4.723392999150587,225.32786956582606,224.34621412210734,-6.027409856821261,0.2652666075224915,51391200,2.6634095186597784,0.9211361668796636,-101165300.0,-87.30645599955174,78.30330443471131,85.07633588200967,-86.63098462428144,20.075631526372863,25.320180965715394,0.08259842576410574,5.388012901416482,231.89403558349608,228.59297549438475,225.92499542236328,223.2570153503418,219.95595526123046,0.06,0.0,190.56248242837208,-0.029842027945180205,-0.04976406534059862,222.93766566685267,226.82174137660436,6.665670904180028
2024-07-26,0,218.04000091552734,213.19000244140625,235.29999542236328,219.89312648773193,229.15062713623047,-0.21071568067773133,6.354600967562741,-0.871457922113144,2.995330695345344,225.13125038146973,5.225849456787108,0.028307841937553656,214.53274803161622,231.49775047302248,0.8183183766781105,0.017517013928701988,0.9713028266428064,0.9604852713055222,0.9785455175036466,-0.03008196400150298,40.17657115580626,237.19120171387303,224.48199977874756,211.7727978436221,222.70499965122767,3.641385372484523,226.90499932425362,5.360663079149785,223.4782621227277,223.69325901111884,-7.089577490475087,-2.7006196029901703,41601300,2.7628726930733856,0.7511628667018282,-59564000.0,-85.22772442938134,78.30330443471131,85.07633588200967,-91.20067961470843,19.12541545478759,24.121730851831618,0.0862826953183561,5.251726217550248,231.89403558349608,228.59297549438475,225.92499542236328,223.2570153503418,219.95595526123046,0.06,0.0,190.6739187497654,-0.02830900560797156,-0.027745519314169114,221.37946864536826,226.11826978410994,6.401768330665942
2024-07-29,0,217.56250381469727,213.19000244140625,235.29999542236328,219.90937614440918,229.15062713623047,-0.153221978909059,6.095409190341624,-0.8116536053774683,2.995363642161709,225.13125038146973,4.996649703979495,0.027130136696144485,217.6319995880127,231.49775047302248,0.7842921401281275,0.022749652509873586,0.9683518011884908,0.9635410211106522,0.9823654186347607,-0.035028365571918796,40.77715124365796,236.86381795343715,224.6729995727539,212.48218119207064,221.3864288330078,3.585278455870575,226.15267862592424,5.893409215468812,222.1100805746249,223.21369448116712,-4.830702169196281,-3.736162485916933,36311800,2.7480384110067435,0.68421190976576,-95875800.0,-83.98933976888421,78.30330443471131,85.07633588200967,-102.81249585028962,18.180088702630346,23.291445628806116,0.17296228086092247,5.130173873151226,231.89403558349608,228.59297549438475,225.92499542236328,223.2570153503418,219.95595526123046,0.06,0.0,190.77024262939358,-0.02554030654124817,-0.027060723876730322,220.53187997000558,225.373418535505,5.715313022866705
2024-07-30,0,218.61000061035156,214.56749725341797,235.29999542236328,219.90937614440918,229.15062713623047,0.007110914659482161,5.748148625200353,-0.9219536545542426,2.99540557199146,225.13125038146973,4.7573747634887695,0.025559638489719518,217.93150024414064,231.49775047302248,0.7704724505354364,0.01395834224482752,0.9720682171197673,0.9758460142360827,0.9941856913752679,-0.027319224378935414,38.98788340579438,236.38792189181916,224.89162464141845,213.39532739101773,220.50178582327706,3.3587243819690813,225.2567858014788,6.02671347712869,220.97205578008277,222.86852336334033,-4.0697976106657485,-4.617589194212223,41643800,2.7393719552259634,0.798798765389236,-54232000.0,-81.5125704478903,78.30330443471131,85.07633588200967,-98.71951905235532,18.553302772636357,21.90844801979051,0.1448049573121051,5.064447301187748,231.89403558349608,228.59297549438475,225.92499542236328,223.2570153503418,219.95595526123046,0.06,0.0,190.88252418749116,-0.02759870423429467,-0.02303984168588261,219.74564906529017,224.36173357282365,5.576304018797784
2024-07-31,0,221.99250411987305,217.56250381469727,235.29999542236328,220.05187606811523,229.15062713623047,0.1610587642332906,5.4446228281779465,-1.0083714289481047,2.9954400614601475,225.13125038146973,4.55524959564209,0.0241882452657681,217.97475204467773,231.49775047302248,0.8100345111330799,0.0029131703858951037,0.9862224264688826,0.9980712463674138,1.0152382483553226,0.003957189338200884,39.6192601299572,235.98299546562103,225.09374980926515,214.20450415290927,220.00642939976282,2.6958886363094634,224.73625019618444,5.966911573697586,220.3957433125696,222.69696456843636,-2.754640638729332,-5.4260713312453035,50036300,2.6409334557308286,0.9672114463364303,-4195700.0,-67.00572086472314,78.30330443471131,85.07633588200967,-46.71428692310472,22.16425419129525,20.35631104552134,0.08776483138274153,5.061272783604634,231.89403558349608,228.59297549438475,225.92499542236328,223.2570153503418,219.95595526123046,0.06,0.0,191.03449258874744,0.016198463295483023,-0.013021611619797983,219.47738647460938,223.9700437273298,5.5079257653501
2024-08-01,0,221.05749893188477,217.56250381469727,235.29999542236328,220.97125053405762,229.15062713623047,0.1793131485383222,5.248868913110271,-0.8935416491962198,2.995461206423213,225.13125038146973,4.354374504089355,0.023297799117138265,218.03325080871582,231.49775047302248,0.844813287613179,0.006620352515336455,0.9811929557982201,0.9970569587448898,1.0101537321477119,0.014153157332380317,47.20117468191616,235.7923627270384,225.29462490081787,214.79688707459732,219.4789297921317,1.8376807709908343,224.08357184273856,5.821867916135553,220.8077242562954,222.95872652858577,-1.537964596238843,-3.1784274213506944,62501000,2.6884315754014043,1.179506840039446,-66696700.0,-83.45862276778632,78.30330443471131,85.07633588200967,-80.09760824637625,19.907174089405018,23.21125178304482,0.012633307796847853,5.232610609954452,231.89403558349608,228.59297549438475,225.92499542236328,223.2570153503418,219.95595526123046,0.06,0.0,191.2088524143052,0.004000155651359583,-0.0008235890672221198,218.52848597935267,223.1010502406529,5.663054479186788
2024-08-02,0,220.5800018310547,217.56250381469727,235.29999542236328,221.10249996185303,229.15062713623047,0.17776509781604022,5.226251671812066,-0.8734288648509163,2.9954635951252504,225.13125038146973,4.328124618530273,0.023194707000702842,218.03325080871582,231.49775047302248,0.8663728123256242,-0.013235261638881743,0.9789594596602866,0.9974834605916285,1.0051377867372862,0.011649242821785588,42.84279291617183,235.77337813000108,225.32087478637695,214.86837144275282,219.4021442958287,1.7677008569513841,223.03214372907365,4.895945954346091,220.87165275419386,223.10613991042032,-1.6429354020427056,-3.969459419960849,105568600,2.571803520624839,1.9108509336405362,-172265300.0,-75.79675160604857,78.30330443471131,85.07633588200967,-57.89041295576066,19.313518446345356,20.798815880097315,-0.08352456546878223,5.4224248949495415,231.16060211181642,227.9997007751465,225.44499969482422,222.89029861450197,219.72939727783205,0.06,0.0,191.50975471141925,0.008717165022674944,0.010896999960525112,218.71684047154017,222.06367928641183,5.769368625407081
2024-08-05,1,204.4650001525879,217.56250381469727,235.29999542236328,220.93812465667725,229.15062713623047,0.23078480372689683,5.3219906036085876,-0.9674839617056405,2.9954533595731783,225.13125038146973,4.500249290466309,0.023637664436970986,218.03325080871582,231.49775047302248,0.8738545387116199,-0.02614761667758461,0.9081329567615202,0.9263787889978894,0.9295532535257801,-0.06020110741722662,39.922213788719766,235.79273132165807,225.14875011444093,214.5047689072238,217.47250148228235,5.96878463494275,220.87928635733468,5.932533125995168,220.8026790577109,223.1494581074724,-0.24308273808236078,-6.255841001988214,119548600,2.4959277409442473,2.0516306493010816,-291813900.0,-62.577547208214355,78.30330443471131,85.07633588200967,-217.25463059543463,14.429421257848993,38.548886199673184,-0.07623924056255621,6.739399747730404,223.09144512939454,217.91428414916993,213.7300033569336,209.54572256469726,204.36856158447264,0.08,0.0,191.6762085630237,-0.041101520008237524,-0.03986967216607693,217.54391261509485,220.24078914097376,6.664802132133776
2024-08-06,1,205.89750289916992,204.4650001525879,235.29999542236328,220.0875015258789,229.15062713623047,-0.7316310408111163,6.957635990274174,0.9863151767382354,2.99524611343946,224.77624893188477,5.5024364471435545,0.031054376412410007,217.93150024414064,231.49775047302248,0.5986238439286823,-0.10359715952845494,0.9189929692131164,0.9418280434730002,0.9473477246790614,-0.058151492043771014,19.872125266857136,237.9621469805483,224.046875,210.1316030194517,215.737858908517,7.375115622723735,219.22142927987235,6.655280048015239,216.73675391832919,220.93708173700202,-6.196882498608729,-12.84712720235126,69660500,4.2795632211030945,1.1737383077733403,-222153400.0,-67.39258149982729,78.30330443471131,85.07633588200967,-182.7075124553204,13.096074710193298,34.98678738698881,-0.07373742261824844,6.895157344366538,222.31216186523437,217.28392150878906,213.22000122070312,209.1560809326172,204.12784057617188,0.08,0.0,191.7704337281001,-0.05287941888606329,-0.05044910622894055,216.01282610212053,218.69614737374442,7.508037092741363
2024-08-07,1,209.1875,204.4650001525879,235.29999542236328,218.4675006866455,229.15062713623047,-0.6789197839133193,7.926379959782654,0.2392976632283732,2.995094685977253,223.3712501525879,6.2074991226196286,0.03555434918042275,216.39600372314453,231.49775047302248,0.7103539667582198,-0.10925686391774563,0.9383256236663711,0.9652008550010679,0.9738778364585394,-0.05768214638886415,21.610009634924257,238.78976038495836,222.93700046539306,207.08424054582775,214.5414297921317,7.701858618479278,217.96392931256975,6.776805057608302,214.04813393271422,219.14086103007782,-5.568931372854674,-10.130615053421412,63516400,4.208395873198522,1.0694131759271754,-158637000.0,-56.513505805350086,78.30330443471131,85.07633588200967,-126.05999670284194,15.883379818470639,32.36873808115632,-0.12652770682036935,6.920503333948106,220.27991906738282,215.64003924560546,211.88999938964844,208.1399595336914,203.50007971191405,0.08,0.0,191.87810277010237,-0.05520530207310681,-0.04104205499256809,214.81135995047433,217.67161996023995,7.627755705601121
2024-08-08,1,212.36249923706055,204.4650001525879,235.29999542236328,218.02312564849854,227.3712501525879,-0.4872564613112986,8.227944007129812,-0.23728969151748602,2.995039859058421,221.5550022125244,6.389749526977539,0.0370897509571771,208.858500289917,230.63599662780763,0.7810845867315357,-0.0876330354443238,0.9572831563414917,0.9852739463809101,1.0005889556448402,-0.039333656342069756,29.94211008356853,238.29463847202334,221.83875045776367,205.382862443504,213.64892959594727,7.511439395281156,217.07535770961218,6.625023902608746,212.84775161358465,217.86027325473242,-3.8494702294060925,-7.762602192652182,47161100,4.329461707188986,0.8059491881054518,-111475900.0,-45.53178658436459,78.30330443471131,85.07633588200967,-93.10954418902065,15.576110328165647,30.545507216293824,-0.07626086189435526,6.809752399687243,220.27991906738282,215.64003924560546,211.88999938964844,208.1399595336914,203.50007971191405,0.08,0.0,191.96669749092462,-0.023126934741934724,-0.039490258511008416,214.0279802594866,216.88681466238836,7.70292430531545
2024-08-09,1,214.27250289916992,204.4650001525879,235.29999542236328,217.8700008392334,225.79312419891357,-0.2802729383898048,8.288842680195462,-0.44165219300649516,2.9950259825997207,221.08749961853027,6.425836830139161,0.037507284654862576,208.858500289917,230.63599662780763,0.8013991441786618,-0.07746691701479298,0.9695900947850435,0.9967298675990561,1.0179288786400966,-0.028595062469515153,36.24626624723237,237.57056065030793,220.99287528991698,204.41518992952604,212.54607227870397,6.592797569149498,216.2762508392334,6.196748659090197,212.7405083287465,217.09109143425405,-2.8578296307800226,-5.533747333114239,42201600,4.412273748384338,0.7279404249924212,-69274300.0,-34.58305140248669,78.30330443471131,85.07633588200967,-56.807261340336964,17.53760586617315,28.971376909352543,-0.04597653174360815,6.666912352189075,219.63816186523437,215.12092150878905,211.47000122070312,207.8190809326172,203.30184057617188,0.08,0.0,192.05657270352395,-0.016464951640783432,-0.009708689639269666,213.19466073172433,216.33602360316686,7.415398384821426
2024-08-12,0,217.1775016784668,204.4650001525879,235.29999542236328,216.74000358581543,224.96687602996826,-0.10306748537408748,8.129902681206325,-0.39236905386250776,2.995049419955111,220.81875038146973,6.34007453918457,0.036921083792311835,208.858500289917,229.6572521209717,0.7626822908533127,-0.08936461084688518,0.9862884036498495,1.0120166133841075,1.037949791869949,0.062174462702134115,37.6010926432481,236.4565560032818,220.19675064086914,203.93694527845648,211.9917869567871,5.882814063192403,215.7353583744594,5.71171541616317,213.13303747345842,216.646556173019,-3.4775954491393213,-4.962075858569988,38028100,4.236107455426724,0.6701717182744938,-31246200.0,-27.263532635759308,78.30330443471131,85.07633588200967,-21.35474701176775,19.794490914539683,27.720789006246584,-0.02713955283763697,6.469988680449721,218.6144046630859,214.29280377197264,210.8000030517578,207.30720233154295,202.9856014404297,0.02,1.0,192.1458969013111,0.0406736675883248,-0.009452417113127184,213.1121542794364,215.82032012939453,6.623731637050181
2024-08-13,0,220.2949981689453,204.4650001525879,234.6050033569336,216.45125198364258,224.76312255859375,-0.20129599489691138,7.370525674977583,-0.2100072240818771,2.995165859297358,219.59500122070312,5.73587474822998,0.03361076490581327,208.858500289917,227.02399978637695,0.718741709392309,-0.07428444163210017,1.0045800964400693,1.0267279092933044,1.040209259027337,0.06992554580336985,43.53458991908055,234.0316773036295,219.29062595367432,204.54957460371915,211.95107214791435,5.814053170982269,215.6766082218715,5.656055639109595,214.14098448781405,216.46975632575672,-1.755198205066785,-3.36929683442243,44155300,4.3297606348030735,0.7775207776951045,12909100.0,-14.628381548003652,78.30330443471131,85.07633588200967,29.953979773616634,21.50916410431049,26.354640391739533,-0.015027372631112559,6.319274868412883,218.6144046630859,214.29280377197264,210.8000030517578,207.30720233154295,202.9856014404297,0.04,0.0,192.26170412529686,0.06898678343302267,0.0585660284360829,213.34989711216517,216.03336879185267,5.570622380099162
2024-08-14,0,221.25500106811523,204.4650001525879,229.10750198364258,216.45125198364258,222.68187713623047,-0.6190397707025443,6.491274028969246,-0.2575092979581428,2.995288399585859,219.45249938964844,5.023861980438232,0.029698137005986273,208.858500289917,225.59324913024903,0.7237795567621225,-0.038464492600187514,1.0122606603351048,1.030392996029407,1.0307278085670581,0.05768748643257959,51.067284844948176,231.55767375221336,218.5751256942749,205.59257763633644,214.3496437072754,5.672581517048466,215.9110725947789,5.824089687243046,215.67464947754533,217.11655976931547,-0.12920648279242616,-0.3719751422186352,41960600,4.2771347204422945,0.7490208958847281,54869700.0,-13.1081219012034,78.30330443471131,85.07633588200967,49.676383190621245,22.00488474394077,25.327960208197375,-0.0036382317122956747,6.105754867870986,218.6144046630859,214.29280377197264,210.8000030517578,207.30720233154295,202.9856014404297,0.06,0.0,192.37380433017736,0.05793838833229237,0.07116078253352316,215.16303144182478,216.35347202845983,5.097742329934615
2024-08-15,0,224.35750198364255,204.4650001525879,226.79249954223633,216.45125198364258,221.4393768310547,-0.8215952525508886,6.065890139008768,-0.09387276661680843,2.9953427092713123,219.45249938964844,4.670499439239501,0.027801909506854443,208.858500289917,224.86825141906738,0.7072934061938061,-0.024416585580643628,1.028302000924869,1.0452004438096498,1.0335602222889009,0.05648362017623443,53.656629982619656,230.31428092651606,218.18250064849855,206.05072037048103,216.98678643362862,5.371312333918944,216.36232267107283,6.232170443586439,217.069272825601,217.81230671541658,8.211674811335595,1.5059244735005486,46414000,4.265032902028398,0.843284204436917,101283700.0,-2.972988855931193,78.30330443471131,85.07633588200967,94.54993285147621,23.83758838594655,24.22030373395151,0.04988882138445789,5.928915200332721,218.6144046630859,214.29280377197264,210.8000030517578,207.30720233154295,202.9856014404297,0.08,0.0,192.50860746624952,0.05470961709541622,0.07225290730903382,217.69583129882812,216.85432870047433,5.1491001197254525
2024-08-16,0,225.11249923706055,204.4650001525879,225.45999908447266,216.45125198364258,221.4393768310547,-0.9219468549146855,5.914400068704444,-0.02809763218664818,2.9953612488850707,219.45249938964844,4.560924549102781,0.027122717168516216,208.858500289917,224.75524673461913,0.6869656996540193,-0.0019795139800567107,1.0323384581662343,1.0471079293835226,1.025702644979353,0.05058976859476738,59.35176299867349,229.88955090797774,218.06075077056886,206.23195063315998,219.26178632463728,4.866123462135996,216.90160805838448,6.65624566534064,218.8905473878815,218.71905103433988,8.96562552947166,2.897404623733569,44340200,4.309649481682938,0.8091424287722012,145623900.0,-2.5299991338670362,78.30330443471131,85.07633588200967,112.20731880206044,24.737160849616625,23.260612136286202,0.08931954908114194,5.732564286579845,219.5541213989258,215.0529411315918,211.41500091552734,207.77706069946288,203.2758804321289,0.1,0.0,192.64128631373333,0.0465762178931568,0.06095189955513466,220.04905700683594,217.43020847865515,5.288540286323004
