date,buy?,todays_price,Minimum,Maximum,25th Percentile,75th Percentile,Skewness,Standard Deviation,Kurtosis,Shannon Entropy,Median,Mean Absolute Deviation (MAD),Coefficient of Variation (CV),10th Percentile,90th Percentile,Autocorrelation,Cumulative Return,curr_to_avg_one_month,curr_to_avg_one_two_week,curr_to_avg_one_one_week,momentum,rsi,upper_band_current,middle_band_current,lower_band_current,rolling_mean_7,rolling_std_7,rolling_mean_14,rolling_std_14,ema_7,ema_14,roc_7,roc_14,Volume,Volatility,Relative Volume (RVOL),On-Balance Volume (OBV),Williams %R,Stochastic Oscillator %K,Stochastic Oscillator %D,Commodity Channel Index (CCI),ADX1,ADX2,Chaikin Money Flow (CMF),Average True Range (ATR),Fib_23.6,Fib_38.2,Fib_50,Fib_61.8,Fib_76.4,Parabolic SAR 2,Parabolic SAR 3,VWAP,Adj Close Momentum,Adj Close Return,Adj Close 7d MA,Adj Close 14d MA,Adj Close Volatility
2024-01-02,0,61.31750011444092,58.50374984741211,62.91250038146973,58.936561822891235,62.31031322479248,-0.22953820078117293,1.6619068423013386,-1.7093541233492084,2.9953579683230593,61.536874294281006,1.583043727874756,0.027329976675754375,58.630001068115234,62.57449960708618,0.8192035717935681,0.060458754176238715,1.0083632880544924,0.9855088774632099,0.9826207474446345,-0.012282535602484157,62.58044020209864,64.13275113882631,60.80893745422363,57.48512376962095,62.20053604670933,0.4933436189268745,61.80142845426287,1.072701437284179,62.24591698759814,61.43661582219132,-0.43234508392952486,6.136383485001219,15248400,0.8177852098412481,0.91978844455597,49477500.0,-44.53709165392449,83.25868849609935,82.425646108079,18.744132043286253,27.17088160677518,18.976850184458588,-0.04244892696567063,1.5690996418104612,62.715177505493166,61.83990766143799,61.132497787475586,60.42508791351318,59.549818069458006,0.02,1.0,60.77849153498852,-0.006144907295886126,-0.009668099831473488,62.15571485246931,61.790000098092214,1.6180757489186561
2024-01-03,0,59.607500076293945,58.50374984741211,62.91250038146973,59.156561851501465,62.31031322479248,-0.3873181137421118,1.5876324210893047,-1.537586479672819,2.9953917461541417,61.536874294281006,1.472950057983398,0.02605107716195106,58.69750003814697,62.57449960708618,0.8557097135340428,0.026663871457509113,0.978085080205848,0.9586223931553063,0.957557889031925,-0.04266127417212351,52.262266668349724,64.1183272429965,60.94306240081787,57.76779755863925,61.847857339041575,1.1028780863874246,61.848303522382466,0.945352459836423,62.01456154629416,61.41602949207231,-2.0193749285006186,3.533137537969241,21245800,0.8204759243299788,1.2545456746376082,28231700.0,-95.15566344067287,83.25868849609935,82.425646108079,-76.73893332069068,22.69395742386009,26.869990504835943,-0.0925679390981274,1.7085843812289412,62.7659175415039,61.92203771972656,61.23999786376953,60.5579580078125,59.71407818603515,0.04,0.0,60.690632182064654,-0.06281969659376685,-0.05190813513182573,61.66571480887277,61.771428789411274,1.6830615118865138
2024-01-04,1,58.24374961853027,58.50374984741211,62.91250038146973,59.156561851501465,62.31031322479248,-0.3799465033381564,1.592339401847188,-1.552865876199217,2.995389676598106,61.536874294281006,1.4800000762939447,0.026130831929806808,58.69750003814697,62.57449960708618,0.7826281277236868,0.018866315950013587,0.9557997688671285,0.9393509217961654,0.9437038402633176,-0.06919834523873902,41.970741894692125,64.12186618925345,60.937187385559085,57.75250858186471,61.29982158115932,1.7383584391897313,61.70696422031948,1.2916263639621148,61.40687807269046,61.15098549456006,-3.9769652849726524,1.1132095815464451,16680400,0.8673140262182065,0.9992002995132909,11551300.0,-84.90280502901508,83.25868849609935,82.425646108079,-119.65087629851526,20.76839939526862,29.34163987509294,-0.05338307408266077,1.7011599482538518,62.55115757751465,61.57441777801514,60.78499794006348,59.995578102111814,59.0188383026123,0.06,0.0,60.5886206789112,-0.06748563372114469,-0.06569693926039875,61.18142918178013,61.537143162318635,1.6375602102026234
2024-01-05,1,58.96749973297119,58.24374961853027,62.91250038146973,59.156561851501465,62.31031322479248,-0.4024112834364215,1.6130794177650494,-1.5095230318428572,2.9953804555740544,61.536874294281006,1.495600090026855,0.026476831079578787,58.69750003814697,62.57449960708618,0.7369573223984446,-0.011015839130894819,0.967883237750412,0.9575191379383358,0.969027433445123,-0.06270614940716135,34.05039334719469,64.1503462096451,60.92418737411499,57.69802853858489,60.82892853873117,1.8748210491500623,61.45196431023734,1.4568779001102101,60.6088521177222,60.781096132224526,-6.179526916704875,-3.2857324652670776,17413600,0.9188979451828497,1.0681781237444141,28964900.0,-58.92720799303124,83.25868849609935,82.425646108079,-71.75822076999714,24.366106505050418,25.436803793505216,-0.035324569174825945,1.7909845629229995,62.42509979248047,61.47244956970215,60.70249938964844,59.932549209594725,58.97989898681641,0.06,0.0,60.536551934370785,-0.04692458486443307,-0.04084239567369026,60.83285740443638,61.412143162318635,1.6166386284716308
2024-01-08,1,61.03000068664551,58.24374961853027,62.91250038146973,59.160624504089355,62.31031322479248,-0.40215073215907515,1.6084323974079677,-1.5062854997955668,2.9953825274401336,61.536874294281006,1.491100101470947,0.026398930720130765,58.69750003814697,62.57449960708618,0.7553364873201107,0.004385959711410452,1.0016751481583324,0.9968598101461553,1.0160955445743327,-0.01849468660157838,40.17879943043551,64.14480215939419,60.92793736457825,57.711072569762315,60.608392987932476,1.7197529846002308,61.403750147138325,1.4590274444889308,60.19549239474372,60.55230106926247,-5.294013358447593,-5.708572981420449,14264400,0.9333658639567555,0.8835591619307184,43229300.0,-34.09958549889213,83.25868849609935,82.425646108079,8.98056588941516,29.611789524425575,23.173967556166488,0.016197450880266764,1.796915620651257,62.42509979248047,61.47244956970215,60.70249938964844,59.932549209594725,58.97989898681641,0.06,0.0,60.56046672429872,0.0053737474657979956,-0.02124286800397967,60.6985718863351,61.446429116385325,1.517268806672862
2024-01-09,1,60.867499351501465,58.24374961853027,62.91250038146973,59.51187491416931,62.31031322479248,-0.5459923807840246,1.5258300417791204,-1.2475045988799545,2.995418404409948,61.536874294281006,1.3519000625610347,0.024995603279254194,58.91462421417236,62.57449960708618,0.7117827171738362,0.04173424335421183,0.9971096548973531,0.9959074687692021,1.0172855277781807,-0.00733886349084012,53.30333446062129,64.09559748056141,61.04393739700318,57.99227731344494,60.316249983651296,1.4086692567978412,61.36794655663626,1.46608551037614,60.40495945407524,60.64050640896792,-2.467087024326093,-1.0939118299216841,14877300,1.0382020592458043,0.9231843228752978,28352000.0,-44.6743330858409,83.25868849609935,82.425646108079,-6.944663171749092,27.441380966583715,21.108257319122238,8.755120488651523e-05,1.805648299917271,62.42509979248047,61.47244956970215,60.70249938964844,59.932549209594725,58.97989898681641,0.06,0.0,60.57768640629663,-0.0066710031487080546,-0.005862247374142167,60.40857151576451,61.416428974696565,1.4300993029588813
2024-01-10,1,60.90750026702881,58.24374961853027,62.91250038146973,60.06874990463257,62.31031322479248,-0.6602443749159145,1.419285271206286,-0.9359417698457917,2.9954615687438437,61.536874294281006,1.2149501037597659,0.023206838417964275,58.965874671936035,62.57449960708618,0.6992608320691984,0.027733219747997136,0.9959030406464443,0.9985429492035838,1.0194875634640204,0.02180933924541284,51.49284106424209,63.996632905083466,61.1580623626709,58.31949182025833,60.134464263916016,1.1937883502808706,61.2577680179051,1.4361676730661936,60.521362293680575,60.735243073552304,-3.250548011235295,-0.8167842267352572,10137900,1.0328513812180011,0.6329083104215518,38489900.0,-46.053645446626405,83.25868849609935,82.425646108079,-23.6576787935121,25.946901791760883,19.958685035619293,0.03617174702395069,1.7499986763140742,62.42509979248047,61.47244956970215,60.70249938964844,59.932549209594725,58.97989898681641,0.06,0.0,60.58488389080322,0.039740712500592856,-0.008135372721252134,60.344285692487446,61.27000045776367,1.3386737409800546
2024-01-11,1,60.89375019073486,58.24374961853027,62.91250038146973,60.706249475479126,62.31031322479248,-0.8073036461929288,1.350405906036109,-0.5135053629482011,2.995487674093157,61.536874294281006,1.114000053405762,0.022050255930831757,58.965874671936035,62.57449960708618,0.6477026668988336,0.03318421871502914,0.9943105034509048,1.0005422243909472,1.0148408671266715,0.04549845416136278,52.15279006990335,63.942999216704784,61.24218740463257,58.54137559256035,60.07392856052944,1.1329955168302268,61.137232303619385,1.3865010889597975,60.619437824845406,60.840443966810334,-2.046478018497294,-2.4699752553201475,11900700,1.0294631049811556,0.7474976006110277,26589200.0,-35.47856499430628,83.25868849609935,82.425646108079,-28.83895969989745,24.186194887946964,19.61140571522729,0.057272497877102556,1.7223286931233426,62.06983967590332,61.18507947540283,60.46999931335449,59.754919151306154,58.87015895080567,0.06,0.0,60.5950539887664,0.04961501579689287,0.046392586669848725,60.32857131958008,61.24214308602469,1.212614767593771
2024-01-12,1,61.362000465393066,58.24374961853027,62.91250038146973,60.887187480926514,62.31031322479248,-0.9482958970125555,1.2481239317711812,0.09890116587733422,2.9955238789348924,61.536874294281006,0.999631223678589,0.02034786308739622,59.54350004196167,62.57449960708618,0.6763505880875339,0.011146172029117435,1.0003698771056533,1.0110268589265539,1.0136908297339062,0.040607126692926654,50.01180554752715,63.835560321580694,61.33931245803833,58.843064594495964,60.32457147325788,1.2044288868055655,61.08621440614973,1.3622191595382223,60.69461915999412,60.991372670044676,-0.6910750159663752,-2.6964945488574372,9275600,0.9920182577433754,0.60121486158855,35864800.0,-41.25411606371173,83.25868849609935,82.425646108079,-13.531431569237876,24.821859909895483,18.495713622087912,-0.013645972478609991,1.6770486679714525,62.06983967590332,61.18507947540283,60.46999931335449,59.754919151306154,58.87015895080567,0.02,1.0,60.60741971265425,0.01463740990934248,0.04362701802867021,60.66714259556362,61.16642870221819,1.2138894062232648
2024-01-16,1,59.20875072479248,58.24374961853027,62.91250038146973,60.90406274795532,62.31031322479248,-1.1133102033568834,1.2215684229036061,0.5369967970849214,2.9955328302621176,61.536874294281006,0.9397124767303466,0.019896454213517604,59.54350004196167,62.57449960708618,0.7506215112922638,-0.018796690584201494,0.9643702110727941,0.9780475744155498,0.9704419617767049,-0.02984188008130817,49.276607920964146,63.83942433474458,61.396287488937375,58.95315064313017,60.462428774152485,0.9562162903822539,60.8811251776559,1.4161630566390786,60.86639517818401,61.184555418619105,2.9434221983030127,-1.1506019656863298,20907100,0.8432060504222928,1.3867724943179878,14957700.0,-83.33330185894059,83.25868849609935,82.425646108079,-156.53139971358215,21.539676312770517,28.089530699100006,-0.009564335573843761,1.7763346913640918,62.06983967590332,61.18507947540283,60.46999931335449,59.754919151306154,58.87015895080567,0.02,0.0,60.53528896526259,-0.05328799523947547,-0.02777774781462322,60.66714259556362,60.924285888671875,1.3727590364477198
2024-01-17,1,58.4402494430542,58.24374961853027,62.91250038146973,60.887187480926514,62.2009379863739,-0.8601420934003758,1.2801077052254743,-0.22119285783423015,2.995512375512186,61.36537504196167,1.011255016326905,0.020906595444935148,59.18462562561035,62.57449960708618,0.6668697751709223,-0.040454554524044485,0.9544405113879295,0.9701144008650631,0.9635988921370778,-0.039877601910836336,37.473974546894695,63.79006551192189,61.229850101470944,58.66963469102,60.38710730416434,1.1030851210748311,60.608017921447754,1.495473311122519,60.45016621077579,60.96783863084808,1.6568320422062792,-4.625079256511324,29527400,0.9513737083039108,1.9232764626053278,-14569700.0,-51.35867058140355,83.25868849609935,82.425646108079,-138.25402319888067,18.378426392583652,30.759387501104616,0.11561969374925056,1.9151211450534302,61.84115615844726,60.81492225646973,59.98550033569336,59.15607841491699,58.12984451293946,0.02,1.0,60.43490491474865,-0.019000816738879323,-0.029964402956334693,60.63428551810129,60.73357146126883,1.4042675083345677
2024-01-18,1,61.292500495910645,58.24374961853027,62.91250038146973,60.552499532699585,62.2009379863739,-0.6827082075356374,1.4106149483824801,-0.747899379675963,2.995464020647572,61.33975028991699,1.14330135345459,0.023099610208314882,58.91477470397949,62.57449960708618,0.6860079564323504,-0.047719730215780944,1.0036990404589046,1.022345066814531,1.0187833154004104,0.006321064354864792,34.35476521170794,63.88784252188704,61.06661262512207,58.2453827283571,60.424607276916504,1.132648952731872,60.51650013242449,1.402220327949821,59.94767323629383,60.634236954627596,-0.8941370963744365,-6.140814717497131,25339500,0.9611189679402438,1.5907154123213822,10769800.0,-20.059752199325956,83.25868849609935,82.425646108079,27.39598926910564,26.51293019947894,27.557005403772198,0.14767145349586738,1.9679202629148667,61.84115615844726,60.81492225646973,59.98550033569336,59.15607841491699,58.12984451293946,0.02,1.0,60.48754891810788,0.01853676320679387,0.01703523224445855,60.68428530011858,60.69142859322684,1.4185325395040178
2024-01-19,0,64.32249927520752,58.24374961853027,62.91250038146973,60.552499532699585,62.2009379863739,-0.6759272454684839,1.409896069271611,-0.7507300427458947,2.995464275190808,61.30500030517578,1.1398701429367066,0.023089279649307407,58.91477470397949,62.57449960708618,0.6611097266984268,-0.018534816923774667,1.0533827321576348,1.0698778249445042,1.0677803166087676,0.05630707706017346,50.938502910520626,63.88259230753432,61.06280016899109,58.24300803044786,60.918178694588796,1.870360095942193,60.617214339120046,1.621103360889168,60.28488231206846,60.73713192448285,0.4301160188624683,-2.0475823419545285,37995100,1.1447439654441194,2.2571887366014116,48764900.0,-4.004512303076357,83.25868849609935,82.425646108079,196.89978304860344,36.27166713644163,23.37235066133678,0.19161495757917257,2.1374664200657114,63.91159545898437,62.489701690673826,61.34049987792969,60.19129806518555,58.769404296875,0.04,0.0,60.76787028702485,0.0728606574063515,0.07972442065848835,61.365713936941965,60.88714272635324,1.7172006548328065
2024-01-22,0,65.79800128936768,58.24374961853027,64.32249927520752,60.552499532699585,62.2009379863739,-0.2599084708343491,1.5537397020019923,-0.49724766779251794,2.995408743719008,61.30500030517578,1.224132618904114,0.02540599288442742,58.91477470397949,62.61437520980835,0.521700272477733,0.02782381430805049,1.0758967865809725,1.083465188642838,1.0799800608291474,0.07229231104478773,62.69594029025888,64.2639045462922,61.15642514228821,58.04894573828422,61.61682169778006,2.6263193997589065,60.87564298084804,2.105431579272272,61.294793517386765,61.19450782857221,5.6762639512326665,2.241206255018112,44006900,1.3371797093418853,2.42299057521862,92771800.0,-38.07818391919171,83.25868849609935,82.425646108079,186.57579375988436,36.90130236215357,19.50835819178708,0.12672440408467212,2.3605554216652345,65.43959545898437,63.72570169067383,62.34049987792969,60.955298065185545,59.241404296875004,0.06,0.0,61.07055029291569,0.044918060302734375,0.03895685841547109,61.762857164655415,61.05357142857143,1.7992804033471252
2024-01-23,0,64.80375099182129,58.24374961853027,65.79800128936768,60.552499532699585,62.2009379863739,0.36518607225328104,1.8341056343688753,0.14728954962113638,2.995286340481223,61.30500030517578,1.3713626384735107,0.02991173372212577,58.91477470397949,63.05350027084351,0.5785624655337531,0.0599544946360031,1.0568598163263985,1.055224721128886,1.0483940234364948,0.09449617157157841,67.53762639696207,64.9854739659576,61.317262697219846,57.649051428482096,62.17539324079241,2.8529222526377827,61.12466090066092,2.3532890834367626,62.42262331366115,61.77779675488604,8.029390470628545,5.818592741130522,19883700,1.3635398558242358,1.07209089725344,72888100.0,-29.218849721899794,83.25868849609935,82.425646108079,153.40883994980794,34.45492760961605,18.21505004576366,0.10893487945349732,2.3317705127238875,65.43959545898437,63.72570169067383,62.34049987792969,60.955298065185545,59.241404296875004,0.06,0.0,61.18878648958521,0.10829765498259825,0.06196719310322746,62.25285720825195,61.290714263916016,1.947012540694716
2024-01-24,0,64.49249935150146,58.24374961853027,65.79800128936768,60.552499532699585,62.34125065803528,0.3527401268576236,1.9809902081726998,-0.3343192659843566,2.9952144421623252,61.30500030517578,1.530515117645264,0.032235523924465805,58.91477470397949,64.3706244468689,0.6900183904485304,0.04387485617691077,1.0494496627076115,1.0437427480347805,1.024806361291983,0.10356304030400731,62.38391649714801,65.4156181116579,61.4536376953125,57.491657278967104,62.622607367379324,2.9479473614040947,61.4735894203186,2.4702794443487157,63.02492741206894,62.14693885954282,6.421021515080446,5.685572423653524,21694100,1.3889158133286523,1.1434099538505973,51194000.0,-44.21159662926168,83.25868849609935,82.425646108079,101.15595811184424,31.066638141187937,20.370319097782527,0.07057713927782472,2.3864445782339945,65.43959545898437,63.72570169067383,62.34049987792969,60.955298065185545,59.241404296875004,0.06,0.0,61.280260566776626,0.052262499582797384,0.07818647793280872,62.54142870221819,61.6042856488909,1.9737978324860859
2024-01-25,0,61.85000038146973,58.24374961853027,65.79800128936768,60.552499532699585,62.65843725204468,0.28159558688149156,2.0861182486542327,-0.6928529347724002,2.9951599308303085,61.30500030517578,1.6752650833129876,0.033879711397378214,58.91477470397949,64.52362451553344,0.7351855206747534,0.03579527870816008,1.0044781326292125,0.9951385452184899,0.9642690398038082,0.009095727553100508,60.67758119908018,65.74649916401074,61.57426266670227,57.4020261693938,62.999928746904644,2.584836109829465,61.731178760528564,2.2889455960707985,63.40020650140215,62.47885052161974,5.101689746692559,8.195276213488269,43452600,1.392551521606336,2.104368494766756,7741400.0,-63.889607410112994,83.25868849609935,82.425646108079,-8.91225515098617,26.124757470962518,29.023829858003076,0.013000506228721693,2.6200535792178576,65.43959545898437,63.72570169067383,62.34049987792969,60.955298065185545,59.241404296875004,0.06,0.0,61.282288747921875,-0.022225818404313813,0.01369176328570726,62.86428560529436,61.76571410042899,1.9704775523297346
2024-01-26,0,61.09399890899658,58.24374961853027,65.79800128936768,60.552499532699585,62.65843725204468,0.3117063896516334,2.08122397343094,-0.659860182573142,2.995162418284332,61.30500030517578,1.6504400444030765,0.03381158558037953,58.91477470397949,64.52362451553344,0.739572729191372,-0.011566338377694338,0.9925337200271761,0.9814864578979979,0.950829780296323,-0.050192396169147835,49.05601885061253,65.71602308113923,61.553575134277345,57.391127187415464,63.379035813467844,1.911548425827827,61.88307155881609,2.158268745803699,63.01532023756644,62.417184260921786,4.460910970667172,6.19165281520976,18430700,1.5211727737497276,0.877039288725786,-10689300.0,-54.77469268594499,83.25868849609935,82.425646108079,-4.896613995578583,24.388899364946116,27.0953430430478,0.02259810659381674,2.5922586369872453,65.43959545898437,63.72570169067383,62.34049987792969,60.955298065185545,59.241404296875004,0.06,0.0,61.28405598236563,-0.06137953409691421,-0.0049927745615908955,63.13428551810129,61.88428551810129,1.952825920670572
2024-01-29,0,62.41250038146973,58.24374961853027,65.79800128936768,60.552499532699585,62.36312532424927,0.4175892813861498,2.069913475716238,-0.5590817181980317,2.9951678950932785,61.19324970245361,1.600213875770568,0.03366830449637212,58.91477470397949,64.52362451553344,0.7277909714724831,-0.028905248741453084,1.0151743499791253,1.0023459713385958,0.9812105965289944,-0.051452944490048114,46.04583400679032,65.61941455404782,61.479587602615354,57.339760651182885,63.53903579711914,1.7476396201841504,61.98182153701782,2.1478371031029306,62.528556353092114,62.16330511079712,4.540961907645979,3.606222386323048,15913900,1.5265315150595788,0.7489350527479204,5224600.0,-37.90784022918733,83.25868849609935,82.425646108079,61.34721734577181,26.768961321178878,24.820191537164618,0.05373175894513748,2.6148794322176983,65.43959545898437,63.72570169067383,62.34049987792969,60.955298065185545,59.241404296875004,0.06,0.0,61.316885350233385,0.00031372203545387833,-0.031297498979675695,63.372856685093474,62.02857099260603,1.9878192128471097
2024-01-30,0,63.28750038146973,58.24374961853027,65.79800128936768,60.552499532699585,62.23812532424927,0.45070766716070154,2.0554248120544227,-0.4781743929942204,2.9951755000151983,61.19324970245361,1.5677138757705684,0.03344623879579901,58.91477470397949,64.52362451553344,0.7213137160122167,0.0037391456280612516,1.0298254833423757,1.0146866056203445,1.0056721318723683,-0.023397574787652697,51.76476894204977,65.5654372267242,61.454587602615355,57.34373797850651,63.39117881229946,1.7137623658844994,62.154678753444124,2.1486386306929472,62.49106292713076,62.02416870998121,1.827303302194054,2.2652788452724617,18786100,1.550021484407743,0.8799497495440081,24010700.0,-38.58931247700912,83.25868849609935,82.425646108079,79.65590315353063,26.942018708876045,23.06635955123832,0.09691343790654706,2.6008968449257606,65.43959545898437,63.72570169067383,62.34049987792969,60.955298065185545,59.241404296875004,0.06,0.0,61.36867218722754,-0.016980526317525113,-0.0009413456496861972,63.067142486572266,62.21642821175711,2.045740973720955
2024-01-31,0,62.234999656677246,58.24374961853027,65.79800128936768,60.552499532699585,62.63125038146973,0.3815430519260352,2.0888686053110335,-0.6516010319495158,2.995157872067269,61.19324970245361,1.6397013807296745,0.033959841898727965,58.91477470397949,64.52362451553344,0.7199986001726852,0.03212786338895204,1.0117873108602964,0.9913291483175758,0.9937359550060478,-0.035004065860748224,55.684367603096405,65.68769981705212,61.50996260643005,57.33222539580798,62.882178579057964,1.3755166194335537,62.249500138419016,2.118445465771432,62.6823419371063,62.00940640554389,-1.6090775473594248,3.9758509151051,15623100,1.546967678683125,0.7311517168711138,8387600.0,-58.43769944379959,83.25868849609935,82.425646108079,17.523750944269533,24.99315305599651,23.95428019436504,0.05875814887174861,2.5925448346267026,65.43959545898437,63.72570169067383,62.34049987792969,60.955298065185545,59.241404296875004,0.06,0.0,61.38095880253937,-0.026499555244557937,-0.052948446585522,62.725713457380024,62.24428531101772,2.046352878735
2024-02-01,0,61.55799961090088,58.24374961853027,65.79800128936768,60.552499532699585,62.63125038146973,0.3150193266328559,2.0942061461087054,-0.7052187146032369,2.995155365449918,61.19324970245361,1.675505104064942,0.034021243610998016,58.91477470397949,64.52362451553344,0.7257320751903559,0.04408001639089481,1.0000351230272202,0.9746539696128765,0.9900636528731135,-0.004721111863668304,53.01309483686892,65.74424987575928,61.55583758354187,57.36742529132446,62.41849981035505,1.148063530502777,62.29694652557373,2.0930313738060518,62.564558565254,61.9230679830805,-5.415060583711342,2.1795335284299227,13449400,1.5129899136652525,0.641120031842921,-5061800.0,-52.73021095061008,83.25868849609935,82.425646108079,-4.462452203858714,23.931496973569207,24.578349860351324,0.12892008972673696,2.5044272647989194,65.43959545898437,63.72570169067383,62.34049987792969,60.955298065185545,59.241404296875004,0.06,0.0,61.38424198003403,0.02157801668664594,-0.01586797830428778,62.331427982875276,62.29214259556362,1.9224315140183093
2024-02-02,0,61.982500076293945,58.24374961853027,65.79800128936768,60.887187480926514,62.63125038146973,0.23785185058457572,2.0460663583872067,-0.5816055830144378,2.99518280437285,61.327250480651855,1.5974851226806634,0.03318661421568006,58.91477470397949,64.52362451553344,0.676988487835919,0.056903101432813234,1.0053385168684021,0.9809627632002104,0.9978283103917823,0.014543182361017815,51.57050050355536,65.74549527704663,61.653362560272214,57.5612298434978,62.05992848532541,0.6948509583493695,62.341267926352366,2.0782277089765584,62.311223150438146,61.83196750961664,-5.008585662471988,1.0908334896198968,14611700,1.4846119774045246,0.6999771012918129,9549900.0,-49.32278471963157,83.25868849609935,82.425646108079,8.742457434583697,24.690650827175464,23.286242831084632,0.1426367511277042,2.4457880910135845,65.43959545898437,63.72570169067383,62.34049987792969,60.955298065185545,59.241404296875004,0.06,0.0,61.39625983783474,0.010359329917353666,0.028166679464009577,62.24571337018694,62.393571036202566,1.7575140425471405
2024-02-05,0,61.72949981689453,58.4402494430542,65.79800128936768,60.90406274795532,62.63125038146973,0.29718054783613046,1.8909218545614874,-0.3895550717999168,2.9952660092119774,61.46000003814697,1.4621551036834717,0.030577501273743014,59.18462562561035,64.52362451553344,0.6477144093248657,0.05112986572223515,0.9982082838195017,0.9805901732233308,0.9909206309280535,-0.010943329627889353,52.57206611794637,65.62214379228338,61.8403000831604,58.058456374037426,62.04271411895752,0.7023705196429032,62.52132143293108,1.8862890271865378,62.238944706225794,61.93992535851486,-3.891924332979171,1.011211509068757,10223300,1.4802818675126976,0.4983323198485013,-673400.0,-56.81914192534514,83.25868849609935,82.425646108079,-17.006732301015035,23.812782365646235,22.45830766193871,0.1009246039195615,2.3470082374772723,65.43959545898437,63.72570169067383,62.34049987792969,60.955298065185545,59.241404296875004,0.06,0.0,61.39930661151844,-0.03481802798693168,-0.0038847178457691563,62.364285060337615,62.61428533281599,1.7060723228811059
2024-02-06,0,62.772499084472656,58.4402494430542,65.79800128936768,60.99937558174133,62.63125038146973,0.3388237684398488,1.7732677720093883,-0.11110658206871227,2.99532413945,61.643749713897705,1.3507050704956058,0.02861106078101442,60.70162448883057,64.52362451553344,0.6908597297685879,0.011461561893806217,1.0128125120364002,1.0036449893717225,1.0098779600043395,-0.00813748834908734,49.143713056687204,65.52493563137534,61.97840008735657,58.43186454333779,62.28249985831125,0.6041510878744719,62.830767835889546,1.476025442268673,62.12180441390943,62.01223451275992,-0.19482710401291656,4.25739280299751,17564300,1.4122813404820236,0.8493367027691463,16890900.0,-48.335136198249586,83.25868849609935,82.425646108079,47.15005047707485,27.408444896431195,20.893975723808232,0.11396782487078834,2.3353459029337382,66.01283966064453,64.65358001708984,63.55500030517578,62.45642059326172,61.09716094970703,0.06,0.0,61.43347230201833,0.00047108635604753424,-0.0007841787700245437,62.63999938964844,62.88714245387486,1.7432407419052935
2024-02-07,0,63.882500648498535,58.4402494430542,65.79800128936768,61.04737424850464,62.901249408721924,0.20650198907078962,1.7673269163566343,-0.12948228272357687,2.9953274933851257,61.78975009918213,1.3600050354003912,0.02847517871072948,60.70162448883057,64.52362451553344,0.6724889363176098,0.0312974863969699,1.0292751191750722,1.0247203445750785,1.0294414034176376,0.026472258390131342,54.10422787590722,65.60017883996119,62.06552500724793,58.53087117453467,62.49249989645822,0.8587193470808537,63.01576784678868,1.4299862781572081,62.279991562029466,62.12553577536404,2.7474059735004537,7.413126539851479,33211300,1.4288829869129795,1.537793702006601,50102200.0,-53.38344478316452,83.25868849609935,82.425646108079,69.59514181283349,29.354770851872306,19.5231061154838,0.06222155687084025,2.3142114703061765,66.01283966064453,64.65358001708984,63.55500030517578,62.45642059326172,61.09716094970703,0.06,0.0,61.51894892269833,0.030806898962564055,-0.006909526140081099,62.56571415492466,62.969285420009065,1.7388879647018909
2024-02-08,0,57.11750030517578,58.4402494430542,65.79800128936768,61.24287509918213,63.43625044822693,0.013646646444780315,1.7871837056329665,-0.2589683799914537,2.9953195986131784,61.916250228881836,1.4060275411605836,0.02872534081415085,60.725250244140625,64.52362451553344,0.6501035474563521,0.04884456542177598,0.918047572584289,0.9171023371997208,0.9155646460668407,-0.07213521124456357,58.53551780238309,65.79064248336371,62.21627507209778,58.64190766083185,61.61107131413051,2.1309064549002787,62.501125063214985,2.0747048365634444,62.66919392779882,62.35927514577025,2.3552978298322618,4.225639567047345,68272700,1.4463767324040502,2.7862473299689103,-18170500.0,-97.10610409892946,83.25868849609935,82.425646108079,-218.40884814296396,23.34431902274763,34.931925848670694,-0.05253189310235923,2.6950795139871917,65.27415940856933,63.457919609069826,61.989999771118164,60.5220799331665,58.705840133666996,0.02,1.0,61.17644556839013,-0.09496935417889252,-0.0850855344064561,61.487142835344585,62.277142660958425,2.203161163814099
2024-02-09,0,57.62375068664551,57.11750030517578,65.79800128936768,61.24287509918213,63.43625044822693,-0.43152711129013327,2.091015537979984,0.016955233999946362,2.995160953358378,61.916250228881836,1.57657753944397,0.03371149855018515,59.13190059661865,64.52362451553344,0.3632497570715283,-0.06201375139042837,0.9290141332979781,0.9323152870164362,0.9370187879309934,-0.07032225844848583,35.713685824780846,66.2088061499651,62.02677507400513,57.84474399804516,60.95232146126883,2.5728179604741888,61.9172500201634,2.220600215140104,61.26888555998788,61.696014498301054,-9.749160638520797,-11.20136663098978,31421400,2.117948868912003,1.2332034053265184,13250900.0,-69.30596744716942,83.25868849609935,82.425646108079,-145.5233314941329,23.097239410767344,32.0120497634625,-0.019919920324114968,2.7241819492715647,63.58572010803223,62.09214017486572,60.885000228881836,59.67786028289795,58.184280349731445,0.02,0.0,61.07627793889722,-0.05623195169011508,-0.05014512395028937,61.13857160295759,61.932142530168804,2.3075334444410833
2024-02-12,0,59.43375015258789,57.11750030517578,65.79800128936768,61.24287509918213,63.43625044822693,-0.46216396801564535,2.2914531757512653,-0.39190270269513183,2.9950419377605257,61.916250228881836,1.7356500148773193,0.03704060562735531,58.35859956741333,64.52362451553344,0.5036866491384063,-0.060921250128666456,0.960727508488152,0.9670294372143918,0.9803480906254175,-0.037190478962512596,37.240221278531976,66.44618145030319,61.863275098800656,57.28036874729813,60.648857252938406,2.6144130209563095,61.53367853164673,2.1461943710611386,60.35194379311125,61.212221564540286,-7.409414309423867,-12.42325061938173,21768200,2.1185956245362703,0.8338988569814157,35019100.0,-57.7712620905959,83.25868849609935,82.425646108079,-76.69891717154798,25.528712764156495,30.08808197539145,0.012163284794879957,2.6852738673900243,63.58572010803223,62.09214017486572,60.885000228881836,59.67786028289795,58.184280349731445,0.02,0.0,61.04613425152542,-0.02356192299915283,-0.03732774887386369,60.86285727364676,61.59714262826102,2.3350626673000607
2024-02-13,0,58.18249988555908,57.11750030517578,65.79800128936768,60.67893671989441,63.43625044822693,-0.3599071589520832,2.3503250932152104,-0.6557317959858264,2.9950045915105314,61.916250228881836,1.8403763103485105,0.03805155377692736,58.35859956741333,64.52362451553344,0.5626245724364698,0.0038001042927121942,0.9419694873966525,0.9512812207798395,0.9670328709880656,-0.07312117990932354,45.26457066137676,66.46751276959083,61.7668625831604,57.06621239672998,60.106000082833425,2.684908154800124,61.08296428407942,2.1395852335551515,60.11925794165085,61.011639700605855,-3.450809759478961,-8.286558659098501,19540200,2.1107862185426334,0.7505133320376804,15478900.0,-72.72729931581972,83.25868849609935,82.425646108079,-126.19857822772926,23.953607848418788,29.781061168736375,0.03603650235495656,2.6518696631419716,62.74532127380371,61.41234111785889,60.33500099182129,59.25766086578369,57.92468070983887,0.02,0.0,60.9925450388749,-0.08554388386842282,-0.05329870889174058,60.26857158115932,61.25714247567313,2.349990119987055
2024-02-14,0,58.52750015258789,57.11750030517578,65.79800128936768,60.67893671989441,63.43625044822693,-0.37159333094166147,2.4159017054168785,-0.7549434379705926,2.9949619165922683,61.916250228881836,1.8982150840759275,0.03914575344146043,58.12662496566772,64.52362451553344,0.5337994765604002,-0.004410480104919393,0.9483428425010774,0.9649762811452279,0.9878392489362816,-0.08382578079364067,42.34387820146883,66.54735345203248,61.71555004119873,56.883746630364975,59.64857155936105,2.634502339562418,60.84564283915928,2.2303031292592794,59.648621308297564,60.745284357285,-6.130763015459948,-9.784082690843146,16520600,2.1228971223308073,0.6507903743248098,31999500.0,-66.04602287564632,83.25868849609935,82.425646108079,-116.7219386600115,23.819810724294918,28.600774451522597,0.007511051712958481,2.5590975483647167,62.74532127380371,61.41234111785889,60.33500099182129,59.25766086578369,57.92468070983887,0.02,0.0,60.95240930946976,-0.06910187587914018,-0.07596923908554083,59.88714272635324,61.12571389334543,2.40511823882095
2024-02-15,0,59.2162504196167,57.11750030517578,65.79800128936768,60.67893671989441,63.43625044822693,-0.3699699555808274,2.410055066326012,-0.7478798193228222,2.9949657752113623,61.916250228881836,1.8929800415039069,0.039048257939963395,58.12662496566772,64.52362451553344,0.6212853827946643,-0.045111560483769644,0.9594350987787227,0.9823368951808398,1.017863591778203,0.03674443214824552,40.983463266695296,66.54002270932745,61.71991257667541,56.899802444023386,59.1405360358102,2.245918267893705,60.71151794706072,2.2703212706388904,59.388667485631366,60.566516939523396,-5.187146621638908,-5.371867758107982,13321000,2.015883729036465,0.5374726921224805,45320500.0,-56.95509479291795,83.25868849609935,82.425646108079,-77.80058561361777,25.868413193088173,26.79646412498697,-0.013426527506184513,2.531751706797769,62.74532127380371,61.41234111785889,60.33500099182129,59.25766086578369,57.92468070983887,0.02,0.0,60.931637354482035,0.06360234503633677,-0.055977242592843146,59.31428582327707,60.97714260646275,2.448720950984851
2024-02-16,0,59.05000019073486,57.11750030517578,65.79800128936768,59.37937521934509,63.43625044822693,-0.2692483300110897,2.4701964582337608,-0.9624685318573931,2.994925329364023,61.916250228881836,2.017555046081543,0.04009011370912418,58.12662496566772,64.52362451553344,0.6640714675344119,-0.07938511272305264,0.958353419332099,0.9833992067014491,1.0077350694249934,0.024751070298169475,40.75963277788902,66.55649298932823,61.61610007286072,56.6757071563932,58.45017882755825,0.8612694141700593,60.47133936200823,2.254335348223825,59.355104940342386,60.4054523786616,-5.66529725074404,-3.0735399923270847,12181800,1.88533841146804,0.5185101632980545,33138700.0,-63.08873452760223,83.25868849609935,82.425646108079,-75.96487932793806,24.863402178916907,25.755397501168982,-0.07746293536913865,2.441863491424605,62.74532127380371,61.41234111785889,60.33500099182129,59.25766086578369,57.92468070983887,0.02,0.0,60.91053029038777,0.0039042529762700617,0.05362548128015339,58.728571210588726,60.647142682756694,2.305172372568987
2024-02-20,0,58.519999504089355,57.11750030517578,65.79800128936768,59.17468786239624,62.901249408721924,-0.07727835972602742,2.4485477377233935,-1.0067277927361253,2.994934647809729,61.78975009918213,2.057455024719238,0.03990951845037457,58.12662496566772,64.52362451553344,0.6171120259452766,-0.10255632338976875,0.9538327409110947,0.9793556180125471,0.9938520998752941,-0.015374272129095146,38.532961831151795,66.24957059408388,61.35247511863709,56.455379643190305,58.65053585597447,0.6322647564786857,60.13080358505249,2.1540627436655084,59.2768100238351,60.339898412186216,-7.564670150208425,-5.38754283225799,12598700,1.8405054848073388,0.5746680265505778,20540000.0,-68.674695774795,83.25868849609935,82.425646108079,-81.44055213759995,24.125756978638048,25.803258559385064,-0.002196127770511777,2.333161696861257,62.74532127380371,61.41234111785889,60.33500099182129,59.25766086578369,57.92468070983887,0.02,0.0,60.88331828899702,-0.024296872703698624,-0.00475299236160455,59.08571406773159,60.286428451538086,2.308640540894277
2024-02-21,1,57.788750648498535,57.11750030517578,64.80375099182129,58.91937518119812,62.50250005722046,-0.07059303107582325,2.2969487385577216,-1.207966518123768,2.995022132689011,61.643749713897705,2.023734893798829,0.03766195123351334,58.12662496566772,63.94350051879883,0.589174612493536,-0.09696586064169324,0.9475340360168517,0.9723405376819643,0.9844887390972512,-0.006767485718816246,37.61431655069713,65.5824725064886,60.988575029373166,56.39467755225773,58.67410727909633,0.5892154401779849,59.813214370182585,2.1477235186905967,59.08238185433537,60.125400011874014,2.4554631967787373,-7.533084493215776,13424300,1.8349320329522574,0.6214818473857282,7115700.0,-81.27054891105657,83.25868849609935,82.425646108079,-100.26828194533451,22.97815954609719,27.92318907351707,-0.0069562083790429075,2.271450550110474,62.74532127380371,61.41234111785889,60.33500099182129,59.25766086578369,57.92468070983887,0.02,0.0,60.84347832559241,-0.013388238959296084,-0.04343485777540238,58.88142830984933,60.00999995640346,2.270802203782202
2024-02-22,0,58.03249931335449,57.11750030517578,64.49249935150146,58.52562499046326,62.279374837875366,-0.0029166090882116204,2.2219616007527567,-1.3250527109951695,2.9950606378445523,61.32599925994873,2.0280423164367676,0.03664316126618085,57.77225065231323,63.34700040817261,0.5469806871923587,-0.1039461762284277,0.957034644657389,0.9846990342275356,0.9899693645070528,-0.008457577001287797,35.530517685948936,65.08174821371254,60.63782501220703,56.19390181070152,58.47392858777727,0.5223587427739429,59.56139292035784,2.1340497082862715,58.75582303128693,59.791625941949505,0.28634019807264405,-7.14429024296085,17293000,1.8370928527769996,0.8088243376005564,24408700.0,-71.74153653313834,83.25868849609935,82.425646108079,-77.39650059632075,22.641651129604558,26.751225198064688,0.06367503755143289,2.1986830800377457,62.74532127380371,61.41234111785889,60.33500099182129,59.25766086578369,57.92468070983887,0.02,0.0,60.80037821059192,-0.00883302984879164,0.001544801839697721,58.63285664149693,59.74785695757185,2.2621536909846847
2024-02-23,0,58.91749954223633,57.11750030517578,63.882500648498535,58.43562459945679,62.04562497138977,0.05854015600335365,2.104577093085908,-1.4701236985604134,2.9951237321232993,60.263874530792236,1.9655748844146728,0.03489319736443766,57.77225065231323,62.82399921417237,0.6210925364987505,-0.06172192473031833,0.9768328024192271,1.0097387612544353,1.006766735761631,-0.005045082646458865,39.18731560962687,64.5239791964715,60.314825010299685,56.10567082412787,58.57892853873117,0.5278575426784399,59.3424643107823,2.020776860579032,58.569062968364264,59.55542714508872,-2.3576685563941058,-5.7271196592328515,13357000,1.7591589653613449,0.6720288433551934,37765700.0,-62.86967148900611,83.25868849609935,82.425646108079,-44.650318817033316,24.41073817237323,25.65552330067536,0.12341381518778835,2.1262061249710187,62.74532127380371,61.41234111785889,60.33500099182129,59.25766086578369,57.92468070983887,0.02,0.0,60.77791262186385,-0.009045241350525535,0.004926124015441003,58.76142828805106,59.51499993460519,2.280641321723877
2024-02-26,0,59.28625011444092,57.11750030517578,63.882500648498535,58.43562459945679,62.04562497138977,0.23519251715083314,2.0946440246457723,-1.4089918425730894,2.9951277573158186,59.325000286102295,1.9440198850631716,0.03481314092407659,57.77225065231323,62.82399921417237,0.6455968784743493,-0.035625419936944853,0.9853419272246602,1.0129337051851588,1.0141032431789638,0.004000845435105038,44.99072883087915,64.35748801762958,60.168199968338016,55.97891191904645,58.68732139042446,0.5898046813212705,59.16794647489275,1.9007051210029957,58.657725665864334,59.51418917990325,1.2632658585020222,-4.9449449929979,11065600,1.7700363527583245,0.5672519836082549,48831300.0,-61.00765655194025,83.25868849609935,82.425646108079,-25.743615816028484,25.761913999736237,24.344557241923578,0.09450087710746015,2.078275532984884,62.74532127380371,61.41234111785889,60.33500099182129,59.25766086578369,57.92468070983887,0.02,0.0,60.764313768927614,0.003212756905092373,-0.00619763697079303,58.827142987932476,59.357142857142854,2.2690068020801504
2024-02-27,0,59.85249996185303,57.11750030517578,63.882500648498535,58.43562459945679,62.04562497138977,0.35780381332365296,2.0917457527235293,-1.3498560767023582,2.9951284700257226,59.25125026702881,1.9237499427795413,0.034817275541239104,57.77225065231323,62.82399921417237,0.6328808010197612,-0.05009013014894357,0.9962496542854334,1.0197119024394172,1.0229622817234687,0.02277000118003336,45.249715846699345,64.26130403405729,60.07781252861023,55.89432102316317,58.778214182172505,0.7196367209574913,58.95937510899135,1.6132057238481952,58.81621900760054,59.51902278420922,1.2963990600570319,-3.957993681628583,11467600,1.7420497304415101,0.5946363157189255,60298900.0,-51.916770251214295,83.25868849609935,82.425646108079,-1.9164847804662395,25.146519977019256,23.539913270624066,0.07897263421540252,1.9936773986532592,62.74532127380371,61.41234111785889,60.33500099182129,59.25766086578369,57.92468070983887,0.02,0.0,60.756005939868054,0.026095834068284418,0.017247217928483907,58.892857142857146,59.10357148306711,2.1168081299753103
2024-02-28,0,60.072500228881836,57.11750030517578,63.882500648498535,58.43562459945679,61.792749881744385,0.5091736104607396,2.02213160001724,-1.0945936293146286,2.9951664585159015,59.25125026702881,1.7798811721801762,0.03373040740969619,57.77225065231323,62.82399921417237,0.578877656109421,-0.05427612718012245,1.0020465071719253,1.0227304208979662,1.0220670230735105,0.0395189298047689,47.28640018718918,63.994075707663875,59.949812507629396,55.90554930759492,58.9242856161935,0.8717045323483797,58.687232221875874,0.8680944266970838,59.070775362213325,59.55558643390012,1.0744509112410068,-4.651717177438164,9851600,1.7336970159116558,0.522954782640084,70150500.0,-12.670592408233498,83.25868849609935,82.425646108079,15.649611339441245,26.230161720515714,22.268214200889844,0.06750077333758125,1.9550705230467282,59.68932127380371,58.940341117858885,58.33500099182129,57.72966086578369,56.980680709838865,0.02,0.0,60.75116581291385,0.048190683365059384,0.027630886958413686,59.05142865862165,58.88999993460519,1.944125004250174
2024-02-29,0,60.70524978637695,57.11750030517578,63.882500648498535,58.43562459945679,61.60087466239929,0.6161493999387909,1.8726772918801833,-0.7468104404473439,2.9952447372345916,59.25125026702881,1.5772499084472655,0.031321402503680054,57.77225065231323,62.288749599456786,0.5527913590261689,-0.03474731967100435,1.0153236603496996,1.030188091130962,1.0248682087612353,0.04605609795626031,50.00179810543508,63.53441708376037,59.7890625,56.04370791623963,59.23646422794887,1.071246195316043,58.94350004196167,0.8980986325557103,59.33219006843379,59.59045671639396,1.7315834629030302,-5.964075264649566,17117300,1.7232760926393949,0.9050523315911501,87267800.0,-26.74378958599914,83.25868849609935,82.425646108079,44.02789078837411,28.0132702039103,20.738551402540303,0.07319452166658175,1.9475488866780297,60.51938482666016,59.68630863952637,59.01300048828125,58.33969233703613,57.50661614990234,0.02,0.0,60.75100535994283,0.034104571216902135,0.04975644803633015,59.29571424211775,59.19071415492466,1.918437659299433
2024-03-01,0,60.72999954223633,57.11750030517578,63.882500648498535,58.43562459945679,60.918437242507935,0.7014148621097342,1.8010856257615038,-0.425020524933315,2.9952804176202745,59.25125026702881,1.4854649162292475,0.03016258510985165,57.77225065231323,62.061499977111815,0.5298643868341059,-0.013852786476396777,1.0170386980571655,1.0268132955162157,1.0161159643256605,0.03076335577854361,54.64538695994783,63.31474625800799,59.71257500648498,56.11040375496197,59.656642641339985,0.9818633899559082,59.16537496021816,0.9301033189955686,59.68348686096124,59.73684333873333,3.7341939521631287,6.281348907133569,17462600,1.7255636156600438,0.9136164564597873,104730400.0,-28.087270176844847,83.25868849609935,82.425646108079,49.95522569429359,26.49883372807278,19.617396375960993,0.014631211310590383,1.9101743976994838,60.751844970703125,60.06257887268066,59.50550079345703,58.9484227142334,58.25915661621094,0.02,0.0,60.75168508805044,0.023326590122964674,0.03753217649830003,59.73285729544504,59.307142802647185,1.859447813381064
2024-03-04,1,59.96249961853027,57.11750030517578,63.882500648498535,58.43562459945679,60.7114372253418,0.7652051685194535,1.7673917242107648,-0.20851032106282785,2.9952967749412287,59.25125026702881,1.435784912109375,0.029618852387612197,57.77225065231323,62.061499977111815,0.49661957659803,-0.02020732517268456,1.0048821665647378,1.011248314886714,0.9972259728879147,0.011406515048328902,54.1914919061125,63.205958451473286,59.67117500305176,56.13639155463023,59.93235697065081,0.6718026123993044,59.20314277921404,0.9523093855292109,59.94692482684032,59.86316518721493,5.089656482847345,5.390570413374191,17125200,1.7221459151649234,0.8901116121955042,87605200.0,-39.94919124550939,83.25868849609935,82.425646108079,9.819891650529234,24.745816035712323,23.452295856559147,0.002597868921707488,1.8978948422788449,60.751844970703125,60.06257887268066,59.50550079345703,58.9484227142334,58.25915661621094,0.02,0.0,60.73818342905667,0.010955632751074917,0.01386071157774164,59.965714590890066,59.2992856161935,1.7565622372563239
2024-03-05,1,59.11999988555908,57.11750030517578,63.882500648498535,58.43562459945679,60.230687618255615,0.9294069693883712,1.6883734255355276,0.3772628828412494,2.9953339727748944,59.25125026702881,1.3145848846435542,0.028342596376420642,57.77225065231323,61.83379974365234,0.45823637539262324,-0.028624890912863896,0.9924429449006252,0.9955078392239327,0.9810079068823827,-0.012238420730308786,49.437966110923576,62.946921831234626,59.57017498016357,56.19342812909252,59.96128559112549,0.6234370963018744,59.270107064928325,0.9068980504788816,59.95257019943346,59.82001838577467,3.3257232206293206,0.88964513358974,18056700,1.7289063574354657,0.9198028328075083,69548500.0,-76.17030629081547,83.25868849609935,82.425646108079,-27.9028555726577,22.070913554442686,24.53256346367922,-0.021040765551573953,1.974478324740743,60.751844970703125,60.06257887268066,59.50550079345703,58.9484227142334,58.25915661621094,0.02,0.0,60.71205751269296,-0.03141621333846689,-0.017866194852132745,59.83857182094029,59.300000054495676,1.727292185475327
2024-03-06,1,58.42499923706055,57.11750030517578,63.882500648498535,58.43562459945679,59.989999771118164,1.182843866008749,1.6157288734776702,1.2105480768303956,2.9953665997534613,59.16812515258789,1.1899848985672001,0.02718265526110584,57.77225065231323,60.93424949645996,0.35082166211186017,-0.05818629578533146,0.9829289053138512,0.9828119249619441,0.9718378992575125,-0.02742521096248962,42.667185225821854,62.671157730552146,59.4396999835968,56.20824223664146,59.838249751499724,0.8297169216413856,59.26278557096209,0.913742293081007,59.74293558066218,59.65590629070021,0.34370152314014446,1.6113092456391476,17187400,1.7149094079161264,0.8763622253687882,52361100.0,-79.34763110646405,83.25868849609935,82.425646108079,-60.72372383935635,21.22772850557552,23.595334894869236,-0.0905878330829554,1.9049813513120075,60.751844970703125,60.06257887268066,59.50550079345703,58.9484227142334,58.25915661621094,0.02,0.0,60.67846065684035,-0.03535271482348934,-0.03390958977229948,59.665714263916016,59.246428625924246,1.4438069866181438
2024-03-07,1,58.49125003814697,57.11750030517578,63.882500648498535,58.36437439918518,59.87999987602234,1.502082051135773,1.4350718773609972,3.095694660905484,2.9954420740418795,59.08500003814697,1.0146650123596188,0.024231940869825754,57.77225065231323,60.70772476196289,0.05091026549147717,-0.08543030338569345,0.9876554162102293,0.9828744271648505,0.9783018724457748,-0.036471306122964564,36.946544092264006,62.09246874594819,59.222324991226195,56.3521812365042,59.64378547668457,0.9729741089712128,59.21099982942854,0.9368351629027463,59.40394965256259,59.36472512858641,-1.4526991936880622,-0.17513291232345843,19447900,1.6899523908004088,1.0276822496676186,71809000.0,-71.29846749548717,83.25868849609935,82.425646108079,-40.902059891161116,20.839624266433614,22.57900765092979,-0.03975327188981317,1.8473736970957755,60.751844970703125,60.06257887268066,59.50550079345703,58.9484227142334,58.25915661621094,0.02,0.0,60.64445402669246,-0.030493870532563694,-0.029045643153526972,59.42857142857143,59.160714285714285,1.1026833262312472
2024-03-08,1,58.88300037384033,57.11750030517578,60.72999954223633,58.36437439918518,59.538437604904175,0.14461863160530616,0.9631349889048174,-0.6578859450980685,2.995598909428525,58.983749866485596,0.790137529373169,0.016337402162396316,57.77225065231323,60.13577518463135,0.6321056485069262,0.024051292959799,0.9988166443105226,0.9886951555649951,0.9922024863939898,-0.030413291327483827,48.30294305922813,60.87903243851825,58.95276246070862,57.02649248289899,59.473856925964355,0.9893549538191551,59.19907127107893,0.9401003335982345,59.15991147148911,59.070048496707564,-2.2743409624888633,-1.2243267284440456,18272400,0.7243971097206756,1.112540927086996,90081400.0,-60.49570856718989,83.25868849609935,82.425646108079,-15.461677335676859,21.755848540210124,21.395249366503588,0.11817355701453715,1.809275113821722,60.751844970703125,60.06257887268066,59.50550079345703,58.9484227142334,58.25915661621094,0.02,0.0,60.61975924757654,-0.02527258954173095,-0.022041793630947576,59.2514283316476,59.151428495134624,0.8702784506242702
2024-03-11,1,59.56125068664551,57.62375068664551,60.72999954223633,58.474687337875366,59.538437604904175,0.3659962669710655,0.8669893361992439,-0.6483176091615888,2.995624640083043,58.983749866485596,0.7018625259399414,0.014684520689965919,58.0081244468689,60.13577518463135,0.6008738455307129,0.02185296292222539,1.0088110447384941,1.0001414846058108,1.0099175492837014,-0.00669166453095571,50.7723395807118,60.77501613654033,59.041037464141844,57.30705879174336,59.31042848314558,0.8343946557389884,59.27344635554722,0.9232819639196891,59.09502894483731,59.03968420778256,-1.980107121410626,-0.2828108659697076,11172700,0.7212313464873213,0.7249544012006548,101254100.0,-37.83094776750146,83.25868849609935,82.425646108079,53.44948355655553,23.309991615072025,20.287197828131134,0.07293816853441594,1.7708446113102427,60.751844970703125,60.06257887268066,59.50550079345703,58.9484227142334,58.25915661621094,0.02,0.0,60.61211897231865,0.0016672605798861984,-0.0075982668899279016,59.214285714285715,59.25499997820173,0.8920300786128194
2024-03-12,1,59.90024948120117,57.788750648498535,60.72999954223633,58.51281213760376,59.63406300544739,0.37039724614576675,0.809556509959799,-0.6311177496474945,2.9956387265916447,59.08500003814697,0.6579038333892825,0.013689298053100402,58.16749982833862,60.13577518463135,0.7170566029995462,0.0021452547370858694,1.0128908340740226,1.0053696341138154,1.017049506439242,0.01319772660947982,52.90191195004784,60.75702548406145,59.13791246414185,57.518799444222246,59.191892760140554,0.6339871770122436,59.424267700740266,0.8298260394699617,59.21726278748696,59.1023086344403,-1.8845142780191204,1.7793082559465676,13485100,0.6134392552603397,0.8991604230990166,114739200.0,-40.836331240454776,83.25868849609935,82.425646108079,68.7602449677972,23.227515022282887,19.292224129500486,0.04811556161273605,1.7282941424636384,60.804944610595705,60.148528289794925,59.61800003051758,59.08747177124023,58.43105545043945,0.02,0.0,60.60501464450743,0.03020419268417407,0.0008335984901990327,59.14142826625279,59.43714278084891,0.8890211435906226
2024-03-13,1,61.385000228881836,57.788750648498535,60.72999954223633,58.51281213760376,59.86443734169006,0.30316341155854515,0.8243297751767731,-0.7997974797048149,2.9956353305819308,59.08500003814697,0.683561296463013,0.013933612800850368,58.16749982833862,60.13577518463135,0.7349575548339293,0.029523475254944073,1.0375881725076994,1.0302072220139218,1.0395049167041275,0.0506632611120974,59.222718394775164,60.809896980926055,59.16123743057251,57.51257788021897,59.39510713304792,1.0278173730008553,59.663732051849365,0.8795363582648748,59.38706447535461,59.179667127031884,-1.3662935407369532,3.653823294339549,19983400,0.5402093717481623,1.3304886050522666,134722600.0,-15.6537463416142,83.25868849609935,82.425646108079,205.0255517612816,31.031402855796603,16.68378217257358,0.08739868831881059,1.8548916437271394,62.01851916503906,61.2257391204834,60.584999084472656,59.944259048461916,59.151479003906246,0.02,0.0,60.62408930726222,0.07450106522075717,0.07173503127403622,59.494285583496094,59.73000008719308,1.117659921249202
2024-03-14,1,62.97999858856201,57.788750648498535,61.385000228881836,58.52562499046326,59.91581201553345,0.4473195517687446,0.9237095036735381,-0.47940500785102946,2.995611310424879,59.16812515258789,0.7598349952697759,0.015571279309158048,58.38574924468994,60.70772476196289,0.6286424615052382,0.048823203944199145,1.061674850169643,1.054652514878145,1.0559291802762332,0.0767422229391157,68.54613725545525,61.16878145508573,59.32136244773865,57.47394344039157,59.946535519191194,1.6825427784724727,59.953910555158345,1.2190319476720903,59.88640841722416,59.506785447087445,2.372317063833619,5.776936983921806,19342000,0.6222075235232541,1.2758015561982274,154064600.0,-18.95730370122173,83.25868849609935,82.425646108079,242.46734494132642,32.11957449134954,15.404792972989101,0.03036627768209891,1.8645962946049597,62.70611741638184,61.781937705993656,61.03499794006348,60.2880581741333,59.36387846374512,0.02,1.0,60.660708295471075,0.07692307692307687,0.08396423189605488,60.16999980381557,60.00428581237793,1.3649618064610827
2024-03-15,1,62.927499771118164,57.788750648498535,62.97999858856201,58.79225015640259,59.989999771118164,1.0704246227195704,1.2006029504939493,1.1838975007050436,2.9955304007066728,59.25125026702881,0.9253361797332765,0.02016329445730362,58.38574924468994,60.79549961090088,0.6224509892834352,0.06355938010722961,1.056823745789517,1.0497745183026965,1.0394041135865006,0.06868704671297055,74.85360950709656,61.94519327052526,59.543987369537355,57.14278146854945,60.58974988119943,1.855653676978819,60.21399981634958,1.4349462062000609,60.658180071299014,60.01452693463367,6.529091188218676,6.895233297219938,20032000,0.692422491540251,1.2927027664497428,134032600.0,-21.32699679577382,83.25868849609935,82.425646108079,190.96158266085817,30.35644634632366,14.55918326336207,-0.017685488213328073,1.8312379356346853,62.70611741638184,61.781937705993656,61.03499794006348,60.2880581741333,59.36387846374512,0.02,0.0,60.69603820930142,0.06507372075600704,0.07435894827557425,60.84571402413504,60.25571414402553,1.5439501552128543
2024-03-18,1,63.80250072479248,57.788750648498535,62.97999858856201,58.79225015640259,60.230687618255615,0.9683125457346647,1.40500934108198,0.2957535032485308,2.995457629832354,59.42375040054321,1.0949548673629763,0.02352285166912458,58.38574924468994,61.53925018310547,0.7401424333637731,0.06566468362165548,1.0681898808678005,1.060483871619693,1.039962005115663,0.07120820985543741,74.719784273787,62.53956851927639,59.72954983711243,56.919531154948466,61.348499979291645,1.9385930390166137,60.49614272798811,1.7186781570955962,61.220748996567295,60.424571004435506,7.706462289864371,6.141811380629574,14219900,0.689732927140466,0.9116419158206245,148252500.0,-7.692286397814605,83.25868849609935,82.425646108079,196.7583935064848,31.72477452050874,13.472616498849625,-0.0034973118577196864,1.8368912865152278,63.133961380004884,62.12802091217041,61.31500053405762,60.50198015594482,59.49603968811035,0.04,0.0,60.7308620441821,0.06907459053594467,0.08845967096893766,61.66428593226841,60.54642868041992,1.8260361519193433
2024-03-19,1,63.40750026702881,57.788750648498535,63.80250072479248,58.79225015640259,60.7114372253418,0.9174129803410053,1.6504371105225935,-0.06924254486317327,2.9953565851387456,59.70687532424927,1.283252482414246,0.027522342252585937,58.38574924468994,62.93274965286255,0.7511054287695504,0.09026830597177271,1.0573701430995612,1.0472343503451091,1.0194287615775761,0.05855152217568538,79.33620080583458,63.2680490848605,59.96717486381531,56.66630064277012,61.994857106889995,1.7216856541958478,60.734357016427175,1.8790790500393122,61.86197001241548,60.88843896484655,9.0804191792475,6.599558523799315,9089300,0.682343712630366,0.5893474856785312,139163200.0,-25.399172725979184,83.25868849609935,82.425646108079,134.17993107276956,29.924127163632676,13.898661527997753,-0.025048732116058518,1.8076973573121373,63.133961380004884,62.12802091217041,61.31500053405762,60.50198015594482,59.49603968811035,0.04,0.0,60.74781273685095,0.04964183912767406,0.04876824902099176,62.23571450369699,60.74357141767229,1.9090483414870325
2024-03-20,0,64.27625179290771,57.788750648498535,63.80250072479248,58.90887475013733,60.893749713897705,0.712711341961836,1.7751900220626362,-0.6335145616152662,2.9953005614933366,59.8763747215271,1.4456899595260615,0.02948254985884001,58.38574924468994,63.02274875640869,0.7935748801437346,0.09722912427552645,1.067507013148867,1.0541181656395617,1.021871875083133,0.04710029409864758,76.74379129804036,63.76192994608754,60.21154990196228,56.66116985783702,62.66842869349888,1.5216022081953382,60.989428588322234,2.1037604659208404,62.24519137676964,61.23536718269416,7.683881365526601,5.551625161996439,12641400,0.65992997399177,0.8217503098286119,151804600.0,-4.1388182793732895,83.25868849609935,82.425646108079,157.49406031018728,32.28101414185584,12.629991016569491,0.025859042585273165,1.846594954970537,63.5923602142334,62.49881996917725,61.614999771118164,60.73117957305908,59.63763932800293,0.06,0.0,60.78218317428565,0.041633342787103844,0.08362492711214638,62.94571467808315,61.08000019618443,2.0728920218358224
2024-03-21,0,65.8700008392334,58.03249931335449,64.27625179290771,59.069374799728394,61.77062511444092,0.6705091474488314,1.8917380100498886,-0.8709567038318173,2.9952472421046754,59.93137454986572,1.5926601028442378,0.03124984067436686,58.48462495803833,63.44700031280517,0.7842164941013317,0.10759061824718627,1.0881142211611905,1.069987802922956,1.0376700959254799,0.04588762012446668,79.45100790332903,64.31940097928252,60.535924959182736,56.75244893908296,63.52125031607492,1.3776643697046858,61.35657153810774,2.471391263453401,62.754068192110324,61.6693148193732,7.916222463272381,5.882525842653136,14022100,0.6719862142977366,0.9212967708193714,165826700.0,-9.320159799025662,83.25868849609935,82.425646108079,178.64789384165465,36.16457717739347,11.681988262895354,0.0009702681126223277,1.853292198599086,64.83767811584472,63.50615827178955,62.42999839782715,61.353838523864745,60.02231867980957,0.08,0.0,60.83515297713338,0.049841260153149713,0.059087247103746875,63.81857190813337,61.48000008719308,2.3360170070106543
2024-03-22,0,65.80249977111816,58.42499923706055,65.8700008392334,59.24468755722046,62.940624475479126,0.778955500525529,2.1294055273114396,-0.5784426991585963,2.9951267853006858,60.017499923706055,1.8154151964187626,0.03494965395224416,58.843825340270996,63.849875831604,0.7747479624136788,0.11800401155879017,1.080007808140177,1.0562313392674756,1.0272531633839792,0.04568749768315983,83.06477279547558,65.18661109009956,60.927800035476686,56.66898898085381,64.15232167925153,1.2410030806082017,61.77371440614973,2.700253535461895,63.537784990766376,62.22009785858176,9.966154414608484,8.463693949844865,10196000,0.7198062757635851,0.6769393788702761,155630700.0,-26.439265186905907,83.25868849609935,82.425646108079,136.36665524630058,32.75281099770085,11.712001006012425,-0.05671221702778173,1.8996516106514392,65.03631974792481,63.66683959197998,62.55999946594238,61.453159339904786,60.08367918395996,0.1,0.0,60.869601402197816,0.030548897622262983,0.028095184810577878,64.14999989100865,61.82214273725237,2.4350046215111942
2024-03-25,0,65.49625205993652,58.42499923706055,65.8700008392334,59.49250054359436,63.08687400817871,0.6451183909170616,2.3242050902066036,-0.8685711419865858,2.995018345616343,60.388875007629395,2.0274851608276365,0.0379325498074045,58.843825340270996,64.42887659072876,0.8300360809912419,0.10991165142168473,1.0689417443970122,1.039767044503096,1.013375800157632,0.026546786033511793,82.08061635392143,65.92046022733398,61.272050046920775,56.623639866507574,64.51178646087646,1.208844821240366,62.22916099003383,2.755398094668426,64.10947579616548,62.6333451059689,7.196382708748254,9.73942078756028,10224300,0.7262785677376116,0.6807194082229211,145406400.0,-13.38329742589624,83.25868849609935,82.425646108079,121.63219001637631,30.735578577631756,10.990663587527383,-0.0337126392943862,1.87925191805495,65.04575996398925,63.68211994171143,62.579999923706055,61.47787990570068,60.114239883422854,0.1,0.0,60.904645591988434,0.027557162549569414,0.05011935723715157,64.57857131958008,62.374285561697825,2.6012850637768214
2024-03-26,0,66.96999931335449,58.42499923706055,65.8700008392334,59.77968764305115,63.50625038146973,0.45176681625067044,2.449600590847639,-1.1777826625778702,2.994945515035896,60.71762466430664,2.1902102661132816,0.03977751140723953,58.843825340270996,65.5268768310547,0.8735938076421401,0.09429434195197427,1.0874833724252118,1.0532395363844678,1.0307754802286357,0.05618419006147368,78.0774690646772,66.48175132589083,61.58255014419556,56.68334896250028,65.08928639548165,1.2888067932845049,62.839518138340544,2.79404919932957,64.46237135731278,62.95727068784638,3.995321574731658,10.785270951827139,14826400,0.7381940227814495,0.9762055493938057,160232800.0,-12.97408176015149,83.25868849609935,82.425646108079,138.05158517426736,34.457247458910636,10.168003859874748,-0.10106283766550318,1.8857540859775668,65.6052811126709,64.1423610458374,62.96000099182129,61.777640937805174,60.314720870971684,0.12000000000000001,0.0,60.968220772219574,0.05808601721802198,0.03798839614646109,65.12428556169782,62.98499979291643,2.8057412351094313
2024-03-27,0,67.15999984741211,58.42499923706055,66.96999931335449,59.815499782562256,63.92093849182129,0.36481183361441016,2.67870730166193,-1.216360603135795,2.9948014913478707,61.05749988555908,2.4086677122116087,0.043247907850870994,58.843825340270996,65.80924987792969,0.8503511814492901,0.11481957731395465,1.084302671987848,1.044613025726356,1.0224867785441827,0.044864906930098813,82.05480181302988,67.29583971509447,61.93842511177063,56.581010508446774,65.56892912728446,1.3532537634046804,63.458714553288054,2.715747665728846,65.09265866415994,63.40910838311386,6.424058729394671,14.625588682718583,10591200,0.7830323367388379,0.6956560577453905,170824000.0,-16.452644820173813,83.25868849609935,82.425646108079,119.04833210660505,31.766607262533068,10.732047430110073,-0.12469494522782461,1.8989523244187463,65.85755143737794,64.40222365570068,63.22599983215332,62.04977600860596,60.59444822692871,0.14,0.0,61.01229730971531,0.023366588343693095,0.056498991717547964,65.45857075282505,63.56142834254673,2.9544390589117793
2024-03-28,0,67.00250053405762,58.42499923706055,67.15999984741211,59.815499782562256,64.58125185966492,0.238972617245253,2.870374458748468,-1.3182177130883972,2.9946739215839995,62.15625,2.5764502048492433,0.04607875154876807,58.843825340270996,65.98000068664551,0.8786288880133136,0.1063293551010754,1.0756058554817254,1.0328853844730177,1.0112096735007539,0.017192950970021492,82.1413440567428,68.03354901019408,62.29280009269714,56.552051175200205,66.08250059400287,1.042819670364435,64.03867885044643,2.523595551720935,65.60997546566664,63.84567843201062,5.262331545752354,14.820592487955942,10775800,0.7812447296305851,0.7228349932149112,160048200.0,-13.16784998460122,83.25868849609935,82.425646108079,107.7102774119559,30.184750847673357,10.1976322207175,-0.09485971549887588,1.8553396937702284,66.02345922851562,64.67076931762695,63.57749938964844,62.48422946166992,61.13153955078125,0.14,0.0,61.0570265405603,0.0128515041119599,0.029823131760165156,66.02714211600167,64.13142830984933,3.0953972793882825
2024-04-01,0,66.09774971008301,58.42499923706055,67.15999984741211,59.815499782562256,65.57281398773193,0.08805114130253906,3.0204236837901295,-1.4385941184739661,2.9945694940678096,62.95374917984009,2.7010714578628536,0.048243674286905944,58.843825340270996,66.9732494354248,0.8995562564992285,0.10328504921951971,1.0557453661961969,1.0126586521185783,0.9941566776091366,0.004486910679561085,80.25957547699853,68.64850999766144,62.60766263008118,56.566815262500924,66.34271458217076,0.6817325668238886,64.50557163783482,2.21761330829837,65.95370506093877,64.17455696575762,5.669676697376712,13.789209294138647,9840500,0.7861564467158653,0.6774131704044688,150207700.0,-35.67423315535117,83.25868849609935,82.425646108079,70.49230276424174,27.48692988999213,14.699543389901073,-0.09799386134046016,1.891547796249784,66.10629563903808,64.8048519821167,63.753000259399414,62.701148536682126,61.39970487976074,0.14,0.0,61.08889589167199,0.0040142372966804896,-0.016782591784016383,66.02428436279297,64.48499952043805,3.0999555034848827
2024-04-02,0,64.25,58.42499923706055,67.15999984741211,59.815499782562256,65.81937503814697,-0.09492673285126797,3.0795587074557167,-1.4920804445766895,2.9945302528618107,63.19374942779541,2.7280151557922365,0.04897824689485944,58.843825340270996,66.9732494354248,0.9132425795629333,0.10231811766660828,1.0218517203052768,0.9795920783997759,0.9655077025295012,-0.019027837788276214,72.21595566849362,69.03516755338494,62.87605013847351,56.71693272356208,66.1112858908517,1.0463935780828792,64.81626810346332,1.7853331253465292,65.98339700546428,64.31080636962928,2.8338583323806668,10.974415325538283,10329300,0.796767991048817,0.7280928243809911,139878400.0,-42.26186178167301,83.25868849609935,82.425646108079,31.128410733174977,25.922851326299536,19.438025085814417,-0.09143910702527303,1.8620838612511716,66.22759962463378,65.00119995880127,64.01000022888184,63.018800498962406,61.79240083312988,0.14,0.0,61.11174985004619,-0.020302974816524655,-0.0016982088414050573,65.81285640171596,64.81571415492466,3.04912283092142
2024-04-03,0,64.92125129699707,58.42499923706055,67.15999984741211,59.815499782562256,65.81937503814697,-0.2646187968099919,3.0178921888215164,-1.3614020429773939,2.994582655909058,63.605000495910645,2.614057812690735,0.04783439295717776,58.843825340270996,66.9732494354248,0.9070664675056573,0.08677266786825544,1.0290190807064337,0.9891514767161914,0.979262737577088,-0.030592026838335062,57.90639988830544,69.12620953519003,63.090425157546996,57.05464077990396,65.98539325169155,1.1386781731600233,65.06885746547154,1.4879151555776202,65.54185001331892,64.22826771069556,-2.4593909497394386,7.261656765159108,7176100,0.8991908423749073,0.5260006039833582,147054500.0,-47.833379109700516,83.25868849609935,82.425646108079,44.51109539852362,27.288564213127817,18.631854327936693,-0.02628301798385015,1.8035959345342738,66.79399908447266,65.91799908447265,65.20999908447266,64.50199908447266,63.62599908447265,0.14,0.0,61.13091999816302,-0.019949030562208647,-0.010000055486505682,65.894284929548,65.02214241027832,2.867589202923873
2024-04-04,0,65.30749893188477,58.42499923706055,67.15999984741211,61.01381254196167,65.81937503814697,-0.45871376237823963,2.8987789401963386,-1.1196129827590795,2.994678358867784,64.02625036239624,2.4490653419494635,0.045736141265291796,58.843825340270996,66.9732494354248,0.8701468844157799,0.11118959597376898,1.0304038557108002,0.9927467641633895,0.9912151487731811,-0.027583396660753934,62.555925160016336,69.17804560851157,63.380487728118894,57.58292984772622,65.95842851911273,1.1543194111625361,65.23510748999459,1.3612002900512181,65.37850896079894,64.30333752104002,-1.3392325172848352,5.760773894159598,9933400,0.873404444311256,0.7479936084626123,156987900.0,-63.49479141917328,83.25868849609935,82.425646108079,39.49039793164012,28.68043473265639,17.15108332433353,-0.019192773709085238,1.8190843273669135,66.8459193725586,66.00203955078125,65.31999969482422,64.63795983886719,63.79408001708984,0.14,0.0,61.15722918146985,-0.03049419841674872,-0.03194836226064448,65.68571363176618,65.13214247567313,2.588208720446216
2024-04-05,0,64.84499931335449,58.49125003814697,67.15999984741211,62.54187488555908,65.81937503814697,-0.6284504752050669,2.6911563757470587,-0.8072939300307445,2.994832054680007,64.26312589645386,2.2261152267456055,0.04223103540657475,59.49342565536499,66.9732494354248,0.838610464557336,0.11653450540537866,1.017581693364584,0.9841734538249826,0.9897612365218564,-0.032200308996027105,64.29243724640628,69.10692546435422,63.72461271286011,58.34229996136599,65.6548570905413,1.1229484743802869,65.37207174301147,1.1978109231190341,65.35833257829847,64.42800712502066,-0.28818920490141514,3.695618284350769,8058000,0.8710085166774019,0.6339608034733311,148929900.0,-56.56187883364746,83.25868849609935,82.425646108079,27.8295694131891,27.0635845660875,17.303685878101664,-0.0023961337403100983,1.7898104799175072,66.93323912048339,66.14337914276123,65.5049991607666,64.86661917877197,64.07675920104981,0.02,1.0,61.17731174237832,-0.027466732296848706,-0.021330902440363335,65.46857125418526,65.29642840794155,2.288613062598917
2024-04-08,0,65.9749984741211,58.88300037384033,67.15999984741211,62.96687388420105,65.81937503814697,-0.7524255283921009,2.4155240376713047,-0.42935459413360055,2.995013786328669,64.5606255531311,1.9491401290893549,0.03771763398581247,59.866349601745604,66.9732494354248,0.8106907775607136,0.10125161594453785,1.0301784647361272,1.002883979675951,1.013685306989607,-0.0018571167172910519,60.02833509683938,68.87334825196308,64.04230017662049,59.21125210127789,65.48557118007115,0.9311741161218569,65.5272501536778,1.1168157279308777,65.22894354596271,64.50188346760743,-3.1730625978612688,3.047156726726338,8421400,0.8899856644375256,0.6892608987630151,157351300.0,-34.56567096719149,83.25868849609935,82.425646108079,67.67456910322504,30.335103931828225,16.22110736534403,0.001490376512627373,1.7726515504988436,66.93323912048339,66.14337914276123,65.5049991607666,64.86661917877197,64.07675920104981,0.02,0.0,61.20494169265019,0.020144511505216345,-0.009702963824551025,65.43571363176618,65.44714219229562,2.0033585110379724
2024-04-09,0,66.89875030517578,59.56125068664551,67.15999984741211,63.30062484741211,65.89625024795532,-0.8487371346402721,2.136553930197326,-0.06937684349626894,2.9951764146353455,64.88312530517578,1.7081849193572993,0.03317790029471704,61.23652515411377,66.9732494354248,0.7611592917790698,0.10768322883645626,1.0388504760379726,1.0166593205643695,1.0282663353781463,0.04122568568366969,64.73674454455596,68.67000794202917,64.39690008163453,60.123792221239874,65.47074971880231,0.9034170550248489,65.77662515640259,0.9896249642331064,65.41858390157036,64.74383506346265,-1.7644451697190966,3.4050354212596257,8459900,0.9053071848467968,0.7001851871010459,165811200.0,-23.74876742913232,83.25868849609935,82.425646108079,95.16559004594524,31.509267846621974,15.597348973191075,-0.020371207047136446,1.7116516191261417,67.00757969665527,66.26371007537841,65.66250038146973,65.06129068756104,64.31742106628418,0.02,0.0,61.23662078700122,0.036189239179735155,0.03029372993514956,65.43714250837054,65.7321423121861,1.7967216143070244
2024-04-10,0,65.56000137329102,59.90024948120117,67.15999984741211,63.70375061035156,66.00568628311157,-0.8619696420226785,1.8905165745109462,0.23553355073893245,2.9953024414906895,65.11437511444092,1.5181199645996089,0.029190957023192823,62.773249816894534,66.9732494354248,0.6734274739164023,0.11683592112869226,1.0122943159190587,0.9941953701421764,0.9995502589413457,0.009838844192510132,68.24949834439288,68.54480821158293,64.76377506256104,60.982741913539144,65.39392852783203,0.8631821604724172,65.8683215550014,0.8948458753471162,65.79107779651856,65.11266594534686,-0.15484530883903252,5.506052160145452,8566300,0.9147233231459082,0.7237229790895654,157244900.0,-50.00004093022952,83.25868849609935,82.425646108079,33.561598814037104,28.966751536199336,19.863021463780576,-0.018252058263096074,1.7287013734886136,67.1102391204834,66.42987914276124,65.8799991607666,65.33011917877197,64.6497592010498,0.02,0.0,61.26173778613851,0.008264477284860128,0.01886782434600305,65.5585708618164,65.79142761230469,1.4168836366406274
2024-04-11,0,65.67575073242188,61.385000228881836,67.15999984741211,64.13812518119812,66.00568628311157,-0.5740169711109634,1.530678183900329,-0.34529638110714833,2.995454080930079,65.40187549591064,1.2625861930847164,0.023531965640902038,62.97474870681763,66.9732494354248,0.66137953142675,0.06801337670183519,1.0096697829309582,0.9980847895629452,0.9993685227646334,0.005638736845843484,56.57399877436306,68.10811902496619,65.04676265716553,61.98540628936487,65.5976072038923,0.7013031809409321,65.854446547372,0.896322585651381,65.73455425047476,65.31840905209532,-0.8135652713604565,1.9972377737884066,8785500,0.9499546064524722,0.7790953608110289,166030400.0,-51.716654755969884,83.25868849609935,82.425646108079,20.802026016194866,26.92907689745534,19.99861250472225,-0.052169362598255505,1.7265052780871253,67.1102391204834,66.42987914276124,65.8799991607666,65.33011917877197,64.6497592010498,0.02,0.0,61.28670558850415,0.019522809395054352,0.007040201096559136,65.72142791748047,65.76714215959821,1.2806363827142506
2024-04-12,0,65.02499961853027,62.927499771118164,67.15999984741211,64.26968884468079,66.00568628311157,-0.31277898399022297,1.283084349854119,-0.8962884102525859,2.995538578962874,65.52812671661377,1.0680399703979504,0.019660723066643373,63.36475009918213,66.9732494354248,0.6824898512523749,0.04280330587923269,0.9963791624875383,0.9904292705861036,0.9883585659919423,0.0027758548397225358,55.067332317279465,67.82746888205077,65.26130018234252,62.69513148263429,65.61242839268276,0.6855461776507275,65.79891082218715,0.9234645890312531,65.72129683855212,65.46715846427027,2.2190672878161477,-0.29489920196846947,9909200,0.8929596979994207,0.9171024257512795,156121200.0,-77.68246491665377,83.25868849609935,82.425646108079,-34.3341169007369,24.916949801916356,20.6509527629762,-0.06007382002664291,1.732476588551767,67.1102391204834,66.42987914276124,65.8799991607666,65.33011917877197,64.6497592010498,0.02,0.0,61.30994963705827,-0.008595628163812652,0.0007746424179435224,65.61428506033761,65.75428499494281,1.1788505309875006
2024-04-15,0,64.32249927520752,62.927499771118164,67.15999984741211,64.7028124332428,66.00568628311157,-0.30378062416847096,1.1740636377738483,-0.651579803225621,2.9955706419052426,65.52812671661377,0.9509450387954714,0.01796205428826287,63.763000679016116,66.9732494354248,0.6009519239794405,0.03333200675445871,0.9840729128863256,0.9826890181924686,0.977146108609111,-0.02504735486370302,50.66665251751405,67.71167750938864,65.36355023384094,63.01542295829324,65.47171415601458,0.8418405477869388,65.71507133756366,1.0029192357494416,65.54778040604997,65.46516953014853,0.15980641078309285,-1.1815662859196554,11008700,0.9096502872599711,1.0632588143312534,145112500.0,-94.7580973886239,83.25868849609935,82.425646108079,-103.79570770659349,22.678683808257453,22.47809191972668,-0.06470645863944725,1.7673408512529674,67.03943930053711,66.3152794342041,65.72999954223633,65.14471965026856,64.42055978393554,0.04,0.0,61.329546336230266,-0.04265900169700565,-0.02517272702893584,65.46714183262416,65.57642773219517,1.1131662329232683
2024-04-16,1,63.38749980926514,63.40750026702881,67.15999984741211,64.71437430381775,66.00568628311157,-0.05173536380927086,1.063500177987161,-0.8546833355801629,2.995600140858196,65.52812671661377,0.8742200660705564,0.01625319485016811,64.20525007247925,66.9732494354248,0.5673283991714376,0.008150128043695585,0.9687345679761775,0.9710381299571132,0.9678012769669981,-0.052486040171052184,44.82503125159258,67.56030056501973,65.43330020904541,63.30629985307109,65.26349994114467,1.147452169058169,65.45917851584298,1.1094704212329285,65.24057983881895,65.39289373555246,-1.508248934329262,-1.7920915286188994,9912700,0.9080636062756134,0.977740515615175,135199800.0,-90.35912952805928,83.25868849609935,82.425646108079,-139.79305787052917,21.47169133152148,22.643260821647683,-0.10166105634457802,1.7332078007053542,66.9615588684082,66.18921873474122,65.56499862670898,64.94077851867675,64.16843838500976,0.06,0.0,61.34342817427557,-0.05328357753468982,-0.043864880816292355,65.22142737252372,65.34499931335449,1.169013247578867
2024-04-17,1,63.39750003814697,63.38749980926514,67.15999984741211,64.71437430381775,66.00568628311157,-0.1495994975727921,1.0985862187712336,-0.7708375411957324,2.9955911090929566,65.52812671661377,0.8970451164245603,0.016794731531321952,64.16575002670288,66.9732494354248,0.49207341233300855,-0.00031542731821068004,0.9691947474897015,0.9724762287714478,0.9784448114511914,-0.03298507153517294,40.22790964649124,67.60972260081151,65.41255016326905,63.21537772572658,64.89528587886265,1.286243444271085,65.1904285294669,1.121419882033972,64.77640620889846,65.15719957777385,-2.2476667738805745,-5.349409498015284,8000900,0.9290464787389805,0.7934287687717766,143200700.0,-86.77049472324889,83.25868849609935,82.425646108079,-158.0313494931006,20.2227658001617,22.748943945718825,-0.07314074025241235,1.7086679857251912,66.50696136474609,65.75652145385742,65.1500015258789,64.5434815979004,63.793041687011716,0.08,0.0,61.353232763984295,-0.03976926291916072,-0.055820920574131294,64.78142765590123,65.1085706438337,1.144043429406641
2024-04-18,1,62.98249912261963,63.38749980926514,67.15999984741211,64.71437430381775,66.00568628311157,-0.15242192129792,1.0995005802998503,-0.7674077421861596,2.9955908694665863,65.52812671661377,0.8975951290130609,0.01680883839824389,64.1647500038147,66.9732494354248,0.5658607980531315,-0.013671484105700517,0.9628577452691636,0.9683737997284384,0.9785718549112583,-0.0410083109788143,38.58955569456891,67.61105131242466,65.41205015182496,63.21304899122525,64.33582142421177,1.109084706925343,64.90328557150704,1.1363099994547237,64.43536628553771,64.95075605617181,-3.906780592022527,-5.602292760294159,9240000,0.906240624724768,0.9320261431315776,133960700.0,-97.22791109519402,83.25868849609935,82.425646108079,-174.5911295354166,18.489633975733902,23.395102689355156,-0.1604242187133725,1.7352166020708268,66.08400422668457,65.2939983291626,64.6555004119873,64.017002494812,63.22699659729004,0.1,0.0,61.3610629020336,-0.0562310700005032,-0.05737703304322409,64.08142743791852,64.75928497314453,1.3537988097521985
2024-04-19,1,62.12374973297119,62.98249912261963,67.15999984741211,64.71437430381775,66.00568628311157,-0.3300489393668878,1.1980613718502453,-0.6998773213471741,2.995563849774858,65.52812671661377,0.9687515258789062,0.018333737211116127,63.39650001525879,66.9732494354248,0.6665845073170977,-0.04383636981668171,0.9506695808199438,0.9585970319346069,0.9733755879360435,-0.0446174533268634,32.78676057012606,67.74348526201103,65.34736251831055,62.95123977461006,63.84492833273752,1.2307332334476015,64.61942843028477,1.2996044374474656,64.0782408979071,64.73941772612558,-5.853997518176603,-5.999778186479185,13118800,0.8220057907418954,1.3293314634522004,120841900.0,-89.43084892292593,83.25868849609935,82.425646108079,-175.5957096320683,17.905663454584786,23.62305556867549,-0.1306094062164407,1.6637099699234041,65.95374127197266,65.14563073730469,64.49250030517578,63.83936987304688,63.03125933837891,0.12000000000000001,0.0,61.36767726971299,-0.035299506020595506,-0.053039536726489,63.57142802647182,64.5649994441441,1.4773661665955635
2024-04-22,1,63.086249351501465,62.12374973297119,67.15999984741211,64.30437445640564,66.00568628311157,-0.4452906382709612,1.3806489365899934,-0.563319183285397,2.9955070481108326,65.40187549591064,1.1185451459884646,0.021188580078959813,63.34699974060059,66.9732494354248,0.6899346609415371,-0.055905931399913754,0.9681737412314199,0.9775535844393859,0.99752540417453,-0.019219556727991693,28.97058478179201,67.92134783617743,65.16004996299743,62.39875208981744,63.4749995640346,0.9446320122548043,64.53630338396344,1.3608271216654635,63.59654928736286,64.3956627434948,-5.241384332428865,-6.012307521122152,9958200,0.8365852193031923,1.0102842394562959,130800100.0,-73.53208340914479,83.25868849609935,82.425646108079,-105.20241637287464,21.994519289387583,22.258265686173182,-0.06828403672325788,1.639496488946521,65.95374127197266,65.14563073730469,64.49250030517578,63.83936987304688,63.03125933837891,0.12000000000000001,0.0,61.37843933119862,-0.005038571930110147,-0.021675147709527824,63.198570251464844,64.45999908447266,1.5313995342821256
2024-04-23,1,63.927499771118164,62.12374973297119,67.15999984741211,64.03687500953674,66.00568628311157,-0.2596986349635783,1.4429628568560748,-0.8973940048084406,2.995485534037451,65.16624927520752,1.190188903808594,0.022191153846945047,63.07587432861328,66.9732494354248,0.7740174447757693,-0.03679603996622023,0.9831334020352578,0.9950432647487882,1.014794710193171,0.008519029200992456,38.24332593922113,67.91016315572875,65.0242374420166,62.13831172830445,63.31821387154715,0.7052377644397781,64.46532113211495,1.3651140875952665,63.47305143024026,64.24440493217368,-3.9428576788876533,-1.8112850560288485,9913000,0.8746976388711715,1.007289205198722,140713100.0,-51.12917721135132,83.25868849609935,82.425646108079,-44.60601255573409,25.20805069998358,20.784540770591615,-0.06286888431425877,1.6302396286826821,65.95374127197266,65.14563073730469,64.49250030517578,63.83936987304688,63.03125933837891,0.12000000000000001,0.0,61.395212277511305,0.015765410613097552,0.014485939347453099,63.17571367536272,64.39499936785016,1.5131472706119533
2024-04-24,1,64.5149974822998,62.12374973297119,67.15999984741211,63.794999837875366,66.00568628311157,-0.11329467943630918,1.457734932307292,-1.0076291250357476,2.9954801195124148,64.97312545776367,1.2214250564575195,0.022445407342390516,63.07587432861328,66.9732494354248,0.7822037587749358,-0.045430783536377056,0.9933667404756025,1.0088535262506029,1.0223679809820745,0.017626837706225418,42.17866917141346,67.86126969219028,64.94579982757568,62.03032996296108,63.34571361541748,0.7530571042891824,64.40871388571603,1.343769586089191,63.59004913577169,64.25004149558143,-1.68781215509512,-1.5307029763378455,8189100,0.8236978402771241,0.8611584327086882,148902200.0,-43.7218463811745,83.25868849609935,82.425646108079,-8.964397057051961,25.748675211438986,19.784884935351872,0.017800460908431782,1.590194407017644,65.95374127197266,65.14563073730469,64.49250030517578,63.83936987304688,63.03125933837891,0.02,1.0,61.41163913331016,0.024976257639570676,0.022229166418588058,63.36571339198521,64.41642761230469,1.4506714838777288
2024-04-25,1,63.730000495910645,62.12374973297119,67.15999984741211,63.794999837875366,65.75056266784668,-0.02372524602807132,1.3835945587548906,-0.8293101367984694,2.9955044105607684,64.88312530517578,1.1414953041076656,0.021344175634890106,63.07587432861328,66.90912532806396,0.7486910455728596,-0.039383596949400905,0.983137954098681,0.9982093318645832,1.0063638165330158,0.011868398105888467,46.32403958962554,67.59023885353274,64.82304973602295,62.05586061851317,63.394642284938264,0.7672181601450156,64.32907111304146,1.3489546494133147,63.820687203728454,64.30844231994676,0.2992704096721592,-1.2134922674217459,11711200,0.8372613736685055,1.2243293537123383,137191000.0,-57.09126596864989,83.25868849609935,82.425646108079,-51.57909195501546,23.59039831014822,22.871906617148863,0.0859428829559278,1.6116227303426969,65.95374127197266,65.14563073730469,64.49250030517578,63.83936987304688,63.03125933837891,0.02,0.0,61.428873456513024,0.03220611995398781,0.013278535802647361,63.46142741612026,64.34142739432198,1.391320484507893
2024-04-26,1,65.03499984741211,62.12374973297119,67.00250053405762,63.64687538146973,65.58893871307373,0.04571455510724535,1.2929008875576284,-0.7428949365219792,2.995532344657542,64.67999839782715,1.0793002605438233,0.019997987553093545,63.07587432861328,66.17784976959229,0.6910884035011665,-0.04884146131954507,1.0059310268715533,1.0217636422640315,1.0245524012224905,0.046862111945181306,41.86436337201781,67.23735154356314,64.65154976844788,62.06574799333263,63.628570829119,0.9865300342675734,64.26192835399083,1.282484571777582,63.79209233586123,64.23391878773688,0.5403284364836956,-1.7194831201335512,14200900,0.8496162355196679,1.458498837639826,151391900.0,-23.486941131713447,83.25868849609935,82.425646108079,52.300529789703376,29.118650058932726,20.38873288262192,0.14520196527840507,1.6786904512332743,65.95374127197266,65.14563073730469,64.49250030517578,63.83936987304688,63.03125933837891,0.04,0.0,61.46253723127613,0.05857803933135841,0.06215782133972417,63.847141810825896,64.31428473336356,1.316186919152021
2024-04-29,0,66.63500022888184,62.12374973297119,66.89875030517578,63.64687538146973,65.37062454223633,-0.08274402557150498,1.1802195900357946,-0.6053953486197439,2.9955650346148364,64.67999839782715,0.9809252262115479,0.01828290544805788,63.07587432861328,65.98727359771729,0.6808666186508439,-0.016078457547077117,1.032249777076665,1.0468847697792059,1.040217001795694,0.05625236741540274,52.14152438262153,66.91361391418718,64.5531747341156,62.19273555404401,64.15035670144218,1.4465380891977173,64.24308906282697,1.2420714105472224,64.09407377898546,64.3438007988872,2.5829091183088213,-1.4247800658573746,19142400,0.891591051863736,1.8763839537334281,170534300.0,-9.613815414639259,83.25868849609935,82.425646108079,143.40937398733416,32.48198160870509,19.003328361694802,0.21161288071624895,1.6723521434428035,66.17530197143554,65.32485130310059,64.63750076293945,63.95015022277832,63.09969955444336,0.06,0.0,61.524340745136406,0.06013608671696313,0.07510827134220834,64.54571315220424,64.31357029506138,1.4208145598395003
2024-04-30,0,68.95050048828125,62.12374973297119,66.89875030517578,63.64687538146973,65.37062454223633,0.00593777255376784,1.2204961950444924,-0.6146056892656682,2.9955536693259317,64.67999839782715,1.0077877521514893,0.018898970128024398,63.07587432861328,66.04099864959717,0.6871528600706164,0.037120626130456594,1.0676751425618787,1.0793416131767366,1.0645684391523034,0.0785733954111627,63.46977518251339,67.02102965014453,64.58003726005555,62.139044869966575,65.12560680934361,2.0343422286634727,64.48526757104057,1.746645055152704,64.72695023636356,64.68605360858881,5.79923178207205,-0.39425262070035955,43903400,0.8586906632331631,3.6954308568148275,214437700.0,-30.681471856963217,83.25868849609935,82.425646108079,209.73528714728525,40.03801019963773,16.256112613595644,0.04075355061608668,1.8152589790164084,68.55286959838867,67.24806700134278,66.19350051879883,65.13893403625488,63.83413143920898,0.08,0.0,61.70585953271354,0.05416727995093873,0.07485361046102419,65.34714126586914,64.45928464617047,1.5957189734114239
2024-05-01,0,66.60750007629395,62.12374973297119,68.95050048828125,63.64687538146973,65.58893871307373,0.6772084518580646,1.544012762845456,0.589123324950795,2.995449965711039,64.88312530517578,1.1863065481185913,0.023821820244017855,63.07587432861328,66.66137523651123,0.6189860853936868,0.062063640345615956,1.0276546489141278,1.0336632163164248,1.012686042948167,0.03243435907392289,71.05555552225074,67.90308781016051,64.8150622844696,61.72703675877869,65.6286426271711,1.8751445897848082,64.55182109560285,1.8120240654485393,65.78600281629485,65.30604724256132,10.988954763119956,5.171597077439226,17966500,0.9831614199610093,1.4465810116364968,196471200.0,-50.59864724929592,83.25868849609935,82.425646108079,83.48164685081935,36.29830613057056,21.387479977393486,-0.015171770687986037,1.8591903429981604,68.55286959838867,67.24806700134278,66.19350051879883,65.13893403625488,63.83413143920898,0.08,0.0,61.75542003952461,0.020049400450044885,0.02654041714066683,65.76856994628906,64.48357009887695,1.6189285845292014
2024-05-02,0,66.73750114440918,62.12374973297119,68.95050048828125,63.64687538146973,65.75056266784668,0.5291838252815851,1.5927789178113785,0.12067014456985348,2.995432323012565,64.93499946594238,1.2676252841949462,0.024542284491937388,63.07587432861328,66.66137523651123,0.7275787248336006,0.019905847960355535,1.028322713875254,1.0305469869976116,1.008247283872548,0.04719128550283824,56.79765385630225,68.08493255905721,64.89937472343445,61.71381688781169,66.03007139478412,1.7466476558384525,64.67414263316563,1.9019914527108508,65.99513013958583,65.48389299028784,5.581645383882176,1.4187113713678456,14480600,1.1348893543476763,1.1449526718474683,210951800.0,-41.19947993453936,83.25868849609935,82.425646108079,87.24333278704195,34.03034552977088,20.051165225828026,0.04112992982104524,1.8413830708461927,68.55286959838867,67.24806700134278,66.19350051879883,65.13893403625488,63.83413143920898,0.08,0.0,61.79689109086068,0.044929874436350214,0.033004428437828436,66.13285609654018,64.65428488595145,1.6830999656839671
2024-05-03,0,66.48749923706055,62.12374973297119,68.95050048828125,63.64687538146973,66.1331238746643,0.4227211079668672,1.6408654983583915,-0.23590385338794917,2.995414398753055,64.93499946594238,1.339125394821167,0.0252554010169827,63.07587432861328,66.75362606048584,0.7446529689579486,0.02918500811310729,1.023343142706227,1.02076769066644,0.9954246603562125,0.022334118444781392,57.88868407196055,68.25260583077745,64.97087483406067,61.68914383734388,66.31185735974994,1.615685415033555,64.8287854875837,1.958379170251691,66.18504120217216,65.62424653399596,4.395606559542858,2.6336048226456152,15435200,1.1279917334972642,1.185845786729532,195516600.0,-55.52202466981563,83.25868849609935,82.425646108079,50.498533274598174,30.049267495008568,21.801821207672372,0.0004282874226918091,1.936323782626991,68.55286959838867,67.24806700134278,66.19350051879883,65.13893403625488,63.83413143920898,0.08,0.0,61.83467120418253,-0.003941815340195665,0.02496097522946208,66.2557133265904,64.8107133592878,1.6902266403633548
2024-05-06,0,65.66499900817871,62.12374973297119,68.95050048828125,63.64687538146973,66.5174994468689,0.2885108622645571,1.6732932544409487,-0.48138050190536985,2.9954021906537975,65.02999973297119,1.4050503587722774,0.025721999889434185,63.07587432861328,66.75362606048584,0.7673414953141733,0.007768105718721361,1.0094077010980238,1.001430875626834,0.9788532335498175,-0.014556932803651335,55.3342966208627,68.39958633912786,65.05299983024597,61.70641332136407,66.58828571864537,1.2165654223088394,64.99146400179181,1.9237320525057646,66.26808791844576,65.74394560616803,3.0574313442419547,3.3658517412234716,11257600,1.1034687839823252,0.855570430319794,184259000.0,-56.529032577508275,83.25868849609935,82.425646108079,26.31752079423127,28.735908790438934,20.848932367259756,-0.008435232031293162,1.8801361268139591,68.55286959838867,67.24806700134278,66.19350051879883,65.13893403625488,63.83413143920898,0.08,0.0,61.85831378318076,-0.020600049222636585,-0.005306223150077109,66.47142791748047,64.96642766680036,1.668037452383412
2024-05-07,0,66.1349983215332,62.12374973297119,68.95050048828125,63.64687538146973,66.5174994468689,0.314178209644146,1.6661011796735241,-0.4302162198577113,2.9954049336493025,65.02999973297119,1.388000388145447,0.025617546543734666,63.07587432861328,66.75362606048584,0.7583638483493298,-0.018442067921582955,1.0168748563059513,1.0046476220540996,0.9887186996272244,-0.04083367266096305,49.822812195682495,68.3697022162959,65.03749985694886,61.705297497601805,66.74542835780552,1.0408413554954152,65.18699959346226,1.888046536347596,66.1196506952745,65.66508222727917,3.036244307564738,3.5929784354433236,9232200,1.0976559779346933,0.6995882278947185,193491200.0,-53.06033595955577,83.25868849609935,82.425646108079,58.65095579755251,30.051393850376343,19.903933787055802,-0.045900349135038564,1.8286790268215614,68.55286959838867,67.24806700134278,66.19350051879883,65.13893403625488,63.83413143920898,0.08,0.0,61.8805916713175,-0.02944640833212575,-0.015972529167714918,66.46571350097656,65.15642765590123,1.6161133430704582
2024-05-08,0,64.68499946594238,62.12374973297119,68.95050048828125,63.64687538146973,66.22312355041504,0.34586759312588156,1.6313942903587768,-0.2498322640334365,2.9954181246350275,65.02999973297119,1.352131524085999,0.025098639257738344,63.07587432861328,66.64525032043457,0.78390477119634,0.008770545091483782,0.9951643674231834,0.979336800797783,0.9752512178012682,-0.028863125145809132,54.01794175192195,68.26210083848427,64.99931225776672,61.73652367704916,66.46685682024274,1.303205183374398,65.30860676084247,1.7872734275394815,66.1215569020759,65.58567506424427,1.6913945978349458,4.317990901437829,11183800,1.0608707085157696,0.8391524438763623,182307400.0,-76.67000173298241,83.25868849609935,82.425646108079,-24.24074649483532,27.558156234803135,25.970329560393175,-0.1003270129821835,1.8516380351629733,68.55286959838867,67.24806700134278,66.19350051879883,65.13893403625488,63.83413143920898,0.02,1.0,61.89648973279613,-0.03522827393194816,-0.0605123219442825,66.01142828805106,65.27857072012765,1.6185552102836336
2024-05-09,0,64.04999923706055,62.12374973297119,68.95050048828125,63.64687538146973,66.22312355041504,0.42661690674815955,1.627499392353929,-0.18250920302977702,2.9954194100003897,64.85499954223633,1.339812707901001,0.02505558166496843,63.07587432861328,66.64525032043457,0.7727057730085154,-0.015085495870706388,0.9860587316129342,0.9694733118680346,0.9713081160025024,-0.04026974131880234,46.25180894144484,68.21056094710714,64.95556216239929,61.70056337769144,65.7667852129255,1.0353803986811447,65.44619601113456,1.5860509582474593,65.76389345906264,65.30223831049163,-2.926391170168043,2.703132405095871,8368700,1.1106736673510877,0.6289108720410952,173938700.0,-75.92279786634391,83.25868849609935,82.425646108079,-36.459006720802286,26.395421195226138,26.307526218017813,-0.08076292428570739,1.7950750042603425,68.73104985046386,67.53647740936279,66.57100105285645,65.6055246963501,64.41095225524903,0.04,0.0,61.906784074719475,-0.03777256318141864,-0.025551896840064866,65.51571382795062,65.43142754690987,1.6040363057888993
2024-05-10,0,63.83500003814697,62.12374973297119,68.95050048828125,63.64687538146973,66.22312355041504,0.5614211046132399,1.6300966946989919,-0.10050765934366179,2.9954179803078955,64.5999984741211,1.340952668190002,0.02512701228739107,63.07587432861328,66.64525032043457,0.7725825678445494,-0.014994238941785079,0.9839801746363975,0.9657512741918997,0.9760031949099808,-0.03989470546118923,44.05035002343059,68.1344679770292,64.87427458763122,61.61408119823324,65.3707137789045,1.1803219782409782,65.4996782030378,1.511209621136381,65.33113744235172,65.04356841874926,-7.10727437294467,3.100665224441578,8745800,1.1102323556299087,0.660135857043277,165192900.0,-99.35750157475104,83.25868849609935,82.425646108079,-57.6802885246834,24.25373881310669,26.26051078920087,-0.09289328401406177,1.814003771489777,68.82545021057129,67.68927799224853,66.7710018157959,65.85272563934326,64.7165534210205,0.06,0.0,61.914893119524216,-0.042161290285121056,-0.0604658532215282,65.0571425301688,65.41285623822894,1.6555261795973242
2024-05-13,0,63.75125026702881,62.12374973297119,68.95050048828125,63.64687538146973,66.22312355041504,0.6420470726293924,1.6451576411634863,-0.11224233682402085,2.9954117915292704,64.41874837875366,1.3734801483154286,0.02538244792329944,63.07587432861328,66.64525032043457,0.7762390999280149,-0.007578984687375926,0.9835913285511614,0.966238405869026,0.9826933908693227,-0.029144121983639137,43.84651210550361,68.10508989093903,64.81477460861205,61.52445932628508,64.94410651070731,1.1430629808220767,65.48708895274571,1.5259762354158135,64.95069075048787,64.81076832682592,-4.162444221703682,1.1868682864211002,7311600,1.1004770367240593,0.5596912956046673,157881300.0,-86.25032781782397,83.25868849609935,82.425646108079,-43.54699901824624,22.802881728149934,24.68960873460687,-0.05562306355504403,1.791568926910627,68.82545021057129,67.68927799224853,66.7710018157959,65.85272563934326,64.7165534210205,0.06,0.0,61.922713212737335,-0.025301018624746097,-0.02663616844124611,64.62428501674107,65.37857055664062,1.6420424911153184
2024-05-14,0,64.52499961853027,62.12374973297119,68.95050048828125,63.64687538146973,66.22312355041504,0.6666270654272494,1.658362234787177,-0.15090854565113432,2.9954064226203743,64.28249835968018,1.3963301086425788,0.025597456303473636,63.07587432861328,66.64525032043457,0.7710793511100212,0.005738520352722662,0.9959680843968005,0.9822588282130631,1.0005233291782587,-0.02434412555929144,44.59303463495593,68.10293662777748,64.78621215820313,61.469487688628774,64.66374942234584,0.9204117438320538,65.48780339104789,1.5254883716846936,64.64437587224538,64.6325742714563,-4.474621953433058,-0.27570216999004754,7556500,1.0796753593609254,0.5837019207744276,165437800.0,-78.15471040512155,83.25868849609935,82.425646108079,-11.919144618211906,23.72250070622811,23.76097400528835,-0.04663184808184978,1.7285840555998568,68.82545021057129,67.68927799224853,66.7710018157959,65.85272563934326,64.7165534210205,0.06,0.0,61.9336860443088,-0.020327614913707492,-0.01569880764693009,64.46428571428571,65.35999952043805,1.6151070384803177
2024-05-15,0,64.50500011444092,62.12374973297119,68.95050048828125,63.74593782424927,66.22312355041504,0.6304311923040407,1.6286566013186021,-0.059837312883587845,2.99541841404188,64.51999855041504,1.3508301162719731,0.02511688867595963,63.07587432861328,66.64525032043457,0.7648961117481896,0.017784606328402095,0.9947860743667196,0.9886145789259781,1.0052322629691979,-0.002782706237730359,49.51774126229338,68.10040035130359,64.84308714866638,61.585773946029185,64.49803529466901,0.8076116098257257,65.54316050665719,1.4698409531113925,64.61341181891683,64.63992008312783,-2.951682107237933,0.015503583074947673,10972600,1.0927252880239744,0.8379609459154501,154465200.0,-86.89282624307293,83.25868849609935,82.425646108079,-28.703272967222727,21.738853591729185,24.99648231528832,-0.07017317437084296,1.7515475815472978,68.82545021057129,67.68927799224853,66.7710018157959,65.85272563934326,64.7165534210205,0.06,0.0,61.94786304150835,0.0014104395964731342,-0.030643153810310932,64.22000013078961,65.34571402413505,1.5899996220366974
2024-05-16,0,63.88499927520752,62.12374973297119,68.95050048828125,63.81406259536743,66.22312355041504,0.6011055450040018,1.5970864007315817,0.0555819348324027,2.9954308736778494,64.51999855041504,1.3065301132202136,0.024609002243830905,63.07587432861328,66.64525032043457,0.7411701960054871,0.024173397579177608,0.9843838691448129,0.9822775604688369,0.9961291439246398,-0.0025761118472824585,50.023804474098505,68.09263495394423,64.89846215248107,61.70428935101791,64.17660685947963,0.38435456962520437,65.46101760864258,1.5312746975320193,64.58212379305938,64.6401793915568,-1.7665406400041408,1.216067177937654,8113600,1.0872467509823605,0.6222999773356287,146351600.0,-84.3228325420771,83.25868849609935,82.425646108079,-50.5315309841035,20.815345211457764,24.186956713643998,-0.029369984896381922,1.6985686983528814,68.82545021057129,67.68927799224853,66.7710018157959,65.85272563934326,64.7165534210205,0.06,0.0,61.95682807913287,-0.005430542912238878,0.004544696671193967,63.96000017438616,65.21285683768136,1.4702644422742532
2024-05-17,0,64.27875137329102,62.12374973297119,68.95050048828125,63.87249946594238,66.22312355041504,0.6445315274481219,1.5544961687566143,0.21821471400841386,2.9954471920599226,64.51999855041504,1.2704301071166981,0.023936099570912125,63.665625381469724,66.64525032043457,0.6761681508038041,0.028350663792941863,0.9897628724267974,0.9926856259869375,1.0027847241001797,0.006951536537618264,47.400360533546795,68.0525794976237,64.94358716011047,61.83459482259724,64.1185714176723,0.3200948513087,65.29271411895752,1.521774822738972,64.40238273407564,64.61938327774142,-3.402130647054233,-1.7682795031948493,8204800,1.0776605341878807,0.6413815719273614,154556400.0,-79.43970725561947,83.25868849609935,82.425646108079,-39.76224866660163,21.251000212288652,23.275005872430363,-0.045266058924571535,1.639016075983274,68.82545021057129,67.68927799224853,66.7710018157959,65.85272563934326,64.7165534210205,0.06,0.0,61.96741763546979,0.02463059024695946,0.0004655765727266593,64.05571474347796,65.0335715157645,1.344500771379106
2024-05-20,0,64.52575016021729,63.086249351501465,68.95050048828125,63.9168746471405,66.22312355041504,0.9928359406491734,1.424561137298627,0.4630061815044306,2.9954941630940755,64.51999855041504,1.1858637809753418,0.0218990292543302,63.74912528991699,66.64525032043457,0.6807384387033071,0.018902724984413248,0.9919204261712115,0.9999109037950772,1.0052462264537092,0.01214877967011474,48.523090985309565,67.90045951672371,65.05133724212646,62.20221496752921,64.18653583526611,0.35202332617328286,64.9766605240958,1.1064759126105081,64.36613459735939,64.70338130914855,-0.6280406524008134,-3.536052896371933,6429000,1.0608523223466522,0.5095940250120383,160985400.0,-62.275524787545656,83.25868849609935,82.425646108079,-35.21625192825853,21.4999314925338,21.97037133250482,-0.04015018192636801,1.6122959344078784,66.7076397857666,65.97618003082276,65.38500022888184,64.79382042694091,64.06236067199707,0.06,0.0,61.976273087403705,0.01282245301554652,0.029238778467625265,64.1014289855957,64.80857140677315,1.2773554572805546
2024-05-21,0,64.22000026702881,63.730000495910645,68.95050048828125,64.01937437057495,66.22312355041504,1.1347780099708338,1.3582811180294247,0.7147388019113583,2.9955164241202934,64.52537488937378,1.1354812526702873,0.020857064397093405,63.82662506103516,66.64525032043457,0.6937827681545258,0.009358263521036449,0.9861292065180272,0.9969329096793236,0.9980744120095303,-0.004726840035716551,48.829309195793044,67.8398745186211,65.12331228256225,62.4067500465034,64.24153586796352,0.3161987664377653,64.80612482343402,1.0160821981529016,64.40918781041114,64.79339355291945,0.7427805289987572,-6.417285294130664,6576000,1.0460970009053498,0.5282320172382285,154409400.0,-75.64874621290282,83.25868849609935,82.425646108079,-57.448073041859274,20.455489984552006,21.220881673014542,-0.0712385819610258,1.573553569972087,66.7076397857666,65.97618003082276,65.38500022888184,64.79382042694091,64.06236067199707,0.06,0.0,61.983991445337395,-0.0074326934550004164,0.002345546667586091,64.26857158115932,64.66285705566406,1.2882513711067467
2024-05-22,0,62.93375015258789,63.730000495910645,68.95050048828125,64.17750000953674,66.22312355041504,1.1512417506569492,1.3468533535574825,0.77076303250769,2.9955201460122236,64.52537488937378,1.1252437353134155,0.020676942028456678,63.82662506103516,66.64525032043457,0.699700647302012,-0.004572537034538843,0.9661612380452071,0.9798785021586638,0.9790123021759539,-0.024358576219911776,45.45058198630967,67.83164401447274,65.13793730735779,62.44423060024283,64.1247501373291,0.5736347731903064,64.53442832401821,0.9672962325637747,64.36484191264402,64.81039321127223,0.6031177702698595,-3.584430892212488,14532200,1.040107435200013,1.1383313632920604,139877200.0,-94.29284515290345,83.25868849609935,82.425646108079,-133.74926877899827,18.424147953525743,27.282570833410052,-0.12445312084739749,1.6222358737304,66.46337982177734,65.58081008911132,64.86750030517578,64.15419052124024,63.27162078857422,0.08,0.0,61.98913248917051,-0.026760608111681905,-0.03700841029082193,64.01714270455497,64.32071386064801,1.439619266645507
2024-05-23,1,62.00625133514404,62.93375015258789,68.95050048828125,64.00874924659729,66.22312355041504,0.9573787343202347,1.425230664690878,0.48542802467036017,2.9954939324056724,64.52537488937378,1.1805873918533307,0.021906783140442837,63.74912528991699,66.64525032043457,0.6568730752721543,-0.012494121090958517,0.9530790594134547,0.9680769963036846,0.9693224899542819,-0.02940827989948147,38.56077264458163,67.90933627025392,65.05887494087219,62.20841361149046,63.76492895398821,0.9483212938196443,64.21433918816703,1.0117159888471992,64.01104662769173,64.61483528588559,-1.282327971634647,-5.699570596133928,10533400,1.0653409667527725,0.8289224967617141,129343800.0,-93.51349716612435,83.25868849609935,82.425646108079,-163.53905320162846,17.227228519557947,28.281698243395283,-0.17311903965958464,1.6110030892543121,65.46019772338867,64.64989839172364,63.994998931884766,63.3400994720459,62.52980014038086,0.1,0.0,61.98823558196688,-0.03931352110848796,-0.03630672362166753,63.58857127598354,64.02642849513462,1.6155265176307771
2024-05-24,1,61.730000495910645,62.00625133514404,68.95050048828125,64.00874924659729,66.22312355041504,0.5611338405528062,1.5496723360249212,0.3257297146468243,2.9954490160603084,64.52537488937378,1.2471498489379882,0.023851134931648827,63.669500255584715,66.64525032043457,0.692291328765081,-0.04657105434572531,0.9500915367279528,0.9668490478051942,0.9707058469974202,-0.039651530605795515,30.986167961040803,68.0720321548837,64.97268748283386,61.873342810784024,63.36850043705532,1.1466632157095054,63.93326786586216,1.118649932748347,63.5202568822193,64.34601057334778,-3.9035231278992475,-6.739985641419084,8171300,1.0329281292932952,0.6586645343410291,121172500.0,-92.4324591827056,83.25868849609935,82.425646108079,-152.4475021537719,16.600925626355224,27.253505611341,-0.2213824977825706,1.5523520209479162,65.46019772338867,64.64989839172364,63.994998931884766,63.3400994720459,62.52980014038086,0.1,0.0,61.98680705503379,-0.04404472424674233,-0.038377521732170156,63.26571382795061,63.74285697937012,1.7369270515089805
2024-05-28,1,62.272499084472656,61.730000495910645,68.95050048828125,63.87249946594238,66.22312355041504,0.3696888039490359,1.702860417202909,0.02540299042351135,2.995388066750316,64.5149998664856,1.356593589782713,0.026275694310579304,62.84100027084351,66.64525032043457,0.7320306126316236,-0.07360996047307283,0.960885069245497,0.978572276575661,0.9871494782440502,-0.03492018411486597,25.656069607151597,68.21315834966461,64.80743751525878,61.40171668085296,63.13814326695034,1.1868737728367675,63.657375063214985,1.0043294717818705,63.07911828190147,64.05608767238238,-4.301991494623727,-5.992535706545818,11159600,0.9460367479775363,0.9294461768076544,132332100.0,-78.79469075377808,83.25868849609935,82.425646108079,-116.48865268072205,19.430763991452633,25.687637412056503,-0.2624742866280127,1.5293239068447568,64.64271795654297,63.98863858032227,63.459999084472656,62.931359588623046,62.277280212402346,0.1,0.0,61.98842461213662,-0.04014201959047692,-0.03582514062849974,62.98999949863979,63.47499983651297,1.7202703652226021
2024-05-29,1,61.179999351501465,61.730000495910645,68.95050048828125,63.81406259536743,65.78249883651733,0.5147829355899927,1.7339121744401007,0.14497720069678888,2.995373467992989,64.39187574386597,1.3142810535430924,0.026845187051132792,62.24587430953979,66.62050018310546,0.6874110660025115,-0.09685210921628595,0.9472155225564323,0.963643624652169,0.9768091500525331,-0.0473372921657883,25.36802051856919,68.05713680691854,64.58931245803834,61.121488109158136,62.69546440669468,1.265807044538882,63.40701791218349,1.1541459247644774,62.88308292327207,63.81375526955645,-2.5240670095157096,-5.8403255992870236,8142800,0.7559104094477845,0.7968536084370893,124189300.0,-95.72647970304051,83.25868849609935,82.425646108079,-164.2276586499674,18.220848617577452,28.333674468078698,-0.19926321694504665,1.5143704064435315,64.42551870727539,63.74223866271973,63.189998626708984,62.63775859069824,61.95447854614258,0.12000000000000001,0.0,61.98491788068415,-0.04758189250647038,-0.05743396014833796,62.4999989100865,63.27785682678223,1.6536655047855755
2024-05-30,1,62.6875,61.179999351501465,66.73750114440918,63.54687523841858,64.92999935150146,-0.12489789476206382,1.5766015508185178,-0.7245299912559693,2.995430364087388,64.24937582015991,1.2163337373733527,0.024557355363355952,61.9786262512207,66.49949932098389,0.7603758721076384,-0.08148482856398576,0.9764288342486737,0.9926180071826058,1.010689323012351,-0.003912847271787201,23.26051742913725,67.35399050283637,64.20078740119934,61.047584299562295,62.43285724094936,0.981579057076431,63.30969653810774,1.1532018085893947,62.45503472524727,63.371992972502774,-4.820803073466574,-5.418567122793829,11874700,0.6222729449906843,1.1977587476422469,136064000.0,-64.52992010329027,83.25868849609935,82.425646108079,-71.89137725824234,24.285802680906038,25.380970843963254,-0.1880400550737326,1.5697786790479211,64.42551870727539,63.74223866271973,63.189998626708984,62.63775859069824,61.95447854614258,0.12000000000000001,0.0,61.989076240722824,0.005145516994541133,-0.024804995170628855,62.177142007010325,63.13928549630301,1.6052117912846724
2024-05-31,1,62.76250076293945,61.179999351501465,66.73750114440918,62.87218761444092,64.56556248664856,-0.004731075045222055,1.5073636228383567,-0.6550884553791203,2.995454883156621,64.13499975204468,1.1761836576461788,0.02355079493475437,61.9786262512207,66.17024841308594,0.7759134540348243,-0.06068553774055206,0.9805907232105585,0.996673925674855,1.012702662899388,0.012196341683484047,38.81466921386461,67.01951464306134,64.00478739738465,60.99006015170795,62.22464302607945,0.6314397850355983,63.233089447021484,1.1512429987052706,62.51521495291325,63.25121385064332,-2.8488629045813716,-2.1272431745357134,14269000,0.7362788854845929,1.440800846567685,150333000.0,-54.27343878633947,83.25868849609935,82.425646108079,-56.69042041151623,22.32717033100818,24.95601246546332,-0.19341334835538945,1.5855104452817157,64.42551870727539,63.74223866271973,63.189998626708984,62.63775859069824,61.95447854614258,0.12000000000000001,0.0,61.994838500850655,0.0228970413362517,0.012863853825753778,62.018571036202566,63.14357130868094,1.4303595624806515
2024-06-03,1,63.15000057220459,61.179999351501465,66.48749923706055,62.74375057220459,64.52518725395203,0.011141114202404684,1.3915534859723782,-0.5998149319186088,2.9954944287819454,63.96749925613403,1.1124547576904291,0.02180911937410789,61.9786262512207,65.71199893951416,0.7497232679192518,-0.05602554640895196,0.9897182643984476,1.0046182255486042,1.0164744615300279,0.02300340296268133,39.84245226810214,66.58914435025592,63.80603737831116,61.022930406366406,62.25553594316755,0.675656505158378,63.19014304024832,1.1416006764675168,62.576519889472024,63.17670982162085,-2.2695414170492465,-1.6801116543692454,9039800,0.7389944809636241,0.9432424677187948,159372800.0,-44.23075982569769,83.25868849609935,82.425646108079,-25.39820695998164,21.353250722170877,23.867421769097838,-0.12798747306696168,1.539398085719603,64.42551870727539,63.74223866271973,63.189998626708984,62.63775859069824,61.95447854614258,0.12000000000000001,0.0,62.000360495713736,0.029526276976729937,0.03052934715032583,62.19999967302595,63.10857118879046,1.344143102135947
2024-06-04,1,63.40749931335449,61.179999351501465,66.1349983215332,62.74375057220459,64.50999999046326,-0.07986330251667441,1.2532283074240815,-0.5448410560984778,2.9955382394781336,63.859999656677246,1.0390797805786136,0.01969272157699805,61.9786262512207,64.78299942016602,0.7624544634609552,-0.03830044123903623,0.9963597394620988,1.0105292035550217,1.0159748657655705,0.01822634783521715,44.679254868957464,66.14561905991651,63.63916244506836,61.1327058302202,62.45571422576904,0.7877655800273476,63.11032158987863,1.0784061789501558,62.71571875105994,63.18035286416848,0.34361597567661684,-0.9431182797291366,9046100,0.7343877786831193,0.9549174379233994,168418900.0,-47.00847873469434,83.25868849609935,82.425646108079,0.8133547436809039,23.13016431660296,22.623756003459583,-0.15996762968970155,1.5080096354203996,64.42551870727539,63.74223866271973,63.189998626708984,62.63775859069824,61.95447854614258,0.02,1.0,62.007266010860405,0.018658576423906226,0.02741730139747636,62.44999967302595,63.01928547450474,1.2500081847184787
2024-06-05,1,63.48749923706055,61.179999351501465,66.1349983215332,62.74375057220459,64.33531355857849,-0.07170226155503792,1.164183460480665,-0.2457139052163484,2.9955642528163398,63.79312515258789,0.9606586074829103,0.018326011278523242,61.9786262512207,64.5416750907898,0.6819028282624563,-0.04124138621608843,0.9993894146058697,1.0136105867602607,1.0135701334992704,0.03771657257303396,45.959918922642416,65.85465438128847,63.52628746032715,61.197920539365825,62.70678547450474,0.7979254500143599,63.03764295578003,1.0092519219344358,62.885669839655975,63.231900360119674,2.2598495281333784,-1.7318873487522777,8846100,0.7267069080614779,0.9357120417352893,177265000.0,-35.96184031341551,83.25868849609935,82.425646108079,3.8518812484445215,22.050279545028378,22.44289966025253,-0.10662126940622667,1.468863096463865,64.04734243774413,63.436331680297855,62.942501068115234,62.448670455932614,61.83765969848633,0.02,0.0,62.01350821651291,0.040622433631921195,0.021875513115760387,62.719999585832866,62.99285670689174,1.1013695275886977
2024-06-06,0,65.82374954223633,61.179999351501465,64.68499946594238,62.74375057220459,64.23468804359436,-0.6044752030852935,0.9988025878998882,-0.6692762417120082,2.995607749562285,63.61937475204468,0.8428798294067377,0.01575549683581565,61.9786262512207,64.52507467269898,0.7492733504229738,-0.018512796456191326,1.038329185564921,1.0521404773703988,1.0431821354714477,0.0500299029668807,49.74969797020068,65.3915176819033,63.39391250610352,61.39630733030375,63.21410696847098,1.3871640605906026,63.17612511771066,1.2408916643864334,63.03213194345115,63.242903920061174,2.8470739138683943,-1.5773984583756016,22068800,0.6591032367305454,2.2072949714546333,199333800.0,-11.477803610443402,83.25868849609935,82.425646108079,205.1326466093266,35.15362237718721,18.325492018216018,0.014779336319107047,1.6703882406241384,66.17507940673828,65.15745922851562,64.33499908447266,63.512538940429685,62.49491876220703,0.04,0.0,62.06142613652065,0.072148431333098,0.09778865652109228,63.41285651070731,63.20142800467355,1.381540575671509
2024-06-07,0,67.07475090026855,61.179999351501465,65.82374954223633,62.74375057220459,64.23468804359436,-0.15008897224090226,1.0982826842255602,-0.2883530772750129,2.9955823195312883,63.61937475204468,0.8927649021148681,0.01730918788406907,61.9786262512207,64.52507467269898,0.5984606308778522,0.027693213525433667,1.0571135121087247,1.0672068500827296,1.0525450818261357,0.06870743015191394,67.04536431366368,65.64741537836933,63.45085000991821,61.254284641467095,64.05621433258057,1.7004072486644568,63.375839369637625,1.603905209521205,63.72805091128838,63.620899776866466,5.7027588582022375,3.0347503937144107,13195000,0.8340973608910254,1.2886453207623272,212528800.0,-13.411194277497144,83.25868849609935,82.425646108079,223.26235193038318,34.06648748073525,16.71014365641832,-0.021791092351395137,1.7010059999822016,66.54103839111328,65.45348364257812,64.57450103759766,63.695518432617185,62.60796368408203,0.06,0.0,62.09569282289584,0.06842357927360387,0.07662781729070318,64.3057141985212,63.40285655430385,1.6182802472555955
2024-06-10,0,66.83749961853027,61.179999351501465,67.07475090026855,62.74375057220459,64.33531355857849,0.5447770595176041,1.349828115444459,0.46439987634665414,2.9955078757233307,63.61937475204468,1.0403375625610352,0.02122301588716015,61.9786262512207,64.6555500984192,0.6293067485752598,0.050751952066821475,1.0508695885290995,1.0549247398354753,1.0348172313196211,0.05839270012530662,72.69867956760602,66.30174382396754,63.602087593078615,60.902431362189695,64.64907142094204,1.8596648934216322,63.5409643309457,1.8339055484296711,64.56392219392373,64.08082608590958,9.635095801324853,4.349803733336562,11978800,0.86907688901674,1.1516875402902678,200550000.0,-16.230452826632906,83.25868849609935,82.425646108079,161.28473713040674,31.647641882164805,17.204201875434972,0.04887474230221268,1.7002194350654016,66.54103839111328,65.45348364257812,64.57450103759766,63.695518432617185,62.60796368408203,0.06,0.0,62.12360249294281,0.05720134424499479,0.06508961025834384,64.9599996294294,63.56857081821987,1.788830923299204
2024-06-11,0,65.86374855041504,61.179999351501465,67.07475090026855,62.74375057220459,64.50999999046326,0.5614603519593891,1.523213895120219,-0.12551337331992318,2.9954480419862293,63.61937475204468,1.190558772087097,0.023892722050981474,61.9786262512207,65.92512454986573,0.7363212805119951,0.04841080509910606,1.0331209834627986,1.0312423714909098,1.0082286866588013,0.03873751943633619,70.61627859313371,66.79864036233822,63.752212572097775,60.70578478185734,65.09210681915283,1.6976675286847263,63.65837492261614,1.9307823754296871,65.13342444453801,64.4468368532375,6.620138972730246,3.582677384723029,15108700,0.872111177536469,1.4001282557404637,185441300.0,-47.37554744376027,83.25868849609935,82.425646108079,80.11601201871777,28.151246663023805,20.918012096670243,-0.011930200525814906,1.7748513510655173,66.54103839111328,65.45348364257812,64.57450103759766,63.695518432617185,62.60796368408203,0.06,0.0,62.14828169744064,0.022737956266813075,0.020642886503196928,65.21428462437221,63.616427830287385,1.802111325322276
2024-06-12,0,64.41250038146973,61.179999351501465,67.07475090026855,62.74375057220459,64.52518725395203,0.40991800278538576,1.5912112087585653,-0.5665045429948146,2.995422799347733,63.68624925613403,1.2960874557495117,0.024918025279211223,61.9786262512207,65.96112365722657,0.8047892347214712,0.02074775575047511,1.0086859016377108,1.0028807857889237,0.9786538494363178,0.014569815405002018,61.10144114810231,67.04025990378422,63.85783748626709,60.675415068749956,65.27246393476214,1.5140914569113466,63.763999938964844,1.9285386793305097,65.32099831420085,64.62225430585256,4.941243178294192,2.559558200796438,14137500,0.8946468515235282,1.2713590569775692,171303800.0,-65.36447771099886,83.25868849609935,82.425646108079,12.676602107842303,24.95023485037108,24.320884394048097,-0.05410898115500646,1.8595095390855043,66.54103839111328,65.45348364257812,64.57450103759766,63.695518432617185,62.60796368408203,0.06,0.0,62.161517814557875,-0.0015740355114516325,0.001579006335541557,65.20999908447266,63.7049993787493,1.7951875729263138
2024-06-13,0,62.451250076293945,61.179999351501465,67.07475090026855,62.74375057220459,64.51018762588501,0.42064597449179814,1.5890401982053433,-0.5481088134753862,2.9954236147169415,63.68624925613403,1.2904624938964844,0.02488621984082023,61.9786262512207,65.96112365722657,0.8203245477314656,-0.0014339932223406543,0.9780592967301727,0.967475581177413,0.9461959407093671,-0.05123529864822407,50.94323193145642,67.03029292082475,63.852212524414064,60.67413212800338,65.13585690089634,1.7371126361269313,63.79578556333269,1.9008072409583985,65.09790789800752,64.54818184453238,1.9992079142131074,2.349693487669952,11985400,0.9571632047582784,1.0729385898557198,159318400.0,-90.73698527995936,83.25868849609935,82.425646108079,-73.1135530315547,22.951539599264173,27.624298042532022,-0.07750226674814979,1.8770454584166676,66.54103839111328,65.45348364257812,64.57450103759766,63.695518432617185,62.60796368408203,0.02,1.0,62.16190704145614,-0.08176657717135227,-0.031323751015371194,64.95428466796875,63.702142170497346,1.8625271832359076
2024-06-14,0,60.96875,61.179999351501465,67.07475090026855,62.628437519073486,64.44081282615662,0.5599486390239952,1.6097615462024142,-0.5261611196010483,2.9954148783747487,63.44749927520752,1.3176024866104128,0.025251349647453673,61.9786262512207,65.96112365722657,0.7822211924981877,-0.02244265813852773,0.9563796746481645,0.9448549539458428,0.9332720541252515,-0.09103277788310216,41.62017479464435,66.96904811491154,63.74952502250672,60.53000193010189,64.77603558131626,2.30386483707098,63.7414105279105,1.973929218657781,64.43891146879716,64.21648249208634,-1.5081011669216666,0.7176675441072583,10366000,1.0453261200235038,0.9187069328429309,148952400.0,-95.93194570516013,83.25868849609935,82.425646108079,-123.8655621322204,21.765176041472188,30.899021385519696,-0.11267391074903152,1.8379687393018556,66.41359907531738,65.24720475006103,64.30450248718262,63.3618002243042,62.19540589904785,0.04,0.0,62.15538892150402,-0.09903424112921377,-0.09527004836389778,64.5407131740025,63.63035637991769,1.9763854383852324
2024-06-17,0,60.15524959564209,60.96875,67.07475090026855,62.40656232833862,64.44081282615662,0.5030955430784758,1.719240757915172,-0.6289443417676019,2.995368501492977,63.27874994277954,1.4207050323486328,0.02703050952139356,61.67500038146973,65.96112365722657,0.743629435976917,-0.051494487720655714,0.9457820491230108,0.9348465662877422,0.9383606227639137,-0.09997755842194267,35.24944827976112,67.04219407457668,63.60371255874634,60.16523104291599,63.966249874659944,2.813966579744531,63.59017842156546,2.1668092207230125,63.572407943863595,63.68471763958654,-3.9673152468261628,-1.2331937304310798,13558500,1.0842350467749502,1.1738010819037592,135393900.0,-92.64003474669134,83.25868849609935,82.425646108079,-140.98669236446128,20.758213703245126,32.77868485655218,-0.11965288793781054,1.789468808706548,66.2179545135498,64.93052584075927,63.89000129699707,62.84947675323486,61.562048080444335,0.06,0.0,62.141893319059676,-0.10374117826333185,-0.10653791468818224,63.55642809186663,63.48464230128697,2.0961834789923284
2024-06-18,0,59.54499912261963,60.15524959564209,67.07475090026855,62.2059371471405,64.44081282615662,0.4081010991817451,1.8668400003050725,-0.6062074388783851,2.9953003118596038,63.04187536239624,1.507516074180603,0.029446569611516496,61.15887441635132,65.96112365722657,0.7467896281944536,-0.06773265795009362,0.9392320506285347,0.9296897164483499,0.9486174096269671,-0.09593668090358931,32.165273149003696,67.13121747047403,63.39753746986389,59.66385746925375,62.890571049281526,2.866342981051815,63.47339269093105,2.3435570647015203,62.719231553746084,63.078477568320714,-8.611633317784488,-3.3999751414481008,13500300,1.0884036753862238,1.1340501491032802,121893600.0,-99.02902032830497,83.25868849609935,82.425646108079,-149.3631025544355,19.82093269361451,33.14989313635754,-0.1790401401938704,1.7402191334003072,66.11151846313477,64.75824375915528,63.66450119018555,62.57075862121582,61.21748391723633,0.08,0.0,62.12435225918871,-0.08723171227439719,-0.11879561545757038,62.38785607474191,63.34678513663156,2.2567895264260383
2024-06-20,0,59.46000003814697,59.54499912261963,67.07475090026855,61.93718862533569,64.26812529563904,0.33758058569562943,2.0252237596395055,-0.5466742680037453,2.995219646800827,62.84812545776367,1.5940749120712283,0.032070813436104184,60.887399959564206,65.96112365722657,0.768833820899336,-0.07279665407926465,0.941590063348653,0.9339951669136041,0.9667263112214644,-0.0768872550202615,30.500691935283452,67.19894743726302,63.14849991798401,59.09805239870501,61.8366425377982,2.507015080748851,63.24285697937012,2.574206607647888,61.91948192132297,62.481734183363194,-11.2259109077344,-2.6724423769411336,12928500,1.0916377110374054,1.0577947779130061,108965100.0,-89.37850419299659,83.25868849609935,82.425646108079,-129.30878750780596,18.81457936204984,32.47384317770692,-0.13381867225082508,1.7023447969085679,66.05487896728516,64.66656457519531,63.54450225830078,62.42243994140625,61.03412554931641,0.1,0.0,62.108439470541946,-0.05722845736481941,-0.07673301935453929,61.34642791748047,63.15321377345494,2.3474054394942274
2024-06-21,0,60.23999881744385,59.46000003814697,67.07475090026855,61.59250020980835,63.71874952316284,0.3549710833211811,2.160493737421777,-0.6005550709155347,2.995144696980388,62.72500038146973,1.679649910926819,0.03434233936515232,60.094224548339845,65.96112365722657,0.8176236966208236,-0.05519693496762126,0.9575507889292983,0.9522717867269004,0.9954383845250702,-0.03540763805606306,31.24756328809834,67.23148738138346,62.91049990653992,58.58951243169637,61.03324971880232,1.8039011369901672,63.06267826897757,2.6958219734595557,61.297706993408056,61.99735119274101,-11.037964649320807,-5.1485542761364345,18888300,1.0639985396833271,1.5183606338620876,127853400.0,-80.86024628439203,83.25868849609935,82.425646108079,-88.16480481599694,21.20445212554463,30.949421426253817,-0.037559567374102355,1.6586043110475606,66.05487896728516,64.66656457519531,63.54450225830078,62.42243994140625,61.03412554931641,0.1,0.0,62.09279222845744,-0.015112126931105196,-0.04445845311771363,60.75214276994978,62.98321369716099,2.3938752762237474
2024-06-24,0,59.87750053405762,59.46000003814697,67.07475090026855,61.1271870136261,63.71874952316284,0.4153877320694071,2.2374414458139107,-0.7342567550870562,2.995099940361076,62.56937503814697,1.7850749397277839,0.03564177606660749,60.094224548339845,65.96112365722657,0.8555995184969778,-0.02848507174145383,0.9538307558644149,0.9549707370259165,0.9967323694805649,-0.01789850482324773,37.80342903682487,67.25069523141055,62.77581233978272,58.30092944815489,60.38539259774344,1.0410527575456001,62.82892826625279,2.8263827737558653,61.028517889720945,61.76518806905797,-8.538459861066857,-4.019122748189018,10464700,1.069402663958025,0.8414509071888824,117388700.0,-92.63854700552969,83.25868849609935,82.425646108079,-98.30836043685733,20.13074030239835,30.306916750075725,-0.05581174842571878,1.6222743200195273,66.05487896728516,64.66656457519531,63.54450225830078,62.42243994140625,61.03412554931641,0.1,0.0,62.08174501017291,-0.018883428296554983,-0.03331165431528789,60.18928582327707,62.69964245387486,2.4884128233038685
2024-06-25,0,59.36000061035156,59.46000003814697,67.07475090026855,60.78656220436096,63.71874952316284,0.41441888602717675,2.3206065225884975,-0.8575469068597488,2.9950498644069565,62.56937503814697,1.8813500881195069,0.03702935492821535,59.84425039291382,65.96112365722657,0.8578279155994607,-0.030009718888237297,0.9471931194470576,0.9577105446265604,0.9917209178703826,-0.01321994324079967,36.549990320819106,67.31058784490538,62.669374799728395,58.028161754551405,59.94378553118025,0.5658752897671775,62.5398212160383,2.966197628196617,60.7386773646344,61.60113649807214,-7.040558619141486,-5.1821061100470684,9359200,1.0703536756936791,0.7489822653688533,108029500.0,-94.32116139426363,83.25868849609935,82.425646108079,-106.6876479790378,19.573845395578775,31.727723938446655,-0.045986965110053415,1.549252338509099,66.05487896728516,64.66656457519531,63.54450225830078,62.42243994140625,61.03412554931641,0.1,0.0,62.069572514822134,-0.013304493977212895,-0.021522165854749836,59.8735716683524,62.413928168160574,2.586069100509719
2024-06-26,0,58.94499969482422,59.36000061035156,67.07475090026855,60.21881151199341,63.71874952316284,0.38615093887445057,2.423767533442188,-0.9658470974430107,2.9949849106162505,62.56937503814697,1.999850082397461,0.038748739181997664,59.536499214172366,65.96112365722657,0.8630523547506997,-0.04677021987137996,0.9423529227714011,0.9626282374273433,0.9874113200621691,-0.01007640333590143,33.38778978087009,67.39840987233481,62.55087480545044,57.703339738566065,59.65467834472656,0.4624624830122164,62.215356963021414,3.0999880672326605,60.39384484477647,61.43900536422845,-4.949860030289129,-6.383312300333015,12599400,1.063142014107506,1.002507980661814,95430100.0,-97.76025480338103,83.25868849609935,82.425646108079,-111.05723208310697,18.0337002901329,33.531435999586606,-0.07134391306677584,1.561449040584774,65.87551846313477,64.37624375915527,63.16450119018555,61.95275862121582,60.453483917236326,0.12000000000000001,0.0,62.04979287045564,-0.014546695295823864,-0.031099330007722654,59.53428595406668,62.0374995640346,2.7520315432996756
2024-06-27,0,58.13749980926514,58.94499969482422,67.07475090026855,60.08581233024597,63.71874952316284,0.38684532802291943,2.5481778861116307,-1.0590270602802723,2.9949020149101457,62.56937503814697,2.1729000759124757,0.040846330303388426,59.45000009536743,65.96112365722657,0.8683961672350143,-0.03653154103249259,0.9319221916041674,0.9602913028321712,0.9758461787588405,-0.022241847091042377,32.78430802311619,67.48085560819128,62.384499835968015,57.28814406374475,59.36642837524414,0.677356639941681,61.666339124952046,3.0923923023377813,60.025173493389616,61.245005671151034,-3.3193239244297796,-7.1549511271104915,11648900,1.0421982491608275,0.9141278259712937,83781200.0,-89.53918861088522,83.25868849609935,82.425646108079,-117.58363516569209,16.963957333285546,35.342502268232536,-0.018546656109621674,1.5413451821491215,65.68199853515625,64.06300387573242,62.75450134277344,61.445998809814455,59.82700415039062,0.14,0.0,62.02818584337002,-0.023913048886621935,-0.0126860624754766,59.28285707746233,61.41964258466448,2.8769594618441956
2024-06-28,0,58.2524995803833,58.13749980926514,67.07475090026855,59.79437518119812,63.71874952316284,0.3038730027630139,2.7017360939021735,-1.111353948134089,2.994793494204395,62.56937503814697,2.3402375507354733,0.043413674956640246,59.31850051879883,65.96112365722657,0.8758287626136273,-0.07258225628290908,0.9360481535936993,0.9722681750358223,0.9821368304101502,-0.03299301587112613,26.400248039627478,67.63584704666056,62.232374858856204,56.82890267105186,59.181785583496094,0.7877363381264162,61.03617831638881,2.789561827321558,59.550331655047344,61.00973740765644,-3.35423724436367,-11.677015950055,28102000,0.9784565080333826,2.0732521551803638,111883200.0,-92.02334832494694,83.25868849609935,82.425646108079,-98.24195121841883,17.55785827349257,33.888010307023954,-0.0734690740176805,1.4926762245121081,65.06391815185548,63.56303833007812,62.349998474121094,61.136958618164066,59.63607879638672,0.14,0.0,61.97964424233506,-0.04256726291162671,-0.029598670239894067,59.12714276994978,60.757499422345845,3.0172715741596616
2024-07-01,0,57.89125061035156,58.13749980926514,67.07475090026855,59.523749351501465,63.71874952316284,0.3598056459100633,2.8340462710043575,-1.1698450009691497,2.994692982707592,61.71000003814697,2.516475057601929,0.045702591748008885,58.87574968338013,65.96112365722657,0.8942450123271947,-0.07185821354682631,0.933569864224175,0.9730578691208837,0.9826316198112564,-0.03317189104405416,27.34214000744415,67.67871737988408,62.01062483787537,56.34253229586666,58.957678522382466,0.9091828419588804,60.39716053009033,2.3481571602246003,59.22343936654255,60.771173720944255,-2.1706265199109565,-13.152864828380498,12237500,0.9791736223447735,0.9096500959824871,99645700.0,-92.29246657805916,83.25868849609935,82.425646108079,-98.94354545595696,16.427647445434634,35.901562565342324,-0.08561592585692458,1.4814135828868031,64.76168087768555,63.28416047668457,62.09000015258789,60.89583982849121,59.41831942749023,0.16,0.0,61.956152012653696,-0.02824004467600949,-0.04619698414228915,58.842857360839844,60.094642639160156,3.1396841830203437
2024-07-02,0,58.83500003814697,57.89125061035156,67.07475090026855,59.43500018119812,63.71874952316284,0.42622926897679103,2.9652473593371265,-1.1873466183062606,2.994587017217064,60.604374408721924,2.660493721961975,0.04800693520897966,58.24099960327148,65.96112365722657,0.8970675004874874,-0.08327394955191277,0.9525303263344089,0.9940628285534548,1.0054300223742638,-0.008844349171267307,25.039158372569943,67.69755704892022,61.76706233024597,55.836567611571716,58.75696441105434,0.7127858760571081,59.895107064928325,1.7695696980377986,58.89370313510405,60.48049534246056,-2.6383273238966836,-13.385074335872403,13231600,0.968238174760226,0.9684565087156035,112877300.0,-78.02942198060077,83.25868849609935,82.425646108079,-65.10373710611461,19.638177216633107,33.37156796033527,-0.09532143165926434,1.4798839429106565,63.776120178222655,62.48693991088867,61.44499969482422,60.403059478759765,59.11387921142578,0.16,0.0,61.93769472601688,-0.006067766715677547,-0.008740972316225249,58.60857173374721,59.68035725184849,3.1640888190602627
2024-07-03,0,59.39374923706055,57.89125061035156,67.07475090026855,59.25625038146973,63.71874952316284,0.5704014493454668,3.0133647942486763,-1.1252063920291502,2.9945441671258703,60.19762420654297,2.6947999191284184,0.04895695447382391,58.24099960327148,65.96112365722657,0.9148826965300356,-0.07211290974606356,0.9649469201266997,1.0057468113439374,1.0168029701195158,0.00761302136838804,33.68051417630015,67.57804189204046,61.55131230354309,55.52458271504573,58.6878570829119,0.6006725650877608,59.53662484032767,1.2010663253011895,58.887348549869955,60.342007477572245,-2.3323353367829514,-10.671649681293117,6908300,0.9997806347204635,0.5096241979835013,119785600.0,-60.42456213414775,83.25868849609935,82.425646108079,-44.904019924694765,22.19814721511187,31.54338094452424,-0.07233676960661874,1.4538201302596998,62.06857971191406,61.1057095336914,60.32749938964844,59.54928924560547,58.58641906738281,0.16,0.0,61.93019366979466,0.023686939716323074,0.0052249713302973495,58.62999997820173,59.4096429007394,3.154929938719938
2024-07-05,0,59.53250026702881,57.89125061035156,67.07475090026855,59.25625038146973,63.71874952316284,0.7384333018815374,3.0167158165052346,-0.9576826647991536,2.994537018454817,60.01637506484985,2.649662470817566,0.049171721174037494,58.24099960327148,65.96112365722657,0.9209020581779184,-0.06448119786092144,0.9703650201015127,1.0083546178328169,1.0176147894865255,0.02399484777192562,38.36473331494931,67.38405643273884,61.350624799728394,55.31719316671794,58.71249989100865,0.6353790855012609,59.32814271109445,0.8615618064387026,59.027459392919084,60.289058827484816,-0.8079016202787528,-7.791579452259519,12243800,1.0134836237972136,0.8920437490346478,132029400.0,-40.78092883314963,83.25868849609935,82.425646108079,-39.81520550204635,21.48021074151643,29.469524112402766,-0.0670947064180508,1.444975529293162,60.55203924560547,59.87897915649414,59.334999084472656,58.79101901245117,58.11795892333984,0.02,1.0,61.917385730617575,0.023813592857359955,0.025746653676877847,58.69142804827009,59.28249985831125,3.1236113795619946
2024-07-08,0,59.36750030517578,57.89125061035156,67.07475090026855,59.25625038146973,62.94156265258789,0.9198885054288257,2.99973940504746,-0.7007127428551252,2.9945462028213403,59.71124982833862,2.5546249961853023,0.04905312158006062,58.24099960327148,65.96112365722657,0.8905316936780628,-0.09557719393014355,0.9708047323957459,1.0054363998834803,1.0099777199965025,0.019140821987456036,34.357342370960865,67.15235366132173,61.152874851226805,55.153396041131884,58.77285712105887,0.6796700070627368,59.21376773289272,0.72199337025198,59.16992100606694,60.25380047182823,0.29059914909631007,-4.673645132322297,10320400,0.8232129500484823,0.785529762964925,121709000.0,-44.772074367174376,83.25868849609935,82.425646108079,-45.20424341343547,19.990329988066506,28.416371035451785,-0.13073177124114274,1.4417627725950255,59.87971842956543,59.335138496398926,58.89499855041504,58.45485860443115,57.91027867126465,0.02,0.0,61.905171534246584,0.018266437973270877,0.012335124788049679,58.80999973842076,59.17214284624372,2.814640004809192
2024-07-09,0,59.00500011444092,57.89125061035156,67.07475090026855,59.25625038146973,61.339375019073486,1.210338602399144,2.8218350779582346,0.044113973887188074,2.994675332290748,59.53874969482422,2.2628125190734862,0.046388824326623945,58.24099960327148,65.96112365722657,0.8287134438110118,-0.11490539273939987,0.9699973630924358,1.0007759604425615,1.0000169483914079,0.01923864992286428,30.092467000233576,66.47373254529025,60.83006238937378,55.18639223345731,58.896785736083984,0.6210758482096761,59.13160705566406,0.6702042221024889,59.227521846171214,60.13337972184055,0.7167709093883683,-2.626344963320092,8473600,0.7360947685225935,0.6567628295304552,113235400.0,-47.18494738682978,83.25868849609935,82.425646108079,-48.992542993939516,18.712390055145605,27.64860150293727,-0.13866298001617977,1.4302082890975534,59.87971842956543,59.335138496398926,58.89499855041504,58.45485860443115,57.91027867126465,0.02,0.0,61.89443976218047,0.020584649687601875,0.016715513374251326,58.89999989100865,59.09142848423549,2.358885462842603
2024-07-10,0,58.875000953674316,57.89125061035156,66.83749961853027,58.99000000953674,60.422186613082886,1.4950626761353596,2.452893576634795,1.0673619235565592,2.9949241737495784,59.49625015258789,1.840087437629699,0.04059296067533853,58.24099960327148,64.55762519836426,0.7647491433913549,-0.11718720102925341,0.974322987853316,1.0000509737561163,0.99406097686026,0.0006798829863416955,28.542827780598397,65.33236200335199,60.426574850082396,55.5207876968128,58.98571450369699,0.5544400932065097,59.08375004359654,0.6622890184406531,59.172595432737054,59.90877991285836,1.4921527551439893,-1.9121348326755192,7697100,0.7351173947841779,0.6066447903272268,105538300.0,-49.86587195501725,83.25868849609935,82.425646108079,-56.67014728449099,17.65816553587581,27.207527357082263,-0.15793742381687734,1.4073359719434642,59.87971842956543,59.335138496398926,58.89499855041504,58.45485860443115,57.91027867126465,0.02,0.0,61.883958379007254,-0.0011870390601186331,0.01885487159132788,59.02428599766323,59.0757143838065,1.7366518899808534
2024-07-11,0,59.97500038146973,57.89125061035156,65.86374855041504,58.92750000953674,60.17643690109253,1.7309679961625797,1.9807964797758704,2.244606529413911,2.995197724349607,59.42687463760376,1.3920797920227046,0.03299762833323143,58.24099960327148,62.64737510681152,0.6944973003841332,-0.10610916855713466,0.999109596608876,1.0195755152148338,1.0124968908250773,0.0097864026412815,29.116663740796273,63.990042876391335,60.0284499168396,56.06685695728786,59.28339304242815,0.4092616622050016,59.120535782405305,0.6981275015549767,59.09353360037896,59.677846736184875,1.0686260293981356,-1.1251963705056085,13082000,0.725274706805172,1.039355189824139,118620300.0,-24.10251945983908,83.25868849609935,82.425646108079,30.031135041520514,23.864967649755965,24.49013543187288,-0.12831645818980447,1.4518125008609262,60.00959994506836,59.44019972229004,58.97999954223633,58.51979936218262,57.9503991394043,0.04,0.0,61.87383176614692,0.005868583038233677,0.0172969380472994,59.335714612688335,59.08928598676409,1.294187020838732
2024-07-12,0,60.239999771118164,57.89125061035156,64.41250038146973,58.92750000953674,60.02006268501282,1.7408784243044921,1.4609820814406078,3.1546640773275403,2.9954372424646523,59.42687463760376,0.9942162227630611,0.02445812728946255,58.24099960327148,61.11700000762939,0.6062801280491926,-0.06889190721862717,1.0084706725946921,1.0222904743795642,1.0149786753500953,0.01188425651393632,44.49478812215246,62.65597667127355,59.73401250839233,56.812048345511116,59.484107289995464,0.4893886205862405,59.1205358505249,0.6981276191887098,59.30429685194236,59.59298331773729,3.5994208954704594,0.8661290665865319,8166200,0.7480710311366604,0.6645624603019917,126786500.0,-16.923066389400233,83.25868849609935,82.425646108079,63.17453189082685,22.964552478366006,23.5661329435444,-0.08373241412580949,1.4009682188060295,60.00959994506836,59.44019972229004,58.97999954223633,58.51979936218262,57.9503991394043,0.04,0.0,61.867830400243086,0.008534172532710826,0.01056339829917205,59.521428789411274,59.06500026157924,0.9479667992844969
2024-07-15,0,60.390000343322754,57.89125061035156,62.451250076293945,58.92750000953674,60.02006268501282,0.9426421961403207,1.0046556402606308,1.536017817143331,2.9955905693498925,59.42687463760376,0.7256761264801028,0.016877767333040132,58.24099960327148,60.31287479400635,0.5798202816423881,-0.035407622785362886,1.0145251110842306,1.0211924093693,1.0150859357657371,0.01722322875126725,51.54032783521003,61.53469875839602,59.52538747787476,57.5160761973535,59.62642887660435,0.5926911702829308,59.15714297975813,0.7522147639508004,59.52969562869549,59.55567124229216,2.3880338778961994,1.5831247263074184e-06,9443000,0.6339250315548252,0.7765008780142036,136229500.0,-13.784436232916331,83.25868849609935,82.425646108079,105.33428012120964,24.120647168851114,22.109360757884197,-0.03303044862987158,1.3866132296281728,60.078360061645505,59.49581981658935,59.02499961853027,58.55417942047119,57.97163917541504,0.06,0.0,61.86195625968694,0.023354223465081425,0.011880905607624288,59.64000047956194,59.135000228881836,0.8479681286221189
2024-07-16,0,61.327500343322754,57.89125061035156,60.96875,58.92750000953674,60.02006268501282,-0.15835331849599962,0.7797789766766021,-0.5253625383050329,2.995646105679995,59.42687463760376,0.6160748958587646,0.013122660158311506,58.24099960327148,60.254999828338626,0.6281083685217763,-0.009492562282763647,1.0320616090396642,1.0333105893700827,1.0273129306660964,0.039361074898353055,57.25922987842971,60.981882944579404,59.4223249912262,57.86276703787299,59.88285745893206,0.8691211237348231,59.297678674970356,0.9506494779424269,59.740370558721345,59.578803280683736,1.6773669267549214,0.8559138318968956,9198800,0.5477115785004412,0.7600677705336991,145428300.0,-4.208397070863903,83.25868849609935,82.425646108079,200.7173727858301,27.31914501078939,20.358751931942372,0.014798112153674704,1.3982837877485095,60.84236006164551,60.113819816589356,59.52499961853027,58.93617942047119,58.20763917541504,0.08,0.0,61.86052808758963,0.0476271419201868,0.046031497946848465,59.93285805838449,59.31214305332729,0.9710003087730894
2024-07-17,0,61.21125030517578,57.89125061035156,61.327500343322754,58.92750000953674,60.02006268501282,0.09074617124309732,0.8183193989320322,-0.13916072591719475,2.9956375381133995,59.42687463760376,0.6340124130249023,0.013767089248915988,58.24099960327148,60.254999828338626,0.6263926209474453,0.01948708974795089,1.0297944141234807,1.0254149822154188,1.0174488658084888,0.039681517004810596,67.64843943299567,61.076901306256396,59.44026250839234,57.80362371052828,60.14625031607492,0.9613907585714001,59.459553718566895,1.0712707082065513,60.13621671381655,59.761272455507786,3.0151599013019776,3.314521079415364,8322100,0.5554608806943534,0.7028334692336698,137106200.0,-15.631232804244938,83.25868849609935,82.425646108079,156.98973038420687,25.647189341660365,19.241901940538366,0.007813987011028669,1.3830491731842096,60.84236006164551,60.113819816589356,59.52499961853027,58.93617942047119,58.20763917541504,0.08,0.0,61.85831839957885,0.03972835470232994,0.037966130143505035,60.24000113351004,59.5250004359654,1.0415256828655581
2024-07-18,1,60.454999923706055,57.89125061035156,61.327500343322754,58.92750000953674,60.04124999046326,0.2561070109945212,0.8933747013393893,-0.3159286622176669,2.9956196598629696,59.42687463760376,0.6901186990737912,0.015016451719570369,58.24099960327148,60.47212533950806,0.7327934262455955,0.02798305831065477,1.0161689000146483,1.0087307599020874,0.9971341928619698,0.008003327039321384,68.13770930243005,61.279811946547795,59.493062543869016,57.706313141190236,60.35339314596994,0.820381047404516,59.62508944102696,1.029508084396048,60.40713808378554,59.93158246795311,3.1056554352504175,3.8446867793445,9102000,0.5345685090279977,0.7832460048171953,128004200.0,-40.48095748104693,83.25868849609935,82.425646108079,75.27777535144212,23.806679629260366,21.552431753080537,0.020585916330483185,1.3835458944305503,60.84236006164551,60.113819816589356,59.52499961853027,58.93617942047119,58.20763917541504,0.08,0.0,61.85270620631723,0.00016666646530194562,0.0186756951718887,60.38285827636719,59.64142908368792,1.0433028959433324
2024-07-19,1,59.4300012588501,57.89125061035156,61.327500343322754,58.92750000953674,60.23999905586243,0.14498602542533584,0.9177033339124738,-0.5725816506882659,2.995613561192954,59.42687463760376,0.7407749748229975,0.015413595728296488,58.24099960327148,60.53062496185303,0.7926109489031082,0.016733936846968264,0.9981766216656606,0.9898751578191073,0.9786783992432916,-0.013446190493785815,58.06688713738648,61.37396925174829,59.53856258392334,57.70315591609838,60.43267890385219,0.6659774596761879,59.70919670377459,0.9540823088225231,60.421332911332286,59.99559026003676,2.4574185347900084,3.986239728306286,9352900,0.5660674825746865,0.817411853953255,118651300.0,-53.907769977654596,83.25868849609935,82.425646108079,-18.07762099324179,22.25966022390266,26.338233429292806,-0.013884040962311349,1.3740068175384508,60.84236006164551,60.113819816589356,59.52499961853027,58.93617942047119,58.20763917541504,0.08,0.0,61.84250183962425,-0.015596459591330492,-0.011001830787562955,60.4442868913923,59.73428644452776,1.042478646151921
2024-07-22,1,60.2450008392334,57.89125061035156,61.327500343322754,58.92750000953674,60.23999905586243,0.1497653186739192,0.9178550177682263,-0.5732158130281011,2.995613518897991,59.41187524795532,0.741974925994873,0.015416531770163652,58.24099960327148,60.53062496185303,0.7896592756372076,-0.01344617487540848,1.0118907141673514,1.0036212571773047,0.9947533823454109,-0.002401051552658018,45.68882810351723,61.37277268049495,59.537062644958496,57.701352609422045,60.47125039781843,0.642455571206007,59.87732172012329,0.8047925415131235,60.17584072261293,59.88541047791959,0.9426756623112111,2.0213753692096055,7489500,0.5870539679830311,0.68887018666961,126140800.0,-32.72251570317259,83.25868849609935,82.425646108079,69.86468171097847,25.546124163031358,24.348070051808335,-0.0442111697149722,1.380149172803605,61.11848052978516,60.56076057434082,60.11000061035156,59.659240646362306,59.101520690917965,0.08,0.0,61.83776526142081,0.004961125037282743,0.00829600126435029,60.55571528843471,59.94571495056152,1.0518673239275314
2024-07-23,1,60.267499923706055,57.89125061035156,61.327500343322754,58.92750000953674,60.24125003814697,0.14933657956178711,0.9180471841403353,-0.5749158394664216,2.995613469924841,59.41187524795532,0.7422750473022461,0.015419694672082328,58.24099960327148,60.53062496185303,0.7706508609859877,0.006137535833960728,1.0122643623633576,1.0025305422980917,0.9956016171474166,-0.017284259323837148,54.03127365856056,61.37340711432864,59.537312746047974,57.701218377767304,60.47517899104527,0.6408879689254562,59.979643140520366,0.7513686267380666,60.189090959917905,59.87010575811065,0.45018833855162926,4.065813407148887,7572000,0.6116525205079476,0.7058484653715236,133712800.0,-60.47124496949241,83.25868849609935,82.425646108079,47.5241656756522,24.703068230541408,22.75037452345612,-0.03286489608838649,1.371567176122466,61.11848052978516,60.56076057434082,60.11000061035156,59.659240646362306,59.101520690917965,0.08,0.0,61.83222369277043,-0.03397512121275892,-0.012568250717518867,60.475715092250276,59.99857194083078,1.0526155917139286
2024-07-24,1,58.8149995803833,57.89125061035156,61.327500343322754,58.92750000953674,60.25062561035156,0.10289419039208592,0.9291408196088753,-0.6817847998411595,2.995610632964733,59.41187524795532,0.765675010681153,0.015600915785182488,58.24099960327148,60.53062496185303,0.7859419061070972,0.015288061051607146,0.9875444453569011,0.9763182713879528,0.9750214332557119,-0.03914722723103503,55.52436275581761,61.415094354748156,59.5568127155304,57.69853107631264,60.25017888205392,0.8999064083295673,59.93830387932913,0.800404246184716,60.20326933351615,59.866878805358674,0.0456509838850887,2.434775022742057,11801700,0.5984506568099975,1.087750376971033,121911100.0,-97.77227395563244,83.25868849609935,82.425646108079,-72.84910125943738,22.518212429770646,29.480444952015468,-0.08968173666338988,1.3971696694276936,61.06656024169922,60.476720108032225,60.0,59.523279891967775,58.93343975830078,0.02,1.0,61.815934461387926,-0.05176358420573357,-0.06050803422377701,60.13285773141043,59.88642910548619,1.1022253672070994
2024-07-25,1,57.8075008392334,57.89125061035156,61.327500343322754,58.86500072479248,60.25062561035156,0.16144845582331824,0.9424105705547758,-0.7768648490773304,2.995607058951296,59.41187524795532,0.7877688121795657,0.01583096747868743,58.24099960327148,60.53062496185303,0.7287044701412736,-0.0022054477074216166,0.9710721572990983,0.9596895621647262,0.9659940768590116,-0.043792888724072276,43.51850552774461,61.41438380514154,59.529562664031985,57.64474152292243,59.74732181004116,1.147096850631357,59.815089634486604,0.980247651876114,59.85177073814951,59.6635546381701,-2.6080489385418573,-0.97442856211562,12515700,0.6799654633838226,1.1540041427491976,109395400.0,-99.58505271722011,83.25868849609935,82.425646108079,-130.38747033022753,20.853434182038626,31.27787882309832,-0.10327330949198076,1.400943343797317,60.882480529785155,60.17876057434082,59.61000061035156,59.041240646362304,58.33752069091797,0.04,0.0,61.79420115002249,-0.04633331298828125,-0.06564337602193737,59.47714342389788,59.705000741141184,1.184033821837229
2024-07-26,1,57.792500495910645,57.8075008392334,61.327500343322754,58.829999923706055,60.25062561035156,0.0618359304777975,1.0080139272600273,-0.8864395047781044,2.9955886716963462,59.41187524795532,0.8389562606811524,0.016949190727423867,58.11287488937378,60.53062496185303,0.662821678882734,-0.005676180969501335,0.9717485909966469,0.9629054225809605,0.9743648107522226,-0.027553436450510005,38.18723471299194,61.488715575772495,59.47268772125244,57.45665986673239,59.25892898014614,1.147717586170644,59.702589648110525,1.116479843278038,59.33824693162735,59.376558291724024,-5.739675487152979,-2.8975759796044978,11323400,0.6936882045241229,1.0456378045244423,98072000.0,-73.86138823275246,83.25868849609935,82.425646108079,-116.34078630885128,19.424250492074744,30.310598283922772,-0.09640723461515789,1.396590232110962,60.82820063781738,60.09090074920654,59.4950008392334,58.89910092926026,58.161801040649415,0.06,0.0,61.77552510764016,-0.017529089557232758,-0.02849998474121094,59.05571474347796,59.647857938494,1.1879053102169004
2024-07-29,1,58.652499198913574,57.792500495910645,61.327500343322754,58.829999923706055,60.25062561035156,0.00040925685698907865,1.0333487474366452,-0.8777516358621678,2.995581221717445,59.41187524795532,0.8544812297821046,0.01738022267508377,57.88287563323975,60.53062496185303,0.6874907534304348,-0.007896641136195334,0.9864951199254147,0.9812355901631147,0.9943545255209393,-0.02643375579941465,37.80989515237282,61.52213525045801,59.45543775558472,57.38874026071143,59.00142887660435,1.0309026142093132,59.67741101128714,1.137204312448777,58.95337575692879,59.17925372860034,-5.58516578606149,-2.652966355613637,12346800,0.6929896325327548,1.2295870504370896,110418800.0,-60.990144482625,83.25868849609935,82.425646108079,-57.40594702194472,22.49910226379137,28.683339145261126,0.036035085172610795,1.3704049797609152,60.82820063781738,60.09090074920654,59.4950008392334,58.89910092926026,58.161801040649415,0.06,0.0,61.75971821989447,-0.030113572770607,-0.006573456806157833,58.90428597586496,59.64357212611607,1.1487036970522266
2024-07-30,0,63.56624984741211,57.792500495910645,61.327500343322754,58.829999923706055,60.25062561035156,-3.9209225830323785e-05,1.0135542107916249,-0.7888930851453093,2.9955870506108018,59.41187524795532,0.8364812469482423,0.017041559496911725,57.88287563323975,60.53062496185303,0.6852996353210019,0.013149631084768663,1.0687815385071067,1.0665411007656642,1.0835094659543796,0.05473513797456375,46.60584100608969,61.50254615809448,59.47543773651123,57.44832931492798,59.59232153211321,2.0242858204094127,60.0125002179827,1.511984334215223,58.880398708342796,59.155683032228296,-2.9815577323087066,-0.597408549857917,44232800,0.7150337410005582,3.7996819052355923,154651600.0,-13.102571550361573,83.25868849609935,82.425646108079,262.9133325757082,41.64689058693536,21.349275533987267,0.0590655504626252,1.7096634781129603,63.15075842285156,61.96961895751953,61.01499938964844,60.060379821777346,58.879240356445315,0.02,1.0,61.79718832478203,0.07184727819972347,0.053151218000750886,59.57142857142857,60.00785773141043,1.468881736371013
2024-07-31,0,65.48499870300293,57.792500495910645,63.56624984741211,58.86500072479248,60.29812502861023,1.0245791907519541,1.2876462406895781,1.6309867683170953,2.9955017590303252,59.48125076293945,0.9844812393188477,0.02154725139821176,58.56799936294556,61.22287530899048,0.27102138714219687,0.08041556567005229,1.0958147395433122,1.0946229741420064,1.1038022260013278,0.11340642982584148,70.01388122155431,62.334480179743416,59.75918769836426,57.1838952169851,60.34089265550886,3.026591630067629,60.406071526663645,2.1030657535796577,60.05305783930037,59.78472891831107,6.959866230771881,7.968150858169995,25825900,1.2941331335280837,2.10464595098974,180477500.0,-12.075843212082772,83.25868849609935,82.425646108079,288.93810166227297,44.36251789550429,18.817726561764967,0.05109769713343969,1.8011163816609181,64.62527865600586,63.16235914611816,61.97999954223633,60.79763993835449,59.334720428466795,0.04,0.0,61.83744176924058,0.13277077880129307,0.10165801018078893,60.28714261736189,60.421428952898296,1.9749519046307398
2024-08-01,0,65.85249900817871,57.792500495910645,65.48499870300293,58.97250032424927,60.40625023841858,1.513962967420004,1.7731373542488773,2.373280632736133,2.995303094158925,59.75375032424927,1.2362311315536503,0.02950719848507369,58.56799936294556,61.551375293731695,0.4756444354117917,0.10255707956118658,1.0958670259335765,1.0929580561764076,1.085586630678908,0.1391687592812394,74.58084249392267,63.637962340104814,60.09168763160706,56.5454129231093,61.138749667576384,3.671464938843536,60.80696432931082,2.5552885470792543,61.41012988694392,60.56607866277887,8.697813579175989,9.187158460170028,19086400,1.3458623604392919,1.4818857894199484,199563900.0,-19.264328561700594,83.25868849609935,82.425646108079,227.41672971563747,41.6324952772852,17.147925783520527,-0.01558336922589363,1.8353229675635525,64.8621226196289,63.35394235229492,62.13500213623047,60.916061920166015,59.40788165283203,0.06,0.0,61.868417710230375,0.1413840644058486,0.12467707769619349,61.08714239937918,60.78142874581473,2.2858205015551354
2024-08-02,1,62.72749996185303,57.792500495910645,65.85249900817871,58.97250032424927,60.644062519073486,1.3310814209375939,2.162109835602871,1.020325256045889,2.995101531099055,60.107500076293945,1.540974740982057,0.03578785486630921,58.56799936294556,63.7581247329712,0.6425839027147427,0.10616047894514755,1.0382833599826171,1.0318486790822308,1.0073510896576188,0.08539169310197225,75.33797016172329,64.73884479136872,60.41462512016297,56.09040544895722,61.69767829350063,3.554701894454613,60.97392858777727,2.601890045637346,62.51872295365115,61.319219874724624,9.26701637124956,9.316897839284916,23117100,1.3452048283666558,1.7221404003584766,176446800.0,-51.50050887240079,83.25868849609935,82.425646108079,68.13636407406841,35.12537062799137,29.07214061479837,-0.059641392604243365,2.0199434036260997,64.8621226196289,63.35394235229492,62.13500213623047,60.916061920166015,59.40788165283203,0.06,0.0,61.872420157552604,0.06330414425720199,0.083187665501324,61.645713806152344,60.88928576878139,2.3070373695461206
2024-08-05,1,60.2162504196167,57.792500495910645,65.85249900817871,58.97250032424927,61.240312814712524,1.0920764920269272,2.2085654104930086,0.4040670577962806,2.9950759339262185,60.24250030517578,1.6723747539520275,0.036460391158277095,58.56799936294556,63.7581247329712,0.7318694942664977,0.05659661665735174,0.9940878517579873,0.9851953899320739,0.951933999837285,0.02666128881226082,58.10263534292554,64.9915059258902,60.57437510490418,56.15724428391816,62.04178537641253,3.215786930102163,60.89455359322684,2.607218843728024,62.56690604624665,61.57516933566703,6.652215267165745,3.8706732989590518,17445400,1.5496753482806738,1.2660199191275294,159001400.0,-66.21493470332518,83.25868849609935,82.425646108079,-21.786618609391603,31.172319978358363,33.37066251889559,-0.013280796539372487,2.113519099659471,64.8621226196289,63.35394235229492,62.13500213623047,60.916061920166015,59.40788165283203,0.02,1.0,61.859885346486095,0.025788946270434376,0.03722762283174483,62.10857064383371,60.79285703386579,2.2829156327498783
2024-08-06,1,61.80749988555908,57.792500495910645,65.85249900817871,58.97250032424927,61.240312814712524,1.0654484439996974,2.1930676131697084,0.41204824721780753,2.99508574722895,60.24250030517578,1.6469122505187983,0.03617919713556929,58.56799936294556,63.7581247329712,0.7132996964373326,0.020527926494814788,1.019642855235251,1.0112773204405898,0.9722823096945398,-0.027667983656025408,48.68287434632151,65.00294783696563,60.61681261062622,56.2306773842868,62.615356717790874,2.637653394872792,60.937142848968506,2.617639153418674,61.9776098883448,61.460585000785734,4.16684607605196,-1.8119928539155696,14358900,1.6594279296009395,1.0202440886500874,173360300.0,-44.04648833729451,83.25868849609935,82.425646108079,55.8609831240609,36.057760380859605,29.81177549799521,0.015014097331284407,2.196839652323202,64.8621226196289,63.35394235229492,62.13500213623047,60.916061920166015,59.40788165283203,0.02,0.0,61.861861656479086,-0.01953125,0.06464203362849236,62.74571337018694,60.90071405683245,2.3005061818856407
2024-08-07,1,63.43375110626221,57.792500495910645,65.85249900817871,59.29125118255615,61.447500228881836,0.9271379350309702,2.1750633040689844,0.2520084284989461,2.995098134190962,60.25625038146973,1.6678934860229497,0.03579942291394002,58.56799936294556,63.7581247329712,0.6852709091422565,0.049808898248548596,1.044057742421766,1.0352770025504645,1.003416785823629,-0.031323931241777014,54.07366031185289,65.10706420732011,60.75693759918213,56.40681099104415,63.29839270455496,1.976657748766799,61.14991079057966,2.695341562770251,61.938169773061645,61.55550130092048,6.947267128427046,0.9740849556423523,13464400,1.6930213483087038,0.9374788944706124,186824700.0,-44.14327749277312,83.25868849609935,82.425646108079,90.822723191352,37.918259743472994,27.527368827322316,-0.03520640670844663,2.2092084865468133,64.8621226196289,63.35394235229492,62.13500213623047,60.916061920166015,59.40788165283203,0.02,0.0,61.87029378119042,-0.046214611694198826,-0.0196874737739563,63.28857094900949,61.096428462437224,2.2969455188141925
2024-08-08,1,63.90124988555908,57.792500495910645,65.85249900817871,59.83875060081482,62.03749990463257,0.6997321674763971,2.204569599722867,-0.19014671124139682,2.9950840026788192,60.328750133514404,1.7532248306274412,0.03614944846343769,58.56799936294556,63.7581247329712,0.6740607515339367,0.057669874160786484,1.0478212798442188,1.0351041654974393,1.0174143184800626,-0.029630600994766887,58.046341343834754,65.39401430625726,60.98487510681152,56.57573590736579,63.346249852861675,1.9882451357817712,61.469285692487446,2.740396283058713,62.31943303525827,61.72820875563662,8.151829798647688,4.927220554652756,9761200,1.7124586406519438,0.6875871265138617,196585900.0,-29.23527335089152,83.25868849609935,82.425646108079,97.26133752247459,35.52475764257233,25.78976758807228,-0.006810870891199235,2.1896222027427186,64.8621226196289,63.35394235229492,62.13500213623047,60.916061920166015,59.40788165283203,0.02,0.0,61.878461887462656,-0.015770920499159402,-0.02280328409601764,63.32857077462332,61.44999967302595,2.3999400748120694
2024-08-09,1,64.87250137329102,57.792500495910645,65.85249900817871,60.01968812942505,62.90406274795532,0.4830762285298558,2.279442536359027,-0.6204571883577938,2.995042012012593,60.422500133514404,1.8681810808181765,0.037257245673816594,58.56799936294556,64.05962476730348,0.6883079414844272,0.06077772457423365,1.0603341310811703,1.0405656007137758,1.039336098780663,0.03419555079897085,59.17472263162197,65.74007265473404,61.181187582015994,56.622302509297946,63.2587502343314,1.8894583040601438,61.799821444920134,2.85792397008037,62.71691828033209,61.87552631655083,0.5270092839378208,7.523554655895523,8605300,1.7135715819721324,0.6052285563674612,205191200.0,-24.97581194321309,83.25868849609935,82.425646108079,110.62205503351048,36.84392376582261,24.7298535802129,-0.03168550964372793,2.120363359466699,64.8621226196289,63.35394235229492,62.13500213623047,60.916061920166015,59.40788165283203,0.02,0.0,61.88854599019989,0.044207836377920806,-0.009033782880810887,63.17714255196707,61.73214258466448,2.5155099740180598
2024-08-12,1,64.20624828338623,57.792500495910645,65.85249900817871,60.01968812942505,63.46687579154968,0.3058818873329786,2.4039979719919202,-0.9734941176090142,2.994968778690536,60.83312511444092,2.03437484741211,0.039144892861657635,58.56799936294556,64.9337511062622,0.6953208005208482,0.07422588184276913,1.0454862023114013,1.0183143675493715,1.02164007777348,0.06626114771287228,61.74628119312584,66.22080860610848,61.41281266212464,56.6048167181408,63.02357155936105,1.5918214349026771,62.08116061346872,2.8891739455549907,63.257117524650155,62.137277259148526,-0.9353246420448152,7.681136143406021,7519500,1.7222850446411966,0.5324636792429449,197671700.0,-37.17331352005282,83.25868849609935,82.425646108079,72.10801101667343,34.53254076624058,27.207735649965322,-0.056260208055755004,2.1006943096005366,64.8621226196289,63.35394235229492,62.13500213623047,60.916061920166015,59.40788165283203,0.02,0.0,61.89457118047509,0.04961958394687538,0.023878663329575875,62.91285705566406,61.999999727521626,2.54639664341771
2024-08-13,1,64.61750030517578,57.792500495910645,65.85249900817871,60.01968812942505,63.64999985694885,0.1270710116824545,2.465898163960382,-1.16387211233322,2.9949321020624295,61.26937532424927,2.1419872522354124,0.04002845874075733,58.56799936294556,64.9337511062622,0.7375633922894063,0.046940571912236925,1.0489236671243816,1.0158886199045007,1.015292036542671,0.045463745092741314,58.234835082107324,66.53542138704857,61.60362505912781,56.671828731207036,63.293571608407156,1.690464588714341,62.49562495095389,2.7993889533636094,63.49891515748489,62.37538065602464,-2.4999062292047873,6.535443422518478,8638600,1.725129825473652,0.6129240078103715,206310300.0,-21.20040709792064,83.25868849609935,82.425646108079,87.24099661288487,33.70915662592216,25.19637658042206,-0.06505022678548551,2.1063590377949315,64.8621226196289,63.35394235229492,62.13500213623047,60.916061920166015,59.40788165283203,0.02,0.0,61.904333070312795,0.03760957147970623,0.07691038035548234,63.36000006539481,62.50285693577358,2.6685920308759026
2024-08-14,1,65.5625,57.792500495910645,65.85249900817871,60.01968812942505,63.97749948501587,0.00368097114717048,2.550284976753346,-1.3235099589696409,2.994879558674022,61.50937509536743,2.2788747787475585,0.04128804256873307,58.56799936294556,64.9337511062622,0.7479755329478479,0.05564745015038487,1.0614293365593424,1.0290447656628867,1.0211233299754492,0.03355861598302434,59.62143447663832,66.86869501072715,61.76812505722046,56.667555103713774,64.05732154846191,1.2069904518294288,63.049553462437224,2.5571471543450377,63.78112277297805,62.68350366530359,3.013033110632713,9.865681826388725,8944800,1.7248418304679716,0.6332505381334018,215255100.0,-11.22946230872971,83.25868849609935,82.425646108079,100.29885160291765,34.28221798883949,23.699099383216094,-0.04202257758170259,2.079475881520654,64.8621226196289,63.35394235229492,62.13500213623047,60.916061920166015,59.40788165283203,0.02,1.0,61.91749101258359,0.05419186516133867,0.05402389465575199,64.17142868041992,63.13999966212681,2.842620941046143
2024-08-15,1,67.56750297546387,57.792500495910645,65.85249900817871,60.01968812942505,64.30906128883362,-0.09826621552979135,2.676000488365701,-1.4227663173270833,2.994798616637355,62.267499923706055,2.4368123054504394,0.043171264117287764,58.56799936294556,65.49274883270263,0.7465609344149277,0.08448432855412435,1.090050068892493,1.0603855625797898,1.045418724584842,0.057373730505595466,63.29999317593007,67.33768851869307,61.98568754196167,56.63368656523026,64.88017913273403,1.369973820460799,63.74776792526245,2.336289533569946,64.22647450384618,63.03383535493355,8.878416612007527,13.415212642272467,12968300,1.7180971804993688,0.9057005153461982,228223400.0,-1.791047268829416,83.25868849609935,82.425646108079,135.09548813827493,37.9054548009595,22.08175228763519,0.017633673962253817,2.0723706858089184,65.74820202636718,64.28090158081055,63.095001220703125,61.9091008605957,60.44180041503906,0.04,0.0,61.9461988003595,0.0569384525764518,0.0828817440839209,64.91285760062081,63.82928548540388,3.098447758308822
2024-08-16,1,67.81250190734863,57.792500495910645,67.56750297546387,60.01968812942505,64.68125057220459,-0.08491611245489879,2.9112183552647544,-1.250347580474212,2.994639782836879,63.08062553405762,2.60380618095398,0.04669805991299377,58.56799936294556,65.59149990081787,0.7161819831009772,0.13692582103726547,1.0877618544801257,1.0613738416759486,1.0374396380017032,0.04531967277075055,69.61275250467541,68.16374940507907,62.34131269454956,56.51887598402004,65.50571496146065,1.582627926377664,64.40205383300781,2.0666634660554797,65.05921590191137,63.58742608591246,9.319262388172689,16.91396356910512,9526800,1.7311767340081967,0.6649438394385514,237750200.0,-5.959635114629709,83.25868849609935,82.425646108079,126.60033565736951,37.84399068474232,21.155160203540465,0.015204905718086288,2.008629816182049,66.2136026916504,64.76820246887208,63.60000228881836,62.43180210876465,60.986401885986325,0.06,0.0,61.96803947192831,0.050061770745657874,0.05724953912664083,65.6585715157645,64.473571232387,3.2528129516179787
