date,buy?,todays_price,Minimum,Maximum,25th Percentile,75th Percentile,Skewness,Standard Deviation,Kurtosis,Shannon Entropy,Median,Mean Absolute Deviation (MAD),Coefficient of Variation (CV),10th Percentile,90th Percentile,Autocorrelation,Cumulative Return,curr_to_avg_one_month,curr_to_avg_one_two_week,curr_to_avg_one_one_week,momentum,rsi,upper_band_current,middle_band_current,lower_band_current,rolling_mean_7,rolling_std_7,rolling_mean_14,rolling_std_14,ema_7,ema_14,roc_7,roc_14,Volume,Volatility,Relative Volume (RVOL),On-Balance Volume (OBV),Williams %R,Stochastic Oscillator %K,Stochastic Oscillator %D,Commodity Channel Index (CCI),ADX1,ADX2,Chaikin Money Flow (CMF),Average True Range (ATR),Fib_23.6,Fib_38.2,Fib_50,Fib_61.8,Fib_76.4,Parabolic SAR 2,Parabolic SAR 3,VWAP,Adj Close Momentum,Adj Close Return,Adj Close 7d MA,Adj Close 14d MA,Adj Close Volatility
2024-01-02,0,150.55999755859375,144.5625,153.99999618530273,146.45562553405762,153.3506259918213,0.0027681007148830177,3.4532826479900116,-1.7321181254092564,2.9954659854865353,148.7762508392334,3.271587257385255,0.023076556455497697,145.51375465393068,153.57625312805175,0.9054964846443345,0.04118943175902975,1.0061169726789574,0.9848778268543137,0.9817678933282932,-0.01955233980638016,66.4688580324661,156.5511907690025,149.64462547302247,142.73806017704246,152.9489288330078,1.1270867594922418,151.59928594316756,2.519067026728899,152.79804847282844,151.0743877368556,-0.980515937817956,4.063879487479197,47339400,1.145001366721086,1.0087844632437881,317199600.0,-55.17919841887659,47.13413368669027,45.7615501877868,7.825356793883194,17.792962000755647,23.267281906549176,0.18834323532537378,2.8247358176285293,153.1921244506836,151.6839441833496,150.46500396728516,149.2460637512207,147.73788348388672,0.04,0.0,149.39581984727536,-0.022748048069462845,-0.025416041050349045,152.75142778669084,151.63928440638952,3.354881397621453
2024-01-03,0,149.26250076293945,144.5625,153.99999618530273,146.513747215271,153.3506259918213,-0.13643659286796636,3.378918739828001,-1.6450677940017155,2.9954777613211583,149.88000106811523,3.157999610900879,0.022548711175231065,145.51375465393068,153.57625312805175,0.8786507741081298,0.0414872291126243,0.9960810774536569,0.9755224870797761,0.9771334025852642,-0.027574176347097357,55.97953809637516,156.60758780772,149.84975032806398,143.09191284840796,152.37178584507532,1.7680039281461573,151.80017880031042,2.1639440284509113,152.2350421534896,150.91666291890604,-1.6285263814474498,3.588012173856444,49425500,1.1485823407605502,1.051970431895208,267774100.0,-70.82100128439454,47.13413368669027,45.7615501877868,-19.190726606022707,16.236811607947864,21.42527008165917,0.11017699537154167,2.8152550798923004,153.24404473876953,151.76798464965822,150.57500457763672,149.38202450561522,147.9059644165039,0.04,0.0,149.39041111413482,-0.03220130580458602,-0.032264352804849315,151.98428562709265,151.70999908447266,3.155036328245661
2024-01-04,1,145.39750289916992,145.34500122070312,153.99999618530273,146.5631227493286,153.3506259918213,-0.15643481098149475,3.1593289055491027,-1.6060688851517901,2.9955104498804883,149.9112491607666,2.9229995727539064,0.021050299233201595,146.00500297546387,153.57625312805175,0.8770198461186322,0.025629983670189357,0.9687693289584453,0.952203995322846,0.9571355433166134,-0.05401752904307533,47.4050839041463,156.40340817730913,150.08475036621093,143.76609255511272,151.20535714285714,3.0674079514714063,151.59214319501604,2.617713560422755,151.49010379920782,150.68513067572226,-2.635313104022758,1.920450655751536,56039800,1.191396242093489,1.1811627475874233,211734300.0,-95.50946295132341,47.13413368669027,45.7615501877868,-107.91653880758835,14.081586763655375,31.434607929463734,0.04980785124356699,2.9577973507296966,152.8971244506836,151.20644418334962,149.84000396728516,148.4735637512207,146.7828834838867,0.04,0.0,149.1806587775405,-0.057193095233593616,-0.05762333698499226,150.72000122070312,151.40499986921037,3.31908187135502
2024-01-05,1,145.26250076293945,145.34500122070312,153.99999618530273,146.5631227493286,153.3506259918213,-0.16216999698497617,3.169176727916246,-1.5983274009862247,2.9955090347151674,149.9112491607666,2.92974967956543,0.021116864046952545,145.99150276184082,153.57625312805175,0.7997861243759395,-0.0045187671636235365,0.9679133551344188,0.9567097315303625,0.9668149762979894,-0.05386481944872079,32.48585895840776,156.4163537152319,150.0780002593994,143.7396468035669,150.02928597586495,3.5788039889036307,151.371429170881,3.012392055819619,149.96492995933903,149.97786867492064,-5.317053781162613,-1.9637910101493683,45124800,1.4928071562638452,0.945677626341781,166609500.0,-89.72364202728397,47.13413368669027,45.7615501877868,-104.89947420927166,13.202033844359027,29.471164346340238,0.07082098433535998,2.8794133918984754,152.8971244506836,151.20644418334962,149.84000396728516,148.4735637512207,146.7828834838867,0.04,0.0,149.03168964475265,-0.05307079886891175,-0.05282373182583048,149.55285862513952,151.24928610665458,3.2594854250329477
2024-01-08,1,147.8474998474121,145.26250076293945,153.99999618530273,146.5631227493286,153.3506259918213,-0.18671838700161586,3.223869231199166,-1.5732142273164633,2.9955010941278255,149.9112491607666,2.9694997787475588,0.021486982337881044,145.39225273132325,153.57625312805175,0.8149387164922465,-0.00893753994504504,0.9853987212563077,0.9787562881113494,0.9949728901047631,-0.030444630991897093,31.39645709865991,156.48598862261562,150.03825016021727,143.59051169781893,149.19321496146065,3.246536524401692,151.27482169015067,3.107570256790318,148.78575268403847,149.3577743180562,-5.363365729328147,-2.082874503818066,46757100,1.4872546526338517,0.9856650204871249,213366600.0,-56.390308693950644,47.13413368669027,45.7615501877868,-44.911362004947186,19.70143200137604,25.946632226650166,0.10072949933789964,2.9894687258228116,152.8971244506836,151.20644418334962,149.84000396728516,148.4735637512207,146.7828834838867,0.04,0.0,148.9992796146593,-0.01869156438236752,-0.027904541941871357,148.94714573451452,151.18714359828405,3.181977363780643
2024-01-09,0,149.90500259399414,145.26250076293945,153.99999618530273,147.5193738937378,153.3506259918213,-0.2084096069254557,3.1668069571622004,-1.5134890231200582,2.9955093661744714,149.9112491607666,2.905749702453613,0.021097699911875642,145.39225273132325,153.57625312805175,0.8339658904516671,0.00895693076897645,0.9986875748344014,0.995973730513191,1.0151626117198982,-0.004350391705769674,44.49233854168407,156.43561415083565,150.10200023651123,143.7683863221868,148.6750008719308,2.678227396423241,151.09785733904158,3.110180846991227,148.54043718797487,149.18467476462558,-3.807740544588873,-0.9065044830617475,43812600,1.6011027375797175,0.9216944876642059,257179200.0,-36.78764328171963,47.13413368669027,45.7615501877868,2.7711355196885887,24.22785719753299,23.40995418273371,0.10878181991902901,3.032717178293722,152.8971244506836,151.20644418334962,149.84000396728516,148.4735637512207,146.7828834838867,0.04,0.0,149.0506753804384,0.00960449884447212,-0.0037515289921004587,148.66000148228235,150.9942855834961,3.1235706091694784
2024-01-10,0,153.02249908447266,145.26250076293945,153.99999618530273,148.1943759918213,153.3506259918213,-0.31710074604976995,3.0603984050178923,-1.336346748905337,2.99552441749337,150.23250007629395,2.7372493743896484,0.020365929397451885,145.39225273132325,153.57625312805175,0.7971151317609352,0.0313736374487813,1.0183136311488818,1.0191631021154353,1.0371945481418152,0.025190508683121227,53.34663894949514,156.39129737461099,150.2705005645752,144.14970375453942,148.75107192993164,2.809015658993933,151.0280361175537,3.05041623435457,148.8717659680251,149.36555991618332,-2.3626910249410003,-1.6258434258973435,44421800,1.630637031399731,0.940929217856215,301601000.0,-16.4076757758197,47.13413368669027,45.7615501877868,67.58660218774308,29.658783007177824,21.442615942027558,0.0897855129609437,3.034162313014277,152.8971244506836,151.20644418334962,149.84000396728516,148.4735637512207,146.7828834838867,0.04,0.0,149.20152988407233,0.035427995309415206,0.02534518266785483,148.91571480887276,150.99000004359655,3.0207536990048354
2024-01-11,0,155.12749481201172,145.26250076293945,153.99999618530273,148.3418731689453,153.3506259918213,-0.4854144567918876,2.895570076369639,-1.150135808889834,2.9955469745222465,151.47125053405762,2.5996246337890625,0.01921995340375241,146.3447509765625,153.57625312805175,0.7513291411497852,0.04487878652982865,1.0296912674501253,1.033508071160641,1.0461300972205896,0.06691993823022768,61.55489142748865,156.44551561050295,150.65437545776368,144.8632353050244,149.40357153756278,3.691198552191651,151.17625018528528,3.202944344049556,149.91242103163165,150.0486734102652,0.3492015215060842,-0.6347383928853417,49072700,1.7447539642124539,1.0349181838533175,350673700.0,-15.167730440365096,47.13413368669027,45.7615501877868,104.27358738236164,33.76155194271351,19.14218245267865,0.04375817446886438,3.1180672801025193,154.07367932128906,152.15816003417967,150.61000061035156,149.06184118652345,147.14632189941406,0.02,1.0,149.4240791555014,0.07338994821912204,0.045194257425132035,149.66571480887276,151.20857129778182,3.0694626700798793
2024-01-12,0,155.05499649047852,145.26250076293945,155.12749481201172,148.98812770843506,153.50437450408936,-0.6048006798354477,2.8831719197580945,-0.8268531859515464,2.9955494739628734,152.43625259399414,2.5696743965148925,0.01908270111475059,147.60250015258788,153.72999687194823,0.7440106811804399,0.045967860397771246,1.026254499115946,1.032043545872186,1.0320967902453078,0.06741241322507507,65.35866877833743,156.85459399973345,151.08825016021729,145.32190632070112,150.23107092721122,4.259794534679574,151.30142838614327,3.3243788947276776,151.22131425226831,150.94300773227658,3.0336725076263544,1.355741969065491,40460300,1.7567600153713776,0.8645051065463661,310213400.0,-19.436006103517897,47.13413368669027,45.7615501877868,90.69764163455412,31.776327778085218,18.016596661087608,-0.00470582998864189,3.0422589298648974,154.07367932128906,152.15816003417967,150.61000061035156,149.06184118652345,147.14632189941406,0.02,0.0,149.5890565264536,0.06458268568755265,0.06951640923992088,150.5442853655134,151.26428549630302,3.1116894758682845
2024-01-16,0,153.45750045776367,145.26250076293945,155.12749481201172,149.24687671661377,153.54000186920166,-0.7550337764995801,2.9325353241493186,-0.5746143903250749,2.99554380589883,152.75625038146973,2.5616493225097656,0.019366192125993272,147.60250015258788,154.10549621582032,0.7566672219259988,0.04517955221942088,1.0134191436898883,1.0203766186981245,1.0083184797049851,0.037944507794460014,65.03074109431145,157.2905705643753,151.42549991607666,145.56042926777803,151.38249914986747,3.8000231542392697,151.2939281463623,3.318999300047399,152.18369929282505,151.76487079507822,3.880744123896715,1.143161261443314,41384600,1.7580369839427328,0.9006269303221178,268828800.0,-30.563993896482106,47.13413368669027,45.7615501877868,47.02979710966205,29.364891710282368,21.61945528043537,-0.002351051589774198,3.025906202446638,154.07367932128906,152.15816003417967,150.61000061035156,149.06184118652345,147.14632189941406,0.02,0.0,149.70310501450447,0.02723002945938857,0.05453041771826481,151.77142769949776,151.24571446010046,2.9829083106869865
2024-01-17,1,151.31500244140625,145.26250076293945,155.12749481201172,149.74437713623047,153.54000186920166,-0.9891312625095423,2.8755686001455323,-0.1255148994559998,2.9955514151863203,153.0374984741211,2.4330241584777865,0.018958032568763744,147.60250015258788,154.10549621582032,0.7816145684561709,0.0285354942996101,0.9975887009899759,1.0054837815666693,0.9869646426215329,0.00940595592550686,58.00893192510043,157.43188728421438,151.68075008392333,145.92961288363227,152.2471422467913,2.7067193423888654,151.13821411132812,3.2583751032051698,152.5105982776479,152.2546537118605,5.543422271965143,-0.06837825271480369,34953400,1.8059447405968252,0.828346457812532,233875400.0,-41.61580401752901,47.13413368669027,45.7615501877868,-17.171872258060755,26.853466057642787,25.665061012377375,-0.049635736430374625,3.043856122474097,154.07367932128906,152.15816003417967,150.61000061035156,149.06184118652345,147.14632189941406,0.02,0.0,149.74108076758594,0.0022462284973745472,0.01750503355807724,152.69571358816964,151.12428610665458,2.9540322301313893
2024-01-18,0,152.96750259399414,145.26250076293945,155.12749481201172,150.39624881744385,153.54000186920166,-1.1265352813436236,2.8207614907655416,0.23508729840079656,2.9955583578856677,153.0374984741211,2.2955492973327636,0.0185837442143464,147.60250015258788,154.10549621582032,0.8178865986493299,-0.007005404449524171,1.0077806828476867,1.0159548938316902,0.9959113641433341,-0.0003594013351471137,48.23515760044034,157.42802295864288,151.78649997711182,146.14497699558075,152.97857121058874,1.8874641309883697,151.0858930860247,3.2197270341192534,152.22111313225372,152.28753249993332,4.166596090992646,-1.420239425159327,37850200,1.736956314356178,0.9239989829961894,271725600.0,-27.972557429823503,47.13413368669027,45.7615501877868,34.96719516778596,29.728855256107025,24.242907030813885,-0.06963462310053428,2.966520197079496,154.07367932128906,152.15816003417967,150.61000061035156,149.06184118652345,147.14632189941406,0.02,0.0,149.82597991878208,-0.0014961018274318727,0.014071513189674707,153.32428414481026,151.1357149396624,2.9338574705972778
2024-01-19,0,154.41749954223633,145.26250076293945,155.12749481201172,150.39624881744385,153.54000186920166,-1.1436076408686184,2.8298086819581387,0.24197407588788833,2.995557285556886,153.0374984741211,2.316024265289303,0.01863975696354317,147.60250015258788,154.10549621582032,0.8014588652037271,-0.006704504005741863,1.017137547402543,1.0230677578989489,1.0054237256141172,-0.004576849968703334,52.25853868564571,157.47536729525174,151.81574993133546,146.15613256741918,153.6232136317662,1.3595261931421578,151.1491072518485,3.2795885535658735,152.41056771699942,152.38060133007235,3.4630296432920376,-0.47657408509559773,51033700,1.7387483543803584,1.2339921199973354,322759300.0,-13.948189878953098,47.13413368669027,45.7615501877868,79.37036818258187,32.598768605511694,22.301322495594626,-0.01949414189255874,2.970732604604998,154.07367932128906,152.15816003417967,150.61000061035156,149.06184118652345,147.14632189941406,0.02,0.0,149.98684084305194,0.0010310843514709234,0.01047291130616449,153.89142717633928,151.27571432931083,3.008952869993538
2024-01-22,1,155.65499877929688,145.26250076293945,155.12749481201172,150.39624881744385,153.54000186920166,-1.129045083747422,2.847330305891059,0.21323604420497855,2.9955551689110513,153.0374984741211,2.3306368827819823,0.018752592162998467,147.60250015258788,154.48124923706055,0.7938837234747305,0.00891851944606465,1.0251479093243843,1.0251403153700478,1.0144190720935904,0.0038696095088763816,57.26897420303397,157.53128571096423,151.83662509918213,146.14196448740003,153.99928501674108,1.5202606098547145,151.37517847333635,3.4819718096553456,152.9132976357497,152.51385784991263,3.010237730667287,0.5764240890344235,43687500,1.7562587606113826,1.0649032153800422,366446800.0,-18.2164655421059,47.13413368669027,45.7615501877868,91.57126782264608,33.288267095302224,20.46062803760667,0.0013067691018117749,2.984753353363826,154.07367932128906,152.15816003417967,150.61000061035156,149.06184118652345,147.14632189941406,0.02,0.0,150.13381308575873,0.0010348186985007501,-0.002577612549061562,154.0414276123047,151.47857121058874,3.0786355981317004
2024-01-23,1,155.25250244140625,145.26250076293945,155.65499877929688,150.39624881744385,153.5968770980835,-1.0356847661916049,2.957268823149791,0.06961769966243869,2.9955416187344004,153.16250038146973,2.4217244148254395,0.019459972792264774,147.60250015258788,155.06224632263184,0.7840050393773428,0.015345458000184187,1.0216215211111215,1.0155386538348856,1.0110053018808003,0.011697062563172711,60.36221710015003,157.88128779125807,151.9667501449585,146.05221249865892,154.01714324951172,1.5363711621464218,151.71035739353724,3.6205604367704765,153.6065670764081,152.76386182830282,1.720335055677666,2.0755440133731793,37986000,1.7752708183714707,0.924034156132241,328460800.0,-8.765200643846704,47.13413368669027,45.7615501877868,89.90726961289302,31.276056358125683,19.22382303034158,0.0017873417641514973,2.9300086438850776,154.07367932128906,152.15816003417967,150.61000061035156,149.06184118652345,147.14632189941406,0.02,0.0,150.25848517902963,0.018673286380046727,0.009054515583268266,154.16142926897322,151.91357203892298,3.183945186939884
2024-01-24,1,157.41499710083008,145.26250076293945,155.65499877929688,150.39624881744385,153.87937259674072,-0.9991119721188367,3.0309288072556546,-0.028560463651972956,2.9955322747669113,153.23999977111816,2.489974441528324,0.01993189591640386,147.60250015258788,155.13999557495117,0.8022225418893003,0.011005281789025094,1.0351874086860102,1.0247204724657675,1.0226966077828086,0.040313217863416684,58.62409966828106,158.12610779761678,152.06425018310546,146.00239256859413,154.35428619384766,1.9931228419231815,152.29267856052942,3.8452117408606097,154.0262344405532,152.92957458369358,0.08058379950376904,3.11670095570127,48547300,1.7787562242716366,1.1541779881856002,377008100.0,-11.341634569725109,47.13413368669027,45.7615501877868,129.5343198119111,35.33108030001387,17.947855439186103,-0.029086924711460155,2.896040043762889,155.0974365234375,152.98627777099608,151.27999877929688,149.57371978759767,147.46256103515626,0.04,0.0,150.4653946776816,0.03401218228835967,0.024222978364918574,154.48285784040178,152.5135716029576,3.3478627445293956
2024-01-25,1,156.93999862670898,145.26250076293945,157.41499710083008,150.39624881744385,154.57687377929688,-0.7789392217580835,3.235538843067876,-0.17596585438461965,2.995505186348702,153.23999977111816,2.6248117065429653,0.021250527086612337,147.60250015258788,155.29275207519532,0.7777261725340365,0.025538279398176735,1.0307580448107199,1.0166581865001012,1.0115926333965761,0.025969542323369454,64.11466680391631,158.72795253354786,152.25687484741212,145.78579716127638,154.85178593226843,2.159644036212291,153.11714254106795,3.4724327289304413,154.88713642130622,153.4026338008742,1.5220409943361506,5.461851634683865,43638600,1.837173033054835,1.0150683402030203,333369500.0,-5.436299993560309,47.13413368669027,45.7615501877868,110.09861385156432,31.724646506399097,21.090699376651102,0.008644192223588532,2.9777039423708733,155.2107155151367,153.16963613891602,151.5199966430664,149.8703571472168,147.8292777709961,0.04,0.0,150.63223064216652,0.027687296416938123,0.03981275472174059,155.1385716029576,153.45499965122767,3.5587674234764206
2024-01-26,1,159.04249954223633,145.26250076293945,157.41499710083008,150.39624881744385,155.07312107086182,-0.7030224026246334,3.3851109881274044,-0.3331609225715484,2.99548434261925,153.23999977111816,2.7453866958618165,0.022207770279170105,147.60250015258788,155.7834987640381,0.8100084551873714,0.021080037363682275,1.0433865556688415,1.0276702204358061,1.0199216361720431,0.029951268565483913,62.06298648771604,159.1993468084081,152.42912483215332,145.65890285589853,155.95571408952986,2.021015241722794,154.10142816816057,2.9948964426564753,155.40770824144843,153.80710748374136,2.2693567655911386,7.9385790659304085,51047400,1.84346271687398,1.1609218575650306,384416900.0,-10.981505142115076,47.13413368669027,45.7615501877868,148.1461001653489,34.9758992554654,19.4843020834754,0.026664873510519473,2.9771158503396538,157.2814794921875,155.15425842285157,153.43499755859375,151.71573669433593,149.588515625,0.06,0.0,150.88451708403167,0.024333712298246324,0.03661234604030945,156.19714137486048,154.44642748151506,3.8530917737579777
2024-01-29,1,160.19749450683594,145.26250076293945,159.04249954223633,150.39624881744385,155.15874671936035,-0.4790041552867683,3.6733773319725094,-0.44464192887929554,2.995441725832812,153.23999977111816,2.9529991149902344,0.02405676192368969,147.60250015258788,156.98749847412108,0.7952972616372103,0.03588815578281093,1.0491252702463676,1.0325213522351586,1.0212703936840262,0.029183102137181338,67.003487968285,160.04300462579806,152.69624996185303,145.349495297908,156.9885700770787,2.0857759696387603,154.9835706438337,2.8251373231447396,156.3095016240895,154.37963310120767,5.1068942115124365,9.486273957093088,45270400,1.89063903248203,1.008651443598735,429687300.0,-0.22934870101842023,47.13413368669027,45.7615501877868,153.29922976895412,34.28692935802642,18.277842549489684,0.08249218871582077,2.9325097925023607,158.20311645507812,156.29343841552733,154.75,153.20656158447267,151.29688354492188,0.08,0.0,151.1274161448906,0.041865846870686285,0.038109941473593964,157.3057120186942,155.31499808175224,4.294327705636457
2024-01-30,1,159.97999954223633,145.26250076293945,160.19749450683594,150.39624881744385,155.3531265258789,-0.29032367561404354,4.020088725647029,-0.5575409140405574,2.995386241329854,153.23999977111816,3.226498603820801,0.026270024638829926,147.60250015258788,157.5777473449707,0.8121538471772966,0.050544250400238015,1.0454193468125834,1.0277131804630393,1.014010953450695,0.030450376171001103,70.37550271368846,161.06967707745372,153.02949962615966,144.9893221748656,157.78321293422155,2.000867063306791,155.70321328299386,2.7129357152596607,157.26496096415553,154.99389813442724,4.726488822944059,8.353198175261534,45207400,1.8727169646728234,1.0012042382542476,384479900.0,-23.096426058724433,47.13413368669027,45.7615501877868,121.45014987006512,32.57028012085807,16.762543285135482,0.0637183678796665,2.9557648358803674,158.94047760009767,157.21475875854492,155.81999969482422,154.42524063110352,152.69952178955077,0.1,0.0,151.33969117245806,0.019100087462727178,0.027264512559665336,157.82856968470983,155.85999843052454,4.47321875401852
2024-01-31,1,156.50499725341797,145.26250076293945,160.19749450683594,150.39624881744385,155.9762487411499,-0.2885496128401135,4.292060431129438,-0.7214122167544041,2.995339695812861,153.9375,3.509598712921144,0.027978803972370358,147.60250015258788,159.13624954223633,0.8406568145299491,0.06256643289314996,1.0202145820434019,1.0011946637214948,0.9860756661935095,-0.0057808967644247256,71.57446686797876,161.98812038160702,153.40399951934813,144.81987865708925,157.9046412876674,1.87181462545671,155.95196315220423,2.605772002744531,157.91970668317146,155.499925422886,3.602247165308193,6.72092109929748,50284400,1.7978490001399419,1.1100241665199604,334195500.0,-55.24537362757944,47.13413368669027,45.7615501877868,50.564416092253985,29.191779469471335,24.112483123285383,0.030234451823622086,3.0494735136225115,158.94047760009767,157.21475875854492,155.81999969482422,154.42524063110352,152.69952178955077,0.1,0.0,151.473116951627,-0.010645746292640368,-0.0052557832442226724,157.88856942313058,155.96499851771765,4.404310039595108
2024-02-01,1,157.63249588012695,145.26250076293945,160.19749450683594,150.96250247955322,156.61374759674072,-0.46356193763232084,4.29066628634003,-0.6148195563475438,2.995340829079194,154.73624801635742,3.48737340927124,0.02791562397952967,147.60250015258788,159.13624954223633,0.8587181337707955,0.04852187557798685,1.0255771920444472,1.005070523056949,0.9943197818364563,0.004412496874458993,58.307866446575986,162.28258207676947,153.70124950408936,145.11991693140925,158.2446403503418,1.4862237985973692,156.13089179992676,2.6306893838470495,157.54365934070816,155.5568977582867,0.5460784946112177,2.2758079300631975,76542400,1.9697009836012356,1.6405650534163578,410737900.0,-20.727568467729963,47.13413368669027,45.7615501877868,80.76844236379902,27.813279532075324,21.50435322881946,0.13987851758385694,3.162797461232581,158.94047760009767,157.21475875854492,155.81999969482422,154.42524063110352,152.69952178955077,0.1,0.0,151.73646123413002,0.00969888291154919,0.015363063282490805,158.35428292410714,156.25785609654017,4.379080108880317
2024-02-02,0,170.20750045776367,145.26250076293945,160.19749450683594,152.55437755584717,157.05874824523926,-0.678435144770986,4.245266248326837,-0.32501093396296543,2.9953504088547955,155.09124565124512,3.3782983398437523,0.027545244971599884,147.60250015258788,159.13624954223633,0.7902243638835402,0.08414857708692383,1.1043847480615887,1.0820307988456503,1.0727036884747632,0.07020136722991022,64.69099978616441,162.6102817566024,154.11974925994872,145.62921676329503,160.07214082990373,4.695681971872181,157.2132135118757,4.5620535423334525,157.55196199836635,155.75809013006764,1.5329823360618196,1.614801470977709,117154900,1.7003064577308733,2.356678359043991,527892800.0,-3.0544601738110777,47.13413368669027,45.7615501877868,286.61848862558696,45.12032497240237,16.075544497740683,0.25642241609392885,3.9146160979096876,167.16876086425782,163.87062139892578,161.2050018310547,158.5393822631836,155.24124279785156,0.12000000000000001,0.0,152.79686864269965,0.07975114901216784,0.08912835219393819,160.48856898716517,157.4857134137835,5.316299400828733
2024-02-05,0,169.68999862670898,145.26250076293945,170.20750045776367,153.00874996185303,157.4693717956543,0.71101022533879,5.061655205886045,1.9242519656679349,2.9952051922729015,155.18999862670898,3.5332739448547357,0.032580117719777535,149.69925231933593,160.0017490386963,0.4698293330105546,0.17172360081789526,1.0922356237734485,1.0680202874230549,1.0546007180259198,0.05925500988074428,80.97382640412475,165.4835595496505,155.3602491378784,145.23693872610633,161.89356940133231,5.653409511356993,158.37267766680037,5.500378373597791,160.72403861295092,157.77147177100355,8.126610292880498,9.77234162732423,55081300,3.1470189913653477,1.0970250768277843,472811500.0,-9.694567491951815,47.13413368669027,45.7615501877868,221.77166153976344,41.60385581412253,14.822691011790926,0.3134534395437946,3.929173505767023,167.16876086425782,163.87062139892578,161.2050018310547,158.5393822631836,155.24124279785156,0.12000000000000001,0.0,153.22866560209587,0.05612057149967331,0.07032430106075054,162.28285435267858,158.71071297781808,5.663887639450119
2024-02-06,0,169.2249984741211,147.8474998474121,170.20750045776367,153.34875011444092,157.9849967956543,1.1454163330905205,5.412712508716402,1.274368211560116,2.995142197109088,155.45375061035156,3.845199203491211,0.034567993161461155,151.17400245666505,161.14674491882326,0.6052379197139927,0.14773668003746904,1.0807462211564856,1.0557674171405407,1.03944644869613,0.057788467047994896,78.84435035083992,167.40704904849966,156.5816240310669,145.75619901363413,163.34821210588728,6.090642956496074,159.65196309770857,5.806854037794404,162.98647105500626,159.44291758882864,8.124123940084022,10.577846061954467,42505500,3.157250121312397,0.8501589691566234,430306000.0,-16.199261556987317,47.13413368669027,45.7615501877868,177.92968324555665,39.46451800238839,13.95091799551646,0.27582496381996435,3.8646141283478643,167.61952172851562,164.60024279785156,162.16000366210938,159.7197645263672,156.70048559570313,0.12000000000000001,0.0,153.54009473897224,0.06383643960053065,0.0489271961950487,163.71571132114954,159.956426348005,5.966616325447067
2024-02-07,0,169.95750045776367,149.90500259399414,170.20750045776367,154.17749977111816,159.27687454223633,1.1482100474126422,5.686252077226816,0.3765693327804214,2.9950903183744737,156.07999801635742,4.243949737548826,0.03606872236149988,152.80225257873536,169.2714984893799,0.6872812132309516,0.128881595315759,1.078065097011183,1.051174068837927,1.0322225200988782,0.08595574224740554,76.82946629354247,169.023003116856,157.65049896240234,146.2779948079487,164.74249867030554,6.360333006276049,160.8655343736921,6.071735997342498,164.55920121304922,160.7765753588208,6.402376070039466,11.836232854472005,47174100,3.1692944166638672,0.9403750947245396,477480100.0,-9.969644576680455,47.13413368669027,45.7615501877868,158.81676105268247,38.27928169436823,13.412344733767886,0.2697698783327658,3.7220642944751816,167.83664129638672,164.95168209838866,162.62000274658203,160.2883233947754,157.40336419677735,0.12000000000000001,0.0,153.8918756586245,0.09877578693617561,0.07251571559306211,165.03999764578683,161.17285483224052,6.377212044590581
2024-02-08,0,169.9499969482422,151.31500244140625,170.20750045776367,154.89562225341797,160.03437328338623,1.0159454860294106,5.991801448647572,-0.3597518183346211,2.995027801311395,156.72249794006348,4.772812461853027,0.03776667803970521,153.0169994354248,169.71674880981445,0.7487582125531876,0.11067000914644863,1.071204857604531,1.043036366238202,1.015581804908891,0.0781406206844697,76.79743629724531,170.63672675288598,158.65312385559082,146.66952095829566,166.16678401402064,6.2310985507098176,161.9749984741211,6.220161221613807,165.91554471435546,162.02334918948233,6.092483519154699,11.106932894671314,42316500,3.1306030647438523,0.8453168032795891,435163600.0,-14.3010902647317,47.13413368669027,45.7615501877868,132.56669568940825,37.413399522135514,12.717383956359926,0.2396321800498766,3.6354807629921777,168.1103985595703,165.39479766845704,163.1999969482422,161.00519622802733,158.28959533691406,0.12000000000000001,0.0,154.19372125002536,0.06629832772177502,0.09432989482938423,166.58856855119978,162.2085691179548,6.69709421438706
2024-02-09,0,172.7324981689453,151.31500244140625,170.20750045776367,155.10937023162842,162.45437049865723,0.7809765868674781,6.32306132012907,-0.9190285507594131,2.9949541773125548,157.17749786376953,5.271099777221681,0.039643142265219575,153.40850067138672,169.95074729919435,0.7966516586328959,0.09555045128649073,1.0829657743376908,1.0517158715266317,1.0172343685934642,0.014834820465554177,76.16205092914342,172.14562138903744,159.4994987487793,146.85337610852116,168.48499843052454,4.9176414957199714,163.194819859096,6.551131303836963,166.9210247859652,163.1403429142753,6.232027400008636,10.05876759567487,56986000,3.1230283582409446,1.129428758099077,492149600.0,-2.6103600406707783,47.13413368669027,45.7615501877868,143.04437590329456,40.63702659572339,11.42709223311314,0.2793299822071054,3.747825686692057,170.02747827148437,166.95125720214844,164.46499633789062,161.9787354736328,158.90251440429688,0.14,0.0,154.6636393017842,0.015365807736235526,0.09524107411606221,169.33856855119978,163.61356898716517,7.362447750427523
2024-02-12,0,173.51749801635742,151.31500244140625,172.7324981689453,155.20312595367432,169.34124851226807,0.5978081604748623,6.856103620983892,-1.215106402699987,2.9948258263048895,157.52374649047852,5.948399963378904,0.0427491854008829,153.40850067138672,169.98250045776368,0.7949434684030569,0.11400794607449055,1.0819165087143336,1.04776195606036,1.018827318897665,0.02255583370041947,79.37458842088253,174.09195615859375,160.37974891662597,146.6675416746582,170.75428444998605,1.663370799046223,164.49946240016394,6.665486108518152,168.36687414015358,164.40016773811868,10.368679083934456,10.97137870519829,51050400,3.1469811851659744,1.001280766341539,543200000.0,-14.635333914202246,47.13413368669027,45.7615501877868,117.90230179372571,38.33742719768875,10.565730179857658,0.2647453684896029,3.755338547621045,170.47176025390624,167.4291207885742,164.97000122070312,162.51088165283204,159.4682421875,0.16,0.0,155.05999838035237,0.011919434022647168,0.003084795918911094,171.20428248814173,164.77928270612443,7.654588900258383
2024-02-13,0,168.26749801635742,151.31500244140625,173.51749801635742,155.55437469482422,169.75499820709229,0.4232630797904544,7.305228956410078,-1.416301061833342,2.994712739565207,158.33749771118164,6.61598731994629,0.04528889520425238,153.40850067138672,170.46000022888185,0.80632721814886,0.13072021568678482,1.0431773089408387,1.0079534661256726,0.9835804425342759,-0.005658150192922595,81.74013887190164,175.91333190574005,161.30287399291993,146.6924160800998,170.47714124407088,1.9126025038740764,165.2746410369873,6.40413918300347,169.64235877538482,165.27911500328827,10.077238229045337,11.76470284712129,56345100,3.090720207320088,1.0891493602986482,486854900.0,-32.389641008368905,47.13413368669027,45.7615501877868,62.68963396792961,33.66032607417091,19.99554171884603,0.2785400662257161,3.963321916258256,170.47176025390624,167.4291207885742,164.97000122070312,162.51088165283204,159.4682421875,0.16,0.0,155.3704461389053,-0.003015043010572316,-0.009805637912541004,170.75142560686385,165.61999729701452,7.541137437142245
2024-02-14,0,169.92000198364258,151.31500244140625,173.51749801635742,156.2924976348877,169.75499820709229,0.2382168713628289,7.222591995291166,-1.5298175146329922,2.994741979855152,159.51124954223633,6.720049819946292,0.04457196750943764,154.27249984741212,170.46000022888185,0.8181340888660926,0.1120344665197074,1.0486081468475885,1.01282424159697,0.9943529487821107,-0.00022063441754616164,65.13041952474819,176.48855786143196,162.04337387084962,147.59818988026728,170.50999886648995,1.898751489748739,166.20178413391113,6.033545816042653,169.295105455027,165.46394924736947,-1.1397866934117007,6.894197576725119,42815500,3.328696389106628,0.8213810973860952,529670400.0,-21.428587316521973,47.13413368669027,45.7615501877868,70.72426978250425,32.29235194124402,18.891972911929653,0.29070414619704116,3.887653045898964,170.53311895751952,167.52843869018554,165.0999984741211,162.67155825805665,159.66687799072267,0.16,0.0,155.62650012239823,0.0026388140002544525,0.010818811097176886,170.8471396309989,166.56499699183874,7.339151818301489
2024-02-15,0,169.7849998474121,152.96750259399414,173.51749801635742,156.83124828338623,169.92750072479248,0.11600021053355039,6.974785728284755,-1.676977556331082,2.9948176281667727,160.08874702453613,6.670487651824951,0.04279702177323831,155.16900215148925,170.46000022888185,0.8077889873012564,0.11082418881246762,1.0417943458495165,1.0039914916302177,0.9936065380867759,-0.0009708567448831751,67.03578436833972,176.9231953045309,162.97362384796142,149.02405239139193,170.5899990626744,1.8466700060959798,166.96910558428084,5.728396906611827,169.45266592745588,165.98703022190216,0.13554326053096658,8.270678903092955,49855200,3.3286964349627666,0.9455438709354389,479815200.0,-27.162273277621708,47.13413368669027,45.7615501877868,57.71373212657223,30.106007685999323,18.91782449510023,0.2728499894726208,3.865164455658261,170.53311895751952,167.52843869018554,165.0999984741211,162.67155825805665,159.66687799072267,0.16,0.0,155.90111577663416,-0.00023547625409303663,-0.004280746688351512,170.93999808175224,167.3278547014509,7.093541729430303
2024-02-16,1,168.95999908447266,154.41749954223633,173.51749801635742,157.2962474822998,169.92750072479248,-0.03121139865815688,6.72712304359395,-1.7416995806821942,2.994888427154958,164.23249626159668,6.510750389099121,0.04106549234983758,155.6147491455078,170.46000022888185,0.8080199438806168,0.09951916298821079,1.0314105309013553,0.9919844531420037,0.9889695007400149,-0.021840123453681914,66.04771884565164,177.26874479782023,163.81449871063234,150.36025262344444,170.44749886648995,1.9397526462078765,167.59499876839774,5.400950436371471,169.53509396551362,166.4254136932705,0.3309211867871013,6.754484075700115,48074600,3.333530453719665,0.9143390766477378,431740600.0,-28.571449755362632,47.13413368669027,45.7615501877868,47.38369969723899,28.236955071613902,18.54565279961583,0.25870086660388114,3.820272290683003,170.53311895751952,167.52843869018554,165.0999984741211,162.67155825805665,159.66687799072267,0.02,1.0,156.14673206197745,-0.02831758399440909,-0.0019430160042994856,170.7942831856864,167.9171404157366,6.874335789143445
2024-02-20,1,167.34000396728516,155.25250244140625,173.51749801635742,157.57812118530273,169.92750072479248,-0.19507240634463607,6.452449360330593,-1.7064928398501409,2.9949611596389043,168.61374855041504,6.225462951660157,0.03921469361804531,156.41999740600585,170.46000022888185,0.807123907038379,0.08547750094451469,1.0170071269313083,0.9831933806742301,0.9838321157491248,-0.035601562491927585,62.81188157442788,177.44652240840531,164.54162368774413,151.63672496708296,170.07464272635323,2.27345942167743,168.12071337018693,4.941356091884946,169.39243174051182,166.72022140628152,-0.5869122401802478,5.469813747469568,41980300,3.351337342833849,0.7997288789883407,389760300.0,-40.37899329073033,47.13413368669027,45.7615501877868,22.874188184981257,26.20465335077731,19.940873150703688,0.27357933715063015,3.816608493509663,170.53311895751952,167.52843869018554,165.0999984741211,162.67155825805665,159.66687799072267,0.04,0.0,156.3239821321062,-0.030521031789528252,-0.04224703494477053,170.3999982561384,168.49428340366907,6.465779129546469
2024-02-21,1,168.7249984741211,155.25250244140625,173.51749801635742,158.68999862670898,169.92750072479248,-0.3561561301395715,6.14293870051597,-1.5611203618402814,2.995037006571735,168.61374855041504,5.80420066833496,0.03720155148115862,156.8964984893799,170.46000022888185,0.7829886336019157,0.07785704794317787,1.0217962481647764,0.9927014539655755,0.999233055054688,0.0027188878610366896,58.05889539880004,177.4117513481755,165.12587394714356,152.83999654611162,169.50214276994978,1.9779938113054996,168.99357060023718,3.6394735831654303,168.88980132950746,166.71195906404688,-1.5357417051039415,4.600577851049257,44575600,3.3832970664618296,0.8438729260906946,434335900.0,-34.395556814471846,47.13413368669027,45.7615501877868,35.397833234116405,27.54575561362789,18.727998290900032,0.23931498992192166,3.768106443748657,170.72427838134766,167.83785775756837,165.50499725341797,163.17213674926757,160.28571612548828,0.04,0.0,156.53083286369295,-0.0002965076609273698,-0.021759313448328804,169.56285531180245,169.4507119315011,6.101896565685707
2024-02-22,0,173.56250381469727,156.50499725341797,173.51749801635742,159.74562454223633,169.92750072479248,-0.5220289578462313,5.749385804452275,-1.3898968199705495,2.9951272098295765,168.84249877929688,5.288400878906254,0.0346767381556671,157.36749725341798,170.46000022888185,0.7721423238682168,0.07184830912931724,1.0468216437594937,1.021463635330768,1.0273253177048565,0.021436568906145315,59.89744749268738,177.29827035768383,165.79949874877929,154.30072713987474,169.5085721697126,1.993235301545268,170.13142830984933,1.8784206355545496,168.85829442073327,166.94997508031025,-2.320061214482398,7.808058167571546,55392400,3.369261663817014,1.0418979439442189,489728300.0,-8.393762392832633,47.13413368669027,45.7615501877868,95.6362302668956,32.81172773377889,16.586168577204493,0.3104183982261918,3.9455400534555922,173.11260083007812,171.7037017211914,170.56500244140625,169.4263031616211,168.01740405273438,0.02,1.0,156.88181047369693,0.02105513038643614,0.03522297475631314,169.88285609654017,170.54356929234095,5.979494774570738
2024-02-23,0,174.68000030517578,156.50499725341797,173.56250381469727,160.14312076568604,169.95187282562256,-0.6889753888927885,5.64816794936213,-1.06479064314628,2.9951529367065763,169.09249877929688,4.934375915527346,0.03390116992710882,157.56324615478516,172.8109981536865,0.696393249734246,0.10591630771914232,1.048456141231063,1.0258638943677536,1.029500598127405,0.028830582573035723,68.6905798434875,177.9032099831969,166.60687408447265,155.3105381857484,170.4246439252581,2.6822569315451856,170.45089258466447,2.23821614061835,170.00671197411458,167.9472342713469,0.02593732554603863,10.105789320676893,59715200,3.4872120665136084,1.1064777696269674,549443500.0,-7.592356882083489,47.13413368669027,45.7615501877868,109.24612511028039,33.34031317722283,15.93816268491952,0.2951873210741524,3.8079760376046474,173.38764129638673,171.92618209838867,170.74500274658203,169.5638233947754,168.10236419677733,0.04,0.0,157.26809101145426,0.030565384853522337,0.02345309314438779,170.78999982561385,170.77071271623885,5.822345308678366
2024-02-26,0,175.26499557495117,156.50499725341797,174.68000030517578,165.55437660217285,170.02000045776367,-0.8179509879012049,5.44989690987785,-0.6487534989022556,2.9951979946818796,169.45749855041504,4.426575431823733,0.032537887949254794,158.9014991760254,173.5219985961914,0.6923633710282533,0.09832278043886414,1.0463964514830089,1.026448151395705,1.0270225598378484,0.037316504052099964,69.55590633445485,178.39366798815166,167.493874168396,156.59408034864032,171.18821443830217,3.2212853176345835,170.84910665239607,2.5645742662297453,171.16118271959962,168.97535125834182,3.810897745799367,2.6276749469815184,44368600,3.475879550816706,0.8272354566877208,593812100.0,-15.42804318399419,47.13413368669027,45.7615501877868,113.03146978411094,33.176079009047946,15.276598039556433,0.28069504058568845,3.6848903868310745,173.86131756591797,172.30933908081056,171.05500030517578,169.800661529541,168.2486830444336,0.06,0.0,157.54932307925642,0.030794651583170296,0.029034114176538076,171.32571411132812,171.0864268711635,5.637632687154027
2024-02-27,0,173.77499771118164,156.50499725341797,175.26499557495117,168.03562450408936,170.83874988555908,-0.9772279140590151,5.337760075785886,-0.07954047348755555,2.9952239094997735,169.73749923706055,3.9907504653930688,0.031714804126146745,159.7452491760254,173.67425346374512,0.6879751700072468,0.09405578479551235,1.0325005126088018,1.0162146860887438,1.010822224299357,0.038454604944042625,70.00359751899715,178.98051912160352,168.30499897003173,157.62947881845994,171.7582141331264,3.284007042565347,171.1741065979004,2.6303830779821666,172.17815059019358,169.9366720820665,3.145594120121969,3.285401021486419,31141700,3.4753446632792664,0.5883746056343523,562670400.0,-26.622808969248414,47.13413368669027,45.7615501877868,87.20184136148227,31.911842053223378,17.547371229285126,0.23606306807027663,3.553468706387676,173.86131756591797,172.30933908081056,171.05500030517578,169.800661529541,168.2486830444336,0.06,0.0,157.7256603473254,0.038664061433338004,0.023774402158536764,171.85999843052454,171.3999982561384,5.461719248042135
2024-02-28,0,172.9800033569336,156.50499725341797,175.26499557495117,168.61062335968018,172.92874813079834,-1.246451966838477,5.122526136962679,0.7494362610111027,2.9952667526730514,169.85250091552734,3.5477126693725554,0.030313698057451027,159.7452491760254,173.86549797058106,0.6688023076921719,0.08622951749229937,1.0236479915450656,1.011413356177919,0.9987211668481768,0.025218580063967933,65.10575556385994,179.2289264041744,168.98387413024903,158.73882185632368,172.33250045776367,3.056750494232774,171.38999966212683,2.646833986420052,172.57123215238158,170.60118658834253,2.350029665374086,2.688727598219692,28180500,3.5062966813179095,0.5411312976685874,534489900.0,-30.197503183104214,47.13413368669027,45.7615501877868,74.16924833375295,30.712129321206547,18.133790992600378,0.26966232174254134,3.4251730262804125,173.86131756591797,172.30933908081056,171.05500030517578,169.800661529541,168.2486830444336,0.06,0.0,157.87690807143568,0.027107227139737677,0.03638976397188796,172.38142830984933,171.58785574776786,4.962480097328333
2024-02-29,0,174.95999908447266,156.50499725341797,175.26499557495117,168.90124893188477,173.11437702178955,-1.6060662619986144,4.750025087922749,2.2172336508331494,2.9953340717587387,169.93499946594238,3.0782129096984847,0.028001630611434816,166.36925315856934,173.86549797058106,0.5393683306163248,0.10526824314011367,1.0313977664237661,1.0201793807504798,1.0052139379272873,0.008051827088570995,65.29428397589705,179.1339244968294,169.6338743209839,160.1338241451384,173.42107118879045,2.2265880353406726,171.74785695757186,2.7728479419126093,172.67633309860162,171.15554248178768,2.379263905210552,1.7783874739444332,53805400,3.3863107595561597,1.0297081166155628,588295300.0,-4.007028615556793,47.13413368669027,45.7615501877868,121.08066324429352,34.49379900455977,16.494313120406733,0.34858034563356305,3.4934606333692275,174.5107222290039,172.8346428527832,171.4800033569336,170.125363861084,168.44928448486328,0.08,0.0,158.20260352651712,0.012487069841429443,0.04846075298899039,173.76428440638952,172.08214133126395,3.8011510967813806
2024-03-01,0,177.44250106811523,157.63249588012695,175.26499557495117,169.15874862670898,173.52874946594238,-1.671172519251089,3.809367427996995,4.013103618465183,2.9954795941659214,169.95374870300293,2.7019500732421875,0.022334913352782038,168.17474861145018,174.70800018310547,0.27430176500005615,0.10992342097737613,1.0403729651621345,1.03162295446269,1.017842403435568,0.015814636810815186,68.34931393130474,178.17535926853063,170.55662441253662,162.93788955654261,174.66642870221818,1.4724445464284102,172.08428573608398,3.160182406189339,173.2633281758513,171.99853670688813,4.553600416238309,2.947927170458409,31956200,3.3951000334915,0.6388205602338889,620251500.0,-3.9260576615858813,47.13413368669027,45.7615501877868,157.79527007069026,35.73996962633905,15.57146566108002,0.325042203570335,3.433271890149279,175.66435803222657,173.7678194580078,172.23500061035156,170.70218176269532,168.80564318847655,0.1,0.0,158.41270398009715,0.018458172616408364,0.02085003638143476,175.13999938964844,172.35142735072546,3.0019953079631505
2024-03-04,0,178.18500137329102,167.34000396728516,177.44250106811523,169.573748588562,173.61562728881836,0.40871399326389857,2.7475988403138434,-0.9783586246526852,2.995604276985546,170.08250045776367,2.499087505340577,0.016016583463979984,168.67924842834472,174.9904987335205,0.6046264159673024,0.04250694353006435,1.038694188049197,1.0313482228958726,1.0188724674070884,0.016660519054366052,67.26854499918943,177.04232235256376,171.54712467193605,166.05192699130833,175.32678549630302,1.8760669617453658,172.4176788330078,3.5457049572656643,174.3321438206813,172.94842256879312,5.166692945818117,2.726761292228395,37381500,2.0530679742746334,0.81202204927199,657633000.0,-17.777768358768192,47.13413368669027,45.7615501877868,149.89433937624275,36.72913248211221,14.689689954756775,0.22208157813718446,3.376752314207428,176.7416008300781,174.6392017211914,172.94000244140625,171.2408031616211,169.1384040527344,0.12000000000000001,0.0,158.66189090609845,0.016310914972834434,0.014800824370462703,175.56857081821985,172.72571345738,3.25442584470047
2024-03-05,0,175.31999588012695,167.34000396728516,178.18500137329102,169.573748588562,174.00124835968018,0.4022894544467204,3.082781015335114,-0.9602508100142382,2.995571922106429,171.3449993133545,2.764000129699707,0.017928774268643553,168.67924842834472,175.48274612426758,0.6655459868474032,0.05006189413242725,1.0196224173167956,1.009375792152578,0.9991536678193932,0.008890796658292288,69.22697202668179,178.11156174838263,171.9459997177124,165.78043768704217,175.41821343558175,1.8547670567385686,172.92142868041992,3.4090722410387846,175.30354385498504,173.52501094712727,2.6633042604230495,2.6899323758653955,37228300,2.0433077315609567,0.824685334839086,620404700.0,-41.80560294494754,47.13413368669027,45.7615501877868,58.953855332755246,33.435881228558515,22.150348177224878,0.1531348554809262,3.441881054516987,176.7416008300781,174.6392017211914,172.94000244140625,171.2408031616211,169.1384040527344,0.12000000000000001,0.0,158.85957004813153,0.0033421796329009545,-0.003491104133618546,175.44428362165178,173.1171417236328,3.247069644341027
2024-03-06,0,174.69249725341797,167.34000396728516,178.18500137329102,169.64499950408936,174.75,0.1985219892645172,3.120739027040844,-1.1235484488534337,2.9955682888984705,172.85625076293945,2.791749897003174,0.018119864914977236,168.67924842834472,175.5322463989258,0.7184114732448647,0.03601712194394224,1.0143124511418933,1.0011633799712985,0.9938274073858824,0.009899952961330172,58.826057059957684,178.46897763446498,172.2274995803833,165.9860215263016,175.33642796107702,1.8751591588420062,173.26232119968958,3.3233934212175034,175.31174649460755,173.66108798659212,0.3663817116058299,4.191241889793805,32090900,2.1662726422897594,0.7191769923602194,588313800.0,-46.04172009011167,47.13413368669027,45.7615501877868,45.604774989773006,31.18451637714392,20.743066027093786,0.12551571276589768,3.4244528519507815,176.7416008300781,174.6392017211914,172.94000244140625,171.2408031616211,169.1384040527344,0.12000000000000001,0.0,159.02221544708252,0.0020211991067493607,-0.0001728637804394345,175.2699977329799,173.297855922154,3.160509677096216
2024-03-07,0,175.84000396728516,167.34000396728516,178.18500137329102,169.88625144958496,174.75937271118164,0.01056151023326346,3.0850183547897787,-1.1105202686831777,2.995572347506435,173.2487506866455,2.710199737548828,0.017884073709108966,168.67924842834472,175.5322463989258,0.731420774515263,0.027859887224165176,1.0193571740273264,1.004305046381538,0.9984102034618573,0.005029749013587992,56.28822356940509,178.6709112289277,172.50087451934814,166.33083780976858,175.63142885480607,1.7466003599167417,173.69482149396623,3.2286954190646355,175.16314076836966,173.77101492327992,-0.32664726898553864,2.808671853849682,34063300,2.173941380089829,0.774761771325947,622377100.0,-23.055510226571922,47.13413368669027,45.7615501877868,82.3814404836608,31.45797659669643,18.831336775754494,0.1106061888163881,3.5004648653746875,176.7416008300781,174.6392017211914,172.94000244140625,171.2408031616211,169.1384040527344,0.12000000000000001,0.0,159.21057436550103,0.0003395158364325468,0.021136541838213483,175.7385711669922,173.79928479875838,3.250388022607698
2024-03-08,0,176.22750091552734,167.34000396728516,178.18500137329102,169.88625144958496,175.03624820709229,-0.18502115231802,3.108839063571476,-1.1073897878780303,2.995570230595252,173.54000091552734,2.6680001068115247,0.01799148742187009,168.67924842834472,176.00025367736816,0.716351328370168,0.03465729405594961,1.0198645865144553,1.005210658363496,0.9996114546390418,-0.006847289376976762,59.1849914856741,179.01267782196717,172.7949996948242,166.57732156768125,176.09535707746232,1.2988659068544253,174.213928767613,2.983821403185104,175.33865223827306,174.03633157904602,1.1883218433618439,3.5662774245750533,37853500,2.182046632312847,0.8653611171247704,660230600.0,-33.263856363871405,47.13413368669027,45.7615501877868,76.90254066776596,30.242126990354144,17.137964995587232,0.09964351598013865,3.5695212969188903,176.7416008300781,174.6392017211914,172.94000244140625,171.2408031616211,169.1384040527344,0.12000000000000001,0.0,159.4148567782753,-0.016103664558016484,-0.00797685249569174,176.05142865862166,174.21642848423548,3.2050379203318475
2024-03-11,0,173.0525016784668,167.34000396728516,178.18500137329102,169.88625144958496,175.27874565124512,-0.3809210943975899,3.1226213160009055,-1.009601356696434,2.995569189821368,173.66875076293945,2.61609962463379,0.01803848195494092,168.67924842834472,176.34900093078613,0.757540904900525,0.020233614309008933,0.9996743482114567,0.9862297534728184,0.9829568470770543,-0.02880433064100507,58.428601100313244,179.35411752519028,173.10887489318847,166.86363226118667,175.82285744803292,1.7113569048472133,174.6219643184117,2.2788094180986147,175.57046276001344,174.2784242238231,1.8773832209337737,4.301315027482483,28484800,2.103331577040974,0.6731138913865157,631745800.0,-62.923020582932686,47.13413368669027,45.7615501877868,-12.366918951941987,27.89228734239547,21.533759614097004,0.029763499963529023,3.5918544994142656,177.07199938964843,175.17399938964843,173.63999938964844,172.10599938964845,170.20799938964845,0.02,1.0,159.53368735201516,-0.03164768025249953,-0.035125095185493345,175.36571611676897,174.56500026157923,3.2038211332503255
2024-03-12,0,174.40749740600586,167.34000396728516,178.18500137329102,169.88625144958496,175.27874565124512,-0.3966325345366806,3.121471416266256,-0.9987027163972817,2.9955693247688457,173.66875076293945,2.5968994140625,0.01803017281617227,168.67924842834472,176.34900093078613,0.7579875233988083,-0.002679823897914837,1.0074086542262202,0.9952067628823298,0.9964633782131572,-0.005204759842368456,47.479366760917756,179.3678179011971,173.12487506866455,166.881932236132,175.38928549630302,1.6143399510746945,175.02785709926061,1.5310616057129502,174.93538742071985,173.93578101190798,-1.0902477229008776,3.4137071684893887,36610600,2.226065482446443,0.8801479759091989,668356400.0,-54.78663210119026,47.13413368669027,45.7615501877868,37.48604534908549,29.751184534971582,19.513725810709104,0.08492397469224265,3.6787124009146774,178.09387982177734,176.82806008911132,175.80500030517578,174.78194052124024,173.51612078857423,0.02,0.0,159.7070347644969,0.00729384509576958,-0.012332483493776317,174.961430140904,175.05071476527624,3.23750224163159
2024-03-13,0,176.40749740600586,167.34000396728516,178.18500137329102,169.88625144958496,175.27874565124512,-0.43152304847288037,3.1330738770962485,-1.0034856279908706,2.9955681596394275,174.09124755859375,2.6324993896484385,0.018092540187351677,168.67924842834472,176.34900093078613,0.7606031805459239,0.036489514980793045,1.0186991629850577,1.0062560179931959,1.0089422408528863,0.009817251339077293,55.4974451662212,179.4355227923394,173.16937503814697,166.90322728395452,175.13535635811942,1.183633462655183,175.23107092721122,1.510271254687997,174.77945189465183,173.79526008834944,-1.710415285988514,3.3679057539042403,30772600,1.8701630598342505,0.7632597739905179,699129000.0,-41.291840682016975,47.13413368669027,45.7615501877868,79.41823934573678,30.146312812068455,18.638926843557837,0.0789013808266474,3.574606410406709,178.09387982177734,176.82806008911132,175.80500030517578,174.78194052124024,173.51612078857423,0.02,0.0,159.86745694521733,0.017578255710437807,0.014013338558642055,174.81571524483817,175.192143031529,3.1243452887034753
2024-03-14,0,178.11000061035156,167.34000396728516,178.18500137329102,172.21500301361084,175.4499979019165,-0.6215875996177403,2.995555850056582,-0.6743723447858643,2.995582806897785,174.54374885559082,2.4285987854003905,0.017257854647125308,168.9364990234375,176.5109977722168,0.7462197068601443,0.03817970425275656,1.026118909341913,1.0139849249381783,1.0166850298886942,0.012909443766213391,59.69981616188874,179.56748670774255,173.5763750076294,167.58526330751624,175.53392846243722,1.638511909293033,175.47607094900948,1.6824011585103198,175.17751188515516,174.19304180658204,-0.997560935873245,1.6391752416443763,43705800,1.8847165161360762,1.082849274748308,742834800.0,-16.03229161716799,47.13413368669027,45.7615501877868,115.14947562001741,32.151429949704095,17.480862594173455,0.06064264542274241,3.5376421666885904,178.09387982177734,176.82806008911132,175.80500030517578,174.78194052124024,173.51612078857423,0.02,0.0,160.11242694573863,0.010915012984036299,0.03020002108845446,175.4771445138114,175.46071406773157,3.253765901266148
2024-03-15,0,175.72249603271484,167.34000396728516,178.18500137329102,173.0343770980835,175.9368782043457,-0.7544617023179138,3.0273585066523663,-0.3273878306781861,2.9955802099908495,174.68624877929688,2.3706991577148413,0.017400024615299256,168.9364990234375,177.50925102233887,0.7074649792906885,0.049032604590636596,1.0099813912730513,0.9986020013611195,1.0004639943386078,-0.002865641742570979,63.76532385568875,180.0405919522696,173.98587493896486,167.9311579256601,175.68107114519393,1.5960535771498727,175.50874955313546,1.6824290952721608,175.90002603470856,174.75969110220015,1.5913785054685052,1.9635907368807979,72115500,1.904823982696718,1.7387760032491968,670719300.0,-65.97465315726764,47.13413368669027,45.7615501877868,33.456850160864754,29.06865015003371,20.88556833204564,-0.019590089500288885,3.6318711814154705,178.09387982177734,176.82806008911132,175.80500030517578,174.78194052124024,173.51612078857423,0.02,0.0,160.44170473383312,-0.005303723422862561,-0.01357317642721708,175.60714503696985,175.4385713849749,3.0963481470360446
2024-03-18,0,175.3125,167.34000396728516,178.18500137329102,173.43500328063965,175.9368782043457,-1.013077131612725,2.8888042404852725,0.35933955540499474,2.9955941113756483,174.8262481689453,2.158424015045168,0.016575388239274732,168.9364990234375,177.50925102233887,0.6764288905989388,0.040024248253346835,1.005908503585453,0.9972468208731241,0.998704006901625,0.013059610809512012,56.15229046008802,180.06035822920052,174.28274974822997,168.50514126725943,175.60571343558175,1.5997476719336718,175.61857114519393,1.6091361054571167,175.85382144415746,174.92569826308025,0.5896067635936909,0.26103356021711943,31250700,1.9894330948878913,0.7690838656710063,639468600.0,-65.2826396478686,47.13413368669027,45.7615501877868,18.96717286848252,27.64993120793365,19.866231305514876,-0.0780960603092981,3.5441725575934067,178.09387982177734,176.82806008911132,175.80500030517578,174.78194052124024,173.51612078857423,0.02,0.0,160.57757169071277,0.014654506369408349,-0.004961564560556462,175.27285766601562,175.5057144165039,2.885555021037535
2024-03-19,0,174.93249893188477,167.34000396728516,178.18500137329102,173.72187423706055,175.9368782043457,-1.2973967240737068,2.6231164323692964,1.6351563935375424,2.9956186668001483,175.1124973297119,1.8360117149353044,0.01502354411016615,172.55450286865235,177.50925102233887,0.5335902333717049,0.04764249936478704,1.001902196019168,0.9967138473555454,0.9939798435757352,0.0030102004425689444,56.107027784734186,179.84660765874494,174.60037479400634,169.35414192926774,175.42071315220423,1.5907114784987424,175.7580351148333,1.4384152444633185,175.72487796266336,175.05414765207658,-0.2999908754456681,0.8847661108151624,26880900,1.9440105536819847,0.6740666069856841,612587700.0,-48.904341276001105,47.13413368669027,45.7615501877868,7.195141464713812,26.18242440282453,20.38135298793658,-0.04571507641368741,3.47427564599022,178.09387982177734,176.82806008911132,175.80500030517578,174.78194052124024,173.51612078857423,0.02,0.0,160.6926056173454,0.002907774152521192,0.022912229755684577,175.35142735072546,175.70142800467355,2.3021242888929985
2024-03-20,0,176.86499786376953,168.7249984741211,178.18500137329102,174.2493724822998,175.9368782043457,-1.0827923181478305,2.0264478684066893,2.374291207805234,2.995664924972848,175.1124973297119,1.403249740600586,0.011581025681266786,173.04525184631348,177.50925102233887,0.31508951342952296,0.03679063869552071,1.010772650168388,1.007947195957221,1.00436122860526,0.002593429783263268,53.822067483413804,179.0328952790497,174.97999954223633,170.92710380542295,175.96535546439034,1.263808005798426,175.89410645621163,1.447193269855982,175.5370391225826,175.2764550822678,-0.7348467049211137,1.1287406272748866,29947200,1.9378202403112188,0.7649880144929609,642534900.0,-22.95277870175309,47.13413368669027,45.7615501877868,89.34790857764018,29.092151517919458,18.758474443259832,-0.012291998737154341,3.5040940267173655,178.09387982177734,176.82806008911132,175.80500030517578,174.78194052124024,173.51612078857423,0.02,0.0,160.83550466905558,0.009005416628208529,0.015736327706486287,176.23571123395647,175.80071367536272,1.8570553440256266
2024-03-21,0,179.42749786376953,172.9800033569336,178.18500137329102,174.6118745803833,176.27250003814697,0.2683336270800863,1.470459453271098,-0.6139636483872435,2.9956971524930567,175.2887477874756,1.1704003143310557,0.008384084666280222,173.51150360107422,177.50925102233887,0.31527130685025145,0.019027693058623705,1.0230376160336834,1.0212863355220367,1.0183837151695458,0.007397098696890314,56.06019078950254,178.32791841826094,175.38699951171876,172.44608060517658,176.68249838692802,1.6094882477154626,176.03589194161552,1.6877995213328623,175.8747305522794,175.6723764404118,2.2030864323397004,1.0888196097767011,32824300,1.6722963082363715,0.8633685241869993,675359200.0,-32.86437462715636,47.13413368669027,45.7615501877868,169.34618737710952,33.07842149311399,17.497212356851673,-0.11809507461176794,3.487308603646416,179.07179888916016,177.6190993347168,176.44499969482422,175.27090005493164,173.81820050048827,0.02,1.0,161.00946567441912,-0.003356677502185268,0.009005416628208572,176.62999616350447,175.79571315220423,1.9389495190656552
2024-03-22,0,178.15749740600586,172.9800033569336,179.42749786376953,174.68937301635742,176.52187252044678,0.45134497757721914,1.6510898627721515,-0.2911901172041733,2.995688170537759,175.31624794006348,1.3105254173278809,0.009398266852179283,173.70274810791017,178.1175006866455,0.32074219404959425,0.027178254810508385,1.014100891835675,1.0119911418215985,1.0096655140523836,0.013857083915070678,62.10423509100593,178.98242893971667,175.68024921417236,172.37806948862806,176.93249838692802,1.6933798099253752,176.03392737252372,1.6851194497382316,176.75771273587677,176.18122153265386,2.8783168914335926,1.1186704333548094,27964100,1.744771244531989,0.7675840458155235,647395100.0,-25.628179234852006,47.13413368669027,45.7615501877868,107.68447348835083,31.336732262627145,19.51275882499122,-0.11797778929963032,3.417249595821764,179.07179888916016,177.6190993347168,176.44499969482422,175.27090005493164,173.81820050048827,0.02,0.0,161.14753307609539,0.025513111999530436,0.0006713013548951049,176.95999581473214,175.88785552978516,2.062057319533835
2024-03-25,0,178.9875030517578,172.9800033569336,179.42749786376953,174.87249851226807,177.00937366485596,0.2554792230727807,1.7183359118440527,-0.6456766247966019,2.995684571649399,175.5212459564209,1.3989501953125,0.009771371134678299,173.70274810791017,178.16024780273438,0.4416100206040332,0.016503591156727723,1.0178180580019305,1.0155924441168906,1.011577462611659,0.02096258425245101,57.020102277228375,179.29079589290197,175.85412406921387,172.41745224552577,177.0578558785575,1.8226236704875367,176.29589217049735,1.8432477946102712,177.10987130677714,176.38588382866863,0.9920213288737583,-0.015435624251861946,29815500,1.7749261274741637,0.8350823367853132,677210600.0,-17.185849040689604,47.13413368669027,45.7615501877868,132.12912899742867,32.492374227469696,17.98880637335632,-0.07267855032110794,3.4410967714534326,179.07179888916016,177.6190993347168,176.44499969482422,175.27090005493164,173.81820050048827,0.02,0.0,161.30094636044134,0.029974845910101244,0.03032914000949541,177.0971396309989,176.28714207240515,2.2181500225502275
2024-03-26,0,179.21249771118164,172.9800033569336,179.42749786376953,174.87249851226807,177.60937595367432,0.15120072865927547,1.8416257014986848,-0.9196335997800174,2.9956775799920137,175.78125,1.544775257110595,0.010461389979422956,173.70274810791017,178.2652515411377,0.46497199537254946,0.029995715202019366,1.0180200168891127,1.0134561935386703,1.0086591099215434,0.0244665731378102,60.57947879448715,179.7235008460516,176.0402494430542,172.3569980400568,177.55642754690987,1.8731000068935555,176.61874934605189,1.9343993235607262,177.58164650164713,176.7326909325213,0.49267443624681595,2.091893256795691,29659000,1.7371489438472487,0.8324274836069968,706869600.0,-31.35674446351155,47.13413368669027,45.7615501877868,102.47110163096235,30.76719557065776,17.03369288735565,-0.09286440807840392,3.3736673911622583,179.07179888916016,177.6190993347168,176.44499969482422,175.27090005493164,173.81820050048827,0.02,0.0,161.4475614906593,0.013644168496593778,0.021893669290225796,177.65142604282923,176.62928553989954,2.187556989777025
2024-03-27,0,179.25500106811523,172.9800033569336,179.42749786376953,174.95312404632568,178.12187480926514,0.0289109767597919,1.8879244932173054,-0.9629005735550198,2.9956749481670144,176.03375244140625,1.5985874366760242,0.010707854035455587,174.27199783325196,179.0100025177002,0.45500692629245665,0.03603014356166752,1.0166912890100848,1.0109495463951685,1.0040609549867001,0.013513149765147947,61.97866057569433,180.08797342948878,176.3121244430542,172.5362754566196,178.11964198521204,1.6673576631665998,176.8626777103969,2.0410230047884044,177.99337682111548,177.12095721366114,1.9860870163243365,2.587403883297132,33272600,1.7189384733377255,0.9272231307791033,740142200.0,-15.97986759354254,47.13413368669027,45.7615501877868,97.57720083337934,28.983963937483157,17.425383765988542,-0.05170406628710177,3.3246937788344515,179.07179888916016,177.6190993347168,176.44499969482422,175.27090005493164,173.81820050048827,0.02,0.0,161.61051747235854,0.009430300264542835,0.022342285792704964,178.41571262904577,176.84428514753068,2.190804778804271
2024-03-28,0,180.37749862670898,173.0525016784668,179.42749786376953,175.22437477111816,178.16437339782715,0.02299263070900144,1.828577178105845,-1.0944559791934545,2.995678685462272,176.3174991607666,1.6009629058837902,0.010352827325308908,174.66399726867675,179.216748046875,0.5218348177203976,0.02454847968745646,1.0212405136696778,1.0156490820577266,1.0076504916594733,0.005294621918323417,60.71200629662973,180.28302868482496,176.6258743286133,172.96871997240163,178.89749908447266,1.1094363106709113,177.15910611833846,2.233923989435815,178.3162642878064,177.5033579732592,2.2488419639872994,1.9421047678464762,38051600,1.674816358218539,1.0842009781902413,778193800.0,-12.903153633547273,47.13413368669027,45.7615501877868,133.5148756808492,31.16413628058407,16.491684259981188,-0.11782329835930186,3.2613328669885604,179.28571795654298,177.79213858032227,176.58499908447266,175.37785958862304,173.88428021240233,0.04,0.0,161.80788846300607,0.012517603495534768,0.012517603495534737,179.0557141985212,177.20357077462333,2.3452083838868334
2024-04-01,0,181.17749786376953,173.0525016784668,180.37749862670898,175.31812191009521,178.38562679290771,-0.016596173863117448,1.958391807150776,-1.0104348629855675,2.995670985795267,176.6362476348877,1.7084255027771007,0.011070818513268148,174.66399726867675,179.27225074768066,0.5973147216513658,0.01654055562182978,1.0241991363597425,1.018852799267561,1.0110464307399367,0.01695129591364508,62.289651293007445,180.81353292002666,176.8967493057251,172.97996569142356,179.51357051304407,0.9828206644086077,177.7394629887172,2.13835464989992,178.84317150666155,177.88169353062062,3.1126290015124023,2.354909244937256,29174500,1.6044328224310334,0.8345738923076571,807368300.0,-18.421034412571466,47.13413368669027,45.7615501877868,144.2333279294223,31.935063985857735,15.382160010206292,-0.160290962039626,3.2462004735833805,180.39927899169922,178.7903583679199,177.48999786376953,176.18963735961916,174.58071673583984,0.06,0.0,161.9632895355393,0.01174040454431613,0.015829398938162972,179.4585723876953,177.8471418108259,2.50652493206609
2024-04-02,0,179.73250198364258,173.0525016784668,181.17749786376953,175.31812191009521,179.04375171661377,0.11267503412460932,2.1683567808847304,-1.0002466619621375,2.995657336397621,176.6362476348877,1.9138503265380848,0.012244826826597844,174.66399726867675,179.5224979400635,0.6414856691914511,0.016794323132783468,1.0149590608437102,1.0076358083443542,0.9996134765976251,0.0041622957982119235,64.15031061033048,181.42021270727727,177.0834991455078,172.74678558373833,179.55714253016882,0.9851270301728009,178.11982045854842,1.9668031937182167,179.42485888316023,178.18157817802003,2.4383004280596596,4.695104726309623,32611500,1.6055929039764056,0.9393021545062251,774756800.0,-24.367073836154653,47.13413368669027,45.7615501877868,91.62771189500201,30.084122477816337,18.00398166814703,-0.06814612342759849,3.1992209133220464,180.7627210083008,179.37864163208008,178.26000213623047,177.14136264038086,175.75728326416015,0.06,0.0,162.12214214055862,0.005453206226292195,0.010175028645952407,179.82143075125558,178.22571345738,2.639932108058169
2024-04-03,0,181.24499893188477,173.0525016784668,181.17749786376953,175.31812191009521,179.22312355041504,0.07666240682567572,2.2329307373478757,-1.143482580833193,2.995652865176117,176.6362476348877,1.998962860107423,0.012603972224303072,174.66399726867675,179.79700164794923,0.7325810418277628,0.025168299151299464,1.023053198257542,1.0136036334439873,1.007190843536025,0.011341291743942383,60.294739241591174,181.62673565072114,177.1608741760254,172.69501270132966,179.99821417672294,0.9443600100001439,178.46535628182548,2.065304086722967,179.48968951441182,178.26766403225133,0.1699873896166247,3.0531970567988598,31046600,1.4922072886587474,0.9022610580859654,805803400.0,-6.223592866996071,47.13413368669027,45.7615501877868,130.295293451997,32.679067505630144,16.763707323339286,-0.007508353755985538,3.189970564850141,180.7627210083008,179.37864163208008,178.26000213623047,177.14136264038086,175.75728326416015,0.06,0.0,162.2852921508706,0.023051040605750694,0.015024188121817125,180.32714625767298,178.64357103620256,2.7913220658742453
2024-04-04,0,182.2750015258789,173.0525016784668,181.24499893188477,175.61999702453613,179.2981252670288,-0.03035913808357832,2.3585541399213743,-1.157181980742421,2.9956439336698217,177.48749923706055,2.111125183105469,0.01329083940047303,174.66399726867675,180.45749855041504,0.6979172502421047,0.037508775599912565,1.027149528177544,1.0157779376593274,1.0106316722858724,0.01684751019368269,65.68585943374809,182.174232608456,177.45712432861328,172.74001604877054,180.4678568158831,1.1524733667531224,178.7628563472203,2.29714344024521,179.92031849927756,178.60877220971594,1.7330180154264019,2.7422312526464148,41624300,1.5037822168782449,1.1931367612836448,847427700.0,-44.04149652065391,47.13413368669027,45.7615501877868,118.1214453926533,33.89111912881434,14.924362653594574,-0.028255672460584032,3.326672232773761,182.3671256713867,180.6764454040527,179.31000518798828,177.94356497192382,176.25288470458983,0.08,0.0,162.49988077763777,0.0009453270712025397,0.009534475149440709,180.36857386997767,178.73285675048828,2.6741702298093584
2024-04-05,0,183.92250442504883,173.0525016784668,182.2750015258789,175.81062698364258,179.5037488937378,-0.055322020204542466,2.4894739593912183,-0.9959572956159306,2.995634260221057,178.1337490081787,2.175875167846681,0.013998686802040129,174.87999877929687,181.18424797058105,0.7230436713227644,0.03659575417088238,1.0342239273403424,1.021878269300355,1.0163626221166784,0.019653259554708757,67.71243899498795,182.81519746101876,177.83624954223632,172.85730162345388,181.14071491786413,1.5894792968347748,179.348571232387,2.4988396426670705,180.51136500110238,179.06962511680754,1.836719557549472,2.33844304152188,42335200,1.5007070630222477,1.1992960914491881,889762900.0,-9.411740770527164,47.13413368669027,45.7615501877868,176.26173165670502,31.959186634477327,13.031309028985337,-0.023236250777916648,3.5372973256720246,183.26100427246095,181.39950427246094,179.89500427246094,178.39050427246096,176.52900427246095,0.1,0.0,162.74374528464676,0.026000678093191176,0.02913866117894445,181.3357173374721,179.49357169015067,3.107400150610962
2024-04-08,0,186.0474967956543,173.0525016784668,183.92250442504883,176.10124969482422,179.89375114440918,0.06714996473912699,2.7725509310948566,-0.7168357316621292,2.9956113236399746,178.57250022888184,2.3208757400512696,0.015555122894346459,174.87999877929687,181.34799919128417,0.727228784146353,0.04366516843026672,1.043801087433629,1.0311096509015614,1.0240930466246103,0.026879711825729125,71.47234393551959,183.78547642731425,178.2403745651245,172.69527270293477,182.1110714503697,2.201821809405373,180.1153567177909,2.7946224082012456,181.3645486245874,179.67109181437604,2.628168667933986,4.666453400939264,39221300,1.5289724345603255,1.1089352849419667,928984200.0,-15.250490342741266,47.13413368669027,45.7615501877868,183.27786243406572,32.42921745080454,12.36331900392857,-0.03260996952509279,3.461646681873307,184.04027587890624,182.02985748291016,180.40499877929688,178.7801400756836,176.7697216796875,0.12000000000000001,0.0,162.97840765714656,0.023318788706624405,0.026665913229787647,182.10143171037947,180.2585721697126,3.3875981230947043
2024-04-09,0,186.11249923706055,173.0525016784668,186.0474967956543,176.2362470626831,180.57749843597412,0.31365640505834097,3.2079483673307725,-0.3129780273176306,2.9955714796415758,179.10000038146973,2.561488189697266,0.01794843450867745,174.87999877929687,182.4397518157959,0.6896683870105023,0.07509278970917349,1.0412973094645295,1.0269791488307631,1.0189876973614407,0.03549718155038328,79.9308064151533,185.1472710937924,178.73137435913085,172.3154776244693,182.9303572518485,2.4965196009602226,180.91392816816057,2.797039118096856,182.53488900045477,180.44830282269723,3.7892921743131605,6.123349330854501,36546900,1.3195082476420281,1.0216754746476493,965531100.0,-13.149595041253,47.13413368669027,45.7615501877868,163.7671921372975,30.31065819831271,12.824765527198638,-0.008687634495197638,3.4386354105425707,184.3427970581055,182.48859750366213,180.98999786376953,179.49139822387696,177.6371986694336,0.14,0.0,163.19255250628052,0.027560992087284797,0.02597113840160876,182.85714503696985,180.95642961774553,3.325958363281675
2024-04-10,0,184.41500091552734,174.40749740600586,186.11249923706055,176.7506227493286,181.19437313079834,0.4905312501467709,3.313018919943558,-0.4590837146721882,2.9955622154569412,179.23374938964844,2.585812911987304,0.01846882669705293,175.27449989318848,184.13500366210937,0.7490591714140528,0.06711295102071464,1.028043839937913,1.0136270694524192,1.0026886656567895,0.017490148706579944,79.50240056413831,186.01041207694763,179.38437423706054,172.75833639717345,183.3928576878139,2.416263124079515,181.453214100429,2.6817994117651875,183.43365270750976,181.22241622535546,3.179443474942592,6.391036756142752,35879200,1.3164174121420862,1.004036242934616,929651900.0,-13.125588954880888,47.13413368669027,45.7615501877868,125.8869158707185,28.04826298276143,15.039724645564073,0.010718441980880726,3.450178874333939,184.84075720214847,183.29461773681643,182.0449981689453,180.79537860107422,179.2492391357422,0.14,0.0,163.39182227704356,0.019406793569777037,0.02911060067388973,183.56857299804688,181.5135726928711,3.4829269316896054
2024-04-11,0,187.7675018310547,174.93249893188477,186.11249923706055,177.79874992370605,181.5024995803833,0.399914491026959,3.2791178900737785,-0.725069074402986,2.9955665084467427,179.34124946594238,2.6494503021240234,0.01822899329032975,175.68149642944337,184.57825050354003,0.8334521275438342,0.04539208155701021,1.043821126828491,1.0291111374234214,1.0174094982302035,0.030133042157160395,68.17478041110905,186.44298519268415,179.88474941253662,173.3265136323891,184.54071480887276,2.2929689856563136,182.0489286695208,3.092112378646703,183.67546435550102,181.69666427721592,1.7869233706893042,4.268794358945579,40020700,1.3696676000196655,1.1056245246546919,969672600.0,-5.529961478016189,47.13413368669027,45.7615501877868,170.75787366842718,32.74818841511811,13.73342170804914,0.04820294243312418,3.5081030829621636,186.69728326416018,184.79636264038086,183.26000213623047,181.7236416320801,179.8227210083008,0.16,0.0,163.6416348617261,0.0502777947319879,0.036401508998093086,184.76285879952567,182.29214477539062,3.9299169732159136
2024-04-12,0,186.8275032043457,174.93249893188477,187.7675018310547,178.14562320709229,182.6868772506714,0.3972288814642513,3.5961528185542386,-0.7179574094714831,2.9955341952328682,179.57999992370605,2.934050445556642,0.019928501094343385,175.68149642944337,186.05399703979492,0.7944038687913815,0.05422211659990215,1.035326441871867,1.0192041121484297,1.0063263322403742,0.01579468911853965,74.47938055232244,187.64505527089761,180.45274963378907,173.26044399668052,185.33821541922433,1.891289157970954,182.66821479797363,3.1208651351094194,184.6956525551133,182.4759573080152,4.470532462817089,4.64811919386922,38554300,1.4947360004868355,1.072746797804495,931118300.0,-29.050277288636078,47.13413368669027,45.7615501877868,116.94688076906144,30.12240783711872,13.500706526402096,-0.0007620116457200203,3.541137720017889,186.8129245605469,184.98354473876955,183.5050048828125,182.02646502685548,180.19708520507814,0.16,0.0,163.86233009201496,0.005727549125433162,0.03405558268229167,185.2942875453404,182.8107169015067,4.090555293271971
2024-04-15,0,185.68499755859375,174.93249893188477,187.7675018310547,178.78000164031982,184.04562854766846,0.2359272231117388,3.807857464589533,-0.9859182516653395,2.995511038629522,180.05500030517578,3.179238185882568,0.021050839816866833,175.68149642944337,186.18399963378906,0.8198216130253712,0.06319627493547214,1.0265156131369577,1.0094195470883498,0.9970520805171708,-0.0019484230817612413,72.60150525067847,188.50433969266783,180.88862476348876,173.2729098343097,185.82535770961218,1.3252467249888227,183.14660726274764,3.0251089980508614,185.21938804635153,182.9669835390686,3.0800873432976466,4.866483827274266,48052400,1.3774903955817919,1.383334715159555,883065900.0,-49.35799230692939,47.13413368669027,45.7615501877868,78.53295563920155,26.805036757823707,16.039709940216085,0.022133039212187317,3.6948091023749674,186.8294426879883,185.01028170776368,183.54000091552734,182.06972012329103,180.25055914306643,0.02,1.0,164.1145662101038,-0.008477819015718757,-0.007834938940111544,185.8114297049386,183.09000178745814,3.824311122818916
2024-04-16,0,183.42000198364258,174.93249893188477,187.7675018310547,179.15624904632568,184.73250007629395,0.08133809051673206,3.750661964951273,-1.0558284322550502,2.9955185800025212,180.77749824523926,3.1958506774902333,0.020677706438117442,176.7097480773926,186.18399963378906,0.8239708248919475,0.05916576147504456,1.0112094855090343,0.9946692914225349,0.9852735471212666,-0.014467041517659762,67.25483250719755,188.88807376968526,181.3867498397827,173.88542590988015,185.75357164655412,1.45295596208197,183.4471432822091,2.8052110571210633,185.33483802444854,183.2860616903955,1.8707974237655962,3.7418782834795024,32891300,1.4145366287204242,0.9446455019677662,850174600.0,-51.76559769477306,47.13413368669027,45.7615501877868,37.293568065247825,25.442135111393196,16.688196826009364,0.05123913530804729,3.614378128395202,186.8294426879883,185.01028170776368,183.54000091552734,182.06972012329103,180.25055914306643,0.04,0.0,164.27062396798607,-0.01265681514462158,-0.010097710959203442,185.5614297049386,183.44857352120536,3.474075038436243
2024-04-17,0,182.49500274658203,174.93249893188477,187.7675018310547,179.24437522888184,184.73250007629395,0.021776620161179622,3.502144537639151,-0.9798710785970477,2.9955467146961143,181.21124839782715,3.0343383026123036,0.01926455581513757,178.02824745178222,186.18399963378906,0.7994903126838661,0.048518732102847725,1.0038663820440692,0.9876780520485933,0.98314864896302,-0.010411290618515312,57.71533780015523,188.79641401424317,181.79212493896483,174.7878358636865,185.24607249668665,1.8883625066564949,183.6785719735282,2.5552721348826797,184.85942108345722,183.25035609997983,-0.27321422301044584,2.34777391431804,31359700,1.536816136021818,0.8949019493696388,818814900.0,-74.5391215813412,47.13413368669027,45.7615501877868,-6.44476636776866,23.103953000499576,19.875352644466584,0.0009894983738386548,3.6955764607169197,187.08196441650392,185.41902450561525,184.07500457763672,182.7309846496582,181.06804473876954,0.06,0.0,164.4050359981352,-0.02511426859687005,-0.02364409669274558,185.0028577532087,183.55214473179407,3.18380910149445
2024-04-18,0,180.43249893188477,176.86499786376953,187.7675018310547,179.38437366485596,184.73250007629395,0.19338506199920458,3.129539281654575,-1.167195401604763,2.995584861238562,181.76000022888184,2.72650089263916,0.017179200662163212,178.9045024871826,186.18399963378906,0.8110122352693253,0.03183221638432392,0.9904608398101353,0.9758554324736906,0.9740524268920161,-0.03906428336981149,52.71415308441377,188.42932869300887,182.1702501296997,175.91117156639052,184.43464388166154,2.556245884287811,183.682500566755,2.5498430232192755,184.27338613162715,183.1491984163709,-1.9094554402815511,1.8074818884610233,30723800,1.5238203699876016,0.8757850304890563,788091100.0,-92.62514150216693,47.13413368669027,45.7615501877868,-57.34841477424544,21.43368936843003,20.700103588770915,-0.06379648300382425,3.698752959356253,187.08196441650392,185.41902450561525,184.07500457763672,182.7309846496582,181.06804473876954,0.08,0.0,164.52137032422596,-0.05199683508263919,-0.03619250248986187,184.08142961774553,183.4692873273577,3.12166945639837
2024-04-19,0,176.4525032043457,178.15749740600586,187.7675018310547,179.65625095367432,184.73250007629395,0.345607968214408,2.9164880141634435,-1.2182197735418532,2.995604595198667,181.76000022888184,2.5554882049560548,0.01599402250077208,179.18999824523925,186.18399963378906,0.8363523326924166,0.005601154115621019,0.9676656625579756,0.9552818703418745,0.9601707678785952,-0.05553250898317774,43.52626820052692,188.18160121143237,182.34862518310547,176.51564915477857,183.29714420863561,3.9552328951452345,183.34500094822474,3.149178552027477,183.31425887003394,182.81768382343424,-3.0519176994882478,0.030491777297347002,55950000,1.5117288652811407,1.543971096419546,732141100.0,-92.7127843969789,47.13413368669027,45.7615501877868,-157.98734781113006,19.131751233223255,28.15763376164882,-0.06062365948521334,3.847543701043001,185.91612384033206,183.53194357299807,181.6050033569336,179.67806314086914,177.29388287353515,0.1,0.0,164.670242658127,-0.061784772461809134,-0.07627610651239941,182.46428789411272,183.0164304460798,3.4440450078026092
2024-04-22,1,176.89999771118164,176.4525032043457,187.7675018310547,179.61312675476074,184.73250007629395,0.12870346385265996,3.1297506821362284,-1.0536854372471174,2.995584833756364,181.76000022888184,2.69687557220459,0.017177567626783588,178.9045024871826,186.18399963378906,0.7267198011653531,-0.009570151278981085,0.970911737860089,0.9615933264385232,0.9735988863301932,-0.04731130658329019,34.478967551933046,188.4593768144067,182.19987545013427,175.94037408586183,181.74464362008231,4.040024402244649,183.14267921447754,3.4734163293870797,181.59855480233932,181.8646691818946,-4.317706082288241,-2.6079368106610197,37924900,1.7403687291891405,1.032369953368332,770066000.0,-76.79122558991148,47.13413368669027,45.7615501877868,-124.28818296231036,17.612750900159952,25.92200699958094,-0.07369939349148778,3.8806030077886096,185.91612384033206,183.53194357299807,181.6050033569336,179.67806314086914,177.29388287353515,0.1,0.0,164.77963225018308,-0.03480012830612644,-0.04781609048405111,180.77571541922433,182.769287109375,3.541012128437901
2024-04-23,0,178.38249588012695,176.4525032043457,187.7675018310547,179.61312675476074,184.73250007629395,0.05272869300003796,3.221611438152604,-1.0222523545265576,2.995575876076228,181.76000022888184,2.759750556945801,0.01768784722445633,178.77875251770018,186.18399963378906,0.7722308049558213,-0.011662855255165652,0.9793863708325454,0.9744974831645523,0.9913443090614878,-0.027464322587701595,35.44173949477524,188.5802233416983,182.13700046539307,175.69377758908786,180.5382140023368,3.4931135094241066,182.93821471078056,3.6722760456421777,180.42436947256792,181.19514597188618,-5.78774495793802,-1.5759555123306097,37046500,1.7318042567703302,0.9986302243167733,807112500.0,-62.645498097090055,47.13413368669027,45.7615501877868,-83.86058914693568,18.28294193833933,24.038308194969353,-0.04566172646940447,3.885563464162372,185.91612384033206,183.53194357299807,181.6050033569336,179.67806314086914,177.29388287353515,0.1,0.0,164.89845791337424,-0.02061975718449882,-0.022219812327360117,179.83428519112724,182.5642863682338,3.546827629218356
2024-04-24,1,178.25749969482422,176.4525032043457,187.7675018310547,179.61312675476074,184.73250007629395,0.04760040370516147,3.2537230537271964,-1.0531765997537026,2.9955726852874567,181.76000022888184,2.7900009155273438,0.017867119433073085,178.23424606323243,186.18399963378906,0.8072889469633624,-0.004631383645979401,0.9788626703308384,0.9779443695505666,0.9962276277302824,-0.023219830614442327,40.90251563636328,188.61419621426592,182.10675010681152,175.59930399935712,179.47714287894112,2.70931188107283,182.65125029427665,3.8792278066188666,179.91153593908862,180.85239675227004,-4.520216338266793,-1.579355606293774,34185100,1.7670082560719567,0.9159106217456935,772927400.0,-80.71038858982831,47.13413368669027,45.7615501877868,-99.42957142206042,17.61113517650909,22.216090438132092,-0.05350273562523954,3.9037513038028844,185.91612384033206,183.53194357299807,181.6050033569336,179.67806314086914,177.29388287353515,0.1,0.0,165.00004775351778,-0.02587159351824686,-0.03671181931836531,178.82999965122767,182.32071467808314,3.6576651880007165
2024-04-25,1,170.89749908447266,176.4525032043457,187.7675018310547,179.61312675476074,184.73250007629395,0.04338495283468735,3.3024892501803054,-1.1016056136761065,2.9955677758642127,181.76000022888184,2.8377508163452148,0.018139664869320657,178.12174949645996,186.18399963378906,0.8127528922680037,-0.005564705962719413,0.9386929450953145,0.9407443429340727,0.9596400593146496,-0.05284524630461207,40.53969347236661,188.66397870635427,182.05900020599364,175.454021705633,177.68821389334542,3.6447337928724544,181.72089276994978,4.961745796959172,179.49349390176292,180.61831654838738,-4.000052756780068,-2.204088216937578,49249400,1.7669741015438916,1.2918736094155518,723678000.0,-68.65675138061155,47.13413368669027,45.7615501877868,-212.34455919139006,14.645297611849426,34.643118733081884,-0.030160962664113278,4.35877888408724,184.2358049926758,180.81210543823244,178.04500579833984,175.27790615844728,171.8542066040039,0.12000000000000001,0.0,165.0713156563962,-0.030967542762836975,-0.04197926225505174,177.45142691476005,181.50642830984933,4.071627535489815
2024-04-26,1,178.59250259399414,170.89749908447266,187.7675018310547,179.39500045776367,184.73250007629395,-0.6823799739617399,4.070337879717674,0.29492942822915413,2.9954798483367724,181.76000022888184,3.255625915527344,0.022408680178148913,176.85524826049806,186.18399963378906,0.6539853647993753,-0.05255644198645406,0.9832162319462363,0.9923183919655183,1.0137049091891888,0.012127906098164942,26.065981735256432,189.78180086624687,181.64112510681153,173.5004493473762,177.13071387154716,3.034286889859096,181.1883931841169,4.860702062066825,177.3384052856373,179.47407239740187,-6.827228635776964,-7.081789899117025,43919800,2.379227080915814,1.1432722986619852,767597800.0,-43.28362676411477,47.13413368669027,45.7615501877868,-52.92300052959649,23.82234809578979,30.75930945739556,0.0020396846318578724,4.558273106735621,184.2358049926758,180.81210543823244,178.04500579833984,175.27790615844728,171.8542066040039,0.12000000000000001,0.0,165.20892477069685,0.028574644075189726,0.0022318596906591727,177.2142835344587,181.1085706438337,4.086449851089216
2024-04-29,0,181.65750122070312,170.89749908447266,187.7675018310547,178.54000091552734,184.73250007629395,-0.6135492459170658,4.116376111969677,0.10854662629591472,2.995473972762826,181.76000022888184,3.344875717163086,0.02267327784441963,176.85524826049806,186.18399963378906,0.7347896073653111,-0.014267750135941788,1.000581794681822,1.0139881680175273,1.0286032312412317,0.02689374545549117,46.09028408798667,189.7846275291151,181.55187530517577,173.31912308123643,177.3057141985212,3.281692269204699,180.8701790400914,4.655014810513431,177.6476278577241,179.54159883894135,-2.138414802517644,-4.007038165016736,54063900,2.9956557546876272,1.3631728825320206,821661700.0,-37.56929085337969,47.13413368669027,45.7615501877868,-3.8076541090692673,26.542833681491327,28.749522987563395,-0.002307832949538449,4.528379627576905,184.2358049926758,180.81210543823244,178.04500579833984,175.27790615844728,171.8542066040039,0.02,1.0,165.40416864730426,0.021046160786813983,0.03624807681419072,177.46285574776786,180.7721426827567,4.0865177201240925
2024-04-30,1,178.47000122070312,170.89749908447266,187.7675018310547,178.54000091552734,184.73250007629395,-0.631387635946842,4.115522592017662,0.12564676318040213,2.99547411354617,181.96625137329102,3.329038124084474,0.022665580332719495,176.85524826049806,186.18399963378906,0.7320038073343481,0.01071035686820707,0.9828948958983222,0.998440553659834,1.0051391888680976,0.0004905489193007817,52.476882180069765,189.8069206570578,181.57587547302245,173.3448302889871,177.593928200858,3.2828633078961613,180.4455362047468,4.577282595172292,178.65226617556186,180.0892002852708,0.6789255239882318,-2.393712423732956,94639800,3.0605123420828315,2.213187929260621,727021900.0,-62.98510104312874,47.13413368669027,45.7615501877868,-73.04721671247268,23.29952134850756,32.08466697440495,-0.14236276603494616,4.790060551970118,184.2358049926758,180.81210543823244,178.04500579833984,175.27790615844728,171.8542066040039,0.02,0.0,165.65785661587458,-0.02528680770805991,-0.012582496085861792,177.51571219308036,179.99000004359655,4.3357569519801435
2024-05-01,0,180.58749771118164,170.89749908447266,187.7675018310547,178.44812488555908,184.73250007629395,-0.5854640055879891,4.152825891782642,-0.00843668409952425,2.9954693112678648,181.96625137329102,3.3984756660461413,0.022878976170176122,176.85524826049806,186.18399963378906,0.7167952624346692,-0.01531075465549555,0.9949025469479301,1.013092277044961,1.0169646455598997,0.0130709676751124,46.148491014412684,189.8184022184408,181.5127504348755,173.2070986513102,178.12071391514368,3.444816046302851,179.932678767613,4.067661975913668,178.60798748755317,180.151717750814,1.1433660501948235,-3.223707217585499,94645100,3.125701830346762,2.060114040235359,821667000.0,-43.316962702245505,47.13413368669027,45.7615501877868,-20.217559975701324,23.016448597000238,27.585885926030592,-0.20066030096882792,5.173098380493689,183.41068359375,180.14466430664064,177.5050048828125,174.86534545898436,171.599326171875,0.04,0.0,165.95502958432354,0.013647452925351633,-0.0030076490271013067,177.76856994628906,179.2721426827567,4.352994230545127
2024-05-02,0,182.64500427246094,170.89749908447266,187.7675018310547,178.44812488555908,184.73250007629395,-0.5603418336520085,4.157415327410733,-0.039601711838229026,2.995468683648236,181.96625137329102,3.4346382331848133,0.022908409645128115,176.85524826049806,186.18399963378906,0.7238980518470058,-0.009258010152630164,1.006420154831055,1.0257324910519692,1.025859234090912,0.06874006495660678,49.61398878667888,189.7947060286618,181.47987537384034,173.16504471901888,178.72964368547713,3.851528933227434,179.63392884390694,3.6549749630616932,179.1082295170988,180.39213146614296,2.084511050147355,-3.823880090993229,54303500,3.1565181585318993,1.1659206400599111,875970500.0,-17.74699189653761,47.13413368669027,45.7615501877868,35.14418318438206,21.101489083390298,25.290751015326094,-0.10348508658721517,5.239335853074554,183.41068359375,180.14466430664064,177.5050048828125,174.86534545898436,171.599326171875,0.04,0.0,166.15488672790443,0.06362643616203889,0.046038875652142805,178.5085710797991,179.17142813546317,4.42122763658037
2024-05-03,0,186.62250137329102,170.89749908447266,187.7675018310547,178.44812488555908,184.73250007629395,-0.5711869868162217,4.161733405342749,-0.04159069338139121,2.995468166711141,182.07625198364258,3.4512883567810064,0.022929865865860793,176.85524826049806,186.18399963378906,0.7139602356037988,-0.006945861011307026,1.0282323511033642,1.046769420752308,1.034547273392915,0.04496268691386218,52.531543559183795,189.82184232185492,181.49837551116943,173.17490870048394,179.9246439252581,4.849119409088016,179.7008934020996,3.7807903083853427,180.00193672523602,180.8353746708306,2.3895328806243357,-2.238695513320695,39172000,3.1696885161650594,0.8439062180885304,915142500.0,-7.702966791758126,47.13413368669027,45.7615501877868,91.60971091015038,24.057085797900122,24.172333434247374,-0.13897109798152715,5.0900348156289,182.78419799804686,179.63789978027344,177.09500122070312,174.5521026611328,171.4058044433594,0.06,0.0,166.32314199230115,0.036688630307445624,0.07220595771943877,179.8828582763672,179.35642896379744,4.479718109385533
2024-05-06,0,187.13249969482422,170.89749908447266,187.7675018310547,178.44812488555908,185.7756223678589,-0.5429786318669572,4.280281909095746,-0.19588768713810856,2.9954533489942383,182.07625198364258,3.5727882194519056,0.023565503314826316,176.85524826049806,186.64300155639648,0.6634180348997466,0.003090633239039364,1.0302759574080826,1.0436764920222141,1.0282203146897335,0.030139126858677256,58.00443398715169,190.19393917677303,181.63337535858153,173.07281154039003,182.2439297267369,3.5093681453438164,179.96607181004114,4.17169407429834,181.66965861455668,181.87684127670067,4.692650627764683,0.5048893701826568,34725300,3.262747991027253,0.7517489784095662,949867800.0,-0.22292941634262423,47.13413368669027,45.7615501877868,104.44540883294502,23.95686260018795,22.81013065080324,-0.07356787360481729,5.0085719614913895,183.4565217285156,180.18174279785157,177.53500366210938,174.88826452636718,171.61348559570314,0.08,0.0,166.47665870153418,0.042771827736575174,0.05055117513576772,182.0300009591239,179.74071393694197,4.7021318983872264
2024-05-07,0,188.7324981689453,170.89749908447266,187.7675018310547,178.44812488555908,185.79187297821045,-0.5084924848441084,4.3423110394484485,-0.2530220742456626,2.995445438206781,182.07625198364258,3.6246257781982423,0.023899872252796005,176.85524826049806,186.85800285339354,0.6661952793690658,0.00548055859732692,1.0387746421688362,1.046627041147934,1.0308097169345736,0.057502644018874394,58.73656565820239,190.37224758243693,181.68762550354003,173.00300342464314,183.6925005231585,3.82914454186782,180.41160719735282,4.754877037392605,183.04266576375062,182.52870275723453,9.49984680719452,2.0240419098418294,34048900,3.2645099674630376,0.7391044239596525,983916700.0,-4.995800925088624,47.13413368669027,45.7615501877868,119.47986441983397,24.78374860087762,21.924216287444672,-0.06744712485565126,4.838613136800038,184.36568359375,180.91716430664061,178.1300048828125,175.34284545898439,171.894326171875,0.1,0.0,166.63391137974446,0.07862854003906228,0.04310337921959747,183.3357151576451,180.27499934605189,4.893056761211635
2024-05-08,0,187.56499862670898,170.89749908447266,188.7324981689453,178.44812488555908,185.91937351226807,-0.3976457471437492,4.5101042496839145,-0.34709413978516146,2.995423519830086,182.07625198364258,3.7556257247924805,0.024805512848412,176.85524826049806,187.19599990844728,0.6844316577046743,0.02341185495748055,1.0316049753557879,1.0342165594079138,1.0130762994176203,0.03863778502920856,62.023996107806326,190.83883394950212,181.81862545013428,172.79841695076644,184.53642872401647,3.954819913276303,180.92107146126884,5.124991122690359,184.4744358757227,183.19452657300383,5.677727467654719,3.4178993005221368,26136400,3.254435353382505,0.5734101144696521,957780300.0,-8.213390526887,47.13413368669027,45.7615501877868,95.72877114405321,23.883549807757216,22.537855304399944,-0.0839446982623496,4.662224322632821,184.36568359375,180.91716430664061,178.1300048828125,175.34284545898439,171.894326171875,0.1,0.0,166.74736485138763,0.05027932960893855,0.07428571428571429,184.34142848423548,180.90214211600167,5.0077807149128715
2024-05-09,0,189.38000106811523,170.89749908447266,188.7324981689453,178.44812488555908,186.6737518310547,-0.37865313738459555,4.650829612598583,-0.4978207413339093,2.9954045398359037,182.07625198364258,3.9131256103515626,0.025557361461670574,176.85524826049806,187.58524894714355,0.7028276649129968,-0.0010784784500563202,1.0406859730569813,1.0388926487069763,1.015227341310357,0.0368747933866691,58.023367431306525,191.27778456089052,181.97612533569335,172.67446611049618,186.09500013078963,3.253158461868633,181.8444641658238,5.414369575567206,185.2674611392918,183.7329235347305,3.251997504264137,3.953001669348278,43368400,3.181677546892812,0.9479840933023884,1001148700.0,-8.66823423032364,47.13413368669027,45.7615501877868,124.43545800678757,27.35712444548127,21.057313529214657,-0.11415016688348556,4.633484701798335,185.71031939697266,182.00484091186524,179.01000213623047,176.0151633605957,172.30968487548827,0.12000000000000001,0.0,166.9501941230531,0.025876996252212736,0.05865921787709497,186.41285705566406,181.9642846243722,5.043132729096287
2024-05-10,0,188.36499786376953,170.89749908447266,189.38000106811523,178.44812488555908,186.6737518310547,-0.3053653339186514,4.763148371450987,-0.5240379337441428,2.9953890126720513,182.07625198364258,3.99375057220459,0.026162986890990222,176.85524826049806,187.6817485809326,0.7012228504159284,0.013662323908368534,1.0346498965619961,1.0229528167928907,1.0025467400688002,0.009337011762547753,61.5177259883458,191.58304704044835,182.0567502975464,172.53045355464442,187.2060715811593,2.224004957245798,182.6633927481515,5.475685890120068,186.29670762970275,184.26052156383767,6.113072097713704,7.3263329388977185,34141800,3.198751856271493,0.7499176320193993,967006900.0,-16.627277170786193,47.13413368669027,45.7615501877868,97.54140647078742,26.075364184440264,20.87799380449998,-0.12286790397493104,4.513916100858262,185.71031939697266,182.00484091186524,179.01000213623047,176.0151633605957,172.30968487548827,0.12000000000000001,0.0,167.09728894158874,0.006820197453852872,0.014941503294698838,187.62428501674108,182.69642748151506,5.112900877580611
2024-05-13,0,187.06000137329102,170.89749908447266,189.38000106811523,178.44812488555908,186.75000095367432,-0.2742086502691648,4.851120271322707,-0.586737401884708,2.9953765966185824,182.07625198364258,4.070625305175781,0.026634951511616118,176.85524826049806,188.4017478942871,0.7387556992175358,0.0144330470442562,1.0270481430430431,1.0105028948100774,0.9937578148755729,-0.0003874170528980203,59.672884899626666,191.835865573163,182.13362503051758,172.43138448787215,187.83678545270647,1.0091737458549959,183.2832145690918,5.4448730275961745,186.80508757915294,184.5279415639691,4.306776632470235,6.481062917426597,24898600,3.1961988458928823,0.5611621081138461,942108300.0,-20.212733338423604,47.13413368669027,45.7615501877868,73.0680891465928,24.826910078418802,22.426492467486476,-0.08876515856438562,4.402177687791336,185.71031939697266,182.00484091186524,179.01000213623047,176.0151633605957,172.30968487548827,0.12000000000000001,0.0,167.1964477394148,-0.011287703542505412,0.001933304319701488,187.8885716029576,183.19857134137834,5.208237724282312
2024-05-14,0,185.5150032043457,170.89749908447266,189.38000106811523,178.44812488555908,187.07812595367432,-0.2748363771969884,4.9103450133351325,-0.6498841203517989,2.995368121785723,182.07625198364258,4.139375495910644,0.026949950610536167,176.85524826049806,188.4017478942871,0.7759076175300492,0.019845160562003774,1.0181810362190429,0.9992405473947564,0.9856259215964526,-0.01704791170474229,57.76813963043312,192.02306524792272,182.20237522125245,172.3816851945822,187.67857142857142,1.281376547388821,183.80160767691476,5.272331118074766,186.85715376385534,184.49906901863542,2.4172558775514057,4.864549882178657,38698200,3.165201740282242,0.8665058742090667,903410100.0,-18.242677371471103,47.13413368669027,45.7615501877868,58.65231856108162,23.10267715059031,23.975524695129874,-0.051605502456941676,4.39273438295126,185.71031939697266,182.00484091186524,179.01000213623047,176.0151633605957,172.30968487548827,0.12000000000000001,0.0,167.34340429888948,-0.008953100401557612,-0.008637994967591447,188.0114288330078,183.9471435546875,5.324464359478363
2024-05-15,0,185.35250091552734,170.89749908447266,189.38000106811523,178.44812488555908,187.07812595367432,-0.3163188257746691,4.957323878444147,-0.7038666955512536,2.9953614001382323,182.07625198364258,4.244125556945801,0.027192156481915555,176.85524826049806,188.4017478942871,0.793585386593192,0.016548400845569092,1.0167046440369472,0.9945911316059449,0.9881408727794346,-0.011795898634504476,54.479402248074656,192.22177303917587,182.3071252822876,172.3924775253993,187.42428588867188,1.5551707773226717,184.83410780770438,3.7450648595899527,186.5300732814591,184.3270084880542,-0.5934429989929473,4.071359422154067,75459900,3.1797075400678176,1.6101524664480888,827950200.0,-33.78694388916861,47.13413368669027,45.7615501877868,40.87300093399804,21.47051609542211,23.453740237445334,0.014761491000276126,4.388967600482971,187.7115983886719,185.24419927978516,183.25,181.25580072021484,178.7884016113281,0.12000000000000001,0.0,167.6095315619676,-0.010691460142744247,-0.014674661444597063,187.62428719656808,184.827144077846,5.386018815754083
2024-05-16,0,185.00000381469727,170.89749908447266,189.38000106811523,178.44812488555908,187.07812595367432,-0.38241764612583207,5.0016594782757595,-0.7385329053455107,2.9953550916904987,182.15125274658203,4.387000465393067,0.027413863924620332,176.85524826049806,188.4017478942871,0.7992856657803572,0.027267825989041657,1.0139764517473093,0.9901679173023568,0.9885937811562385,-0.023128087594859625,55.35968923604043,192.45331914728638,182.45000019073487,172.44668123418336,186.89107240949357,1.6676752673070425,185.29178646632604,3.287142197088937,186.21706465841575,184.15723133259402,-0.9511970300186755,8.458287516489488,38834500,3.1378734409196647,0.8215360075818796,789115700.0,-47.751449585484465,47.13413368669027,45.7615501877868,32.44201944440804,21.081941061233458,21.97087544429671,-0.0002224839080267042,4.350461010269171,187.7115983886719,185.24419927978516,183.25,181.25580072021484,178.7884016113281,0.12000000000000001,0.0,167.740766910549,-0.030976227531332445,-0.023244654878656915,186.8914315359933,185.1135733468192,5.338046286702708
2024-05-17,0,184.2775001525879,170.89749908447266,189.38000106811523,178.44812488555908,187.07812595367432,-0.5078489487500721,5.008597871872669,-0.6688487837115478,2.9953545548384244,183.8225040435791,4.394125175476074,0.027417573973654182,176.85524826049806,188.4017478942871,0.7839555492790191,0.048440801094518295,1.0087537712874095,0.9850592660671955,0.9893642369798794,-0.021699879263863187,57.16606503777557,192.69557117862084,182.67837543487548,172.66117969113012,186.42142977033342,1.8938267572704914,185.47892924717493,3.1353981872535237,185.89007095590543,184.081318628115,-1.977663831327489,3.5877772737580766,33175700,2.980563389962078,0.7191490224169249,755940000.0,-41.42013330227401,47.13413368669027,45.7615501877868,22.54003635497182,20.379137175161144,21.426492284083622,0.04828485355789166,4.17896517108334,187.7115983886719,185.24419927978516,183.25,181.25580072021484,178.7884016113281,0.02,1.0,167.84903458687867,-0.014828242173298145,-0.025329831407692942,186.42000252859933,185.3807155064174,5.007062660656562
2024-05-20,0,184.4574966430664,170.89749908447266,189.38000106811523,178.5618772506714,187.07812595367432,-0.7081557472598525,4.808613307453957,-0.2053630789066978,2.995385053821261,184.63875198364258,4.123662815093994,0.02626658190860022,178.12174949645996,188.4017478942871,0.7702678403964434,0.04170436708230622,1.0075811121513947,0.9872589952847192,0.9946963981051195,-0.013912673533189701,54.65118896118435,192.6868518971955,183.0696252822876,173.4523986673797,185.71821485246932,1.4810913419218403,185.90660749162947,2.436215764376929,185.48686036267856,184.02083373224212,-1.7527249210626223,1.4422740125119424,30511800,2.9920403873244164,0.6667609240398477,786451800.0,-53.89698805198469,47.13413368669027,45.7615501877868,18.708456516889623,21.556043520878102,20.167764843918047,0.010548832210390264,4.1226000591400505,188.12695709228515,185.91651718139647,184.12999725341797,182.34347732543947,180.13303741455078,0.04,0.0,167.94765390264715,-0.016240627749027348,-0.021015588495810235,185.56857299804688,185.99071502685547,4.809505677792828
2024-05-21,0,182.36499786376953,170.89749908447266,189.38000106811523,180.08874893188477,187.07812595367432,-0.9332111971685983,4.601420062628018,0.43786740485673414,2.9954151224124437,184.72875022888184,3.809000015258789,0.025083034965791125,178.36999626159667,188.4017478942871,0.7668413143457073,0.03405603634463022,0.9940991162934262,0.9774589106251602,0.9861805312596411,-0.016979787543686786,54.15811875529862,192.65034035413785,183.44750022888184,174.24466010362582,184.86107199532645,1.4293084633390805,186.03357178824288,2.169390291885888,185.22425466476744,184.0576661462327,-2.599273628305835,3.354902998492674,50839100,2.981086092334275,1.094470586766316,735612700.0,-72.51915115010414,47.13413368669027,45.7615501877868,-22.46991850278451,20.489216063395872,23.657535369430136,0.02831659642651774,4.027397529024305,188.91755853271485,187.19621951293945,185.80500030517578,184.4137810974121,182.6924420776367,0.06,0.0,168.08878129561774,-0.02095479378979448,-0.01833099262193357,184.9500013078962,186.28714316231864,4.721482530072254
2024-05-22,0,183.5500030517578,170.89749908447266,189.38000106811523,181.39000034332275,187.07812595367432,-1.0850111405411227,4.461983068492051,0.9870517316268299,2.9954343982201386,184.72875022888184,3.5700498962402323,0.024296569896240794,178.44875106811523,188.4017478942871,0.7415262492587766,0.023042498497832208,0.9994738684899134,0.987179588972557,0.9959819045112887,-0.009724702147887454,47.835112997614715,192.57059146504807,183.64662532806398,174.72265919107988,184.35964366367884,1.1091389200110195,186.09821455819267,2.0719468238797885,184.49703577971195,183.84621824460717,-3.18530516181109,0.9842874922773965,28148800,3.0285306890332584,0.6099541171437025,763761500.0,-78.26478953316453,47.13413368669027,45.7615501877868,-9.262038454883157,22.816864783477595,22.274605849506155,0.04947651985126847,3.971860287182766,189.11579766845702,187.51709811401366,186.2249984741211,184.93289883422852,183.33419927978517,0.06,0.0,168.17141076192178,-0.015377173643111197,-0.021061646908355915,184.4585723876953,186.17357199532645,4.424425420315524
2024-05-23,0,182.38750076293945,170.89749908447266,189.38000106811523,182.18812370300293,187.07812595367432,-1.3085676143885883,4.288076429207356,1.8496820904856692,2.9954575668810173,184.72875022888184,3.2524996948242175,0.02331600931234331,178.58025245666505,188.4017478942871,0.603158102795769,0.07403562974921693,0.9917147551938098,0.9830501175829724,0.9916136598723589,-0.01412163782642184,57.207771676369916,192.48740335432535,183.91125049591065,175.33509763749595,183.9128576006208,1.1929167554797842,185.7957145145961,2.287456761581198,184.24178935793495,183.9002965208041,-1.8764023819976146,0.4954960486884393,33670200,2.4491136669149283,0.7421233616820423,730091300.0,-91.65230956708092,47.13413368669027,45.7615501877868,-62.227122473759486,20.920391005598365,23.779863195526442,-0.02210297449764624,4.022448655041329,188.95767810058595,187.26115881347656,185.88999938964844,184.51883996582032,182.82232067871092,0.08,0.0,168.25964059070606,-0.014050001429239067,-0.026560580114547306,183.59857177734375,185.80500030517578,3.781174836898205
2024-05-24,0,181.2849998474121,178.47000122070312,189.38000106811523,182.38187503814697,187.07812595367432,-0.33311783657075517,3.115405830513427,-0.7741241562443832,2.99558940605461,184.72875022888184,2.586750030517578,0.016886972683374114,180.38799819946288,188.4017478942871,0.7329884652581182,0.021249481998540144,0.9826504175939768,0.9808042897841529,0.9884274097245545,-0.016239097571314365,46.656219484821825,190.71656224086084,184.485750579834,178.25493891880714,183.3317860194615,1.3544898506420868,185.3780359540667,2.544059997796597,183.79050736117472,184.04848917697967,-1.6858487924889236,-2.269287239849238,27434100,1.8320379893465208,0.6158627749417454,702657200.0,-94.23409250874558,47.13413368669027,45.7615501877868,-89.54067466762247,20.097784357557245,22.8448197946209,-0.06442512884965966,3.887969522121761,188.95767810058595,187.26115881347656,185.88999938964844,184.51883996582032,182.82232067871092,0.08,0.0,168.32655072509928,-0.021386015232848554,-0.01568373798525158,182.8499995640346,185.23714338030135,3.7148099517484243
2024-05-28,0,180.95249938964844,178.47000122070312,189.38000106811523,182.38187503814697,187.07812595367432,-0.1989726947880444,2.909183958874479,-0.8173926023068199,2.995607980688909,184.72875022888184,2.4521251678466798,0.015757653790388196,181.21524963378906,188.4017478942871,0.7747536873470848,-0.0020505697303325144,0.9801328751278663,0.982769850046732,0.9898445905406209,-0.019001652506432376,39.77841027127318,190.43874336025385,184.6203754425049,178.80200752475594,182.75357110159737,1.3871783920809106,184.8223217555455,2.603970900919722,183.1600069031983,183.86459335071726,-2.194467864217791,-3.124791181087313,29927000,1.7220381124020074,0.6905334934817879,672730200.0,-78.214657945448,47.13413368669027,45.7615501877868,-86.0976551156322,19.060584700945263,23.185927698948657,-0.018886903218283558,3.8066756164379045,188.81843896484375,187.03578021240236,185.59500122070312,184.1542222290039,182.3715634765625,0.1,0.0,168.39948520643568,-0.007573277980246207,-0.013806188921986621,182.63856942313058,184.76500047956193,3.666098775409584
2024-05-29,0,182.3375015258789,178.47000122070312,189.38000106811523,182.38187503814697,187.07812595367432,-0.20068383528809322,2.948871528544967,-0.8742748628804216,2.9956045145112173,184.72875022888184,2.487375259399414,0.015975672595168598,180.91599922180177,188.4017478942871,0.7214436124231964,0.013909890468792882,0.98782337514575,0.9935876966770915,1.0012602485477995,-0.00015077640014649063,41.2737102128587,190.4828684080421,184.58512535095215,178.6873822938622,182.47642844063895,1.2150912933096427,184.4489291054862,2.554766044464976,182.60517945992706,183.61292398196392,-2.187840184642891,-4.1222358919514495,32009300,1.555571235816983,0.7961041031471049,704739500.0,-79.27927477586661,47.13413368669027,45.7615501877868,-65.85388046395141,21.67114325531974,22.058070776913254,0.0665678041415191,3.7154736125600625,188.81843896484375,187.03578021240236,185.59500122070312,184.1542222290039,182.3715634765625,0.1,0.0,168.48410676473787,-0.006169749722525819,-0.008281513943951354,182.2557133265904,184.33785792759485,2.9862269478683556
2024-05-30,0,180.08250045776367,180.58749771118164,189.38000106811523,182.38187503814697,187.07812595367432,0.08711850218729497,2.65354534196628,-1.199678452766943,2.995629195587307,184.72875022888184,2.294000244140625,0.014360682312645902,181.25174980163575,188.4017478942871,0.7612018240053631,0.009690614449379508,0.9745857883945356,0.9830018590299422,0.988907343679477,-0.01889132408794547,45.54727010327261,190.08559105014348,184.77850036621095,179.47140968227842,181.8514289855957,1.1496790015301417,183.7848219190325,2.376559819911003,182.54651986207438,183.68180881978262,-1.0527593575464183,-2.787032302990506,29249200,1.5143845004083325,0.7918536202981051,675490300.0,-91.67383507801438,47.13413368669027,45.7615501877868,-147.69573160759012,20.14451845284012,26.644070304011414,0.11370976790533037,3.7115110374680222,187.16891967773438,185.48553985595703,184.125,182.76446014404297,181.08108032226562,0.12000000000000001,0.0,168.54491745085105,-0.020804878812905714,-0.020911748293206855,181.6528581891741,183.61071559361048,2.9541659734190984
2024-05-31,1,176.9550018310547,180.08250045776367,189.38000106811523,182.38187503814697,187.07812595367432,0.0347683571509611,2.695377695349902,-1.139662472752682,2.9956258640769273,184.72875022888184,2.3192501068115234,0.014589067786378437,181.25174980163575,188.4017478942871,0.7562052875310956,-0.014029969365461794,0.9577910069174348,0.9687167342719034,0.9754477531107428,-0.029785478221699635,35.39395180344947,190.14400589423985,184.75325050354004,179.36249511284024,181.07857240949357,2.1393404636275584,182.96982220241003,2.6281576279426853,181.94342879492035,183.45580476805188,-2.371818042054723,-4.90944162948203,58903900,1.5259359165905246,1.584816152646703,616586400.0,-82.20216835386859,47.13413368669027,45.7615501877868,-199.71675086827545,18.099836426366412,32.301835849032344,0.04768373735495804,3.835702374519051,184.90215698242187,182.79391662597655,181.08999633789062,179.3860760498047,177.27783569335938,0.14,0.0,168.6311142115843,-0.02546258233993881,-0.03653143812062517,180.6942879813058,182.822144644601,3.4991307970275853
2024-06-03,1,177.66499710083008,176.9550018310547,189.38000106811523,182.35812377929688,187.07812595367432,-0.44261723051138363,3.162676020474551,-0.3881816754247698,2.9955849109974038,184.72875022888184,2.603750228881836,0.017144779340318276,180.86549949645996,188.4017478942871,0.7509563631614007,-0.05180243256357895,0.9631170414144947,0.9769059299577492,0.9852624963577677,-0.019968572963174003,23.045043954999198,190.79410242241883,184.46875038146973,178.14339834052063,180.23785727364677,2.1624669210104828,182.2987504686628,2.701860393646678,180.71217364704353,182.756746150443,-2.966575875901484,-6.057386543208441,30786600,1.3303841483461534,0.8377674284189631,647373000.0,-67.72563717810579,47.13413368669027,45.7615501877868,-144.3964456458701,17.143938951618686,30.595895386895013,0.09819299743744747,3.760287823811774,184.45139978027345,182.42929888916015,180.7949981689453,179.16069744873047,177.13859655761718,0.14,0.0,168.6818790215437,-0.013333353593966146,-0.014968277648095163,180.01000104631697,182.23428671700614,3.7212831143858254
2024-06-04,0,178.31000137329102,176.9550018310547,189.38000106811523,182.0743761062622,187.07812595367432,-0.34636954897587935,3.4473973040482337,-0.680488525573657,2.995556393645013,184.36749839782715,2.860787467956544,0.01873372953423811,179.84075012207032,188.4017478942871,0.8130537216285609,-0.05059250856710485,0.9689661632717118,0.9840304161665647,0.9928256712204931,-0.014603268953291892,26.347948655531308,190.91566977594312,184.02087516784667,177.12608055975022,179.65535736083984,2.0321621207196148,181.78410748073034,2.7281788606417856,179.9604105766141,182.1593177474433,-3.2062140305539892,-5.022454936110347,27198400,1.3391656997835186,0.7477831873054137,674571400.0,-59.300593548621485,47.13413368669027,45.7615501877868,-110.38357504579889,18.17829332364532,28.617019870854843,0.07945086711947043,3.7331223646759173,184.13815698242186,182.17591662597655,180.58999633789062,179.0040760498047,177.04183569335936,0.14,0.0,168.73060697017038,-0.015426833119690841,-0.007800850136151452,179.76571437290735,181.68214307512557,3.689441853328098
2024-06-05,0,180.40750122070312,176.9550018310547,189.38000106811523,181.2018747329712,185.90125274658203,-0.1725715489501394,3.5828132236272254,-0.8936341390440585,2.9955415894919653,183.91375160217285,2.9907499313354493,0.019516385759941305,178.24550094604493,188.4017478942871,0.8228328788685981,-0.055223646678615575,0.9827200493152632,0.998994960382917,1.0074691503854378,-0.010584768843626247,27.794235870557642,190.74537669902446,183.57975025177,176.41412380451555,179.53000041416712,1.939848899298642,181.43089321681433,2.5445786609945906,179.55558241490172,181.72394016356347,-2.2356243561603604,-3.8837839024363663,32116400,1.275894690062376,0.8853489339818718,706687800.0,-44.866054195939164,47.13413368669027,45.7615501877868,-60.097035318173596,20.479725376928236,27.082260584264702,0.1120292960111778,3.6628935966663296,184.13815698242186,182.17591662597655,180.58999633789062,179.0040760498047,177.04183569335936,0.02,1.0,168.79900678208392,-0.004065517392563001,-0.004776256636505547,179.84142848423548,181.34571402413505,3.5077855852839175
2024-06-06,0,183.31000137329102,176.9550018310547,189.38000106811523,180.8162498474121,185.39312648773193,-0.03725078845779993,3.440770887575201,-0.8450805892850202,2.9955557673272595,182.96875190734863,2.8887502670288088,0.01878524312965869,178.24550094604493,187.64499855041504,0.8592507147059143,-0.038160090946662596,1.000799837132451,1.016168846154467,1.0258892848060905,0.01792234618757038,39.34031627083227,190.04504217950833,183.1635004043579,176.28195862920748,179.86678641183036,2.3821913151143885,181.31017875671387,2.3981072115860234,179.77029300027067,181.56297399093256,-0.4840437032559652,-2.6678893839570343,31371200,1.3952489123454397,0.85861091264495,738059000.0,-13.046857584272006,47.13413368669027,45.7615501877868,21.72664115650789,25.813750875367948,25.11969030560201,0.13346840902155424,3.666973022382045,183.64919744873046,181.78039700317382,180.2699966430664,178.759596282959,176.89079583740235,0.04,0.0,168.88378175424546,0.03167517535013009,0.01637180341496068,180.24857221330916,181.44357081821985,3.351132080485293
2024-06-07,0,184.71249771118164,176.9550018310547,189.38000106811523,180.8162498474121,185.08812808990479,0.03196296121307913,3.290297189213382,-0.5999557515987979,2.995570560614357,182.84875106811523,2.67600040435791,0.017984606127448805,178.24550094604493,187.19050102233888,0.8007617578732028,-0.03205195723196238,1.0096296252640582,1.024079754232735,1.0300173541661721,0.04383880534517637,49.10216318070845,189.53134492011378,182.950750541687,176.37015616326022,180.2060715811593,2.9045853579534295,181.34125001089913,2.4419285987671153,180.6595855008875,181.7780780658048,1.3028291908619203,-0.9135148143559056,28021500,1.5021921326348857,0.7833840884254067,766080500.0,-18.515582438568487,47.13413368669027,45.7615501877868,52.55404745053166,26.86846169998197,23.665049210598582,0.124287247175733,3.6143278576827256,183.64919744873046,181.78039700317382,180.2699966430664,178.759596282959,176.89079583740235,0.06,0.0,168.96281053572943,0.044547724447928205,0.02777155657000952,180.57428632463728,181.41499982561385,3.006078525501219
2024-06-10,0,185.5374984741211,176.9550018310547,188.36499786376953,180.8162498474121,184.78437423706055,-0.21461544294167992,2.976577928134967,-0.6030135904564586,2.995599412769448,182.84875106811523,2.4426252365112306,0.016290612329806508,178.24550094604493,185.66950302124025,0.769675461535296,-0.01939054598259,1.015434345499495,1.0273294599083975,1.025743437533775,0.04431093069403613,54.550344100002086,188.67053123011027,182.71737537384033,176.76421951757038,180.9853570120675,3.5302865564167707,181.41839299883162,2.562051344341935,181.66777151045045,182.13462158919955,1.3025275466800528,0.23605570850134042,34494500,1.5398029142569287,0.9638715476894202,800575000.0,-1.272441326189513,47.13413368669027,45.7615501877868,96.46273111444361,26.89965127196166,22.050549789769807,0.19763041292862074,3.6018752270567465,184.07703558349607,182.12647549438475,180.54999542236328,178.97351535034178,177.02295526123046,0.08,0.0,169.06745632705696,0.04889537624628981,0.06019040450146378,181.67999921526228,181.66642870221818,2.9726698435178887
2024-06-11,0,186.64999771118164,176.9550018310547,187.06000137329102,180.8162498474121,184.78437423706055,-0.48751342046858953,2.764579896813122,-0.7108710565141259,2.9956173400870996,182.84875106811523,2.3012502670288084,0.015142077220939791,178.24550094604493,185.51725273132325,0.759236222466246,-0.008139115192946371,1.0223139804673171,1.0310616519302833,1.0229891545059617,0.04677245400515084,58.27301828386336,188.10516019798416,182.5760004043579,177.04684061073164,182.37035642351424,3.586882741311015,181.7244644165039,2.915416625478474,182.63475569753737,182.62886747804717,3.029166078042564,0.5855017284250257,27265100,1.5322261415802392,0.7593514914176747,827840100.0,-3.884951001755709,47.13413368669027,45.7615501877868,111.01688592736159,26.242619405292892,20.627540110903546,0.2284805571904634,3.5753118808857436,184.48960211181642,182.4602007751465,180.81999969482422,179.17979861450198,177.15039727783204,0.1,0.0,169.15161417302582,0.043994644534189886,0.04984860139172053,183.22142682756697,181.9578574044364,3.0206822092355976
2024-06-12,0,187.17250061035156,176.9550018310547,186.64999771118164,180.8162498474121,184.78437423706055,-0.5375599641970943,2.732588739032384,-0.7337346537383236,2.9956199349463706,182.84875106811523,2.2807500839233397,0.014968536887251048,178.24550094604493,185.51725273132325,0.7686405376957076,0.00611807394136061,1.0252909410206947,1.0307040227105932,1.0165595446745204,0.03749843739242542,63.01587458836401,188.0206776993172,182.55550022125243,177.09032274318767,183.72857121058874,3.296496053395111,181.98321424211775,3.2333203908748045,183.6344404884469,183.18037424757392,5.478791658787421,2.3496832712454467,33984200,1.5132999385168482,0.9527371266723054,861824300.0,-10.08291164451246,47.13413368669027,45.7615501877868,118.47993924028495,25.865493191592567,19.408162057968994,0.1922602586657489,3.5285022063681115,184.93272351074216,182.81864190673826,181.11000061035156,179.40135931396483,177.28727770996093,0.12000000000000001,0.0,169.2576328600861,0.03094660551703532,0.04209882461206821,184.44285583496094,182.22642844063895,3.007448920548795
2024-06-13,1,185.06499862670898,176.9550018310547,187.17250061035156,180.8162498474121,184.78437423706055,-0.40670748839055415,2.8439540620163823,-0.737410329795098,2.9956107705882333,182.84875106811523,2.3636249542236327,0.015571503308605152,178.24550094604493,185.64874839782715,0.7782209112528472,0.009819126722512724,1.0132864932352788,1.0163924909144944,0.9977813871237354,0.009573930719928958,64.58823968015079,188.3262832155855,182.63837509155275,176.95046696752,184.69357081821985,2.276982170845272,182.17446408952986,3.3366100495390922,184.52005428435697,183.71994216813724,5.351365583917297,1.973575319185514,39721500,1.5157336860936028,1.1723083597599397,822102800.0,-31.21547543526492,47.13413368669027,45.7615501877868,59.41906146106312,23.32307714092315,22.926264855180953,0.1003741763940305,3.6336147008645168,184.93272351074216,182.81864190673826,181.11000061035156,179.40135931396483,177.28727770996093,0.12000000000000001,0.0,169.3649238259379,-0.0063243144267314255,0.014066654175469005,185.08428519112724,182.4249997820173,2.9231622957536967
2024-06-14,1,183.17250061035156,176.9550018310547,187.17250061035156,180.8162498474121,184.78437423706055,-0.40969988423005815,2.830895477158192,-0.7191005921209923,2.9956118641822735,182.84875106811523,2.349249839782715,0.015501223702870307,178.24550094604493,185.64874839782715,0.8136159565323935,0.00035132330092717143,1.0030034422272456,1.0032534006379217,0.9857125665685745,-0.008337265317250098,55.833923027374595,188.2857909314282,182.62399997711182,176.96220902279543,185.08857073102678,1.5252854543094432,182.30928557259696,3.3360388844538647,184.6580933765892,183.82738626710798,3.788344569229417,1.4680270591840854,25456400,1.5918038161270673,0.7664301868068957,796646400.0,-32.389495048273865,47.13413368669027,45.7615501877868,19.705655753467695,22.558923736453984,23.076119511943077,0.19092886973071033,3.488349874017082,184.93272351074216,182.81864190673826,181.11000061035156,179.40135931396483,177.28727770996093,0.12000000000000001,0.0,169.42617642682248,-0.00347259565410174,-0.007243223448057586,185.42428588867188,182.6328571864537,2.923695221411864
2024-06-17,1,183.20000076293945,176.9550018310547,187.17250061035156,180.8162498474121,184.52124691009521,-0.36397288975334474,2.7817966708787605,-0.6345876140419193,2.995615919370098,182.7800006866455,2.25787467956543,0.015239997089119205,178.24550094604493,185.64874839782715,0.8234234779626319,-0.005996388822950994,1.0036562008940286,0.9999986423694158,0.9874972795122675,-0.01259851906167464,49.678560260644794,188.09621815865205,182.53262481689453,176.969031475137,185.07285635811942,1.5470742966559758,182.4698213849749,3.319762746932046,184.2870897157267,183.58274478443877,1.5326410326285995,1.0411786769606783,35601900,1.6405782598048062,1.0679858187451807,832248300.0,-29.6271083562881,47.13413368669027,45.7615501877868,28.218953006244607,23.428664361954606,21.30054039376633,0.19793671256729786,3.509182880178543,184.93272351074216,182.81864190673826,181.11000061035156,179.40135931396483,177.28727770996093,0.12000000000000001,0.0,169.51231102380729,-0.016037635192742372,-0.001302254417742254,185.28999982561385,182.7692860194615,2.903614139882528
2024-06-18,1,183.06749725341797,176.9550018310547,187.17250061035156,180.8162498474121,184.52124691009521,-0.3268936046919047,2.757812582752468,-0.5868970266433351,2.995617872615285,182.7800006866455,2.203999710083008,0.015113061575983714,178.24550094604493,185.64874839782715,0.8172162050353049,-0.0068172663242864265,1.0032263888617068,0.9962653682193479,0.9892759742424364,-0.019193680694854165,49.62093410021163,187.99437501291703,182.4787498474121,176.96312468190717,184.8378562927246,1.7255755003997502,182.52196393694197,3.3232556454521025,184.01120449485288,183.3526464968837,-0.06000796984751429,1.242039419666389,36659200,1.6397663400167937,1.0896555516501611,795589100.0,-38.25969849161493,47.13413368669027,45.7615501877868,13.882579432621364,22.046451001947002,20.043879277588676,0.23261436500424268,3.4628107720611943,184.93272351074216,182.81864190673826,181.11000061035156,179.40135931396483,177.28727770996093,0.02,1.0,169.5962309158884,-0.0236073186444834,-0.02271998318971832,185.07714189801897,182.82571411132812,2.89611184522407
2024-06-20,1,184.56000137329102,176.9550018310547,187.17250061035156,180.8162498474121,183.84062671661377,-0.2811806789086306,2.724382357006466,-0.5126590396188044,2.9956205717336255,182.7274990081787,2.134499740600586,0.0149355493695065,178.24550094604493,185.64874839782715,0.8408661100099335,0.0038521613131771004,1.0117908028063305,1.00179396860372,1.0012178978062145,-0.01395770868338797,51.06621919208027,187.8580145919426,182.40924987792968,176.96048516391676,184.6982138497489,1.6988657459504135,182.8417854309082,3.2856679288067117,183.7746477022119,183.11022656017758,-0.8905734469228019,0.4003541352876634,44726800,1.5691784226020713,1.341643941877734,840315900.0,-15.53866224358829,47.13413368669027,45.7615501877868,75.2345859337946,24.883152774841356,18.487343642482955,0.21774930546546986,3.486181862341961,184.93272351074216,182.81864190673826,181.11000061035156,179.40135931396483,177.28727770996093,0.02,0.0,169.7144754278326,-0.004227049540975081,-0.00603530230096155,184.94000026157923,183.30999973842077,2.999388397046819
2024-06-21,1,188.00500106811523,176.9550018310547,187.17250061035156,180.8162498474121,184.59812545776367,-0.3647927179596964,2.764308740689644,-0.5864843957172798,2.9956173613156474,183.11999893188477,2.228849697113037,0.01514532043174024,178.24550094604493,185.64874839782715,0.8270538224601518,0.005502578614767997,1.0300571502862947,1.0181984682880414,1.022805793654623,0.015886323525371004,55.49198820425604,188.04761753478502,182.51900005340576,176.9903825720265,184.89178575788225,2.0074843219418717,183.63107109069824,3.083778242368243,183.98170659041904,183.13764087761353,-0.5268461140573263,2.4863609202147274,72931800,1.582464989922944,2.0500016021830163,913247700.0,-1.496983077135688,47.13413368669027,45.7615501877868,141.97311312222584,28.82048590692213,17.190082619218533,0.3058767460611104,3.481454284609234,186.1270386352539,184.1764785461426,182.5999984741211,181.0235184020996,179.07295831298828,0.02,1.0,169.93984440783427,0.028558994438921292,0.011718136061632151,185.20428684779577,184.21285683768136,3.318429200157072
2024-06-24,1,187.80750274658203,176.9550018310547,188.00500106811523,180.8162498474121,184.80062294006348,-0.2044189558508448,3.0072324973433493,-0.6961383140589477,2.995596704527335,183.11999893188477,2.4293246078491224,0.01645618747821258,178.24550094604493,186.70224800109864,0.7623215018166012,0.030799809645273887,1.0277208289491995,1.0145491410566831,1.018473340865899,0.025304028283645863,66.3968583031261,188.7562149489103,182.74174995422362,176.72728495953695,184.98250034877233,2.1378377385405987,184.35553577968054,2.7473988054561613,184.98783142086015,183.58845213031543,0.7259594822124231,6.244524948557475,50610400,1.7242718624825688,1.3894996824849473,862637300.0,-37.29391199366173,47.13413368669027,45.7615501877868,107.63631273933679,28.989118947441415,15.27622106356455,0.2622310142907148,3.637784100333741,187.56384057617188,185.4380809326172,183.72000122070312,182.00192150878905,179.87616186523437,0.04,0.0,170.0864805606264,0.010399671262249166,0.009465296610088597,185.01571655273438,184.72928619384766,3.3299871902066145
2024-06-25,1,186.85249710083008,176.9550018310547,188.00500106811523,180.8162498474121,185.183123588562,-0.22584376970869224,3.2010661009278243,-0.8584793043087906,2.9955790887431455,183.1862506866455,2.610699768066405,0.017490945849366817,178.24550094604493,187.23600082397462,0.7976244052126356,0.03597927520015403,1.0209807625223042,1.007705308396103,1.0082259370126974,0.019937207001526902,66.7314164124086,189.4148822552614,183.01275005340577,176.61061785155013,185.23785727364677,2.2529881251072097,184.9657140459333,2.1944069971505247,185.69036079347495,184.05791290714242,0.3392603796817309,5.708781026797183,45898500,1.6972796159400672,1.228984416021875,816738800.0,-38.04084622130079,47.13413368669027,45.7615501877868,87.80594447797918,27.03401126014905,14.245949764588469,0.2486420254197988,3.622227477022253,188.109,186.3205,184.875,183.4295,181.641,0.04,0.0,170.21404470911938,0.012387258554488856,0.014592141034211536,185.37428719656808,185.22928619384766,3.3426634307172547
2024-06-26,0,190.39749908447266,176.9550018310547,188.00500106811523,180.8162498474121,185.81562328338623,-0.3776606208550457,3.2798259784685,-0.8818737516678015,2.995571795603142,183.25500106811523,2.6761247634887697,0.017894079595890042,178.24550094604493,187.23600082397462,0.8235434888880945,0.03260522916833033,1.0387709670702812,1.0260959973036086,1.0233206178602992,0.04003988660481794,62.619367367077835,189.85077687301367,183.29112491607665,176.73147295913964,186.26999991280692,2.749385065417365,185.67928532191686,2.2222458480788085,185.97344951217053,184.43126567785407,0.9658760367359482,4.790811318348539,65103900,1.7159144680095564,1.6648257081766047,881842700.0,-8.762903394349754,47.13413368669027,45.7615501877868,174.80658775434725,33.59785120446879,12.058892281434723,0.26174225025378506,3.9735077301509945,191.5951226196289,189.61244235229492,188.01000213623047,186.40756192016602,184.42488165283203,0.06,0.0,170.44172753562756,0.05907774846009839,0.05188527207666435,186.79571533203125,186.11000061035156,4.007741565320959
2024-06-27,0,196.7249984741211,176.9550018310547,190.39749908447266,181.85500144958496,186.70062255859375,-0.2834934346574106,3.575724769101782,-0.6849888745038859,2.9955425847115924,183.93500137329102,2.912624549865723,0.019458310291872352,178.24550094604493,187.82725257873534,0.7761805106768028,0.04420372929948152,1.0705343139257155,1.0580594769797484,1.0490629127713305,0.06591350785821226,69.93995754255995,190.91482443902146,183.76337490081787,176.61192536261427,188.2021424429757,4.455419663479562,186.63749940054757,3.592071712554045,187.06501239891654,185.2444652237396,3.9443685324197566,5.537462575654311,74397500,1.8496751348696925,1.8046719043530561,956240200.0,-10.687383223522758,47.13413368669027,45.7615501877868,243.63219272896075,38.688797778551816,10.761008272566002,0.2992427073228525,4.134689780273738,195.4456774902344,192.72715820312501,190.52999877929688,188.33283935546876,185.61432006835938,0.08,0.0,170.76516894082613,0.06313809572614537,0.08227125838728412,188.76571655273438,187.0278581891741,5.010207643988004
2024-06-28,0,195.58250045776367,176.9550018310547,196.7249984741211,182.40249824523926,186.93249797821045,0.5500687154899181,4.535067363558262,0.7299404181465254,2.9954313721880874,184.63624954223633,3.4174745750427236,0.024582609321182745,178.24550094604493,188.24425086975097,0.6686280946947362,0.09241596476088876,1.060166875898597,1.0465379197190405,1.0296118909333736,0.040304775652766134,80.84585367979882,193.5528844753465,184.48274974823,175.41261502111348,189.99000004359655,4.561334707250944,187.41392816816057,4.257178182595385,189.45928919438933,186.7635296337274,7.38264064129725,7.318202498679756,76930200,2.161852334685552,1.7640901836880212,879310000.0,-35.39204117087891,47.13413368669027,45.7615501877868,169.65039013878,34.60101018372496,12.45265596483119,0.227443297857234,4.292930613341684,195.4456774902344,192.72715820312501,190.52999877929688,188.33283935546876,185.61432006835938,0.08,0.0,171.0616375524702,0.022054147073000685,0.038420170134262736,190.25714547293526,187.66714368547713,5.1589071006896186
2024-07-01,0,195.4525032043457,176.9550018310547,196.7249984741211,183.14624977111816,187.33125114440918,0.514974512567556,5.015807471563129,0.20012481759786693,2.9953673151596716,184.8887481689453,3.741024799346923,0.027074751142015595,178.24550094604493,190.91599922180177,0.7312657181056164,0.10526686690943796,1.0550301051911224,1.0399894821957814,1.020783628190249,0.040706576393167104,79.30910752020655,195.28936469135624,185.25774974822997,175.2261348051037,191.5460717337472,4.247336172176752,188.12214279174805,4.7205125853643555,190.97694067088815,187.95976778681032,6.836278089835546,5.884822565486868,41192000,2.0083741952612857,0.9641554745174775,838118000.0,-14.17830334021713,47.13413368669027,45.7615501877868,168.60789262503616,31.507135180730423,11.339192490617258,0.26359387823345587,4.377722945450442,195.4456774902344,192.72715820312501,190.52999877929688,188.33283935546876,185.61432006835938,0.08,0.0,171.22551574932885,0.06267170967830005,0.042944759036139715,191.84285845075334,188.3914293561663,5.3048863999429
2024-07-02,0,198.40999603271484,177.66499710083008,196.7249984741211,183.19312572479248,187.85687732696533,0.5527411183048855,5.104194299974531,-0.16887549783338685,2.9953582496899727,185.30124855041504,3.900137710571289,0.027414987327600334,180.1977512359619,195.4655029296875,0.7573259783264339,0.1001182359709307,1.0656740725824743,1.048872655473632,1.0280204162537925,0.06185359634582821,78.55327816997277,196.3910134168436,186.18262481689453,175.97423621694546,193.03249958583288,4.607008942246787,188.96214267185755,5.43122329244274,192.09509100977107,189.0015375709453,5.901875677289098,5.3439357605694795,45600000,2.0230317198836536,1.0491424295975964,883718000.0,-2.2383803594435348,47.13413368669027,45.7615501877868,179.08779688366164,32.66684733002923,10.508267036486272,0.27529053382544394,4.3864572089007074,195.89643469238283,193.0917759399414,190.8249969482422,188.55821795654296,185.75355920410155,0.1,0.0,171.42372062518507,0.07330687952434878,0.07776037132212793,193.4028581891741,189.30357251848494,5.71625714531725
2024-07-03,0,198.57999801635742,178.31000137329102,198.40999603271484,183.28250122070312,188.6031255722046,0.6784414569391617,5.3688772799518185,-0.4084591884733486,2.9953236157120666,186.09374809265137,4.184087772369386,0.02867685541791018,182.80149765014647,195.6967502593994,0.7334345706078021,0.11272499862385509,1.0606779769894605,1.041397891560247,1.0167243870744256,0.04297587400690839,81.57350403591684,197.9576293233924,187.21987476348878,176.48212020358514,194.57142748151506,4.3635467560494465,189.77696391514368,5.970966133531316,193.67756328097192,190.32702268838534,5.534424566094294,6.300561728230172,31597900,2.0708495324331158,0.7233281624904471,915315900.0,-14.783954196605583,47.13413368669027,45.7615501877868,139.69255604057045,30.895145360740774,9.93834618632705,0.23380885886208314,4.306708975596029,195.89643469238283,193.0917759399414,190.8249969482422,188.55821795654296,185.75355920410155,0.1,0.0,171.55612756520057,0.020556767289872546,0.06037351197324462,195.1199994768415,190.06785801478796,5.764072246326804
2024-07-05,0,199.34249877929688,180.40750122070312,198.57999801635742,184.24750137329102,191.66125011444092,0.7234659968767138,5.5028164754022715,-0.8248676745797945,2.995307842732255,186.75124740600586,4.574724769592285,0.029234010638247734,183.1620002746582,196.89349822998048,0.7798371820240794,0.10073027270314448,1.0590178240576047,1.0369608337221903,1.0121477509596564,0.013305377178691957,81.22456917452206,199.23900754644663,188.2333745956421,177.22774164483755,196.35571343558175,3.031466704937656,190.79678535461426,6.313709229077371,194.91816025053265,191.54490489498076,5.735923811473737,6.094643908056528,39858900,2.0646392858913902,0.9044211896348565,955174800.0,-2.845333676452131,47.13413368669027,45.7615501877868,133.67213437076197,30.225899931202918,9.439287391570828,0.22546853380069948,4.21051417040052,195.9881226196289,193.16594235229493,190.88500213623047,188.604061920166,185.78188165283203,0.12000000000000001,0.0,171.7302824033516,0.010866787112250753,0.033004490313021516,197.07142857142858,191.22285788399833,6.020983376341116
2024-07-08,0,199.62249755859375,183.06749725341797,199.34249877929688,184.67437362670898,195.4850025177002,0.6474998773092644,5.700269391262403,-1.1637343650683436,2.9952811503710155,187.01249885559082,5.022912273406979,0.030131439056425423,183.19725074768067,198.4269962310791,0.8243763247286662,0.08746111661063932,1.055198045323629,1.0304931617629376,1.0108824640680218,0.020656229935573922,81.28296982247855,200.5806632560966,189.18012447357177,177.77958569104692,197.67357036045618,1.739400012954455,191.97178513663155,6.316356972172674,196.04266311656897,192.58006402343236,6.684417854863825,7.714857081855202,34767300,2.0131336389845447,0.7858619752390177,989942100.0,-9.559579932626093,47.13413368669027,45.7615501877868,113.61724516988929,29.65786444616184,8.911769462878963,0.18211405104094355,4.141189836604765,196.48471795654297,193.56763858032227,191.20999908447266,188.85235958862305,185.93528021240235,0.14,0.0,171.87994687730375,0.03125481648710382,0.007278176083875434,197.88285609654017,192.33928571428572,6.291735884239758
2024-07-09,0,199.5900001525879,183.06749725341797,199.62249755859375,184.97687339782715,195.86812496185303,0.468953940347038,5.9629747463150755,-1.4124706117401948,2.995242061212286,187.4900016784668,5.414649734497073,0.03138477975861608,183.19725074768067,198.65624809265137,0.8528925809572762,0.08072003807087022,1.0504971869421589,1.0241831769883063,1.0065992109338724,0.02116881022453021,81.20732352784201,201.92169877546706,189.99574928283693,178.0697997902068,198.08285631452287,1.8144505141431384,193.1424993787493,6.079965482037139,196.94846521040623,193.3010141541692,4.845125864824667,8.980604017212698,32700100,2.012341964362433,0.7352483383607002,957242000.0,-9.408195287759561,47.13413368669027,45.7615501877868,101.41585326259239,28.843476364930773,8.667057344566384,0.16971037060696573,3.9539592981207603,196.5342759399414,193.64785531616212,191.31499481201172,188.98213430786132,186.09571368408203,0.14,0.0,172.02010484313797,0.010851924050537143,0.031513564491025374,198.09571184430803,193.4307141985212,6.435777819868304
2024-07-10,0,199.39749908447266,183.06749725341797,199.62249755859375,185.41937351226807,197.14624786376953,0.27637037778652773,6.181469304062925,-1.5819508743422965,2.995208576432842,187.90625190734863,5.738799743652345,0.03240789281906488,183.19725074768067,199.36724891662598,0.8734950557702106,0.07573941544990082,1.0453910649482367,1.0170461946609601,1.0014489600133798,0.00497708316870793,80.75829658834225,203.10256301303306,190.73962440490723,178.3766857967814,198.62785611833846,1.4804682090858463,194.3089280809675,5.540961552669311,197.61517644877915,193.96316359438057,1.4563485579814015,8.946506179799133,32883800,2.0205318985052587,0.7407200507631936,924358200.0,-7.6298917104627595,47.13413368669027,45.7615501877868,85.95987060560886,27.546554732408914,10.804263172056707,0.16224907055003412,3.8443890167772654,196.83871795654298,194.14063858032227,191.95999908447266,189.77935958862304,187.08128021240233,0.14,0.0,172.15732500421237,-0.001050033569335973,0.013133855872068825,199.02999659946985,194.64357103620256,6.647657827645949
2024-07-11,0,197.06750106811523,183.06749725341797,199.62249755859375,186.25374794006348,198.4524965286255,0.08267363501698657,6.334441388405135,-1.6704313427923954,2.995185177165091,189.20125007629395,5.980887184143066,0.033089664873407754,183.19725074768067,199.41674919128417,0.8921661988039786,0.06829628464831934,1.029435299491447,0.9987709795880462,0.98876605798333,-0.007616562409863636,79.18632928893918,204.10150721223505,191.4326244354248,178.76374165861455,198.85857009887695,0.9246581239685485,195.2023209163121,4.808032993170575,198.05908985348657,194.53366710644096,1.9505828066314344,8.920208161500824,44565000,2.028852067129336,0.9846580923086304,879793200.0,-38.75233641265471,47.13413368669027,45.7615501877868,45.909711756862386,23.989608068664126,17.825807144064697,0.1189670953214673,4.099079293775986,197.45467810058594,195.13765881347655,193.26499938964844,191.39233996582033,189.07532067871094,0.02,1.0,172.3197751930003,-0.012854867823314797,-0.02474998474121094,198.7228546142578,195.28285653250558,6.602306302822381
2024-07-12,0,194.89750289916992,183.06749725341797,199.62249755859375,186.4056224822998,198.4524965286255,-0.10821519364570509,6.348051084921296,-1.6717879897054466,2.995184649912045,192.92500114440918,6.02349967956543,0.033070775464065075,183.19725074768067,199.41674919128417,0.9125708158180778,0.05286567431378555,1.0153370649765858,0.9844451810320273,0.9793647542597255,-0.022298285149160546,66.25930616874399,204.64960177311406,191.9534996032715,179.25739743342893,198.3567853655134,1.7727697309874302,195.69464247567313,4.344948704675367,197.79615134182217,194.64619639803362,0.8262866104513638,6.776928696227388,30598500,2.136940885501758,0.6786082437644821,849194700.0,-42.280992561938795,47.13413368669027,45.7615501877868,29.484179830939425,22.857199442508712,16.98435539044104,0.10244863418981101,3.994857964383194,197.45467810058594,195.13765881347655,193.26499938964844,191.39233996582033,189.07532067871094,0.02,0.0,172.42479300333903,-0.027549972534179568,-0.015689007045809108,197.93571254185267,195.6692853655134,6.506769508689053
2024-07-15,0,193.57500076293945,183.06749725341797,199.62249755859375,186.4056224822998,198.4524965286255,-0.2693016622136187,6.280049651687699,-1.58415729547455,2.9951975376801934,195.1750030517578,5.893024883270263,0.03265081534578588,183.19725074768067,199.41674919128417,0.903871571098893,0.053130004838429175,1.006422234858057,0.9786684953265264,0.9770840199573392,-0.030294665529265852,58.99889874825846,204.89984902108776,192.3397497177124,179.77965041433706,197.64178575788225,2.5197005159396806,196.10660661969865,3.7757468512565486,197.05632699706956,194.481574306979,-1.770320651065264,3.6661268540178336,40683200,2.1410281249354135,0.9013038079859914,808511500.0,-53.7388870946219,47.13413368669027,45.7615501877868,5.705780865106946,20.718793403741234,20.631672009616537,0.11263922635215692,4.092369314291097,197.47591723632812,195.17203741455077,193.30999755859375,191.44795770263673,189.14407788085938,0.04,0.0,172.55258954285242,-0.032966994263463834,-0.03639999389648438,197.23999895368303,196.17999921526228,6.1828279760749325
2024-07-16,0,194.36750030517578,183.06749725341797,199.62249755859375,187.56875133514404,198.4524965286255,-0.4241951019538913,6.057075645243349,-1.3782677571032955,2.9952362741613845,195.1750030517578,5.505949859619141,0.031422030945708126,183.19725074768067,199.41674919128417,0.8752810710583421,0.05679073069333868,1.0083119259415814,0.9836735547744762,0.9871105658396843,-0.026166139803694977,55.590733108671984,204.87940111501064,192.76524982452392,180.6510985340372,196.93107169015067,2.6578833427577937,196.6433925628662,2.755183023448818,196.1809555187822,194.25239373928747,-2.520393445167472,3.07096251854208,33994700,2.110829777186117,0.7460691389107623,842506200.0,-54.7522847326339,47.13413368669027,45.7615501877868,8.815178270045326,19.889534944516313,19.062268355428422,0.061882103225300245,4.11291384924896,197.6741563720703,195.49291601562498,193.72999572753906,191.9670754394531,189.78583508300778,0.04,0.0,172.66181853144937,-0.03170458604161408,-0.031461634928501604,196.24285670689173,196.65714263916016,5.789116190788821
2024-07-17,0,189.2125015258789,183.06749725341797,199.62249755859375,187.95562648773193,198.4524965286255,-0.5753415851214565,5.6482000480347345,-1.1018178397560614,2.9953029746918904,195.1750030517578,4.938499927520752,0.029216087177588314,184.42400131225585,199.41674919128417,0.8475169841942891,0.060957966679743944,0.9787275402175423,0.9581107529056143,0.9660550121253036,-0.0510788631018837,57.98038172207039,204.6213999053346,193.32499980926514,182.02859971319566,195.44392939976282,3.634039763465718,196.5587498801095,2.9715327603110913,195.72146785737883,194.26699469461448,-2.495703878794652,4.021890700390494,48076100,2.107820878641659,1.040860780288897,794430100.0,-87.24531050298872,47.13413368669027,45.7615501877868,-75.01563260873557,17.578300645882784,27.178207022050366,0.025754447628870206,4.321279197482881,197.61043896484375,195.38978021240234,193.59500122070312,191.80022222900394,189.57956347656253,0.06,0.0,172.7752868169697,-0.0593623354967836,-0.05723890775421161,194.6199994768415,196.25142778669084,5.520416787861703
2024-07-18,0,186.11749649047852,183.06749725341797,199.62249755859375,188.910626411438,198.4524965286255,-0.5545272174988917,5.247060147472738,-1.0183251360010463,2.995363165688144,195.1750030517578,4.552749786376955,0.02709899658997985,186.62324752807618,199.41674919128417,0.7743638936411027,0.03356687759790853,0.9612234777145308,0.9468484204406973,0.9602396773897885,-0.05556474060049055,42.08250449714996,204.11974514235757,193.6256248474121,183.13150455246662,193.5192860194615,4.52953553817034,195.8010711669922,4.073791898237951,194.07803315443118,193.65872371444772,-5.21484109257739,-0.622380842338695,51043600,2.4660659369517393,1.0881638338526831,743386500.0,-88.35441492780855,47.13413368669027,45.7615501877868,-132.61980502814012,15.332093304971307,30.754335844540847,0.0027279966614198255,4.600475896679822,196.5389969482422,193.6554969482422,191.3249969482422,188.9944969482422,186.1109969482422,0.08,0.0,172.86726937844875,-0.057933877851615745,-0.08028426760674069,192.39285714285714,195.2442844935826,5.427369122080377
2024-07-19,0,182.32749938964844,184.56000137329102,199.62249755859375,188.910626411438,198.4524965286255,-0.4364432358358683,4.975266888267197,-1.2553479688824691,2.995401373705074,195.1750030517578,4.36974983215332,0.02567506984167758,186.77899703979492,199.41674919128417,0.728777282280372,0.00843896351104436,0.9409085755634827,0.9334857311262253,0.9514360656886911,-0.06449545695834069,34.542284048700395,203.72865858579954,193.77812480926514,183.82759103273074,191.0807146344866,5.356871591416604,194.85428537641252,5.4397741908085475,192.0865393150114,192.7940943543126,-6.750089509399046,-5.392045782650231,43081800,2.562476007006444,0.9200448641944092,700304700.0,-85.68039451464887,47.13413368669027,45.7615501877868,-159.59952855317206,14.1885749748769,30.534051327950827,-0.023049314004046147,4.616155761805537,196.2227578125,193.14361834716797,190.65499877929688,188.16637921142578,185.08723974609376,0.1,0.0,172.92966986914988,-0.05840917419661895,-0.06111252490358722,190.01285879952567,194.52142769949776,5.6781729384588555
2024-07-22,0,183.77249908447266,182.32749938964844,199.62249755859375,188.910626411438,198.4524965286255,-0.572930594863136,5.200766442332935,-0.9093043506190499,2.995369756649816,195.1750030517578,4.5036999511718765,0.02685423885968113,186.77899703979492,199.41674919128417,0.7337983321699303,-0.030198673685333546,0.948912173037559,0.9491523191699471,0.9717242987575051,-0.050639295569325005,25.923982965395833,204.06803259474887,193.666499710083,183.26496682541713,189.18142863682337,5.235994510735421,194.01999936785018,6.185519821724052,189.65130380719722,191.6212656599015,-8.560789264258872,-6.777191741128021,39931900,2.5719804281704444,0.8839230503346208,740236600.0,-88.43052221387777,47.13413368669027,45.7615501877868,-138.090888148617,13.811418058708165,29.27540708393888,-0.13696807452849366,4.470714999942832,196.2227578125,193.14361834716797,190.65499877929688,188.16637921142578,185.08723974609376,0.1,0.0,172.99054029152092,-0.052770849442340007,-0.06139134199276859,188.2271445138114,193.4749995640346,6.113713298953016
2024-07-23,0,185.8650016784668,182.32749938964844,199.62249755859375,188.8612518310547,198.4524965286255,-0.6039355706795386,5.504100333426098,-0.9691363859088122,2.9953250952150614,195.1750030517578,4.769662685394289,0.028451598050949038,185.88299674987792,199.41674919128417,0.7895095562606018,-0.021484784170491874,0.9607667010319605,0.9678830489871411,0.9930834518947921,-0.04374444602806149,30.973650176091702,204.46307527775306,193.45487461090087,182.44667394404868,187.89107131958008,4.675536686717028,193.12392834254675,6.4054017569735695,188.17614906999927,190.80060840977862,-6.746420344086689,-5.97587850162328,47537700,2.6013682753852847,1.055874077925678,787774300.0,-70.12800310240407,47.13413368669027,45.7615501877868,-93.6927018631206,19.022876136876658,26.192781863710927,-0.0871647577405572,4.639950672822497,196.2227578125,193.14361834716797,190.65499877929688,188.16637921142578,185.08723974609376,0.1,0.0,173.08339780540314,-0.03424515834649522,-0.0327417887018772,187.07285853794642,192.50428553989954,6.061755944204932
2024-07-24,0,182.4724998474121,182.32749938964844,199.62249755859375,188.6225004196167,198.4524965286255,-0.5882954325328054,5.6188393207362655,-1.0570362243225142,2.9953075283578836,195.1750030517578,4.895925254821779,0.029059292082138647,185.65575141906737,199.41674919128417,0.8167973479031165,-0.005284892830896475,0.9437040939140313,0.9570570629831067,0.9838967114441782,-0.03562133381310939,37.939945834434305,204.59542819896765,193.3577495574951,182.12007091602257,186.30499976021903,4.293568092605313,191.97339275905065,6.785341749707109,187.6019745922252,190.43685900542079,-4.6344879161310155,-6.322763270545887,41532400,2.6442324236857413,0.9269833546577776,746241900.0,-96.586053363084,47.13413368669027,45.7615501877868,-139.87044807857401,17.301839455210526,28.57283796072109,-0.10254996004947739,4.7370977417977915,196.2227578125,193.14361834716797,190.65499877929688,188.16637921142578,185.08723974609376,0.1,0.0,173.13818528897428,-0.03777997723320059,-0.06315408854824837,185.37428719656808,191.30714307512557,6.497820804461962
2024-07-25,0,180.8650016784668,182.32749938964844,199.62249755859375,188.4387502670288,198.4524965286255,-0.6278646440775641,5.944065272075828,-1.0587030764770755,2.9952554892617202,195.1750030517578,5.180625076293947,0.030776140373011428,183.6424991607666,199.41674919128417,0.8208956033443501,-0.041623441879058004,0.9364511366271606,0.9571222638092596,0.9823693444063423,-0.028221391922066963,29.914126838177737,205.02688023897585,193.1387496948242,181.25061915067258,184.3760713849749,2.862186610190419,190.65357153756278,7.034184938034043,186.3336587583988,189.70066913744736,-5.7355034853513756,-8.111339676626699,44464200,2.6009626929463874,1.0158174753448792,701777700.0,-87.4999843659909,47.13413368669027,45.7615501877868,-139.04506963962976,15.513259993173724,30.87523998561419,-0.16576325814402718,4.905876931247992,195.44159838867188,191.87919927978515,189.0,186.12080072021485,182.55840161132812,0.12000000000000001,0.0,173.18307626319373,-0.02122445657950678,-0.04299466230600722,183.49285888671875,189.86785779680525,7.116578127422007
2024-07-26,0,181.5800018310547,180.8650016784668,199.62249755859375,186.0543727874756,198.4524965286255,-0.5923655929106307,6.500866285713264,-1.2153827215870994,2.995159011436295,195.1750030517578,5.80023740768433,0.03374231594110277,182.45799980163574,199.41674919128417,0.8520710608753822,-0.08062013937563028,0.9424789745075074,0.9692162627213214,0.9919125179821767,-0.004099752155303227,22.521121112650494,205.66385739595046,192.66212482452391,179.66039225309737,183.28571428571428,2.051725751835938,189.36482184273856,6.916383131251832,184.97840070009295,188.90656066799454,-6.946891124035013,-9.269221171591482,29506000,2.0666343235330817,0.7105211479735061,731283700.0,-76.02021067010915,47.13413368669027,45.7615501877868,-102.5044510218066,14.74124960056929,29.338747581468404,-0.1821809293783873,4.794027633974467,194.96028631591798,191.48986569213866,188.68500518798828,185.8801446838379,182.40972406005858,0.12000000000000001,0.0,173.22010190492512,-0.0034402056791056346,-0.006802721088435374,182.71714564732142,188.66857256208147,7.300741528425056
2024-07-29,0,183.54249954223633,180.8650016784668,199.62249755859375,185.34187602996826,198.4524965286255,-0.3939037067538977,6.855885102881798,-1.4694889494006749,2.9950909153797514,194.63250160217285,6.302649841308596,0.03572543481844514,182.25274963378905,199.41674919128417,0.8863260746874577,-0.07159382150210747,0.9564243719683165,0.9867054051210009,1.0034524917332306,-0.00125154494487556,25.59025182014568,205.6166451981342,191.9048749923706,178.193104786607,182.91785757882255,1.6511203105564538,188.218571799142,6.4020630104433,184.1271422151671,188.19855238157137,-4.033824209961258,-9.038307780035254,33270100,2.093523139727756,0.8456150909942136,764553800.0,-72.73117356790392,47.13413368669027,45.7615501877868,-77.2413800312703,16.612626522174278,28.263920447375302,-0.13064130959263387,4.62088147175618,194.73108398437503,191.30446380615237,188.53500366210938,185.7655435180664,182.33892333984375,0.12000000000000001,0.0,173.26840903225735,0.003560634815766628,0.0003821987853627614,182.6385737827846,187.51571546282088,7.512013483952284
2024-07-30,0,182.9175033569336,180.8650016784668,199.62249755859375,183.71499919891357,198.4524965286255,-0.19869343997610436,7.032849791803239,-1.6336585615792052,2.9950546625252232,193.97125053405762,6.59708734512329,0.036762906954569234,182.25274963378905,199.41674919128417,0.9116117553096832,-0.060935539155809425,0.9561670383050878,0.9886777941523298,1.0002871103882285,-0.015858275064781546,32.72006379926647,205.3685745302007,191.30287494659424,177.23717536298778,183.00214385986328,1.6308963677141153,187.04142924717493,5.660639726126813,183.98612117231966,187.9378040244053,-1.3835329814754522,-8.040232776232848,39508600,2.175971888116813,1.0063298377563576,725045200.0,-79.07966166708928,47.13413368669027,45.7615501877868,-79.31478844136907,14.995076605999861,30.019712487781348,-0.17645296310259811,4.753676046837644,194.73108398437503,191.30446380615237,188.53500366210938,185.7655435180664,182.33892333984375,0.12000000000000001,0.0,173.31889789091812,-0.025213222766528487,-0.004601458909055529,182.4357169015067,186.2242878505162,7.629364906611111
2024-07-31,0,186.10750198364258,180.8650016784668,199.62249755859375,183.38625049591064,198.4524965286255,-0.012556938657581623,7.191864343971474,-1.7136903354926347,2.9950206316671086,191.39375114440918,6.80887451171875,0.03771769719831496,182.25274963378905,199.41674919128417,0.8989419147963297,-0.07808322657910224,0.9760398792891462,1.0121840704951326,1.0210231254673134,0.019920821708861114,29.086918923229668,205.05985364216662,190.67612495422364,176.29239626628066,183.33571570260185,2.009554198419024,186.2585721697126,4.870057167092358,183.73371529314397,187.54102461922864,0.3235957106087824,-8.26489590050349,41667300,2.0057716581740297,1.0666568023744956,766712500.0,-48.637756048665075,47.13413368669027,45.7615501877868,-34.34268483437887,16.67940999203003,27.270489100407655,-0.2006458596480334,4.8591279685212925,191.9424769897461,189.04875814819337,186.70999908447266,184.37124002075194,181.47752117919921,0.02,1.0,173.3957786571289,0.03400980940225917,0.0030577332451688964,183.06857299804688,185.64785875592912,7.293409722393166
2024-08-01,0,186.45750045776367,180.8650016784668,199.62249755859375,183.38625049591064,197.44562530517578,0.1694255597630566,7.028336363745654,-1.6408184212268924,2.9950497541403127,187.6649990081787,6.589099636077881,0.03697937164613128,182.25274963378905,199.41674919128417,0.9051458139024537,-0.06280842057258687,0.9810402986976136,1.0158030143907326,1.0188795166602,0.030920845533393804,39.81279203151599,204.1176729792613,190.06100025177003,176.00432752427875,183.42035838535853,2.141959783389384,185.65571485246932,4.1938349406809206,184.33876696319206,187.4309360718407,1.270594300454399,-5.561545676008951,70435600,2.188864472929168,1.7177177411527376,837148100.0,-63.31984266965787,47.13413368669027,45.7615501877868,-39.50050648570633,18.35384212762394,23.959264043980127,-0.21477240356180485,5.135620868757086,191.9424769897461,189.04875814819337,186.70999908447266,184.37124002075194,181.47752117919921,0.04,0.0,173.51444399208228,0.02346400376697355,0.017917411161623088,182.73428780691964,184.90357317243303,7.129463415327896
2024-08-02,1,165.99250030517578,180.8650016784668,199.62249755859375,183.38625049591064,195.44000244140625,0.3504906655539696,6.786068012252908,-1.4789924208831544,2.9950932549963976,186.2874984741211,6.222099761962892,0.03581891465639168,182.25274963378905,199.41674919128417,0.8884331183050623,-0.0646374877431375,0.8761585046446146,0.9041441331058313,0.901540286073142,-0.08584371279157599,40.317569156506124,203.02701139834613,189.45487537384034,175.88273934933454,181.06607273646765,6.970905313288057,183.68553624834334,6.1907606987331665,184.87986443220387,187.41541166251034,0.3187790998554185,-4.330482595137547,141448400,2.1766946193402767,3.069306017611224,695699700.0,-79.62297626405368,47.13413368669027,45.7615501877868,-223.81965238436086,13.572393414396165,41.33220435772476,-0.09337842441641564,6.4487966515085775,188.1074769897461,182.84125814819336,178.58499908447266,174.32874002075195,169.06252117919922,0.02,1.0,173.36450105760693,-0.08000003344392126,-0.06644432472330984,180.88714381626673,183.1307155064174,8.03794818695222
2024-08-05,1,157.45000457763672,165.99250030517578,199.62249755859375,182.80625247955322,194.50000095367432,-0.46772775552605994,8.118254765286098,0.48161475306223034,2.9947904482302627,186.11249923706055,6.543099975585937,0.04323109977881259,181.5085018157959,199.41674919128417,0.5703791978976188,-0.16846797162001642,0.8384482939826088,0.8653131641229153,0.8698727018837736,-0.14216050794598267,18.778179318988613,204.02388498070647,187.78737545013428,171.55086591956209,177.72107315063477,11.335168102183852,181.04857226780481,8.660611071994989,180.160585794691,184.62737378324996,-9.03149765362852,-14.248999276276603,83149400,4.909565280897567,1.714282062150853,612550300.0,-76.45733456411477,47.13413368669027,45.7615501877868,-259.35691189229743,11.364189525140693,43.53646029283895,-0.02589257878988887,7.151742021828873,182.14708154296875,176.3114613647461,171.59500122070312,166.87854107666016,161.0429208984375,0.04,0.0,173.19820020170613,-0.12106983103306257,-0.11769860672624144,178.1971435546875,180.84500122070312,9.446553402554775
2024-08-06,1,161.81499862670898,157.45000457763672,199.5900001525879,182.4362497329712,193.77312564849854,-1.0765743047094287,10.023674991248676,1.4229011444260813,2.994243532943224,185.9862518310547,7.0188747596740715,0.05398396395927296,179.37775154113768,197.30050086975098,0.6066507047133121,-0.21113279995357914,0.871478281325028,0.9023560421013407,0.9205278986275804,-0.11536624075305968,15.158956030117864,205.7261007835838,185.67875080108644,165.63140081858907,174.89750126429968,12.604365541665848,179.09160777500696,9.706243302187286,174.49345308571088,180.97027334168365,-12.946118311189993,-18.993656691357877,59950800,5.114525221414857,1.202227028169538,672501100.0,-73.53169886770328,47.13413368669027,45.7615501877868,-197.21703396935234,12.747713251054288,40.67521752067245,-0.002702357959522905,7.1080466145416334,181.39836480712887,175.70582400512694,171.1050033569336,166.50418270874022,160.81164190673826,0.04,0.0,173.10721128568545,-0.10885484182075278,-0.11610264534267517,175.2585710797991,178.98785836356026,10.196666887675434
2024-08-07,1,164.58250045776367,157.45000457763672,199.39749908447266,182.140625,190.30312633514404,-0.993094593674837,10.756601412412122,0.5230464718481809,2.99398272972621,184.81875038146973,7.5164999008178714,0.05852658670217363,165.5747501373291,195.11450271606446,0.7113374586479168,-0.18848030005553,0.8954921367251629,0.9302650877356217,0.9593039312679138,-0.1156589675131462,23.325251713427456,205.30320354961674,183.7900007247925,162.27679789996824,172.18892996651786,12.473498048093417,177.5533937726702,10.200945348347428,171.33350784227713,178.25947343890502,-10.885011017201894,-14.479753017494312,48408200,5.307135225406914,0.9558776269223536,720909300.0,-71.37727086479633,47.13413368669027,45.7615501877868,-151.24937880265463,14.488900427091616,38.136992264525595,-0.053507526853723626,7.039615136319223,181.39836480712887,175.70582400512694,171.1050033569336,166.50418270874022,160.81164190673826,0.04,0.0,173.04815704068363,-0.12947904593150217,-0.10423202763527742,172.34000069754464,177.48928724016463,10.43017354543767
2024-08-08,1,165.0525016784668,157.45000457763672,197.06750106811523,181.40125179290771,187.14625072479248,-0.8896146258551153,10.906005991887529,-0.11623348941823242,2.9939026966351845,183.6574993133545,8.001049728393559,0.05990689851429753,164.3057502746582,194.4205005645752,0.7598908531033479,-0.1648419979665917,0.906636533570392,0.9424516531652901,0.9868049396604365,-0.11479827159940681,28.40525276029683,203.86126277723207,182.04925079345702,160.23723880968197,169.63678686959403,11.71723234059898,176.31946536472864,10.615427185453049,169.6542937693786,176.23657194488132,-10.330032080722335,-11.570645661363997,44616200,5.410402017187909,0.8809555331315967,765525500.0,-63.606051699853886,47.13413368669027,45.7615501877868,-117.75482257175209,13.861811041656855,36.48639751015939,-0.010404697772373355,6.832499076262327,181.39836480712887,175.70582400512694,171.1050033569336,166.50418270874022,160.81164190673826,0.04,0.0,173.00080209764224,-0.09925573719503566,-0.11327411038474937,170.067143031529,176.25142996651786,10.494072041335313
2024-08-09,1,166.93500137329102,157.45000457763672,194.89750289916992,177.14687633514404,186.2024974822998,-0.7579272948358772,10.933693254731962,-0.6042522560475114,2.9938656628274947,183.23000144958496,8.734999847412116,0.06059176554421836,164.3057502746582,193.65425071716308,0.7797829053430395,-0.15313177837965125,0.925111600323763,0.9618855696444706,1.0242762095413145,0.005677973802325154,29.589208446262838,202.31588733343852,180.4485008239746,158.58111431451067,166.89785821097237,9.194783661241738,175.1167869567871,10.659792118493563,168.502129709339,174.46639195023388,-9.766698839971683,-9.474707747877126,36401000,5.430659292069597,0.714650883001514,801926500.0,-60.682227054975826,47.13413368669027,45.7615501877868,-86.09377723012864,15.476712348646995,35.39067650711331,-0.0022091079661038875,6.5408911501399105,181.39836480712887,175.70582400512694,171.1050033569336,166.50418270874022,160.81164190673826,0.04,0.0,172.9726276840215,-0.005717638415579596,-0.09306244472865104,167.20428684779577,175.1364299229213,10.316291239761554
2024-08-12,1,167.4000015258789,157.45000457763672,194.36750030517578,166.6993761062622,186.11000061035156,-0.6175913007526156,10.783456995849736,-0.9272224664646953,2.9938938447403944,182.69500160217285,9.247474746704096,0.06022582723336965,164.3057502746582,189.64875144958498,0.7921511221302835,-0.1376210734064414,0.9349324223802826,0.9727736707449807,1.0259427466845026,0.06319464375331885,33.16223475970584,200.6172897393801,179.05037574768068,157.48346175598124,164.17535836356026,3.48933576807872,173.7978583744594,10.365905004584377,168.0993895735752,173.19550455437397,-10.301841895678487,-9.162142211192403,30072800,5.485253306836446,0.5966252447185627,831999300.0,-61.041291866272104,47.13413368669027,45.7615501877868,-74.14339555414018,15.044991329846017,34.4034578670355,-0.0032956713979204327,6.247969735949413,181.39836480712887,175.70582400512694,171.1050033569336,166.50418270874022,160.81164190673826,0.04,0.0,172.94971142905962,0.035896153433933486,-0.006551464471194332,164.73714338030135,173.73571559361048,10.094726597512828
2024-08-13,1,169.0449981689453,157.45000457763672,194.36750030517578,166.6993761062622,185.92562675476074,-0.48814644298660015,10.52655892029287,-1.159312206968411,2.993959685324782,182.39999961853027,9.496387195587157,0.05922393740775727,164.3057502746582,186.7330005645752,0.7761945758025968,-0.13874489684209187,0.9510715198061626,0.9916349217557084,1.023541220894551,0.04468065138334443,33.64931612947842,198.79474362641335,177.74162578582764,156.68850794524192,164.61142948695593,3.9186108388891285,172.8387511117118,10.119811819477937,167.9190444491301,172.6988810665125,-10.220827204643166,-9.934629965748487,39237900,5.47884073562716,0.7744271419266978,871237200.0,-52.24418442194867,47.13413368669027,45.7615501877868,-49.92910828919092,17.212099783737646,32.69664109654054,0.041120630294952325,6.104542268532485,181.39836480712887,175.70582400512694,171.1050033569336,166.50418270874022,160.81164190673826,0.04,0.0,172.93185543712997,0.05125673702941613,0.05719780903429835,165.07000078473772,172.97857230050224,9.514824920115823
2024-08-14,1,170.8375015258789,157.45000457763672,189.2125015258789,166.6993761062622,184.2956247329712,-0.45909470292616306,9.958210247578599,-1.3918799849702617,2.994125040684896,181.95375061035156,9.353149871826172,0.05642828726516079,164.3057502746582,186.15149688720703,0.7977663013497417,-0.1065865267585147,0.968052227468152,1.0103720824789824,1.0254167143972257,0.03800526210695421,37.988521102484725,196.39192117417332,176.4755006790161,156.5590801838589,166.52392905099052,3.0002069280014623,172.12250110081263,9.859551366967295,168.18701668607278,172.57659312595678,1.838937215932973,-7.358644009204235,28843800,5.445121330104282,0.5802952738420596,900081000.0,-52.577576588426375,47.13413368669027,45.7615501877868,-37.33641597699598,17.99895778969391,31.345783300520694,0.04873546024580461,5.9127886714421445,181.39836480712887,175.70582400512694,171.1050033569336,166.50418270874022,160.81164190673826,0.04,0.0,172.92242693089915,0.04503287853199889,0.05045398503841412,166.36714390345983,172.28214372907365,9.199338299467351
2024-08-15,0,176.0875015258789,157.45000457763672,186.45750045776367,166.6993761062622,183.5999994277954,-0.35454701592834975,9.581212969471508,-1.4648497699126444,2.994232217605175,181.22250175476074,9.090074787139892,0.054576158036722694,164.3057502746582,186.10850143432617,0.806050713231348,-0.082098648717754,1.0030232437363413,1.050912604904587,1.0490515604601174,0.06685751342872104,42.168556843605856,194.71917661795914,175.55675067901612,156.3943247400731,168.56285803658622,3.962211557294917,171.73017965044295,9.558974332147978,168.84034073519456,172.6021491412119,8.50269708416615,-5.544190451182094,51698500,5.458407373242175,1.0394138259721466,951779500.0,-33.367550481381606,47.13413368669027,45.7615501877868,11.468652535390824,22.987718683094272,28.454641942651676,0.11482110192528101,6.048303885368966,181.39836480712887,175.70582400512694,171.1050033569336,166.50418270874022,160.81164190673826,0.04,0.0,172.94625025857522,0.07110972900556778,0.09104866791440566,168.60428728376115,171.93142918178015,9.006998796958765
2024-08-16,0,177.17499542236328,157.45000457763672,186.45750045776367,166.6993761062622,183.07375240325928,-0.3025524245787749,9.27285054269994,-1.4173627152028527,2.994320747613499,178.47625160217285,8.638725013732909,0.05297099340576917,164.3057502746582,185.88925170898438,0.8123154575924356,-0.03422411805491917,1.0121090026166382,1.0639878716086988,1.0418320165347736,0.061341204449833375,51.848359570710414,193.600952016186,175.05525093078614,156.5095498453863,170.36178588867188,4.652372092558614,171.27535792759485,9.09387330545927,170.6418665351754,173.23481027390534,8.820259568209224,-3.0248376747380488,31489200,5.5702566072731505,0.6405647039677776,983268700.0,-34.726870062369606,47.13413368669027,45.7615501877868,19.78207070166781,22.92805616667519,27.721308603470757,0.09769254886112733,5.764853168745425,181.39836480712887,175.70582400512694,171.1050033569336,166.50418270874022,160.81164190673826,0.04,0.0,172.96353056076936,0.06062055210966877,0.06791311399023861,170.64571489606584,171.49285779680525,8.823118761989107
