date,buy?,todays_price,Minimum,Maximum,25th Percentile,75th Percentile,Skewness,Standard Deviation,Kurtosis,Shannon Entropy,Median,Mean Absolute Deviation (MAD),Coefficient of Variation (CV),10th Percentile,90th Percentile,Autocorrelation,Cumulative Return,curr_to_avg_one_month,curr_to_avg_one_two_week,curr_to_avg_one_one_week,momentum,rsi,upper_band_current,middle_band_current,lower_band_current,rolling_mean_7,rolling_std_7,rolling_mean_14,rolling_std_14,ema_7,ema_14,roc_7,roc_14,Volume,Volatility,Relative Volume (RVOL),On-Balance Volume (OBV),Williams %R,Stochastic Oscillator %K,Stochastic Oscillator %D,Commodity Channel Index (CCI),ADX1,ADX2,Chaikin Money Flow (CMF),Average True Range (ATR),Fib_23.6,Fib_38.2,Fib_50,Fib_61.8,Fib_76.4,Parabolic SAR 2,Parabolic SAR 3,VWAP,Adj Close Momentum,Adj Close Return,Adj Close 7d MA,Adj Close 14d MA,Adj Close Volatility
2024-01-02,0,138.1624984741211,129.2700023651123,141.74499893188477,132.1737518310547,139.69750118255615,0.17779808153094315,4.095668895262834,-1.4707839594179652,2.9952759767313895,134.70374870300293,3.7098745822906496,0.030232753396258635,130.7237518310547,141.00824890136718,0.854219928177144,0.06070276678797187,1.019865826998451,0.9962953193367019,0.9811876014042791,-0.02178920206281021,65.92266441352479,143.66258784774612,135.47125005722046,127.27991226669478,140.30928584507532,1.1994177447663965,137.28642872401647,3.7533828411326127,139.55230301607648,137.48042174493062,2.0876011933118503,3.4913479424698233,23711200,1.8135630891594228,0.7746441831935875,151794800.0,-34.71899844005488,45.37968769486497,52.4753318404932,39.97433483327982,29.749714793464943,23.95608636175086,0.057439103587579476,2.7301216711262537,139.61435498046876,137.71781640625,136.18499755859375,134.6521787109375,132.75564013671874,0.04,0.0,135.1728940753258,-0.023464652945959452,-0.016023363756477768,140.10919625418526,137.15045057024275,4.024609237892358
2024-01-03,0,138.22000122070312,129.2700023651123,141.74499893188477,132.21624851226807,139.69750118255615,0.00038669973411472393,4.036101511460748,-1.4493629375819643,2.99529049533399,135.6062469482422,3.6521245002746583,0.029721334606259385,130.7237518310547,141.00824890136718,0.8302319950247372,0.0687900978286724,1.0178343864476538,0.9924624793775007,0.9859054613765845,-0.02486858610705245,61.473691941831696,143.870328003848,135.7981249809265,127.72592195800502,140.06285749162947,1.439845759532488,137.72017887660436,3.4526632620633033,139.2070876090207,137.44461278386868,-0.7952193437225195,4.200840730889012,24212100,1.750985414154084,0.8074398074318038,176006900.0,-28.94532204409194,45.37968769486497,52.4753318404932,43.65293996443439,27.81971234113721,21.918443956872743,0.05901127895573414,2.713817055060751,139.61435498046876,137.71781640625,136.18499755859375,134.6521787109375,132.75564013671874,0.04,0.0,135.29508969979656,-0.0183720398794347,-0.01816388774893358,139.89515686035156,137.60706874302454,3.75949713869302
2024-01-04,0,137.5800018310547,130.08250045776367,141.74499893188477,132.50124835968018,139.69750118255615,-0.0850727342509541,3.7752237276368823,-1.4569844568024344,2.9953480027424892,136.53374671936035,3.4020621871948236,0.027708953808615194,132.01224937438965,141.00824890136718,0.8182042828036336,0.06255646020258973,1.0097939064692598,0.9852372091452293,0.9863002073420372,-0.0241341753911416,61.01706850943278,143.79607237897983,136.24562492370606,128.6951774684323,139.53999982561385,1.5970894730109493,138.06482151576452,3.146124403977193,138.9694413233766,137.4921329452437,-1.2326260158510627,4.595245599274446,27137700,1.7512839805740719,0.9053775275527163,148869200.0,-48.42184768921383,45.37968769486497,52.4753318404932,13.757531482273047,25.269060827282427,22.29069203838796,-0.0036165304075536867,2.722360346181555,139.61435498046876,137.71781640625,136.18499755859375,134.6521787109375,132.75564013671874,0.04,0.0,135.37337970772722,-0.02835360923181862,-0.03624937027898139,139.16741943359375,137.8796125139509,3.540616717057852
2024-01-05,1,136.1974983215332,130.79500198364258,141.74499893188477,132.7143783569336,139.69750118255615,-0.15391706123687887,3.5073645097158996,-1.4073491766745596,2.9954022476949955,137.17000007629395,3.1169502830505365,0.025672314988685913,132.1790023803711,141.00824890136718,0.8038525712872385,0.05187506972369366,0.9969038199182332,0.9747644303942801,0.9811757611431342,-0.030450259470021668,57.04159391641964,143.63522901180244,136.6204999923706,129.60577097293879,138.74749973842077,1.694012457526651,138.3516069139753,2.7232483947494615,138.632863420707,137.45845177820237,-2.5913363917891643,3.6345122750749637,22506000,1.7657129761707755,0.752195951958522,126363200.0,-60.43475607167119,45.37968769486497,52.4753318404932,-22.02605026587316,23.60209766372297,24.75864902442577,0.014242218166614185,2.660167350517232,139.96599267578125,138.28699267578125,136.92999267578125,135.57299267578125,133.89399267578125,0.04,0.0,135.39345406056492,-0.03209014619190553,-0.03305544981021341,138.34122358049666,138.15001678466797,3.1923490547861144
2024-01-08,1,137.59999465942383,132.14749908447266,141.74499893188477,134.06562519073486,139.69750118255615,-0.15550044255406154,3.2466542094137774,-1.3388869708183249,2.995450632433483,137.17000007629395,2.832875633239746,0.023717140702202672,132.22299766540527,141.00824890136718,0.9193505696601866,-0.0008069754019008965,1.0051820192299294,0.9869724256212871,0.9974266561924784,-0.014432596746899229,44.30806838324928,143.3839332280927,136.89062480926515,130.3973163904376,138.26428495134627,1.4086129966671297,138.73535673958915,2.10142019065643,138.03405322822084,137.29043057683307,-3.913718757031704,3.0374637274410294,21404000,1.3215453807279085,0.760294740311961,147767200.0,-37.46337890625,45.37968769486497,52.4753318404932,24.365733092171883,27.00959057792015,22.18655429738316,0.032779995700573106,2.7134369788191317,140.26099267578124,138.76449267578124,137.55499267578125,136.34549267578126,134.84899267578126,0.04,0.0,135.4700235678277,-0.0060849307251601426,-0.00991232930315533,138.1229030064174,138.595219203404,3.2207887025245934
2024-01-09,1,139.77249908447266,132.14749908447266,141.74499893188477,134.06562519073486,139.69750118255615,-0.21431350070019736,3.24726737968466,-1.3253954269972072,2.9954506609196567,137.58999824523926,2.8327251434326173,0.023710426469593197,132.22299766540527,141.00824890136718,0.9103747362752006,0.019976990508231183,1.020570582745021,1.0042444455562358,1.01614298738543,0.011652949448168304,52.76419967733916,143.44978454574627,136.95524978637695,130.46071502700764,138.1639278956822,1.2397646461801461,139.11178534371513,1.7227519611141864,137.912285443684,137.21938625041628,-2.3992364679678797,4.063071355345214,24759600,1.3139241180765764,0.8913216234483292,172526800.0,-22.974714581568676,45.37968769486497,52.4753318404932,68.87253110759289,31.84119215436265,19.917458119176807,0.07439223889697905,2.7665157693862614,140.90291296386718,139.80353314208983,138.9149932861328,138.0264534301758,136.92707360839844,0.02,1.0,135.62327738254444,0.020120229154486413,0.009020005951294527,138.22564261300224,138.96265520368303,3.297371939264863
2024-01-10,0,141.79750061035156,132.14749908447266,141.74499893188477,134.06562519073486,139.81562423706055,-0.3899688618351261,3.2668306135903733,-1.2623745531999742,2.995447868259728,137.88124656677246,2.822400054931643,0.023810957422595282,132.22299766540527,141.00824890136718,0.8585173538011421,0.054150878603826974,1.033519838958772,1.0198691088148282,1.0284571537396772,0.025882646202093795,63.93998430503547,143.7322860288165,137.19862480163573,130.66496357445496,138.47571345738,1.8091831564655234,139.47160693577356,1.719837388466527,138.36156785712024,137.52931126463292,-0.5000885547458147,3.9181431657933348,21320200,1.253261707953476,0.7813135876377707,193847000.0,-9.171982941270231,45.37968769486497,52.4753318404932,104.7926473592329,34.44651647184269,18.63325420841572,0.03370664509464686,2.709957347758596,141.14739855957032,140.00129766845703,139.0749969482422,138.14869622802735,137.00259533691406,0.04,0.0,135.79819633730642,0.02418663479741845,0.02974605759288726,138.595219203404,139.36433737618583,3.331377490936182
2024-01-11,1,142.85750198364258,132.14749908447266,141.79750061035156,135.77374839782715,140.07749938964844,-0.5436162051945188,3.233730848359704,-1.0038905195437084,2.9954551365008077,138.1912498474121,2.697737846374511,0.023490899884724487,132.22299766540527,141.29050483703614,0.7992686998030112,0.07302447335541579,1.0377645618162126,1.0274543001170544,1.0307960063071797,0.03835950052587256,70.12928031001549,144.1263365899079,137.65887489318848,131.19141319646906,139.1464282444545,2.435563622168275,139.72785704476493,1.9405841864712687,139.207813336372,138.19501889787006,1.563226663070963,3.683461794855252,24008700,1.288763960992773,0.8880129514140735,217855700.0,-31.181699164176575,45.37968769486497,52.4753318404932,112.06916883879114,36.29875827287616,16.172432090761866,-0.006529912908833076,2.8644166196111707,142.8434794921875,141.37325842285156,140.18499755859375,138.99673669433594,137.526515625,0.06,0.0,136.0014478961053,0.041718674116911325,0.022746976409484063,139.1531524658203,139.6311743600028,3.222613118096295
2024-01-12,1,142.58499908447266,132.18250274658203,142.85750198364258,136.6193733215332,140.60187339782715,-0.6072266874822697,3.1627168400629646,-0.6761394373265097,2.9954691218554395,138.7450008392334,2.5781880378723145,0.022886002698662176,132.70225410461427,141.75024909973143,0.7787000620039914,0.07609880403189248,1.0317713658397,1.0241133643222287,1.0210533866237625,0.04689881122382977,72.23787629092759,144.5198087182729,138.19437503814697,131.86894135802103,139.76999936785018,2.702943972650692,139.91642842973982,2.0861180762643996,140.11295559863527,138.9477389499209,3.3981750195411347,2.5759327307296775,18768600,1.2945525799676068,0.7090619359099224,199087100.0,-25.52140471673526,45.37968769486497,52.4753318404932,102.90112210222847,34.807149846103066,15.507865666570392,-0.001539475728939424,2.7431622019330053,142.8434794921875,141.37325842285156,140.18499755859375,138.99673669433594,137.526515625,0.06,0.0,136.15008586266438,0.05098354485828027,0.04589778822357185,139.6853986467634,139.7902777535575,3.0727846578858666
2024-01-16,1,142.57250213623047,132.18250274658203,142.85750198364258,137.37500095367432,141.046875,-0.7357024263449847,3.0406820677074546,-0.2564275230186066,2.9954905754250327,139.44250106811523,2.4740381431579577,0.02192495863928105,134.2749984741211,141.87625045776366,0.74459452431234,0.0786979828777649,1.0280246809205065,1.022474042891698,1.0117085849490133,0.03613741039099727,71.44847710718001,144.7672388836449,138.68587474823,132.6045106128151,140.483213697161,2.6873979520036593,140.0116067613874,2.179460036332167,140.72494439890232,139.5866702990353,3.158007397785875,1.8864549611672021,22670500,1.2827642472587113,0.8832539026240868,176416600.0,-27.11016625552316,45.37968769486497,52.4753318404932,104.53387111177264,35.219659217463445,14.188381597266833,-0.022872165364390643,2.7558440773079047,142.8434794921875,141.37325842285156,140.18499755859375,138.99673669433594,137.526515625,0.06,0.0,136.3263857324628,0.02628934508741576,0.04980481719535523,140.55582972935267,139.86162458147322,2.7286808212650384
2024-01-17,1,140.88999938964844,132.22749710083008,142.85750198364258,137.59499645233154,141.36625385284424,-0.761439361737253,2.7597950053676628,0.057288943754310484,2.9955347222323123,139.69375038146973,2.2393009185791017,0.019825348058321115,136.0279983520508,142.5737518310547,0.6816568661764095,0.07823641271460963,1.0121017214698225,1.0082692509809166,0.9927633674190582,0.007995137187183143,71.34124144224056,144.72496472844773,139.2053747177124,133.68578470697707,141.15357099260603,1.914206210958205,139.9505353655134,2.138750674625132,141.18866865311156,140.21181177258944,3.628797963897737,0.9434272098855861,20968600,1.2840132160781932,0.8673780579237917,155448000.0,-37.23929764163237,45.37968769486497,52.4753318404932,36.82334422993397,31.631638252626924,19.979201369848063,-0.014836842859321962,2.822660921083609,142.8434794921875,141.37325842285156,140.18499755859375,138.99673669433594,137.526515625,0.06,0.0,136.43251439863928,0.003689289031518328,0.018942768551371076,141.37489100864954,139.85805729457311,2.268777776333333
2024-01-18,1,142.93250274658203,134.50249862670898,142.85750198364258,138.02187252044678,141.36625385284424,-0.4753765532488369,2.2663252898355637,-0.6123335524344933,2.995600215291955,139.85874938964844,1.8839004898071294,0.016229945842727515,136.7037483215332,142.5737518310547,0.6955080196304847,0.04748982976641185,1.023589503742794,1.0208935817104874,1.0055719664848652,0.0080043874634248,59.5973233709513,144.17115041182444,139.63849983215331,135.1058492524822,141.91535786220007,1.1874041221066967,140.08982140677315,2.270562140541001,141.12573786324265,140.50731821419382,3.4453650955006836,-0.6031955615218539,25746400,1.3071765672310791,1.079553685744733,181194400.0,-17.279088655469824,45.37968769486497,52.4753318404932,120.0563667845548,35.87081458088251,18.435494361157847,-0.025504397275346348,2.8160971363738163,142.8434794921875,141.37325842285156,140.18499755859375,138.99673669433594,137.526515625,0.06,0.0,136.62750023442592,0.008434068556319785,0.017949626681666598,142.03698948451452,140.07994624546595,2.219175258169647
2024-01-19,0,145.4875030517578,136.1974983215332,142.93250274658203,138.20562553405762,141.75812435150146,-0.2730982440056574,2.0450342873879936,-1.0828220881598842,2.9956255280635564,140.20999908447266,1.7477506637573241,0.014601130135877516,137.49800148010254,142.61224937438965,0.6841966219645729,0.04513384396610476,1.0387512709705313,1.0356567237517533,1.0219151278222536,0.01840996119627225,64.5157125442561,144.15006861292295,140.06000003814697,135.96993146337098,142.73178700038366,1.4119757460998965,140.44785744803292,2.6920514070182384,141.59016468282448,140.93158989219296,3.875369399800333,1.3831536559239754,33300700,1.2913302000373938,1.3737736852375237,214495100.0,-0.6193986418331067,45.37968769486497,52.4753318404932,190.89704426763885,39.1428359483144,16.910291138522464,0.04840288612063552,2.8282220862857743,143.78319622802735,142.1333957824707,140.79999542236328,139.46659506225586,137.8167946166992,0.08,0.0,136.953527806286,0.03026466556588714,0.028816463532018655,142.8118155343192,140.51872907366072,2.472637948637599
2024-01-22,0,146.8300018310547,136.1974983215332,145.4875030517578,139.00750064849854,141.9912509918213,0.08531429181557795,2.2181367791926925,-0.3682758784490372,2.9956076877137985,140.68249893188477,1.8126258850097656,0.015787857692815405,137.5979953765869,142.86500205993653,0.6934448313010994,0.04464351671973835,1.045080355589351,1.0393627892838588,1.0275484925067022,0.02977173457123028,69.69094697875981,144.93264883304357,140.4963752746582,136.0601017162728,143.45071574619837,2.011074215200564,140.9632146017892,3.168749405877328,142.57682972035576,141.53977647200216,4.088790001408823,3.568253875838371,32200400,1.2953705485138716,1.3763813332524042,246695500.0,-18.126834597791625,45.37968769486497,52.4753318404932,188.5390600484903,41.76750295008797,15.708635202229392,0.07876992659081267,2.806463305405085,145.2653580932617,143.33231729125976,141.7699966430664,140.20767599487306,138.2746351928711,0.1,0.0,137.28089383365995,0.02341402483381594,0.027519705277495272,143.3412083217076,140.9682137625558,2.6873882763680785
2024-01-23,0,146.40249633789062,136.1974983215332,146.8300018310547,139.26625156402588,142.57562637329102,0.34918300886268955,2.589939811562387,-0.13049831580272464,2.995563608678789,140.93624877929688,2.030188465118408,0.018384747440764047,137.5979953765869,143.18800277709963,0.7331601282120047,0.049197914546746796,1.0392414942823731,1.028594986155918,1.0185052748696577,0.02686348450278664,72.32739375574043,146.05425496644753,140.87437534332275,135.69449572019798,143.95714351109095,2.266875217867607,141.55178587777274,3.367544132362843,143.65005413765402,142.16242222419254,3.5490761113850975,5.167782878521915,21636100,1.3132538925549717,0.9365320252995798,225059400.0,-10.19641649101011,45.37968769486497,52.4753318404932,154.53489855491418,39.76276769037043,15.92603168229849,0.08057300137470205,2.718958172630163,145.2653580932617,143.33231729125976,141.7699966430664,140.20767599487306,138.2746351928711,0.1,0.0,137.4851623353571,0.03193196047824065,0.03077460006663102,144.04896545410156,141.60105895996094,3.003497468133361
2024-01-24,0,148.79750061035156,136.1974983215332,146.8300018310547,139.26625156402588,142.65312480926514,0.29061765357409935,2.8440040791120142,-0.5227372691953631,2.995529784262816,141.1112518310547,2.2477510452270506,0.020142064208598705,137.5979953765869,145.5790023803711,0.8118743149740509,0.03655119402396528,1.0538271844914124,1.0389961784851196,1.029679914462043,0.05612535492199111,69.19736028356809,146.88525833370014,141.19725017547609,135.50924201725203,144.84464372907365,2.794787397481275,142.3073215484619,3.729637125817597,144.34471914586635,142.64624350383667,2.4814898097923863,5.963990196162345,25233500,1.3051720672823532,1.0952845706313898,250292900.0,-7.823185036019016,45.37968769486497,52.4753318404932,181.21891460094702,44.1598378188826,14.658675080770307,0.05099699845950635,2.7259874212934507,146.38080322265625,144.23460144042969,142.5,140.76539855957031,138.61919677734375,0.12000000000000001,0.0,137.77007510729982,0.051106119914693826,0.04358189529478361,144.9122597830636,142.2988292149135,3.428126491000731
2024-01-25,0,151.13249969482422,136.1974983215332,148.79750061035156,139.26625156402588,142.87625217437744,0.4571382014276565,3.2914539042301225,-0.4868996906476588,2.995462916905692,141.36374855041504,2.625625801086426,0.02324881511371784,137.5979953765869,146.44524688720702,0.7889881411136559,0.0497548536569947,1.0675074436142942,1.0486919245446544,1.034516385431557,0.057369715010033184,74.17898314003958,148.1580327397957,141.57512493133544,134.9922171228752,146.0675005231585,3.4344304146622275,143.27535711015975,4.144035824541468,145.460239308734,143.35667405195562,4.357051278724201,7.652654678217511,29149100,1.388523604355332,1.2321686690201885,279442000.0,-6.592219726450117,45.37968769486497,52.4753318404932,197.85004647123202,47.603738310884836,12.941752910347825,0.08960491234080581,2.850639445429137,148.82560089111328,146.21219955444337,144.0999984741211,141.98779739379881,139.3743960571289,0.14,0.0,138.15502812454199,0.05847497201438712,0.07351370029425262,146.25072152273995,143.4032756260463,4.11515239515954
2024-01-26,0,151.70999908447266,136.1974983215332,151.13249969482422,139.26625156402588,143.57125282287598,0.6505661298977127,3.8960343475028187,-0.3099826935451615,2.995358231959242,141.38999938964844,3.119700775146484,0.02742826613026103,137.5979953765869,147.02675170898436,0.7894468808377758,0.07199476287982731,1.068045571050388,1.045924203871412,1.0269410327697497,0.042769969256405194,79.05892997267159,149.83656866448806,142.04449996948242,134.25243127447678,147.61321476527624,3.1379005199304006,144.38339287894112,4.179695631084572,146.8793289441291,144.31794212162194,6.003961093713937,9.850630675533578,26115500,1.4271486280910772,1.0890038776385893,305557500.0,-5.122097514427228,45.37968769486497,52.4753318404932,171.37993181644717,45.58150860216708,12.391981019592649,0.14091752010798317,2.7498103767755375,149.08756103515626,146.63621978759767,144.65499877929688,142.67377777099608,140.2224365234375,0.14,0.0,138.49248226260812,0.03969114280356112,0.06070530345731185,147.78039332798548,144.5776421683175,4.652932644705679
2024-01-29,0,152.69499588012695,136.1974983215332,151.70999908447266,139.26625156402588,145.71625137329102,0.6052191384019079,4.416569563933842,-0.6070391665334105,2.995255339113238,142.18500137329102,3.550712928771972,0.0309758904443614,137.5979953765869,149.03100051879883,0.8308577686254012,0.0799786491004755,1.070936027456598,1.0463291314225496,1.0249740484485772,0.03994411207472859,80.56374842962944,151.41401414312645,142.58087501525878,133.74773588739112,149.00785664149694,2.868761945358517,145.4616072518485,4.241740645610827,148.08233201322196,145.1940903017411,7.679749976362902,11.389710496970915,27784300,1.4058723717473696,1.130913276690592,333341800.0,-1.7274740122304573,45.37968769486497,52.4753318404932,155.6572118893333,46.05320129074338,11.578400424535054,0.1912053234757682,2.7194353256048838,150.09131762695313,147.8093369140625,145.96499633789062,144.12065576171875,141.83867504882812,0.16,0.0,138.85904942415837,0.05151029656574657,0.04870873100363665,149.21160670689173,145.62429809570312,5.186059388779943
2024-01-30,0,152.2675018310547,136.1974983215332,152.69499588012695,139.26625156402588,146.50937271118164,0.510088090793179,4.901612195461016,-0.8657752497536721,2.995149560928947,142.57875061035156,4.071187229156496,0.03423107770170935,137.5979953765869,151.19024963378905,0.8464874834610887,0.09368616584472325,1.0633808793463244,1.0362210470039626,1.0141194727399427,0.04006082983467629,83.0888999078534,152.99509927648108,143.1918748855591,133.3886504946371,149.9764278956822,2.6154749740344387,146.35410744803292,4.267075967313029,149.2241560105416,146.04095879997521,6.830142162174078,10.970204801290166,36331800,1.3654107501842574,1.427673808611594,297010000.0,-15.591339409501465,45.37968769486497,52.4753318404932,121.13351251083753,42.91561391249283,11.462428177347071,0.12348218416881931,2.697544497895322,150.26831762695312,148.0958369140625,146.33999633789062,144.58415576171876,142.41167504882813,0.16,0.0,139.28487804351283,0.030059947850294755,0.03746832174051259,149.93648856026786,146.37415204729353,5.400865445626334
2024-01-31,0,141.89749908447266,136.1974983215332,152.69499588012695,139.38437461853027,147.3218765258789,0.34045731187045,5.206172955264129,-1.1267344077679116,2.995079549391778,142.72125053405762,4.472649917602541,0.036198095311511615,137.5979953765869,151.76574935913087,0.8654798404225182,0.10208995576014117,0.9866017207767319,0.959321087794357,0.937728196960751,-0.04637175690166728,82.6394570586959,154.2368458037167,143.8244998931885,133.41215398266027,149.2717846461705,3.935684926236898,146.36125019618444,4.258937778454406,149.97081870099834,146.7289550410461,4.660193237961381,8.939528754530299,71910000,1.2983592326456355,2.5812875854461472,225100000.0,-91.93540448083219,45.37968769486497,52.4753318404932,-42.22112849901514,31.790642585553876,33.810026277578594,-0.00776335786474822,3.3672759132908108,150.26831762695312,148.0958369140625,146.33999633789062,144.58415576171876,142.41167504882813,0.02,1.0,139.40695335564484,-0.057834518916161204,-0.047197997457966795,149.0960235595703,146.21861594063895,5.307304844373236
2024-02-01,0,141.78249740600586,136.1974983215332,152.69499588012695,140.6106243133545,147.3218765258789,0.326205799062598,5.064791690542547,-1.0419615046469977,2.995115947820129,142.72125053405762,4.3232498931884775,0.035169416925592695,137.5979953765869,151.76574935913087,0.8167399994912874,0.02660611945660077,0.9845237610333849,0.9578911456176954,0.9455917396758299,-0.061866258466567015,44.95530221196347,154.14083330479113,144.01124992370606,133.881666542621,148.61178479875838,4.791400359171683,146.28446415492468,4.33596181540564,147.94239831842185,146.02684819379522,-3.3593289416814556,0.0705220287315795,40466500,2.803399911654331,1.4114131710503783,184633500.0,-84.8117673117468,45.37968769486497,52.4753318404932,-40.47325538790743,29.674894190586226,31.559882744364625,-0.07381884035597379,3.3367202377565173,150.26831762695312,148.0958369140625,146.33999633789062,144.58415576171876,142.41167504882813,0.02,0.0,139.4807321340704,-0.07052075020152804,-0.05070602302376066,148.25698852539062,146.1529769897461,5.214698313502536
2024-02-02,1,140.18999862670898,136.1974983215332,152.69499588012695,141.5593729019165,147.3218765258789,0.3244557855583407,4.918518601486547,-0.947304451486874,2.995152392676197,142.72125053405762,4.180750045776369,0.034111519039425095,137.5979953765869,151.76574935913087,0.7942339487863067,0.030545831654456197,0.9722630317686807,0.9478685743834921,0.9467787297133347,-0.07593435190352416,45.04391756813831,154.02641193594428,144.1893747329712,134.35233752999812,147.382141658238,5.745330576579391,146.11339269365584,4.535790112492412,146.3968146753076,145.37170952831045,-3.155683166236461,-0.752501312643566,62470600,2.7976292659505404,2.052418467909134,122162900.0,-65.97219156139455,45.37968769486497,52.4753318404932,-63.304510239498384,25.845001719825824,36.53367602567645,0.06834862301285925,3.544781839708351,149.70191906738282,147.17903924560548,145.13999938964844,143.1009595336914,140.57807971191406,0.04,0.0,139.52957277045277,-0.06445888527868038,-0.06248758995334929,147.35516793387276,146.13371385846818,4.903665665512988
2024-02-05,0,143.6875,136.1974983215332,152.69499588012695,141.5593729019165,147.3218765258789,0.3760986263233252,4.773924484019779,-0.8917648076560787,2.9951872314912524,142.72125053405762,4.076350173950198,0.03307877378741186,139.55524864196778,151.76574935913087,0.7440902156969145,0.02931405021662249,0.9956182433318626,0.9750085732034522,0.9857374733829039,-0.0589901183611693,42.331465767625154,153.8677235407935,144.31987457275392,134.77202560471434,146.3185702732631,5.623164049250621,146.1930353982108,4.478258102772481,144.84540973473594,144.5923966655472,-5.784708713745538,-1.679700160004058,38505400,2.8043497353276554,1.2326648798200242,160668300.0,-58.449113524339005,45.37968769486497,52.4753318404932,-14.498645011895324,30.198369792790672,34.13800535350857,0.06144033702650286,3.5108973830806374,149.70191906738282,147.17903924560548,145.13999938964844,143.1009595336914,140.57807971191406,0.04,0.0,139.6571501955509,-0.0640349817462571,-0.055917044835176746,146.18650817871094,146.21861485072546,4.454797765645525
2024-02-06,0,144.32500076293945,137.59999465942383,152.69499588012695,141.79374980926514,147.3218765258789,0.5381588310136095,4.401300915406546,-0.8884907688375083,2.995272024867791,142.8950023651123,3.776750106811522,0.03041791310719375,140.14824867248535,151.76574935913087,0.7265671019276607,0.044240592854988575,0.9974472131718028,0.981427187801224,1.002500617336278,-0.05216149849839713,50.41778800982781,153.49697648749031,144.69437465667724,135.89177282586417,145.26357051304407,5.112655651362027,146.43839263916016,4.253839019832755,144.56944212753245,144.46471661619293,-4.926140777038431,0.7820567410005413,29128200,2.888973914326113,0.921086645837375,189796500.0,-56.01848009028117,45.37968769486497,52.4753318404932,-16.807346519853972,28.771506293151802,32.524995309468814,0.023604402920220664,3.4112982875355473,149.70191906738282,147.17903924560548,145.13999938964844,143.1009595336914,140.57807971191406,0.04,0.0,139.75399689585856,-0.048593684692956995,-0.06129886083031194,145.03211975097656,146.40625653948103,4.225926659351748
2024-02-07,0,144.96249389648438,139.77249908447266,152.69499588012695,141.87249946594238,147.3218765258789,0.6827769353378428,4.092517068580775,-0.8918594672524778,2.9953365852255747,143.31000137329102,3.5077498626708974,0.02821829575413619,140.8199993133545,151.76574935913087,0.7248142972832041,0.032570796889847806,0.9995302298022465,0.9871567948557457,1.0181630728064315,0.021600062240611395,50.66826667349308,153.21565909901454,145.03062496185302,136.8455908246915,144.15892737252372,3.940355223488743,146.58339200701033,4.158675538167124,144.51586412033333,144.43337552333892,-4.867838880824994,2.438073240238366,25208900,2.857340221063317,0.7965853720193894,215005400.0,-47.685220342934244,45.37968769486497,52.4753318404932,-6.405397779128795,28.26120785324492,31.28519856044102,0.03317616672939024,3.2838074079070507,149.70191906738282,147.17903924560548,145.13999938964844,143.1009595336914,140.57807971191406,0.04,0.0,139.8492325493399,0.03882939260727314,-0.03908629042279023,143.89485386439733,146.55323028564453,4.106299616736436
2024-02-08,0,145.7925033569336,140.18999862670898,152.69499588012695,142.40375137329102,147.3218765258789,0.704216199341856,3.9114183547963477,-0.8500700173460594,2.995372089597493,144.00625038146973,3.300150070190432,0.02692143297974809,141.69324760437013,151.76574935913087,0.7306625930719859,0.02232051533002663,1.0034577618782337,0.9954084916117785,1.0196028747215566,0.028282799529512737,51.02532958245552,153.11296141204633,145.29012470245362,137.46728799286092,143.23392759050643,2.0036888603201364,146.60517774309432,4.153288378466528,144.62570158786417,144.49758851261132,-5.064017939208021,1.420244598600151,22563800,2.8283603171406395,0.7116036833165239,237569200.0,-45.543956441805555,45.37968769486497,52.4753318404932,5.003093193082287,29.11593519750856,30.37761244761297,0.03393700316569982,3.132088413405626,149.70191906738282,147.17903924560548,145.13999938964844,143.1009595336914,140.57807971191406,0.04,0.0,139.94353085096856,0.033649742648009795,0.04147041544125504,143.1029052734375,146.51969691685267,4.039692131529269
2024-02-09,0,147.8249969482422,140.18999862670898,152.69499588012695,142.5818748474121,147.3218765258789,0.6320339315707022,3.8290979997986527,-0.8419532763768007,2.9953877732932193,144.6437473297119,3.1708499908447267,0.026318656222746473,141.69324760437013,151.76574935913087,0.7287095626267414,0.02054495796536522,1.016050066102751,1.0129787226044698,1.0280510158003915,0.05446179040106358,52.51159631886074,153.14807083938,145.48987483978271,137.83167884018542,144.08071299961634,2.5285428045304377,146.67624882289343,4.165925460544,144.91014121722225,144.92507060851955,-4.252383730118129,0.20964020880011672,26829500,2.825000901958043,0.8423858268062653,264398700.0,-27.662031926899093,45.37968769486497,52.4753318404932,49.38716872433912,33.969521136648076,27.878034348143313,0.0785264174056046,3.161411167246405,149.70191906738282,147.17903924560548,145.13999938964844,143.1009595336914,140.57807971191406,0.04,0.0,140.09685262607135,0.04649529699573596,0.055539785532252355,144.3728768484933,146.73445020403182,4.017865289075407
2024-02-12,0,148.16499710083008,140.18999862670898,152.69499588012695,142.5818748474121,148.06812286376953,0.47309338416091445,3.8113608982733944,-0.9546507945424687,2.995391639127609,145.2249984741211,3.1808249282836925,0.026152097400975557,141.69324760437013,151.76574935913087,0.7066740820231111,0.036749994020515174,1.0166514111407097,1.0180187803804992,1.0195879955245672,0.031161354333745672,57.65975047173143,153.3609713845595,145.7382495880127,138.11552779146592,144.99249867030554,2.7062052837213892,146.80214173453194,4.183609951260495,145.6333549303838,145.53789038474912,4.177309608706245,0.6776510963558795,21564100,2.8534096798252913,0.6741057410166151,285962800.0,-36.168984036550455,45.37968769486497,52.4753318404932,41.34943236862998,32.36879783386758,26.564356152996652,0.04400121151940998,3.073812217114423,149.70191906738282,147.17903924560548,145.13999938964844,143.1009595336914,140.57807971191406,0.04,0.0,140.2141593098807,0.02679572846158762,0.03617075767471049,145.2818320138114,146.769410269601,3.95441453526646
2024-02-13,0,145.10499954223633,140.18999862670898,152.69499588012695,142.84250259399414,148.32312297821045,0.30741842207551,3.774378980690133,-1.012825892154407,2.9953990035056672,145.6400032043457,3.1669743919372566,0.025848856857003392,141.69324760437013,151.76574935913087,0.6968667685744369,0.039225621215905185,0.9937524508249005,1.0001068350293199,0.9924152346363141,0.0054044605936158785,58.452670904462536,153.56600745021083,146.01724948883057,138.4684915274503,145.694641658238,1.7048410764041977,146.538391658238,4.164489404983368,146.2586016396029,146.16001883374904,4.501613253818915,1.2038734359226209,27837700,2.8526208037699217,0.8632499425150216,258125100.0,-50.0,45.37968769486497,52.4753318404932,-22.50527511436608,29.455149870690825,32.799531331991396,0.05242897449830154,3.130028369548195,149.70191906738282,147.17903924560548,145.13999938964844,143.1009595336914,140.57807971191406,0.04,0.0,140.30635589604128,0.0072171774739338,0.010161590921487053,145.67566571916853,146.51541682652064,3.8672305443320476
2024-02-14,0,145.65750122070312,140.18999862670898,152.69499588012695,143.4987506866455,148.32312297821045,0.26365363747269177,3.6984048742921196,-0.9250277704438843,2.9954127032468048,145.6400032043457,3.053012008666991,0.02530660207627819,141.69324760437013,151.76574935913087,0.6500401718483368,0.02991695770351162,0.9966719567237384,1.0088953636496132,0.9951322200098699,0.004794394091447218,50.599731546095406,153.5406841077151,146.14387435913085,138.7470646105466,145.97607040405273,1.46385594565858,146.14732033865792,3.9515105241100796,145.96190728340312,146.19016224838887,3.5059568897027855,-2.4815612177415525,22704200,2.918680973138935,0.7021699997850582,280829300.0,-45.3703523826848,45.37968769486497,52.4753318404932,-21.61727664089952,27.752688991004785,30.90377051563531,0.04637368275766637,3.0787663557925415,149.70191906738282,147.17903924560548,145.13999938964844,143.1009595336914,140.57807971191406,0.04,0.0,140.38428180309677,0.00274845376515076,0.012768909537160953,145.99815586635046,146.09233202253068,3.6972976059163747
2024-02-15,0,142.47250366210938,140.18999862670898,152.69499588012695,144.1656255722046,148.32312297821045,0.27527960368052934,3.5004347960869726,-0.770835460644002,2.995446925384083,145.72500228881836,2.8384744262695305,0.0239129731181394,141.88599891662597,151.76574935913087,0.6503934202560427,0.019064932200568055,0.9732908477411298,0.9842711085444704,0.9724488189683279,-0.022772087853489276,50.741988972786274,153.38311904285752,146.3822494506836,139.38137985850966,145.71142796107702,1.9111926893485762,145.48749923706055,3.7153884656561784,145.88901512706394,146.32865623986666,1.3710317325467594,-3.6226479977347945,37590700,2.888570531454646,1.1416531643916537,243238600.0,-63.71525048964115,45.37968769486497,52.4753318404932,-94.61087209590966,24.33657348396574,35.253445005397914,0.0612564603276288,3.2542906534699685,149.70191906738282,147.17903924560548,145.13999938964844,143.1009595336914,140.57807971191406,0.04,0.0,140.42936517816224,-0.021520100307850232,-0.019032504388761622,145.8083735874721,145.42024666922433,3.731547198433709
2024-02-16,0,141.71000289916992,140.18999862670898,152.69499588012695,144.1656255722046,148.32312297821045,0.2678988208542455,3.524454958458523,-0.7944250642809312,2.99544289196456,145.72500228881836,2.8591743850708013,0.024080848805826723,141.88599891662597,151.76574935913087,0.6409398353218678,-0.02072342521801229,0.9682340090340344,0.9785369135241666,0.9716480043586915,-0.041366441233300355,40.929088287664044,153.408159413377,146.35924949645997,139.31033957954293,145.2467863900321,2.4445586766349177,144.7028568812779,3.200428202259504,145.03783783218245,145.9593352737941,-1.28355939098375,-6.088916668715957,31451100,2.9205400249294153,0.9578800313211246,211787500.0,-76.5186599356849,45.37968769486497,52.4753318404932,-104.41165692988275,22.66441753684761,33.55209857276587,-0.021811884816034598,3.239382586799165,149.57967626953126,147.08015698242187,145.05999755859375,143.03983813476563,140.54031884765624,0.04,0.0,140.44628807138403,-0.056912731310368336,-0.036940568687551016,145.09205409458704,144.4934539794922,3.96526658757786
2024-02-20,0,140.5875015258789,140.18999862670898,152.69499588012695,143.38375091552734,148.32312297821045,0.29166046148819635,3.66454452676236,-0.9392670389199771,2.9954187106320007,145.72500228881836,3.0291618919372554,0.025070364221050703,141.77524795532227,151.76574935913087,0.6618314452228644,-0.034870250412282436,0.9618057148551791,0.9697679460790668,0.9721031424372374,-0.051142278697542065,38.21415677672076,153.49946354235527,146.17037448883056,138.84128543530585,144.50321469988143,2.983176136538464,143.86857114519393,2.5286583192947085,144.2095296390919,145.4466748918513,-2.243677595417895,-7.194075298695963,25144700,2.90135502972481,0.7741288560474131,186642800.0,-64.29679872080902,45.37968769486497,52.4753318404932,-100.70286104449694,21.324495087796144,33.05219245705548,0.031699621336954885,3.1920662692363577,146.38616186523439,144.49692150878906,142.97000122070312,141.4430809326172,139.55384057617186,0.04,0.0,140.45331223109068,-0.04344877245962231,-0.052885939343857234,144.40855189732142,143.75572858537947,4.126430374821608
2024-02-21,0,141.84249877929688,140.18999862670898,152.69499588012695,142.3287525177002,148.32312297821045,0.3417134889640543,3.855921767614849,-1.0279462701484852,2.9953838129088566,145.38125038146973,3.212899169921877,0.02643608970717496,141.5977527618408,151.76574935913087,0.6797289462327067,-0.03971923264608113,0.9724681277283358,0.9805215924175953,0.9911673964838161,-0.022483724015242013,36.09163697546728,153.57009300880148,145.8582494735718,138.1464059383421,143.6485721043178,2.7180971687052704,143.86464255196708,2.531996714879199,143.3352655262592,144.75998144020483,-3.5701436707699883,-7.670711192290452,23315700,2.9074914070425253,0.7159683791917554,209958500.0,-53.24573485087897,45.37968769486497,52.4753318404932,-72.0549090472982,21.749364526404392,31.495962789166427,0.03474649614944617,3.106061306827316,146.38616186523439,144.49692150878906,142.97000122070312,141.4430809326172,139.55384057617186,0.04,0.0,140.47498087136347,-0.017844875339846133,-0.03375583306635442,143.48817879813058,143.93052782331193,4.187445277101502
2024-02-22,0,144.20499801635742,140.18999862670898,152.69499588012695,141.8837490081787,148.32312297821045,0.4384017257073134,3.9506519946829655,-1.075828908982708,2.995365683438169,145.03374671936035,3.3370249366760247,0.02712796280753739,141.5977527618408,151.76574935913087,0.7074931103162413,-0.0467413888171912,0.990213217492643,0.9985665881160558,1.0122916617226956,-0.009972045326693046,38.50941854385578,153.53155358500803,145.63024959564208,137.72894560627614,143.08285794939314,1.9148368434427834,144.03767830984933,2.4605257402288814,142.9908752924597,144.34021639390184,-4.0470138964656694,-0.03876058812216215,27191900,2.862547517264615,0.8324938305924545,237150400.0,-41.34470706432274,45.37968769486497,52.4753318404932,-29.5351331977292,25.971541233553644,29.66265454749088,0.053972125939479525,3.05839029062395,146.38616186523439,144.49692150878906,142.97000122070312,141.4430809326172,139.55384057617186,0.04,0.0,140.53202785300923,-0.01267648241037711,-0.0072344032322522985,142.997314453125,144.13957323346818,4.143759156007074
2024-02-23,0,143.93499755859375,140.18999862670898,152.69499588012695,141.8837490081787,147.90999698638916,0.6059728387081104,3.8929316249590937,-0.8580703887731609,2.9953757027954784,144.6437473297119,3.2039999389648415,0.026773830162407225,141.5977527618408,151.76574935913087,0.6822015131079417,-0.04583727320368036,0.9899200783165005,0.997220014059298,1.01246098027878,0.010265095782642009,44.55660259615992,153.18648771586058,145.40062446594237,137.61476121602416,142.91571480887276,1.7531461389996732,144.30517823355538,2.1997997706494847,143.31521266609505,144.30631161181176,-2.6726954152185995,1.7086034275546245,19493800,2.863919495088913,0.6057658663249268,217656600.0,-55.075350837240045,45.37968769486497,52.4753318404932,-23.052516138634495,25.166653650862752,28.74337516779509,0.03534014358164833,2.927150736671021,147.0918031616211,145.63910360717773,144.46500396728516,143.29090432739258,141.8382047729492,0.04,0.0,140.57248496080592,0.008335037298377035,-0.013567268479362234,142.82893589564733,144.25230080740792,3.8760202479270056
2024-02-26,0,139.88500213623047,140.18999862670898,152.69499588012695,141.8837490081787,146.30062675476074,0.8232128026600951,3.6728857828290544,-0.3271304674080273,2.9954137814979607,144.26499938964844,2.8891500091552755,0.02532313021725182,141.5977527618408,151.76574935913087,0.6223052610474313,-0.051249104032686454,0.964453112344763,0.9704094151790065,0.9819523387991024,-0.01287841878203888,43.39112957786352,152.38652092478898,145.04074935913087,137.69497779347276,142.09107208251953,1.5994116366789233,144.03357124328613,2.496646870276754,143.46683498735655,144.14085614900256,-0.8063140397185423,2.67137382735609,53641800,2.8554863942608697,1.5985405016310437,164014800.0,-98.50615859766066,45.37968769486497,52.4753318404932,-127.28103869506052,21.410783357048654,38.173765793299644,-0.06144814984950989,3.1912201493117482,146.59620172119142,144.83690127563477,143.41500091552734,141.99310055541991,140.2338001098633,0.04,0.0,140.52801286218565,-0.020993390053793193,-0.03642215918532388,141.6345934186663,143.81637464250838,3.8535725322234033
2024-02-27,0,138.31000137329102,139.88500213623047,152.69499588012695,141.82749843597412,145.69125175476074,0.9575034408347914,3.4993792975350115,0.2946847530009258,2.995441009877886,144.0699977874756,2.687399368286134,0.02422562424490171,140.54775123596193,148.57524757385255,0.4643836071688731,-0.08389268862453722,0.9574972695704657,0.9647975580998751,0.9733903045193764,-0.01619987643189358,33.74607846641282,151.44825810678878,144.44949951171876,137.45074091664873,141.49642889840263,2.1222828724679568,143.60392842973982,2.9236727740155732,142.55815330603127,143.50143642569654,-3.9630633754495426,-2.646366499361135,33099200,2.9460006550072104,0.978615406084947,130915600.0,-85.50601084794346,45.37968769486497,52.4753318404932,-137.0058152593491,20.336227907506775,36.95497244657398,-0.060433025007197015,3.116546857736257,146.52540100097656,144.72230010986328,143.26499938964844,141.8076986694336,140.00459777832032,0.04,0.0,140.48832071286108,-0.015872978071275967,-0.011670954655738582,141.0795157296317,143.44394465855189,3.395939060496035
2024-02-28,0,136.92499923706055,138.31000137329102,152.2675018310547,141.76437377929688,145.24312496185303,0.7303871091733644,3.195871814095274,0.5525958363213279,2.9954863388184685,143.81124877929688,2.493749237060547,0.022235206707323103,140.15949897766114,147.85899696350097,0.319295257145716,-0.09166434262019964,0.9526526214249895,0.9617478179640224,0.9667420925551669,-0.0346687317592157,31.227528137762345,150.12199341456753,143.73024978637696,137.3385061581864,140.81285694667272,2.726596429833277,143.0298216683524,3.388557979760286,141.47166021327845,142.69018064932894,-2.921617983698969,-4.167676672684281,37328600,2.952079805129286,1.102038478616168,93587000.0,-93.08623446115696,45.37968769486497,52.4753318404932,-168.25358336823632,18.711554864180762,37.87050132052854,-0.032618919266420625,3.1421163174665954,146.1289227294922,144.08054290771486,142.4250030517578,140.76946319580077,138.72108337402344,0.06,0.0,140.407966190642,-0.04328299780302025,-0.03358837857949014,140.488765171596,142.7904096330915,3.2464435608987503
2024-02-29,0,137.75,136.92499923706055,148.16499710083008,141.42937755584717,144.99812030792236,-0.14580544864481032,2.880356543163134,-0.5026545143772996,2.995529078480098,143.0800018310547,2.4028741836547853,0.020147548887730637,139.7275020599365,145.99575271606446,0.6751329701670264,-0.03504289983611299,0.9635351796542189,0.9731337334874474,0.9793675193297442,-0.04476265112271083,33.325426333595274,148.72383774300351,142.96312465667725,137.202411570351,140.40749958583288,2.9660881653357514,142.45535714285714,3.561484146456693,140.30331718119714,141.80047799762784,-3.376616727270848,-5.544533929695834,42133000,1.9044808715966783,1.301065018665387,135720000.0,-78.26084592210731,45.37968769486497,52.4753318404932,-120.54330030185423,19.61307945128,35.676752604619125,0.10844138855949144,3.0942611380359613,146.1289227294922,144.08054290771486,142.4250030517578,140.76946319580077,138.72108337402344,0.06,0.0,140.3509522687421,-0.03907272670793427,-0.02869158448845072,140.1092027936663,142.25887734549386,3.340445914434056
2024-03-01,0,137.83999633789062,136.92499923706055,148.16499710083008,140.48812580108643,144.99812030792236,-0.15417127064514813,3.091197985474146,-0.7820664189989799,2.9954975293218924,143.0800018310547,2.610249137878418,0.021653754695815354,138.2540012359619,145.99575271606446,0.7465141636561589,-0.028441433038511595,0.9655652863383162,0.9792397878682827,0.9890858725003524,-0.042345512377710226,36.67224190391563,148.93814567340192,142.7557497024536,136.5733537315053,139.83571352277482,3.0284855719448673,141.7421428135463,3.399561956374536,139.65783737871448,141.3732233517537,-2.0183170588294352,-5.516403910867553,31119500,1.91979731435112,0.9750401991219484,166839500.0,-87.58078508866095,45.37968769486497,52.4753318404932,-113.52323985541449,18.719974938696314,34.008576258958755,0.11500612752498025,3.011628722686937,146.05251806640626,144.01873913574218,142.375,140.73126086425782,138.69748193359374,0.06,0.0,140.3061228862733,-0.04737425569680509,-0.04823373663376645,139.3372323172433,141.41270555768693,3.559703856337794
2024-03-04,1,134.14500427246094,136.92499923706055,148.16499710083008,140.11374950408936,144.99812030792236,-0.11823037833006245,3.2676470516493623,-1.018387905140141,2.995469294671468,143.0800018310547,2.80737419128418,0.022921426603923024,137.83099670410155,145.99575271606446,0.7746888535482961,-0.016762981038867326,0.940981330331296,0.9561365688758562,0.9710660367612199,-0.041033690360740005,37.98514820763553,149.09391875234658,142.55862464904786,136.02333054574913,138.39857155936105,2.9962819955622955,140.74071475437708,3.426870315239045,139.20078079748566,140.9562205900089,-2.8217935215834267,-6.7546090421010465,55999400,1.8927012903890406,1.7725502460072877,110840100.0,-90.24388226744036,45.37968769486497,52.4753318404932,-177.02544596750624,16.492579554743504,41.360049357477095,0.004507483559166155,3.171701089600997,143.18663946533204,141.031680267334,139.29000091552734,137.5483215637207,135.39336236572265,0.08,0.0,140.11326014046642,-0.030675303063599335,-0.07370093870304455,137.80470711844308,140.40101078578405,4.120572401084024
2024-03-05,1,132.1150016784668,134.14500427246094,148.16499710083008,139.4912519454956,144.99812030792236,-0.40101186419897056,3.720899527355775,-0.6924353936595047,2.9953889103146962,143.0800018310547,3.1312367820739753,0.026156293727798034,137.66749992370606,145.99575271606446,0.7515047311253835,-0.06641145351919313,0.9287105884867114,0.946772501214324,0.9643853120795155,-0.044790684934665426,26.590691913703697,149.698173986047,142.25637493133544,134.81457587662388,136.7100007193429,2.668912762792237,139.81285776410783,3.8825824681317838,137.95284948434303,140.16721375092322,-6.9761755017363285,-9.462418994162418,40194800,1.8493606791805663,1.2688942113575672,70645300.0,-87.3817083290814,45.37968769486497,52.4753318404932,-170.99747919388707,15.476375903277933,41.66250136564227,0.05990615843580425,3.1362474708560732,142.77940283203125,140.46530194091798,138.59500122070312,136.72470050048827,134.410599609375,0.1,0.0,139.9521374979089,-0.044714859612685065,-0.03561830815173873,136.1936994280134,139.51131766183036,4.614491719521092
2024-03-06,1,132.23749923706055,132.1150016784668,148.16499710083008,138.19250011444092,144.99812030792236,-0.507675797844917,4.307000478728054,-0.5596779624092072,2.9952676394270497,142.15750122070312,3.5864493560791004,0.03039997796594163,136.6469997406006,145.99575271606446,0.7682730409093153,-0.08460072073395065,0.9333681486529711,0.9534392799699619,0.9740893443320104,-0.034234069936961986,22.880803097508853,150.2917509727149,141.6777500152588,133.06374905780268,135.61750030517578,2.7174224134727902,138.85428619384766,3.9839096895483914,136.50029409868563,139.2282328450422,-8.212037433991835,-8.952136662933158,35318600,1.8587365147370725,1.1041703465988049,105963900.0,-94.9058225103846,45.37968769486497,52.4753318404932,-148.8805516463276,15.28502462086936,39.02469875556216,0.03370636338550369,3.106974425778119,141.6181195678711,139.52593930053712,137.83499908447266,136.1440588684082,134.0518786010742,0.1,0.0,139.81148681697854,-0.03651571303853218,-0.05385952094804584,135.3132781982422,138.47393580845423,5.103573728049687
2024-03-07,1,133.43000030517578,132.1150016784668,148.16499710083008,137.81749725341797,144.99812030792236,-0.40780753581791773,4.721282008377302,-0.8230507346598537,2.995169478761872,141.7762508392334,3.9865368652343762,0.0334668537590453,133.9542537689209,145.99575271606446,0.8134898464951248,-0.08778128961074969,0.9458198640452463,0.9687460885503308,0.989708309404497,-0.03136115930906869,22.72297696557063,150.51593895571946,141.07337493896483,131.6308109222102,134.92035729544503,2.531134233749424,138.20839309692383,4.083935344224376,135.44911699291453,138.43745651290504,-5.466992731445371,-9.213395720216514,37738200,1.8435645048839218,1.1571515237091694,143702100.0,-74.11021465588932,45.37968769486497,52.4753318404932,-105.9275145360754,17.164173477970795,35.85462636149783,0.036467546070730404,3.1381577345939626,141.6181195678711,139.52593930053712,137.83499908447266,136.1440588684082,134.0518786010742,0.1,0.0,139.6978725665445,-0.02946706278100375,-0.014664935098684365,134.67115783691406,137.87533678327287,5.189769443181273
2024-03-08,1,135.4275016784668,132.1150016784668,148.16499710083008,137.54374980926514,144.42999839782715,-0.2216793591463604,4.911497150348241,-1.0545905076112783,2.995119416674395,141.1487522125244,4.1833247756958,0.03495808366585088,133.31075019836425,145.99575271606446,0.8426640586563252,-0.0847951901991254,0.9639191043808967,0.9910012199628346,1.0110038282555225,-0.017502138156693103,27.453180284571868,150.3197445600959,140.49675025939942,130.67375595870294,134.70642907278878,2.3929790420991437,137.75964300973075,4.014144947259798,134.95706493641381,137.9038783238268,-3.5283067165507305,-6.346841056698895,39343100,1.86078148056635,1.1761067655785995,183045200.0,-66.92250601886212,45.37968769486497,52.4753318404932,-64.47122440072967,22.658341309540287,32.563366245754715,0.006599723551892649,3.2066608673419577,141.6181195678711,139.52593930053712,137.83499908447266,136.1440588684082,134.0518786010742,0.1,0.0,139.625060674403,-0.012614811751946897,-0.022028058478903732,134.53274536132812,137.51075526646204,5.138037739509495
2024-03-11,1,137.25750350952148,132.1150016784668,148.16499710083008,136.5506248474121,144.00249767303467,-0.027320987927106116,4.87204629736362,-1.0816497154552058,2.995126129124664,140.2362518310547,4.171999549865722,0.03480567580918539,133.31075019836425,145.87425079345704,0.8357305338992829,-0.08386602757121052,0.9805613243280676,1.0106843404198393,1.0283694737771067,0.02320249832590693,34.045529603111,149.72259277020333,139.97850017547609,130.23440758074884,134.63607243129186,2.293763231363151,137.52178600856237,3.9314997382795616,135.08468185813103,137.6285757126278,-1.0936626378950036,-4.4333505695947775,32437800,1.858140380588126,0.9616216103244374,215483000.0,-51.151436807005624,45.37968769486497,52.4753318404932,-30.22059383928467,23.044278460514104,29.896925411887473,-0.020707759658927204,3.2414278107117434,141.6181195678711,139.52593930053712,137.83499908447266,136.1440588684082,134.0518786010742,0.02,1.0,139.5945942070298,0.03239583705646609,0.003864634638639841,134.4200156075614,137.26460920061385,4.689409456639244
2024-03-12,1,137.98500061035156,132.1150016784668,148.16499710083008,136.5506248474121,142.83812713623047,0.04990263556918926,4.555158712083082,-0.9811035025736512,2.995198866554512,139.09750175476074,3.9063747406005858,0.03266514602001879,133.31075019836425,145.160249710083,0.8100189205244877,-0.07361720922442812,0.9894935562954994,1.0180107886469938,1.0290207899071635,0.04443097950504371,40.79170851121464,148.5604429277062,139.45012550354005,130.3398080793739,134.6567873273577,2.3279206161333863,137.24625042506628,3.7356917123720397,135.62338613384537,137.5376424604232,-0.35752921268857757,-2.3686301984280207,27563400,1.9284836997004957,0.8099173845128578,243046400.0,-45.35938010778049,45.37968769486497,52.4753318404932,-11.609996821327771,22.452479470059718,28.307184491709183,0.01617708748410161,3.17733966807711,141.6181195678711,139.52593930053712,137.83499908447266,136.1440588684082,134.0518786010742,0.04,0.0,139.57802585557135,0.04394363232602094,0.03862011307325934,134.61407906668526,136.97565569196428,4.2775534228295236
2024-03-13,1,139.71749877929688,132.1150016784668,145.65750122070312,136.5506248474121,142.0,-0.0399209688525983,4.098813275897111,-1.0540064439067576,2.9952968439019774,138.1475009918213,3.4929874229431164,0.029500360356704256,133.31075019836425,144.2949981689453,0.8407810136707132,-0.049067909130259275,1.0055877847288666,1.0310398440818604,1.0328977594473399,0.056564889576647515,45.43951684884868,147.13875223081033,138.94112567901612,130.74349912722192,135.4528579711914,2.9840706421711003,136.92571476527624,3.2541641993078056,136.1970451431099,137.60217343327156,0.10519753069746528,-2.719564447992048,23347200,1.8555923786487116,0.690585481146604,266393600.0,-34.90364958574713,45.37968769486497,52.4753318404932,28.138324679136208,25.039069096668403,26.626709082609548,0.009168255318048291,3.1351326856622266,141.37363397216797,139.32817477416992,137.67499542236328,136.02181607055664,133.9763568725586,0.06,0.0,139.58209683253548,0.06385087445785986,0.05366694554811027,135.53302219935827,136.66886465890067,4.02696496680965
2024-03-14,1,142.08500289916992,132.1150016784668,145.65750122070312,136.5506248474121,141.74312686920166,-0.04204616377828196,3.8546307305565906,-0.8799697212537771,2.995345686379768,138.1475009918213,3.196674880981445,0.027796798646750186,133.31075019836425,143.9619976043701,0.7969469144755071,-0.040780614740917744,1.0246138975135635,1.0463545110195014,1.0389102493326736,0.06486549182491763,50.78519948673859,146.38101210198232,138.67175064086913,130.96248917975595,136.87714385986328,3.4658331189615503,136.7935722896031,2.973062991470854,137.0681265620195,137.97839081953683,4.154082768164579,-3.1118888379662972,42753400,1.9046842900260805,1.2281826396472653,309147000.0,-3.792494611591721,45.37968769486497,52.4753318404932,88.08371805456893,28.53367515503621,24.343296673318928,0.0340427578432353,3.182890181800759,140.54087677001954,138.65455703735353,137.12999725341797,135.6054374694824,133.7191177368164,0.08,0.0,139.63618368938293,0.06489063086872338,0.08904119463008911,137.0213143484933,136.60750688825334,3.799704902146985
2024-03-15,1,141.72249603271484,132.1150016784668,144.20499801635742,136.5506248474121,141.74312686920166,-0.22503754386364574,3.601215100360581,-0.9442867459693209,2.995393461225535,138.1475009918213,3.00018747329712,0.02600284368999483,133.31075019836425,142.6187530517578,0.8168991787769321,-0.0027198284088448227,1.0233179104812726,1.0403636294952343,1.0233077450909605,0.04648239298686674,60.11637425427131,145.69555592551364,138.4931257247925,131.29069552407134,138.2321434020996,3.1929861777489146,136.9248218536377,3.155026839606173,138.32075475161827,138.54775229376182,7.546456567413509,-1.2852987048342592,49460600,1.8671483896708914,1.3970425200239862,259686400.0,-18.65328176208332,45.37968769486497,52.4753318404932,69.22156221588804,26.504598111953623,23.582954813347175,-0.012441797217098994,3.180528196328168,140.54087677001954,138.65455703735353,137.12999725341797,135.6054374694824,133.7191177368164,0.08,0.0,139.67610537594902,0.042611188082387175,0.050602662473546695,138.41685485839844,136.8650665283203,3.7213465237487875
2024-03-18,0,148.90249633789062,132.1150016784668,144.20499801635742,136.5506248474121,141.71312618255615,-0.23314802000440124,3.563286841013364,-0.9098741562886961,2.995400364638311,138.1475009918213,2.958937053680421,0.025735948482971543,133.31075019836425,142.2700023651123,0.8285818434380171,8.815985667441585e-05,1.0754528461278707,1.0899644457699065,1.0654652366323962,0.08484048252823806,59.44287442689068,145.5821990253495,138.45562534332277,131.32905166129603,140.44249997820174,4.430332652750383,137.68142863682337,4.49731660908213,139.17951995054833,139.0038266267974,7.172698251538059,1.3135746280325935,69273700,1.8609069331589179,1.8574567260098693,328960100.0,-20.810065688105457,45.37968769486497,52.4753318404932,203.35624475624013,38.14023226310365,18.617637194031396,-0.054003300291930775,3.739611774329097,147.08071490478517,143.94463552856445,141.40999603271484,138.87535653686524,135.73927716064452,0.1,0.0,139.95295969637397,0.07271006939859515,0.09061358698392846,140.3146754673549,137.49291665213448,4.242104947842648
2024-03-19,0,147.51499938964844,132.1150016784668,148.90249633789062,136.5506248474121,141.75249671936035,0.35276407537830884,4.182701306779028,-0.13740114427376593,2.9952797375257063,138.1475009918213,3.354524192810058,0.030131425087079833,133.31075019836425,143.9619976043701,0.6842205512588792,0.059144623254302024,1.0626714238776602,1.068268055700315,1.0382348318660135,0.06906546897954602,73.75176471316978,147.18065262881686,138.81525001525878,130.4498474017007,142.1692853655134,4.50489752095602,138.43785721915108,5.196540908527182,141.62117541340245,140.29061155396278,11.595964923425592,7.65851699763277,24070400,2.4327807231269305,0.6463378400349827,304889700.0,-23.83610863862165,45.37968769486497,52.4753318404932,147.35192240989974,36.11717348994598,19.76355757653446,-0.07247336234044756,3.665737085789927,147.08071490478517,143.94463552856445,141.40999603271484,138.87535653686524,135.73927716064452,0.1,0.0,140.02798773437164,0.0615884198359844,0.06798869684613779,141.97277178083147,138.2527585710798,4.604365301311492
2024-03-20,0,148.08500289916992,132.1150016784668,148.90249633789062,136.5506248474121,141.90312480926514,0.3801829130439091,4.582821493699547,-0.514683319339849,2.995192050295758,138.1475009918213,3.735536575317383,0.03293164690132448,133.31075019836425,144.53599815368653,0.7697806492686282,0.039991544559418835,1.0641224044099316,1.0605681025914129,1.0284502182379824,0.05988873400239347,68.50443513869008,148.32726789584638,139.16162490844727,129.99598192104816,143.71607099260603,4.394824656149366,139.17607171194894,5.791355027281517,143.10319250090373,141.1814417679335,8.925438010279395,7.734161191597486,21311500,2.457485990063986,0.5737999210845052,326201200.0,-15.875181944046835,45.37968769486497,52.4753318404932,142.29188792920343,34.71351221918318,18.918169904183337,-0.07424236835679163,3.554866529972918,147.08071490478517,143.94463552856445,141.40999603271484,138.87535653686524,135.73927716064452,0.1,0.0,140.10043662713144,0.06402463179348206,0.07393497987223277,143.55238778250558,138.9862016950335,5.037928109551659
2024-03-21,0,148.58499908447266,132.1150016784668,148.90249633789062,136.5506248474121,142.54750156402588,0.39647744358462117,4.95245496714442,-0.7787510182649635,2.9951045278374018,138.1475009918213,4.078874301910401,0.03550815091069706,133.31075019836425,147.57199974060057,0.7882715572436293,0.026906174794110702,1.0653259051438408,1.0522066798329914,1.0200670015690587,0.045747236180270434,68.49167692619224,149.37866004872973,139.47375011444092,129.5688401801521,145.23035648890905,3.8879465796443005,139.94357190813338,6.291100764978691,144.3503102411405,141.95898581952386,7.888457179244368,7.502724427709562,24755600,2.4103964854282856,0.668723618405378,350956800.0,-21.18244272802766,45.37968769486497,52.4753318404932,133.12175874259518,35.33066082823525,17.591754964847766,-0.10077606909384258,3.548781256720933,147.08071490478517,143.94463552856445,141.40999603271484,138.87535653686524,135.73927716064452,0.1,0.0,140.18480040548204,0.03144654826590498,0.055869584816586576,144.85089765276228,139.73248835972376,5.266460429849705
2024-03-22,0,150.11249923706055,132.1150016784668,148.90249633789062,136.5506248474121,142.54750156402588,0.43382343860359623,5.245031623586979,-0.8951531618360811,2.9950308724378334,138.1475009918213,4.319774360656737,0.037546913617813774,133.31075019836425,148.1350025177002,0.8105909679365729,0.03230626049780535,1.0745904784370994,1.0517364229483284,1.0214375179645372,0.05920022183640472,69.5838910282589,150.18281341502063,139.69275016784667,129.2026869206727,146.71535655430384,3.3838812273370675,141.08410726274764,6.598866678454846,145.40863881144472,142.56699993045464,7.681993279873847,7.795272077810084,29175700,2.4085551558224916,0.7779507256366277,380132500.0,-6.424533978161742,45.37968769486497,52.4753318404932,148.08652092174796,34.93785587779065,16.18966521937071,-0.0808639205465263,3.5796929749533253,147.08071490478517,143.94463552856445,141.40999603271484,138.87535653686524,135.73927716064452,0.1,0.0,140.30785209709825,0.06792760906601725,0.053598892590951366,146.41767229352678,140.9753472464425,5.762557307614779
2024-03-25,0,149.55250549316406,132.1150016784668,150.11249923706055,136.5506248474121,143.44250202178955,0.4747667467303307,5.651873875274727,-0.9988358552992427,2.994922173828355,138.1475009918213,4.699611911773678,0.0403700590268917,133.31075019836425,148.61674880981445,0.8438393557069379,0.07311360721051266,1.0682197811933851,1.037141999523348,1.006139034629054,0.004365334170076229,76.07553184369178,151.30537300231947,140.00162525177,128.69787750122055,147.78214263916016,2.809119798030055,142.32964324951172,6.418934813423131,146.58180820174823,143.2255690720025,7.440013275777298,11.903160353380098,19229300,2.1979067699791366,0.5373917247604635,360903200.0,-9.76520077139312,45.37968769486497,52.4753318404932,113.52004419538349,32.848077430326576,17.57328730462562,0.005221333510755562,3.534564639855948,147.12319677734376,144.0133985595703,141.5,138.9866014404297,135.87680322265624,0.1,0.0,140.37935183894484,0.01618369463698155,0.06296935704381143,147.41224452427454,142.21677943638392,6.161379213792468
2024-03-26,0,150.78249740600586,132.1150016784668,150.11249923706055,136.5506248474121,147.6575002670288,0.3505216918064529,6.022483903742773,-1.2827613516634473,2.9948175136092186,138.1475009918213,5.267999801635744,0.042869230777336564,133.31075019836425,148.96749725341797,0.8745022688731741,0.08128482400582264,1.0732996188606,1.036831365223967,1.013527567176108,0.022150276445628503,75.27872896443616,152.52996822710224,140.4850004196167,128.44003261213118,149.0764285496303,1.1477154005344978,143.65428597586495,6.080671075660451,147.32509130345693,143.84629194443124,5.255658543564534,13.198731100299698,22149100,2.1578631829963957,0.6286081694853249,383052300.0,-7.699742410874606,45.37968769486497,52.4753318404932,114.67848487943763,35.20068713430872,16.739885912031667,-0.03798221394658371,3.444675267075172,147.38659594726562,144.3716968383789,141.93499755859375,139.4982982788086,136.48339916992188,0.12000000000000001,0.0,140.47417914666767,0.02475679272273279,0.02024647932852956,148.7664053780692,143.5916301182338,6.548174056935261
2024-03-27,0,150.6474952697754,132.1150016784668,150.78249740600586,136.5506248474121,148.2100019454956,0.20925788625337974,6.398968326557367,-1.4566112823116522,2.9947067734110613,138.85124969482422,5.736487178802491,0.04534781850878393,133.31075019836425,149.6085048675537,0.8743463422141323,0.10120502644629265,1.0675994825515902,1.0268666279530165,1.0081914453820933,0.01730419907781111,78.69190174580932,153.90656187436718,141.10862522125245,128.31068856813772,149.32571411132812,1.2849448126744583,144.88410704476493,5.5737282798326815,148.18587287231352,144.41499051967944,6.392775760313754,14.024008527036587,22879200,2.1102656470003396,0.6629216657358492,360173100.0,-7.61226619826237,45.37968769486497,52.4753318404932,96.11506050522995,33.1651250447579,18.051187934110143,-0.010533153235461598,3.3941969964852254,147.95063580322267,145.2846766052246,143.12999725341797,140.97531790161133,138.30935870361327,0.12000000000000001,0.0,140.56578342309317,0.014320223074671512,0.026117041216402112,149.22159685407365,144.76813616071428,6.794890731187051
2024-03-28,0,150.84499740600586,132.1150016784668,150.78249740600586,136.8000030517578,148.66437339782715,0.03642779273953124,6.644576297418433,-1.547092032877406,2.9946343584955626,140.71999740600586,6.0114747810363784,0.04686052407684967,133.31075019836425,150.16599884033204,0.8931001860337169,0.09362972972613713,1.0638263925967413,1.0206090569852497,1.0060625741127247,0.01521013787029979,77.70645243614575,155.08390261772504,141.7947500228882,128.50559742805135,149.8014281136649,1.1069406993871271,145.98535673958915,5.0610893215273265,148.79318403166175,145.01092947561867,1.171907103508192,12.903765963591727,24485400,2.1188457081645544,0.7280756829519337,384658500.0,-8.245521925654742,45.37968769486497,52.4753318404932,89.14935950688425,32.24180045826648,17.548638777052894,-0.04556835674476666,3.2413470587871247,148.4533169555664,146.098338470459,144.19499969482422,142.29166091918944,139.93668243408203,0.12000000000000001,0.0,140.6656027272189,0.022560902088330392,0.014723647250337642,149.7781001499721,145.87543596540178,7.037200765994903
2024-04-01,0,153.13250350952148,132.1150016784668,150.84499740600586,136.8000030517578,149.06499862670898,-0.12892231912176114,6.8555849879463455,-1.5776404316619546,2.9945711583991077,141.90374946594238,6.2981993484497085,0.04812642370164024,133.31075019836425,150.66099548339844,0.9011583836588706,0.09434853027880058,1.0749950236704469,1.0299815348124555,1.0182494917550253,0.020118273213822757,77.98122831885594,156.16066986908118,142.4494998931885,128.7383299172958,150.5224996294294,1.406072848501318,147.1192853110177,4.722249263939751,149.28931425670953,145.55655833689937,2.2573962174256685,11.384316727737783,31730800,2.117408816350352,0.9426615956930393,416389300.0,-1.3361833794250269,45.37968769486497,52.4753318404932,107.80441118053938,37.874262783258025,15.639531588962049,0.03280694689630961,3.3765854924634913,151.3244439086914,148.5927829284668,146.38500213623047,144.17722134399415,141.44556036376952,0.14,0.0,140.83068480615663,0.03130592968099011,0.053455253945213346,150.74128069196428,147.14683423723494,7.489417924128995
2024-04-02,0,153.72749710083008,132.1150016784668,153.13250350952148,136.8000030517578,149.69250392913818,-0.255593808517835,7.145512280444516,-1.5130958214073014,2.994481499383279,144.80000114440918,6.601874351501465,0.0498939072377304,133.31075019836425,150.78874740600585,0.869615113826784,0.14154458706859613,1.073410160000472,1.0261086766961918,1.0181168359068882,0.027916560768397547,86.25623126684307,157.50514981265908,143.21412525177,128.92310069088094,151.25714220319475,1.5600452762346255,148.24374934605189,4.2283542022974805,150.2307133564356,146.36030681799022,3.4085157251125366,11.565852207780217,24586000,1.873517303618222,0.7661531452446994,440975300.0,-7.044823489972014,45.37968769486497,52.4753318404932,97.00402876201113,35.19002300093717,14.531120499663894,0.08875666457385693,3.3739670610219505,151.78700549316406,149.34150549316405,147.36500549316406,145.38850549316408,142.94300549316407,0.14,0.0,140.95443321219676,0.029919339052352223,0.025137554592232096,151.7344251360212,148.29266139439173,7.498298836931182
2024-04-03,0,154.08250045776367,132.1150016784668,153.72749710083008,137.80312633514404,150.24624824523926,-0.4059859050277252,7.177308848134778,-1.3270108558130815,2.9944842433691043,147.80000114440918,6.5761744308471695,0.04977562301599686,133.31075019836425,151.07374801635743,0.8453397093767748,0.16358850355966703,1.06858331143726,1.025176570533077,1.0148557394072923,0.021885849541754432,89.99058027548016,158.54786758945804,144.19324989318847,129.8386321969189,151.82428523472376,1.7806052717483438,149.2698208945138,3.7115337559752475,151.09376458847606,147.25135571972464,3.460980615838507,11.408846194038805,24705000,1.7368328686250178,0.7889014136679046,465680300.0,-5.21964973760916,45.37968769486497,52.4753318404932,95.02063132891789,34.220701606071266,13.790553239024584,0.08931652417287152,3.3006707666338015,152.03244390869142,149.7387829284668,147.88500213623047,146.03122134399413,143.73756036376952,0.14,0.0,141.0806026076569,0.028207372024849686,0.032318228352151576,152.32660130092077,149.37213679722376,7.311044040338926
2024-04-04,0,152.3125,132.23749923706055,154.08250045776367,139.28437423706055,150.681245803833,-0.5212499100696987,6.921198930430617,-1.1414810789060772,2.9945874361334384,148.3350009918213,6.2470495605468725,0.04763659941463427,135.2277515411377,153.19200286865234,0.8279334612809642,0.16519520821807027,1.0483226419689191,1.0089910765974932,0.9988556483489667,0.011052322690416894,90.24066950682617,159.13402269301454,145.29162483215333,131.44922697129212,152.21857016427177,1.4726663474720225,150.00035640171595,3.1530938824912456,151.83539528717733,148.2115067160407,2.6446839809346074,10.281462095995796,34724700,1.730445725998058,1.109911604246052,430955600.0,-33.16361863339197,45.37968769486497,52.4753318404932,66.18725911849708,30.985864900964042,17.30854250937636,0.06966305321952039,3.384360007063772,152.03244390869142,149.7387829284668,147.88500213623047,146.03122134399413,143.73756036376952,0.14,0.0,141.2233055438563,-0.0022535254621747214,-0.0009291301044744144,152.3922402518136,149.90224238804407,6.580504637981967
2024-04-05,0,151.38750076293945,133.43000030517578,154.08250045776367,141.22124671936035,150.79812240600586,-0.6447636817770775,6.390587230373698,-0.984271647361683,2.994768590876534,148.74374771118164,5.644262027740479,0.04368277012201746,137.07450332641602,153.19200286865234,0.8252646485968999,0.1415161481798465,1.034807155709151,1.0000627651740088,0.9906262339042965,0.0035964292237906648,78.24992044442487,159.07654933104766,146.2953748703003,133.51420040955293,152.30499921526228,1.3897576852741282,150.6907138824463,2.0750329429606844,151.95808446954453,148.84203746516633,1.8455020179933361,7.198153846038193,23449300,1.8489759144129663,0.7670298800584595,407506300.0,-33.54041682067613,45.37968769486497,52.4753318404932,62.55690712444805,28.50594108878056,17.704116567819767,0.05020742558350298,3.415533874478518,153.46024462890625,152.04988409423828,150.91000366210938,149.77012322998047,148.3597626953125,0.02,1.0,141.31688854204464,0.010402217244943834,0.010804083117584799,152.6533704485212,150.7098879132952,6.052130339474487
2024-04-08,0,153.87750244140625,135.4275016784668,154.08250045776367,141.99437618255615,150.98062324523926,-0.7628066710088234,5.749262540758213,-0.8162632438400319,2.9949614458309743,149.22750091552734,4.896449584960942,0.03905928121656526,137.91225090026856,153.19200286865234,0.8210418598780156,0.1178490253948938,1.0454114067939138,1.014633247990214,1.006205527896519,0.004865060746809036,71.87743311944185,158.6917749747049,147.19324989318847,135.69472481167202,152.76642881120955,1.2795562189998277,151.04607146126884,2.169099343331324,151.8045759696804,149.30745375087656,0.4012424302169011,6.819668719349655,20702000,1.8803760281560546,0.6984597077447818,428208300.0,-9.213240706516416,45.37968769486497,52.4753318404932,94.4439942837326,30.757762313543573,16.662703904805312,0.096289423796908,3.369345795249285,153.46024462890625,152.04988409423828,150.91000366210938,149.77012322998047,148.3597626953125,0.02,0.0,141.41670510933758,-0.004116024436187193,0.025972344762034125,153.2212916782924,151.22144426618303,5.567813642300931
2024-04-09,0,156.61000061035156,137.25750350952148,154.08250045776367,146.1575002670288,151.6187505722046,-0.8696902204240562,5.245506028591606,-0.5571373039770489,2.995098396235121,149.8325023651123,4.2442745399475115,0.03541491050764929,139.54424896240235,153.74249763488768,0.7869030247849357,0.12108626856040584,1.0573487335611098,1.0300934531485042,1.0230765491613232,0.01875073466935362,75.93995392893422,158.60676198851866,148.11574993133544,137.62473787415223,153.59000069754464,1.6409771312651946,151.69571440560478,2.381745154057639,152.32182547501444,150.04665868076233,2.1440828908881966,3.341116654099811,31113000,1.9042879842177078,1.0520651000151657,459321300.0,-16.58200313696128,45.37968769486497,52.4753318404932,130.9132227458015,35.287759607988164,15.359526406604209,0.0858892206655683,3.393716246658152,155.77047943115235,154.0447605895996,152.6500015258789,151.2552424621582,149.52952362060546,0.02,1.0,141.5929922285221,0.013198839412225993,0.007138765188739296,154.03036499023438,151.90423257010323,5.253519915845493
2024-04-10,0,155.9099998474121,137.98500061035156,156.61000061035156,147.94250202178955,152.51750087738037,-0.8543873310193503,4.928648354057458,-0.16426622454385154,2.995180366144565,150.37999725341797,3.806950225830076,0.03305967792263736,141.52199630737306,153.898002243042,0.7219206961818759,0.13497843908842047,1.045790652853258,1.0207508837629904,1.0146823316046052,0.011860525265485089,79.85906593041702,158.94067149449188,149.08337478637696,139.22607807826205,153.98678588867188,1.8361126796878664,152.25464275905065,2.3873799811593988,153.39548133754505,150.998459880641,3.8218060283623108,6.165475550509576,22838600,1.9482510260935488,0.778490661544584,436482700.0,-20.75469475888242,45.37968769486497,52.4753318404932,110.85286437967355,33.80650655465613,15.824026375873268,0.09475319234983524,3.289011584427261,155.80823669433593,154.10587615966796,152.72999572753906,151.35411529541017,149.6517547607422,0.02,0.0,141.71171546424503,0.00787500648345496,0.010222550098679216,154.12311444963728,152.43219757080078,4.804077600127656
2024-04-11,0,158.1150016784668,139.71749877929688,156.61000061035156,148.46000003814697,153.28125190734863,-0.8215300482850939,4.433932297912998,0.06501525223555182,2.995291532853556,150.71499633789062,3.36719970703125,0.029563564419875146,142.04875221252442,154.2652503967285,0.7096296690617062,0.115894581635,1.0542432143292373,1.0317236466182305,1.026590794844609,0.03809603071623657,75.51656167831774,158.847489344056,149.97962474822998,141.11176015240397,154.61357225690568,2.3962736873059245,152.93535723005022,2.6089327697110978,154.03116814280537,151.75646022129104,1.8137862793563782,5.28412519502071,27166400,1.9743615189801078,0.9200221417072652,463649100.0,-2.2764700433319267,45.37968769486497,52.4753318404932,155.86767915482685,37.858145486545375,14.612435982628467,0.14184052195499974,3.3069633773358786,156.8810361328125,155.14947827148438,153.75,152.35052172851562,150.6189638671875,0.04,0.0,141.87700099384332,0.05899160985708596,0.028982769096905513,154.81517900739397,153.2748020717076,4.564000201741714
2024-04-12,0,158.26250076293945,141.72249603271484,158.1150016784668,148.82312202453613,153.76499843597412,-0.5483643219860765,4.105757148188691,0.1759217457550739,2.995360131849827,150.81374740600586,3.1059507369995116,0.027208553713530384,146.97199974060058,155.97999992370606,0.6783584240699165,0.11281978007680728,1.0487940707223202,1.0276785738370855,1.0198640267663819,0.04541326044324956,78.10063129427512,159.11101418956585,150.89949989318848,142.6879855968111,155.2107151576451,2.7382886987382484,153.51750019618444,2.8304709783204216,155.0584094767807,152.70917481780143,2.854079237860061,6.413838982881576,25329200,1.9681211065873923,0.8838817347730161,488978300.0,-20.080699345102296,45.37968769486497,52.4753318404932,138.80525933127637,36.497574443968304,13.634288120647332,0.0676497973032551,3.2907312436804492,157.2936026611328,155.4832035522461,154.02000427246094,152.55680499267578,150.74640588378907,0.06,0.0,142.0268129450718,0.034295045780319944,0.04783096919216649,155.21614728655135,153.77137429373605,4.369171944763187
2024-04-15,1,156.88750076293945,141.72249603271484,158.26250076293945,149.3900032043457,153.9287519454956,-0.35616068834750764,3.8767105120954595,0.3441396610641254,2.9954046659087505,151.11624908447266,3.065463333129884,0.02555370141928103,148.02800254821778,156.7605007171631,0.6179266380169485,0.11670698155363111,1.034138695268836,1.0138666522501634,1.00212385227272,0.019561003225142315,78.80770450222988,159.46179581056785,151.70837478637696,143.95495376218608,155.86428669520788,2.4634399583021676,154.04142842973982,2.7166589658651525,155.86792549288936,153.58727223166284,2.7128326012087154,5.429262431377062,27136500,1.9549209191385666,0.9853281903751447,461841800.0,-47.34979807728599,45.37968769486497,52.4753318404932,84.55369138846729,32.91523775051501,17.67861056791106,0.051077396647780736,3.3879370443075727,157.5484794921875,155.89575842285157,154.55999755859375,153.22423669433593,151.571515625,0.06,0.0,142.163753802083,6.461722531470038e-05,0.015475444072058864,155.8340105329241,154.11312539236886,3.6061763203956767
2024-04-16,1,154.41749572753906,147.51499938964844,158.26250076293945,149.97250080108643,154.53937530517578,0.3083882385939257,3.287737754647611,-1.0891167541951257,2.9955002591392965,151.85000038146973,2.8405381965637218,0.02156365535181262,148.53499946594238,157.0102508544922,0.8390344241986963,0.05362572570260473,1.0127953950863542,0.9954888659193635,0.982568355261837,-0.013999775712072782,67.57092596370774,159.0421005321834,152.4666250228882,145.89114951359298,156.2971431187221,1.6907226071558572,154.3010711669922,2.5498123831358623,156.13574794740583,154.24146943314585,3.003693566148184,4.904628809519121,20779500,1.3375848085826432,0.8273457488614764,441062300.0,-51.413458998096694,45.37968769486497,52.4753318404932,39.68230354633641,31.33398214279308,19.339542827264253,0.16045327311091773,3.3044216928361765,157.5484794921875,155.89575842285157,154.55999755859375,153.22423669433593,151.571515625,0.06,0.0,142.25411498799681,-0.014048636190219455,-0.002906098050868258,156.1051265171596,154.3792484828404,3.43318148891028
2024-04-17,1,155.6875,147.51499938964844,158.26250076293945,150.51374626159668,154.79062175750732,0.15340736425845508,3.2075419964230996,-1.0572583306454757,2.9955119855381316,152.72250175476074,2.7598752975463867,0.02099968654136296,148.53499946594238,157.0102508544922,0.8258788675700023,0.046791827044368975,1.01928164995324,1.0032299877974917,0.9934213270452085,-0.0014271044040142788,57.40455085139445,159.15745898521678,152.7423749923706,146.32729099952442,156.5557141985212,1.3662752472697253,154.66107150486536,2.3415843769356166,155.70277617362916,154.23546863289334,2.001482915914132,2.410756144823223,21763100,1.4330223577838306,0.8705067639660735,462825400.0,-44.72695088449293,45.37968769486497,52.4753318404932,62.11970685870009,32.62867026252288,18.20268024574279,0.1630470321774774,3.25977535665891,157.71368237304688,156.1631630859375,154.91000366210938,153.65684423828125,152.10632495117187,0.06,0.0,142.35661196848687,-0.004290944383459228,-0.007215857151176748,156.19359697614397,154.70744432721818,3.1792263888473036
2024-04-18,1,155.72749710083008,148.08500289916992,158.26250076293945,150.74874687194824,155.74312496185303,0.07716179435935475,3.0312978283540284,-1.1130741401427404,2.9955364703268006,153.43000030517578,2.60674991607666,0.01979286996429018,149.45575485229492,157.0102508544922,0.7961878858903249,0.05133873756282104,1.0168232468449885,1.0024509482225723,0.9939587762689571,-0.015099797946382165,60.776876709591036,159.21359567959624,153.15100002288818,147.08840436618013,156.42964226858956,1.4007132667319546,155.0098214830671,2.0782999059441645,155.70123528978502,154.38999675963618,1.1762587317031377,3.3455615848103597,19883000,1.446795374428856,0.7975829022101506,482708400.0,-39.64226600305751,45.37968769486497,52.4753318404932,60.68744020914382,30.93344277204243,17.25695724493599,0.13351559759410236,3.1925856900847647,157.71368237304688,156.1631630859375,154.91000366210938,153.65684423828125,152.10632495117187,0.06,0.0,142.44991236114305,-0.02132874779183136,-0.0008325946623931373,156.10940551757812,155.06988525390625,3.0364600180341683
2024-04-19,1,154.73749923706055,148.58499908447266,158.26250076293945,150.82937240600586,155.7731227874756,0.00754176869524284,2.844547019629645,-1.1485932848378169,2.9955606338228256,153.80249977111816,2.44406244277954,0.018527252829491712,150.0564998626709,157.0102508544922,0.7779632841497994,0.048070115155412235,1.00784439518302,0.9938932402887936,0.9906592039876936,-0.022273131720311867,60.53187932307044,159.22221877223046,153.5331247329712,147.84403069371194,156.26214218139648,1.5367124960116805,155.12446403503418,2.009920249343792,155.70514711951134,154.5670688925008,-0.5635039308359168,3.2367660703276484,32239100,1.4487691185510612,1.274109308904846,450469300.0,-57.72135311900137,45.37968769486497,52.4753318404932,10.583905512234592,28.174712709142344,20.814077853641617,0.15319055722492383,3.254597997341685,157.71368237304688,156.1631630859375,154.91000366210938,153.65684423828125,152.10632495117187,0.02,1.0,142.58067830050123,-0.02307745277716733,-0.03337317316392589,155.81688363211495,154.9699990408761,2.6740621848429353
2024-04-22,1,155.5724983215332,149.55250549316406,158.26250076293945,151.25187492370605,155.7731227874756,-0.0015582714080681734,2.6163224432786345,-1.1328924994838088,2.9955876454644934,153.98000144958496,2.206675148010254,0.017006693270087157,150.5939956665039,157.0102508544922,0.795783772022397,0.03081022582067674,1.0112567611887788,0.9971109979064638,1.0005209272314342,-0.008381817767581401,54.72196738526382,159.07339462715782,153.8407497406006,148.60810485404335,155.89892741612024,1.3094500976842451,155.25624983651298,1.9713955512901884,155.46165275370618,154.5471351368133,-0.7520368234873194,1.0481091151489383,26446200,1.452506699526239,1.0508380694066024,476915500.0,-37.09985172243359,45.37968769486497,52.4753318404932,59.465830648591435,28.76648473145067,19.188995583203617,0.14479464580853332,3.277860048202045,157.71368237304688,156.1631630859375,154.91000366210938,153.65684423828125,152.10632495117187,0.02,0.0,142.70150818125484,0.009169528959026563,-0.009192899313840012,155.37025233677454,155.09271567208427,2.6020874334457553
2024-04-23,1,157.61750030517578,149.55250549316406,158.26250076293945,152.08125019073486,155.7731227874756,-0.14782371540529862,2.495109059483805,-0.9876894505137264,2.9956010986186357,154.24999809265137,2.078999710083008,0.016190048353405297,150.7689971923828,157.0102508544922,0.7408747484222752,0.040253373278619595,1.0227348346094343,1.0091217480049288,1.0153902296122979,0.020723070028819457,58.30812446693351,159.10396781379183,154.1137496948242,149.1235315758566,155.8067844935826,1.1251325056734294,155.50874982561385,2.0348584188909835,155.4860572168991,154.62954934427233,-1.6080089364979273,1.2001764521626122,21151600,1.4452791835262886,0.8372598774843015,498067100.0,-18.455815584087173,45.37968769486497,52.4753318404932,109.62927216201318,29.995141896341856,18.048698097328884,0.13516668969180215,3.2358384827247897,157.71368237304688,156.1631630859375,154.91000366210938,153.65684423828125,152.10632495117187,0.02,0.0,142.8097782948302,0.025000004946988952,0.021955218519856084,155.44587925502233,155.33101327078683,2.5421027268917906
2024-04-24,1,158.34000396728516,150.6474952697754,158.26250076293945,152.9275026321411,156.08500003814697,-0.17076062902883266,2.374136653405137,-1.0470611706435256,2.9956141213048317,154.5774974822998,1.9957504272460938,0.01536488970197307,150.83874740600587,157.6672504425049,0.6991765438258963,0.045330214161167455,1.0247416436109222,1.0130939840817899,1.0158563467944701,0.017037359886215464,63.704633684803476,159.26527274223506,154.5169994354248,149.76872612861453,156.01428495134627,1.4458790347758494,155.93928582327706,1.9421115359939198,156.02538545836885,155.05955256998374,-0.4075510336651476,2.2942253902357366,22779100,1.4833380028498147,0.9005595510624196,520846200.0,-10.263623719812871,45.37968769486497,52.4753318404932,122.15324159857757,29.725349233739497,17.073838650614128,0.18079856612220205,3.176094489715564,157.71368237304688,156.1631630859375,154.91000366210938,153.65684423828125,152.10632495117187,0.02,0.0,142.9306742149223,0.023541539216771046,0.03063482335984062,156.055180140904,155.94459533691406,2.535103273823173
2024-04-25,1,153.67250061035156,150.6474952697754,158.34000396728516,153.57874870300293,156.67937564849854,-0.24679267171129318,2.350995107954677,-0.9347623202939124,2.9956169346388166,155.15499877929688,1.9781255722045898,0.015178004511411018,151.3332504272461,158.12975158691407,0.6622269168079825,0.05106297110173808,0.992108362817016,0.9817039528804218,0.9825670293304339,-0.013196105560907778,65.8503842421183,159.5968649793981,154.89487476348876,150.1928845475794,155.90785707746232,1.6019949504347777,156.1025000980922,1.5951847544335775,156.61102938717733,155.58572247944198,0.9258246815598574,3.957327184101867,57109700,1.4806412724909122,2.114711187291967,463736500.0,-45.13367343275203,45.37968769486497,52.4753318404932,-27.439962798604327,24.767144955983877,26.94797929816293,0.23808622731497425,3.5394679249835588,158.01339978027343,156.64829888916015,155.5449981689453,154.44169744873048,153.0765965576172,0.04,0.0,143.1473761048785,-6.403885415495747e-05,0.0034089919803105017,156.28349086216517,156.1943086896624,2.3308500974881206
2024-04-26,0,172.6699981689453,150.84499740600586,158.34000396728516,153.71374797821045,156.67937564849854,-0.1574651217397181,2.1626371990425453,-0.8398137786618198,2.9956349172944097,155.15499877929688,1.8268753051757813,0.01394834729740505,152.22000007629396,158.12975158691407,0.5400308180371529,0.018744428074968608,1.1136685817524228,1.1062048149309884,1.1069441087035237,0.11588980706229379,47.541924741230126,159.37139942860267,155.04612503051757,150.72085063243247,158.3339282444545,6.520715636918594,157.44482122148787,4.619239039805029,155.87801990412936,155.40484363108777,-0.48245512186132183,1.509371537211803,64665300,1.8651080573272143,2.2286924599615268,528401800.0,-11.57721653964883,45.37968769486497,52.4753318404932,427.49266934270014,45.76793375839072,19.15430931077219,0.2027639102378959,4.623733481318078,169.08376397705078,165.60312228393553,162.79000091552734,159.97687954711915,156.4962378540039,0.02,1.0,143.75112762053726,0.11590637923675984,0.10217301261682929,158.63507734026228,157.41433715820312,4.193900631118925
2024-04-29,0,167.49250030517578,151.38750076293945,172.6699981689453,153.8400011062622,157.07000064849854,2.7861781027410824,4.2583734644843885,8.511061850717862,2.9953692791331044,155.6299991607666,2.5540880775451624,0.02727324871839099,153.05050315856934,158.27025108337403,0.028684040722473807,0.1275855498451315,1.0727252218216017,1.0632216800395335,1.0496194568486144,0.07662023887413971,75.897628437917,164.6541219976333,156.13737506866454,147.62062813969578,160.0146429879325,7.216078563962636,158.22214262826103,5.329060608033129,160.07275209757373,157.79439456728727,10.908067872465876,12.212633704979,45610000,4.600324619835608,1.5352319922016542,482791800.0,-35.90607656656932,45.37968769486497,52.4753318404932,216.50682352637799,41.15087990310553,23.867504829459616,0.10631919788926596,4.774979602117996,169.08376397705078,165.60312228393553,162.79000091552734,159.97687954711915,156.4962378540039,0.02,0.0,144.08764678626443,0.06315579569364305,0.07826594288711111,160.08198765345983,158.09569658551897,4.708792187040443
2024-04-30,0,164.77250289916992,151.38750076293945,172.6699981689453,154.03125095367432,157.74187564849854,2.078269242389736,4.859393130380803,3.9120097416463446,2.995262186790975,155.70749855041504,3.139738159179686,0.03098008680427505,153.5365005493164,159.25525360107423,0.3948730773051688,0.08954158146032404,1.0504740624625946,1.0389612660616914,1.0173748350109315,0.04539472190677296,65.09636563439858,166.57416116920888,156.85537490844726,147.13658864768564,161.4482149396624,6.98610315829185,158.85517856052942,5.554876326887811,161.92333647193703,159.1514417401532,7.554865661732254,6.948789765923103,33562900,4.804970135225609,1.1129127510013195,449228900.0,-50.04195524901448,45.37968769486497,52.4753318404932,134.9899506022017,37.7998251014816,25.78827792390059,0.01644676125805008,4.826793788769101,169.08376397705078,165.60312228393553,162.79000091552734,159.97687954711915,156.4962378540039,0.02,0.0,144.3029805096765,0.02856068102229803,0.04159204709573836,161.3219953264509,158.56943947928292,4.8418908566694405
2024-05-01,0,164.59249877929688,151.38750076293945,172.6699981689453,154.33374691009521,158.15187644958496,1.6764031478698997,5.094466214922201,2.2088549586482653,2.9952175521632367,155.8187484741211,3.54166316986084,0.03236479940855585,153.5365005493164,165.0445026397705,0.4979406283137608,0.06937843304494232,1.0456450160649986,1.031093965914072,1.0073627594205765,0.03948777728528774,60.19147330833152,167.59655762820864,157.40762519836426,147.21869276851987,162.73678643362862,6.5392836464447885,159.31785692487443,5.754653279694726,162.6260000298679,159.93144705777672,6.485178907237977,5.684371150299195,33493200,4.866086891586607,1.094652045682731,415735700.0,-45.5117484297984,45.37968769486497,52.4753318404932,117.94108676504702,35.353331381572374,24.1191998311127,-0.05248067185430659,4.792005699714572,169.08376397705078,165.60312228393553,162.79000091552734,159.97687954711915,156.4962378540039,0.02,0.0,144.5154331278121,0.029724034920933784,0.03538482313959187,162.4036102294922,158.88693128313338,5.009954747750486
2024-05-02,0,165.50749588012695,151.38750076293945,172.6699981689453,154.65749835968018,158.28187656402588,1.3591855263583257,5.263623613525063,1.1337917201497998,2.995184869630162,156.26000022888184,3.8713130760192853,0.03332817994775292,153.5365005493164,165.0445026397705,0.5228876103289544,0.08062370967121461,1.0479593546964738,1.0310740807913858,1.0052690459592752,0.07701439895081763,60.64141879614071,168.46037234149108,157.9331251144409,147.40587788739074,163.86392865862166,6.179940356459361,159.83535657610213,5.974027234139133,163.11013905929929,160.52650666631428,5.797940224062848,4.096699890629182,24294500,4.838847780232678,0.8077807898160669,440030200.0,-33.93459589510612,45.37968769486497,52.4753318404932,116.09063712169984,33.79560553696739,23.056468273438334,0.039460451969030405,4.654657482520724,169.08376397705078,165.60312228393553,162.79000091552734,159.97687954711915,156.4962378540039,0.02,0.0,144.67471429779388,0.06807687818207309,0.04706834322937711,163.59652709960938,159.52120317731584,5.064091944957384
2024-05-03,0,166.4525032043457,151.38750076293945,172.6699981689453,155.36374855041504,159.9031276702881,1.126985247648615,5.344103951563533,0.38273721634266833,2.9951713675439917,156.7487506866455,4.207062149047855,0.033696999027532516,153.85700225830078,165.70599632263185,0.5163401971038968,0.09327054774025412,1.0495585208379359,1.0306816103135668,0.9966798038116266,-0.03600796334355805,62.19015852196068,169.28108281157435,158.59287490844727,147.9046670053202,165.02285712105888,5.71453037983369,160.51857103620256,6.15516572138757,163.71504637649713,161.2131124788881,5.005786514615905,4.57783434626737,34662400,4.824823308308212,1.131417292545289,474692600.0,-31.333882495860475,45.37968769486497,52.4753318404932,102.03572203856268,33.1390334242179,21.32529303903508,0.05888157483256466,4.672904112470466,169.08376397705078,165.60312228393553,162.79000091552734,159.97687954711915,156.4962378540039,0.02,0.0,144.90144210011326,-0.02739170950383163,0.0720512625667163,164.75376892089844,160.40447453090124,5.191936486432555
2024-05-06,0,167.43250274658203,153.67250061035156,172.6699981689453,155.6587495803833,164.63749980926514,0.987913387245903,5.337122662761723,-0.20809847553474192,2.9951772578759748,157.25250053405762,4.54107490539551,0.033493896771820277,154.36349639892578,166.5565029144287,0.5366908103293331,0.08172085303846015,1.0507472504556716,1.029283406766453,1.0100685768025417,-0.0003582104182839885,62.61133214707311,170.020370356041,159.34612503051758,148.67187970499415,166.98857171194894,2.764739497156765,161.44821439470564,6.145660524607577,164.41828701654407,162.10893461599386,5.123467875330281,6.096726887031736,21871300,4.807686424599337,0.7125425113692155,496563900.0,-27.72649914009341,45.37968769486497,52.4753318404932,104.19358334478028,32.31264262024366,20.609159561365196,0.06997269989060154,4.489768586770593,169.08376397705078,165.60312228393553,162.79000091552734,159.97687954711915,156.4962378540039,0.02,0.0,145.0509432044828,0.011736503228159112,-0.02239019786519133,166.48035975864954,161.38192531040735,5.421673267474558
2024-05-07,0,169.9749984741211,153.67250061035156,172.6699981689453,155.71749782562256,164.95625114440918,0.761667987561034,5.458911687453622,-0.7296268399157242,2.9951552128688217,157.8662509918213,4.875287666320804,0.03411310772153247,154.7054988861084,167.4385025024414,0.574222507706128,0.06910479595206084,1.062185242205253,1.0373500824621118,1.025480902159749,0.03157380924252129,63.02278984735085,170.94169842068362,160.02387504577638,149.10605167086914,166.6035717555455,1.8914399443006877,162.46875,6.2998057246268075,165.18160475359585,162.45148622647852,8.95410830277306,8.428453626787999,28039700,4.783827411389032,0.9180983046923871,524603600.0,-14.513443921097249,45.37968769486497,52.4753318404932,124.34866704407523,36.24358609659442,19.39264363916253,0.1106486172429941,4.430477231905917,169.08376397705078,165.60312228393553,162.79000091552734,159.97687954711915,156.4962378540039,0.02,0.0,145.26541018673734,0.05203336311076456,0.030695208297877877,166.38047354561942,162.50777544294084,5.898037911813953
2024-05-08,0,169.31750106811523,153.67250061035156,172.6699981689453,155.71749782562256,165.74374771118164,0.5477469475790928,5.80703666536871,-1.133592993308612,2.9950833583322867,158.18875122070312,5.335800094604491,0.03613765557941547,154.7054988861084,167.74075012207032,0.5878063645984163,0.09021229324914558,1.053676408426527,1.025602588586479,1.0151416210249486,0.028707275992900128,66.67946245222332,172.30619826970224,160.69212493896484,149.07805160822744,166.8642861502511,2.1433884682672977,163.4394645690918,6.227773178283458,166.38187710266604,163.21631570781472,-1.5607805197214129,9.177036354313026,19569100,4.793318424778885,0.6441952768471758,505034500.0,-22.357379355457287,45.37968769486497,52.4753318404932,97.55476806962005,34.729556054631544,18.58254043953651,0.08899202422804077,4.293254029364083,169.08376397705078,165.60312228393553,162.79000091552734,159.97687954711915,156.4962378540039,0.02,0.0,145.40684781639467,0.03368738753235245,0.040545543562936756,166.84137616838728,163.46168191092355,6.088574382263176
2024-05-09,0,169.55500030517578,153.67250061035156,172.6699981689453,155.71749782562256,166.69750308990479,0.33738958440211136,5.987377703083514,-1.3799807770927346,2.9950464991647303,158.3012523651123,5.595000152587891,0.03710513721021621,154.7054988861084,169.38325080871581,0.6399084178862248,0.07085032584339575,1.0507707819671595,1.0202571181954547,1.0108383959862208,0.024455112461977846,64.36713262796168,173.33725540616703,161.3625,149.387744593833,167.54750006539481,2.127659178239996,164.4978575025286,5.884790710347283,167.12185392242293,163.9279600422246,1.0896014804330065,8.72678507026022,15346700,4.7898969646698895,0.5152215232316674,520381200.0,-19.924486952269586,45.37968769486497,52.4753318404932,88.76157338113941,33.234426445205116,18.743060793596005,0.06357988117211721,4.165839894502897,169.08376397705078,165.60312228393553,162.79000091552734,159.97687954711915,156.4962378540039,0.02,0.0,145.51746738642254,0.020045676711203386,0.03722696616894848,167.86591448102678,164.59395490373885,6.3533059884777785
2024-05-10,1,168.18000030517578,153.67250061035156,172.6699981689453,155.71749782562256,167.44750213623047,0.15001196606025866,6.192741608773216,-1.5417400639172236,2.995002179061902,161.46625137329102,5.84225025177002,0.0382422622195956,154.7054988861084,169.5970001220703,0.6648541070838482,0.0713529704623542,1.0385680653380756,1.0024034922695202,0.997825520838638,0.01037831854477611,64.653936895488,174.31998314888185,161.93449993133544,149.54901671378903,168.06000028337752,1.6828066887865967,165.39839335850306,5.354671100137569,167.7256075418515,164.5501326016852,2.9024851366932487,9.575895397801773,29799900,4.789501897955417,0.9929943679036486,490581300.0,-25.41950448642743,45.37968769486497,52.4753318404932,66.09004010812359,31.070795903533316,20.95925084130445,0.10623176152011918,4.1375577707635145,169.08376397705078,165.60312228393553,162.79000091552734,159.97687954711915,156.4962378540039,0.02,0.0,145.71726399910003,0.008431013120958175,0.012183451314695304,168.5494166782924,165.4765134538923,6.437676028752778
2024-05-13,1,166.6699981689453,153.67250061035156,172.6699981689453,155.71749782562256,167.66437530517578,-0.034080320927227,6.275371820972234,-1.600580334082469,2.994985384712954,164.6825008392334,5.9213378143310536,0.03863422604614009,154.7054988861084,169.5970001220703,0.6785571699202966,0.07197832515223472,1.0261011726586708,0.9960690786422235,0.9868436491766326,-0.00455410129531908,61.887672512391234,174.98111855039178,162.43037490844728,149.87963126650277,168.22607203892298,1.4268145443920515,166.04500034877233,4.867188474223156,167.82680952147956,164.90368998300448,2.1796263818130677,8.10394004060134,31327600,4.789501897955417,1.036661687022321,459253700.0,-23.364113316935263,45.37968769486497,52.4753318404932,52.58633366389624,28.29270734675425,22.79380432623623,0.19426406571120575,4.219182543439621,169.08376397705078,165.60312228393553,162.79000091552734,159.97687954711915,156.4962378540039,0.02,0.0,145.916614578875,0.006186765452805165,0.011360950031769299,168.90900530133928,166.25276620047433,6.334463950674173
2024-05-14,0,170.04000091552734,153.67250061035156,172.6699981689453,155.71749782562256,167.66437530517578,-0.22063189838337532,6.205126584736766,-1.5248202006788474,2.995004668779694,165.13999938964844,5.758350296020507,0.03808707118032908,154.7054988861084,169.5970001220703,0.6590653887128985,0.07934659465676802,1.0437056408008234,1.0167089741090933,1.007707153652867,0.0003824235445788471,59.49690578883746,175.3297529482211,162.91949977874756,150.50924660927402,168.73857171194894,1.324197783500467,166.8807144165039,4.4270064170386325,167.52749073554185,165.0548405308516,0.7023864886822597,5.743332971429106,25127100,4.7618924586002125,0.8255425332427639,484380800.0,-18.330571519458466,45.37968769486497,52.4753318404932,78.81701280267009,30.52162874439019,21.818940898709723,0.20779591533364816,4.092780733723511,169.08376397705078,165.60312228393553,162.79000091552734,159.97687954711915,156.4962378540039,0.02,0.0,146.0932702973169,-0.005313833665739676,0.013325368937201137,169.35135541643416,167.0525621686663,6.1651108677317925
2024-05-15,0,171.5749969482422,153.67250061035156,172.6699981689453,157.14499950408936,168.46437549591064,-0.4059661030774524,6.0674799084414754,-1.3749194334584867,2.99504168056495,165.97999954223633,5.45493757247925,0.037064488342836675,155.48899841308594,169.98149871826172,0.6245482667926436,0.09218788223542253,1.0481022714987207,1.022666126036021,1.0167256591345442,0.013332915179387061,64.48695435428756,175.8355848550299,163.70062503814697,151.56566522126403,169.3303565979004,1.5496787376242287,168.15946415492468,2.4723949716217026,168.16699844265509,165.72282783530883,2.1552681047862903,7.389160449092536,26948400,4.79934333639906,0.8779027076192145,511329200.0,-18.166904179597577,45.37968769486497,52.4753318404932,96.20537635188876,31.77371592513093,20.91085002656208,0.25440204941111805,3.9654096882280743,171.8520465698242,170.0839864807129,168.6550064086914,167.22602633666992,165.4579662475586,0.02,0.0,146.2935525203131,0.018479110709707536,0.0073576913257546225,169.98063223702567,168.2304959978376,6.096662042105095
2024-05-16,0,173.81999588012695,153.67250061035156,172.6699981689453,158.1593780517578,169.37687587738037,-0.5862216911777549,6.006085168078779,-1.113263978055159,2.9950606589596327,166.5612506866455,5.130249977111816,0.036512265857669084,155.48899841308594,170.19350051879883,0.5995403987670394,0.10176430073329444,1.056688628840119,1.031753310429956,1.0272806586713643,0.025154053653827724,66.69026437820692,176.50717022171665,164.49499988555908,152.48282954940152,169.87964194161552,2.3107834945915524,168.2416068485805,2.6467370049639656,168.97707922943812,166.45380538921643,2.4741278626946412,11.649772253842462,27867900,4.799224631916646,0.8962011809715109,539197100.0,-7.50801330879575,45.37968769486497,52.4753318404932,117.79262767763854,34.803733585975706,19.902929211489802,0.25493881401644053,3.868574005842093,172.16527770996095,170.33735931396484,168.86000061035156,167.3826419067383,165.55472351074218,0.04,0.0,146.51420291905256,0.024829292100383427,0.028338538621361226,170.39872305733817,168.3895983014788,6.058315174782987
2024-05-17,0,175.04999923706055,153.67250061035156,173.81999588012695,163.02937507629395,169.6599998474121,-0.7040704510539478,5.979885870728851,-0.727161186223249,2.995072833546425,167.05125045776367,4.849236965179443,0.036154168288308045,155.48899841308594,171.6844970703125,0.5529240757915072,0.12332173349804296,1.0583458059398558,1.033952687684326,1.0293607486851704,0.04084908383528729,70.35235828366918,177.35939656598163,165.39962482452393,153.43985308306623,170.69857025146484,2.9933373046777714,168.781428200858,3.1959248699132004,170.17334192239144,167.4603501445758,2.26209586146357,0.6660089901990094,24479300,4.788864402809503,0.7971741193017559,563676400.0,-1.5362599999776756,45.37968769486497,52.4753318404932,131.78977977163785,35.28059493497147,18.931515568819226,0.29773613508738433,3.7765148203027445,173.04388470458986,171.04806497192382,169.43500518798828,167.82194540405274,165.8261256713867,0.06,0.0,146.71447683136967,0.04393714261697679,0.03589076851586368,171.35191345214844,169.09664481026786,5.81188860850772
2024-05-20,0,176.9900016784668,153.67250061035156,175.04999923706055,164.72750186920166,169.99124908447266,-0.7603034651429179,5.8051684815587015,-0.2805773985200899,2.995118114918981,167.4625015258789,4.483174800872803,0.03488363288628863,157.41300010681152,172.78499794006348,0.5194089167042675,0.12519886950244735,1.0635443678694914,1.0401295375125417,1.0324270610676183,0.06191878336172185,71.61514328596942,178.02558678764134,166.41524982452393,154.8049128614065,171.76071330479212,3.7447236532652473,169.65410668509347,3.652485067737645,171.39830556488678,168.57527026866268,3.3856501145969364,4.512141688800873,22554400,4.788941522227994,0.739173345922501,586230800.0,-11.7684857497287,45.37968769486497,52.4753318404932,151.90848250049666,38.26137599018735,17.94098362458301,0.2753477724895499,3.7003215933945555,175.060083984375,172.76496380615234,170.91000366210938,169.0550435180664,166.75992333984374,0.08,0.0,146.90874617674882,0.045997345388190114,0.04903642906470086,172.34505789620536,170.10548618861608,5.659203164744723
2024-05-21,0,177.17749786376953,153.67250061035156,176.9900016784668,165.3237476348877,170.42374992370605,-0.7134638831162814,5.680335668339938,0.22674491771729066,2.995152145456218,167.83625030517578,4.231761837005616,0.03391526115132636,158.26775360107422,173.9429962158203,0.5017952254487648,0.12290831497633432,1.0578637357084977,1.035415766619276,1.0212253895187522,0.04197539937551498,73.33210774776694,178.8467963290505,167.4861249923706,156.1254536556907,173.04607009887695,3.853413772055436,170.55303519112724,3.854038232021816,172.80816763113862,169.87079659554993,4.385008616619404,7.41476797665275,16989400,4.787821886761472,0.5606157025127458,603220200.0,-5.852405200412337,45.37968769486497,52.4753318404932,139.03696281118673,36.4862007157687,17.643941439543454,0.2816064818520648,3.603138831962186,175.060083984375,172.76496380615234,170.91000366210938,169.0550435180664,166.75992333984374,0.08,0.0,147.0535215470372,0.04408828041169066,0.05149578415997324,173.6578369140625,171.10362679617745,5.593611318729046
2024-05-22,0,176.34500122070312,153.67250061035156,177.17749786376953,166.21625137329102,171.84874725341797,-0.7452945407626151,5.579997965015153,0.7682097115955413,2.9951788088771507,168.7487506866455,4.152874183654785,0.03312276705388264,163.9672492980957,175.24399948120117,0.4915692454364084,0.1189686334754445,1.046780739557875,1.026231189371676,1.008132189471449,0.027801278492226134,73.34508158413118,179.62412080033064,168.46412487030028,157.30412894026992,174.42821339198522,2.7673452652948964,171.3271427154541,3.851043296606088,173.91082188576195,171.04717879746934,5.349921240496543,7.646155917073695,17880000,4.7910585650793545,0.5948115664901527,585340200.0,-15.203557277723528,45.37968769486497,52.4753318404932,113.99481353681887,34.53919935993284,17.91518338152472,0.2660368834759298,3.5343321968265715,175.060083984375,172.76496380615234,170.91000366210938,169.0550435180664,166.75992333984374,0.08,0.0,147.19929262685207,0.022433519840993954,0.0354585244477766,174.69093758719308,171.7999714442662,5.331658405303038
2024-05-23,0,175.4550018310547,153.67250061035156,177.17749786376953,166.6156244277954,172.95749759674072,-0.8652529721380129,5.320380331696955,1.557474775378334,2.995234002576463,169.4362506866455,3.955374336242676,0.031413810254283685,164.7545024871826,176.40950126647948,0.3564376827587977,0.14753778665865164,1.0359616779366163,1.0168931747309167,0.997603447038431,0.00940631682016213,74.46668034309519,180.00513539636506,169.36437473297119,158.7236140695773,175.20178495134627,1.9815059072163708,171.9701783316476,3.7239880546328723,174.5315253267291,171.88197226696062,5.804885797113125,6.548045019317743,21024900,4.626352348695701,0.7440941119844845,564315300.0,-35.34190731708829,45.37968769486497,52.4753318404932,84.0769148075717,30.96657200444302,20.47281416206191,0.17080727024691597,3.6604702017597917,175.28428326416017,173.12786264038087,171.38500213623047,169.64214163208007,167.48572100830077,0.08,0.0,147.36108811834802,-0.0036169175618187,0.006028608861246536,175.14898245675224,172.25016893659318,4.291714996836035
2024-05-24,0,174.8474998474121,164.59249877929688,177.17749786376953,167.24187660217285,174.12749671936035,0.27118220598317566,4.082069906765616,-1.240472979560937,2.9954460861229912,169.76499938964844,3.545449447631836,0.023948290364813933,165.43399658203126,176.40950126647948,0.8446743022701229,0.016129053637821012,1.0257782917846563,1.0099188353762991,0.9923043497093952,-0.001156808857646463,62.15604080570767,178.61763960753757,170.45349979400635,162.28935998047513,175.6692853655134,1.2247601273096225,172.4998209817069,3.552315735260602,174.79478280650156,172.6350212618074,3.1845453342577983,5.408448928915807,16572500,1.9627237259390955,0.6410762266614985,547742800.0,-25.59240139384917,45.37968769486497,52.4753318404932,75.86264130767728,29.586108056337785,19.560153184833634,0.20653318383134814,3.557565425981091,175.28428326416017,173.12786264038087,171.38500213623047,169.64214163208007,167.48572100830077,0.08,0.0,147.4867762879565,-0.006077462110546938,0.004650422812751546,175.50286211286272,172.7417471749442,4.392830670141661
2024-05-28,0,175.62249755859375,164.59249877929688,177.17749786376953,167.24187660217285,174.89812469482422,0.22745882055413316,4.167872300225053,-1.3510454272910883,2.9954342174779267,169.76499938964844,3.676099548339846,0.024436059261064874,165.43399658203126,176.40950126647948,0.892133527579371,0.04391241117563666,1.029667285556299,1.0105036232282165,0.9969318022048367,-0.007726448425924959,65.23815333060419,178.89811947837978,170.5623748779297,162.22663027747961,175.92678560529436,0.9236158202403386,172.90321377345495,3.564186518102257,174.7810781888531,172.64500446127568,1.907330880009932,4.428648547440678,20572200,1.5272445635262542,0.8362965091911637,568315000.0,-16.046104877542312,45.37968769486497,52.4753318404932,86.50509904615492,30.892526317118755,18.40585309864355,0.2863180583779179,3.5105911297336228,175.28428326416017,173.12786264038087,171.38500213623047,169.64214163208007,167.48572100830077,0.08,0.0,147.6480466624918,-0.002939211595345159,0.0019310994208176786,175.81964111328125,173.1091820853097,4.420098665373423
2024-05-29,0,175.72249603271484,164.59249877929688,177.17749786376953,167.24187660217285,175.15124988555908,0.0308192439690522,4.2444025439604935,-1.4463983842762533,2.9954241480667063,170.00749969482422,3.8162619400024425,0.024825586238432205,165.43399658203126,176.40950126647948,0.8606467816226999,0.06584833311698446,1.0278040157854849,1.005897495388368,0.9990505196051468,-0.008212114114927949,70.88833154928952,179.45767982852158,170.9688747406006,162.48006965267962,176.02285657610213,0.8491927121595937,173.3607134137835,3.4785636505848694,174.9815080081953,172.88607764636876,1.036993281089405,3.3225469246481536,23388700,1.3410624744314443,0.9708697965916798,591703700.0,-19.43134425037217,45.37968769486497,52.4753318404932,75.00781953407858,29.52101940177845,17.588705464021682,0.3629601771545095,3.4112510780939664,175.28428326416017,173.12786264038087,171.38500213623047,169.64214163208007,167.48572100830077,0.08,0.0,147.8279607250442,-0.01096432156902083,-0.00576531017101048,175.79680960518974,173.57436152866907,4.046436069305548
2024-05-30,0,173.57999801635742,164.59249877929688,177.17749786376953,167.99312591552734,175.49687576293945,-0.11978838837340129,4.114035932110337,-1.4509061259634874,2.9954442847805907,170.80749893188477,3.744124412536621,0.023986257560348893,166.35800247192384,176.40950126647948,0.8434656979869015,0.06762153400649352,1.0120316420302804,0.9904114115566871,0.9885050197478529,-0.01567950996742562,71.40760874636203,179.74444626149855,171.51637439727784,163.28830253305713,175.53571319580078,1.1326809757826923,173.64821325029646,3.301662905185113,175.16700530604416,173.1702792543484,0.3841741208713584,3.7828310270318277,22958700,1.334249289946969,0.9743234678203604,568745000.0,-45.09141324032741,45.37968769486497,52.4753318404932,19.171365521020217,27.016811518118573,22.14405304824165,0.3753586063013068,3.4611672483736156,175.28428326416017,173.12786264038087,171.38500213623047,169.64214163208007,167.48572100830077,0.08,0.0,147.98502713316626,-0.024209099800805323,-0.032274353954607954,175.11045619419642,173.7277570452009,3.5703513875823694
2024-05-31,0,171.7150001525879,165.50749588012695,177.17749786376953,169.03312587738037,175.49687576293945,-0.19835500695460348,3.813040550237061,-1.4300833144541496,2.99548605467967,172.5774974822998,3.495249557495117,0.022173255804991496,166.64824867248535,176.40950126647948,0.847977407909685,0.048774238854276335,0.9985418654151921,0.9786505332400502,0.9809735267105585,-0.02131601629726143,58.863123535182645,179.59183045960498,171.96574935913085,164.33966825865673,174.75535637991769,1.5988272316156338,173.90071323939733,2.969797789777847,174.7786724678134,173.1807574858924,-1.9266645741403186,2.3738596348896794,37638900,1.4630063086242096,1.5533395196351114,531106100.0,-42.4509306618924,45.37968769486497,52.4753318404932,-14.730006266129065,25.004874038052236,25.329344474788176,0.37241257368350905,3.4725132547694106,175.28428326416017,173.12786264038087,171.38500213623047,169.64214163208007,167.48572100830077,0.08,0.0,148.2244489323603,-0.006050137253455601,-0.02199802892588933,174.3470458984375,174.00244140625,3.3041425246577547
2024-06-03,0,172.8499984741211,166.4525032043457,177.17749786376953,169.49562549591064,175.49687576293945,-0.20866970756328837,3.5157698051488517,-1.3703403071342157,2.9955237159187,172.64749908447266,3.18487434387207,0.020407760006605602,167.35625228881835,176.40950126647948,0.8363520496554543,0.031615607136779876,1.0033311284589805,0.9863024591727937,0.9916952345194201,-0.011424248988599839,49.98233945109642,179.30766418305157,172.2761245727539,165.24458496245623,174.2560702732631,1.5650294360699453,174.34214183262415,2.1617090479748424,174.024955461354,172.98610516267624,-3.083065161797078,2.101914520750134,27459100,1.5428053691244348,1.1503222138856737,558565200.0,-56.16855985821725,45.37968769486497,52.4753318404932,6.073296007504899,26.29813997742941,23.56964162424123,0.3378141951874392,3.4651898362264815,176.417083984375,174.96146380615235,173.78500366210938,172.6085435180664,171.15292333984374,0.08,0.0,148.40550553688144,-0.010400612902769613,-0.002189559230944057,173.88899884905135,174.2899682181222,3.047878736838847
2024-06-04,0,173.20249938964844,166.6699981689453,177.17749786376953,169.86999893188477,175.49687576293945,-0.2722586417603988,3.2525460379653173,-1.2400705518756232,2.9955543870217913,173.21499824523926,2.890399494171143,0.018844851853309034,168.1052505493164,176.40950126647948,0.825749271427189,0.03235629664891726,1.0035139867420926,0.9895561065895427,0.996000536722458,-0.013779545346335409,53.33205993596131,179.1010914121733,172.59599933624267,166.09090726031204,173.93428421020508,1.5079596396276658,174.56803458077567,1.814997373619193,173.73261830777918,173.00722016403319,-1.981912003396053,3.7079260653206547,26879600,1.54690550608232,1.114355605368803,585444800.0,-53.37631306515158,45.37968769486497,52.4753318404932,5.073475524576914,25.201522564482616,22.586801033832867,0.3429953078800582,3.357667288685989,176.56812384033202,175.20594357299805,174.1050033569336,173.00406314086914,171.64188287353517,0.08,0.0,148.58178071102094,-0.014795930164435922,-0.006857617958553987,173.9232439313616,174.53611319405692,2.8277670977668703
2024-06-05,0,175.2974967956543,166.6699981689453,177.17749786376953,170.02375030517578,175.49687576293945,-0.37541923161330454,3.0300380921860692,-0.996400439442179,2.9955783339272557,173.39124870300293,2.608299770355225,0.01752637227027912,169.2037509918213,176.40950126647948,0.8659304452745479,0.018988092040011017,1.0139572815311102,1.0036973449193167,1.010861282248286,-0.002418581835881839,52.29660442646961,178.9445753527681,172.884499168396,166.82442298402387,173.9985694885254,1.5620025193376308,174.8339274270194,1.6030945035433481,173.5973013422224,173.09512520719238,-1.2838063423094548,1.8598555969734223,22068500,1.453160545946895,0.9263664886917469,607513300.0,-36.01286121046494,45.37968769486497,52.4753318404932,56.698085152349655,29.672411492128727,21.197765251478533,0.3103425441415003,3.322116762164937,176.56812384033202,175.20594357299805,174.1050033569336,173.00406314086914,171.64188287353517,0.08,0.0,148.73714802999365,-0.002785601924935599,-0.00561213589639203,173.9831760951451,174.7430191040039,2.8257967634239387
2024-06-06,0,176.38249588012695,166.6699981689453,177.17749786376953,171.19124794006348,175.49687576293945,-0.583479693026519,2.9963605477479156,-0.768315654788394,2.9955820222915164,173.6999969482422,2.5302496337890603,0.017304936459750335,169.2037509918213,176.40950126647948,0.8219886519443367,0.03531823757033452,1.018665088923258,1.0109979692628943,1.0176167712253652,0.016145281114160692,60.49836951171439,179.14334517996852,173.15062408447267,167.15790298897682,174.10714067731584,1.712822230758031,175.0169631413051,1.6245670166137214,174.00873433606884,173.38328118520064,0.25736538905897766,2.1696050786088894,23251000,1.4999065616424034,0.9685196740582019,630764300.0,-21.865039062819424,45.37968769486497,52.4753318404932,81.83244721059262,29.636134511949898,20.376735883365278,0.3310906004815131,3.2090991440825625,176.56812384033202,175.20594357299805,174.1050033569336,173.00406314086914,171.64188287353517,0.08,0.0,148.9062798627204,0.026843188075485136,0.00471854477897432,174.03026471819197,174.9249529157366,2.7442760997395226
2024-06-07,0,175.92000198364258,166.6699981689453,177.17749786376953,171.67999935150146,175.64749717712402,-0.8029002958543561,2.9395576733781974,-0.36317296351092665,2.9955880833105533,174.33374786376953,2.4243495941162108,0.016942317243832043,169.4175003051758,176.44324645996093,0.7985543123994542,0.04026714377436593,1.0139254997903118,1.0083253534277392,1.0116769780058736,0.02448826152239514,63.54973378604466,179.38298917182962,173.50387382507324,167.62475847831686,174.13535581316268,1.745187692847483,175.0791061946324,1.642468991140872,174.59092183231843,173.81775272956415,0.43274542390540904,1.474226245964935,19661400,1.509517348588774,0.8117007035821071,611102900.0,-46.195034434484526,45.37968769486497,52.4753318404932,49.23351313567631,27.29980902837029,21.972291322457423,0.2779425072079707,3.2348790273192987,176.56812384033202,175.20594357299805,174.1050033569336,173.00406314086914,171.64188287353517,0.08,0.0,149.0425858552232,0.011362380446333642,0.013654053696139635,173.82478768484933,174.81079864501953,2.5910798052853705
2024-06-10,0,174.9499969482422,166.6699981689453,177.17749786376953,172.5662488937378,175.77187252044678,-1.0648593659589056,2.8375905024022834,0.2776026911643794,2.995598234076787,174.94874954223633,2.276662693023681,0.01632467972769614,169.8540008544922,176.44324645996093,0.7506633724758194,0.046022129054714936,1.006488662167286,1.0024983585220724,1.001256211396877,0.012149253645700853,62.90690820097784,179.49730491380114,173.8221239089966,168.14694290419203,174.33106994628906,1.7493413161697549,174.93339157104492,1.5476544574378752,174.9110586837266,174.20749182353333,0.11239650891993022,0.49700242809132184,23779200,1.467505179573406,0.9940538696667091,587323700.0,-36.776463008251184,45.37968769486497,52.4753318404932,24.918038994245872,24.76716431200476,23.25641940645752,0.2623092454877323,3.3109642954947156,176.17084057617188,174.88458093261718,173.84500122070312,172.80542150878907,171.51916186523437,0.08,0.0,149.20189630132137,0.011785255973984832,0.01571510804109104,174.2672576904297,174.68885694231307,2.266901860130497
2024-06-11,0,175.86249923706055,166.6699981689453,177.17749786376953,173.1143741607666,175.77187252044678,-1.3450714014915681,2.5316525560489302,1.5532658800125958,2.9956259155044123,174.99999809265137,1.98325019836426,0.01453630850456562,171.4214973449707,176.44324645996093,0.6120293021820601,0.04967899964157821,1.0097718729948975,1.007667995297405,1.0040650814294962,0.015357745164104042,59.80487179453628,179.22392885324774,174.1606237411499,169.09731862905204,174.92356981549943,1.378721151693837,174.83946309770857,1.436924020894641,174.91915781534584,174.5227173353235,0.7892608293241615,-1.152610153612312,21540600,1.4349648459840825,0.9192777938288902,608864300.0,-18.50176316135871,45.37968769486497,52.4753318404932,47.63585028821167,23.118162452775582,21.70800319065063,0.24386071746818028,3.2937509470095954,176.17084057617188,174.88458093261718,173.84500122070312,172.80542150878907,171.51916186523437,0.08,0.0,149.3489594730001,0.017450444093075168,0.021093152270154382,174.8840789794922,174.61556243896484,1.963501661661511
2024-06-12,0,178.13999938964844,170.04000091552734,177.17749786376953,173.48562335968018,175.87687492370605,-0.8324993413090338,1.8807857166252675,-0.14675124929153016,2.995674092751976,175.17374801635742,1.555925178527832,0.010770719487623974,171.70099983215331,176.44324645996093,0.6132046831093126,0.03424193301684179,1.0201566005053275,1.020577411310622,1.0139883098562263,0.01621530624198053,60.115665875675965,178.3818202278062,174.62024879455566,170.85867736130513,175.67928423200334,1.4973990353976823,174.96767725263322,1.6464065519280555,175.16823571949004,174.9477772889816,2.4153388351554272,-0.7421927968076832,27864700,1.2653925331145386,1.1822621013985761,636729000.0,-23.883410067739362,45.37968769486497,52.4753318404932,147.60295624948577,28.58534291284031,19.72684694006906,0.21581491737890574,3.3656301545362193,177.8210833740234,176.21946319580076,174.9250030517578,173.63054290771484,172.0289227294922,0.1,0.0,149.55359368036218,0.014731384093278788,0.024190423650835007,175.5724378313337,174.7307183401925,1.794855145952701
2024-06-13,1,175.72250366210938,171.5749969482422,178.13999938964844,173.75999641418457,176.02625179290771,-0.43500806595004354,1.7157589150505197,-0.4606401304402006,2.995684154649015,175.3762493133545,1.366200408935549,0.009802922307583051,172.73649864196778,177.00875129699708,0.5189585947345795,0.03826316513580745,1.003983739197366,1.00533500224685,0.997001463653712,-0.0037418237831611245,66.19118345577758,178.45676654836274,175.0252487182617,171.59373088816068,176.0392848423549,1.0338782096959431,174.98678452628,1.654031796225702,175.9234561597928,175.53351980254914,3.0604576003622914,1.0178900204258114,20913300,1.31328932040238,0.8988312524726315,615815700.0,-47.85778865814461,45.37968769486497,52.4753318404932,20.63477043872042,26.80262218306365,21.132626573976594,0.1368694076193429,3.3330826092566537,177.8210833740234,176.21946319580076,174.9250030517578,173.63054290771484,172.0289227294922,0.1,0.0,149.69193940486937,-0.007746026653011717,-0.000279207684185628,175.79661560058594,174.85992976597376,1.6844752091386987
2024-06-14,1,175.55499649047852,171.7150001525879,178.13999938964844,174.59062385559082,176.02625179290771,-0.4456812843891237,1.526407705605307,-0.11810756348689555,2.995694284480604,175.53874969482422,1.1846004486083985,0.008710750716917404,173.1672492980957,177.00875129699708,0.5914238711659964,0.010945275728199104,1.001839682754646,1.0031470510101292,0.9967975984823881,-0.002074837932289242,52.92610724052581,178.2854394651657,175.23262405395508,172.17980864274446,176.07607051304407,1.0073263553803697,175.03732000078475,1.6602452625569406,175.88642877732784,175.63017559759703,1.454946828909068,0.1524617869328482,18063600,1.3698250636291467,0.7930631777670457,597752100.0,-32.99917933595743,45.37968769486497,52.4753318404932,39.00103585618844,25.115783326407314,21.381450615927555,0.15826384776050645,3.302861213615297,177.8210833740234,176.21946319580076,174.9250030517578,173.63054290771484,172.0289227294922,0.02,1.0,149.81211357475166,0.014518440139597022,0.0014876091493235442,176.0224827357701,175.0028294154576,1.7042372732442161
2024-06-17,0,176.46750259399414,171.7150001525879,178.13999938964844,174.92437267303467,176.02625179290771,-0.608336577264505,1.4925867470446434,0.2332524090644923,2.9956959694702285,175.58874702453613,1.1062503814697267,0.00851352997829825,173.1672492980957,177.00875129699708,0.6130095705210178,0.0028848743537215264,1.0065487828456898,1.0061535124282888,1.0023942801911558,0.008673939252487717,51.06406137264084,178.30454757856194,175.31937408447266,172.33420059038338,176.08821432931083,1.0121370608728313,175.09767750331335,1.6980842915598602,175.80996609436716,175.6102189178324,0.14689296740180394,0.40463640811783547,19618500,1.3444667002480397,0.8706192786354462,617370600.0,-28.89697188877897,45.37968769486497,52.4753318404932,76.83962139208572,25.994326982522477,19.74857900656332,0.13056051296888618,3.3205149998753156,177.8210833740234,176.21946319580076,174.9250030517578,173.63054290771484,172.0289227294922,0.02,0.0,149.9453604774761,0.012742192196577795,0.01710085826086591,176.12428501674108,175.0772748674665,1.7582433928908712
2024-06-18,1,175.93000030517578,171.7150001525879,178.13999938964844,174.92437267303467,176.35437488555908,-0.7041861888487665,1.511646030436326,0.2087074804594935,2.995695055437976,175.6724967956543,1.1289255142211914,0.00861875752432307,173.1672492980957,177.00875129699708,0.6154786402389147,-0.002952138988177801,1.0030774290769149,1.0010241881587292,0.9976212012575649,0.0003838286639168409,52.86164247203313,178.41354131319198,175.39024925231934,172.3669571914467,176.08964266095842,1.0118671341660495,175.11249923706055,1.7048496634575994,175.97784594301982,175.69983467032353,0.04819452941915492,0.48114851294519806,21869900,1.2857996670617313,0.9720070036380428,595500700.0,-48.49595927280807,45.37968769486497,52.4753318404932,12.907254904596366,24.153370259648973,19.878306424994598,0.13022638654024563,3.3183347859733376,177.8210833740234,176.21946319580076,174.9250030517578,173.63054290771484,172.0289227294922,0.04,0.0,150.08536912423176,-0.00866265893780438,0.0004571272131064641,176.24285452706474,175.03382110595703,1.7264807347369522
2024-06-20,1,175.98749923706055,171.7150001525879,178.13999938964844,174.92437267303467,176.03375053405762,-0.715146042592727,1.4727086890353442,0.3823134681565028,2.995696927465175,175.6724967956543,1.091825466156004,0.008399291627375618,173.1672492980957,176.53850212097169,0.5917423339790223,-0.0070409480528556825,1.0037085676684974,0.999799741273857,0.9978708615175458,-0.012083193892235777,50.217246246769676,178.28266656172548,175.3372491836548,172.3918318055841,176.23785727364677,0.8851665108766249,175.2844636099679,1.6591870448120967,175.968820248599,175.6760711651921,0.005683447828822097,0.11808634474569821,20160100,1.2896051941754914,0.8897457749422175,615660800.0,-37.465817256200026,45.37968769486497,52.4753318404932,56.08962849842782,22.93073162307213,18.872070640768875,0.10762699949798481,3.245592880501427,177.8210833740234,176.21946319580076,174.9250030517578,173.63054290771484,172.0289227294922,0.04,0.0,150.2164276997813,-0.0083806192172865,-0.0018117544687812528,176.42714146205358,175.34719957624162,1.6513925273590142
2024-06-21,1,178.52250289916992,171.7150001525879,178.13999938964844,174.92437267303467,175.94437503814697,-0.7755453242726439,1.4202627001001558,0.6310405364354357,2.995699374766362,175.6724967956543,1.052150268554692,0.008102926390591831,173.1672492980957,176.39099655151367,0.5955488282297647,-0.0020272873127554635,1.0185120681928637,1.0138039024106107,1.014721568980531,0.015934209783651676,51.45318736029241,178.11827465251963,175.27774925231932,172.43722385211902,176.61785779680525,1.208927052338287,175.77071380615234,1.5247042831702453,175.97764327493738,175.62529752907662,0.593027897637116,1.3869692638642919,58582700,1.2770027867545628,2.3724026718874938,674243500.0,-12.590308703018746,45.37968769486497,52.4753318404932,197.96949509076717,28.314998658907147,17.034971368594082,0.14164946004504694,3.3387684070320613,178.56316552734373,177.1484251708984,176.0050048828125,174.86158459472657,173.44684423828124,0.02,1.0,150.63069146820663,0.025519531441241305,0.01034935410407715,176.85714285714286,175.8706109183175,1.922679090410766
2024-06-24,1,179.73500061035156,171.7150001525879,178.52250289916992,174.92437267303467,175.94437503814697,-0.35552946595931834,1.5731377328870562,0.37637206867773854,2.99569200262327,175.6724967956543,1.1263880729675293,0.008969542226156958,173.1672492980957,176.63475227355957,0.5306289926702247,0.01748312123394992,1.0247930894990738,1.0194505870078037,1.0183718871882326,0.02381022587471482,62.503067589427175,178.5328998020168,175.38662433624268,172.24034887046855,176.84571511404855,1.6230249176297835,176.26249967302596,1.6177012664157377,176.6133130318434,175.8794411593789,1.5125474013215983,3.9644193812612802,18298000,1.3789702003458775,0.7451217694626311,692541500.0,-18.55553521050347,45.37968769486497,52.4753318404932,194.24620344225673,27.02484344611348,16.206044335809167,0.15675588037844637,3.258853780083429,178.76599938964844,177.45199938964845,176.38999938964844,175.32799938964843,174.01399938964843,0.04,0.0,150.76017253684608,0.013745166733715397,0.02317879352426623,177.0614297049386,176.31693376813615,2.0497070037297447
2024-06-25,0,181.83999633789062,171.7150001525879,179.73500061035156,174.92437267303467,176.08624839782715,0.08888272530669838,1.836886330105346,0.2634423552244822,2.995677575275916,175.7224998474121,1.2807508087158226,0.010460591115134721,173.1672492980957,178.1782497406006,0.5896285663458585,0.027952934798637284,1.0355316052459163,1.0291630901299136,1.0254414557164415,0.030444663549510365,66.93759022536499,179.27439693541817,175.6006242752075,171.92685161499685,177.71964263916016,2.3853809983069434,176.87946374075753,1.9696990808011574,177.39234766042398,176.35896454131293,0.8953638858021739,3.983223718258397,23235600,1.3854261017369491,0.9335234749880625,715777100.0,-2.2549395868348263,45.37968769486497,52.4753318404932,261.010782100333,31.30415932738351,14.473846088183544,0.18755601794190918,3.3882248367468604,181.56891357421875,179.8855337524414,178.52499389648438,177.16445404052735,175.48107421875,0.06,0.0,150.9397937546237,0.03830959758345687,0.0409525751915505,178.32857186453683,177.0625937325614,2.7689775087229207
2024-06-26,0,183.375,171.7150001525879,181.83999633789062,175.21062183380127,176.40374755859375,0.6168728258471041,2.2737726883852996,0.7025232146300087,2.995648987329895,175.79250144958496,1.5423253250122086,0.012922815966554774,173.1672492980957,178.64375267028808,0.6307918036077413,0.0354026327249019,1.0421980130079844,1.0338193524844832,1.027869487202975,0.0423179655653374,71.67045230040759,180.49779447650204,175.95024909973145,171.40270372296087,178.8367859976632,2.9637128737495515,177.45642825535364,2.5640296899172577,178.49769052179386,177.0790791420936,3.481337078798036,4.986935511138711,19839000,1.4422522762051169,0.7982359062918766,735616100.0,-5.361613821475835,45.37968769486497,52.4753318404932,223.81751748621696,30.4024384478134,13.836156651324373,0.18641750405343754,3.291205879074786,181.7369945068359,180.02149450683592,178.63499450683594,177.24849450683593,175.53299450683593,0.08,0.0,151.09656508362465,0.050202802722999706,0.03746332195811478,179.3414306640625,177.6819566999163,3.273430227526012
2024-06-27,0,184.91500091552734,171.7150001525879,183.375,175.21062183380127,176.88562679290771,0.8597566414026007,2.7876090554636455,0.5606629865968578,2.995607869584957,175.89125061035156,2.009737815856937,0.015808339914301833,173.1672492980957,179.94550018310548,0.6982201546916041,0.043548800751501186,1.0486402976761366,1.0381047326051571,1.027922315076521,0.050728044418888896,74.7412774228459,181.91309233272906,176.33787422180177,170.76265611087447,180.04357147216797,3.5080488037912367,178.06589290073939,3.219435479480336,179.70543835357103,177.863306069445,4.454446564239836,4.607882800381179,18848900,1.4657569176178888,0.7653889204604865,754465000.0,-4.815643176489983,45.37968769486497,52.4753318404932,205.41501503768924,32.36059048784111,13.168270722920727,0.196899083527743,3.211117459574537,182.91356103515625,180.97321978759766,179.40499877929688,177.8367777709961,175.8964365234375,0.1,0.0,151.25109679002867,0.051673286742241586,0.05894115906144093,180.5085732596261,178.3164291381836,3.8276505533692315
2024-06-28,0,183.3900032043457,171.7150001525879,184.91500091552734,175.21062183380127,178.2356252670288,0.9212625616114105,3.349467044364281,0.2391780312914369,2.995553822864333,175.92500114440918,2.574250335693364,0.018945217293695433,173.1672492980957,181.99349670410157,0.737207497427739,0.0653013194417813,1.0372884444537818,1.0256424758331393,1.00942606019083,0.027265472005649327,80.33535256319924,183.49643355467094,176.7974994659424,170.09856537721384,181.1092861720494,3.1666317884070203,178.5994644165039,3.447378773545203,180.99773215232108,178.7627862530647,4.786999417659749,4.837501018921543,29156600,1.355721811881865,1.1692357295301739,725308400.0,-29.34542248103826,45.37968769486497,52.4753318404932,128.60635237627199,29.89023118508015,16.721206742894918,0.18044264010366515,3.228180706431443,182.91356103515625,180.97321978759766,179.40499877929688,177.8367777709961,175.8964365234375,0.1,0.0,151.47289839284053,0.014028775511729874,0.033182023502343116,181.51714433942522,178.879999433245,3.803395853542124
2024-07-01,0,182.8000030517578,171.7150001525879,184.91500091552734,175.49062156677246,178.82562732696533,0.7104104824835765,3.554402688912797,-0.39433586534688514,2.995532216951205,175.95874977111816,2.8901505279540998,0.020048749460873556,173.1672492980957,183.37650032043456,0.7846565682639468,0.06799058347484653,1.0310906735647947,1.0179775092000554,1.0008157789333785,0.017052896937146178,74.21457137653766,184.39680510316737,177.2879997253418,170.17919434751622,182.08250100272042,2.2420650344990865,179.1601791381836,3.4465340822853787,181.59561113652848,179.40318106993556,4.240324496236843,4.246248940696182,16006100,1.32500831763542,0.6709797013769125,709302300.0,-24.918549371133814,45.37968769486497,52.4753318404932,104.83222008327488,28.15903066531471,17.234383684368158,0.14454397519468118,3.181881141386953,183.15192333984376,181.35904351806641,179.91000366210938,178.46096380615234,176.668083984375,0.1,0.0,151.5919922936169,0.021035622401421206,0.018705118961298235,182.47285897391183,179.4500002179827,3.7915295116380423
2024-07-02,0,183.6050033569336,172.8499984741211,184.91500091552734,175.68062686920166,180.26124954223633,0.6570570552784869,3.5061058274657526,-0.8275515807649638,2.99553875106906,176.18499755859375,2.9979507446289064,0.01971469563628858,174.7752471923828,183.37650032043456,0.8188101849780292,0.05756438915518083,1.032403736968218,1.0183517539860354,1.0018607181646326,0.009706374035354015,70.39502483065797,184.85446152523178,177.8422498703003,170.8300382153688,182.80857249668665,1.6388665765495996,179.71321514674597,3.4974897522826964,181.90168964866285,179.87919011980105,3.871015750681595,4.48699985164218,17372500,1.345176453086447,0.7439886700450398,726674800.0,-6.77822397865022,45.37968769486497,52.4753318404932,117.22176707592054,29.395043973545434,15.711247072367069,0.16740197651169367,3.2410344600651473,183.22980377197266,181.48510421752928,180.07500457763672,178.66490493774415,176.92020538330078,0.1,0.0,151.72599684198747,0.006575051469289717,0.03359002472635597,183.2742876325335,180.06571524483817,3.926330323793028
2024-07-03,0,185.19000244140625,173.20249938964844,184.91500091552734,175.82750034332275,182.07999801635742,0.5466240499893228,3.5239098222810075,-1.188851797508352,2.995537821761005,176.42499923706055,3.1142509460449217,0.019755072429757926,175.2627468109131,183.4115032196045,0.810310537157739,0.060059779760354134,1.0381769386848096,1.023092654696874,1.0085667466392232,0.009897763824982864,72.0188706823677,185.42781975900292,178.38000011444092,171.33218046987892,183.58785847255163,1.1610813889263356,180.2167867933001,3.7518370780477155,182.32636839099854,180.36037717250287,2.8469802827233965,4.402589610327466,10242100,1.3459403345605814,0.4548281499550483,736916900.0,-2.2517867687485773,45.37968769486497,52.4753318404932,123.64629640830051,29.18165429558771,14.96871959183111,0.13442371592461982,3.158815806941738,183.26035864257815,181.5098200683594,180.09500122070312,178.68018237304688,176.92964379882812,0.12000000000000001,0.0,151.80734300196175,0.010550371926749902,0.009726721495382895,184.21714564732142,180.63928767613,4.054211387880442
2024-07-05,0,188.28000259399414,174.9499969482422,185.19000244140625,175.90562629699707,182.94375228881836,0.4884489976694684,3.610702252877012,-1.4259368215043486,2.995529428457668,177.3037509918213,3.3015007781982435,0.02017384543604543,175.52924652099608,183.73600311279296,0.8267142196559194,0.05643266918570849,1.0519647993691408,1.0348694120268482,1.0233721053341283,0.018197559212645986,74.28539240617216,186.20077977278285,178.97937526702881,171.75797076127478,184.50785936628068,1.8763902780620882,181.11375100272042,4.081335566343402,183.05057283929432,180.95063681836882,3.0350247934628016,3.9575631951907835,20967500,1.3196394894027799,0.9334003752298444,757884400.0,-1.5512803821619474,45.37968769486497,52.4753318404932,165.45088651912758,36.322034275180634,13.326580076715407,0.17229258061073327,3.2946170255471325,186.90464190673828,184.45768270874024,182.4800033569336,180.50232400512695,178.0553648071289,0.14,0.0,151.9913218469922,0.027992030305249882,0.03654557886805464,185.15571812220983,181.74214499337333,4.667464758875645
2024-07-08,0,189.21999740600586,174.9499969482422,188.28000259399414,175.92750072479248,183.37875080108643,0.5149152660631413,4.032750810151487,-1.0963229173218043,2.9954811924149403,178.33125114440918,3.647350749969482,0.022450506448852894,175.70575294494628,184.94250106811523,0.7970955494286557,0.06745287651419203,1.0533962974657207,1.0330561927763264,1.0247328470366517,0.031790141773234915,79.08931999531998,187.6940021772488,179.6285005569458,171.5629989366428,185.3428589957101,2.488819892615073,182.08982249668665,4.278913963855693,184.361680546419,181.80537569939355,3.541578522767265,7.1462098878531455,21035900,1.4356178980942431,0.9410852595266546,778920300.0,-10.918868919129302,45.37968769486497,52.4753318404932,139.2984361085499,34.07821996684543,12.503323019283973,0.1545083074311217,3.2607157479626414,186.90464190673828,184.45768270874024,182.4800033569336,180.50232400512695,178.0553648071289,0.14,0.0,152.17362517486032,0.03777109587345007,0.01952427078198325,185.8914315359933,182.6164311000279,5.004675205611172
2024-07-09,0,189.84249877929688,174.9499969482422,189.21999740600586,175.92750072479248,183.44375324249268,0.46067149802534113,4.463640751157072,-1.0691010144583524,2.9954268307641807,179.12875175476074,4.018162860870362,0.024760811284036784,175.70575294494628,185.49900245666504,0.8164280139792589,0.07560251973848854,1.0530987030588521,1.0304366583835203,1.0216527748559163,0.03852568714424498,81.01336601388314,189.1976571355539,180.27037563323975,171.3430941309256,186.0467872619629,2.993338085491117,183.04517936706543,4.41791784571073,185.5742234263419,182.63084214511917,3.1874559814619547,7.783886069154679,15121400,1.4136311463601465,0.6834280869265351,794041700.0,-13.78914044190403,45.37968769486497,52.4753318404932,131.93848803340086,34.72300531594259,11.770260368960583,0.16910088598883033,3.2163781552325523,187.28664190673828,184.76668270874023,182.7300033569336,180.69332400512695,178.1733648071289,0.16,0.0,152.30601270177766,0.03273397483229612,0.03749658007090635,186.40143040248327,183.4550018310547,5.102635545914977
2024-07-10,0,190.27749633789062,174.9499969482422,189.84249877929688,175.97312450408936,183.93250274658203,0.36460611397964526,4.803591208089654,-1.1434147933372405,2.99538103997662,180.7874984741211,4.2792503356933596,0.02654409073244884,175.70575294494628,188.3740020751953,0.8247989768448621,0.08512433318567325,1.0514514887591375,1.0271625422294872,1.0162903174343996,0.036341564004034765,83.20101533423791,190.57368288920173,180.96650047302245,171.35931805684316,187.03071485246932,3.104406561570145,184.07000051225936,4.303048950879593,186.6422658809184,183.5176845706695,2.6647366840835724,7.579297031292569,15952500,1.3582558399504616,0.7339721801423775,809994200.0,-3.400999469219753,45.37968769486497,52.4753318404932,131.929768018746,33.44036630193477,11.038945305693986,0.19091865036497896,3.184493832357982,187.79464129638671,185.34768209838867,183.37000274658203,181.3923233947754,178.94536419677735,0.18,0.0,152.4482529946313,0.03206643816924504,0.04475647268573425,187.6914302280971,184.60428728376115,5.321717507282816
2024-07-11,0,187.84000396728516,175.55499649047852,190.27749633789062,176.34750175476074,184.98375129699707,0.26946525960368906,5.001197293367057,-1.2305419800632686,2.9953544645208585,182.31999969482422,4.367337455749512,0.02751949685047103,175.84849967956544,189.28224754333496,0.8465197885245145,0.08196743002838162,1.0336049738381672,1.0094067808821128,0.9961710442915158,0.01430963600055768,83.46675482881058,191.735270029239,181.73287544250488,171.73048085577076,187.75071498325892,2.481641453065497,184.91660799298967,3.7165189831239593,187.55520133091872,184.41926523850566,3.755653532472217,8.155229925440265,25625800,1.3600586883010968,1.168061877770072,784368400.0,-40.818975726027126,45.37968769486497,52.4753318404932,73.55565687751186,29.145726352865804,17.937417727484263,0.0985838936104497,3.392746494389531,188.17696014404297,185.96652023315428,184.18000030517578,182.39348037719728,180.1830404663086,0.02,1.0,152.65391680246324,-0.0013453879568726679,0.001781482516026146,188.06000191824776,185.2664304460798,5.206620123561722
2024-07-12,0,185.43750381469727,175.55499649047852,190.27749633789062,177.72187519073486,185.85250282287598,0.08463005594480646,4.979468638269799,-1.310615423734434,2.995359566498921,183.0875015258789,4.30857545852661,0.027309937077475047,175.90925064086915,189.28224754333496,0.904469203006298,0.05445158084018933,1.0170335288512018,0.9941110703368342,0.9806734499305307,-0.015097188974585007,68.60793456570802,192.2906879555557,182.33175067901612,172.37281340247654,188.01250076293945,2.026308806263527,185.41053662981307,3.2288829826735967,187.6218605304377,184.85858006587083,2.757112052181051,6.734856044666515,22898400,1.4847313020601278,1.055691867654015,761470000.0,-51.070273246610235,45.37968769486497,52.4753318404932,44.033418185790225,27.51145106693995,18.19431796640899,0.0843401269901785,3.337549259752634,188.6631195678711,186.7534393005371,185.20999908447266,183.6665588684082,181.75687860107422,0.04,0.0,152.82714702345655,-0.029013633799641503,-0.004036163870618087,188.0357164655413,185.6550020490374,5.105781010378129
2024-07-15,0,186.1525001525879,175.55499649047852,190.27749633789062,178.00875282287598,186.03812885284424,-0.09186550079021169,4.926024784328876,-1.260145563291332,2.995368398556967,183.38250160217285,4.181300506591799,0.026962866774660203,175.90925064086915,189.28224754333496,0.8939710659073711,0.05528603309265683,1.0189159172222801,0.9976646367642055,0.9874233190680226,-0.016211274154264488,60.37942031980406,192.54867546892632,182.69662590026854,172.84457633161077,188.1500004359654,1.8255741856979915,185.8689294542585,2.786381360574853,187.06267092174593,184.83971927218613,0.9980667325286536,3.8734617783355625,16474000,1.48317781210215,0.7673584335714889,777944000.0,-42.335770036593864,45.37968769486497,52.4753318404932,54.79353400010724,27.975235830475878,16.901053486709163,0.11809902862639554,3.3362962494397888,188.84011956787108,187.0399393005371,185.58499908447266,184.1300588684082,182.32987860107423,0.04,0.0,152.9544502522947,-0.01322541404086286,-0.021353657890274595,188.13714381626673,186.17714473179407,4.815257568644161
2024-07-16,0,185.8324966430664,175.55499649047852,190.27749633789062,179.43187618255615,186.5743761062622,-0.2566047208067738,4.707333895274132,-1.1000411520415974,2.995401426130358,183.49750328063965,3.8907504272460924,0.025692512008036284,175.98174934387208,189.28224754333496,0.8707283175910584,0.06036571942675608,1.0142691718296524,0.9944772573680606,0.9889441543263413,-0.021122784213309043,62.47536548225898,192.63279351534075,183.2181257247925,173.80345793424422,187.80035672869002,2.02049890124815,186.15410804748535,2.535310992884647,186.82622774199933,184.9392731188557,0.5197352440697618,3.570534131050445,18290700,1.4749880826349606,0.851529878523134,759653300.0,-74.92826906874635,45.37968769486497,52.4753318404932,27.963931956096253,24.92379030696467,18.24152115982534,0.050035096603693235,3.4772764729157775,189.28380072021486,187.75810116577148,186.5250015258789,185.29190188598633,183.76620233154296,0.06,0.0,153.08949777129266,-0.02677530782617299,-0.02703274952838451,187.182856968471,186.1692875453404,4.545807735244587
2024-07-17,0,181.86000061035156,175.93000030517578,190.27749633789062,181.31374740600586,186.5743761062622,-0.39228481892053324,4.393232768697395,-0.8509139416027902,2.9954454503664003,184.26000213623047,3.5667495727539062,0.023911091977360438,176.41950225830078,189.28224754333496,0.8656746085658279,0.053069227542811,0.9898112461922374,0.9716417495888732,0.9719520300167915,-0.044237999183000865,60.41120691328294,192.51846626981666,183.73200073242188,174.9455351950271,186.7489286150251,2.8875721772285883,186.0458938053676,2.690630415543676,186.57074628249558,185.01397667138556,-1.2999287854300285,2.195611738661177,20734100,1.4850285784658204,0.9627830024624354,738919200.0,-90.54844051393096,45.37968769486497,52.4753318404932,-52.472810875395346,22.888329095901845,23.801178652609845,0.014501099515184026,3.516043142265579,188.9533985595703,187.22329766845704,185.8249969482422,184.42669622802734,182.69659533691407,0.08,0.0,153.22318523998482,-0.05314357564889349,-0.04212081508645151,186.03857203892298,185.96500178745814,4.327955436676966
2024-07-18,0,179.64749908447266,175.93000030517578,190.27749633789062,181.85499954223633,186.5743761062622,-0.4079495364524454,4.094431478912072,-0.5633667470619454,2.99548389492547,184.26000213623047,3.297124671936035,0.022252148397173814,178.26900253295898,189.28224754333496,0.8035321980022604,0.033706589523613634,0.9763364778230497,0.9607164901439169,0.9688444519424452,-0.04361427124032291,46.435153933683964,192.1904885910639,184.00162563323974,175.81276267541557,185.29250008719308,3.559968986090999,185.669643674578,3.1839988699849724,185.38562934645,184.56025257606993,-3.8896506165054467,-0.8261755362772665,25315700,1.7793829897635907,1.1661986338601467,713603500.0,-92.01569817953045,45.37968769486497,52.4753318404932,-114.82593400914254,20.220727810196117,27.656716956415448,-0.0002715193128369222,3.6956131137356234,188.14392028808595,185.9130404663086,184.11000061035156,182.30696075439454,180.07608093261717,0.1,0.0,153.36983998197485,-0.042463784942600946,-0.07056172586664147,184.42571585518974,185.4135731288365,4.075285326912316
2024-07-19,0,178.4900016784668,175.98749923706055,190.27749633789062,181.85499954223633,186.5743761062622,-0.25352776870644866,3.797391706273221,-0.6057211894114536,2.995519336742247,184.26000213623047,3.1112497329711912,0.020616989179374743,179.53499946594238,189.28224754333496,0.7317091241680889,0.02079693082337614,0.9690668537439419,0.9573640801382739,0.9711838857105026,-0.037465464069085574,40.56005218282028,191.78228398475105,184.18750057220458,176.59271715965812,183.60857227870397,3.5966369018713116,185.31964356558663,3.6839311350736192,183.95653973090373,183.9308609967871,-5.370240994708202,-2.8486070924343134,18881900,1.8665403180137743,0.8723861657542493,694721600.0,-92.21202528485405,45.37968769486497,52.4753318404932,-133.08152346046663,18.972795302495424,25.94986859417279,-0.03573959440564163,3.657353867206579,188.14392028808595,185.9130404663086,184.11000061035156,182.30696075439454,180.07608093261717,0.1,0.0,153.4759015863051,-0.04003892240155371,-0.04262544242017196,182.4942888532366,185.09285954066686,3.945582567613006
2024-07-22,0,181.2974967956543,178.4900016784668,190.27749633789062,181.85499954223633,186.5743761062622,-0.007061855785477781,3.5588763763424685,-0.9835977926392134,2.995545824657167,184.26000213623047,2.986124610900879,0.019308912576861053,179.53499946594238,189.28224754333496,0.7448945723280189,-0.00018205671652207225,0.9836412243205633,0.9775557907086028,0.9939746495116885,-0.02608078512485179,35.59937787536758,191.43037844695988,184.3126256942749,177.19487294158995,182.6739283970424,3.1341113434259764,185.21232169015067,3.7835205058276045,182.6029844376503,183.35115876828988,-6.1948968670955455,-2.671902197645413,24100300,1.8037098468161619,1.209863528088816,718821900.0,-65.9686036409391,45.37968769486497,52.4753318404932,-68.1970918995767,21.73740741162577,23.46271952303112,-0.0912167256966256,3.756114637418037,188.14392028808595,185.9130404663086,184.11000061035156,182.30696075439454,180.07608093261717,0.1,0.0,153.6270722450592,-0.026054793556836597,-0.018371475769799157,181.93714468819755,184.99857330322266,3.8440815901865966
2024-07-23,0,182.24749755859375,178.4900016784668,190.27749633789062,181.85499954223633,186.5743761062622,0.08439183163986094,3.3800330766014444,-0.9446249175598473,2.9955644418078347,184.26000213623047,2.84737491607666,0.018324791937556897,179.72625045776368,189.28224754333496,0.7802617103431042,0.00869333285112385,0.9880517137600285,0.9868940178748972,1.0045307776519428,-0.019291561751755726,44.48488203340728,191.21144154230203,184.45137538909913,177.69130923589623,182.21821321759904,2.8875215259064,185.11535699026925,3.844781040066147,182.28481937673013,183.25720999754782,-3.483021206052745,-0.8219399513237959,36352700,1.8931657462102092,1.7458303087729021,755174600.0,-65.1832952196447,45.37968769486497,52.4753318404932,-55.909241891898695,22.641230406953227,22.508517880795903,-0.1313020871905052,3.635677481590959,188.14392028808595,185.9130404663086,184.11000061035156,182.30696075439454,180.07608093261717,0.1,0.0,153.85832795689186,-0.0115811488909211,-0.025411491578748457,181.46857125418526,184.75214385986328,3.702766944400721
2024-07-24,0,173.56000518798828,178.4900016784668,190.27749633789062,182.1506233215332,186.5743761062622,0.11676328355464759,3.2464575029625533,-0.8240583810547188,2.9955776820561733,184.26000213623047,2.7217500686645506,0.017588635088893217,181.13249702453612,189.28224754333496,0.8158942146075167,0.002240987840463416,0.9403122001419131,0.9437314829801962,0.9604418497673234,-0.04563947758994369,45.878316246607135,191.0699152424363,184.57700023651122,178.08408523058614,180.4192853655134,3.804813750447461,184.28464290073939,4.930515786329512,182.27985855988595,183.27490569168108,-1.7202594893054661,-0.7393620944527378,49585200,1.8451744081002903,2.2396140210067133,705589400.0,-95.9357859695651,45.37968769486497,52.4753318404932,-221.72186358023347,18.697158918888736,35.57062085348519,-0.2408284590387334,4.088131293781574,187.04652172851561,184.13674279785155,181.78500366210938,179.4332645263672,176.52348559570314,0.12000000000000001,0.0,154.07246595270573,-0.046348465316685794,-0.0613853490568331,179.48285784040178,183.81000082833427,4.559197168004267
2024-07-25,0,170.10250091552734,173.56000518798828,190.27749633789062,182.1506233215332,186.5743761062622,-0.6496175930405814,4.007772468945991,0.4484526488982059,2.9954942973693295,184.26000213623047,3.135749626159668,0.021762093657081923,179.53174934387206,189.28224754333496,0.6095529226603248,-0.05352417075398347,0.9236518751777113,0.9334161949048984,0.9500358889213915,-0.053131817685127536,28.716046086705166,192.17854561690808,184.1630006790161,176.14745574112413,178.1721431187221,4.630430022586335,182.98624992370605,6.061216738989508,180.09388379436473,182.10248931328854,-6.764612322841558,-6.280035153138289,44852000,2.643198955244213,1.9175129960755795,660737400.0,-99.63356536304241,45.37968769486497,52.4753318404932,-237.23176896722111,16.735347031709964,39.6362098607889,-0.33714372451528496,4.241122617254363,185.95384057617187,182.36808093261718,179.47000122070312,176.57192150878907,172.98616186523438,0.14,0.0,154.22078502869977,-0.05858519623546121,-0.07590324366849213,177.10571507045202,182.1442860194615,5.8882719400650645
2024-07-26,0,166.5749969482422,170.10250091552734,190.27749633789062,181.71937465667725,186.5743761062622,-1.0092129122262024,5.047343609208711,0.7470933055932134,2.9953502966386707,184.26000213623047,3.8099373435974115,0.02750605330003184,177.99700202941895,189.28224754333496,0.6772640170021889,-0.08010437188255283,0.9077687392139522,0.9230436570588098,0.9403605437888037,-0.06675446589825451,23.816469729009093,193.5940629432099,183.4993757247925,173.40468850637507,175.9885711669922,6.002261994540799,181.36874989100866,7.186739156850061,177.58788850443187,180.69925343580636,-8.464609802747308,-9.654504688777093,41336900,2.6739342259086047,1.6861801382534816,619400500.0,-89.38244065659627,45.37968769486497,52.4753318404932,-222.8751077145028,15.595411159535487,42.22673814057038,-0.29718089095248956,4.2260422509649995,185.2151594238281,181.1724190673828,177.90499877929688,174.63757849121095,170.5948381347656,0.16,0.0,154.32901837059904,-0.06000227086780652,-0.06016096738437103,175.1028573172433,180.57071467808314,6.86759795632089
2024-07-29,0,169.19499969482422,166.5749969482422,190.27749633789062,180.8849973678589,186.5743761062622,-1.092573661347908,6.233483637597445,0.5544239414258052,2.9951418147768427,183.49750328063965,4.687900543212891,0.034140664560995196,173.2142547607422,189.28224754333496,0.733375046972811,-0.09168987383334676,0.9266776117190664,0.9474650926302294,0.9681757199137809,-0.06675490458906419,21.04017055420863,195.04934280162308,182.58237552642822,170.11540825123336,174.495356968471,6.235916581253763,179.89392852783203,7.428553317505166,174.8246642424744,179.01809387156365,-8.404818877603889,-11.96755140482045,20293800,2.7398890080530434,0.843046737959806,639694300.0,-80.24557335349469,45.37968769486497,52.4753318404932,-149.56841569444222,18.687976434131837,39.74529469914287,-0.2382932158717331,4.169181244388544,185.2151594238281,181.1724190673828,177.90499877929688,174.63757849121095,170.5948381347656,0.16,0.0,154.39421156862733,-0.0668244592503312,-0.04576159357890656,173.93714250837053,179.18142918178015,7.428431219151295
2024-07-30,0,170.04999923706055,166.5749969482422,190.27749633789062,179.3581247329712,186.5743761062622,-0.8722997733713167,6.87612182906401,-0.30519207973012863,2.9950092426265016,183.2025032043457,5.425350189208984,0.03780734904879412,170.01175079345703,189.28224754333496,0.8278313108437093,-0.07442561887201657,0.9349950214273426,0.9613821724890098,0.9867352101524639,-0.06692820743731542,28.64475357660275,195.62486900908016,181.87262535095215,168.12038169282414,173.28964233398438,6.150172330817806,178.44910730634416,7.217732455716764,173.41549601497906,177.9656868956641,-5.81833838094987,-10.87612058271346,18959700,2.849640265180136,0.78282287670902,658654000.0,-76.75374993238877,45.37968769486497,52.4753318404932,-119.43104814249659,19.176859479874835,37.79949772469176,-0.23431999681519708,4.0706672997483215,184.5351998901367,180.62239944458008,177.45999908447266,174.29759872436523,170.3847982788086,0.16,0.0,154.4573203801886,-0.0632598076061277,-0.06264107996648727,172.88428388323103,177.6892863682338,7.831629097765549
2024-07-31,0,172.2599983215332,166.5749969482422,190.27749633789062,177.25750255584717,186.5743761062622,-0.6662665821437437,7.336236627617024,-0.859990778562838,2.9949051349713236,182.92625045776367,6.102587337493898,0.04047911033322912,169.96449928283693,189.28224754333496,0.8630458973568086,-0.07382698658555462,0.9504779946450789,0.9826442780133918,1.0139113985237225,-0.007490244454919193,30.430908769691253,195.9075984154513,181.23512516021728,166.56265190498326,171.99857112339564,5.036766452959592,177.33624976021903,6.850162303006175,172.58642042990772,177.09203671445826,-4.728557544982341,-10.630525148864967,25729100,2.851066416521865,1.044307079233128,684383100.0,-69.61820791622662,45.37968769486497,52.4753318404932,-86.13012484367279,23.037891832789914,34.99553411507093,-0.2743312933116645,4.082762944169754,182.869673828125,179.27515454101564,176.3699951171875,173.46483569335936,169.87031640625,0.16,0.0,154.55278273464006,-0.00631414913890338,-0.05638374156198334,171.43714032854353,176.68714250837053,8.030954767151421
2024-08-01,0,170.98500061035156,166.5749969482422,190.27749633789062,173.2350034713745,186.5743761062622,-0.4670317556180189,7.56607057615882,-1.1837020478213085,2.9948491818407788,182.05374908447266,6.54629981994629,0.04187833935608584,169.96449928283693,189.28224754333496,0.8874899839552485,-0.06982020600147719,0.9464051132333158,0.980741936471598,1.0079493599235843,0.0051880465605997905,35.2633177798984,195.80001606076485,180.66787490844726,165.53573375612967,170.3896429879325,2.239061622837081,176.30392810276575,6.620538108237297,172.5247731088134,176.57418952973902,-4.984899755294207,-8.294295845769584,24531400,2.8808451405141513,0.967633653427054,659851700.0,-72.78635955713555,45.37968769486497,52.4753318404932,-82.4200497891556,20.993003592291412,33.829303212044586,-0.2947762504991235,4.160422955891583,182.869673828125,179.27515454101564,176.3699951171875,173.46483569335936,169.87031640625,0.02,1.0,154.63919098451927,0.02080341793958551,-0.010832475949044856,169.8614262172154,175.66499873570032,8.184781393324357
2024-08-02,0,166.56999969482422,166.5749969482422,190.27749633789062,171.9412488937378,186.5743761062622,-0.2624756172268497,7.772154761279809,-1.4002125727723844,2.9947956420279014,181.57874870300293,6.875362167358398,0.04318880497110315,169.96449928283693,189.28224754333496,0.8723923107603616,-0.09185788052562022,0.9256067914005193,0.960189074803327,0.9809025263825879,-3.000002106867683e-05,31.489376936428467,195.50193433945418,179.95762481689454,164.4133152943349,169.39107077462333,2.1462694322887987,174.90517807006836,6.446070900042665,172.15414373162588,176.12982859507267,-6.179781395693086,-7.793732609120808,29130100,2.741684364274527,1.1308233514802748,630721600.0,-89.43945321215547,45.37968769486497,52.4753318404932,-112.28559686188872,18.868420528525306,37.40187402963239,-0.3245597255228286,4.298250207458397,182.869673828125,179.27515454101564,176.3699951171875,173.46483569335936,169.87031640625,0.02,0.0,154.71241133558527,-0.0020359062149138962,-0.0037063314306063507,169.0085688999721,174.24571337018693,8.224478879173716
2024-08-05,0,158.52749633789062,166.56999969482422,190.27749633789062,170.7643756866455,185.91249752044678,-0.11514712849213261,8.045272263621403,-1.452217303113276,2.994718495025805,180.47249794006348,7.206161975860596,0.04497778666394774,168.93299942016603,189.28224754333496,0.8317563668973723,-0.11970192380133035,0.8862616052033883,0.9201508367783092,0.9335470802636102,-0.06304857339859038,25.817191792508307,194.96266919917883,178.87212467193604,162.78158014469324,167.7374986921038,4.582754759754115,172.95482090541296,6.993081500682896,170.76356553192716,175.10628338666368,-4.027428718726396,-10.519601102167327,53630700,2.8113519778503715,1.9580522982626392,577090900.0,-84.93721712325086,45.37968769486497,52.4753318404932,-152.3835177243188,15.594696083661214,45.3193372305757,-0.31587791009765465,4.8290923424945404,176.84151873779297,172.6542375793457,169.2699966430664,165.8857557067871,161.69847454833985,0.02,1.0,154.76611783249515,-0.060638228356740154,-0.04640718562874251,167.8614262172154,172.4835706438337,8.849711792360186
2024-08-06,0,158.6500015258789,158.52749633789062,190.27749633789062,170.08937549591064,185.53625202178955,-0.25545635549476037,8.815475219053825,-0.9634813377906299,2.9944904283263507,179.06875038146973,7.821249961853027,0.0497101585283245,166.5744972229004,188.04025344848634,0.7581933222190611,-0.16495254035721366,0.8946218474217245,0.9331955080650884,0.9461559032500029,-0.06703909298634758,19.228537632621435,194.96845005663798,177.33749961853027,159.70654918042257,166.60535648890905,5.748460950436733,171.2969638279506,7.455448322851796,167.71485083029185,173.13760018705446,-6.804723337597987,-14.693339861661142,49004600,3.1610604270237084,1.6849344553255778,626095500.0,-88.28451994149735,45.37968769486497,52.4753318404932,-142.60957087669786,14.625530089345988,42.502869356296586,-0.28470319664859584,4.781300120057192,176.84151873779297,172.6542375793457,169.2699966430664,165.8857557067871,161.69847454833985,0.02,0.0,154.80294561895548,-0.07046802791187379,-0.06630098256413543,166.6171395438058,170.85999843052454,9.277210798421578
2024-08-07,0,160.4099998474121,158.52749633789062,190.27749633789062,169.83624935150146,183.04499912261963,-0.25294074602286415,9.21534332909494,-0.9625205207971557,2.9943506371420483,176.02500343322754,8.130374908447266,0.05242607092556031,165.7779998779297,186.3212505340576,0.7807135270412596,-0.1662177368355126,0.9125721884520908,0.9568290609368624,0.969839512015808,-0.06879135370710032,19.270652154713474,194.20856141404926,175.7778747558594,157.34718809766952,165.35035651070731,6.040417164906323,169.92285673958915,7.569922200648973,165.45621538119522,171.26878211127655,-4.75761402824802,-12.762564063882188,25138600,3.1509758632126075,0.8509074058622798,651234100.0,-86.01810091973017,45.37968769486497,52.4753318404932,-117.69895757423363,17.204642079444177,39.52084291506699,-0.329637570025212,4.77477883527034,176.84151873779297,172.6542375793457,169.2699966430664,165.8857557067871,161.69847454833985,0.02,0.0,154.8303221607944,-0.07345220553733778,-0.06665095597047524,165.10428292410714,169.52071271623885,9.166904273844224
2024-08-08,0,161.61000061035156,158.52749633789062,187.84000396728516,168.5399990081787,181.9568748474121,-0.19777200289335978,9.164551923883218,-1.123852931993312,2.9943437305430955,172.91000175476074,8.024450092315675,0.05258386102891459,160.2340000152588,185.86449699401857,0.8170292555222453,-0.14602855377201945,0.9272769562067918,0.9716080818691589,0.9912990734971381,-0.05482937080173589,24.41898815117764,192.61360377910194,174.28449993133546,155.95539608356898,164.14464242117745,5.782837141096858,168.71714237758093,7.4436526006728485,164.19505816788546,169.76488312074372,-5.1922337322365015,-10.708470385115028,25578800,3.235067475532804,0.8658764524548732,676812900.0,-75.2440580919177,45.37968769486497,52.4753318404932,-94.38786750437126,17.044195039612752,36.71152499491546,-0.29165408783018737,4.773008912914289,176.84151873779297,172.6542375793457,169.2699966430664,165.8857557067871,161.69847454833985,0.02,0.0,154.8674970421318,-0.051124361726244794,-0.05543893482013281,163.92428370884485,168.40428379603796,9.067157769873907
2024-08-09,0,161.63249588012695,158.52749633789062,186.1525001525879,166.5737476348877,181.4381227493286,-0.07826894951766074,9.00630564902937,-1.2222284908399514,2.99437380987715,171.62249946594238,7.776800365447997,0.052067696469067226,160.2340000152588,185.47700309753418,0.8401631107894447,-0.1284934423413933,0.9344377220787752,0.9767302526424991,1.0029722983244835,-0.02964221542740797,28.12944696616887,190.9856110615475,172.97299976348876,154.96038846543001,162.62642778669084,4.56370247208675,167.31249945504325,6.7059567484978535,163.5403154046466,168.55567592575977,-4.9632453187742085,-9.457112952759669,28602300,3.278592929392012,0.9589678580493011,705415200.0,-69.52579123024219,45.37968769486497,52.4753318404932,-86.05993528991058,15.83694320998703,35.83333703540195,-0.22195887393649893,4.769936533582688,176.84151873779297,172.6542375793457,169.2699966430664,165.8857557067871,161.69847454833985,0.02,0.0,154.9097480520172,-0.017940750194786248,-0.04152024224624108,162.7999986921038,167.11856951032365,8.760426727560274
2024-08-12,0,163.34499740600586,158.52749633789062,186.1525001525879,165.3356237411499,180.05999851226807,0.07865556933467018,8.852062120835093,-1.223417361796966,2.9944053265863535,170.54375076293945,7.530275173187254,0.05153056493429227,160.2340000152588,182.60599746704102,0.8267198158544136,-0.13171998362827286,0.9508812614080382,0.9900356885717843,1.019848148725017,0.03038905665832914,27.710360471382412,189.48687360843044,171.78274936676024,154.07862512509004,161.5349987574986,2.8070257952562248,165.96232087271554,5.201873036653431,163.05506668518524,167.55398401213031,-6.169454629605537,-10.84681325616555,15895300,3.2602986985802147,0.5334495411396946,721310500.0,-65.38101020888598,45.37968769486497,52.4753318404932,-72.59209268054876,16.79806234899013,34.14820375406729,-0.24016940235967932,4.64779770507303,171.17264013671874,168.0686787109375,165.55999755859375,163.05131640625,159.94735498046876,0.02,0.0,154.93569819945736,0.01908943978733313,-0.026221110524132892,161.58999851771765,165.7257123674665,8.218132925299708
2024-08-13,0,163.81750106811523,158.52749633789062,185.8324966430664,162.91687202453613,178.77937602996826,0.20043781398941318,8.384142434531165,-1.1748119294738946,2.9945283416427912,170.07625007629395,7.039862842559813,0.04913282807035118,160.2340000152588,181.89875030517578,0.8149102129212085,-0.12100950933384329,0.9600048159659349,0.9964325814287712,1.0166822464535812,0.03257169550920813,32.57312195392296,187.41065909849348,170.64237422943114,153.8740893603688,161.14178466796875,2.0837715809348336,165.26642772129603,4.738297189334988,163.13623559497964,166.95003214627707,-4.468230065253555,-10.371884610657336,18551700,3.3231266348938404,0.6223263176803814,739862200.0,-52.22563412407318,45.37968769486497,52.4753318404932,-58.0640730099354,16.146033639132565,32.82271699403889,-0.20477936233773922,4.490097647380941,169.69047827148438,166.86975720214843,164.58999633789062,162.31023547363282,159.48951440429687,0.02,0.0,154.9692896259223,0.03708390059354949,0.03083204811371664,161.23285566057478,165.12071228027344,7.6494200351998405
2024-08-14,0,160.92499923706055,158.52749633789062,182.24749755859375,162.91687202453613,174.7925043106079,0.2720477707236006,7.73783871784846,-1.1636092931772892,2.9946944348916738,169.62249946594238,6.508375549316407,0.04563975804124284,160.2340000152588,181.35374717712403,0.8307341698924903,-0.0992109286356691,0.9491769337380068,0.9825635802232324,0.9923657077553872,0.0032105192328304444,35.269520189571885,185.01730188638052,169.5416244506836,154.06594701498668,161.48428508213587,1.7532812440016858,164.61089188711983,4.651825112736381,163.31444065461932,166.63123715367016,-1.6524576044617187,-5.613334771061245,40591100,3.2746607930849296,1.3177604393324762,699271100.0,-71.84264814130327,45.37968769486497,52.4753318404932,-86.38062749588161,14.539429679811146,37.671337740922404,-0.18744992811714925,4.630090781013121,169.69047827148438,166.86975720214843,164.58999633789062,162.31023547363282,159.48951440429687,0.02,0.0,155.01346413912196,0.008997059606239866,0.013140450560856196,161.39285496303015,164.62714059012276,7.359218915831192
2024-08-15,0,160.76250076293945,158.52749633789062,182.24749755859375,161.6268720626831,172.58500003814697,0.4280725609970126,7.409700011487231,-0.9847955070194128,2.9947707906980847,167.8849983215332,6.2886255264282225,0.04397581848506341,160.2340000152588,179.81249885559083,0.8151155092715363,-0.10421798211957596,0.954109146361637,0.9884120483569194,0.9907343615536364,-0.005244105217569239,31.846022172012717,183.3142744049935,168.49487438201905,153.67547435904459,161.78607068743025,1.3098510213403076,164.19571358816964,4.721899737540297,162.73408372072697,165.97611148308945,1.5123577641444654,-5.3952773351782355,31524300,3.2919380482559766,1.0132024577735887,667746800.0,-67.02894430070229,45.37968769486497,52.4753318404932,-74.98598730268371,14.065072048144472,36.44228770622177,-0.12766853003098788,4.444369521626126,169.69047827148438,166.86975720214843,164.58999633789062,162.31023547363282,159.48951440429687,0.02,0.0,155.04988155257112,-0.004505312183167964,0.014848374066318417,161.82285635811942,164.2199979509626,7.153588041682143
2024-08-16,0,162.65500259399414,158.52749633789062,182.24749755859375,161.4387502670288,171.30375003814697,0.6255291522802602,7.126182327009746,-0.6491944021450946,2.994835209177734,166.5724983215332,6.023187980651855,0.042531517562074315,160.2340000152588,178.77075119018556,0.8086030048174855,-0.09931929379137883,0.9707812376853101,1.0063727972887588,1.003445501457681,0.0063261209220299985,32.017758224313475,181.80298911996186,167.55062446594238,153.2982598119229,162.1067853655134,1.185729350580486,163.72857093811035,4.507926351885473,162.24606246510277,165.31379918862774,1.331546937751499,-3.4894169543996933,24208600,3.2966945056251418,0.7714693437128145,691955400.0,-58.43679609779522,45.37968769486497,52.4753318404932,-45.36504938311155,18.711639112047976,34.12134054411713,-0.10924107413983708,4.40762824448197,169.69047827148438,166.86975720214843,164.58999633789062,162.31023547363282,159.48951440429687,0.02,0.0,155.0880319164304,-0.004337945029761925,0.005739726850440135,162.3971426827567,163.75071280343192,6.784795856837948
