date,buy?,todays_price,Minimum,Maximum,25th Percentile,75th Percentile,Skewness,Standard Deviation,Kurtosis,Shannon Entropy,Median,Mean Absolute Deviation (MAD),Coefficient of Variation (CV),10th Percentile,90th Percentile,Autocorrelation,Cumulative Return,curr_to_avg_one_month,curr_to_avg_one_two_week,curr_to_avg_one_one_week,momentum,rsi,upper_band_current,middle_band_current,lower_band_current,rolling_mean_7,rolling_std_7,rolling_mean_14,rolling_std_14,ema_7,ema_14,roc_7,roc_14,Volume,Volatility,Relative Volume (RVOL),On-Balance Volume (OBV),Williams %R,Stochastic Oscillator %K,Stochastic Oscillator %D,Commodity Channel Index (CCI),ADX1,ADX2,Chaikin Money Flow (CMF),Average True Range (ATR),Fib_23.6,Fib_38.2,Fib_50,Fib_61.8,Fib_76.4,Parabolic SAR 2,Parabolic SAR 3,VWAP,Adj Close Momentum,Adj Close Return,Adj Close 7d MA,Adj Close 14d MA,Adj Close Volatility
2024-01-02,0,52.77250099182129,50.28083419799805,52.597500801086426,50.93687391281128,51.76791739463806,0.005407955528900911,0.6706987265635056,-0.8248916879036083,2.995647255595617,51.488749504089355,0.5378792619705202,0.013039533469538917,50.43583431243896,52.37600011825562,0.8212934018028206,0.02016310997810148,1.0259879222969919,1.0175774810734761,1.008244034451116,0.014189420293451604,69.2005325441938,52.77718908864031,51.435791635513304,50.094394182386296,52.27976199558803,0.43274821651880135,51.684166635785786,0.7555815857178843,52.1589646075182,51.783168803642816,1.6560466887195102,4.14828325581427,23539800,0.32010243416892903,0.8913395254315072,14156100.0,-2.6852443701445567,97.72219427934739,97.34986547195354,151.46381850961205,33.061537920653365,10.95058808166648,0.19829697223348206,0.6030407439136012,52.447613830566404,51.99452728271484,51.628334045410156,51.26214080810547,50.80905426025391,0.14,0.0,51.35497379621871,0.01685289611110896,0.029005230802673507,51.887010301862446,51.2805426461356,0.8034512924167545
2024-01-03,0,53.19166660308838,50.28083419799805,52.77250099182129,50.93687391281128,52.07062482833862,0.04705900471371734,0.7313834187580774,-0.9660558420094301,2.9956314444940157,51.52750015258789,0.5971668720245361,0.014201734667573565,50.43583431243896,52.54124908447265,0.8279493144352091,0.028269430185837066,1.0328562505639283,1.0217606316377454,1.0133933614340271,0.019388008662243106,73.13494138802297,52.96235022489104,51.49958338737488,50.03681654985871,52.52416678837368,0.3870341830427721,51.88529757090977,0.7553000101244299,52.31302394990205,51.8936079675116,2.323515442117978,4.955500109666933,18756000,0.31777077200492204,0.7185352087424083,32912100.0,-10.352041928482745,97.72219427934739,97.34986547195354,151.3765391078991,34.632448547221074,10.183062764116952,0.17351100971600789,0.5897909339821893,52.6734140625,52.20329388427734,51.823333740234375,51.44337359619141,50.97325341796875,0.16,0.0,51.41304531350406,0.01847716318084558,0.01691670489661243,52.09922736031668,51.467764718191965,0.8717586571163582
2024-01-04,0,52.833333015441895,50.28083419799805,53.19166660308838,50.93687391281128,52.22458362579346,0.13342340889985216,0.8171621746500483,-0.9154438253625541,2.995606920398381,51.58166694641113,0.6658084869384766,0.01583859930613571,50.43583431243896,52.61500082015991,0.825634362235409,0.02989818604580824,1.0240390678846325,1.0113513719751521,1.0027012742117594,0.009072088342923834,76.43313769318281,53.22740773095293,51.59308338165283,49.95875903235273,52.63833345685686,0.3324198821784565,52.02642856325422,0.7327380434738918,52.53177674981926,52.03592843395272,3.3232437161974886,5.589650623053756,19282500,0.3222786750666265,0.7424044316722263,13629600.0,-28.995468090470972,97.72219427934739,97.34986547195354,97.95486749836654,31.117808779234842,16.27826023085569,0.10970167565498937,0.5980999842691461,52.74421388244629,52.31789359283447,51.97333335876465,51.628773124694824,51.20245283508301,0.16,0.0,51.4557628407152,-0.0007601059507915675,0.008631246298121283,52.15157427106585,51.55524526323591,0.8975862855318963
2024-01-05,0,52.3608341217041,50.28083419799805,53.19166660308838,50.93687391281128,52.40249991416931,0.05670632749908086,0.8608143929641225,-1.1358401066273833,2.9955934353243814,51.58166694641113,0.731029300689697,0.016665533626586015,50.43583431243896,52.77858419418335,0.8777815441368358,0.02411681473474467,1.01371590543064,1.0000971056239785,0.991945479126294,-0.004499580318033547,67.40101138615826,53.374003816445814,51.652375030517575,49.930746244589336,52.66416685921805,0.29588368174635193,52.12625013078962,0.6692083635012729,52.60448888511755,52.10068258657991,1.535849876446475,3.885039427633759,21709500,0.335797076571733,0.8435412529732017,-8079900.0,-40.981709061598174,97.72219427934739,97.34986547195354,49.65671721317335,27.458166197084655,23.254830542335814,0.13898489028805597,0.618637326380301,52.74421388244629,52.31789359283447,51.97333335876465,51.628773124694824,51.20245283508301,0.02,1.0,51.483868961819205,-0.005457862139075398,-0.007410685355001684,52.16572298322405,51.662297112601145,0.8979072453187568
2024-01-08,0,52.493332862854004,50.28083419799805,53.19166660308838,50.93687391281128,52.404375314712524,-0.05173366681226038,0.8743046903417694,-1.2292600544257022,2.995589176794156,51.626667499542236,0.7644709014892577,0.01691407389855945,50.43583431243896,52.77858419418335,0.9019047421623895,0.02403927018184576,1.0155225301112332,1.0011236148992813,0.9953481216432107,-0.0007931099602394021,59.46949876216874,53.43956778522456,51.690958404541014,49.94234902385747,52.683452469961985,0.2763842854866627,52.24767868859427,0.5528646455243452,52.54094846148661,52.09303957640213,0.3465577145854927,2.742171451159564,20680800,0.3370409018230251,0.8109464119656239,12600900.0,-28.59135708870356,97.72219427934739,97.34986547195354,69.01758308078796,26.277399397325578,21.501104270911224,0.21861754182806056,0.6115926114237358,52.86929359436035,52.520353126525876,52.238332748413086,51.956312370300296,51.60737190246582,0.02,0.0,51.51885760582883,0.0038058546479005084,0.004315496729110891,52.18317140851702,51.79222079685756,0.8999296696037611
2024-01-09,0,52.85916709899902,50.28083419799805,53.19166660308838,50.93687391281128,52.50374937057495,-0.23227420683385946,0.8810920498616968,-1.2209944924643263,2.995587179512886,51.856667041778564,0.7766250133514404,0.017022959086318252,50.43583431243896,52.77858419418335,0.8694833674553004,0.040656822150222496,1.0212547474516007,1.0061577280186702,1.0024432536534347,0.0016422588573388186,64.9498872009039,53.52122583823352,51.759041738510135,49.99685763878675,52.72083336966379,0.28048655922086435,52.353571619306294,0.5137973130220934,52.525810465430254,52.11476003112062,0.25783722658310787,3.3468955610209186,23322300,0.28645722224490217,0.9342112931882405,35923200.0,-14.820449300762197,97.72219427934739,97.34986547195354,90.94606205468384,29.202372038672664,19.886068165144223,0.2935781337686352,0.6052454540101837,52.90784129333496,52.58274813079834,52.32000160217285,52.05725507354737,51.73216191101074,0.02,0.0,51.5679284127241,0.0001255024905715274,0.010529614265248028,52.265228271484375,51.8945563180106,0.8686206136246326
2024-01-10,0,53.49250030517578,50.28083419799805,53.19166660308838,51.273332595825195,52.55062437057495,-0.3909191565635989,0.8576551388330661,-1.0598714609062942,2.99559532082014,52.107083320617676,0.753720917701721,0.01653155752921351,50.751583099365234,52.835916423797606,0.816329965371834,0.051278642093484476,1.0310838309436254,1.0166165704684416,1.0141206921705899,0.0056556547538206825,70.19408706847766,53.59518531772045,51.87987504005432,50.164564762388196,52.857619285583496,0.3877282035101357,52.48309537342617,0.557419063054893,52.607692363161114,52.21077730964878,0.4974880819949392,2.885553196418667,20121900,0.28453795185702296,0.8254589848797741,56045100.0,-2.664966510012141,97.72219427934739,97.34986547195354,140.46964309765121,36.0844456718115,17.91484002562365,0.2819812097259952,0.6156751534292679,53.21343954467773,52.82994671630859,52.52000045776367,52.21005419921875,51.82656137084961,0.02,1.0,51.6269118237218,0.012492154773017239,0.012555689916571312,52.43688801356724,52.03037479945591,0.8782721136503954
2024-01-11,0,53.71000003814697,50.37583351135254,53.49250030517578,51.45479130744934,52.64125084877014,-0.2990135924337763,0.8437812339486945,-0.8978941906450095,2.995600602912251,52.26916694641113,0.722912678718567,0.016213947009232378,50.851082515716556,52.89241704940796,0.7485961641794856,0.06186829232554296,1.0320816100744608,1.0182103095683654,1.0170839532290115,0.016593066775644205,75.64613233346259,53.72802081331061,52.04045834541321,50.352895877515806,52.99154772077288,0.4992909976364711,52.63565485818045,0.5812857982587776,52.829302318017014,52.3855446026113,1.8225971858774002,3.508826934942328,14355300,0.30513178024679455,0.5975078760755853,70400400.0,-9.774373550665922,97.72219427934739,97.34986547195354,140.3254407803027,35.0471178102184,16.529026374663523,0.26496936877820493,0.6121778976635842,53.33557316589356,52.94721318817139,52.63333320617676,52.319453224182126,51.93109324645996,0.04,0.0,51.66878913709565,0.021234844183172452,0.011362267990922605,52.522718157087056,52.20486422947475,0.853816296639287
2024-01-12,0,53.71750068664551,50.79333305358887,53.71000003814697,51.5508337020874,52.78770899772644,-0.11206557541472915,0.827644117947582,-0.8741696400285597,2.9956065279470447,52.35958385467529,0.6925334930419922,0.015853074792418965,50.95274887084961,53.22174997329712,0.7746092191376526,0.056088108238469235,1.0289296299948367,1.0157497168123097,1.0138597566819323,0.025909949444045566,76.40548183105756,53.862454907648086,52.20716667175293,50.55187843585777,53.06666687556675,0.5690941532538613,52.795416831970215,0.5457566300935404,53.050897233662205,52.56219414665281,1.7764915982871035,4.141284097019211,13629000,0.29623063238565006,0.5941330829334193,84029400.0,-8.469483536141587,97.72219427934739,97.34986547195354,129.27365006113175,33.18279309733308,15.64976798551194,0.21890376030806388,0.5937573684781936,53.433906799316404,53.10638034057617,52.84166717529297,52.576954010009764,52.249427551269534,0.04,0.0,51.707148300607265,0.029417416593664925,0.02256598651175519,52.617980412074495,52.35860388619559,0.8847909890911768
2024-01-16,0,53.908331871032715,50.79333305358887,53.71750068664551,51.6529176235199,52.83979153633118,-0.11615176489046043,0.829168909677369,-0.7895637968034368,2.9956067496770853,52.42708349227905,0.6719668006896967,0.015838897202330192,51.33533267974853,53.5142502784729,0.7862859123248548,0.054042159192305636,1.029764281908039,1.01720390919028,1.0122774914839694,0.02695578525896969,76.25841292908287,54.00850456930897,52.35016674995423,50.691828930599485,53.220238140651155,0.6366677929790598,52.92928579875401,0.5738023549890258,53.21686295690783,52.722475314968236,0.9885647830530625,4.344660916283903,17032500,0.29781409669686765,0.7656306996671142,101061900.0,-8.382307402321135,97.72219427934739,97.34986547195354,142.2056258342595,35.385266462497945,14.794916178632414,0.2795541273978185,0.5772824976622353,53.59839892578125,53.267466186523436,53.0,52.732533813476564,52.40160107421875,0.06,0.0,51.7587961361884,0.02262244199113117,0.03267174581825368,52.809918539864675,52.48074640546526,0.8553386739886832
2024-01-17,0,53.755831718444824,50.79333305358887,53.908331871032715,51.94541668891907,52.94229197502136,-0.09080950858320158,0.8313043625831174,-0.7072285840388628,2.9956068254460977,52.5141658782959,0.6643332958221435,0.015835147980409293,51.470416355133054,53.710750102996826,0.7472565786246544,0.0613269228494497,1.023970988708054,1.0117046699525076,1.004078108212838,0.016963275599224836,78.92472673105344,54.160025459861664,52.497416734695435,50.834808009529205,53.419523511614116,0.5326596585271443,53.041845185416086,0.5700616459777198,53.38931302151549,52.90399515113819,2.034698161625776,3.601797947273639,14827800,0.2884830165954685,0.7608846249765235,86234100.0,-19.55882946926246,97.72219427934739,97.34986547195354,112.0142859808126,33.12051848630715,16.671647883860743,0.26079854885866316,0.5673542839631467,53.59839892578125,53.267466186523436,53.0,52.732533813476564,52.40160107421875,0.06,0.0,51.79796954329197,0.01104769315836851,0.017819960543534463,53.01553290230887,52.59062794276646,0.797092763710283
2024-01-18,0,54.039167404174805,51.37666606903076,53.908331871032715,52.14354181289673,53.26687502861023,0.05047208649874369,0.776602408802022,-1.0622587308964593,2.9956234890585587,52.56624984741211,0.6430957317352295,0.014751532308290072,51.56483383178711,53.72133378982544,0.8085887964503794,0.04630829190468229,1.0264718662223453,1.0151584344934843,1.0060006233193672,0.010219509199986376,73.33666646718541,54.19874648554227,52.64554166793823,51.09233685033419,53.64035701751709,0.3845159826250894,53.161904743739534,0.5916259850816299,53.48168086859188,53.04828873856491,2.6642004852296304,3.019991192128711,18190500,0.27881174513495843,0.953315299975552,104424600.0,-1.9255178492728076,97.72219427934739,97.34986547195354,135.96827822117476,35.35940204298383,14.658401540738527,0.24689195864708827,0.5940347313721336,53.850520324707034,53.47140731811523,53.165000915527344,52.858594512939455,52.47948150634765,0.08,0.0,51.85347433076364,0.01209006207486607,0.0246689525563644,53.250858306884766,52.717014857700896,0.8421042053070009
2024-01-19,0,54.234999656677246,51.48083305358887,54.039167404174805,52.31375026702881,53.54687523841858,0.03926555303584462,0.7758842621924357,-1.0967395810975802,2.9956242313869286,52.68500089645386,0.6499498128890991,0.014700717357878763,51.66866769790649,53.77108173370361,0.810570585829658,0.04566636344083779,1.0275932116531556,1.0172177681776158,1.0075954380696148,0.009774708958432354,75.3969967745198,54.3304352590803,52.778666734695435,51.226898210310566,53.836904525756836,0.2449629100874814,53.27886894771031,0.6319523541225063,53.62052998494382,53.190728995884164,2.944820717250902,3.2102507878992146,19175400,0.2782025208411554,1.0189261247474324,123600000.0,-14.93102670911177,97.72219427934739,97.34986547195354,121.54335491367712,32.864005334849615,13.2990365049169,0.19245273125992093,0.6031709945977481,53.896361373901364,53.50848816680908,53.19500160217285,52.88151503753662,52.49364183044433,0.1,0.0,51.909427944929476,0.007882823273360984,0.0067580802572809115,53.39563805716379,52.83043316432408,0.8536773132928198
2024-01-22,0,54.13583278656006,51.48083305358887,54.234999656677246,52.3602089881897,53.711875200271606,-0.009693744277765688,0.7945225448581644,-1.0377618941559372,2.99561949714882,52.80291700363159,0.6798331642150884,0.01501749634987985,51.988166427612306,53.921415424346925,0.7888758827423216,0.051592348396249856,1.0232367558745648,1.0126955140655427,1.0037949581537007,0.007787631490058233,77.91199833403294,54.49550341987075,52.90645833015442,51.31741324043809,53.92880916595459,0.2127829730166471,53.39321422576904,0.6318304105321012,53.77379316629876,53.32050124197872,2.6028267814009434,3.1132636164283247,13938300,0.2732229688413209,0.7567862523923932,109661700.0,-14.805529350443477,97.72219427934739,97.34986547195354,102.80876004588104,30.771937059408835,12.45244181621771,0.26063782012529263,0.593798825351361,53.896361373901364,53.50848816680908,53.19500160217285,52.88151503753662,52.49364183044433,0.1,0.0,51.94736003610041,0.006632756598570211,0.007944865639187709,53.447513580322266,52.94220079694475,0.7904837727326226
2024-01-23,0,54.12833309173584,51.48083305358887,54.234999656677246,52.46020817756653,53.72708344459534,-0.05788589230211837,0.7756796054472656,-1.0858026204346722,2.9956252770942435,52.84625005722046,0.6874956607818603,0.014625932117914292,52.16541690826416,54.04883394241333,0.7748394572485817,0.05157258683455015,1.0206241338511048,1.009204245716538,1.0021012821610467,0.0040810244551703345,75.59802986538635,54.58590081779762,53.034541606903076,51.48318239600853,53.988571030753,0.19941228681334772,53.49005937576294,0.633278086016343,53.86442680279862,53.424539052049546,1.202659209635094,3.047176028422999,12066600,0.2734881588595567,0.6697454777360665,97595100.0,-9.661286362285049,97.72219427934739,97.34986547195354,99.0567254832728,29.27700009707316,11.847487519500588,0.26628723606121263,0.5756371944059284,53.896361373901364,53.50848816680908,53.19500160217285,52.88151503753662,52.49364183044433,0.1,0.0,51.9801047130192,0.005993976746723417,0.00917425672403356,53.52721241542271,53.02496528625488,0.7481057172575111
2024-01-24,0,53.899166107177734,52.03416633605957,54.234999656677246,52.524582386016846,53.7939567565918,0.0417994291902575,0.7233769324214047,-1.504595552089042,2.9956397283178466,53.0254168510437,0.6644998073577881,0.013605771757347538,52.34050025939941,54.12908306121826,0.8235416353833356,0.04024599418296083,1.0137726530909255,1.0018773807371806,0.9970464248730068,0.0026663970056988173,73.88476282341551,54.61367047365324,53.166916608810425,51.72016274396761,54.01452323368618,0.16752664058696612,53.540595054626465,0.635858647096768,53.93079367459249,53.524953147547095,0.7788736795601386,2.5692019033258977,22932900,0.25702568505230317,1.2605297677988838,74662200.0,-38.51950450081774,97.72219427934739,97.34986547195354,52.74890481849573,25.83528589328763,16.653184164781518,0.18239783820038324,0.6019641314522962,53.896361373901364,53.50848816680908,53.19500160217285,52.88151503753662,52.49364183044433,0.1,0.0,52.028995849534176,-0.0035388715557574946,-0.008218493169856867,53.48854119437082,53.053260803222656,0.7108185855038216
2024-01-25,0,53.960832595825195,52.18000030517578,54.234999656677246,52.58187532424927,53.90145754814148,-0.07944111514239126,0.6908197546146366,-1.5672260447206101,2.995648122207691,53.34208345413208,0.6419997692108155,0.012970664546302734,52.36058406829834,54.12908306121826,0.8380070156054116,0.032946833881705204,1.0131555352381025,1.0010883835141071,0.9976581055902635,-0.001449593176810482,66.08729052655502,54.64180610659561,53.260166597366336,51.87852708813706,54.02202333722796,0.16309678622313267,53.621130738939556,0.6102765386302573,53.92376283450354,53.56869544344635,0.33818665837033196,1.3300946356290275,16369500,0.2677091063673994,0.8883169190470027,91031700.0,-9.159440517267374,97.72219427934739,97.34986547195354,72.3475853542226,23.21669536867929,14.96526515205697,0.23348889411013196,0.6184439014214773,53.896361373901364,53.50848816680908,53.19500160217285,52.88151503753662,52.49364183044433,0.1,0.0,52.06705950006413,-0.0024504454811629106,0.010988961320715732,53.53617204938616,53.17304529462542,0.6876774180697304
2024-01-26,0,54.52999973297119,52.358333587646484,54.234999656677246,52.72875094413757,53.921457052230835,-0.21926459623589611,0.6599334855709785,-1.566127423408337,2.9956556922477353,53.60125017166138,0.6141205930709838,0.012370070853718678,52.480082988739014,54.12908306121826,0.836677004564855,0.030606379125801806,1.0221332529694231,1.0107694330142134,1.0084733004458597,0.005439293411291235,66.37250138256255,54.66907518304077,53.349208211898805,52.02934124075684,54.13261876787458,0.20863283770794233,53.77607113974435,0.536605484110578,53.935292162036845,53.62197759927246,0.09738888771049395,2.134068619244143,15746400,0.2669606074680944,0.8642340189236427,106778100.0,-1.4284312967796016,97.72219427934739,97.34986547195354,125.15469609607362,27.812785148113047,13.900103936118002,0.22350425115247347,0.6149995124303342,54.187598052978515,53.81286486816406,53.5099983215332,53.207131774902344,52.83239859008789,0.12000000000000001,0.0,52.11274398502555,0.011639348707147334,0.0063097413773392265,53.68708201817104,53.35130746023996,0.7235558180580818
2024-01-29,0,54.859999656677246,52.3608341217041,54.52999973297119,52.81812500953674,53.9804162979126,-0.2636201610231088,0.6665910856915584,-1.3625275928162255,2.9956544410396377,53.71375036239624,0.6018997764587397,0.012469484180852856,52.530832290649414,54.145749473571776,0.7948811664570352,0.036741269118338964,1.0262301920386947,1.015343045626123,1.013470452148236,0.013376849174415506,73.23381138159318,54.790973690548164,53.45779151916504,52.12460934778192,54.249880518232075,0.3379505731020712,53.94511876787458,0.47008141089181227,54.08544186520535,53.737573713681115,1.440156332397947,4.142725469623389,18240300,0.28648912061907816,0.9971038545301881,125018400.0,-4.817699020098706,97.72219427934739,97.34986547195354,146.950977712023,29.8857687574067,12.820293259988238,0.2910632074381631,0.6161389628574873,54.53250592041016,54.15874627685547,53.856666564941406,53.554586853027345,53.18082720947265,0.14,0.0,52.16971020286458,0.016318749202119287,0.01638131085926697,53.771968841552734,53.51141357421875,0.7567961893978864
2024-01-30,0,54.976667404174805,52.3608341217041,54.859999656677246,52.85270857810974,54.06145882606506,-0.22285315913314735,0.702033332477339,-0.9987965683407642,2.995646317834148,53.736666202545166,0.602899780273438,0.01310474747946576,52.530832290649414,54.26449966430664,0.7668739790830844,0.0442562256000465,1.0262409351019566,1.0153553257267502,1.012915570013235,0.0156726480196836,77.00554616426194,54.974983126899254,53.57091646194458,52.1668497969899,54.35583305358887,0.43487157078423905,54.09636878967285,0.43298823237358913,54.27892575626831,53.87616415235441,1.5189579927521752,4.508509299659982,15270000,0.2880502860717162,0.8502527789818849,140288400.0,-3.520021679700732,97.72219427934739,97.34986547195354,150.39339393283203,28.858824127438307,11.68733555399157,0.32646090307043174,0.6247503486626264,54.77833409118652,54.47416761016846,54.22833442687988,53.98250124359131,53.67833476257324,0.16,0.0,52.21760298074039,0.017137583478642693,0.01970560570827819,53.92334965297154,53.65949385506766,0.786539944578418
2024-01-31,0,55.49666690826416,52.3608341217041,54.976667404174805,53.10854172706604,54.130208015441895,-0.20095954757281903,0.7232544243177319,-0.7564669449288037,2.995641462637233,53.82749891281128,0.584766421318055,0.013470180951587349,52.74458417892456,54.5629997253418,0.7938566803846645,0.0417673290241658,1.0335922191827238,1.0229407577303165,1.0193098976358579,0.02963869232985572,77.5423708621165,55.139508736101895,53.69299988746643,52.24649103883096,54.55023792811802,0.5948709493458472,54.239523547036306,0.5368351854542872,54.452027653583144,54.02293327417805,1.3675076098322547,4.005928245539608,26134800,0.2867691765780029,1.4447804660427002,166423200.0,-33.420776337892974,97.72219427934739,97.34986547195354,167.38007164821363,33.58112540397888,10.46409738030193,0.2081767618825104,0.6452296423762565,55.33310729980469,54.961780395507816,54.66166687011719,54.36155334472656,53.99022644042969,0.18,0.0,52.305732150353016,0.0295950183799798,0.015049117943966973,54.05822481427874,53.752869197300505,0.8208433225343905
2024-02-01,0,55.628334045410156,52.3608341217041,55.49666690826416,53.41729187965393,54.160624504089355,-0.0030323437629520404,0.7904676386139238,-0.3411234722870278,2.9956244409490993,53.903748989105225,0.6048707199096682,0.014684734650422122,52.799333000183104,54.871666431427,0.7959564749476477,0.043333861342895956,1.0334228557848288,1.0220880430780657,1.015767432025853,0.030902070434583484,80.95518894122472,55.410143460516416,53.82920818328857,52.24827290606073,54.764523778642925,0.6814307552575446,54.376547404697966,0.6283089722795518,54.71130668180208,54.21893500518544,2.5137400713302536,3.746631007439489,20792700,0.2931915098033841,1.1430244159870704,187215900.0,-0.49823778312689815,97.72219427934739,97.34986547195354,182.28814367588538,31.678008308704104,9.237152209408782,0.28642709343871675,0.6760969052127243,55.484974563598634,55.094180732727054,54.77833366394043,54.462486595153806,54.071692764282226,0.19999999999999998,0.0,52.381332895434944,0.033591320339247055,0.04866049016015699,54.31807272774832,53.92264257158552,0.9365410861143635
2024-02-02,0,56.35166645050049,52.3608341217041,55.628334045410156,53.655625104904175,54.30874967575073,0.04013421724228769,0.8668999061011736,-0.3904729942514398,2.9956031921732658,53.934582233428955,0.6480417728424073,0.0160682700668701,52.799333000183104,55.02866735458374,0.8049137675764427,0.052902228014866125,1.0444963586593694,1.032363846465661,1.0227472015986654,0.03340668854666862,84.65624986130427,55.684841367607014,53.951041555404665,52.217241743202315,55.114880970546174,0.7849643381606999,54.56470210211618,0.7895061819156552,54.93803648422862,54.40515482965926,2.771193694681376,3.5716514725390183,21670800,0.2705424081157045,1.1835263797308246,208886700.0,-9.844032511909768,97.72219427934739,97.34986547195354,213.0116155697503,36.67488661646595,8.35217704781425,0.3375818167687369,0.6918380742794085,56.05288014221191,55.553559852600095,55.14999961853027,54.74643938446045,54.247119094848635,0.2,0.0,52.4721208318691,0.03226397580958018,0.04132901450808786,54.74580819266183,54.117174693516326,1.0267136124053389
2024-02-05,0,56.395833015441895,52.3608341217041,56.35166645050049,53.715625524520874,54.612499713897705,0.30731166319565034,0.9727564685624056,-0.006178187260108103,2.995571053007815,54.0,0.7199875688552858,0.01797175567265363,52.82258367538452,55.50983362197876,0.7313011760058574,0.07621789063788321,1.041917648110991,1.0291820799787301,1.0168251217388578,0.027995504345172062,91.57755942580904,56.072471164282405,54.126958227157594,52.181445290032784,55.46273817334856,0.725602293321472,54.74238075528826,0.9022792862464124,55.29009349450877,54.67507335568835,4.550163797424976,4.903738502692196,19145100,0.25787952714192564,1.0529615730157251,228031800.0,-18.713421591843247,97.72219427934739,97.34986547195354,164.54691651364553,34.108307303912234,7.767675586367834,0.32602404905159293,0.6884722891353102,56.05288014221191,55.553559852600095,55.14999961853027,54.74643938446045,54.247119094848635,0.2,0.0,52.54616830725407,0.021934118036190497,0.026724335929434996,55.0202762058803,54.27822412763323,1.0087155871227225
2024-02-06,1,56.40750026702881,52.493332862854004,56.395833015441895,53.746248960494995,54.889166593551636,0.5191677475264336,1.003484942289246,-0.1911198593486847,2.9955622099056245,54.08375024795532,0.7938210010528565,0.018470620341554448,53.42916698455811,55.70066728591919,0.7584915394884927,0.07434277725866073,1.038263234395506,1.0251668694986535,1.0114339000407822,0.026026184023394405,91.61274837430003,56.33567805642297,54.32870817184448,52.321738287265994,55.73095253535679,0.6680810749234671,54.93178565161569,0.9559734392353285,55.56808179040645,54.91881296748523,4.512533077195493,4.614316670677436,14181300,0.2600229261411026,0.7941515928895788,242213100.0,-7.504910583324875,97.72219427934739,97.34986547195354,150.32152175596158,32.100557927033236,7.310439591647586,0.30972975400949776,0.6771965107071766,56.05288014221191,55.553559852600095,55.14999961853027,54.74643938446045,54.247119094848635,0.2,0.0,52.601330761780936,0.025484630811344333,0.02890203238595455,55.28153828212193,54.484310150146484,1.0404246705703708
2024-02-07,0,56.62583351135254,52.85916709899902,56.40750026702881,53.86333250999451,55.106667280197144,0.6624256732140391,1.0081264631676612,-0.629752431954357,2.995562018708479,54.13208293914795,0.8451335144042972,0.01848944981172096,53.68825006484985,56.35608310699463,0.7965318644639658,0.06712805673581979,1.0385408428475076,1.024889598210725,1.0101654305092662,0.020346566127203536,91.35523563390562,56.54066946838855,54.524416542053224,52.5081636157179,55.98321451459612,0.6157372595996996,55.116547516414094,1.0181288031197269,55.779502548577625,55.12769664679323,3.4430598629223894,4.932801639964465,17082600,0.26054742257197333,0.9736346467706097,259295700.0,-12.379098263132207,97.72219427934739,97.34986547195354,137.3642100480347,32.99909864885914,6.913040049679012,0.2145727674320269,0.6630843633967471,56.07325199890137,55.57003865814209,55.16333198547363,54.75662531280518,54.253411972045896,0.2,0.0,52.66786318990289,0.0249924634717007,0.022887869690059313,55.48620932442801,54.629089082990376,1.0549917594661877
2024-02-08,0,56.53666687011719,53.49250030517578,56.62583351135254,53.90604043006897,55.52958369255066,0.6992146101286614,1.031016199992705,-1.022926765513869,2.9955554815685193,54.18541622161865,0.9040502357482907,0.018844167083185502,53.716750621795654,56.396999740600585,0.8412988479680318,0.0585751869570693,1.0333362335474698,1.018250588537343,1.004527809357185,0.01632860016921489,91.5820161182072,56.77478226265631,54.7127498626709,52.650717462685485,56.20607158115932,0.4509822163290416,55.280952317374094,1.050158544305055,55.992222949772966,55.33325796562323,3.2188003385456927,4.786650556310942,14427900,0.238671138109541,0.8358919230832738,244867800.0,-12.475720042544573,97.72219427934739,97.34986547195354,118.30615609409563,31.233255177679155,6.770826903481066,0.14428312996639422,0.6488206607862742,56.07325199890137,55.57003865814209,55.16333198547363,54.75662531280518,54.253411972045896,0.2,0.0,52.72206961458817,0.006297838052827132,0.02493190551756387,55.66447121756418,54.793910435267854,1.089375686753099
2024-02-09,0,56.44333362579346,53.71000003814697,56.62583351135254,53.947707414627075,55.80916714668274,0.5317962278257785,1.0638187076912444,-1.3378451783216845,2.995544918802866,54.38249969482422,0.9499502944946286,0.01938976612338589,53.751998615264895,56.42041692733765,0.874344553513799,0.052628315582993926,1.028768370320872,1.0118753308078214,0.9996428418874751,0.0016266985710793325,87.80460710231462,56.99259560630046,54.86495819091797,52.73732077553547,56.3413096836635,0.32795391799923074,55.44577380589077,1.037613179351643,56.128741903257094,55.47525734991821,2.8375664433670638,4.24387799024641,14329800,0.24485820680268197,0.8302697516282611,230538000.0,-13.346201480205815,97.72219427934739,97.34986547195354,96.75059152787357,30.232388324222125,7.424215300143777,0.13581192592842037,0.6209046965005351,56.07325199890137,55.57003865814209,55.16333198547363,54.75662531280518,54.253411972045896,0.2,0.0,52.77272208908376,-0.0017102812113373167,0.00576313732835149,55.85452325003488,54.95637403215681,1.1002579437024458
2024-02-12,0,56.57833290100098,53.71750068664551,56.62583351135254,54.0195837020874,56.36270809173584,0.3403812466044431,1.0820810947053774,-1.5537176159220747,2.9955391619468346,54.69499969482422,0.9872835731506342,0.01967362050224953,53.88483266830444,56.45266695022583,0.8869280006260467,0.05074385264215406,1.028666571840718,1.0108282715743033,1.0017085040825746,0.003236052662066502,84.08460770557215,57.165787059711036,55.00162487030029,52.837462680889544,56.47702380589077,0.10347311889012153,55.620773792266846,1.0043989616794549,56.207624576645735,55.5839301194091,1.7058082408699147,4.262427897490968,14795100,0.24892162149463432,0.8543431317946022,245333100.0,-3.481593717038541,97.72219427934739,97.34986547195354,97.15998279091889,31.17644236535313,7.031755855943445,0.14973437316775126,0.6073586399586922,56.07325199890137,55.57003865814209,55.16333198547363,54.75662531280518,54.253411972045896,0.2,0.0,52.826335809876234,0.009723649417770375,0.004304972095573216,55.94837025233677,55.13322149004255,1.120689217534281
2024-02-13,1,56.59166717529297,53.755831718444824,56.62583351135254,54.10604166984558,56.39874982833862,0.16787766528436285,1.091920444846373,-1.6746388057456618,2.995536433732928,54.918333530426025,1.0162169265747067,0.01980101639062836,53.907415294647215,56.540833473205566,0.8923485760417773,0.049528541086298554,1.0262400842477304,1.0079720541770933,1.0012975212780935,0.003264936531353513,84.74158386768626,57.32850737071081,55.144666481018064,52.96082559132532,56.51130962371826,0.09437525493637887,55.81309529713222,0.9019423334572695,56.30144921516495,55.684653274921025,1.7077607515898705,4.5262798045395485,18574200,0.24867454285264598,1.067814149218723,263907300.0,-18.122053014575354,97.72219427934739,97.34986547195354,79.30139743976255,27.794450966079722,9.29085161849112,0.1276030571242346,0.6312759983865381,56.185533782958984,55.667233337402344,55.24833297729492,54.8294326171875,54.31113217163086,0.02,1.0,52.889231309573866,-0.003945569648593161,0.0028458876830485345,55.92809132167271,55.33694975716727,1.1097204667619813
2024-02-14,1,56.14750003814697,53.755831718444824,56.62583351135254,54.133957862854004,56.41645860671997,-0.016614583593175265,1.0966101969501278,-1.7082737711471894,2.995535466177673,55.23666715621948,1.0267502307891845,0.019837795636269057,53.954665946960446,56.57966632843018,0.8842019666753447,0.05275400577376066,1.0157142750833135,0.9971924020832178,0.9927916970011661,-0.008447265912821744,86.45587651063634,57.472053640131335,55.27883324623108,53.085612852330826,56.475833484104704,0.16515286080235586,55.96928582872663,0.7293259434570665,56.3745007728017,55.77742070958005,0.4258981852884475,4.9954410477543085,18484500,0.24102930584078788,1.051603945626879,245422800.0,-29.369812907466148,97.72219427934739,97.34986547195354,48.56953091988991,26.05511046530368,11.564581261326012,0.1717691327172175,0.6241036873145194,56.361747848510745,55.95246118927002,55.62166786193848,55.290874534606935,54.88158787536621,0.04,0.0,52.94327532581861,-0.00460500355033977,-0.00712557085036553,55.92526136125837,55.472768783569336,1.0573964038580737
2024-02-15,1,56.40916728973389,53.899166107177734,56.62583351135254,54.21020793914795,56.41645860671997,-0.1816455807788535,1.053568292880552,-1.6741182274735231,2.9955512082124476,55.56250047683716,0.9820751523971559,0.019018021747887345,54.031333923339844,56.57966632843018,0.908722163642466,0.039014898549478545,1.0182451176119456,1.0006829881908044,0.9991085143823873,-0.002255166203487202,68.55306616613292,57.505553247977296,55.398416662216185,53.291280076455074,56.476071630205425,0.16503906633895465,56.10351208278111,0.6066699727460504,56.31736100164593,55.812945601830094,-0.44033923078487935,4.052323392969577,16948800,0.272427978187856,0.9676540862728977,262371600.0,-23.576195680347535,97.72219427934739,97.34986547195354,58.428880297280045,27.929224251151737,10.71601993664402,0.14575772487898583,0.6242910611861843,56.4294012298584,56.061967933654785,55.76500129699707,55.468034660339356,55.10060136413574,0.04,0.0,52.99477637331503,-0.00047233771211696585,-0.0005313911710335937,55.90073830740793,55.591138294764924,1.0500774864263294
2024-02-16,0,56.822500228881836,53.899166107177734,56.62583351135254,54.456249713897705,56.41770887374878,-0.380230674162429,1.02696972369999,-1.5424183620858913,2.9955607641321444,55.887917041778564,0.942975196838379,0.01849832061197259,54.11158304214477,56.57966632843018,0.9024901574366557,0.04008790719682366,1.0235168602836118,1.0066210520814578,1.0068841482345765,0.006717650761065341,71.53513345539213,57.57085610389413,55.51691665649414,53.46297720909415,56.50416687556675,0.20635168756316127,56.24369069508144,0.5174010584955734,56.338778247076135,55.875020848763,0.002955321007289042,3.4461169374011007,22373400,0.2739000661886611,1.2658038783044088,284745000.0,-18.89293923064317,97.72219427934739,97.34986547195354,86.21130740798112,33.00903531608814,9.64569002091753,0.13881876649845995,0.6429517229186631,56.65628126525879,56.251861198425296,55.92500114440918,55.598141090393064,55.19372102355957,0.02,1.0,53.070149915163405,0.006380051522626218,0.005845307113666573,55.946954999651226,55.71658216203962,1.0294770224475431
2024-02-20,0,59.243332862854004,53.899166107177734,56.822500228881836,54.77749967575073,56.46666693687439,-0.5662596044435484,1.0202895563868082,-1.30392888830183,2.9955635846561983,56.24958324432373,0.9200792837142941,0.018335265935787836,54.11158304214477,56.59508380889893,0.8679105474553503,0.04962826475607074,1.0646411659936812,1.0486318937298347,1.0483721003169373,0.04710283646066715,76.97403017024108,57.686870797877994,55.64629168510437,53.60571257233075,56.89083344595773,1.0575823776756974,56.54845251355852,0.8580989054648366,56.457909267899865,55.99078115437708,0.34730917910438963,3.5772887066828947,71788500,0.2767574605882991,3.4903411941796287,356533500.0,-33.80544905018981,97.72219427934739,97.34986547195354,225.78035560756737,49.31002572038673,6.662412490800041,-0.02700281530633027,0.863026235048234,59.1724539642334,58.38210721588135,57.74333381652832,57.10456041717529,56.31421366882324,0.04,0.0,53.43031371589301,0.032648301423178205,0.03887058438683392,56.253019605364116,55.95874541146414,1.1534051889535903
2024-02-21,0,58.09000015258789,53.899166107177734,59.243332862854004,54.947500467300415,56.547083377838135,0.39150923809674054,1.2282651765031736,0.7841129327639771,2.995491511708477,56.37374973297119,0.9733333969116217,0.021971888304121757,54.11158304214477,56.64550018310547,0.6353157372943911,0.094497640680147,1.0391461219903593,1.023060993659876,1.0183575493888728,0.026476211995201115,88.80377995815148,58.35819704192541,55.901666688919065,53.44513633591272,57.12607152121408,1.1225914179783665,56.73369060243879,0.8927946865434884,57.15210792179742,56.42862330467995,4.787452360704061,7.760865945750648,40551600,0.5766767834198618,1.8439242252072456,315981900.0,-47.30982422665674,97.72219427934739,97.34986547195354,138.44638883921945,45.1251059493706,12.836625792484789,-0.08264839699694473,0.8744474844407829,59.17796090698242,58.39102099609375,57.755001068115234,57.11898114013672,56.33204122924805,0.04,0.0,53.5783285696476,0.02695992746592646,0.019964760326590225,56.461463928222656,56.157993589128765,1.1677608575837648
2024-02-22,0,58.17250061035156,53.899166107177734,59.243332862854004,55.36666703224182,56.581666469573975,0.30964620869328435,1.245633531229579,0.4989971945278504,2.9954862618781224,56.40166664123535,0.9346583843231201,0.022203905192052835,54.47308301925659,56.94925022125244,0.7135719790964586,0.07775322603464294,1.0369475900844392,1.0214871327525095,1.0144744385796605,0.03606572992259305,71.03471916920097,58.591017104420835,56.09975004196167,53.608482979502504,57.353809765407014,1.1542105698813974,56.915416785648894,0.909272321972562,57.38526867149746,56.66030693976513,2.917380000464644,4.672953149799975,29512800,0.6508643456815423,1.322198530039306,345494700.0,-43.012307580116946,97.72219427934739,97.34986547195354,151.90131280828342,42.390244210152716,12.05864652790616,0.025652492233247944,0.8632250940687994,59.363614288330076,58.69152774047851,58.14833450317383,57.60514126586914,56.93305471801758,0.04,0.0,53.6855619402453,0.04039141747576269,0.037069866105603866,56.70244761875698,56.325408935546875,1.117331525097248
2024-02-23,0,58.71750068664551,53.960832595825195,59.243332862854004,55.59541726112366,56.60020875930786,0.3442603878667523,1.2159916479647401,0.31051167220294085,2.9954996569224033,56.40833377838135,0.8593916988372812,0.021593284829321876,54.82699966430664,58.098250198364255,0.6962219053264883,0.07805046386278726,1.0426911392975327,1.028264476016526,1.0167972718112315,0.040921245744603096,71.41318700676644,58.745400063049836,56.31341676712036,53.88143347119088,57.65750026702881,1.1990557669357362,57.084404945373535,1.0106351389726451,57.58097364264724,56.88857369877822,2.817629342561244,4.573508462188656,74365800,0.6506132148677183,2.9485877144359303,419860500.0,-41.926154519298336,97.72219427934739,97.34986547195354,173.24123616148825,45.743119309346326,11.26232138043021,-0.12488220300526083,0.8571851454556907,59.363614288330076,58.69152774047851,58.14833450317383,57.60514126586914,56.93305471801758,0.04,0.0,53.961442706047244,0.03703709012780432,0.041281121033336435,57.00521033150809,56.4666508265904,1.1095009894315473
2024-02-26,0,59.18499946594238,54.52999973297119,59.243332862854004,56.01770853996277,56.67500019073486,0.5401807470547421,1.1976307110536937,-0.08166131189127501,2.9955088309031446,56.42625045776367,0.8431666755676275,0.021177793725484128,54.96500062942505,58.227000617980956,0.6910135613576132,0.07679260909921429,1.0465727863890941,1.032508102414099,1.0167642419486282,0.04157682656596173,73.64529002814024,58.94651159376876,56.55125017166138,54.155988749554,58.09142875671387,1.1076630027274366,57.28363112040928,1.132073491339746,57.8657615600731,57.17972281055172,3.7564426309756156,4.19833943726079,32154800,0.6499558986160223,1.2347645503823934,452015300.0,-18.464933506583048,97.72219427934739,97.34986547195354,170.13485408750464,44.666104156620044,9.781815486390375,-0.10342860518947508,0.9153809052145682,59.363614288330076,58.69152774047851,58.14833450317383,57.60514126586914,56.93305471801758,0.04,0.0,54.08274312001465,0.04954200627299454,0.05617577327669701,57.48623439243862,56.70574787684849,1.2193087634180013
2024-02-27,0,59.5625,54.859999656677246,59.243332862854004,56.30062484741211,57.13937520980835,0.6271622900670268,1.233979685503409,-0.4208387962545359,2.995497178241271,56.49000024795532,0.9526833057403564,0.021731115843603085,55.444666957855226,58.76425056457519,0.6958449869846689,0.07883703675413208,1.0489310339874576,1.0341474823061858,1.015010365128024,0.005387393344072233,75.60090722844531,59.251959529316764,56.78400015830994,54.31604078730311,58.54190485818045,0.9376433134244027,57.50898824419294,1.2519311697744062,58.196331835328635,57.47911831391447,5.409856940614834,4.945695987391088,18012700,0.6518985544485743,0.6920014168343587,470028000.0,-18.682130971480092,97.72219427934739,97.34986547195354,155.70350013856017,42.560890982708514,9.320776691636462,-0.1152479006536112,0.8910948851985351,59.363614288330076,58.69152774047851,58.14833450317383,57.60514126586914,56.93305471801758,0.04,0.0,54.15249409253446,0.016547210217657815,0.04936598528342432,57.933304922921316,56.91702161516462,1.294356435585586
2024-02-28,0,59.55999946594238,54.976667404174805,59.5625,56.38479137420654,58.11062526702881,0.6576896230363936,1.2916409185749573,-0.7057947412170069,2.995476924189582,56.55749988555908,1.0856082725524914,0.022652766323578953,55.61516733169556,59.19083280563355,0.7028738412424732,0.08341416117698247,1.0445617901475475,1.0287737557254208,1.0138648795277625,0.025305548450562432,77.2417563442815,59.60240701262599,57.01912517547608,54.435843338326166,58.93297617776053,0.6170706079764564,57.718571526663645,1.3355219123166273,58.538551950036116,57.775680518587365,5.590106824427455,5.593227351036056,14803300,0.6521635972632496,0.5692148412754107,455224700.0,-18.030455708622267,97.72219427934739,97.34986547195354,131.65041327092007,40.94830929613393,8.967623516255554,-0.12805908279830872,0.8591851477108761,59.363614288330076,58.69152774047851,58.14833450317383,57.60514126586914,56.93305471801758,0.04,0.0,54.20877287833727,0.029706361833192085,0.0170589552188298,58.33415821620396,57.14055660792759,1.3429978765370831
2024-02-29,0,59.035000801086426,55.49666690826416,59.5625,56.40458345413208,58.30875062942505,0.642499500188274,1.3153096027879818,-1.091780914000634,2.9954695912355733,56.58500003814697,1.179279079437255,0.02297552576547751,56.09558343887329,59.27499952316284,0.7495771781543232,0.0732175963719569,1.031209822459558,1.0145039734635233,0.9999237926356684,0.014826596444805107,76.58383643272003,59.87891098414042,57.24829177856445,54.61767257298848,58.90321445465088,0.6045031350919522,57.8970239503043,1.332357592042653,58.79592117474843,57.97325248511999,4.817632497749766,5.181673756734357,29245100,0.6508491870672327,1.1178447858041651,425979600.0,-39.97104586255817,97.72219427934739,97.34986547195354,82.17685187402853,37.45061542479914,14.172568365303686,-0.13595688156256333,0.8715308096840838,59.363614288330076,58.69152774047851,58.14833450317383,57.60514126586914,56.93305471801758,0.04,0.0,54.30316135879684,0.0023944677235343548,0.012262570938080756,58.33274350847517,57.292881556919646,1.2763463484621884
2024-03-01,0,58.652499198913574,55.628334045410156,59.5625,56.40875053405762,58.79687571525574,0.4965826576645628,1.3057361167513468,-1.4014482510888016,2.9954747023372055,56.608750343322754,1.2164166259765623,0.022738030064977464,56.33124980926514,59.27499952316284,0.7801112080989696,0.06123977670974942,1.021371985550225,1.0029539976153963,0.9905508869111537,-0.0011070206833022622,68.14038914285096,60.03668070670827,57.425208473205565,54.81373623970286,58.98357146126883,0.5080820374715466,58.054821491241455,1.2766007805189705,58.857494794380464,58.106216069385546,-0.35165486426946757,4.4189621873335945,19017700,0.6714065873593545,0.7293939506675222,406961900.0,-36.71258668010236,97.72219427934739,97.34986547195354,58.45133877203775,35.395869145552254,16.686919190999078,-0.14891639350412234,0.8555329176131021,59.363614288330076,58.69152774047851,58.14833450317383,57.60514126586914,56.93305471801758,0.04,0.0,54.35873673049553,0.004101087670902004,0.004959757105173043,58.454413822719026,57.457938875470845,1.2710614381829664
2024-03-04,0,58.89750003814697,56.14750003814697,59.5625,56.434792041778564,58.79687571525574,0.3772400061453057,1.263311960763024,-1.602539015042374,2.9954921966583106,56.72416687011719,1.2030582666397094,0.02194148285864853,56.39141635894775,59.27499952316284,0.8205336619711913,0.040829897203379886,1.0229448684422502,1.003294774056552,0.9949070127988994,-0.004857640118098638,61.41011116117279,60.10304065240678,57.57641673088074,55.04979280935469,59.08714280809675,0.3704428292129436,58.22047628675188,1.219461785603902,58.8080623359583,58.17476749656597,0.9683233686488886,3.9139530414103207,16033300,0.6696516651290539,0.6216525925390289,422995200.0,-24.98193473966137,97.72219427934739,97.34986547195354,73.97645326727498,36.97692417685839,15.309205395647366,-0.13522089352666927,0.865235605288835,59.363614288330076,58.69152774047851,58.14833450317383,57.60514126586914,56.93305471801758,0.04,0.0,54.40908557304159,-0.005033563119501094,0.013328699484714717,58.57184001377651,57.63714381626674,1.3039120309084034
2024-03-05,0,59.95750045776367,56.14750003814697,59.5625,56.513333559036255,58.931875228881836,0.17807939871853942,1.261751295358655,-1.7129432144999124,2.9954934977292487,57.45625019073486,1.2078749179840087,0.02186603478562987,56.40633354187012,59.27499952316284,0.8116758071137675,0.044359075643409504,1.0390580104744145,1.0177540149224797,1.0137974274970074,0.00663169708732303,63.371414329098435,60.22721100098038,57.70370841026306,55.18020581954574,59.264285632542204,0.4517738034508912,58.4608929497855,1.2053458823136367,58.83055539553297,58.24092262959573,1.246292354959208,4.0990375966078805,19676900,0.6699389179695617,0.762138670280682,442672100.0,-8.906587687779266,97.72219427934739,97.34986547195354,113.96222738166558,41.621428027912444,14.001412861633938,-0.11253419455534629,0.8778370877696063,59.363614288330076,58.69152774047851,58.14833450317383,57.60514126586914,56.93305471801758,0.04,0.0,54.481901730347936,0.007551611176508599,0.007382632488106976,58.786886487688335,57.896048409598215,1.3555915277403376
2024-03-06,0,60.33749961853027,56.14750003814697,59.95750045776367,56.56791639328003,59.072500467300415,0.049605012129058865,1.3148211555815965,-1.6630494128505613,2.995474341043436,58.13125038146973,1.2373624134063719,0.022715626367010033,56.40900058746338,59.56024951934815,0.7619312597677974,0.06293489649300948,1.0424262580775654,1.0229642359455675,1.0188617054280793,0.013054065808588255,70.62814979639192,60.51143409354235,57.88179178237915,55.25214947121596,59.42892851148333,0.6028195469777914,58.7601786340986,1.1025502598698123,59.11360962516969,58.43553794990787,2.1118061167753095,5.947577533005023,12698700,0.7002671049464431,0.4932707294453535,455370800.0,-1.0798977693482714,97.72219427934739,97.34986547195354,123.85393982870467,41.94617335761411,13.31812042810764,-0.11519970732608449,0.8563758714010615,59.52731958007813,58.8513399810791,58.30500030517578,57.75866062927246,57.082681030273434,0.06,0.0,54.53143032795227,0.01593429024916393,0.01644572669729775,58.92412076677595,58.20517757960728,1.4448670395105894
2024-03-07,0,60.69499969482422,56.14750003814697,60.33749961853027,56.58833360671997,59.19958281517029,-0.04031887651838934,1.372221086094701,-1.5272420793956896,2.995453027010802,58.41249990463257,1.2471332359313962,0.02362709103088905,56.4399169921875,59.602000045776364,0.7704345951729586,0.06554722247812224,1.0450548366011825,1.0251191720615889,1.0222143571717122,0.02811889338887319,72.44443363386094,60.82273392214363,58.078291749954225,55.33384957776482,59.590714182172505,0.7726815982203676,59.06630952017648,0.9886772245297839,59.41998373280481,58.6558716104228,1.9472842155740648,7.4624864464786285,16195300,0.7015789983694525,0.6301793302673864,471566100.0,-15.301706419544406,97.72219427934739,97.34986547195354,121.55452822485898,43.20501364469804,12.50243842227793,-0.12099155534235509,0.8465553684444462,59.974959838867186,59.29751992797851,58.75,58.20248007202149,57.525040161132814,0.08,0.0,54.59534141854244,0.02985833062619081,0.012411965296322314,59.03305871146066,58.48318181719099,1.4775429125359476
2024-03-08,0,60.03249931335449,56.14750003814697,60.69499969482422,56.58833360671997,59.3224995136261,-0.11085870532571884,1.441690570907759,-1.357437761945531,2.9954259936799494,58.68499994277954,1.274408164024353,0.024736569671383234,56.4399169921875,59.99550037384033,0.7706719968389955,0.07355107852856009,1.0300394077468593,1.00962831098429,1.0054347744489316,0.02352841112125148,74.62602727675383,61.16513120094333,58.28175005912781,55.39836891731229,59.658214160374236,0.7899955793452315,59.29559516906738,0.7780701156693077,59.73734764055082,58.90068395938215,1.9013636009640609,7.597758681806186,12132000,0.6991306749213667,0.47418937439795594,459434100.0,-27.377533969482432,97.72219427934739,97.34986547195354,85.79777067562392,40.84759264969131,17.189992955524705,-0.09262222408462314,0.8309701127811208,60.251079406738285,59.74445922851562,59.334999084472656,58.92553894042969,58.41891876220703,0.08,0.0,54.63803184836734,0.023145015873956565,0.02576340926060276,59.1037973676409,58.718977791922434,1.4680948758862462
2024-03-11,0,60.334999084472656,56.14750003814697,60.69499969482422,56.76479196548462,59.56062459945679,-0.29933627068048774,1.4314014013534966,-1.251736671058466,2.995431691783713,58.80750036239624,1.2397331428527836,0.024486590554015766,56.4399169921875,60.06299934387207,0.7905736892624932,0.06358883249803055,1.0321342547669772,1.012476599539356,1.005851548095751,0.024406792230478924,65.95505644149614,61.31934448399667,58.45654168128967,55.59373887858267,59.84392820085798,0.771661961912143,59.373571327754426,0.82567527496022,59.80405292616416,59.05283364189676,0.7933174137825411,5.649169029069004,14154000,0.7236301511459051,0.5534110691988657,473588100.0,-11.815553405742932,97.72219427934739,97.34986547195354,99.59498873885937,41.59905936949554,15.941049775617419,-0.06516460915499238,0.8316196469810221,60.251079406738285,59.74445922851562,59.334999084472656,58.92553894042969,58.41891876220703,0.08,0.0,54.6903513096373,0.02293431681815683,0.032335004560185766,59.39382662091936,58.863285064697266,1.4657113357182785
2024-03-12,0,61.14500045776367,56.14750003814697,60.69499969482422,57.77312517166138,59.66125011444092,-0.46651381370191886,1.4088389186610255,-1.0445726626733232,2.9954426448776874,58.9662504196167,1.1746206283569336,0.024020663197178303,56.56141633987427,60.33524913787842,0.775391551418906,0.06639761178621113,1.042520505880944,1.0240928658699895,1.0144927673822954,0.019805695549909075,67.65984050274264,61.46880279154568,58.65112495422363,55.83344711690159,60.19999980926514,0.7022048750889863,59.59178563526699,0.8631951825242723,59.93525584878948,59.247971549265046,2.2020805721108867,1.8426819843944582,16613100,0.7239399918976643,0.647259643528173,490201200.0,-4.210523145680306,97.72219427934739,97.34986547195354,134.48480886187593,45.69398975583358,14.68279657091394,-0.07000880844233752,0.8379735592492135,60.67319987487793,60.11839998626709,59.670000076293945,59.2216001663208,58.66680027770996,0.1,0.0,54.75894605403854,0.022818129811530197,0.0355818869595244,59.76874378749302,59.11157880510603,1.515097305180597
2024-03-13,0,61.21999931335449,56.14750003814697,61.14500045776367,58.151875495910645,59.97625017166138,-0.5139989883825213,1.4243729756849852,-0.7081162585330265,2.9954383839624956,59.110000133514404,1.1432331275939944,0.02419133966301059,56.57341718673706,60.37324962615967,0.7323215511699039,0.08045942997874106,1.0397514013816636,1.0226385227451256,1.0117503129099559,0.014626056770725038,72.15514524282227,61.72820428343174,58.879458332061766,56.030712380691796,60.531785420009065,0.5052840148033995,59.80946411405291,0.8620062429954487,60.23688736559062,59.5234937668844,4.24960793298347,5.259081248323395,15935200,0.7350324210024103,0.6240563151376304,506136400.0,-8.55460081830335,97.72219427934739,97.34986547195354,125.49973749628407,43.3698447355841,13.93598175531187,-0.04476642927635572,0.8194352212062043,60.76995983886719,60.27501992797852,59.875,59.47498007202148,58.98004016113281,0.1,0.0,54.82336576268554,0.01172195801755227,0.02065288708332951,60.04887063162668,59.31035532270159,1.4830669163806964
2024-03-14,0,61.084999084472656,56.14750003814697,61.21999931335449,58.53249955177307,60.10812425613403,-0.5845145337622958,1.4097843499334308,-0.35726775688700396,2.995446472244111,59.21416616439819,1.1053705406188967,0.023849830532691473,56.78116693496704,60.739999771118164,0.693146931794092,0.09034238873968085,1.0333969704821018,1.0175618210700723,1.0065831131741745,0.006425560451591705,74.0089163342196,61.930443638831704,59.11087493896484,56.29130623909798,60.69285665239607,0.47019608694395176,59.978571142469136,0.8635328435093842,60.48178081664467,59.753429226205945,3.9432900780224522,5.238727355757919,16584700,0.7185694710521117,0.6519172551291014,489551700.0,-16.224169206047705,97.72219427934739,97.34986547195354,106.28427302949389,40.182162725189286,15.361708643062068,-0.06608096223532857,0.8209123958272023,60.76995983886719,60.27501992797852,59.875,59.47498007202148,58.98004016113281,0.1,0.0,54.887137150143566,0.014377377555663928,0.010860450542908058,60.21692058018276,59.50190353393555,1.3826999087906187
2024-03-15,0,60.74250030517578,56.40916728973389,61.21999931335449,58.701250314712524,60.33562421798706,-0.5558800771056319,1.2970441157455053,-0.20106461529979391,2.995492513084554,59.40166616439819,1.0352497577667237,0.02185130194660603,57.963250160217285,61.09099922180176,0.6613016385052982,0.08289134584671916,1.0233288899331754,1.0084127894508021,0.9996544118476116,0.011826943737845541,71.69831230673032,61.95183812277214,59.35774989128113,56.763661659790124,60.75071389334543,0.44333204438959356,60.08982120241438,0.853703079880681,60.63382203685708,59.95176604229537,1.88049638177168,4.032014936162982,50904600,0.7241609710416906,1.8757907595252725,438647100.0,-26.40948580807652,97.72219427934739,97.34986547195354,83.62416564841665,37.72904239120731,15.662562113590878,-0.10855208992649154,0.8115129330129076,60.77467994689941,60.28266010284424,59.885000228881836,59.48734035491943,58.99532051086426,0.1,0.0,55.06706963563945,0.012752295547104664,0.008725391176129176,60.26172147478376,59.592921120779856,1.2337889374914017
2024-03-18,0,60.71000003814697,56.822500228881836,61.21999931335449,58.852500200271606,60.42687463760376,-0.44119563157248876,1.1386609320447236,-0.30932420011653816,2.99554907148676,59.56124973297119,0.9380248451232909,0.01911325361014572,58.1642505645752,61.09099922180176,0.6143916029791593,0.06898675807125926,1.019061596604847,1.0043883100271926,0.9967901156377109,0.006215313820578494,66.1313814492155,61.85173840614267,59.57441654205322,57.29709467796377,60.75285679953439,0.44305402440629005,60.171785490853445,0.8542660568012217,60.66295652663409,60.07760298421983,0.6712255052099108,2.6315803890978353,16801700,0.734566894100231,0.6255498604010784,421845400.0,-21.06822876871268,97.72219427934739,97.34986547195354,72.82606698084152,35.98056671533081,15.572787020887265,-0.07541864459776942,0.7898722219476603,60.77467994689941,60.28266010284424,59.885000228881836,59.48734035491943,58.99532051086426,0.1,0.0,55.12359712865352,0.0067141317821477475,0.01575653665907758,60.361785888671875,59.697422300066265,1.08175480445118
2024-03-19,0,60.8774995803833,58.09000015258789,61.21999931335449,59.00062561035156,60.69874978065491,-0.10268564878860945,0.9719014380802473,-1.2107511110279665,2.9955999791422654,59.760000228881836,0.8572082042694091,0.01626101872164332,58.60449934005737,61.09099922180176,0.8315795866892661,0.0247566621325685,1.0185499492199643,1.0041483826194921,0.9983109312047288,-0.004374860992357843,60.59890612907504,61.71259440867698,59.76879153251648,57.824988656355984,60.87357112339565,0.3088684969047008,60.26589264188494,0.8542554337444943,60.677961403503474,60.204492941007395,0.024714298374126302,1.9265478080117064,12353600,0.517501539043214,0.5171608648847329,434199000.0,-20.77154257577044,97.72219427934739,97.34986547195354,75.01454540975615,35.98888438448145,14.888035685802008,0.03837795198327677,0.7669216544930058,60.77467994689941,60.28266010284424,59.885000228881836,59.48734035491943,58.99532051086426,0.1,0.0,55.165392500848675,-0.005417542687038646,0.0068794847793645555,60.497224535260884,59.800510951450896,1.0766579240775136
2024-03-20,0,61.02750015258789,58.09000015258789,61.21999931335449,59.00062561035156,60.718125104904175,-0.2667595528651186,0.9927600361037966,-1.2354648879930366,2.995594489670488,59.99499988555908,0.87819983959198,0.016587330737200298,58.60449934005737,61.09099922180176,0.7957143444662995,0.047985873996786825,1.0196656717451498,1.0050973435444013,1.0016495230166427,-0.0031443835825821775,67.15865138261081,61.83601994060053,59.850499868392944,57.86497979618536,60.97249984741211,0.19896588826175507,60.40821402413504,0.7975036297888223,60.72653293413171,60.268543067166966,1.4075713600030553,2.2120552824959163,12007600,0.42861403322034347,0.5346180979686462,446206600.0,-9.495542915357841,97.72219427934739,97.34986547195354,87.59632681031384,36.13852190792591,14.11983734789365,0.09640056808371823,0.7506451659818715,60.77467994689941,60.28266010284424,59.885000228881836,59.48734035491943,58.99532051086426,0.1,0.0,55.20715145405903,0.0029145607161491505,0.0007914526128567958,60.61020932878767,60.002017974853516,1.0128112299827996
2024-03-21,0,61.359999656677246,58.17250061035156,61.21999931335449,59.147499799728394,60.77625012397766,-0.3606136825375017,0.9371759411348956,-1.1982543393806477,2.9956100388651676,60.183749198913574,0.8236373090744017,0.015620282440534022,58.711000537872316,61.09099922180176,0.7635638420353622,0.04907816429208636,1.022711406811936,1.0094263569024367,1.0077436597358067,0.004501932983977053,68.38231159649959,61.87172675066273,59.997374868392946,58.12302298612316,61.003214018685476,0.2419781903190597,60.60160691397531,0.6544467139901724,60.80517287849865,60.36211986222735,1.1477601369409005,3.375115312041796,14265900,0.42834675403255057,0.6574814036446092,460472500.0,-6.441693024366099,97.72219427934739,97.34986547195354,103.7033039841497,37.68342864070551,13.285869208020431,0.045796760943564684,0.7405602377611584,60.89064024353027,60.41468048858643,60.03000068664551,59.64532088470459,59.169361129760745,0.12000000000000001,0.0,55.25846898281613,0.007046945243760261,0.006189418663685729,60.64547783987863,60.20711081368582,0.9887156397760863
2024-03-22,0,61.14249897003174,58.652499198913574,61.359999656677246,59.46624946594238,60.91499972343445,-0.3533969354960012,0.8827385694618181,-1.281733969731491,2.995624418014285,60.336249351501465,0.7810748958587646,0.014673973778382744,58.87950010299683,61.15250034332276,0.7674645965884117,0.04500360095593678,1.016386343216022,1.0047490986192087,1.003265303496056,0.006585153111023256,70.21596976640258,61.922226959632866,60.15674982070923,58.391272681785594,60.99214254106794,0.2319723611089876,60.7619639805385,0.44691154242524395,60.94685135025548,60.49541768568207,0.3516218780014343,4.616172362206559,14025400,0.4205982002780549,0.7507930611034442,446447100.0,-37.980849467867564,97.72219427934739,97.34986547195354,72.57764275396349,35.18836098864272,14.353591776628019,0.17437524189480022,0.7362189837009685,61.16912031555176,60.86544060516358,60.6200008392334,60.37456107330322,60.07088136291504,0.12000000000000001,0.0,55.30564070703993,0.00313114997609909,-0.0024581738022111865,60.61680167061942,60.33283615112305,0.9114448365964726
2024-03-25,0,60.697500228881836,58.652499198913574,61.359999656677246,59.561874866485596,61.04187488555908,-0.5119918416865865,0.8423413833498717,-1.0899656517123086,2.9956343943759434,60.516249656677246,0.7341499137878416,0.01397427564044514,59.02125072479248,61.15250034332276,0.8062322925305538,0.033074250599863325,1.0069594295737814,0.995620411273856,0.9946578047408716,-0.00020589374497248514,64.54271057955147,61.962682501578286,60.27799973487854,58.5933169681788,60.936785561697825,0.2515313254955497,60.814821107046946,0.3837435844687438,60.994802354930485,60.58128656504474,-0.12659317901339479,3.811704962741569,14186600,0.4202597840976288,0.7977901708264984,432260500.0,-56.4766829137167,97.72219427934739,97.34986547195354,28.218777450981335,33.00781357365105,18.283823649312296,0.105619852880889,0.7286066795342521,61.20451977539062,60.92273973083496,60.69499969482422,60.467259658813475,60.185479614257815,0.02,1.0,55.3489816562812,-0.004765084999478364,-0.001812807664870919,60.55292020525251,60.38492039271763,0.893957325497301
2024-03-26,0,60.50749969482422,58.652499198913574,61.359999656677246,59.858750343322754,61.04187488555908,-0.7309032276495494,0.8080138696444322,-0.6868859516529766,2.9956423558006207,60.69624996185303,0.6812624979019162,0.013387992397857873,59.02125072479248,61.15250034332276,0.833161357812726,0.01905561769371393,1.0025495555963273,0.9919140324387424,0.9915848638130534,-0.006077777308684196,55.15924720623888,61.969652512314376,60.353624773025516,58.737597033736655,60.90321404593332,0.2938985976301438,60.82696396963937,0.3699184069614453,60.91801413075877,60.600761961536,-0.6343600906909395,1.2342071725278938,13738300,0.43195621310233695,0.7819781258093251,418522200.0,-59.58556186726437,97.72219427934739,97.34986547195354,12.941558315650203,31.035305346361802,18.48598407962363,0.09015604966519267,0.7193922027325688,61.20451977539062,60.92273973083496,60.69499969482422,60.467259658813475,60.185479614257815,0.04,0.0,55.38937622729203,-0.00591430650436231,-0.005751027730656417,60.52878625052316,60.39525386265346,0.8707255010278451
2024-03-27,0,60.75500011444092,58.652499198913574,61.359999656677246,60.01374959945679,61.04187488555908,-0.9179239378962081,0.7877460293349114,-0.2916415885751329,2.9956468811476187,60.69624996185303,0.6399500083923343,0.013041963920127136,59.02125072479248,61.15250034332276,0.8240465616472629,0.015908331722259934,1.005862917682805,0.9970133155734386,0.996849728009962,-0.0044652007286164475,52.04610480557415,61.976366816436546,60.40087475776672,58.8253826990969,60.90964262826102,0.2894260827114453,60.831249713897705,0.36861719164479884,60.81170950982596,60.58801925362997,-0.38688004143869337,0.2817486262585142,14363400,0.43539348037739234,0.8185833710185788,432885600.0,-48.70458435618594,97.72219427934739,97.34986547195354,29.466211686201287,31.156001426492836,17.24658659343756,0.07494445994795587,0.715853913600053,61.20451977539062,60.92273973083496,60.69499969482422,60.467259658813475,60.185479614257815,0.04,0.0,55.432505035854504,-0.008653028070963797,-0.002464231311062629,60.508911677769255,60.43534878322056,0.8477140543392284
2024-03-28,0,60.4399995803833,58.652499198913574,61.359999656677246,60.259374141693115,61.04187488555908,-1.1588315355207066,0.7667401228252549,0.2722697528904816,2.9956514604392197,60.703750133514404,0.5976875019073482,0.012681644053232492,59.02125072479248,61.15250034332276,0.7638281802656764,0.02913524671829663,0.9996588654205952,0.9926014697894141,0.9925688688332354,-0.014993482422450244,57.78104636616568,61.99410503584216,60.46062479019165,58.92714454454114,60.84714262826102,0.34029213210004394,60.86035687582834,0.3125128342025672,60.79651187428287,60.610288427629115,0.07412300488497715,0.0988556222396946,17535100,0.41542370538333123,1.0338387922284773,415350500.0,-83.24027465806265,97.72219427934739,97.34986547195354,-22.639404509445793,29.23423290242682,18.407391920856327,0.10991440773608015,0.7082727815916612,61.23755963134766,60.97621949768067,60.76499938964844,60.55377928161621,60.29243914794922,0.06,0.0,55.480794687725805,-0.020829976845308407,-0.017632652907735944,60.40953990391323,60.453382219587056,0.7133896711672306
2024-04-01,0,60.25,58.652499198913574,61.359999656677246,60.33687448501587,61.04187488555908,-1.435107033288612,0.6937985615968731,1.5092497423121332,2.9956662192705816,60.703750133514404,0.5087000846862793,0.011461895515325908,59.851500415802,61.15250034332276,0.6403841552840162,0.030476116207897867,0.9953598105030985,0.9905303680376357,0.9924475202015473,-0.014597031280471295,53.81417824250316,61.918471852350244,60.530874729156494,59.143277605962744,60.736071177891326,0.3942259976438498,60.854285512651714,0.32411467304246083,60.707776218768295,60.604861222686345,-0.7186563229692446,0.6787994364548443,13837600,0.4116345501282883,0.828492140233443,401512900.0,-95.95377379500738,97.72219427934739,97.34986547195354,-65.14763068586305,26.810955558598646,19.17857240768767,0.03601548906854807,0.7169889872903321,61.25171995544434,60.999140022277835,60.795000076293945,60.590860130310055,60.338280197143554,0.08,0.0,55.51719230463307,-0.014292781254032216,-0.023596483035666596,60.23208999633789,60.421149662562776,0.5690516055189497
2024-04-02,0,59.510000228881836,58.89750003814697,61.359999656677246,60.33687448501587,61.04187488555908,-1.3343370166574353,0.5500056555103582,2.2670738404086377,2.995690932069172,60.703750133514404,0.4128500366210943,0.009074391219455783,60.02499942779541,61.15250034332276,0.4686867357980013,0.022963622581213712,0.981839037719871,0.9791573327483232,0.9831488568295084,-0.01956423239049554,49.65660049270883,61.71076108023152,60.61074976921081,59.510738458190104,60.47178554534912,0.5094964474356086,60.7374997820173,0.47209005213232935,60.594063972008016,60.58572092660649,-1.2740160593894496,-0.14087857091644665,19510100,0.4146895499895067,1.156086250347387,382002800.0,-89.92809704155003,97.72219427934739,97.34986547195354,-223.33268790550792,23.70106049897585,26.937039995735148,-0.03449304473839942,0.7530008211597685,61.00392013549805,60.5980403137207,60.27000045776367,59.94196060180664,59.536080780029295,0.1,0.0,55.558486230634735,-0.02327884526594315,-0.028092640566946003,59.90700204031808,60.27623994009836,0.5610158352872714
2024-04-03,0,59.3125,59.510000228881836,61.359999656677246,60.33687448501587,61.04187488555908,-0.5709373064892564,0.46410082456451174,-0.1892982752297523,2.9957029443229857,60.703750133514404,0.37610002517700136,0.007653204206827464,60.02499942779541,61.15250034332276,0.4735876960518235,-0.007463623824630114,0.9780863348894049,0.9778384132898219,0.9837459066227783,-0.01974961287197985,34.93402801574513,61.569576427876584,60.64137477874756,59.71317312961854,60.21035712105887,0.5734678878127959,60.601249831063406,0.584098195005288,60.32487225519907,60.479682651259125,-3.01499256542791,-2.673972060906637,14615100,0.38231405057675083,0.879214818112363,367387700.0,-80.21584609473626,97.72219427934739,97.34986547195354,-211.48469740107342,22.41576811229696,25.476262642431518,-0.014507835977832131,0.7391857003350559,61.00392013549805,60.5980403137207,60.27000045776367,59.94196060180664,59.536080780029295,0.1,0.0,55.58813088721024,-0.017848227135908168,-0.018821208877981093,59.70258004324777,60.159690856933594,0.5943884570152366
2024-04-04,0,59.535000801086426,59.3125,61.359999656677246,60.33687448501587,61.04187488555908,-0.8901328806290878,0.5284512427080491,0.2914861282465879,2.995694163098134,60.703750133514404,0.414800052642822,0.008719004685131362,59.98024940490723,61.15250034332276,0.6027655212924331,-0.01698777087235291,0.9822778507510272,0.9840455359477773,0.9913660455462792,-0.02008064045850455,30.944571086592518,61.66602724127547,60.609124755859376,59.55222227044328,60.04428577423096,0.5771961561262474,60.49053566796439,0.6304141501555551,60.07232009242157,60.35009887786958,-2.9930065026107133,-3.1158107395443753,14436100,0.371835236026361,0.8639316998378793,381823800.0,-77.69787035512378,97.72219427934739,97.34986547195354,-146.41369855572822,24.32931607140767,24.16577136188492,-0.05418618925843297,0.7234985638199487,61.00392013549805,60.5980403137207,60.27000045776367,59.94196060180664,59.536080780029295,0.1,0.0,55.61884827155158,-0.020092250353281993,-0.016691381151664127,59.5506831577846,60.051801681518555,0.636884279860833
2024-04-05,0,59.732500076293945,59.3125,61.359999656677246,60.31374931335449,61.04187488555908,-0.7976009542528966,0.575889579510765,-0.31505822500364866,2.9956869564897515,60.703750133514404,0.46294998168945367,0.009507992228200325,59.53250074386597,61.15250034332276,0.7219201780996253,-0.019111935078182596,0.9861893090318745,0.9897516221442958,0.9987125783425842,-0.011705815833906508,33.90638523433451,61.72077897400871,60.56899981498718,59.41722065596565,59.93357154301235,0.5470789269882828,60.41839279447283,0.6566086218890823,59.9390699499949,60.2639284797384,-1.9152344386701041,-2.5374450464389517,10332300,0.3651346404965637,0.6293804693048873,392156100.0,-65.10799165706132,97.72219427934739,97.34986547195354,-94.93634804962812,25.29731237483733,22.82821114377961,0.002528164722973921,0.7110829371343612,61.00392013549805,60.5980403137207,60.27000045776367,59.94196060180664,59.536080780029295,0.1,0.0,55.64198231112503,-0.005318321579561913,-0.014328152201070822,59.45698983328683,59.992888041905,0.6487932205984493
2024-04-08,0,59.709999084472656,59.3125,61.359999656677246,60.19562482833862,61.04187488555908,-0.5890439817002746,0.6029308303243862,-0.8064627272921681,2.99568255034835,60.703750133514404,0.5032874727249144,0.009962361449293881,59.53250074386597,61.15250034332276,0.7892783576636269,-0.004997280481271096,0.9866017179723308,0.9920540822294674,1.000703875830671,-0.008962670797134309,40.174322359895065,61.72673649470944,60.52087483406067,59.3150131734119,59.78428568158831,0.41130037309295114,60.34696415492466,0.6765359520007816,59.88772020360955,60.198953439804484,-1.2808323306020966,-1.6627570873893962,11070100,0.34022640417964717,0.6765107151423669,381086000.0,-67.6259673966738,97.72219427934739,97.34986547195354,-95.76327605095558,23.704516946173136,22.101783215338674,-0.007510104092440434,0.7045660879545617,61.00392013549805,60.5980403137207,60.27000045776367,59.94196060180664,59.536080780029295,0.1,0.0,55.666209987176046,-0.0036666418636718268,-0.0064816406256479634,59.32354736328125,59.91622952052525,0.6555778922329785
2024-04-09,0,59.732500076293945,59.3125,61.359999656677246,60.120625019073486,61.04187488555908,-0.5515299014935211,0.619851604631162,-0.970637470695296,2.9956796961426453,60.703750133514404,0.5212999725341803,0.010244676764194511,59.53250074386597,61.15250034332276,0.8195346445098399,-0.010358830023763855,0.9872365434352401,0.9947955715757876,1.00289623972526,0.0037388648387892687,38.197255028316256,61.7444530318789,60.504749822616574,59.26504661335425,59.68321432386126,0.2933203816681437,60.26517847606114,0.6766754324276828,59.84541747302491,60.168199544044086,-1.7200247354124758,-1.6471766645461512,10015900,0.3318610922558598,0.619925454705254,391101900.0,-67.26617816565124,97.72219427934739,97.34986547195354,-91.17825291562744,22.086164606062184,21.815618288679595,-0.03185267816341838,0.7020933048724304,61.00392013549805,60.5980403137207,60.27000045776367,59.94196060180664,59.536080780029295,0.1,0.0,55.68756662200052,0.010649135657246678,-0.003499909436012528,59.26960318429129,59.83957154410226,0.6728416841431095
2024-04-10,0,60.09749889373779,59.3125,61.359999656677246,59.732500076293945,61.04187488555908,-0.44255266467189425,0.641627786965647,-1.2240912660525993,2.9956758989256635,60.703750133514404,0.5574499130249023,0.010609867995403147,59.53250074386597,61.15250034332276,0.8507589200321195,-0.02310083197146136,0.9937638971838721,1.002485448812821,1.008271168889015,0.013234965542470611,33.53467035626533,61.75788044613894,60.47462487220764,59.19136929827634,59.661428451538086,0.24606381636452251,60.1987498147147,0.6407788947964453,59.81862416651096,60.14201891431211,-1.1705815833906539,-1.8808254477953483,15097600,0.2667996396406247,0.9388561359804165,406199500.0,-37.41012130193754,97.72219427934739,97.34986547195354,-19.25660742577312,26.735869617786626,18.964517377581235,-0.02834206354035737,0.7498711527543526,61.00392013549805,60.5980403137207,60.27000045776367,59.94196060180664,59.536080780029295,0.02,1.0,55.723861245013765,0.020023512161407186,0.024678775234546507,59.357618059430806,59.79485402788435,0.6505672665364686
2024-04-11,0,60.44999980926514,59.3125,61.359999656677246,59.732500076293945,60.91499972343445,-0.2942636586884251,0.6273628113669192,-1.2557672672875253,2.9956783138588663,60.60249996185303,0.549799919128418,0.010382976693283459,59.53250074386597,61.150249004364014,0.8521958867618467,-0.018335518330720363,1.0004592681562403,1.0090556261693842,1.0115207955849383,0.015369093740937867,42.71963987354984,61.67697541674018,60.42224979400635,59.16752417127252,59.79571410587856,0.3732671588425492,60.13374982561384,0.5542315595180299,59.88677104917479,60.16254725030984,-0.25311386931486646,-1.5239052173607026,10987600,0.2827264185644291,0.6939479134857721,417187100.0,-54.339617752608746,97.72219427934739,97.34986547195354,-2.757727798207665,25.890378366875403,17.491054491693923,-0.08087689356331892,0.754887188009777,60.90459931945801,60.517699653625485,60.204999923706055,59.892300193786625,59.5054005279541,0.04,0.0,55.750451459285856,0.009915942910729614,0.011105491446159412,59.489640372140066,59.698321206229075,0.634928516384253
2024-04-12,0,60.202500343322754,59.3125,61.359999656677246,59.732500076293945,60.785624980926514,-0.2606201834686731,0.6002667218676989,-1.1663925986643422,2.99568281898584,60.47874975204468,0.5189999389648434,0.009940865276982052,59.53250074386597,61.09074907302856,0.8482434302231866,-0.010395339031263594,0.9969983733036949,1.0054361522632942,1.0043039938123306,0.007868417803180705,50.8751232544432,61.58428326253728,60.38374981880188,59.183216375066486,59.922857012067524,0.3303513715013846,60.0666070665632,0.4737154108644066,60.026487953839826,60.22365097851715,1.5795657482237635,-1.4830506070791387,12278100,0.2964594592864824,0.7861438001400295,404909000.0,-41.935512224620815,97.72219427934739,97.34986547195354,-8.79219783554321,24.00434552196864,17.35215104854105,-0.10190118700863132,0.7559680786656411,60.53787966918945,60.22105993652344,59.96500015258789,59.70894036865234,59.39212063598633,0.04,0.0,55.77929483707542,0.004845498852589447,0.010756287990936532,59.59043175833566,59.646505900791716,0.6172135602557768
2024-04-15,0,60.26249980926514,59.3125,61.359999656677246,59.732500076293945,60.745625257492065,-0.15144412935885182,0.5791616089653631,-1.072149997422544,2.995686185584996,60.44499969482422,0.49741244316101074,0.009598362769082894,59.53250074386597,61.039000034332275,0.8646386310934621,-0.00888998574540098,0.9987218171702194,1.0068375548261654,1.0037309421318743,0.009253068719877966,47.700063195946996,61.497948099675114,60.339624881744385,59.181301663813656,60.02678544180734,0.3011392622612168,60.035535608019146,0.44238109773690115,60.070925894636794,60.234158924815915,1.5005274492269824,-1.537389937512553,10557200,0.2919716581912377,0.7762210434486589,415466200.0,-51.61289755507583,97.72219427934739,97.34986547195354,-17.723869910565135,22.21620355944785,16.436732241515617,-0.08605819645526996,0.7584018629025063,60.53787966918945,60.22105993652344,59.96500015258789,59.70894036865234,59.39212063598633,0.04,0.0,55.80331158841116,0.002509227149047888,0.0013367534792086439,59.65147454398019,59.601078850882395,0.6166922317270254
2024-04-16,0,59.984999656677246,59.3125,61.359999656677246,59.732500076293945,60.72125005722046,-0.04893978659927988,0.5718689986431832,-1.0030010670632385,2.9956873179736583,60.35124969482422,0.4811249256134033,0.009481274545351895,59.53250074386597,61.039000034332275,0.8627095507639967,-0.00737111231429172,0.9945184154013864,1.002180282929547,0.9972734354638952,0.00422717247831228,49.11373974707625,61.45936285423522,60.31562485694885,59.17188685966248,60.06285681043352,0.27390488059817353,59.99821417672293,0.4210259262181557,60.120571470350015,60.250196258093204,1.2219685872002797,-0.7166694146816147,14726300,0.2926334833476928,1.0910799033414476,400739900.0,-55.76037352422071,97.72219427934739,97.34986547195354,-43.01230163953256,21.122291904102866,16.882524065969942,-0.18091604649799087,0.7406395937271412,60.53787966918945,60.22105993652344,59.96500015258789,59.70894036865234,59.39212063598633,0.04,0.0,55.83479155435496,0.0008362048984502657,0.00100369085961916,59.65005547659738,59.55352265494211,0.608253034910948
2024-04-17,0,59.95000076293945,59.3125,61.359999656677246,59.732500076293945,60.711875200271606,0.11522234897022572,0.5686907329136008,-0.9588512237701123,2.9956877857912665,60.25624990463257,0.474312424659729,0.009434250677667531,59.53250074386597,61.039000034332275,0.8352742366543796,-0.014660587735335422,0.9945358744044412,1.0008013239627076,0.9958554649000847,-0.002454313965031041,42.9435934535724,61.41675630370257,60.279374837875366,59.14199337204816,60.09714276450021,0.23457142759184632,59.94071422304426,0.3603127860666512,60.08771153183484,60.22459313383095,0.4227172478312361,-0.8635293819481142,15329700,0.2942089126532591,1.1234006067801081,385410200.0,-61.69148752441124,97.72219427934739,97.34986547195354,-49.63561871450868,19.388605932450602,17.501064073076165,-0.23140432993805685,0.7491740502539707,60.4156397857666,60.122180030822754,59.885000228881836,59.64782042694092,59.35436067199707,0.04,0.0,55.86638374078823,-0.01600123764029915,-0.0023415534894411795,59.63160106113979,59.47757421221052,0.601597067979464
2024-04-18,0,59.5625,59.3125,61.359999656677246,59.732500076293945,60.55499982833862,0.3016792020633911,0.5556934570812351,-0.7631527339196009,2.995689754633906,60.22625017166138,0.45624990463256837,0.009225731044966316,59.53250074386597,61.039000034332275,0.8075920072672003,-0.017655964720074576,0.9888682300707301,0.9932753291370958,0.989903605193225,-0.014681551895209588,41.42168265221426,61.34438681116565,60.232999897003175,59.1216129828407,60.07285703931536,0.28251623796716646,59.87803568158831,0.3426692379263903,60.054588369080534,60.18804135713335,0.40194554035625224,-1.3249927577732383,12061500,0.29056768714295583,0.8837238098413048,373348700.0,-81.09464822198899,97.72219427934739,97.34986547195354,-98.79121992173052,18.05266409181873,19.644651110404272,-0.3097368577866319,0.7470880365451484,60.4156397857666,60.122180030822754,59.885000228881836,59.64782042694092,59.35436067199707,0.02,1.0,55.88839426437642,-0.013812634005477942,-0.022434826782601933,59.556361607142854,59.41298239571707,0.5772510166425666
2024-04-19,0,59.40499973297119,59.3125,61.359999656677246,59.72687482833862,60.46437478065491,0.48026233206486035,0.5425372129292536,-0.5018066031811372,2.995691666245003,60.14999961853027,0.44699993133544924,0.009018275739625105,59.53250074386597,60.79375,0.7025466671380722,-0.029294323121490447,0.9874542338059836,0.9906033981231216,0.9902071028820433,-0.01324696824556415,33.09732804136506,61.244824315232286,60.15974988937378,59.07467546351527,59.97392858777727,0.3776706764878171,59.81767851965768,0.3465092320490495,59.932474141808115,60.085960471523656,-0.28460231210281,-1.4518523932420846,14160200,0.2842178171191984,1.0378935748991622,359188500.0,-67.6617784095546,97.72219427934739,97.34986547195354,-102.0334146114672,16.837934315780224,20.725957042908387,-0.2950048001749896,0.7437214385737307,60.4156397857666,60.122180030822754,59.885000228881836,59.64782042694092,59.35436067199707,0.04,0.0,55.91330149232026,-0.010142980127474832,-0.009319325958435033,59.40162604195731,59.37962205069406,0.4889981565257244
2024-04-22,0,59.785000801086426,59.3125,61.14249897003174,59.67312431335449,60.44249963760376,0.3411467881532618,0.4911659397725996,-0.7527781284810997,2.9956988668446907,60.04124927520752,0.41849985122680666,0.00817764877370162,59.49950017929077,60.70325021743774,0.659940143892506,-0.028417210063856915,0.9953881140722145,0.9974848230602162,0.9991977806345946,-0.007923650855673592,31.674588438388074,61.04433177273368,60.06199989318848,59.07966801364328,59.87892872946603,0.31667173549631117,59.83732141767229,0.33534052923516544,59.80160885886052,59.953426062563544,-1.1522928133682457,-1.4024900697573586,14910000,0.28316617788732085,1.089319843593835,374098500.0,-38.46152341342891,97.72219427934739,97.34986547195354,-20.85364633186139,21.38431729483306,18.16810382416609,-0.21219021772066227,0.7877772115942796,60.42979920959473,60.14509909820556,59.91499900817871,59.68489891815186,59.400198806762695,0.04,0.0,55.942641476175666,0.0035040613072370164,0.0,59.40872410365513,59.4491822378976,0.44404582098025513
2024-04-23,0,59.5625,59.3125,60.75500011444092,59.67312431335449,60.30687475204468,0.17604186640475875,0.42673116747466106,-1.1426959194306854,2.995706987167574,59.96750020980835,0.3715373611450197,0.007112882596140789,59.49950017929077,60.52649974822998,0.7024682958224205,-0.015033558620280928,0.9928055457955093,0.9936481590733136,0.9970705136609984,-0.007043421840383646,43.32703978786438,60.84758731969053,59.99412498474121,59.14066264979189,59.78750010899135,0.2996108952785873,59.85517856052944,0.3110178726709504,59.7981313835126,59.8986330005595,-1.100081075726963,0.46210816862192605,17963900,0.2888198526789692,1.2945737355873916,356134600.0,-77.25325190939677,97.72219427934739,97.34986547195354,-105.39105295329193,18.20053672264982,19.455585766096185,-0.21866037315814116,0.8594184529616969,60.34011985778809,59.999940147399904,59.72500038146973,59.45006061553955,59.109880905151364,0.06,0.0,55.972741346511995,-0.012533427627158367,-0.014016373338823268,59.259666442871094,59.425049100603374,0.45550388872460923
2024-04-24,0,59.42500019073486,59.3125,60.75500011444092,59.5625,60.253124952316284,0.30674319337632205,0.40429827499573995,-1.034358578623535,2.9957095390665294,59.86750078201294,0.35262489318847656,0.006745345040149992,59.49950017929077,60.45574979782104,0.6776332893280189,-0.015617893642778526,0.9914514977876404,0.9916355555311539,0.9961778943611704,-0.008757307181372687,40.30039903839743,60.745971523288596,59.93737497329712,59.12877842330564,59.66785730634417,0.23950671713500588,59.847321374075754,0.32095924249536145,59.73928929140199,59.82958063768994,-1.0630793400157148,0.4214963119072708,18529100,0.28975037487229605,1.312645470391606,337605500.0,-43.776880950236986,97.72219427934739,97.34986547195354,-56.2675566041169,16.394287807839866,17.524783877530396,-0.16421544660348142,0.8859071071400386,60.34011985778809,59.999940147399904,59.72500038146973,59.45006061553955,59.109880905151364,0.06,0.0,56.00541106792876,0.003688091508534219,0.0005012780859106216,59.25114822387695,59.45131138392857,0.429495651991277
2024-04-25,0,60.15499973297119,59.3125,60.75500011444092,59.555625200271606,60.214375257492065,0.4803488035527751,0.39673904296037593,-0.8042337078592499,2.995710349787505,59.758750438690186,0.3443248987197876,0.006625208935270088,59.42300014495849,60.440999603271486,0.591850064926363,-0.02189120107317596,1.004537992425047,1.0049449476569594,1.010193450435532,0.009947529619663165,36.512002250498696,60.676728084013405,59.88324999809265,59.0897719121719,59.69214303152902,0.28189262247284774,59.87749992098127,0.3290925139815688,59.659938542799324,59.762676817839406,-1.3897525346293567,-0.18476628684206745,19263000,0.28160268305626557,1.3413574777215098,356868500.0,-29.18458730015799,97.72219427934739,97.34986547195354,73.86819643964431,19.467817013330414,16.519985454660507,-0.15641220822719148,0.872619156923786,60.34011985778809,59.999940147399904,59.72500038146973,59.45006061553955,59.109880905151364,0.02,1.0,56.04451464128808,0.016031091402413544,0.009388068211802048,59.3036733354841,59.47686440604074,0.3873265849477329
2024-04-26,0,60.16499996185303,59.3125,60.44999980926514,59.555625200271606,60.16687488555908,0.20836358927409232,0.34956665990533553,-1.245061660399518,2.995715225191786,59.758750438690186,0.3113248777389529,0.0058403956347879505,59.42300014495849,60.280249786376956,0.4949126450612447,-0.004715417759609156,1.0052085723489224,1.005607599232463,1.00835476975414,0.012793539808064525,53.4806005757256,60.55238329882984,59.85324997901917,59.1541166592085,59.72285720280239,0.3233368337394581,59.909999983651296,0.33371298839474756,59.78148508419945,59.79334485042908,0.2834043131898588,0.7073195599340462,11045200,0.3268027201531458,0.7869008494385641,367913700.0,-31.33047912965889,97.72219427934739,97.34986547195354,76.6018243672488,18.82036616139727,15.970572099828829,-0.10667445655851675,0.8381254584635648,60.34011985778809,59.999940147399904,59.72500038146973,59.45006061553955,59.109880905151364,0.02,0.0,56.06657278157607,0.010582883010691768,0.015187342930796755,59.376072474888396,59.50383676801409,0.3868395266971957
2024-04-29,0,60.1875,59.3125,60.44999980926514,59.555625200271606,60.15749979019165,0.13332196929032777,0.33113960137182336,-1.2623987200398847,2.995716965733295,59.758750438690186,0.2961998987197873,0.0055337962613721415,59.42300014495849,60.25124998092652,0.48201897068805644,-0.001410789014887513,1.005815556646002,1.0060467262802057,1.0061686578871714,0.006732444484742084,54.59258516520291,60.501779200836296,59.83949999809265,59.177220795349,59.8121429170881,0.3562899505983774,59.94249997820173,0.33723413562781684,59.87527019575699,59.83770790290112,0.3586308526729574,0.7620178937478702,9785100,0.32420714918295396,0.7073376221337667,377698800.0,-27.896921225615795,97.72219427934739,97.34986547195354,78.98548411061347,18.073461952943298,15.865921974320461,-0.05486959318639689,0.8103866907077732,60.34011985778809,59.999940147399904,59.72500038146973,59.45006061553955,59.109880905151364,0.02,0.0,56.085950239855045,0.001662868387008798,0.01192682203335182,59.515193939208984,59.53577777317592,0.39677254266503204
2024-04-30,0,59.7524995803833,59.3125,60.44999980926514,59.555625200271606,60.15749979019165,0.12794299713270416,0.32752611721780167,-1.239756498784768,2.9957172962464496,59.758750438690186,0.2927623987197876,0.00547369584518183,59.42300014495849,60.20850028991699,0.608432283016245,0.011384637346873254,0.9985982536924735,0.9989008287028157,0.9975542096398188,0.003189919502762706,59.32187638864628,60.49142723252825,59.83637499809265,59.18132276365705,59.86178575243269,0.3115006824276706,59.91785717010498,0.33764147399567657,59.950349507120805,59.88549704045318,1.0493179433368311,0.7617292481059748,14209200,0.2739788584472388,1.0472073145026848,363489600.0,-66.09451616336086,97.72219427934739,97.34986547195354,-52.90484229073273,16.307797403650014,21.000223689233625,-0.05195488259946466,0.8339427367933421,60.34011985778809,59.999940147399904,59.72500038146973,59.45006061553955,59.109880905151364,0.02,0.0,56.10979038156661,0.004400049607669931,-0.013136028327806503,59.48964091709682,59.44563347952707,0.3824849891904727
2024-05-01,0,59.072500228881836,59.3125,60.44999980926514,59.5625,60.15749979019165,0.0761576807067224,0.3196123783694834,-1.1331608511431293,2.995718015652259,59.76875019073486,0.28184992790222196,0.005340357378260608,59.42300014495849,60.20850028991699,0.5357134938298999,0.007418328014892321,0.9870339317237518,0.9879170524878292,0.9855765275898487,-0.005931846204823232,50.24650632483913,60.48772472240669,59.84849996566773,59.209275208928766,59.75999995640346,0.4333492282863077,59.819464342934744,0.3698169439089297,59.89939371069478,59.87793408160955,0.5849673410893708,-0.5740660089107991,15464300,0.2893196793582545,1.1361519110844662,348025300.0,-86.57420734647167,97.72219427934739,97.34986547195354,-178.23128917217488,15.3315049620256,23.56058782150042,-0.1274612104488546,0.8236560343641225,60.210241256713864,59.8948812789917,59.64000129699707,59.38512131500244,59.069761337280276,0.02,0.0,56.13090506088997,-0.01703690338425934,-0.0040616442214048264,59.30651256016323,59.35761833190918,0.4320042433947505
2024-05-02,0,59.27999973297119,59.072500228881836,60.44999980926514,59.5625,60.15749979019165,-0.2211913341798589,0.34315019174765765,-0.6233454775773284,2.9957158224368343,59.76875019073486,0.2926499176025388,0.0057347971869831415,59.42300014495849,60.20850028991699,0.42928999937858525,-0.007768549021270021,0.9906996524804511,0.9928442477294933,0.990203199304814,-0.014545756859515202,37.84153145591837,60.52280036060713,59.836499977111814,59.1501995936165,59.71964277539934,0.4666801883594924,59.753571442195344,0.3784033951189215,59.69327487582143,59.7936374270937,-1.1917714521325926,-2.2787420756487284,17574100,0.32462410445584244,1.276443526374889,365599400.0,-46.26177387038582,97.72219427934739,97.34986547195354,-88.79545821401337,17.65542482652302,20.99120438499344,-0.06964328673851833,0.8584103390009115,60.19496090698242,59.88252099609375,59.630001068115234,59.377481140136716,59.065041229248045,0.02,1.0,56.15782926530197,-0.008304293056001999,-0.00267242148739982,59.394527435302734,59.327096939086914,0.4270557517794577
2024-05-03,1,59.63999938964844,59.072500228881836,60.44999980926514,59.5625,60.15749979019165,-0.24449661007462584,0.3585094540787366,-0.7822879120048398,2.995714307950919,59.76875019073486,0.30412496566772446,0.005992761311952995,59.39249973297119,60.20850028991699,0.5484415980918861,-0.007575446243582526,0.9969284684712685,0.9993464936319416,0.9991372220290157,-0.008726013006523092,41.23075625388407,60.540768831863524,59.82374992370605,59.10673101554858,59.75035694667271,0.4508635571915543,59.70910712650844,0.349468844856152,59.59040789935197,59.746128133912045,-0.47429215870524005,-1.5323293967704448,14207400,0.3249912586373373,1.0175926771488581,379806800.0,-36.040610119998526,97.72219427934739,97.34986547195354,-33.264944270127394,17.169315951366315,19.521123692193868,-0.04861652037378352,0.8570947764993486,60.06507939147949,59.77745977020264,59.545000076293945,59.31254038238525,59.0249207611084,0.02,0.0,56.18095183915036,-0.00565159215960831,-0.0064773345571288105,59.387429918561665,59.31928907121931,0.42694348802359683
2024-05-06,1,59.8149995803833,59.072500228881836,60.44999980926514,59.5625,60.15749979019165,-0.20827647330030466,0.3602492525001896,-0.8333259440581235,2.995714131631387,59.76875019073486,0.30828749656677273,0.006022308971694501,59.39249973297119,60.20850028991699,0.5780090178039395,-0.001172327849564846,0.9999310369551859,1.0018843368134023,1.0038347577861686,-0.0061889997028734545,48.20649633277761,60.53962339437416,59.81912488937378,59.098626384373404,59.70178549630301,0.4170524084318974,59.696964263916016,0.3420191618387864,59.60391090793642,59.72738193650999,0.3617992397534656,-1.0329814089806346,11119400,0.3361061292602145,0.7962767755352242,390926200.0,-33.50257443994555,97.72219427934739,97.34986547195354,-11.442362806206862,16.44804004031999,18.507476965877338,-0.03215704475251929,0.8394383489446497,60.06507939147949,59.77745977020264,59.545000076293945,59.31254038238525,59.0249207611084,0.02,0.0,56.19938641361258,-0.006142226972447817,-0.004820530091765868,59.33916309901646,59.321418217250276,0.42715431102051654
2024-05-07,1,60.40999889373779,59.072500228881836,60.44999980926514,59.5625,60.15749979019165,-0.25221161932554376,0.35938473814359323,-0.7993704338961543,2.9957142201971823,59.80000019073486,0.30356247425079347,0.006007329598666204,59.39249973297119,60.20850028991699,0.5770112690509263,0.0013811493572842613,1.0097890530475024,1.011799567139469,1.0150893802220387,0.011003712279349598,51.1172420841814,60.5431443904565,59.82437491416931,59.105605437882126,59.73678534371512,0.46940031214524114,59.72982127325876,0.38729626330890266,59.6581679042401,59.73659242206206,-0.5652068059133166,-0.2834043131898588,14520200,0.33844829486428085,1.023309210959829,405446400.0,-8.03573557310772,97.72219427934739,97.34986547195354,122.67670647691656,21.913547711359126,17.05357615537339,-0.021370485427447187,0.8459093893373141,60.27135974121094,59.94432005310058,59.68000030517578,59.41568055725098,59.088640869140626,0.02,1.0,56.22810540709871,0.021398453220495384,0.006307976483324299,59.40446417672293,59.390268325805664,0.46359602630073793
2024-05-08,1,60.5,59.072500228881836,60.44999980926514,59.5625,60.17062497138977,-0.2973596628912569,0.38044132447986584,-0.9087541413835045,2.9957120630574847,59.88250017166138,0.3282499313354492,0.00635570410764062,59.39249973297119,60.2772497177124,0.5234028357168847,0.005199883618327464,1.0107211645264038,1.0118706691150916,1.0143603316559298,0.024165216735150707,58.5941267070975,60.619132504001236,59.85824985504151,59.09736720608178,59.78142820085798,0.5303178191068052,59.79678555897304,0.4343322892433803,59.84872410155733,59.82447306087967,0.40721172116696513,0.7673029607077279,11015700,0.3548473489839055,0.7876593809526533,416462100.0,-24.017464339198646,97.72219427934739,97.34986547195354,111.49979818388015,21.15594154749163,16.129216300858666,-0.09400830609271299,0.8304819374931841,60.30955915832519,59.975219581604,59.704999923706055,59.43478026580811,59.100440689086916,0.04,0.0,56.2494693909198,0.024638980380047082,0.016006781147581806,59.41298130580357,59.46408762250628,0.44085009538416764
2024-05-09,1,60.292500495910645,59.072500228881836,60.5,59.5625,60.19125008583069,-0.2090106053136119,0.4025676847717617,-0.9885201130196437,2.99570966265743,59.88250017166138,0.3483749866485596,0.006723089685958506,59.39249973297119,60.413998985290526,0.5380478873565355,0.0008271330172477483,1.006916112639597,1.0065904109543065,1.0060655271984833,0.017079972461206072,58.64494327172022,60.68351027989814,59.878374910354616,59.073239540811095,59.85857118879046,0.5636373948368665,59.86017847061157,0.4375064742408908,60.01315942241421,59.91483595389402,0.5192107995846313,1.5739769150052465,14550500,0.34650645219923804,1.0273233920558507,401911600.0,-17.903946134407448,97.72219427934739,97.34986547195354,87.16009679442216,19.989114521142312,17.603358540954318,-0.027393356971794534,0.8161574296019044,60.30955915832519,59.975219581604,59.704999923706055,59.43478026580811,59.100440689086916,0.04,0.0,56.2764762067839,0.01572948786022943,0.0305727997716412,59.59741646902902,59.54352869306292,0.47402331159627303
2024-05-10,1,60.40750026702881,59.072500228881836,60.5,59.5625,60.19125008583069,-0.26050551549923007,0.3927288816933529,-0.9651464507542631,2.995710746550802,59.88250017166138,0.340500020980835,0.006559639255663255,59.39249973297119,60.30425033569336,0.5864278610522626,0.0014949570545182982,1.0089693642584918,1.0082788860639513,1.0045899503022304,0.012868894789317853,55.773422097237436,60.6559577080736,59.87049994468689,59.08504218130018,60.049285479954314,0.47168751486831784,59.904642718178884,0.46031639549578196,60.081859855899935,59.97125997263002,0.9037294160404055,1.4939832790654304,12356600,0.345098996335995,0.8721835929311103,414268200.0,-16.157179052787814,97.72219427934739,97.34986547195354,99.63242059363303,19.227742087559015,16.93285800840748,0.01740437125124735,0.7878524547114332,60.30955915832519,59.975219581604,59.704999923706055,59.43478026580811,59.100440689086916,0.04,0.0,56.29959791447476,0.014532683939568747,0.016401714022415297,59.85852977207729,59.58252116612026,0.5054732529270548
2024-05-13,1,60.66749954223633,59.072500228881836,60.5,59.5625,60.206249952316284,-0.2260479611810189,0.403779848642005,-1.0262807827670077,2.9957095271924827,59.88250017166138,0.3507500171661377,0.006743065994342217,59.39249973297119,60.40775012969971,0.5865963031360742,0.0024061474087966493,1.0131386063491354,1.012208902492708,1.0063448568597888,0.01425227731895884,57.31016669402548,60.6883096381562,59.88074994087219,59.073190243588186,60.24749973842076,0.3764528502065607,59.983571256910054,0.49085939446505256,60.16297723502393,60.0319829957653,2.2599348816697993,1.0412301707806795,19260500,0.34578041183103136,1.318977893997608,433528700.0,-33.93500959872641,97.72219427934739,97.34986547195354,136.17055549534848,24.238598307533426,15.344347061031296,0.0001865764034747481,0.8072965941229089,60.69627926635742,60.29185975646973,59.96500015258789,59.638140548706055,59.23372103881836,0.06,0.0,56.33751975612539,0.012512208283576909,0.013358451394036968,59.98758588518415,59.69105666024344,0.5309340291061638
2024-05-14,1,60.09249973297119,59.072500228881836,60.66749954223633,59.5625,60.21375012397766,-0.057698527705718546,0.4316134878239134,-0.9692228953736062,2.995706310265782,59.88250017166138,0.3710000038146973,0.007205447126861969,59.39249973297119,60.41899900436401,0.6164592642185697,0.011377842618410508,1.0031969383763568,1.0018129903893636,0.9939955817456884,-0.0052557385628344555,62.52738035657258,60.76422690316858,59.90099992752075,59.037772951872924,60.31214264460972,0.28166702601322874,60.031249795641216,0.4641200657738591,60.28841842774282,60.10429352100286,2.3405867333251984,1.8551933552761017,18780100,0.34327383078020124,1.268472710927213,414748600.0,-53.790601786437286,97.72219427934739,97.34986547195354,10.526407294920581,21.919623301281103,21.202622714983686,0.02278794467687413,0.8289236837643248,60.69627926635742,60.29185975646973,59.96500015258789,59.638140548706055,59.23372103881836,0.06,0.0,56.3677354828654,-0.009119048217627657,0.0032938641577105058,60.02267837524414,59.7050541469029,0.5314794810327278
2024-05-15,1,59.76750087738037,59.072500228881836,60.66749954223633,59.5625,60.21375012397766,-0.0902953003439471,0.43329219154627635,-0.995117577906591,2.9957061105394684,59.88250017166138,0.3763750076293945,0.007232822751216625,59.39249973297119,60.41899900436401,0.6498703763513776,0.0023769636066431855,0.9976818150970701,0.9958304183364538,0.9896592407906656,-0.012107423514373994,51.57676404621027,60.772959314428,59.90637493133545,59.0397905482429,60.305357115609304,0.29585441400977125,60.00357130595616,0.46771298913874343,60.23712242362406,60.09159248127887,0.7587195639731902,1.1232638453409716,22240600,0.36933430647248294,1.467945980517239,392508000.0,-54.87359152117091,97.72219427934739,97.34986547195354,-22.92607544327184,21.003331743475847,20.316303459856062,0.10248808823155475,0.8032801754052371,60.69627926635742,60.29185975646973,59.96500015258789,59.638140548706055,59.23372103881836,0.06,0.0,56.40087719240483,-0.004359948696150195,-0.009615649487906061,60.046399797712056,59.69278144836426,0.5276473920603675
2024-05-16,0,63.89750003814697,59.072500228881836,60.66749954223633,59.5625,60.21375012397766,-0.02836146219336164,0.434198108262048,-1.0163135039355644,2.995705996939829,59.80000019073486,0.3802249193191528,0.007249049141960963,59.39249973297119,60.41899900436401,0.6449894317332527,0.00344177758456027,1.066785204751355,1.0634119583830872,1.0606186328263838,0.05979183998979831,47.90478014421081,60.7656461535816,59.897249937057495,59.02885372053339,60.80357156481062,1.395241700578015,60.27017845426287,1.1430502809372438,60.11763827500505,60.022016795647026,-0.0794093510593406,-0.6441673299159383,60545600,0.366065356343405,3.44497749222121,453053600.0,-7.0204844146003715,97.72219427934739,97.34986547195354,421.99806422756177,44.395838772007586,14.112022857236518,0.1956678799280503,1.07381786736963,63.04175903320313,62.189119567871096,61.5,60.810880432128904,59.95824096679687,0.08,0.0,56.59304487342016,0.059066900015507295,0.06520009602760583,60.55909729003906,59.981780733381,1.0677406355680892
2024-05-17,0,64.34999942779541,59.072500228881836,63.89750003814697,59.62062454223633,60.321250438690186,2.850329330925558,0.9674939800519817,8.834359042724655,2.9956046766129525,59.953749656677246,0.5656499481201174,0.016094320475002512,59.39249973297119,60.516749954223634,0.08129575524905179,0.07562495287214582,1.0704661059508846,1.062775595855829,1.0554976803845015,0.06526506051962011,78.49375916668956,62.048987899068806,60.113999938964845,58.179011978860885,61.35357148306711,1.9169286171724926,60.567499841962544,1.5783592899167476,61.061965239676084,60.52360881336908,5.773052819523723,6.203773088440949,29330400,0.9872378187621575,1.5998215293332523,482384000.0,-3.650728486605559,97.72219427934739,97.34986547195354,331.3100197138087,43.77145874709512,12.952004752457375,0.21495640129637822,1.0864045371549602,63.39319833374024,62.4733990020752,61.72999954223633,60.98660008239746,60.06680075073242,0.1,0.0,56.69001207847741,0.06894844752547935,0.06965589485377192,61.20838982718332,60.31068556649344,1.4752438863695758
2024-05-20,0,64.30749988555908,59.072500228881836,64.34999942779541,59.724374532699585,60.408124923706055,2.203837189023169,1.321727114553524,3.808258416731121,2.995496265997914,60.12374973297119,0.8064998626708985,0.021896947399600384,59.4105001449585,60.990499591827394,0.4864956910440654,0.07635692172853543,1.0653772075104626,1.0538757785343427,1.04133268504585,0.059999181947306246,79.60684420796177,63.004704152813105,60.361249923706055,57.717795694599005,61.927142824445454,2.1348155549414,60.89285700661795,1.844476318014152,61.88550740527605,61.03264907348537,6.363635417843653,6.915886899763922,15001400,0.9879251485074263,0.8180448208553606,467382600.0,-11.111070743914949,97.72219427934739,97.34986547195354,227.30159739214014,41.17615129800032,12.184051493029058,0.17738520537996633,1.0723732782967221,63.39319833374024,62.4733990020752,61.72999954223633,60.98660008239746,60.06680075073242,0.1,0.0,56.737942693487945,0.06240689380377873,0.0611772510618046,61.741156986781526,60.66928672790527,1.710884675240582
2024-05-21,0,64.82999992370605,59.072500228881836,64.34999942779541,59.724374532699585,60.432499170303345,1.6847797219432266,1.5677599803313644,1.3484353734642607,2.995402197402408,60.15999984741211,1.087299938201906,0.025876017627270664,59.4105001449585,63.938500022888185,0.6492623113987036,0.07966421633677367,1.070024902949242,1.0546736785013286,1.0375622158286577,0.0788367968013739,79.75432530008948,63.72289483859243,60.58737487792969,57.45185491726695,62.55892848968506,2.2608191240683246,61.30410698481968,2.0389822398522828,62.49327518945941,61.45721381259852,6.659201984699168,7.623112567948847,17131700,0.9842984379450177,0.936337295018912,484514300.0,-0.6051575163956943,97.72219427934739,97.34986547195354,194.59408795001096,41.270612320795934,11.360818407217057,0.2395645196761459,1.0679174323178546,63.63004229736328,62.664982208251956,61.88500213623047,61.10502206420898,60.139961975097656,0.12000000000000001,0.0,56.796675566264376,0.08837291759320864,0.07846390512939308,62.406404222760884,61.13246699741909,1.958828066411054
2024-05-22,0,65.16250228881836,59.072500228881836,64.82999992370605,59.7637505531311,60.54187488555908,1.3380710564221352,1.7988829604771037,0.13769863213482125,2.9953008795560474,60.176249980926514,1.398199977874755,0.02956221516084097,59.4105001449585,64.31174983978272,0.7086329299541387,0.09095498049007834,1.0708578353368414,1.052514725009481,1.027305511661858,0.0902664714475252,81.80466259773083,64.4485157950692,60.85074987411499,57.25298395316078,63.20107173919678,2.2723877333673443,61.72428573880877,2.1902815594963854,63.07934846982614,61.897263121816074,7.32111018851595,9.746497393061503,14879400,0.9816620203992216,0.8214300304405097,499393700.0,-6.717591395444729,97.72219427934739,97.34986547195354,161.00052934067378,41.97006443653735,10.62591440302083,0.20839260601619308,1.060207750771863,64.14420172119141,63.187901275634765,62.415000915527344,61.64210055541992,60.68580010986328,0.14,0.0,56.848822974504856,0.09058993393457593,0.09004336136642786,63.09586715698242,61.541726521083284,2.1752610002992387
2024-05-23,0,65.02249717712402,59.072500228881836,65.16250228881836,59.80312490463257,61.47499966621399,1.0688366562328027,1.995395929629801,-0.589472476763186,2.9952056337603277,60.24000024795532,1.6859376668930053,0.03263777306224389,59.60399942398071,64.39799947738648,0.7702561201377007,0.08324333102943289,1.0635430669647055,1.042403060697441,1.0079522684539695,0.01760627784037605,82.25936755666201,65.12841683827877,61.137624979019165,57.146833119759556,63.90535708836147,1.8781516534992981,62.108749866485596,2.2673248353725275,63.601339636485875,62.3466777581149,7.40924346725818,9.923249970217787,16222900,0.9761644484013501,0.9031781790628725,483170800.0,-13.49215383758359,97.72219427934739,97.34986547195354,124.1230204398447,39.23669639114071,11.087208779096079,0.18674388276080806,1.0530489299708632,64.2032017211914,63.283401275634766,62.540000915527344,61.79660055541992,60.87680010986328,0.14,0.0,56.903272859196726,0.012966598125942586,0.08373715599676895,63.8052727835519,61.91397557939802,2.3144341130821195
2024-05-24,0,65.30249977111816,59.072500228881836,65.16250228881836,59.80312490463257,64.0,0.8110575850845421,2.151443136276893,-1.130897924630545,2.9951235920441928,60.35000038146973,1.928399963378905,0.035050636866318374,59.60399942398071,64.84924964904785,0.8153726275029284,0.08073626225132287,1.063887846880894,1.0390132116421609,1.0087743016906539,0.014801870268724926,80.2857104245667,65.6838861237806,61.380999851226804,57.07811357867301,64.69607121603829,0.5193383021570617,62.5007141658238,2.3141329781820748,63.95509116384626,62.7066267553375,8.204014587610624,9.024979615291231,11793800,0.9787862879709235,0.6552313140766285,494964600.0,-4.960079980419934,97.72219427934739,97.34986547195354,115.52365267326932,38.11196932560645,10.438946070262302,0.19475280765416844,1.0385438786267358,64.2150015411377,63.302500984191894,62.56500053405762,61.82750008392334,60.91499952697754,0.14,0.0,56.94427596192459,0.011291498416515555,0.021402814761645923,64.59587587629046,62.32113783700125,2.4598935830915964
2024-05-28,0,65.11750030517578,59.072500228881836,65.30249977111816,59.80312490463257,64.31812477111816,0.5900388830000846,2.2929670958051274,-1.4674248154772624,2.9950451540116507,60.4087495803833,2.140737462043762,0.03720061896511447,59.60399942398071,65.03649768829345,0.8333146762834042,0.08498441987319899,1.0564527163277895,1.0280628424761127,1.0029649672156515,0.012595737994140155,81.23288783495565,66.22380903330033,61.63787484169006,57.0519406500798,64.87035696847099,0.39697428947593516,62.8369642666408,2.3289371999196797,64.2885685131138,62.94571026120089,9.260883946098824,9.174120587195528,13349600,0.9772455823099827,0.7343955523452675,481615000.0,-10.400018066395225,97.72219427934739,97.34986547195354,92.92172073732344,36.15670636781207,11.800929540459434,0.17733233558553374,1.0165024587270146,64.2150015411377,63.302500984191894,62.56500053405762,61.82750008392334,60.91499952697754,0.14,0.0,56.98870081532493,0.013399868936354364,0.006032507586050189,64.7426005772182,62.65084893362863,2.546938208131862
2024-05-29,0,64.88249969482422,59.072500228881836,65.30249977111816,59.80312490463257,64.46999955177307,0.378311474784976,2.3868695301919947,-1.6961048789055744,2.994991838804084,60.4549994468689,2.2914999961853026,0.03856982535105917,59.60399942398071,65.12200050354004,0.8492000546419932,0.08978705095968581,1.0484472024611349,1.0172062358396052,0.9968580484781929,0.0008098067434820777,80.04710000795387,66.65811391733284,61.88437485694885,57.110635796564864,64.94642843518939,0.3251663467504125,63.149999959128245,2.2847700546277547,64.49232908025,63.130761634606955,1.9093082926569354,7.79258648840329,11538600,0.9693262392176679,0.6394652225043699,470076400.0,-12.320060839806617,97.72219427934739,97.34986547195354,78.44129558549444,34.68659118133543,11.974542342397815,0.20375152970315236,0.9838911036362129,64.2150015411377,63.302500984191894,62.56500053405762,61.82750008392334,60.91499952697754,0.14,0.0,57.02597446159301,-0.0035304466081899077,0.0115300005686498,64.78106144496373,62.99472563607352,2.55386420259106
2024-05-30,0,64.93999862670898,59.072500228881836,65.30249977111816,60.02312469482422,64.8431248664856,0.17336067744682937,2.4194104485713517,-1.818171193349521,2.994975814744474,60.583749771118164,2.360462474822998,0.0389342836565813,59.60399942398071,65.12200050354004,0.8467107333720305,0.0983537084672395,1.0450448077891412,1.0105190882669328,0.9975805334909589,-0.0034145966513560166,78.9626350176767,66.9796957598136,62.1408748626709,57.302053965528195,65.0367853982108,0.16785902015941365,63.481964111328125,2.172525186250728,64.58866902036354,63.290886323709074,0.8275062498272531,7.243801148469783,13053500,0.950993122015147,0.7282856122653931,483129900.0,-12.800041015599966,97.72219427934739,97.34986547195354,71.05090582188717,33.63460735800451,11.611375354608825,0.2174408486793516,0.9421801181652393,64.2150015411377,63.302500984191894,62.56500053405762,61.82750008392334,60.91499952697754,0.14,0.0,57.06781004638169,-0.00551726466934932,-0.00399092432593038,64.88220105852399,63.31167902265276,2.4882729565439536
2024-05-31,0,65.12250137329102,59.27999973297119,65.30249977111816,60.24250030517578,64.89687442779541,-0.002629552514319216,2.385054846893693,-1.8804173342635708,2.9950023894749505,62.28249979019165,2.346999931335449,0.03820106520379514,59.75475072860718,65.12200050354004,0.845528652788676,0.09547906408963316,1.0430573219041,1.0052677535691334,1.0010683943745304,0.0015379937792081577,78.9927246242892,67.20435947634965,62.434249782562254,57.664140088774865,65.07857131958008,0.14225824946102864,63.81874990463257,2.0193171559789063,64.67777200845737,63.46258625156057,0.9835536170361002,7.708252423721517,27632200,0.9523979014575081,1.4995898571107218,510762100.0,-2.167172241771389,97.72219427934739,97.34986547195354,73.31057673893265,34.66958259123376,10.166906972395394,0.23983807501060514,0.9991729199443301,64.3754408416748,63.432280418396,62.670000076293945,61.90771973419189,60.96455931091309,0.16,0.0,57.158577405942204,0.014188832636816695,0.007816124948244864,64.96909550258091,63.6877498626709,2.4941754537777925
2024-06-03,0,65.58250045776367,59.63999938964844,65.30249977111816,60.37875032424927,64.96062326431274,-0.18081165340258812,2.3381658882837573,-1.869641878126856,2.9950357925509667,64.10249996185303,2.2944875001907348,0.037275641918279034,59.810249710083006,65.12650146484376,0.8441056457659158,0.09192659355717837,1.0455330887422012,1.01045780269934,1.0078296759623568,0.004287748365328969,79.43650585097194,67.40270664114577,62.72637486457825,58.050043088010725,65.13857105800084,0.23913902709426238,64.16982139859881,1.8494128703769617,64.78999160946199,63.64395941811684,0.45118224576459304,7.80532398364399,11578700,0.9526134024229165,0.6328863458844377,522340800.0,-1.2384178815920863,97.72219427934739,97.34986547195354,76.65050797804768,32.94473548763618,9.661092978306051,0.24730759014666867,0.9763721690355184,64.3754408416748,63.432280418396,62.670000076293945,61.90771973419189,60.96455931091309,0.16,0.0,57.19755524250579,0.0067299151680548785,0.015114191287043846,65.05029296875,64.07308006286621,2.4703833898900056
2024-06-04,0,66.26499938964844,59.76750087738037,65.58250045776367,60.40937423706055,65.04624795913696,-0.36250733122374396,2.304413898448459,-1.7579111901865956,2.995060655953536,64.32874965667725,2.2235499954223625,0.03656435934924784,60.0647497177124,65.17650203704834,0.8312348702309207,0.09642231744279504,1.0514331872378204,1.0190382370428226,1.0174422960048335,0.017621976874033107,81.31439687786869,67.63232771488092,63.02349991798401,58.4146721210871,65.31607137407575,0.47922645147278825,64.61071423121861,1.50660268709009,64.9905751541397,63.878999130894925,0.6445396573074552,8.101538637018576,14780800,0.9529510480084175,0.7999073499821951,537121600.0,-0.5578929671223023,97.72219427934739,97.34986547195354,93.14006976164575,36.866217588720964,9.074776541070092,0.26363901925476424,0.9652017230328722,64.94787982177735,63.901060089111326,63.05500030517578,62.20894052124024,61.16212078857422,0.18,0.0,57.251184320724754,0.023985103332163638,0.01866010230388537,65.30100686209542,64.55313982282367,2.4563109623612323
2024-06-05,0,66.77249908447266,59.76750087738037,66.26499938964844,60.47749972343445,65.11875057220459,-0.5171714639313404,2.28406641583262,-1.5328473401703833,2.9950779687081446,64.58999967575073,2.1284499549865714,0.03605699521885733,60.2725004196167,65.33049983978272,0.8262523414107158,0.09692104954694154,1.054091800286958,1.0237608685008135,1.0216345108594305,0.029129571125312337,83.4138383411829,67.9141327401125,63.34599990844727,58.77786707678203,65.52607127598354,0.7291828447359561,65.11107124601092,0.7452242670780816,65.31225480697775,64.18278040683447,1.910880489778462,10.271663991522317,14982700,0.9545584392027355,0.8098203014766828,552104300.0,-1.4253003958765054,97.72219427934739,97.34986547195354,102.91650659110086,38.276904011443456,8.486316916426798,0.2778097348645174,0.9584012401305021,66.15644084167481,65.541780418396,65.04500007629395,64.54821973419189,63.93355931091308,0.19999999999999998,0.0,57.30776055404097,0.03342577873821684,0.031518959689521786,65.54459817068917,65.07023702348981,2.4821905071501105
2024-06-06,0,67.10499954223633,59.76750087738037,66.77249908447266,60.625624656677246,65.13250160217285,-0.6567181072354386,2.2960391117069627,-1.2004802957228096,2.9950765417919167,64.85624980926514,2.0257248592376698,0.03606488135452831,60.2725004196167,65.65075035095215,0.8148645433980498,0.10367767081772986,1.0540473088836932,1.0258036860459299,1.0208179589772284,0.033338481079624005,85.04944548114584,68.25620314139793,63.66412491798401,59.07204669457009,65.80999973842076,0.9084806323063771,65.34017835344586,0.8314863312442187,65.66781721660843,64.52271375869803,2.2510613200210754,11.720413442522572,13256000,0.9540888532822597,0.7121796910592867,565360300.0,-7.611569842476087,97.72219427934739,97.34986547195354,108.23445882790479,38.5324107140844,8.053212596306457,0.3029972937656417,0.9378000016552681,66.54084211730957,65.98458191680908,65.53500175476074,65.08542159271241,64.52916139221192,0.2,0.0,57.35871691890368,0.03482820067757819,0.034349997077197804,65.84516906738281,65.2938848223005,2.438647240440693
2024-06-07,0,66.62249946594238,59.76750087738037,67.10499954223633,63.08999991416931,65.19750165939331,-0.7946046919345647,2.2921882861725287,-0.7830565433051584,2.9950843894847647,64.9112491607666,1.884124841690064,0.03581859014843177,60.2725004196167,66.31574935913086,0.7962861664659728,0.1129908195926912,1.0410680559839012,1.015412752092994,1.0068460468443754,0.0230334839881714,86.9632341185982,68.57875146744088,63.994374895095824,59.409998322750766,66.05857113429478,0.8484699621552634,65.50249978474208,0.8450225950341277,66.01911593551785,64.88409476482882,3.0521737286383104,5.019757427402434,20213200,0.9456558953312189,1.069684381931705,545147100.0,-45.675732241299144,97.72219427934739,97.34986547195354,80.34719717797276,33.26576311383891,14.955035964410623,0.23688585072704219,1.0086764485435409,66.6967995147705,66.15659940338135,65.71999931335449,65.28339922332763,64.74319911193848,0.2,0.0,57.42946139475238,0.0018248251616443945,0.015256652832355097,65.98192269461495,65.38149206978935,2.311160741405193
2024-06-10,0,66.9375,59.76750087738037,67.10499954223633,64.20499992370605,65.37249994277954,-1.0156842980288614,2.194108738529676,-0.20073937927263108,2.9951432317788664,64.9812479019165,1.6725248718261696,0.03411722735642608,60.376000213623044,66.6374994277954,0.7910664070312322,0.10288456187460882,1.0408426282925007,1.0177319152812263,1.0070408294764972,0.0206609923802612,78.43126805319137,68.69909232065677,64.31087484359742,59.922657366538054,66.34392847333636,0.7383221383320593,65.69035693577358,0.8512415344464684,66.16604398967719,65.15541720237516,2.6817705533884766,3.531468622151046,21667400,0.9630078478033267,1.1190708789479162,566814500.0,-17.88860176080366,97.72219427934739,97.34986547195354,98.78629165888916,29.953311100906298,13.465882121335751,0.2313674745588102,1.0402019500672819,66.76524063110351,66.26738121032714,65.8650016784668,65.46262214660645,64.96476272583008,0.2,0.0,57.50816348446002,0.017319919773446157,0.018248135266968522,66.27679661342076,65.57949883597237,2.1904017240582396
2024-06-11,0,66.74749946594238,59.76750087738037,67.10499954223633,64.33937454223633,65.75312519073486,-1.247368492710274,2.0713889655429316,0.6594935619605993,2.9952116145651133,65.0699987411499,1.4741749477386463,0.03204630403049197,60.60999956130981,66.78899917602538,0.7626504908729098,0.10335023703092522,1.032645580691328,1.0123265755079867,1.00010488338468,0.007281371474204157,79.54744637690118,68.78015276133183,64.63737483024597,60.49459689916011,66.57607105800084,0.5106322237762783,65.82732118879046,0.8564086550591697,66.35667650548136,65.44305119474198,3.075918410120614,4.089725333936535,13367500,0.9628844353612032,0.7010691862326637,553447000.0,-24.63335235090781,97.72219427934739,97.34986547195354,92.85530706346937,28.6603679036942,12.88462348770462,0.2826342814773279,1.009471414945895,66.76524063110351,66.26738121032714,65.8650016784668,65.46262214660645,64.96476272583008,0.2,0.0,57.55517722112906,0.0019520751309971551,0.013825642785387459,66.41497475760323,65.69203513009208,1.9891657458762158
2024-06-12,0,66.5,59.76750087738037,67.10499954223633,64.7099997997284,66.35437440872192,-1.563969273738932,1.9060094589701053,2.083308926505337,2.995294652637875,65.1200008392334,1.2463500404357917,0.029349693690105795,63.51700000762939,66.78899917602538,0.6823172330445996,0.11074592940123218,1.0240004954889617,1.0060856881161815,0.9949578898786494,-0.0040810077233730535,78.6867139715877,68.75339374437148,64.94137482643127,61.129355908491064,66.70714242117745,0.27773427355631813,65.92285673958915,0.851125916326028,66.45417436477855,65.66609259233495,2.495294342790455,2.957734913609287,11704700,0.9475552164730057,0.6254670750341932,541742300.0,-36.950252262532025,97.72219427934739,97.34986547195354,73.12911359905709,26.55571383282067,15.115871525728041,0.29356682860205496,1.0116522166531643,66.76524063110351,66.26738121032714,65.8650016784668,65.46262214660645,64.96476272583008,0.02,1.0,57.594623288019505,-0.011626222854070889,-0.004354372863122794,66.48477499825614,65.76753398350307,1.598579382987314
2024-06-13,0,66.42749977111816,59.76750087738037,67.10499954223633,64.86937475204468,66.5306248664856,-1.8870418160566265,1.5735685706345337,4.768594297733994,2.995436949070525,65.14250183105469,1.0479248619079584,0.02411165153397874,64.26649990081788,66.78899917602538,0.48441447563632756,0.11264481572405201,1.0178626827229942,1.0025354859480569,0.9946842372578399,-0.010096114682062396,75.68410544961061,68.40888698105177,65.26174983978271,62.11461269851365,66.73035676138741,0.238661256634434,66.02321406773159,0.8190244746942034,66.47154464531356,65.84573147695068,1.3990005501958782,2.0525573208552954,11196600,0.9448024614861494,0.6165075419841107,530545700.0,-25.51330670872907,97.72219427934739,97.34986547195354,70.14033989430037,25.014945693475624,14.238845459251522,0.2961809302317933,0.9972481025032954,66.76524063110351,66.26738121032714,65.8650016784668,65.46262214660645,64.96476272583008,0.02,0.0,57.632397373510564,-0.006701442995063589,-0.005813111427035433,66.49902016775948,65.90001351492745,0.9761495739375955
2024-06-14,0,66.74250030517578,63.89750003814697,67.10499954223633,64.9256238937378,66.5306248664856,0.06699889440005832,0.9611655140530201,-1.2957061855575667,2.995624945666545,65.23250102996826,0.8619498443603504,0.014653086065747726,64.34574947357177,66.78899917602538,0.8411930739952262,0.03959465912533002,1.0174975973607254,1.0050332669640276,1.001432931188904,0.001801205901840186,66.14451543803104,67.51708081257566,65.5947497844696,63.672418756363534,66.72607122148786,0.23804694978269422,66.1260712487357,0.8119418021196719,66.47102055916244,66.01318661315959,0.24522807359311846,2.160794578785331,12590100,0.32097413799400915,0.7986837998523176,543135800.0,-16.12914051750176,97.72219427934739,97.34986547195354,86.85278352137351,26.08495375486154,13.401484315202076,0.28665038557909706,0.9838724126711572,66.76524063110351,66.26738121032714,65.8650016784668,65.46262214660645,64.96476272583008,0.02,0.0,57.676109912274455,0.017304145645771207,-0.0019359724207961562,66.48904854910714,66.01682335989815,0.9390141542568499
2024-06-17,0,67.04750061035156,64.30749988555908,67.10499954223633,65.00187253952026,66.65249967575073,0.03255795433123241,0.9085360790446215,-1.514828018107751,2.995636776492276,65.44250011444092,0.8486998844146726,0.01382077189161189,64.78199987411499,66.78899917602538,0.8448210197332241,0.037179501144594444,1.0199355129768786,1.0071691313150626,1.0056471434719938,0.0016433331144958263,68.3546934647691,67.55407195591027,65.73699979782104,63.91992763973181,66.71785708836147,0.22332934487134173,66.26392841339111,0.7911041806711621,66.54052804776703,66.09485552466683,-0.044926848190785997,2.205123140928362,12103000,0.31519052299832007,0.8121625076582704,555238800.0,-4.398876844425054,97.72219427934739,97.34986547195354,98.6906856747775,26.528719158386323,12.402656927108877,0.2800545097683218,0.9871673020491836,66.76524063110351,66.26738121032714,65.8650016784668,65.46262214660645,64.96476272583008,0.02,0.0,57.71901668602709,0.006869802042704043,0.023375816446934435,66.52751050676618,66.1863397870745,0.9618545817572852
2024-06-18,0,67.60000038146973,64.30749988555908,67.10499954223633,65.09374952316284,66.74375009536743,-0.07667347030657877,0.8927085991580007,-1.5569668111762642,2.9956404066636373,65.92374992370605,0.844874906539917,0.013552196610414657,64.8772497177124,66.94850006103516,0.8083452458015917,0.04260779426456565,1.0262346491317238,1.013238813657921,1.0135996334028627,0.012772027751576376,71.59226990246945,67.65729205526486,65.87187485694885,64.08645765863284,66.85750007629395,0.39408936011930595,66.45803560529437,0.7588073786644978,66.66900631884327,66.21820740902776,-0.08568501941286122,2.963873453573551,12093500,0.314969047206887,0.8195207699232794,567332300.0,-7.277744988967195,97.72219427934739,97.34986547195354,127.65852639377299,28.60881405105549,11.875183639680609,0.3003897550823169,0.9573683653184445,66.99444296264649,66.45278309631348,66.0150032043457,65.57722331237792,65.03556344604492,0.02,1.0,57.763767685304636,0.013037553423550285,0.009557985450718638,66.77252633231026,66.37722451346261,0.9335263155950797
2024-06-20,0,67.69750022888184,64.82999992370605,67.60000038146973,65.1212511062622,66.75374937057495,-0.004293286957088209,0.8926279645469328,-1.5277925496599956,2.9956409104751986,66.3462495803833,0.8365999317169184,0.013517190737628682,64.9342487335205,67.05325050354004,0.8050769748444259,0.04272713961165346,1.0251527617319498,1.0126738548913643,1.0124731731452024,0.018007522238824514,75.14400888020694,67.82175581083825,66.03649988174439,64.25124395265053,66.96607153756278,0.50802304339072,66.65500000544957,0.68914433726943,66.90393965739067,66.40097341794663,1.467223420560865,4.1883415395943615,13860800,0.31693053332029814,0.9498089870316756,581193100.0,-3.022551911675683,97.72219427934739,97.34986547195354,133.5415395466642,28.778626227341388,11.13272488042389,0.2851633390483795,0.9482698562286719,67.19307876586915,66.61345970153809,66.14500045776367,65.67654121398925,65.0969221496582,0.04,0.0,57.815716431661386,0.025637268250356504,0.019181741829887376,66.92210061209542,66.5994486127581,0.9930363938307246
2024-06-21,0,68.13750267028809,64.88249969482422,67.69750022888184,65.15250205993652,66.81374931335449,-0.0660344279857773,0.9172743800591808,-1.3977171003997253,2.9956361850615805,66.46374988555908,0.8306499481201172,0.013860322061453727,65.01424732208253,67.15449962615966,0.8351104051579092,0.03890271016339519,1.0295804090946319,1.0178473799415884,1.015416634232294,0.02574239441589543,75.27073388305182,68.01442365712153,66.17987489700317,64.34532613688482,67.16464342389789,0.6578989367198566,66.87035724094936,0.6429450675190665,67.10281342516703,66.57215369758255,1.1353878302623133,4.246229843680235,25891500,0.31397434108531846,1.7097033747351649,607084600.0,-18.879041441798286,97.72219427934739,97.34986547195354,144.28794064435837,30.409643821159513,10.518364667580109,0.2042136075725983,0.9319643636971037,67.74996319580079,67.25502328491211,66.8550033569336,66.45498342895507,65.96004351806641,0.06,0.0,57.91403976915877,0.018141006530083326,0.02412919364739439,67.09019252232143,66.75258363996234,1.0268067931711486
2024-06-24,0,68.47250175476074,64.88249969482422,68.13750267028809,65.25750017166138,66.96500015258789,-0.0580249405554702,0.9793511596364072,-1.1306236896397117,2.995623230412235,66.56124973297119,0.8394002532958978,0.014765135880256023,65.01424732208253,67.60975036621093,0.8080745359475101,0.04790658046673686,1.0323220455933868,1.021276458829391,1.0152346490138915,0.025920537014265888,79.28877632831792,68.2873272353495,66.32862491607666,64.36992259680383,67.4464293888637,0.7427320387076981,67.07678590502057,0.6613291697696717,67.35991817167842,66.78334374700515,2.082479816423604,4.629738160263031,12470400,0.31410210646362824,0.8337930079973362,619555000.0,-4.117627259365639,97.72219427934739,97.34986547195354,167.23749357950774,31.490949389111915,9.6137369127685,0.26082343475266984,0.9468245076969491,68.23760055541992,67.7412003326416,67.34000015258789,66.93879997253418,66.44239974975586,0.08,0.0,57.96309730093309,0.02805144645051305,0.032983648236515034,67.45914241245815,66.97195870535714,1.1001305203385585
2024-06-25,0,67.18249893188477,64.88249969482422,68.47250175476074,65.5125002861023,67.06187534332275,-0.010133570158792184,1.0362838782718353,-0.8793448307931233,2.9956108425582073,66.68249988555908,0.837012691497803,0.015582952559268042,65.0997501373291,67.74150047302246,0.8197642889681929,0.04854334818350398,1.0102460490020435,0.999278582996835,0.9910238499634141,0.0020134728409602065,80.92333470015163,68.57369290150217,66.5011251449585,64.42855738841482,67.55428641183036,0.6137202194155454,67.14232158660889,0.6187879256379017,67.63559077550318,67.02257899313575,2.966168052271793,4.406665309838687,20904000,0.3154089396144128,1.3563685865450623,598651000.0,-47.647118221903085,97.72219427934739,97.34986547195354,48.24096241585077,26.44236494975713,17.28226282724774,0.29538611734665665,1.047054346681444,68.23760055541992,67.7412003326416,67.34000015258789,66.93879997253418,66.44239974975586,0.08,0.0,58.033448792625045,0.0,0.00596839286181127,67.56170763288226,67.03036390032086,1.0750503308386596
2024-06-26,0,67.875,64.88249969482422,68.47250175476074,66.09437465667725,67.12437438964844,-0.19206748392067902,1.008179873231819,-0.702879378812252,2.9956175586007916,66.74499988555908,0.7923501205444324,0.015138944054426742,65.0997501373291,67.74150047302246,0.8382242138458696,0.031711884163723815,1.0192187475438135,1.0092111364010055,1.0008404731174039,0.0040680416712786105,57.92783481382246,68.61148484946047,66.59512510299683,64.5787653565332,67.71607208251953,0.5034139029853413,67.2210716520037,0.6379599345428909,67.51865665330219,67.04684772899213,1.1365762122133425,1.3845914897565894,14177500,0.44865372912994306,0.917451377988997,612828500.0,-22.05881362968282,97.72219427934739,97.34986547195354,109.90729540685969,30.725021979797337,15.680910620910542,0.32769828167308124,1.0715511308691437,68.23760055541992,67.7412003326416,67.34000015258789,66.93879997253418,66.44239974975586,0.08,0.0,58.08491222258885,0.010207143336551816,0.012904236918925477,67.74262128557477,67.11583491734096,1.0554523716474542
2024-06-27,0,68.10499954223633,64.88249969482422,68.47250175476074,66.38687467575073,67.286874294281,-0.3501410128669398,0.9849631367794925,-0.5111174353465997,2.995623150739225,66.75999927520752,0.7521501922607428,0.014759761070002849,65.10425109863282,67.90125026702881,0.7628776177578682,0.04612184054638847,1.0205595350530388,1.0109361468014035,1.003418131254282,0.006019414483204866,64.83159281249044,68.702926361297,66.73300008773803,64.76307381417907,67.86714335850307,0.42132180670825375,67.29250022343227,0.678648805977004,67.60511009949927,67.16362428807163,1.696819402398677,1.6511302267309034,12899200,0.4589438331162609,0.8310716366973742,625727700.0,-34.11773945629369,97.72219427934739,97.34986547195354,102.09113961128375,28.84090299920469,14.719326236910396,0.3052146066855041,1.0600117155312472,68.23760055541992,67.7412003326416,67.34000015258789,66.93879997253418,66.44239974975586,0.08,0.0,58.1313240368446,-0.0019114915619196093,0.004142029180050033,67.80814906529018,67.16782978602818,0.972497968572511
2024-06-28,0,67.75,64.93999862670898,68.47250175476074,66.48187494277954,67.62437534332275,-0.38632614788411723,0.9311781019743434,-0.3416466059668797,2.9956352058248163,66.85499954223633,0.7218752861022949,0.013920177606915659,65.5365005493164,68.1082498550415,0.7172245959376536,0.048737311094207814,1.0127944706484526,1.0032763760473646,0.996990624931549,-0.005687068869594136,66.48875939996688,68.75648128405732,66.89412508010864,65.03176887615996,67.88857187543597,0.4091078333286102,67.37303597586495,0.65965816035195,67.73116214382732,67.29590588936657,1.5772384089758251,1.4902019325260458,18816700,0.45858186619808394,1.1902279192818164,606911000.0,-42.356754445216566,97.72219427934739,97.34986547195354,64.7468949203733,27.295833736300647,16.33465217647088,0.3161645928293391,1.040010291881424,68.29896105957032,67.84052114868165,67.47000122070312,67.0994812927246,66.64104138183593,0.08,0.0,58.196005766460026,-0.002945086640077532,-0.004411134373660544,67.82381875174386,67.29817254202706,0.8445800213012642
2024-07-01,0,67.71500015258789,65.12250137329102,68.47250175476074,66.59187459945679,67.71062517166138,-0.3507532217086259,0.8324950284734033,-0.235818731564986,2.9956550417611316,66.99250030517578,0.6626252174377442,0.012418880938407678,66.19674949645996,68.1082498550415,0.6831544067678198,0.040347016335380084,1.0101496055554082,1.0007980921022428,0.9976133315691733,-0.011062858560154543,60.99120979260329,68.69961520572,67.03462514877319,65.36963509182638,67.89107186453683,0.4077969950400141,67.4285717010498,0.6528637758622038,67.73743068123468,67.36988577222327,0.22189292556777973,1.6923720111011427,8666000,0.4730769446562705,0.5831364815929464,598245000.0,-49.68146056768538,97.72219427934739,97.34986547195354,52.348586087021246,26.398310436558766,15.220144910445933,0.2427223737589586,1.0364378927237785,68.29896105957032,67.84052114868165,67.47000122070312,67.0994812927246,66.64104138183593,0.08,0.0,58.22533659769491,-0.020609552732517744,-0.006331823610266117,67.74832044328961,67.33521052769252,0.7802058598796566
2024-07-02,0,67.7125015258789,65.58250045776367,68.47250175476074,66.71250009536743,67.72375011444092,-0.10808052930943751,0.7187349916929568,-0.6075309506757498,2.9956749915055823,67.07625007629395,0.6056752872467044,0.010701154122231077,66.41124973297119,68.1082498550415,0.6510476185190552,0.03251629138778549,1.008162846118652,0.9993248216847583,0.9998080752520749,0.007888997914940576,59.42364234169644,68.60172007112395,67.16425008773804,65.72678010435213,67.83035741533551,0.39647317025965895,67.4975004196167,0.6258068532467006,67.73494118609135,67.42339730008196,0.025850177106818313,1.1615315071341037,9436500,0.4682481439725235,0.6395933822266038,588808500.0,-30.891764625843727,97.72219427934739,97.34986547195354,59.83640627078651,24.88386061080816,14.346977445319,0.23875239121595962,1.020977688451445,68.29896105957032,67.84052114868165,67.47000122070312,67.0994812927246,66.64104138183593,0.08,0.0,58.25756258201285,0.009641096548622441,-0.012046493617627073,67.77111271449498,67.4306526184082,0.724610798365333
2024-07-03,0,67.97999954223633,66.26499938964844,68.47250175476074,66.74624967575073,67.72375011444092,0.1550544539218086,0.6286255755880594,-1.16503950873211,2.995688631686582,67.14374923706055,0.562825498580932,0.00934470887078131,66.49274997711181,68.1082498550415,0.6744379645131942,0.021844143206263874,1.010543206365388,1.002288973011327,1.0021892380024209,0.0015469545817505814,57.55272252057116,68.52800129231991,67.2707501411438,66.01349898996767,67.75999995640346,0.2939779066841574,67.60321467263358,0.5665405205507675,67.7328969780707,67.45889749157428,-0.6237404186439385,1.4457501294545296,6287500,0.4489250107644011,0.4387881004156536,595096000.0,-25.89003315942945,97.72219427934739,97.34986547195354,77.81603921155096,24.979027706115957,13.696834842543302,0.2205892468737628,0.9930499559578172,68.31075997924805,67.85961940002441,67.49499893188477,67.13037846374512,66.67923788452148,0.08,0.0,58.279436423846796,-0.0007322866951708917,0.01216250062274754,67.67709350585938,67.56811795915876,0.7272703515514026
2024-07-05,0,69.11250114440918,66.42749977111816,68.47250175476074,66.76624917984009,67.78125,0.06127827532771296,0.6019900808284212,-1.2683744799981809,2.995692341618832,67.39124965667725,0.548000431060791,0.008937371738418413,66.61024951934814,68.1082498550415,0.6907200017041792,0.018083799083752808,1.0260702529341257,1.018415857027973,1.0185697061860326,0.014793357447246303,59.25278456368403,68.56048031043004,67.3565001487732,66.15251998711635,68.03571455819267,0.4970178226966255,67.79500048501151,0.5918212472570578,67.79688501438852,67.55017586701227,-0.7192700717849432,2.225563221408012,21586100,0.43989687777396663,1.4725081023042537,616682100.0,-2.857159842814594,97.72219427934739,97.34986547195354,200.73249378807273,34.25701496544156,11.81985020691176,0.2372916447338838,1.068548007784614,69.24140188598633,68.67930210876465,68.22500228881836,67.77070246887207,67.20860269165038,0.1,0.0,58.36441249840644,0.03182088033436892,0.02562600092813081,68.0503158569336,67.80601174490792,0.9241069013584335
2024-07-08,0,69.76749992370605,66.42749977111816,69.11250114440918,66.8899998664856,67.90124988555908,0.3600854644681428,0.6970130170901129,-0.45856563255103566,2.995678981066686,67.64875030517578,0.5949004173278809,0.010330174283078315,66.61024951934814,68.17100257873535,0.601322407225747,0.029915827671071166,1.0339985277683272,1.0259285174621928,1.0251785264462572,0.02977859665986804,69.04348635283098,68.86752628595025,67.47350025177002,66.07947421758979,68.30607169015067,0.8107363759628052,68.0110718863351,0.7169734762651279,68.12561510984685,67.7504598612148,2.8727752661912915,4.042002758710512,12077700,0.49806523677063674,0.82721168015194,628759800.0,-12.566884736918334,97.72219427934739,97.34986547195354,196.25021761813588,32.4135902466289,11.18380517887692,0.2253449799791952,1.048651443789955,69.2673620300293,68.72132234191895,68.28000259399414,67.83868284606933,67.29264315795899,0.1,0.0,58.41264047861163,0.02909467708363933,0.026517381492691682,68.24832262311664,67.9954719543457,1.0279821387450878
2024-07-09,0,69.93000030517578,66.42749977111816,69.76749992370605,66.8899998664856,68.01124954223633,0.7076863502564397,0.8511386264208293,0.18950847094693213,2.995653253627431,67.70500087738037,0.6652128505706785,0.012589574217186922,66.61024951934814,68.53650169372558,0.6286937408021084,0.0472062814060497,1.0343660850548957,1.025859192601949,1.0215096934238872,0.03271062759501797,75.22396527372405,69.30890252368516,67.60662527084351,65.90434801800185,68.5667860848563,1.0053748054530969,68.21696472167969,0.8247607201423419,68.53398209726869,67.99972433852668,2.788213515589031,4.532343865900525,9758400,0.49209839871353844,0.6931787064059575,638518200.0,-9.45942602161801,97.72219427934739,97.34986547195354,189.0825320310443,31.864775765232025,10.72739369604029,0.2804786797596478,1.015175935396712,69.37680072021485,68.83660116577148,68.4000015258789,67.96340188598633,67.42320233154297,0.12000000000000001,0.0,58.452049798779456,0.035862397387636635,0.03234384145831591,68.53607395717076,68.17211151123047,1.0436214758151463
2024-07-10,0,70.16750144958496,66.42749977111816,69.93000030517578,67.02000045776367,68.11312532424927,0.7392946097318698,0.9584187260253333,-0.034808545488298925,2.9956326168872556,67.7137508392334,0.7204002380371094,0.014141809620517353,66.7182502746582,69.17800102233886,0.7168911408669322,0.044705886912056486,1.0353464723738892,1.0271471219222374,1.0183888498969496,0.03625622844206666,75.70993916490826,69.68883776485585,67.77200031280518,65.8551628607545,68.91214343479702,1.0897185625193937,68.4003576551165,0.9525706179636252,68.88106485679901,68.26537280942334,2.679686917562714,4.299190377842638,10803400,0.4908370108082704,0.7982087331279085,649321600.0,-0.7711769666777806,97.72219427934739,97.34986547195354,176.133123698401,31.581495497820256,10.172411027666582,0.3041558954785824,0.9940917136916633,69.52196258544922,68.95402267456055,68.49500274658203,68.03598281860351,67.46804290771485,0.14,0.0,58.49630890675348,0.03437640782347451,0.0434202231393714,68.92069244384766,68.37225559779576,1.1561088139886584
2024-07-11,0,69.92250061035156,66.42749977111816,70.16750144958496,67.14874935150146,68.22125244140625,0.6602211482491632,1.069853226941568,-0.38787789312389,2.995608681905083,67.73250007629395,0.8204503250122059,0.015748536743637558,66.7182502746582,69.78374996185303,0.749549541176817,0.05123790420624849,1.0292786359275843,1.0191075875752373,1.0076522359901345,0.02857459666366058,77.90248881295778,70.07320683916755,67.93350038528442,65.79379393140128,69.22750064304897,1.0013688693880278,68.5592862537929,1.0101551514714358,69.20026433951563,68.52320227663327,3.568267822265625,3.7980784816963236,15624800,0.4841445616579877,1.1448903895388285,633696800.0,-16.66653624946203,97.72219427934739,97.34986547195354,127.00235883912296,28.91857271003128,12.574083548019704,0.28430568941375245,1.0080849853541973,69.52959838867187,68.96019927978516,68.5,68.03980072021484,67.47040161132813,0.16,0.0,58.5578165613304,0.022860589779267304,0.02541500725211741,69.25117819649833,68.49974931989398,1.1702322496985527
2024-07-12,0,69.58499908447266,66.42749977111816,70.16750144958496,67.49562501907349,68.63250160217285,0.4937911560714322,1.1166290934153718,-0.7615909141621686,2.995598163289582,67.8125,0.8877003860473621,0.016398769113354843,66.7182502746582,69.92325057983399,0.7803890214676908,0.05146617459175282,1.0219224453923463,1.0111710338788935,0.9972054800766121,0.006836649408421769,74.41294443062647,70.32550862933562,68.09225044250488,65.85899225567414,69.49500029427665,0.7470082599077507,68.66267885480609,1.0373746297213116,69.37858343228007,68.72294198353768,3.259987377670126,3.286680267287732,12145300,0.48402874892528563,0.8884995372893569,621551500.0,-31.025666105872684,97.72219427934739,97.34986547195354,86.47065852802436,27.137683008070375,12.44423516960502,0.2557114826442262,0.9975073943796278,69.52959838867187,68.96019927978516,68.5,68.03980072021484,67.47040161132813,0.16,0.0,58.60367068975879,-0.011422091960075154,0.014654224217479002,69.41784558977399,68.59447915213448,1.0975108622032217
2024-07-15,0,69.54500198364258,66.42749977111816,70.16750144958496,67.67312526702881,69.23062562942505,0.3715284466501701,1.098962845461858,-0.9914581824300646,2.9956028700921244,67.92749977111816,0.9232001495361345,0.01610284540706703,67.01700057983399,69.92325057983399,0.7872666682401448,0.04753301455321871,1.0190266398916523,1.0084210530333342,0.9952844272270935,-0.003189134486785261,68.67035536982458,70.44442608765225,68.24650039672852,66.0485747058048,69.7185720716204,0.342906827750285,68.73928601401192,1.0615686930046329,69.42911402497836,68.85541825962099,2.765364617164681,2.1243755016806083,10171100,0.4948055383596896,0.7468768759396909,611380400.0,-21.53840134590555,97.72219427934739,97.34986547195354,84.87728357899817,25.691382860340926,11.7810208797621,0.21886893497091814,0.9783997356494489,69.52959838867187,68.96019927978516,68.5,68.03980072021484,67.47040161132813,0.16,0.0,58.642289972659874,-0.0010045966142162577,-0.006139374428540374,69.61300441196987,68.64504895891461,1.0545206954372481
2024-07-16,0,69.90749931335449,66.74250030517578,70.16750144958496,67.70875120162964,69.5550012588501,0.33203669188464646,1.0498997287147291,-1.2523158617357495,2.9956146715831484,68.04249954223633,0.928350219726562,0.015348878177510695,67.16899909973145,69.92325057983399,0.7927109849807289,0.04198976163093289,1.022003969815901,1.0110458101394477,1.0011098185013165,-0.00032176450340470897,67.31602335488988,70.50217496478419,68.40237550735473,66.30257604992528,69.83214323861259,0.2174063856626442,68.93392889840263,1.002335715641061,69.46221596880244,68.94335728222744,2.302151297359021,1.5663225402849654,9836800,0.4955353032208269,0.7297053301395867,621217200.0,-14.197511968031872,97.72219427934739,97.34986547195354,94.87184972877492,26.442068460065315,11.199856135321474,0.19362907978052363,0.9556563625832655,69.68535745239258,69.21231776428223,68.82999801635742,68.44767826843261,67.97463858032226,0.16,0.0,58.68043022702858,0.0012874495451566936,0.004448818058977474,69.60588073730469,68.82809829711914,1.0395641082582108
2024-07-17,0,70.56499862670898,67.04750061035156,70.16750144958496,67.71437549591064,69.630624294281,0.25889715498863847,1.0260394694063966,-1.4979430253708772,2.995620429824696,68.1212511062622,0.9452500152587902,0.014965433330804157,67.55825023651123,69.92325057983399,0.7810293847242381,0.04265630600645194,1.0292350478946561,1.017329096636049,1.0105906600490726,0.005664975507352565,69.7751817519353,70.61270439657646,68.56062545776368,66.5085465189509,69.94607162475586,0.3477627880890181,69.12607165745327,1.0408204536581993,69.57547557048628,69.05202346064763,1.1502957580484316,4.056116436264986,13533800,0.4966621746254628,0.9986533402695533,634751000.0,-1.8181746121392635,97.72219427934739,97.34986547195354,129.26943456816383,30.53770070152238,10.250952059010016,0.1935416104302192,0.9695383024646008,70.19139883422852,69.62929905700683,69.17499923706055,68.72069941711426,68.15859963989257,0.18,0.0,58.73598508842906,0.008805495086198434,0.01616590914165798,69.79818943568638,69.02325602940151,1.1191589992321553
2024-07-18,0,70.78000068664551,67.18249893188477,70.56499862670898,67.74125003814697,69.80249977111816,0.22743310647877718,1.0527218349918754,-1.5210810014558538,2.995615123384938,68.30500221252441,0.9873999214172358,0.01531532489288926,67.68775024414063,69.9537504196167,0.7771345884108763,0.04386092054005391,1.0297294787689732,1.0162495178997022,1.0125169982675692,0.012263578516340967,73.64922795973581,70.84194402856528,68.73650035858154,66.6310566885978,70.06750025068011,0.46861475920539863,69.31714316776821,1.08361113796441,69.82413541164495,69.2325809772437,1.1430805229871084,3.9631655642121317,10682700,0.5016631138459203,0.7923964006999216,645433700.0,-9.390926835313618,97.72219427934739,97.34986547195354,121.24246525947784,29.47451164675919,9.667981327878127,0.19323679161305873,0.9545712907805609,70.26016186523438,69.68492150878906,69.22000122070312,68.75508093261719,68.17984057617187,0.19999999999999998,0.0,58.77991138778054,0.014613131769972032,0.005822951879962823,69.92924390520368,69.23265893118722,1.1589544578990176
2024-07-19,0,70.98250007629395,67.18249893188477,70.78000068664551,67.84375,69.91124963760376,0.12949121812452757,1.1077704304852538,-1.4686346044227416,2.9956030877210615,68.79250144958496,1.0327499389648438,0.01607899535491109,67.7110013961792,70.20725116729736,0.790824917599845,0.0455334458043782,1.0302922497279088,1.0150761639076178,1.0129287298611975,0.020083365814588694,74.91628621326066,71.11104123481086,68.89550037384033,66.67995951286981,70.18392862592425,0.5845132206129284,69.54803603036063,1.0682798901005646,70.06430656475337,69.40641082247974,1.2155017556989984,3.9277603147919233,11665500,0.5016274394539607,0.8723992268772699,657099200.0,-14.215724773455705,97.72219427934739,97.34986547195354,114.46167938859608,29.01285717412966,9.16572178497593,0.12718967259716063,0.9349589039288962,70.36712139892578,69.7714411315918,69.29000091552734,68.80856069946289,68.21288043212891,0.2,0.0,58.82789775475912,0.02180818442300958,0.013610262263146206,69.97767639160156,69.44918441772461,1.1942957408500858
2024-07-22,0,70.6825008392334,67.18249893188477,70.98250007629395,67.95374965667725,69.92437553405762,0.0312013888730148,1.1602566255789213,-1.3992183905394684,2.9955911547522063,69.32875156402588,1.0607749176025394,0.016800764836627666,67.71475028991699,70.58649883270263,0.8203088174678013,0.04175376693467287,1.0234977749617877,1.008090260415148,1.0046406944861417,0.01635629913215575,75.54476867303897,71.38026361736877,69.05975036621093,66.7392371150531,70.29250008719308,0.5982821992408931,69.76000036512103,0.9661131710716317,70.29494523285106,69.59790085069129,1.1615044142544497,4.771217824788111,12666100,0.4974921423330294,0.9965087850768756,644433100.0,-23.34163756436716,97.72219427934739,97.34986547195354,88.35521619071523,26.746291759462085,11.635249481527293,0.17771003195875193,0.9417475222509689,70.36948190307618,69.77526194763183,69.29500198364258,68.81474201965332,68.22052206420898,0.2,0.0,58.87834599235604,0.011061565363510661,0.016464430037471146,70.06029728480748,69.6557377406529,1.1861230712503315
2024-07-23,0,70.48250007629395,67.18249893188477,70.98250007629395,67.95374965667725,69.98937559127808,-0.14326440188213516,1.191277386779808,-1.4127355364278955,2.9955839063641707,69.56500053405762,1.0777999877929687,0.01721822570787404,67.71475028991699,70.6922508239746,0.8616544889603321,0.032275716935068754,1.0187246129546428,1.0039276818479546,0.9985690730512893,0.00822516566301501,68.9383644743747,71.56955504821784,69.1870002746582,66.80444550109857,70.42071451459613,0.511227165882737,69.95785740443638,0.7803136053481706,70.39145231091757,69.7283739295051,1.0869179766853518,4.382338743201048,9263600,0.5051934603287068,0.7381275181502032,635169500.0,-18.328853719176518,97.72219427934739,97.34986547195354,73.53335307754404,25.516595705318327,12.03544232393248,0.1731523375106478,0.9166222458990249,70.45444204711914,69.91278218078614,69.47500228881836,69.03722239685058,68.49556253051757,0.02,1.0,58.91454376846293,0.009430068080843457,0.014940444531203544,70.26115417480469,69.83949988228935,1.2203178286100131
2024-07-24,0,70.57499694824219,67.18249893188477,70.98250007629395,67.95374965667725,70.2462511062622,-0.3142957966499646,1.2113761427305072,-1.393176538655152,2.9955791476373728,69.67624950408936,1.0867500686645513,0.01748332873023023,67.71475028991699,70.6922508239746,0.8408581635860495,0.049119952322032506,1.0185819484605896,1.0044547076991897,0.9982531013715092,0.0001416895306141086,71.31527427605765,71.71025247619586,69.28750019073486,66.86474790527386,70.56785665239606,0.33503588421422725,70.14321436200824,0.5479682658109993,70.41165397965493,69.81153499529952,1.2897909084280772,4.090822947009835,22490800,0.3912853734777705,1.7808182842121307,657660300.0,-22.60069963600976,97.72219427934739,97.34986547195354,77.14908275302568,25.616599030609706,11.550767548776154,0.1199238246953185,0.886863303153184,70.56772103881836,70.09614054870606,69.71500015258789,69.33385975646972,68.86227926635742,0.02,0.0,59.00229632856476,-0.006053805524634748,0.008715567947803884,70.40218026297433,70.0075923374721,1.1589045025654727
2024-07-25,0,70.33499717712402,67.7125015258789,70.98250007629395,68.07374954223633,70.5031247138977,-0.4399046665304895,1.1401712293514243,-1.3237008127267507,2.995597205220325,69.83749961853027,0.9949873733520491,0.016415468216522684,67.74650001525879,70.6922508239746,0.8699241550889039,0.03977896056342081,1.0126390501250109,1.0004586926212784,0.99483026923943,-0.006287136270195726,70.58851743950098,71.73746755025559,69.45712509155274,67.17678263284989,70.62892777579171,0.21037197511213807,70.23053550720215,0.46169928791829906,70.45100701443803,69.92980590126265,1.4810481489983573,3.8172954155340557,18821200,0.3718696374239093,1.463356985023706,638839100.0,-60.648285508413515,97.72219427934739,97.34986547195354,48.916924527703735,23.91562213627546,13.941890402278144,0.026551361436156235,0.8820872997006831,70.82024096679687,70.5048804321289,70.25,69.9951195678711,69.67975903320313,0.04,0.0,59.07255780147688,-0.011296291594709906,-0.014219403674142157,70.40645381382534,70.006167275565,1.1258766311720632
2024-07-26,0,69.77000045776367,67.7125015258789,70.98250007629395,68.86062574386597,70.5031247138977,-0.6588715533852586,1.094640784288307,-1.004208001111381,2.995608086356414,69.91499996185303,0.9140870761871355,0.015732089947646376,67.74650001525879,70.6922508239746,0.8797888678557573,0.03274352323436592,1.0027288756306498,0.9918401139020978,0.9880826978989,-0.01708166966825686,64.39445541376185,71.76940651898555,69.58012495040893,67.39084338183231,70.51535660879952,0.3892125681475657,70.23071411677769,0.46150682598450854,70.41814188033484,69.97309638880448,0.6115193190551818,1.7688493578903517,16789300,0.38072686283796264,1.2859289079143836,622049800.0,-62.0001220703125,97.72219427934739,97.34986547195354,-4.259969366856191,21.296938663523402,21.112901025915196,0.07509952221586422,0.9197952967616793,70.74000183105468,70.37500183105469,70.08000183105469,69.78500183105469,69.42000183105469,0.06,0.0,59.131004951064234,-0.013710197030686544,-0.014685071036669193,70.22839028494698,70.01328986031669,1.0497826270135748
2024-07-29,0,69.625,67.7125015258789,70.98250007629395,69.43687677383423,70.5031247138977,-0.8633024953172084,1.0413024361002874,-0.5264035497020085,2.995620066749961,69.91499996185303,0.8243621540069597,0.014947631178611547,67.74650001525879,70.6922508239746,0.8413414614036232,0.02981550491164091,0.9994491367065205,0.9895185699409682,0.9894271751872299,-0.014961282165704248,54.96664833348533,71.74597986838587,69.6633749961853,67.58077012398472,70.35035651070731,0.490075115930394,70.2089283806937,0.4834704106939424,70.25265536018698,69.93353641182645,-1.1266182731057324,0.0035840958330908166,10315300,0.39698041760262004,0.8166592049224553,611734500.0,-68.39996337890625,97.72219427934739,97.34986547195354,-20.217552766700756,20.008466455545577,19.835563159122575,0.0887633773550206,0.9090958771735306,70.74000183105468,70.37500183105469,70.08000183105469,69.78500183105469,69.42000183105469,0.06,0.0,59.16636819124748,-0.01079845937877466,-0.015971690667640245,70.05744934082031,69.993346623012,0.939994955614495
2024-07-30,0,69.39250183105469,67.7125015258789,70.98250007629395,69.57499980926514,70.5031247138977,-1.039294038243442,0.9447460712507086,0.1628271844694642,2.9956401229201655,69.91499996185303,0.7024871540069597,0.013543363080149484,67.95349960327148,70.6922508239746,0.7922635985303152,0.02820645120147894,0.9947729616845512,0.9861021650099152,0.9890960038131804,-0.015464806782667817,52.600175215118554,71.64661713868671,69.7571249961853,67.86763285368389,70.12321390424457,0.5160370577213417,70.15357126508441,0.5306455916413876,70.09443911149894,69.89614643335712,-1.6318178517105169,-0.4361508706488695,12522500,0.3997912935957323,0.9764954865594919,599212000.0,-85.5999755859375,97.72219427934739,97.34986547195354,-56.02804191269898,18.63653795865588,19.657645251915405,0.0802630229968234,0.9063029510305805,70.74000183105468,70.37500183105469,70.08000183105469,69.78500183105469,69.42000183105469,0.06,0.0,59.20811523029154,-0.020665336281450175,-0.016908175535327176,69.83522578648159,69.90645108904157,0.7827857871640431
2024-07-31,0,68.84000015258789,67.7125015258789,70.98250007629395,69.57499980926514,70.5031247138977,-1.1067334119997991,0.8268276230424981,0.9196602600850654,2.995661883408159,69.91499996185303,0.607899522781372,0.011838713965924239,68.99925098419189,70.6922508239746,0.7069183445041981,0.02481078482285439,0.9856674456784326,0.9789672844288425,0.9842792822150095,-0.024583731784313057,48.75804834387001,71.49465532619364,69.84100008010864,68.18734483402365,69.85999952043805,0.6385698139258,70.07624980381557,0.6354269657214736,69.92044598530127,69.85471661357113,-2.2399862551055314,-1.1044993800828253,22908800,0.4061588654560414,1.6972580548966905,576303200.0,-88.48689576593827,97.72219427934739,97.34986547195354,-140.16069535994689,17.232422876935626,23.591832428894776,0.01916985562725312,0.9101384078984034,70.61256161499024,70.16872148132325,69.81000137329102,69.45128126525879,69.0074411315918,0.08,0.0,59.279037681323,-0.027762048624631386,-0.02845022323679106,69.58736092703683,69.82382910592216,0.721295664482475
2024-08-01,0,69.25500106811523,67.97999954223633,70.98250007629395,69.57499980926514,70.5031247138977,-0.7796714826618073,0.7099581137785204,0.578519647908728,2.995680550326843,69.91499996185303,0.5458870983123774,0.010157149873829754,69.08525104522705,70.6922508239746,0.587783338259989,0.012650788704657752,0.9908097558281167,0.987290901775016,0.9951503559153526,-0.01535503166779184,39.939252317812965,71.31729123900114,69.8973750114441,68.47745878388706,69.68464251926967,0.6068901718054349,70.0526785169329,0.6606710057951113,69.65456629074714,69.7624420543183,-2.6067282067965536,-1.5481432275942015,17275500,0.4278255561300856,1.229841242947305,593578700.0,-50.657909596721375,97.72219427934739,97.34986547195354,-79.76432922168733,19.74487917919815,21.288730119017483,0.05728145190167409,0.9365576708348521,70.61256161499024,70.16872148132325,69.81000137329102,69.45128126525879,69.0074411315918,0.08,0.0,59.33541966848875,-0.003284680505814541,-0.011473027937179574,69.46485246930804,69.86300332205636,0.6060045516244562
2024-08-02,1,69.0099983215332,68.84000015258789,70.98250007629395,69.57499980926514,70.5031247138977,-0.0229352211158404,0.5803380314522557,-0.9299328380967995,2.9956978657971276,69.91499996185303,0.4880995178222662,0.008295150066904377,69.24075107574463,70.6922508239746,0.7309153038286242,0.002061854532052081,0.9864049246633465,0.9859416300958893,0.9947171970816766,-0.01089296447246757,42.42953247254702,71.12180115064254,69.96112508773804,68.80044902483354,69.46107128688267,0.5037226744442297,70.01446396963937,0.7061990304197551,69.5596894629966,69.73846016915557,-1.7415656465789406,-0.47423729352474525,23578700,0.35579288225725403,1.6667438349875041,570000000.0,-79.94427785416609,97.72219427934739,97.34986547195354,-143.3174831882974,16.381230523294988,22.97716108231888,-0.0465636098381684,1.048232594018549,70.4827608947754,69.95862031555176,69.53499984741211,69.11137937927246,68.58723880004882,0.1,0.0,59.407151235515,-0.018916673830245978,-0.022279334431504958,69.16000693184989,69.78109359741211,0.6958753659517941
2024-08-05,1,67.79500007629395,68.84000015258789,70.98250007629395,69.57499980926514,70.5031247138977,-0.05713105919825674,0.5882090955503388,-0.9157803310465362,2.9956969175028663,69.91499996185303,0.49219963073730355,0.008408272285427827,69.23050079345703,70.6922508239746,0.7855641443987962,-0.010857513928422463,0.9691091561560118,0.971320303311085,0.9793497938924441,-0.026283661381774626,36.24942966158513,71.13241813769491,69.95599994659423,68.77958175549355,69.09821455819267,0.6599003680764709,69.86357116699219,0.9231692703797559,69.4238427192393,69.66749870064058,-2.217497264444393,-0.7692913176351784,20770500,0.32501450682941485,1.4244707484738057,549229500.0,-84.6155439484377,97.72219427934739,97.34986547195354,-229.05356719161048,14.59286099757781,25.89457672424939,-0.05158230330347955,1.0926445947686991,70.2868822631836,69.64156253051758,69.12000274658203,68.59844296264649,67.95312322998046,0.12000000000000001,0.0,59.4620286263715,-0.029158299719011183,-0.03138437193537691,68.81385149274554,69.61015265328544,0.868026730251163
2024-08-06,1,67.97249794006348,67.79500007629395,70.98250007629395,69.5068769454956,70.5031247138977,-0.8103248851583517,0.7536461105907052,0.6260027151610608,2.9956739055323713,69.91499996185303,0.589887161254883,0.010788354287354154,68.99299850463868,70.6922508239746,0.6590681004216801,-0.03053053367030826,0.9730182100974266,0.9779089935053088,0.9871329996133643,-0.020463362085552106,24.952878888245987,71.36466717540505,69.85737495422363,68.35008273304221,68.8414284842355,0.7032281481077461,69.67839254651751,1.0259412672754848,69.01498602551621,69.4439283046444,-3.6112848550112613,-3.0218492405105875,14815100,0.41340450126216777,0.9987232068944131,564044600.0,-81.22184286202527,97.72219427934739,97.34986547195354,-161.8823914845179,13.925265249192144,24.12799253708361,-0.08752686751303247,1.088884318288196,70.2868822631836,69.64156253051758,69.12000274658203,68.59844296264649,67.95312322998046,0.12000000000000001,0.0,59.50224949381327,-0.02095676314359185,-0.02700373743199474,68.52325112479073,69.37582070486886,0.9827869254645667
2024-08-07,1,67.4000015258789,67.79500007629395,70.98250007629395,69.35812664031982,70.5031247138977,-0.7363454352230431,0.8577746015593876,-0.08785415306514777,2.995656441893328,69.83874988555908,0.6815498065948489,0.012296169031835844,68.75324993133545,70.6922508239746,0.7682040109843274,-0.031282338179001355,0.9661766739205812,0.9731868563818847,0.9828726714128021,-0.020918050893624973,27.222538610523298,71.4750490390868,69.75949983596801,68.04395063284923,68.52357155936105,0.7877896454502298,69.43696403503418,1.1383090790566601,68.75229584785455,69.27272889520283,-2.5763257931872032,-3.6739187091321526,18499200,0.4109415764598305,1.2155467930189114,545545400.0,-97.78747767729043,97.72219427934739,97.34986547195354,-194.93372584254502,12.837027334601212,27.908186285137738,-0.16849691953782978,1.0968215064786093,70.26328082275391,69.60336019897461,69.06999969482422,68.53663919067382,67.87671856689452,0.14,0.0,59.54743070400723,-0.02520384652683416,-0.03295265614261489,68.137209211077,69.09732927594867,1.1475243048043966
2024-08-08,1,67.27249908447266,67.4000015258789,70.98250007629395,69.19375038146973,70.5031247138977,-0.7271735115603473,0.9933116205104271,-0.31213627958976,2.995630132986892,69.69750022888184,0.7795121574401861,0.014267388279007405,67.95474815368652,70.6922508239746,0.7781900608506583,-0.036075641781312624,0.9662656160653122,0.9758193666319884,0.985150788148808,-0.028626120180009873,23.883294948007915,71.60774808080356,69.62112483978271,67.63450159876186,68.22071402413505,0.805373502039818,69.1719639641898,1.181843234909843,68.41155381390212,69.04570258362531,-3.195689011304982,-4.775359039243873,12489800,0.4227105262084735,0.829221462108819,533055600.0,-78.43127151479086,97.72219427934739,97.34986547195354,-150.36554064001314,11.802359366233194,26.561497894667642,-0.14124258776469673,1.1077628617599176,70.17676119995117,69.50662062072755,68.96500015258789,68.42337968444824,67.75323910522461,0.16,0.0,59.5783182302299,-0.030520149339227087,-0.014277338285470967,67.91925920758929,68.87724249703544,1.2182479798308448
2024-08-09,1,67.83749961853027,67.27249908447266,70.98250007629395,68.96749877929688,70.5031247138977,-0.6271990388894726,1.113720110438048,-0.6942693085084195,2.995603392008624,69.60499954223633,0.8971498107910151,0.01602737303017151,67.75550022125245,70.6922508239746,0.8276174062990105,-0.033232737377674494,0.9762389146341828,0.9884057592097802,0.9992266935986132,-0.016990272881039492,23.609824441139708,71.71606498436486,69.48862476348877,67.26118454261268,68.07749966212681,0.7650189936746947,68.96874959128243,1.1461884297602885,68.12640831448903,68.8507275209085,-3.0550890811567237,-5.226641760763115,13805600,0.4199491456407213,0.9115558535618298,546861200.0,-69.30457214995334,97.72219427934739,97.34986547195354,-103.5224529792614,13.077382352123312,25.01549595307679,-0.0889758192909433,1.0922082827382407,69.85587677001953,69.24705703735351,68.75499725341797,68.26293746948242,67.6541177368164,0.16,0.0,59.613978783400015,-0.007449637246912166,-0.026364918546973832,67.82096753801618,68.70416423252651,1.2616011829017122
2024-08-12,1,68.58249855041504,67.27249908447266,70.98250007629395,68.62312459945679,70.5031247138977,-0.45728094040184586,1.1698651247746132,-1.0777596852260227,2.9955898239460366,69.58500099182129,0.9836248493194575,0.016856542617189985,67.75550022125245,70.6922508239746,0.8828013623799168,-0.024552481363274963,0.9882026441562393,1.0020820950999625,1.013701752350893,0.011615878357325249,33.94135124250771,71.74098003974086,69.40124979019166,67.06151954064245,67.98142787388393,0.6212125455768772,68.8330351965768,1.0626025631361973,68.05609869452596,68.75204292681688,-1.4562761938342768,-4.025043238317289,17385300,0.44700283097145616,1.1212123459568852,564246500.0,-51.31895274164334,97.72219427934739,97.34986547195354,-43.41027292914829,18.468386576794842,22.961681015441265,-0.07909626614040109,1.1049080306333876,69.85587677001953,69.24705703735351,68.75499725341797,68.26293746948242,67.6541177368164,0.02,1.0,59.66294071323808,0.016422503298628044,0.0035057116456057233,67.66569519042969,68.56527382986886,1.2684245753234817
2024-08-13,1,68.07749938964844,67.27249908447266,70.98250007629395,68.42999839782715,70.5031247138977,-0.3371042128597163,1.1826888107157238,-1.2131167083898093,2.995586577377227,69.50875091552734,1.0213125228881836,0.017053143852147713,67.75550022125245,70.6922508239746,0.9057252166366175,-0.018953628379699987,0.981606809557633,0.9962208590973527,1.003900432783324,0.0015447637319074836,43.457075677512364,71.71850223996172,69.35312461853027,66.98774699709882,67.84821374075753,0.43636389519990804,68.65464251382011,0.9514961099810244,68.19027802098674,68.77215530675237,-0.9710526421604708,-2.6957067695133476,26557900,0.47467925532824684,1.625145485275238,537688600.0,-64.39025297965185,97.72219427934739,97.34986547195354,-79.10100563441415,16.659100808972916,26.552532234818774,-0.054154793764598606,1.1374145071149162,69.80239700317382,69.20379722595214,68.71999740600586,68.23619758605957,67.6375978088379,0.02,0.0,59.73095527029597,0.005757218463354086,0.00798926779968612,67.61868613106864,68.38934653145927,1.2842118469416512
2024-08-14,1,68.30500030517578,67.27249908447266,70.98250007629395,68.0512490272522,70.5031247138977,-0.1532989420059342,1.2068036272754499,-1.3725427153406726,2.9955803307100353,69.32375144958496,1.0573750495910645,0.017423842334852113,67.75550022125245,70.6922508239746,0.874737891531328,-0.03525117672317255,0.9861882489418164,1.0014771914221328,1.0069434306384628,0.013427281287959447,36.672316873747,71.6752318768959,69.26162462234497,66.84801736779404,67.92107091631208,0.46746582572830486,68.50964273725238,0.821527273845224,68.16491727196285,68.7409938057334,-1.3512519266266927,-3.5387852165623865,22928600,0.4513454635690011,1.3638559090152038,560617200.0,-44.25754444603538,97.72219427934739,97.34986547195354,-43.96243829484624,16.80792329509025,24.96542277008999,-0.038661460588215395,1.123313612398941,69.39747793579102,68.87625798034668,68.45499801635742,68.03373805236816,67.51251809692383,0.02,0.0,59.79211094592692,0.026154529261583237,0.013581397177029272,67.77110944475446,68.29248046875,1.2163841506568465
2024-08-15,0,73.63000106811523,67.27249908447266,70.98250007629395,68.0512490272522,70.3718729019165,0.03222312535334783,1.1850836798383595,-1.344182634411295,2.9955854295553657,69.13249969482422,1.0393752098083495,0.017138210410870717,67.75550022125245,70.6922508239746,0.8651612357735944,-0.034967509995188516,1.0648078885282688,1.0803989906673939,1.082555344098428,0.09450372842042931,39.17655881331825,71.51879206594502,69.14862470626831,66.7784573465916,68.72928564889091,2.210878677171737,68.7853570665632,1.5772201001248407,68.20234133083369,68.71123772199199,0.7522682031239779,-2.886183199575765,49567500,0.451857983422474,2.6427768630997064,610184700.0,-16.216234792769264,97.72219427934739,97.34986547195354,240.2222351413261,39.7608458067482,17.886002763439038,-0.10386046610414978,1.455934701650461,72.60628143310547,71.47186080932617,70.55500030517578,69.63813980102539,68.5037191772461,0.04,0.0,59.99674751870762,0.08158439465686618,0.09370789428275328,68.5460433959961,68.53464726039341,1.4767718198874302
2024-08-16,0,73.06999778747559,67.27249908447266,73.63000106811523,68.0512490272522,70.3718729019165,0.9949219888961944,1.501727138378247,1.105861793848094,2.9954990349183053,69.13249969482422,1.1854875946044927,0.021672719909379985,67.75550022125245,70.71250076293946,0.39912935518165465,0.03729793947769777,1.0545361772826258,1.0653427988960689,1.05460656856334,0.0771328276892449,73.37512776390432,72.29457900209832,69.2911247253418,66.28767044858529,69.53928511483329,2.639760052151575,69.03142833709717,1.9443118823134875,69.56062442351705,69.39349676903277,8.323223803015756,5.532464648166761,19872100,1.3007580207841327,1.0368320848661992,590312600.0,-12.741376432351755,97.72219427934739,97.34986547195354,198.37833703299052,37.595724529106754,18.21094469147957,-0.04353322681238128,1.4297967395017235,72.60628143310547,71.47186080932617,70.55500030517578,69.63813980102539,68.5037191772461,0.04,0.0,60.07544856544818,0.08402305273928334,0.08866922043960704,69.5074964250837,68.82235281808036,1.7514485718807968
