date,buy?,todays_price,Minimum,Maximum,25th Percentile,75th Percentile,Skewness,Standard Deviation,Kurtosis,Shannon Entropy,Median,Mean Absolute Deviation (MAD),Coefficient of Variation (CV),10th Percentile,90th Percentile,Autocorrelation,Cumulative Return,curr_to_avg_one_month,curr_to_avg_one_two_week,curr_to_avg_one_one_week,momentum,rsi,upper_band_current,middle_band_current,lower_band_current,rolling_mean_7,rolling_std_7,rolling_mean_14,rolling_std_14,ema_7,ema_14,roc_7,roc_14,Volume,Volatility,Relative Volume (RVOL),On-Balance Volume (OBV),Williams %R,Stochastic Oscillator %K,Stochastic Oscillator %D,Commodity Channel Index (CCI),ADX1,ADX2,Chaikin Money Flow (CMF),Average True Range (ATR),Fib_23.6,Fib_38.2,Fib_50,Fib_61.8,Fib_76.4,Parabolic SAR 2,Parabolic SAR 3,VWAP,Adj Close Momentum,Adj Close Return,Adj Close 7d MA,Adj Close 14d MA,Adj Close Volatility
2024-01-02,0,248.54000091552734,235.49499893188477,260.1624984741211,240.19125175476074,254.17312335968018,-0.05527992002618021,8.167321806634341,-1.4961916278299943,2.9951857349255726,249.14249992370605,7.550624847412108,0.033047131628195746,236.01324920654298,255.82824745178223,0.83882659016718,0.06582208710288212,1.0056581973365422,0.9758443817125241,0.9704045026224867,-0.024271506975584445,57.871756054809225,263.476268445422,247.14162483215333,230.80698121888466,254.51107134137834,4.061392954508797,251.05696405683244,7.175571108683334,254.4224087770669,250.48704262192496,-1.550803877895766,3.8765278932598877,104654200,3.798243119763522,0.9187933816696707,190550200.0,-45.24777450216817,40.7826645074338,41.89594136137823,2.6977088773862317,19.6942155728578,23.29100931188979,0.02615097929648675,8.197337389463662,256.4145230102539,251.02274185180664,246.66500091552734,242.30725997924804,236.9154788208008,0.02,1.0,247.00306451136032,-0.016314228346872017,-0.023889987548348476,253.59570966448103,250.88999720982142,7.642147234643722
2024-01-03,0,241.3574981689453,235.49499893188477,260.1624984741211,241.19500064849854,254.17312335968018,-0.15939745380615206,7.7601958372005315,-1.3538253312077906,2.995240840005299,250.04500007629395,7.001587371826171,0.03132042779988327,236.99424934387207,255.82824745178223,0.8194115752154849,0.05314676421015661,0.9741274903299282,0.9488525913115976,0.9469326113916341,-0.055333767087584085,52.55174864873984,263.2882665828483,247.76787490844725,232.24748323404623,252.92821393694197,6.456885246785212,251.36071395874023,6.607020148867493,252.96979445832255,250.22275056820612,-1.6063100127023426,3.1960713904843616,121082600,3.8905306787917255,1.0551575972743916,69467600.0,-72.24479339901538,40.7826645074338,41.89594136137823,-79.6799000214664,17.17144058876565,28.872016572149676,0.008401329410837903,8.550611617568904,256.4145230102539,251.02274185180664,246.66500091552734,242.30725997924804,236.9154788208008,0.04,0.0,246.67382775262487,-0.07076882989740496,-0.055793128662700094,251.3028520856585,250.99285452706474,7.428167552554203
2024-01-04,0,239.40249633789062,235.49499893188477,260.1624984741211,241.34624862670898,254.17312335968018,-0.12309513114389402,7.4348081861314474,-1.3226716228711226,2.995282365511223,250.04500007629395,6.706787338256835,0.02997472921189711,238.12424926757814,255.82824745178223,0.781530674067888,0.013096170593950789,0.9651930245848562,0.9458642452896022,0.9497988406138917,-0.07979628984957454,41.64635975619109,262.90549131122776,248.03587493896484,233.1662585667019,250.73964200701033,8.12757495130313,251.6398209163121,5.933430346899052,250.0897903980687,249.0428962879513,-4.389205974173682,1.793508629054223,102629300,4.242184496500078,0.9083363908653996,-33161700.0,-94.411712988562,40.7826645074338,41.89594136137823,-86.47801185718936,16.25063830103964,27.323781945388536,-0.01947228244265948,8.232561743769837,258.33084545898436,254.1245858154297,250.72500610351562,247.32542639160155,243.11916674804687,0.04,0.0,246.39130971281708,-0.08992506711322434,-0.07279526808042627,249.21570914132255,250.89571162632532,7.4806896229881525
2024-01-05,0,237.34249877929688,235.49499893188477,260.1624984741211,241.34624862670898,254.17312335968018,-0.1132738870385363,7.3620196075972055,-1.3144683587226127,2.9952913888374577,250.04500007629395,6.64271249771118,0.02967430048458392,239.1727466583252,255.82824745178223,0.7949055320014949,-0.010764143095641868,0.9566631171792698,0.9437321416645181,0.9573968125648653,-0.08245062450532781,37.82468838205043,262.81816400920076,248.09412479400635,233.37008557881194,248.14642769949776,9.184602618897985,250.9689279283796,6.970970235405143,247.40439767011588,247.7471933210638,-6.014389588159159,1.6592698034899989,92379400,4.17820637552285,0.8301291574516235,-125541100.0,-91.43231672045685,40.7826645074338,41.89594136137823,-100.33705677136058,15.321339883740352,28.861541710225747,0.033649526601586384,7.969544953072176,257.99572229003905,253.58214068603516,250.01499938964844,246.44785809326174,242.03427648925782,0.06,0.0,246.08892956336248,-0.06197167089229494,-0.09160800460751914,246.48428344726562,249.92714037214006,7.601982932026996
2024-01-08,0,238.2849998474121,235.49499893188477,260.1624984741211,241.19500064849854,254.17312335968018,-0.12522571900080828,7.620528194416725,-1.3749857597686368,2.9952589123576523,250.04500007629395,6.8992875480651845,0.03074518397531454,237.31874885559083,255.82824745178223,0.7893467847070792,-0.01645170151029526,0.961365927920069,0.9532620197209325,0.9780268764207365,-0.05273305279221052,35.76737633529985,263.10193113706345,247.86087474822997,232.61981835939653,245.02107075282507,8.068750024164597,250.00464194161552,7.740630692640147,244.85691427133668,246.18268130198683,-7.104835800495401,-3.806716439832344,85166600,4.198865546954438,0.7729462197817876,-40374500.0,-81.6407507947389,40.7826645074338,41.89594136137823,-82.9285707873819,15.562086044211963,26.968450294314774,0.0333419988234754,7.7959807119575455,257.99572229003905,253.58214068603516,250.01499938964844,246.44785809326174,242.03427648925782,0.06,0.0,245.8733474298368,-0.032316479867062764,-0.05028041747295931,243.48571123395647,248.99499729701452,7.692834390748359
2024-01-09,0,236.0175018310547,235.49499893188477,260.1624984741211,240.48250102996826,254.17312335968018,-0.1228739033009568,7.777553855976075,-1.4243658797415906,2.9952385981169636,250.04500007629395,7.065800056457517,0.031397882859239015,237.31874885559083,255.82824745178223,0.8117200859448138,-0.016011985360069175,0.9527995578619727,0.9495670538387831,0.9793846642088597,-0.050384240115653456,37.19714433999208,263.26460745255275,247.7094997406006,232.15439202864843,241.78499930245536,5.945505056720576,248.72089222499304,8.483515987876217,243.1869690614217,245.08589449036154,-8.409166868792655,-5.361718775282586,96705700,4.200143948453478,0.8801776561640751,-137080200.0,-91.17554425992593,40.7826645074338,41.89594136137823,-107.75764447892804,14.149374699299898,28.03919150623066,0.002043367428741331,7.847996217606026,257.32076214599607,252.48962045288087,248.58499908447266,244.68037771606444,239.8492360229492,0.08,0.0,245.52108906743968,-0.054182398978701585,-0.054410774493479384,240.88285609654017,247.7721405029297,8.158453968119874
2024-01-10,0,233.95750045776367,235.49499893188477,260.1624984741211,239.123122215271,254.17312335968018,-0.12885747689260796,8.105098588257942,-1.4866529677960105,2.9951947372824383,250.04500007629395,7.403775081634521,0.032760811987384564,236.99624977111816,255.82824745178223,0.8051469928616335,-0.02003384249445917,0.9456563176960222,0.9484164384699117,0.9810320379642047,-0.030659903948796252,34.977524946153515,263.6124468942283,247.4022497177124,231.1920525411965,239.27178519112724,4.722199002796994,247.18124961853027,9.090381292215099,241.3716319538433,244.06410946712992,-8.757296933882715,-7.076064484379656,91628500,4.2186811564846955,0.8363592484199233,-228708700.0,-92.16900636188478,40.7826645074338,41.89594136137823,-114.34342760063767,13.489222860468931,27.562158559674614,0.023395075315905844,7.5438527818815055,257.1437621459961,252.20312045288085,248.20999908447266,244.21687771606446,239.2762360229492,0.1,0.0,245.154910912234,-0.01891379561566897,-0.05828836580898578,238.8057141985212,246.10928344726562,8.527600533571722
2024-01-11,0,228.52249908447266,233.95750045776367,260.1624984741211,238.0493745803833,254.17312335968018,-0.16396557787568328,8.512383039204076,-1.4989698623533803,2.995137405093128,250.04500007629395,7.782450199127197,0.03445499863437122,235.9652515411377,255.82824745178223,0.7928761057067675,-0.013274705681235462,0.9249751048109337,0.9345434150016569,0.9642258877141352,-0.045446465345382325,33.7015067643924,264.08276568930904,247.05799961090088,230.03323353249274,236.41214207240515,4.207124874456462,245.46160670689173,10.196787642845605,239.5183557348363,243.0606941492777,-6.993638971438722,-8.435985224959387,105873600,4.162025749290165,0.9617558573977217,-334582300.0,-95.347068286902,40.7826645074338,41.89594136137823,-149.61256084410414,12.237567462294184,31.414393181950242,-0.002613395128823463,7.6286096338352385,255.746642578125,249.94168115234376,245.25,240.55831884765624,234.753357421875,0.12000000000000001,0.0,244.56254929415772,-0.04501320466004577,-0.047095809902554284,235.77714320591517,244.68642643519811,9.358660710877132
2024-01-12,0,220.36499786376953,228.52249908447266,260.1624984741211,238.0493745803833,254.17312335968018,-0.33649280056662617,9.192477641570834,-1.2143696400675454,2.995034456942003,250.04500007629395,8.265100326538084,0.03727251181325234,235.34124908447265,255.82824745178223,0.7608332732823666,-0.029607846786711828,0.8935085084091783,0.9129967255758675,0.9384222202225894,-0.07153165152826091,28.73442334988958,265.01382987115437,246.6288745880127,228.24391930487104,233.41321345738,6.785998805391753,243.170713697161,11.959451474018152,236.7927139928372,241.79900642257127,-8.05403627477178,-9.530973496365785,122889000,4.316653981956424,1.128314421892765,-457471300.0,-96.37347833525955,40.7826645074338,41.89594136137823,-182.27351186120686,10.951656397813753,36.69084565727163,-0.09103110266327806,7.828033557105415,253.80672229003906,246.80164068603517,241.13999938964844,235.47835809326173,228.47327648925784,0.14,0.0,243.64200855407398,-0.07831911100802524,-0.0800235105797609,232.98285784040178,242.14285496303015,11.110075001104919
2024-01-16,0,217.67000198364258,220.36499786376953,260.1624984741211,238.0493745803833,254.17312335968018,-0.7091864781050132,10.59342978137784,-0.39264162786401613,2.994793874773989,250.04500007629395,9.172900390625,0.04308507534215397,233.41400032043458,255.82824745178223,0.7887706166621512,-0.10687580878817442,0.8852967007605207,0.9163740882096785,0.9405456182373536,-0.08651403939387925,17.15628429821438,267.0592340973626,245.87237453460693,224.6855149718513,230.30857140677315,8.374607065090066,240.52410670689173,13.237909924077266,232.72176449065284,239.73505469041675,-8.697678946970797,-12.70512587718959,115355000,3.700666020421954,1.0817227443940403,-572826300.0,-85.4013046189598,40.7826645074338,41.89594136137823,-161.49835243568893,9.716697481823116,37.5086739467942,-0.11592802014535272,8.109569322361738,252.63380200195311,244.90310021972655,238.65499877929688,232.4068973388672,224.6761955566406,0.16,0.0,242.77275773986142,-0.08542313806123336,-0.0740241754365565,230.4085736955915,239.81214141845703,12.36880147157604
2024-01-17,0,214.52249908447266,217.67000198364258,260.1624984741211,237.01124954223633,254.17312335968018,-0.7133148656760846,12.240927410041206,-0.5522090673619231,2.994461903219186,250.04500007629395,10.685212707519531,0.05008170874480484,227.70674896240234,255.82824745178223,0.8250913434264374,-0.13549258765326816,0.8776829531350074,0.9161911778029591,0.9437587524072686,-0.09107376605472473,13.026174279991245,268.9009794233539,244.41912460327148,219.9372697831891,227.0485714503697,9.540571331954315,237.59749957493372,14.169835088677425,228.97100370368975,237.31655889335934,-9.077806074158472,-14.546221038960164,103164400,3.3819064104700125,0.982403387947274,-675990700.0,-93.33582858913961,40.7826645074338,41.89594136137823,-159.05676346514048,8.956929420076547,34.74405478192966,-0.12248083755955111,8.092783546578362,252.593682434082,244.83816091918945,238.56999969482422,232.30183847045896,224.5463169555664,0.18,0.0,241.92120967805678,-0.08260981914997456,-0.10355580874406997,227.2742876325335,236.87928553989954,13.635206209297557
2024-01-18,0,213.7375030517578,214.52249908447266,260.1624984741211,235.50250148773193,254.17312335968018,-0.6210078521337514,13.723945146877243,-0.7770534851642013,2.9941108563664107,244.94874954223633,11.811750030517578,0.05658052236297846,220.09549827575682,255.82824745178223,0.8406898901873384,-0.15538997248413586,0.8811882765342367,0.9262961207463526,0.9584319063002277,-0.08642594217515231,10.584999504255594,270.00388966814415,242.55599937438964,215.10810908063516,223.54178619384766,9.228393025366465,234.28142847333635,13.912823682813771,225.34947008556648,234.5853786887006,-9.614797102159262,-16.036517355995457,108595400,3.257576995749767,1.0379865152575904,-784586100.0,-94.43163783714311,40.7826645074338,41.89594136137823,-148.34715322590895,8.196008427793505,34.981831499834335,-0.09263691292506143,8.1417969015938,251.82196502685548,243.58902511596682,236.93500518798828,230.2809852600098,222.0480453491211,0.19999999999999998,0.0,241.0256882372231,-0.09429767174649406,-0.09822949085612416,223.19286019461495,233.33928571428572,14.94338740479661
2024-01-19,0,210.73250198364258,213.7375030517578,260.1624984741211,232.59875011444092,253.1287498474121,-0.47563490066857,14.808257240139302,-1.0303822071659052,2.993816403738949,240.37999725341797,12.561124801635742,0.06156169240863053,217.3552516937256,255.82824745178223,0.8603942165313073,-0.16349491471231842,0.8760686188279702,0.9243373207290898,0.9624092681111226,-0.07784790194445601,9.355836738548529,270.15988911406765,240.54337463378906,210.92686015351046,219.92964335850306,8.446702288079022,230.8573213304792,13.335819035637419,222.44049446157896,232.05194802618422,-10.301738175451037,-17.844614690683898,102095800,3.1627428055720714,0.9780309970028008,-886681900.0,-90.27922652075297,40.7826645074338,41.89594136137823,-137.85243333550522,7.738386768307084,34.19888601634854,-0.09095211537325351,7.943911624216661,243.9493212890625,236.99534057617188,231.375,225.75465942382812,218.8006787109375,0.2,0.0,240.18453340631038,-0.06614734045660864,-0.0929725560956494,219.94000244140625,230.41142926897322,15.561698453073014
2024-01-22,0,211.28250122070312,210.73250198364258,260.1624984741211,226.48312377929688,252.47749996185303,-0.35008267043572183,15.732197490575617,-1.1714759967594597,2.993533359564311,238.84374809265137,13.189124488830567,0.06601724159756064,214.44399948120116,255.81249923706056,0.87404746890475,-0.165737974006311,0.8866077314869579,0.9385525896106662,0.9808593580128333,-0.041215695464854374,8.720045186252989,269.76876986671033,238.30437488555907,206.83997990440784,216.6903577532087,6.226585085823637,227.98107147216797,12.863604529796394,219.5244395407664,229.39106449259793,-10.71318849290742,-18.532299699379678,117952500,3.163879326431789,1.133810879163026,-768729400.0,-94.37528008090082,40.7826645074338,41.89594136137823,-119.97557773133575,11.273692480959829,30.4492743191238,-0.06426281354284874,8.22437009377763,240.6347210083008,234.0676416320801,228.76000213623047,223.45236264038087,216.8852832641602,0.2,0.0,239.26880703328894,-0.04609619610775051,-0.08106679900531123,216.34857395717077,227.577144077846,16.64317609622543
2024-01-23,0,210.95999908447266,210.73250198364258,260.1624984741211,219.6912488937378,251.7718744277954,-0.18452710594362554,16.417342259418113,-1.308017318306324,2.9933038442289455,237.8137493133545,13.93401180267334,0.06949474186365304,213.49200286865235,255.81249923706056,0.8916696586968629,-0.1630304482467814,0.8929953733236923,0.9480954094127213,0.9876913026310307,-0.030826493490242912,10.308105634305125,269.0733094730599,236.23862495422364,203.4039404353874,214.18142918178015,3.683217681585178,225.29678562709265,12.144362534760745,217.48909099131873,227.3021122459623,-9.691930881760323,-16.00775119796735,106605900,3.1918624892207563,1.0262163058575273,-875335300.0,-92.71759461632911,40.7826645074338,41.89594136137823,-106.15356094537785,10.42989819015528,28.170258471120935,-0.14529499743958402,8.199172293260942,236.37923541259767,230.62537710571291,225.9749984741211,221.32461984252933,215.57076153564455,0.2,0.0,238.48614788122217,-0.048974599122871054,-0.044542921226126554,213.76571655273438,224.77142987932478,17.024318317758727
2024-01-24,0,209.8025016784668,210.73250198364258,260.1624984741211,216.8831262588501,249.29250049591064,-0.012635805581486336,16.854033280289034,-1.3636116541485381,2.99313761672508,236.68000030517578,14.57327453613281,0.07197510849467544,211.25025100708007,255.81249923706056,0.8909837035793123,-0.17180461399819316,0.8959610776621779,0.954616451192012,0.9884827620821491,-0.022002342067380387,8.48473759724052,267.87281646902534,234.16474990844728,200.45668334786924,212.6725011553083,2.780797033542143,223.04285730634416,11.859159671104335,215.89733688100665,225.5703592440896,-7.685238902235213,-15.120303248018097,123369900,3.050458997686525,1.1706202451520085,-998705200.0,-95.71782082835605,40.7826645074338,41.89594136137823,-100.84435740192512,9.832014802163807,27.497999763307966,-0.15180196193474468,8.02631171095442,234.10251867675782,228.78373974609377,224.48500061035156,220.18626147460938,214.86748254394533,0.2,0.0,237.5789231991654,-0.03581536122200568,-0.0549315703237199,212.1857169015067,222.58428737095423,17.308177978484082
2024-01-25,0,186.3474998474121,209.8025016784668,260.1624984741211,214.32625007629395,243.15312385559082,0.1499144069051297,16.9575595248153,-1.3243429862655454,2.9930649534058307,234.98750114440918,14.967374496459962,0.07311853623225936,210.93724937438964,255.81249923706056,0.8849531561328844,-0.178839106222974,0.8035033814532552,0.8581302979137141,0.8818970795937465,-0.12814785806547502,7.522980556120198,265.8338690496306,231.91875,198.00363095036937,208.19785799298967,9.78323951265195,219.25321469988143,14.427984773114657,214.40196711021838,223.78727082908264,-4.79318235096143,-13.073965685702735,198076800,2.97760959612874,1.7853167045989502,-1196782000.0,-95.79995551286386,40.7826645074338,41.89594136137823,-178.60385613594943,7.635677695525926,42.84127245575911,-0.2161123468167316,9.541744549656077,226.80915942382813,217.8754190673828,210.65499877929688,203.43457849121094,194.50083813476562,0.2,0.0,235.10586220194676,-0.13804983635042734,-0.15272557505388004,206.86000279017858,218.63428824288505,19.36143631872303
2024-01-26,0,184.40750122070312,186.3474998474121,260.1624984741211,213.12375259399414,239.8912467956543,-0.1467174147936948,18.75234251506031,-0.5738635239805299,2.9923405338306224,231.23999977111816,16.073236961364746,0.08208101921518654,210.639501953125,252.26199951171876,0.7451138092050348,-0.2837265134661655,0.8071714581239553,0.8682320768889068,0.8959431582030984,-0.12492140754340231,1.7068238992462874,265.96606007589696,228.46137504577638,190.95669001565577,203.8957154410226,12.71935289775634,215.47214344569616,16.15553782579735,207.40631248474497,219.02424392486128,-14.38990299572115,-22.161421581668534,107343200,5.231090008881039,0.9671416787886132,-1304125200.0,-94.78672607594532,40.7826645074338,41.89594136137823,-162.06531822936935,7.3381700328353805,41.17205495559276,-0.2572728053195764,9.170556590630595,226.80915942382813,217.8754190673828,210.65499877929688,203.43457849121094,194.50083813476562,0.2,0.0,233.83121028869348,-0.1363872100873258,-0.13512367483022905,202.24571663992745,214.76000213623047,20.017564589510556
2024-01-29,0,187.92749786376953,184.40750122070312,258.6700019836426,211.2018756866455,238.56437397003174,-0.3210071039250952,19.598276184368647,-0.5058269298247584,2.991879530459231,224.4437484741211,16.69087448120117,0.087229981571697,207.45700149536134,248.84100074768068,0.7666353744398164,-0.2870935949025723,0.8364466354722838,0.9035725185360233,0.9370138476857882,-0.11053922223562307,1.6491438366412374,263.87017755184274,224.67362518310546,185.47707281436817,200.20857184273856,13.125354742158926,211.8751790182931,16.291019639124897,201.640929874871,214.35158253077338,-14.03815357004168,-22.30321068955191,125013100,5.221263047435266,1.1205926220204212,-1179112100.0,-81.54500266964001,40.7826645074338,41.89594136137823,-131.15196207216357,10.75826520798975,38.342791346440485,-0.16075167358913964,9.099097663709754,225.05960455322267,216.46020321655274,209.51000213623047,202.5598010559082,193.9603997192383,0.2,0.0,232.55604693313055,-0.08558433963023893,-0.10019326792503196,199.2528577532087,211.22285897391183,20.004181219334967
2024-01-30,0,193.4724998474121,184.40750122070312,251.54999923706055,210.90312480926514,237.57812404632568,-0.3722076475888882,19.52709365333595,-0.7692497120711357,2.9917788975951938,219.01749992370605,16.47464948654175,0.08830334953911749,187.76949806213378,242.07574844360352,0.8165690032021936,-0.2529218905436498,0.874900795967364,0.9449713986301224,0.9876639316536117,-0.08289485832837062,9.397085890860044,260.19068728378375,221.1364999771118,182.08231267043988,197.7428572518485,12.42117106566165,208.83625030517578,15.384009663417636,198.1891667092627,210.70791939674754,-12.075562229122811,-21.133307600515955,109982300,5.413830740371872,0.9817379844496241,-1069129800.0,-79.20274482043396,40.7826645074338,41.89594136137823,-104.69485569923219,14.401735299946163,36.4577798377657,-0.1596806017588134,8.845802166368783,222.41615942382813,214.32191906738282,207.77999877929688,201.23807849121093,193.14383813476562,0.2,0.0,231.59321556512575,-0.08391509564394894,-0.08242340259737019,196.30999973842077,208.1250010899135,19.84786735758448
2024-01-31,0,188.5275001525879,184.40750122070312,248.54000091552734,210.50000190734863,236.34875106811523,-0.29170959845829914,19.102112317877904,-0.981940528437685,2.991858544683529,216.09625053405762,15.969636821746827,0.08753096525879252,187.76949806213378,239.5979965209961,0.8408281697299285,-0.22156393685228692,0.8638832078659044,0.9318317446194166,0.9799159529546467,-0.10140489915837114,20.31634467007253,256.4368496433852,218.2326250076294,180.0284003718736,194.4921428135463,11.205235242231135,205.59125028337752,14.439871522879336,196.99678289178692,208.29702917556426,-8.190479386786865,-18.02620638451508,103221400,5.767469557064582,0.9219775677200399,-1172351200.0,-85.78730799780192,40.7826645074338,41.89594136137823,-110.72778535355037,13.399882584771735,37.999534248252644,-0.19759452831841082,8.791138395679248,218.924673828125,211.49765454101563,205.4949951171875,199.49233569335937,192.06531640625,0.2,0.0,230.64617291352346,-0.0988308153969939,-0.10447550046515448,193.23714120047433,204.79285757882255,19.552139745072957
2024-02-01,0,187.88000106811523,184.40750122070312,241.3574981689453,205.72000122070312,234.47250080108643,-0.22834123080642132,18.817008656978846,-1.181652395569531,2.99187599330053,214.13000106811523,15.583199462890628,0.08742663107552268,187.76949806213378,238.39674949645996,0.8474815203259632,-0.21888691429581153,0.8729185302127686,0.9407181838966885,0.9986366350040903,0.008223889357023895,18.923460203416745,252.8660172834401,215.23199996948242,177.59798265552473,191.19500023978097,8.65809703150821,202.68821471078056,13.531979571061433,194.87536831742864,205.48531528273713,-10.769941162493925,-19.418056790779083,91843300,5.70125305049745,0.83120204429983,-1264194500.0,-80.56536376104899,40.7826645074338,41.89594136137823,-106.6162355668506,12.74157395249851,37.51003721975214,-0.14393435280767156,8.55173028436988,214.6539166259766,208.04303680419923,202.6999969482422,197.35695709228517,190.7460772705078,0.2,0.0,229.81180114855817,0.034112662547080674,-0.09127652915157007,190.33999851771765,202.052857535226,19.50151539030904
2024-02-02,0,185.9099998474121,184.40750122070312,239.40249633789062,192.23624992370605,229.8812494277954,-0.09273088781560686,18.7138910289364,-1.2788928297559077,2.9918373586809524,212.51000213623047,15.424124717712402,0.08804128761890835,187.72675094604492,237.4367488861084,0.850753432414653,-0.21521285725048156,0.8746313496476246,0.9430641060054161,0.9865582686398792,0.008147708833767808,18.84956634336303,249.98590717231372,212.5581251144409,175.1303430565681,187.78178569248743,2.8843760092875352,200.22714342389787,13.198868685514777,193.1505892266469,203.05826444875487,-10.940461754133647,-17.784900033556013,110505100,5.718666470286489,0.9965438658138509,-1374699600.0,-81.92492592830732,40.7826645074338,41.89594136137823,-101.18816644901041,11.966042467092628,37.249900680395946,-0.06266329263916538,8.425266316097488,213.2405236206055,206.89974246215823,201.7750015258789,196.6502605895996,190.30947943115234,0.2,0.0,228.81622303772178,0.025429760775494303,0.02891090531747422,187.4942844935826,199.84000069754464,19.21127396574247
2024-02-05,1,181.25249481201172,184.40750122070312,238.2849998474121,188.3774995803833,222.4043731689453,0.038871096453084855,18.507598849774944,-1.3105384642555196,2.9918403613915223,211.1212501525879,15.479300079345705,0.08818034206695602,186.30374984741212,236.1500015258789,0.8475002859988648,-0.21670159872931768,0.8635862016863803,0.931162934016831,0.960311189770576,-0.03551903328482875,18.187132814368603,246.89869798946688,209.88350028991698,172.86830259036708,187.0539278302874,3.803151627734472,197.62589291163854,13.084884601739434,191.3601879888288,201.23925887611813,-11.388091962635977,-15.635422299533083,134294400,5.719241550493926,1.1886133176532503,-1508994000.0,-85.86117821078165,40.7826645074338,41.89594136137823,-110.22163566414818,10.652946012794912,39.10839303655703,-0.04625330843396899,8.75866355292277,207.70156103515626,201.45421978759765,196.40499877929688,191.3557777709961,185.1084365234375,0.2,0.0,227.50524039594862,-0.05169431464834218,-0.011950900089529332,187.2699977329799,197.06500026157923,19.032618256823714
2024-02-06,1,181.4775047302246,181.25249481201172,238.2849998474121,187.91562366485596,218.34375095367432,0.1453710517714903,18.383494979284254,-1.2706350707064298,2.9917999276181737,210.84625053405762,16.090700607299805,0.08877527403144035,185.7597499847412,234.16350059509278,0.8208080104002365,-0.2393457627291758,0.8763684615532753,0.9469276745279774,0.9683525857027526,-0.06199845004663562,15.787739477921932,243.8459900501212,207.07900009155273,170.31201013298426,186.63535690307617,4.274932421775602,195.2655361720494,12.779375905957359,188.84957448695366,198.94091327254722,-2.7341418798601325,-16.730604511304023,122676000,5.667637267137692,1.0680521034534651,-1386318000.0,-76.4197018421089,40.7826645074338,41.89594136137823,-88.33845520702552,11.336912004775838,36.013739483356446,-0.03502730452644172,8.804815444004092,207.70156103515626,201.45421978759765,196.40499877929688,191.3557777709961,185.1084365234375,0.2,0.0,226.43181707965275,-0.03387436900896024,-0.030534681799132365,187.53428431919642,194.89000047956193,17.856794139590114
2024-02-07,1,187.0574951171875,181.25249481201172,236.0175018310547,187.49687576293945,215.30937480926514,0.22342641140446526,17.71909326399962,-1.2709831865790295,2.9919853036728057,210.2675018310547,16.094512863159178,0.08675681808412064,184.11450157165527,229.06599922180177,0.81650975351294,-0.23108454533117942,0.9158771746026668,0.9912930543973438,1.011069674766787,-0.007797297657957669,16.484705459356775,239.67681186369265,204.23862533569337,168.8004388076941,186.5110707964216,4.243636931136809,193.35982131958008,11.761657788905788,187.00230406615464,196.64451780976086,-1.5888705562860095,-15.403976037607086,111535200,5.711787493545742,0.964828690122511,-1274782800.0,-70.62396631442014,40.7826645074338,41.89594136137823,-65.24106946454937,13.46517077464914,33.82860858752135,-0.01002296201243954,8.679285928299008,207.70156103515626,201.45421978759765,196.40499877929688,191.3557777709961,185.1084365234375,0.02,1.0,225.58076047804673,0.0015484465551707238,-0.02093008290351385,187.0557141985212,193.15428597586495,16.62626073147488
2024-02-08,1,188.93999862670898,181.25249481201172,233.95750045776367,186.87999629974365,213.93375205993652,0.31138679297135663,16.499644622495758,-1.27735859784416,2.9924116286431475,201.63750076293945,15.364625549316406,0.08176616045713599,184.11450157165527,221.18074798583984,0.8112783739543311,-0.2004637818783802,0.9363170297267723,1.0134852390945095,1.0228703034231519,0.005641886057949463,27.781180001526096,234.78991424499154,201.790625,168.79133575500848,185.86357062203544,3.228883374114773,191.80321393694197,10.677719969935328,187.00636558461866,195.11825182192473,-0.4629459533445737,-12.482604855784055,83034000,6.015541332785613,0.7209607704835184,-1191748800.0,-65.99672786584534,40.7826645074338,41.89594136137823,-49.593174549583765,14.35040470079838,32.049579394924024,-0.008900604498434463,8.484316336056395,207.70156103515626,201.45421978759765,196.40499877929688,191.3557777709961,185.1084365234375,0.04,0.0,225.00556511530473,0.0037064330508311816,0.012120264583452316,186.76571437290735,191.53785705566406,14.957532889308503
2024-02-09,0,191.83749771118164,181.25249481201172,228.52249908447266,186.87999629974365,211.8962516784668,0.3438342233087918,14.956382251882065,-1.4205170096777395,2.9929433204553506,191.20624923706055,14.1737255859375,0.07495440010696788,184.11450157165527,217.93950157165528,0.8066911814586494,-0.17321051807302404,0.9613999105401326,1.027598583182644,1.037365990108486,0.031883695705634985,32.15339874140303,229.45251441221143,199.53974990844728,169.62698540468313,186.33642741612024,3.863941350281883,190.4142851148333,9.096613762638531,187.46417539147873,194.066858860747,-2.342710837084246,-10.341310975667705,84476300,6.047442951463326,0.7403613188088319,-1107272500.0,-54.33067643669727,40.7826645074338,41.89594136137823,-27.608126073961678,15.998507680191214,30.71331680536069,0.03477871214175399,8.201021480811882,206.05895404052737,200.1255141296387,195.32999420166016,190.53447427368167,184.60103436279297,0.06,0.0,224.49312847635196,0.030120821413462062,0.024939143803058044,187.66285923549108,190.4500002179827,13.477965156563291
2024-02-12,1,190.5625,181.25249481201172,220.36499786376953,186.87999629974365,211.04062461853027,0.37443424145917104,13.464588508584699,-1.5710581129239243,2.993430398797596,190.3887481689453,12.7428507232666,0.06810426882153597,184.11450157165527,214.83724937438964,0.8252768228048185,-0.12945567775796998,0.9638705051423897,1.0167224046504988,1.0239075284562793,0.051364838854462525,39.084503539970044,224.63467685695213,197.7054998397827,170.77632282261328,186.71964154924666,4.1639195259755235,188.9573208945138,6.927682174747001,188.53193510388343,193.54013345923738,1.7557107349934349,-9.203319440642872,95498600,5.966307598287101,0.8471300012339006,-1202771100.0,-65.21736492210005,40.7826645074338,41.89594136137823,-35.32190959905319,14.922688220372768,30.633756278892566,0.0338553155389396,8.145802065557419,203.8280754394531,198.32095526123044,193.8699951171875,189.4190349731445,183.91191479492187,0.08,0.0,223.89198792870084,0.03904787042720903,0.0011707797159045824,187.55857413155692,188.94928632463728,12.660004989018727
2024-02-13,1,184.34500122070312,181.25249481201172,217.67000198364258,186.87999629974365,210.7893762588501,0.5209303827065526,12.488120407363745,-1.442549456539304,2.993727255271017,189.7512493133545,11.519988346099854,0.06364496365671014,184.11450157165527,213.8160026550293,0.8067062345707842,-0.12453485430518647,0.9395033456011183,0.982168912671967,0.9806889318734374,0.01580083710507929,38.40750498143034,221.1916157613217,196.21537494659424,171.23913413186676,186.49607031685966,4.25564063421987,187.13892800467355,3.555779013621349,189.02973616060646,193.04820522417344,1.4277724699992071,-9.668894185150751,86759500,5.959778767389779,0.7794952397821947,-1289530600.0,-57.79856117164582,40.7826645074338,41.89594136137823,-64.76364293612342,14.097725435061367,33.68792104733383,0.005210309065204731,7.989828886866347,191.32139916992188,188.2042982788086,185.68499755859375,183.1656968383789,180.04859594726562,0.08,0.0,223.27662418467244,-0.005834693654470535,0.016348209178061616,187.00285993303572,187.24857221330916,11.613449438751005
2024-02-14,1,186.56250381469727,181.25249481201172,214.52249908447266,186.2381248474121,210.03500175476074,0.7016168085039554,11.71353916089685,-1.2204972970024381,2.993943382406655,188.73374938964844,10.374275665283198,0.06020864481610553,184.05825157165526,211.5280014038086,0.7730900768252791,-0.1406728804323994,0.9589480492522986,0.9988409001295958,0.9894669290082483,-0.0026461987111510155,32.9669351073769,217.97620323024094,194.54912490844725,171.12204658665357,187.254643031529,3.5857162147481727,187.1542854309082,3.5525607397973777,187.90859964822369,191.85756556756638,-0.8418044365518133,-12.13403093580772,81203000,6.045245087473025,0.7368420145224199,-1208327600.0,-35.831342901699124,40.7826645074338,41.89594136137823,-45.248611770248196,14.893726347710539,31.93810055428436,-0.004026598345196042,7.810429115104171,191.32139916992188,188.2042982788086,185.68499755859375,183.1656968383789,180.04859594726562,0.08,0.0,222.75410381705882,0.006024122357298323,0.019502974021150105,188.09571838378906,187.68285805838448,10.534587702110233
2024-02-15,0,194.8375015258789,181.25249481201172,213.7375030517578,186.2381248474121,197.55500030517578,0.932989671250699,10.885546305130033,-0.786298999480258,2.994170238846174,188.2274990081787,9.108075599670405,0.05635766448142879,184.05825157165526,210.99224929809571,0.7439144801666359,-0.1271419327401797,1.008730864910338,1.0442431730979949,1.0338976820947279,0.031213628358395917,37.073860768562966,214.92221775521858,193.15112514495848,171.3800325346984,189.1632140023368,3.5536384775540073,187.89928545270647,3.99793771009331,187.6111670001224,191.0637395217532,2.929619814719179,0.11537797258412862,120831800,6.103144460636364,1.090383190030348,-1087495800.0,-1.6621869427993232,40.7826645074338,41.89594136137823,38.235971376901674,24.045377633380458,28.442993032945193,0.060283955202625174,8.129103501381204,194.77468243408202,190.99766091918946,187.94499969482422,184.89233847045898,181.1153169555664,0.1,0.0,222.20827544230303,0.05744882638691906,0.06861069938990061,190.28857421875,188.91142926897322,9.736321478200027
2024-02-16,0,200.6449966430664,181.25249481201172,211.28250122070312,186.2381248474121,193.8137502670288,1.0983139708955745,9.826206730766614,-0.2622139923053681,2.994448453243881,188.2274990081787,7.785075492858891,0.05112327573981452,184.05825157165526,210.7552516937256,0.7006393426468425,-0.0754273797736121,1.0439053207663758,1.0713737282411606,1.0580923579143209,0.045911247993574156,49.94297487443099,211.8585385301978,192.20612506866456,172.55371160713133,191.1042856488909,5.428214027977756,188.80767822265625,5.252731531192499,189.42499447784476,191.22311318508574,7.361792204226414,5.655952299192492,111173600,6.459324575820875,0.9991354796690333,-976322200.0,-11.43466193875461,40.7826645074338,41.89594136137823,79.36858305446556,24.873159103589558,26.93782728753719,0.02465713411034321,7.9569461688117045,196.5242373046875,192.41287677001952,189.08999633789062,185.76711590576173,181.65575537109376,0.12000000000000001,0.0,221.79110666565262,0.032959597988428735,0.054811139077150746,192.05571637834822,189.5557152884347,8.76513716123909
2024-02-20,0,194.40500259399414,181.25249481201172,211.28250122070312,186.2381248474121,193.8137502670288,1.1693380979318637,9.093917742009962,0.14876027490658483,2.9946266402695447,188.2274990081787,7.092524909973145,0.04743784421070718,184.05825157165526,209.9182514190674,0.6061504176297007,-0.05034730522488898,1.0141013464673931,1.029950732595563,1.0157505306848091,0.02016400180515121,56.223931621497265,209.88958528565567,191.70174980163574,173.51391431761581,191.88500050136022,5.4579762652539205,188.87428556169783,5.321891066476674,192.21142404683064,192.0694692283059,7.2638102618484375,6.767236792838009,104545800,6.623327688021339,0.9452650130479842,-1080868000.0,-33.416201840808036,40.7826645074338,41.89594136137823,33.099789989853704,22.471673745722722,31.716500545769442,0.053680987950005456,8.165556666907342,196.5242373046875,192.41287677001952,189.08999633789062,185.76711590576173,181.65575537109376,0.12000000000000001,0.0,221.30200951779065,0.029926058990592086,0.0009814908065738787,192.6557159423828,189.7107151576451,7.826398666596815
2024-02-21,0,194.88000106811523,181.25249481201172,210.95999908447266,186.2381248474121,193.70562553405762,1.3252930527297475,7.948729613901292,1.0490523086670533,2.9948800143325665,188.2274990081787,5.99548749923706,0.04164737566790443,184.05825157165526,201.56074714660645,0.48760669149442804,-0.0784745760443882,1.0210739336825805,1.0253226539311289,1.01416014806502,0.057148280548162456,49.02869619258955,206.75533409810288,190.8578748703003,174.9604156424977,192.31964383806502,5.573484809662713,189.32803562709265,5.555722827187954,192.7373235203704,191.7903741827064,2.892454751247474,0.4819820632479952,103844000,6.742892633907351,0.9400933982664437,-977024000.0,-29.829519900904483,40.7826645074338,41.89594136137823,70.87899838788688,21.715854724133088,29.586944888062288,0.07341221316947738,8.116404402928701,196.5242373046875,192.41287677001952,189.08999633789062,185.76711590576173,181.65575537109376,0.12000000000000001,0.0,220.85942965018185,0.058417561952033736,0.03529473883650069,192.827144077846,190.24500165666853,6.651169948277628
2024-02-22,0,195.27250289916992,181.25249481201172,209.8025016784668,186.2381248474121,193.70562553405762,1.2961285311286759,6.56810411731216,1.849722122491344,2.9951434738221505,188.2274990081787,5.001150131225586,0.03455916970052214,184.05825157165526,195.45650062561035,0.2521581659258588,-0.07112641885091088,1.0274586768121696,1.0201938697223123,1.0051810495103073,0.04668676130721239,49.877177045933145,203.19008320410674,190.05387496948242,176.9176667348581,192.99250139508928,5.610185063258212,189.85607147216797,5.755232474327558,193.23393341996925,191.57655760067902,1.5859794843207315,3.369535431375179,92739500,6.749096690204353,0.851369062353848,-884284500.0,-20.454523287531785,40.7826645074338,41.89594136137823,100.19925910618937,20.34859693241236,28.257832845147504,0.14236664440322788,8.032378114575417,196.5242373046875,192.41287677001952,189.08999633789062,185.76711590576173,181.65575537109376,0.12000000000000001,0.0,220.48142025374648,0.046102467482996845,0.07276382501232355,194.1528581891741,190.85571616036552,5.521896386057384
2024-02-23,0,194.0875015258789,181.25249481201172,200.6449966430664,186.2381248474121,193.70562553405762,0.3549840492285961,4.947067875360333,-0.4881169282663742,2.9953918521322596,188.2274990081787,4.129350204467772,0.02612970192272997,184.05825157165526,194.91925125122071,0.6205923614219049,0.047894407271715046,1.025142304405763,1.00966947404915,0.9902019335389546,-0.0038493616173803646,58.29241800328609,199.22151078123827,189.32737503051757,179.43323927979688,194.38428715297155,4.117146089091882,190.4401787349156,5.7388828432184384,193.69387643803333,191.55939903716938,2.471631564011766,3.934693309041744,78841900,4.123108262041905,0.7656924814578495,-963126400.0,-39.77271126321733,40.7826645074338,41.89594136137823,60.6490788032243,19.21248465531031,26.680128449787823,0.1762312966499851,7.889963798068661,196.5242373046875,192.41287677001952,189.08999633789062,185.76711590576173,181.65575537109376,0.12000000000000001,0.0,220.14344646203398,-0.042304793497845106,0.017275154421349397,195.28857203892298,191.14571598597936,5.270467471971144
2024-02-26,0,196.36749649047852,181.25249481201172,200.6449966430664,186.39937782287598,194.16687679290771,0.16464998410370082,5.0012667301108005,-0.6474393709465587,2.995385202564869,188.73374938964844,4.2570627784729,0.026362086305235958,184.05825157165526,194.91925125122071,0.6280678829467027,0.052492443317642135,1.03506914735388,1.0188021675090624,1.0026013517036456,-0.0213187481579582,57.090595757381635,199.7169085746625,189.7143751144409,179.7118416542193,195.78500039236886,2.262896121708405,191.51982171194894,5.280973440603341,193.81377032041937,191.93555530137436,5.284927847602323,4.398634653960831,111747100,4.103283314754015,1.0829435644808358,-851379300.0,-14.466633252686867,40.7826645074338,41.89594136137823,109.6933634841184,21.31179079446756,24.3171298461108,0.23009979898175986,8.029146380530284,197.0198387451172,193.2150791015625,190.13999938964844,187.06491967773437,183.26016003417968,0.02,1.0,219.74982026255097,-0.0027507029765054813,-0.005238229322741788,196.81571306501115,192.4557157244001,5.3707537794286635
2024-02-27,0,201.90749740600586,181.25249481201172,200.6449966430664,186.93374729156494,194.51312732696533,-0.024090627054802916,5.045802301378165,-0.7125034377558848,2.99538062794656,189.7512493133545,4.324375152587891,0.02651326433509459,184.05825157165526,195.3820022583008,0.646512295113245,0.04491092960130412,1.060926792256749,1.0450887909083217,1.0354097842748677,0.03859208719890983,58.91262947940424,200.40397948068602,190.3123748779297,180.22077027517338,196.79499980381556,3.1667732538551405,192.97910690307617,5.112543672497467,194.47537790187226,192.40807206655168,5.25560735694244,8.339196486174444,108645400,4.0645600259412245,1.0613020955083383,-742733900.0,-24.989395501354092,40.7826645074338,41.89594136137823,138.92878123340373,23.358889424470682,22.69732478635619,0.14766963040992517,7.979244189004142,200.0563648071289,196.62682400512693,193.8550033569336,191.08318270874022,187.65364190673827,0.02,1.0,219.43839642462706,0.030811320138081966,-0.0011002811906023764,196.71285574776786,193.50071498325892,5.7060136529313175
2024-02-28,0,201.54999923706055,181.25249481201172,201.90749740600586,186.93374729156494,194.848126411438,0.052959485743536726,5.604416231866828,-0.7025199558370319,2.9953019153483935,191.19999885559082,4.75987491607666,0.02934074599546764,184.05825157165526,196.7952465057373,0.647901987539248,0.04359791476952158,1.0551727581146244,1.0371479522000577,1.0256840830026317,0.03422618089279461,63.79413320078975,202.22020731877518,191.0113748550415,179.80254239130784,196.92428588867188,3.362569869255511,194.01428576878138,5.2855951686087295,196.3279478678049,193.33945866741752,3.628662770133036,11.25758958728877,99806200,4.064229847207253,0.979826401843962,-842540100.0,-15.155436291484921,40.7826645074338,41.89594136137823,130.47924836358064,21.891206546709682,21.271209256864562,0.18641942251090587,7.898276300045082,200.0563648071289,196.62682400512693,193.8550033569336,191.08318270874022,187.65364190673827,0.02,0.0,219.17246866949915,0.037326019685772316,0.04273327319383663,197.0114266531808,194.53357151576452,6.170300573834339
2024-02-29,0,202.4474983215332,181.25249481201172,201.90749740600586,186.93374729156494,194.9781265258789,0.10346920978808252,6.041244879236291,-0.8912224092991314,2.9952345954514428,191.19999885559082,5.163749885559082,0.031560938246949916,184.05825157165526,200.73549690246583,0.7230477621648778,0.06907479849853565,1.0576351597227645,1.0326240706683945,1.0233045326263217,0.03674350108611102,65.50117402534286,203.4977395829965,191.41524982452393,179.33276006605135,198.0732138497489,3.7139398620873996,194.97910717555456,5.515893614927689,197.60365170758794,194.1461715539798,0.45104667902787415,7.747620115833265,85907000,3.8684638995890595,0.8506032231076697,-756633100.0,-15.836527674655828,40.7826645074338,41.89594136137823,114.67217274207137,20.50949808182621,19.928633194380016,0.22118161075761858,7.8210660951784785,200.0563648071289,196.62682400512693,193.8550033569336,191.08318270874022,187.65364190673827,0.02,0.0,218.9492277169056,0.022643235589793642,0.03650459749646797,198.17142813546317,195.41357203892298,6.433111500058869
2024-03-01,0,201.54500198364258,181.25249481201172,202.4474983215332,186.93374729156494,195.54625129699707,0.014076390220797342,6.456066469216371,-1.03476987906751,2.9951674760698346,192.96249961853027,5.528750038146972,0.0336058740869684,184.05825157165526,201.58574905395508,0.7490519585932383,0.07753617825527143,1.0491056732168678,1.0197581573418675,1.011406536811312,0.03842339356802582,66.86499251223317,205.0233826714039,192.1112497329712,179.1991167945385,199.02535683768136,3.6118039557074697,195.67250033787317,5.697747316967523,198.79036610400368,195.10596782268712,4.136979820594146,7.149094841220544,82099200,3.855808985860307,0.8168409775204366,-838732300.0,-12.601132489000772,40.7826645074338,41.89594136137823,103.31352095279617,19.35020573395702,18.802174035137654,0.20854105708133563,7.691003396431533,200.0563648071289,196.62682400512693,193.8550033569336,191.08318270874022,187.65364190673827,0.02,0.0,218.74140257136662,0.05558159140020158,0.02649306332262092,199.29571315220423,196.0614286150251,6.721192017033328
2024-03-04,0,193.33499908447266,181.25249481201172,202.4474983215332,186.93374729156494,197.4368715286255,-0.14198145101369275,6.690932255152987,-1.1116013613178117,2.9951288357822703,194.24625205993652,5.720550212860107,0.03470499554101155,184.05825157165526,201.58574905395508,0.7685048746336779,0.08409984481234514,1.002803499614073,0.9749093241943962,0.9629987539974817,-0.015442970248148447,65.8804847578728,206.17636428905354,192.79449977874756,179.4126352684416,198.7485705784389,4.000640597232484,195.87053598676408,5.552816148624187,199.46302921271587,195.85239776404163,3.4200538172194315,5.060274653433991,134334900,3.823161266047012,1.3208980914097361,-973067200.0,-74.329513115475,40.7826645074338,41.89594136137823,-20.421682011532507,16.66714742377742,26.455090352993725,0.11278748675940363,8.284789126059941,200.0563648071289,196.62682400512693,193.8550033569336,191.08318270874022,187.65364190673827,0.02,1.0,218.20981104497508,-0.05646938240470267,-0.019951043427099996,197.97142682756697,196.06214250837053,6.711346255094725
2024-03-05,0,181.4875030517578,181.25249481201172,202.4474983215332,188.4693727493286,197.4368715286255,-0.266821364659924,6.501964158515281,-0.9037881975871063,2.9951638515694903,194.24625205993652,5.329100189208987,0.03366002599967475,184.05825157165526,201.58574905395508,0.7171847193947296,0.0666611749813014,0.9395428708012403,0.9185531563618933,0.9067257391507952,-0.10113539426020657,52.01511760775233,206.16967805763116,193.16574974060057,180.16182142357,196.9485707964216,7.632929145817505,195.66642897469657,6.040182260991949,197.9398139791687,195.5251843166716,-0.9922051420100386,1.4549027665320597,119660800,4.158750539091193,1.1851360020141037,-1092728000.0,-88.69069458794723,40.7826645074338,41.89594136137823,-150.64600704589577,15.163769937252347,31.8770755432662,0.09115300921591496,8.449564073480428,198.98492639160153,194.8925465698242,191.5850067138672,188.27746685791016,184.1850870361328,0.04,0.0,217.57265085099777,-0.09507830892000857,-0.09358068693325725,196.3671417236328,195.8278568812779,6.742854784768644
2024-03-06,0,177.95249938964844,181.4775047302246,202.4474983215332,188.4693727493286,197.4368715286255,-0.25688665708732883,6.480601051062431,-0.9179067343467464,2.9951677206787855,194.24625205993652,5.314999694824218,0.033547390591261946,184.0592514038086,201.58574905395508,0.553462366699926,5.509399938061817e-05,0.9211864696928292,0.9065887843006923,0.9075828853793173,-0.11708012868636641,37.61854135630572,206.13870225471274,193.1775001525879,180.21629805046305,194.31785692487443,10.5010962705088,195.05142865862166,7.337449332968229,193.84436329003833,193.7760995437806,-6.491916468119951,-1.5500817217843805,107920900,5.008440055253368,1.0767299907058983,-1200648900.0,-91.09719271845054,40.7826645074338,41.89594136137823,-182.12412619412257,14.139801463402579,33.040888392949,0.03373356889019718,8.408523678855031,198.07160394287106,193.41420260620114,189.6500015258789,185.88580044555664,181.22839910888672,0.06,0.0,216.9602950055654,-0.12621263535624072,-0.11610675881173492,193.10142735072546,194.9585702078683,7.528502950086981
2024-03-07,0,176.68499755859375,177.95249938964844,202.4474983215332,188.4693727493286,197.4368715286255,-0.44348863639058567,6.834666311811646,-0.5648835006207555,2.9951016396403785,194.24625205993652,5.52650001525879,0.035412549482784654,184.0592514038086,201.58574905395508,0.6147950126107659,-0.048674851129782204,0.915460379989041,0.9079615130071844,0.923343430982215,-0.12725521913845872,32.43582381013031,206.67058250918237,193.00124988555908,179.33191726193579,190.71464266095842,11.71943651142088,193.754821232387,8.830190652030112,189.8717027465761,191.69775481930682,-9.377823433076658,-4.615077654404066,102129000,4.886079688046606,1.0237477624406794,-1302777900.0,-84.48277264075989,40.7826645074338,41.89594136137823,-160.41120457728067,13.358218395567286,31.214540337001807,0.04148499782163215,8.259566532025927,198.07160394287106,193.41420260620114,189.6500015258789,185.88580044555664,181.22839910888672,0.06,0.0,216.40039190991598,-0.1150684090770292,-0.1157691554489565,190.08999851771765,193.40142713274275,8.112147795759972
2024-03-08,0,178.56749725341797,176.68499755859375,202.4474983215332,188.34562492370605,197.4368715286255,-0.5840722104863335,7.615003958786792,-0.5715060464597941,2.99494315761507,194.24625205993652,6.148849868774414,0.039562032980820776,181.13400268554688,201.58574905395508,0.6903931113459105,-0.06486186703286469,0.9277070969202551,0.9264851120818453,0.9590039637195966,-0.11400681983713723,30.62515178252557,207.712632925203,192.4826250076294,177.2526170900558,187.43142809186662,11.392708610811281,192.17785699026925,9.454361369332243,186.5529470657672,189.65045517962886,-12.49210661885102,-9.316740270801557,85315300,4.8564834171428055,0.8542294144851927,-1217462600.0,-94.85893755808742,40.7826645074338,41.89594136137823,-138.24802329937043,14.77030120008442,29.026114233379072,-0.007679663888697782,8.243044707647936,198.07160394287106,193.41420260620114,189.6500015258789,185.88580044555664,181.22839910888672,0.06,0.0,215.94617603447807,-0.13472168937023987,-0.13146427532695892,186.27571323939733,191.64356994628906,8.970633087196227
2024-03-11,0,177.7224998474121,176.68499755859375,202.4474983215332,186.00812816619873,197.4368715286255,-0.5248562174192982,8.171495717893562,-0.9072298969450387,2.994818926706791,194.24625205993652,6.7711999511718775,0.042567855017043285,178.50599746704103,201.58574905395508,0.7638809745872961,-0.06917313151020216,0.9258116100097892,0.9295863461617672,0.9786184920840707,-0.08075361062918085,32.75598668359838,208.30699137475196,191.96399993896483,175.6210085031777,183.89928545270647,9.662742520416527,190.98624965122767,10.175848161988325,184.55552826057442,188.10509357445224,-11.402878725199523,-11.003264351975238,85391500,4.822687201164249,0.8546008171557675,-1302854100.0,-87.24136001213049,40.7826645074338,41.89594136137823,-110.96043110060184,13.850950138010543,26.978995511235095,-0.051205189968491015,8.230596965233804,198.07160394287106,193.41420260620114,189.6500015258789,185.88580044555664,181.22839910888672,0.06,0.0,215.51238197719508,-0.05511850298091403,-0.12272994074267624,182.83142743791853,190.50142778669084,9.495444741274866
2024-03-12,0,176.7874984741211,176.68499755859375,202.4474983215332,183.6306266784668,197.4368715286255,-0.40219361062114617,8.741594560377436,-1.218844614661554,2.9946807052333226,194.24625205993652,7.618099822998045,0.045705712345925964,177.92949943542482,201.58574905395508,0.7925927398264144,-0.06737946947897876,0.9243392033117954,0.93380255184509,0.9905004905142055,-0.02589712513867326,32.27114552626378,208.74143916653122,191.25825004577638,173.77506092502153,180.36249923706055,5.942162388215446,189.69392803737097,10.774558418036404,182.83980883898795,186.64359953408524,-12.213042235203178,-8.581313507360028,87391700,4.820936998776868,0.8781814049935786,-1390245800.0,-84.54356960931248,40.7826645074338,41.89594136137823,-110.83350845435687,12.992537473555922,27.416950114063457,0.005885170325184761,8.143561149919904,197.76716552734374,192.92142517089843,189.0050048828125,185.08858459472654,180.24284423828124,0.08,0.0,215.05505014429562,-0.017705057595299833,-0.05634105526684106,179.24571228027344,189.27071271623885,9.954088799126446
2024-03-13,0,171.93249893188477,176.68499755859375,202.4474983215332,180.75750160217285,197.4368715286255,-0.3005681415416924,9.29446221879156,-1.4345877931653608,2.9945363553813453,194.24625205993652,8.444599914550782,0.048772034456090636,177.628999710083,201.58574905395508,0.8144486284196948,-0.04099651575327487,0.9022036525226641,0.9203701097680326,0.9683992068399853,-0.0338292548765059,32.84659437972367,209.15842440706555,190.56949996948242,171.9805755318993,177.30499921526228,2.8634702506635965,188.0267848968506,11.617695909571504,181.32517853931932,185.5454405696641,-12.28385882351516,-9.283919588891205,106524500,4.642340684976697,1.059917272832245,-1496770300.0,-99.09464548549306,40.7826645074338,41.89594136137823,-132.20170664701246,12.032716132795336,28.2620004482412,-0.0309525756897879,8.161270407718531,196.99780322265622,191.67610144042968,187.375,183.0738985595703,177.75219677734376,0.1,0.0,214.44291473416956,-0.039990924589823895,-0.062299487791323,176.57999747140067,187.2757121494838,10.93998390688101
2024-03-14,1,165.48749923706055,171.93249893188477,202.4474983215332,178.4137477874756,197.4368715286255,-0.35617372388043594,10.071321837473073,-1.3960957657758908,2.9943167178371706,194.24625205993652,9.189350051879881,0.053021223974919304,176.77724838256836,201.58574905395508,0.8109088040210807,-0.07841878503808951,0.8712212660556766,0.9001407414427156,0.938462284159032,-0.06337549014493882,27.221226600303382,210.09151852998767,189.9488748550415,169.80623118009535,175.01928438459123,4.739642965475033,185.98392759050643,12.912374939668808,179.00357010736553,184.45653746152706,-11.070163319594622,-11.952529731918734,126325700,4.700895246229214,1.229342034876043,-1623096000.0,-95.58659352105688,40.7826645074338,41.89594136137823,-151.53497820199078,10.928077337798316,33.108151546792165,-0.10573481403308423,8.340753882743249,194.9587633666992,188.37562167358396,183.05500030517578,177.73437893676757,171.15123724365233,0.12000000000000001,0.0,213.6267839233241,-0.09040019282531975,-0.07952868369818643,173.97428240094865,185.17071206229073,12.536516014879757
2024-03-15,1,163.16749954223633,165.48749923706055,202.4474983215332,177.89499950408936,197.4368715286255,-0.46234947896227235,11.387084939708979,-1.1767842176023533,2.9938963031756742,194.24625205993652,10.453850326538088,0.06028257723562235,176.20974769592286,201.58574905395508,0.8096207803664733,-0.15063836304080302,0.8637994223787374,0.9057300781549181,0.9372083246355721,-0.08624188583057979,18.440332646790427,211.6692945055776,188.89512462615966,166.12095474674172,172.90714154924666,6.263895417740716,183.61249923706055,13.871725579692042,175.64605059707267,182.6675678573267,-8.816036115794859,-14.73562288347812,96971900,4.345956464789756,0.9547692705009595,-1720067900.0,-93.21354617347637,40.7826645074338,41.89594136137823,-137.13369250491954,10.49774683178124,31.80440458673528,-0.14924426316294984,8.059239786288268,194.9587633666992,188.37562167358396,183.05500030517578,177.73437893676757,171.15123724365233,0.12000000000000001,0.0,212.99887494179092,-0.06712666396428113,-0.08441078694356666,172.12142726353235,182.6114273071289,13.375935468561902
2024-03-18,1,171.11000061035156,163.16749954223633,202.4474983215332,177.48874950408936,197.4368715286255,-0.39481867352875677,12.58920860586826,-1.203808162344497,2.993450513763502,193.71125030517578,11.601462745666504,0.06720996968372937,171.28799896240236,201.58574905395508,0.8207168386512314,-0.1867851066702648,0.913504439686857,0.9704927407346545,1.0005291876319862,-0.037206877253796566,13.9115743052553,212.49004173871407,187.31162452697754,162.133207315241,172.1107134137835,6.0544164311207505,181.41267803737097,13.17158522326453,172.5140442115387,180.5558279112078,-8.308396846418308,-16.90707349311855,108214400,3.98634834486266,1.0670154810541952,-1611853500.0,-70.32818484150826,40.7826645074338,41.89594136137823,-80.4939164459186,17.751819869315216,28.73082991227909,-0.10087669790782794,8.281076342014472,194.72956103515625,188.19021978759764,182.90499877929688,177.6197777709961,171.0804365234375,0.12000000000000001,0.0,212.43009808752666,-0.022332233364963372,-0.008782897902912885,171.42857142857142,180.75928497314453,13.289455606607191
2024-03-19,1,170.9800033569336,163.16749954223633,202.4474983215332,176.76187324523926,195.54625129699707,-0.19882886802553545,12.670559325575205,-1.3515227037179551,2.9933943378315284,187.41125106811523,11.74487533569336,0.06818181648790035,170.54775047302246,201.58574905395508,0.8925105210064734,-0.11982717354394996,0.9200641354839169,0.9821356996747754,1.0075605579512192,-0.032850145894437355,32.01385194426203,211.17599337649222,185.8348747253418,160.49375607419137,171.02678571428572,5.3432184870992545,179.22910690307617,12.063791278441393,172.1378633506584,179.48623072340112,-3.155331253517074,-15.253270528000813,77271400,4.421465244664782,0.7722960719806476,-1689124900.0,-75.85434043830928,40.7826645074338,41.89594136137823,-77.73907190019115,16.754099899243535,27.11604771128555,-0.08393079740023607,8.14467551608534,194.7142777709961,188.1778571472168,182.8949966430664,177.61213613891601,171.07571551513672,0.12000000000000001,0.0,212.02416730275874,-0.03503428070930248,-0.036282819335238,170.85428728376115,178.56500026157923,13.490779409638504
2024-03-20,0,173.93250274658203,163.16749954223633,202.4474983215332,175.4968729019165,195.54625129699707,-0.006078990142560694,12.904737608108316,-1.4415978565872616,2.993287021272524,180.0275001525879,11.94198751449585,0.06988240171628976,170.43075294494628,201.58574905395508,0.8962054274499115,-0.1226395606536764,0.9418882737157855,1.0051621428630164,1.0320229411615878,0.011632494305161112,31.680455172807775,210.4730999797054,184.66362476348877,158.85414954727213,170.4853575570243,4.705643692740574,177.19232150486536,10.087452865356232,171.84288963313742,178.66385318801625,-4.24909012736871,-15.167450258419953,83846700,4.411266923194115,0.8464725137992565,-1605278200.0,-65.57599228912991,40.7826645074338,41.89594136137823,-52.255766821654326,19.027925803840002,25.787614082782042,-0.038704835022745826,7.949961002612215,194.13364196777346,187.7081805419922,182.51499938964844,177.32181823730468,170.89635681152345,0.12000000000000001,0.0,211.6312225858754,0.036464527321002915,-0.010589104962922619,170.55285862513952,176.692143031529,13.38364853760848
2024-03-21,0,174.79750061035156,163.16749954223633,202.4474983215332,173.43250179290771,195.54625129699707,0.18449185353675834,12.883104837984474,-1.4065124805485008,2.993278254785393,178.2599983215332,11.758249816894534,0.07016320640842262,170.43075294494628,201.58574905395508,0.9039013930113647,-0.10928318035441438,0.9519718475658386,1.01251323719271,1.0346996307679357,0.05625803408845065,37.03455856593324,209.38245952338107,183.61624984741212,157.85004017144317,170.20107214791435,4.304462134319803,175.28178569248743,7.255858271823535,172.3672931770179,178.28761628996511,-2.1325364566017644,-14.085131113679063,73178000,4.497864552265785,0.74613431855392,-1532100200.0,-68.62892177849639,40.7826645074338,41.89594136137823,-47.98174283769917,19.68301365020795,24.282360120027008,-0.09938468920378936,7.837386089273517,190.48935870361328,184.76031790161133,180.12999725341797,175.4996766052246,169.77063580322266,0.02,1.0,211.2951060232983,0.06350773737980764,0.019707409020998483,169.87857491629464,174.56214359828405,13.147180266987016
2024-03-22,1,168.75500106811523,163.16749954223633,202.4474983215332,173.43250179290771,194.6575002670288,0.37806526915816796,12.728763927210618,-1.2686755257234077,2.9933204471874353,177.83749961853027,11.309249591827392,0.06971131862385119,170.43075294494628,201.58574905395508,0.9073279717758929,-0.09938816649126316,0.9242165002117155,0.9785820172885663,0.9880413923578908,0.03424396121503692,38.92876175305994,208.05002758739244,182.5924997329712,157.13497187854995,169.74714388166154,4.2587418399885815,173.5260715484619,5.247286360727646,173.00206618398897,178.1193383196633,-1.1256439968580898,-13.271230300943829,75454700,4.519622013604619,0.7706787316082134,-1607554900.0,-57.14282998554603,40.7826645074338,41.89594136137823,-71.83278117732945,18.494886606670597,27.90857547718071,-0.03281351652279883,7.742949241065418,178.90711590576174,175.39143563842777,172.54999542236328,169.70855520629885,166.19287493896485,0.02,0.0,210.91047882159114,0.044384631544618136,0.051261549729567306,170.0714329310826,173.32571520124162,13.15969925238287
2024-03-25,0,171.3400001525879,163.16749954223633,202.4474983215332,171.72687435150146,194.09312343597412,0.5717975820489565,12.782181242655682,-1.093834899110296,2.9932772488704367,177.2549991607666,10.935887260437013,0.07049286960888931,168.42825088500976,201.58574905395508,0.8740257631100566,-0.1406164254057298,0.9449285736331824,0.9992578740862258,0.9966553150087836,0.0013441618924430188,31.737597107204536,206.89023719539438,181.325874710083,155.76151222477165,170.5832154410226,3.836682625067329,172.80124991280692,4.739210993129675,172.00005576958293,177.27857155027178,-1.8481077652622115,-12.713682536920196,74228600,4.581895662269773,0.7729658654626652,-1533326300.0,-45.796019476110374,40.7826645074338,41.89594136137823,-51.465450587572015,21.150110551507346,26.20753037636839,-0.05566083575211083,7.654588343994069,177.59303497314454,174.3284748840332,171.68999481201172,169.05151473999024,165.7869546508789,0.02,0.0,210.56363746847939,-0.0067318650656000845,0.05538911263013861,171.5185764857701,172.74642944335938,12.538541548423405
2024-03-26,0,179.47000122070312,163.16749954223633,202.4474983215332,171.2825002670288,184.44937705993652,0.8045154774480371,12.469626443178598,-0.7182932341280184,2.9933750599923608,176.73624801635742,10.182549972534185,0.06924704192195441,168.42825088500976,201.58574905395508,0.8443690029311086,-0.15139357203735376,0.9966430634384995,1.050582750725895,1.0436668754222964,0.04965491693228019,34.069392195430126,205.01375277954568,180.0744998931885,155.1352470068313,172.91214425223214,3.5198379399628306,172.90964290073939,4.881314113436615,171.885366972261,176.7709993146832,3.5365214547980126,-5.591295669694673,113186200,4.387924062223028,1.1758636405333047,-1420140100.0,-27.71693474523163,40.7826645074338,41.89594136137823,7.266840543968624,27.063851203754236,23.45902208245787,-0.07552925352544468,7.938708882316507,178.6473587036133,175.18131790161132,172.37999725341797,169.57867660522462,166.11263580322264,0.04,0.0,210.14855036167816,0.03706508623192728,0.02226694504737731,173.5328608921596,172.827144077846,11.618576790336636
2024-03-27,0,179.78750228881836,163.16749954223633,202.4474983215332,171.2825002670288,179.9743766784668,0.9936159039911338,11.420037760763865,-0.09209778102928379,2.993735275156729,176.73624801635742,8.611925239562993,0.06381598345041439,168.42825088500976,201.54550170898438,0.8098642710002389,-0.10955097047848265,1.00466535321571,1.0507912985343832,1.0352904317554816,0.03366248084618784,47.065656411343475,201.79270060545107,178.95262508392335,156.11254956239563,174.15178734915597,4.23480373635417,173.13125038146973,5.12998774833479,173.80065014562956,176.90508169373618,9.991267699880915,0.8527566829684895,81804000,4.895276856719628,0.8578635711261017,-1338336100.0,-18.618353606607428,40.7826645074338,41.89594136137823,14.70326561410959,25.59367274761822,23.45311721029307,-0.06613477090784586,7.793384739229633,178.6473587036133,175.18131790161132,172.37999725341797,169.57867660522462,166.11263580322264,0.04,0.0,209.85043306826515,0.023739030411080497,0.04967309212595929,174.39428928920202,172.91143035888672,10.237375866731837
2024-03-28,0,177.0275001525879,163.16749954223633,202.4474983215332,171.2825002670288,179.54937648773193,1.1763213084814046,10.185088700656264,0.8186384715242814,2.9941263357689394,176.73624801635742,7.167650070190428,0.05726319016505754,168.42825088500976,194.15599937438967,0.737726788625876,-0.11193023485390546,0.9952941700968414,1.029931735655769,1.0125693477723912,0.012757616867802524,47.199957806346795,198.23467763782378,177.86450023651122,157.49432283519866,175.01571546282088,4.0944328880419265,173.0212505885533,5.019781245148145,175.29150872120908,176.95356008842546,5.071300127119419,1.7559525557316946,77654800,4.8841340038331245,0.8178906550419974,-1415990900.0,-35.63607732232095,40.7826645074338,41.89594136137823,5.056358912014794,24.495279450296714,23.10975690421195,-0.0981300819350999,7.559663551535514,178.6473587036133,175.18131790161132,172.37999725341797,169.57867660522462,166.11263580322264,0.04,0.0,209.5512936163439,0.017185428978383488,0.0007400069527123483,175.0328587123326,172.94357299804688,8.47312371001264
2024-04-01,0,174.5875015258789,163.16749954223633,201.54500198364258,171.2825002670288,178.79312324523926,1.2723993269129321,8.481711489291394,2.039315566773781,2.9946002516752253,176.73624801635742,5.783899669647218,0.04802957908153256,168.42825088500976,182.67225265502933,0.614316355216554,-0.12164777885707398,0.9886405853077354,1.0089619710288276,0.996071912601568,0.034561941399351426,44.078018689578855,193.55692330664675,176.59350032806395,159.63007734948116,175.10928671700614,4.072980325224133,172.79732213701521,4.861354914202032,175.6992569267348,176.39958538814003,3.5369614439822494,-0.862417362911548,81562100,4.895924249943477,0.8592869103136058,-1497553000.0,-38.03705429595231,40.7826645074338,41.89594136137823,-14.912438731071743,22.963066773853846,26.53250477691998,-0.09153172456055161,7.486649473598666,178.6473587036133,175.18131790161132,172.37999725341797,169.57867660522462,166.11263580322264,0.04,0.0,209.21620556798862,0.02569805855291163,0.0138872456589003,174.97000122070312,172.7614299229213,5.74157343424073
2024-04-02,1,165.625,163.16749954223633,193.33499908447266,171.2825002670288,178.10624885559082,0.6528636919936447,6.260590429548406,1.6436098765242653,2.99509850056411,175.74124908447266,4.636624526977539,0.03572466027979931,168.42825088500976,179.9575023651123,0.5195325751955199,-0.09696897947796054,0.945102051543813,0.9508909593974579,0.9386910693136278,-0.03335473413971268,43.55065113344016,187.7668061642726,175.2456253051758,162.724444446079,173.79892948695593,5.4370678960820795,172.00000081743514,5.067594107103815,175.3795328628429,175.48368761429413,0.3765821620190229,-1.763985046476856,116650600,4.628969213257223,1.240513285919348,-1614203600.0,-74.2206867738981,40.7826645074338,41.89594136137823,-127.09770044688585,20.476429783028234,29.886626882393283,-0.005373540929498944,7.794739450209308,178.6473587036133,175.18131790161132,172.37999725341797,169.57867660522462,166.11263580322264,0.02,1.0,208.63931441416472,-0.03475641447193967,-0.02458582744965283,174.0857151576451,171.98214503696985,5.0869427943250995
2024-04-03,1,166.12500381469727,163.16749954223633,181.4875030517578,171.07750129699707,177.7799997329712,-0.5535893727275408,5.053902628679462,-0.6787828702047318,2.9953073690340597,174.69250106811523,4.248349990844725,0.029068785142525977,165.61124992370605,179.50175132751465,0.5188543587206497,-0.08740272903106744,0.955509513635511,0.9567745399155059,0.9476638714394705,-0.0743578164330364,36.87569780086642,183.96793060831106,173.86012535095216,163.75232009359326,173.42321559361048,5.913685239355555,171.58517973763603,5.305647153514679,172.91833024760967,173.7939729342637,-5.247501010210877,-6.31407682696246,82950100,4.30628842675802,0.8996893174251389,-1531253500.0,-66.8491636270146,40.7826645074338,41.89594136137823,-99.54299388515858,20.47231208144887,28.333985468147873,0.0386442397797189,7.6333432377966055,178.6473587036133,175.18131790161132,172.37999725341797,169.57867660522462,166.11263580322264,0.04,0.0,208.24689275327773,-0.05228791231988994,-0.024619126917623933,173.73571559361048,171.90357426234655,4.937359426134258
2024-04-04,0,171.59500122070312,163.16749954223633,179.78750228881836,170.423752784729,177.20125007629395,-0.46819098325774056,5.0034664536345,-0.9976484009954465,2.9953124801969815,174.26000213623047,4.330549678802489,0.028906399154132168,165.61124992370605,178.6577476501465,0.5750907451014821,-0.06646434085229365,0.9913514248779213,0.9910493958079936,0.9940016374490166,-0.045567689432352454,38.61997841974413,183.0989332963681,173.09200038909913,163.08506748183015,173.45964431762695,5.8994820467151525,172.02142987932478,5.0084742241178075,171.23588417543323,172.58781237974785,-1.5584707041401473,-3.3777762512998084,123162000,4.267209894443671,1.3248830204088482,-1408091500.0,-55.938681638334955,40.7826645074338,41.89594136137823,-11.869591134300085,26.47094204977859,25.930089923014854,0.03302937396624367,7.744038373822856,178.7063587036133,175.27681790161134,172.50499725341797,169.7331766052246,166.30363580322265,0.04,0.0,207.75015633863717,-0.04849024707732208,-0.03692237083469708,173.51857212611608,172.51857430594308,4.88719522222929
2024-04-05,1,166.33749771118164,163.16749954223633,179.78750228881836,170.423752784729,176.8474988937378,-0.35824813573171327,4.885126394886555,-0.9636849239701886,2.995331086191108,172.9325008392334,4.162374687194824,0.02827464113215041,165.61124992370605,178.6577476501465,0.5827113775549911,-0.0288083108822108,0.9627454183225426,0.9619833125224209,0.9727794072527328,-0.06038611194414456,47.55022717816972,182.54437827042497,172.77412548065186,163.00387269087875,171.5835723876953,5.755959107662367,172.24785831996374,4.635148387246308,171.34587619716382,172.12458246839483,0.14882751715194445,3.6906122890246786,141250700,4.473817792115372,1.4881536445439631,-1549342200.0,-81.50801021965837,40.7826645074338,41.89594136137823,-110.38687728506676,23.94475204696338,30.207815348209177,-0.009147359098224532,7.948411669213923,178.6473587036133,175.18131790161132,172.37999725341797,169.57867660522462,166.11263580322264,0.06,0.0,207.0933569651683,-0.06194891521454704,-0.08302289819580073,171.6942858014788,172.6135733468192,4.990970484892108
2024-04-08,0,171.15249633789062,163.16749954223633,179.78750228881836,168.15062522888184,176.8474988937378,-0.1552764888519621,4.990345262897278,-1.1395455540139916,2.9953118925716873,171.76375007629395,4.23692497253418,0.028970390122602333,165.61124992370605,178.6577476501465,0.5175284790685404,-0.06848950525906658,0.9935894869300593,0.9946967449929884,1.013612324681481,-0.019674977635664948,40.856071801832634,182.2374410140758,172.25675048828126,162.2760599624867,170.35000010899134,4.491025277616705,172.25089372907365,4.634359769456381,170.08553441012342,171.05827634923315,-7.317380854849271,1.9427877352038174,104423300,4.5761091844866115,1.0891933209588667,-1444918900.0,-47.472627062812336,40.7826645074338,41.89594136137823,-2.9448550560862037,25.13448788674987,27.635555217621818,0.05813201071750028,8.066584367023077,178.6473587036133,175.18131790161132,172.37999725341797,169.57867660522462,166.11263580322264,0.06,0.0,206.6925861858529,-0.012783960036289455,-0.015984968803201022,170.71571350097656,172.55500139508928,4.938946845831415
2024-04-09,0,175.23250198364258,163.16749954223633,179.78750228881836,168.15062522888184,175.29500007629395,-0.059391050560694644,4.778680034405599,-0.9938827985057648,2.995345500377121,171.4675006866455,3.907100181579591,0.027801449926714922,165.61124992370605,177.89724998474122,0.49331720446388033,-0.03696776443704268,1.0194693083353061,1.0169917052990054,1.0420147958543662,0.058007559146521226,47.733356353361444,181.4433605113161,171.8860004425049,162.3286403736937,170.093571799142,4.078508257566906,172.55464363098145,4.683751829059318,170.33323937986887,170.804086740597,-4.80289555224817,0.02483532662467401,103232700,4.734783601422971,1.0668480147178392,-1341686200.0,-31.044622627866243,40.7826645074338,41.89594136137823,75.31389960761946,27.710851265348843,25.834093601245343,0.0883869050798426,8.011741652443932,178.6473587036133,175.18131790161132,172.37999725341797,169.57867660522462,166.11263580322264,0.06,0.0,206.35234503675483,0.06151353117470415,0.00947382519429658,170.87142944335938,172.952144077846,4.88817525106495
2024-04-10,0,172.43499374389648,163.16749954223633,179.78750228881836,168.15062522888184,174.90625095367432,-0.06390697785112415,4.655856528168632,-0.8949254885055069,2.9953645848084376,171.4675006866455,3.7701502990722644,0.02710651987365374,165.61124992370605,177.27175025939943,0.4449209958484396,-0.008795850973060421,1.003921095195525,0.9985001975704102,1.0137957212117596,0.037983384706119505,52.89343949570817,181.07321360565368,171.7615005493164,162.4497874929791,169.78607068743025,3.7512293860557424,172.44767870221818,4.666933970952993,171.52793420745894,171.2111580443282,-1.0139657213699136,2.4871321459922857,84532400,4.833338898052234,0.8748842387036225,-1426218600.0,-52.61163691289188,40.7826645074338,41.89594136137823,12.133926559230455,25.993568695223754,25.95605072733831,0.05501981733343832,7.930069240889174,178.6473587036133,175.18131790161132,172.37999725341797,169.57867660522462,166.11263580322264,0.06,0.0,206.04535460473048,0.02007358074597887,0.030786709918368273,170.37714276994978,172.67357199532645,4.709568535182096
2024-04-11,0,172.88500213623047,163.16749954223633,179.78750228881836,168.15062522888184,174.64000129699707,0.005859216286569211,4.5154497189620155,-0.7101650151600505,2.9953857649978257,171.4675006866455,3.535875129699707,0.026322418744057326,165.61124992370605,177.27175025939943,0.47375603812949724,0.0029226284450782876,1.0078179813821961,1.0052008817867013,1.0089553514748544,0.007517706846647432,50.86354944540115,180.5747747507292,171.54387531280517,162.51297587488114,170.8232138497489,3.3958194083660103,172.3110716683524,4.620621611546905,171.72233406779722,171.4417078710255,-1.232910582469936,-0.8609713417781396,94516000,4.747471012812584,0.9843282417463338,-1331702600.0,-40.64865907155368,40.7826645074338,41.89594136137823,24.824702444637246,24.25687907914826,25.581681617846996,0.13764847250832332,7.890010301567208,178.6473587036133,175.18131790161132,172.37999725341797,169.57867660522462,166.11263580322264,0.06,0.0,205.7161867970358,0.020396268369558657,0.03694026036542796,171.51571437290735,172.80071476527624,4.722368041780923
2024-04-12,0,171.88999938964844,163.16749954223633,179.78750228881836,168.15062522888184,174.64000129699707,-0.0244851635200682,4.524311842761133,-0.7273040450313819,2.99538450423781,171.4675006866455,3.583500289916992,0.026366759602247568,165.61124992370605,177.27175025939943,0.47990544194463114,0.044701279149629375,1.001739590339866,1.0034427826430512,1.0016403675210332,0.03338093788153418,53.56807350134051,180.64012415854472,171.59150047302245,162.54287678750018,171.6467846461705,2.6927838316217807,172.5350001198905,4.5096607533377515,172.01080566434683,171.79030502862554,4.383397516214623,-1.0941223229411754,64506600,4.495780213689857,0.6941428729151211,-1396209200.0,-55.602333167290666,40.7826645074338,41.89594136137823,-5.734136929558478,23.292696947811436,24.564840159183067,0.16399430474870808,7.6289644686332165,178.6473587036133,175.18131790161132,172.37999725341797,169.57867660522462,166.11263580322264,0.06,0.0,205.4867862808286,0.03729538740392013,-0.00035063735830598996,171.8971426827567,172.8164291381836,4.17807167297313
2024-04-15,0,165.94750213623047,163.16749954223633,179.78750228881836,170.423752784729,174.64000129699707,-0.10929461832773363,4.3021426238293206,-0.42355197331832484,2.9954187703588806,171.74250030517578,3.2950377082824702,0.02502531525602679,166.07500343322755,177.27175025939943,0.38004368187513277,0.05345733600063086,0.9653070388477444,0.9716663925064382,0.9607947207181482,-0.03041144191893297,52.92395504283356,180.51591072831047,171.91162548065185,163.30734023299323,170.8399990626744,3.4503460537521025,172.14982169015067,4.837923523714955,171.99100639170314,171.9879049026076,3.4702756614420833,1.8577217277654554,100245300,4.463372758534453,1.0768234913854915,-1496454500.0,-95.91406488518953,40.7826645074338,41.89594136137823,-162.0779774832981,21.22096336063661,30.639650025834776,0.09688080910898764,7.774924550271905,178.6473587036133,175.18131790161132,172.37999725341797,169.57867660522462,166.11263580322264,0.06,0.0,205.0613703508523,-0.06648167582402797,-0.020739831992305648,170.52142769949776,172.01999991280692,4.428434247436755
2024-04-16,1,156.44750213623047,165.625,179.78750228881836,170.423752784729,174.64000129699707,0.10884461060604399,4.0552017905084,-0.6052300553252445,2.9954546816613146,171.74250030517578,3.1699375915527357,0.02356981717516298,166.10725364685058,177.27175025939943,0.402725030741719,-0.030170641433618115,0.9093108588314117,0.9206991556545956,0.9112845108136817,-0.10720043162521087,41.95551410390909,180.16102919136836,172.05062561035157,163.9402220293348,169.42714255196708,6.381322120877748,170.50535746983118,5.9445494574975175,170.4826778754722,171.5996118217896,-3.2911792559789785,-3.1472499191987273,97000000,4.3124287506315655,1.0482768220266951,-1593454500.0,-88.06818120243143,40.7826645074338,41.89594136137823,-247.8542376025373,19.7116653698451,35.48076363365518,0.07810805861288572,7.77171183400283,175.26424279785155,171.15288226318359,167.8300018310547,164.50712139892576,160.3957608642578,0.08,0.0,204.57681564089367,-0.11177071306369013,-0.09174468440954492,169.40857151576452,170.55142865862166,5.553881220806557
2024-04-17,1,156.29999923706055,156.44750213623047,179.78750228881836,168.15062522888184,174.64000129699707,-0.8122754632205557,5.294886565912977,1.0290318628271926,2.9952503413119658,171.74250030517578,3.9169998931884775,0.03090686324917722,165.9152519226074,177.27175025939943,0.4059293872470129,-0.08499532656088114,0.9123411129079377,0.9248260725252612,0.9307948340128832,-0.09357146224507029,32.89358526590674,181.90727381847145,171.3175006866455,160.72772755481955,167.3053572518485,7.98079849772063,168.82767868041992,6.418837611513658,166.9624995449801,169.64250515130502,-5.945740263643716,-12.828048658762057,82439700,4.778593418552947,0.8884428457540031,-1675894200.0,-93.41597030978525,40.7826645074338,41.89594136137823,-197.2517244060216,18.994049390250513,33.95013942485795,0.04757163953745249,7.541355773693025,173.47648559570314,169.70676452636718,166.66000366210938,163.61324279785157,159.8435217285156,0.08,0.0,204.16834649336593,-0.09495806986617372,-0.12115562722178935,166.90428597586495,168.80999973842077,6.605027041490263
2024-04-18,1,150.5199966430664,156.29999923706055,179.78750228881836,166.28437423706055,174.64000129699707,-0.8457858386285741,6.226366493431236,0.31680072967861017,2.995058769244009,171.74250030517578,4.854699726104738,0.03650040288707437,164.70725021362304,177.27175025939943,0.5798568525125903,-0.10137555218883885,0.8823830922624248,0.8958337184418682,0.9139373366525697,-0.12936347986704377,31.56495369637375,183.03623346751434,170.58350048065185,158.13076749378936,163.77499934605189,9.25404043768824,166.93428557259696,7.612561565413089,164.30031926921134,167.8237572566111,-8.677931913717554,-13.06403546005466,96098800,4.701179427971068,1.0288528853688335,-1771993000.0,-95.96987039530357,40.7826645074338,41.89594136137823,-210.33689476095606,17.769364699843344,36.61364096777025,-0.0031565360554883,7.484776991759043,172.01728021240234,167.56135958862305,163.95999908447266,160.35863858032226,155.90271795654297,0.1,0.0,203.64679073780187,-0.14129445913712158,-0.12709596255946473,163.05428423200334,166.96285683768136,7.945379761681263
2024-04-19,1,148.29500198364258,150.5199966430664,179.78750228881836,166.08062839508057,174.64000129699707,-0.9494671194381016,7.547429669005556,0.2972310197842867,2.994724768749918,171.4675006866455,5.924549865722656,0.04455050810741514,156.43275184631347,177.27175025939943,0.6248139417293398,-0.13888930838549665,0.8753467044936235,0.8938024060391843,0.9255653258210885,-0.13726800564190822,26.967370934337566,184.5077345134872,169.41287517547607,154.31801583746494,160.32642909458704,9.960002881933093,165.05624989100866,8.739112534669774,160.86000490755433,165.4780227519271,-14.10269502565398,-14.973664253674421,86005100,4.800895784125059,0.9145082759952038,-1857998100.0,-97.48484293619791,40.7826645074338,41.89594136137823,-186.774773273283,16.946533732991707,37.35123448561302,-0.006313390788834045,7.2871198800274275,171.4320012207031,166.61400122070313,162.72000122070312,158.82600122070312,154.00800122070314,0.12000000000000001,0.0,203.16955462820297,-0.14030984841747052,-0.15778924449420786,159.52428545270647,164.95071411132812,9.323499587280693
2024-04-22,1,141.4625015258789,148.29500198364258,179.78750228881836,165.86687660217285,173.31062698364258,-0.8777813468449015,8.721023872147187,-0.11113659746277404,2.9943640394935285,171.24624824523926,6.910449829101561,0.051883756308715265,155.72199897766114,177.27175025939943,0.7273132915192644,-0.12124084593033368,0.8415991130847451,0.8619954353570497,0.9097149949017166,-0.14754666563315433,26.470296237672915,185.52979798843504,168.08775024414064,150.64570249984624,155.8375004359654,10.426621276077402,163.33035714285714,10.768460881931546,157.74395384979385,163.10435676983053,-13.999473793647159,-15.059783382225113,107097600,4.675529378918489,1.1199476133025987,-1965095700.0,-91.95942566247572,40.7826645074338,41.89594136137823,-194.60071098286443,15.5878411079877,41.567501681165986,-0.031164740365046704,7.355953015973165,169.68088165283203,163.779561920166,159.01000213623047,154.24044235229493,148.3391226196289,0.14,0.0,202.51989104613622,-0.12032445621663856,-0.1695410668377768,154.87428501674108,163.19499969482422,10.952740819251348
2024-04-23,1,144.09499740600586,141.4625015258789,179.78750228881836,163.33062553405762,173.31062698364258,-0.9363974713854093,10.469813194740574,-0.10852246526556852,2.9937178301442273,171.24624824523926,8.344812221527098,0.06279760637867005,150.29749717712403,177.27175025939943,0.7407339370883165,-0.17437550251022174,0.8642772091467151,0.8942140747364157,0.9567743243187244,-0.07895622852110717,21.282619176477862,187.66275165650995,166.72312526702882,145.7834988775477,151.8667858668736,8.387731346384479,161.75678525652205,11.880818290903662,153.71024270421833,160.3374571140834,-18.17537682394865,-14.588678323997641,124545100,4.759486868621405,1.2690146347954678,-1840550600.0,-85.45277117666711,40.7826645074338,41.89594136137823,-145.58114630412894,17.418075132424967,39.05382545268356,-0.02764555568513616,7.269747973261019,169.68088165283203,163.779561920166,159.01000213623047,154.24044235229493,148.3391226196289,0.14,0.0,201.81290525332142,-0.07911659274572835,-0.10403767337289267,151.10714067731584,161.50214168003626,11.889294612600365
2024-04-24,1,162.61249923706055,141.4625015258789,179.78750228881836,156.410626411438,173.31062698364258,-0.7332113903470469,11.502047414934678,-0.6989743008041835,2.993267265762538,168.74499702453613,9.504525184631348,0.06955724808491201,147.8750015258789,177.27175025939943,0.797893886488717,-0.19710817169491673,0.9833795274094704,1.0290123071036328,1.0977355034820744,0.04038707633277605,22.508418239882033,188.36496995956907,165.3608751296997,142.35678029983035,151.3903568812779,7.502656373607477,161.11517797197615,11.546489565603217,151.31815516936422,158.38077146669806,-16.170226355423704,-13.261102123593984,181178000,4.306386889156797,1.7842535180627626,-1659372600.0,-42.281041840869925,40.7826645074338,41.89594136137823,-13.845420052084279,31.563995754014154,31.327674068834206,0.013902923990620696,8.41485535842272,169.68088165283203,163.779561920166,159.01000213623047,154.24044235229493,148.3391226196289,0.02,1.0,201.13055129795083,0.042972068611840886,0.03195216251644634,151.1999991280692,160.8607134137835,11.53588298379264
2024-04-25,1,164.59500122070312,141.4625015258789,179.78750228881836,156.410626411438,172.54749584197998,-0.7034652435921501,11.045857271047575,-0.6772383980379004,2.993438678285468,166.23125076293945,9.189350204467772,0.06714072179942987,147.8750015258789,175.4120018005371,0.7955505907584385,-0.09552946024116377,1.00046804112724,1.0480720621017183,1.1017289632774903,0.09350920071446245,47.65408279762518,186.60971457261275,164.51800003051758,142.42628548842242,152.55428532191686,8.9166877637675,160.99071393694197,11.495143272072774,154.1394715294582,159.13534242584973,-2.0096734547002306,-5.234710754825199,126427500,6.263884942926953,1.218297429643209,-1532945100.0,-22.365187913015085,40.7826645074338,41.89594136137823,20.326765509463844,30.708906556770316,28.108417832227023,0.05603623318241339,8.708271354210318,169.68088165283203,163.779561920166,159.01000213623047,154.24044235229493,148.3391226196289,0.04,0.0,200.7154288136665,0.13506303601168024,0.09475713101778628,153.06714085170202,161.23785618373327,11.050356504642114
2024-04-26,1,168.90749740600586,141.4625015258789,177.0275001525879,156.410626411438,172.02624797821045,-0.7611692801103621,10.477420681109676,-0.6085049387697539,2.993648717705108,166.03625297546387,8.657612667083736,0.06398097613373413,147.8750015258789,174.65200157165526,0.787272823966503,-0.07022919558355985,1.0314434142962992,1.0812398005781425,1.109685813872898,0.13899656189786436,50.168197793946284,184.71321633933118,163.75837497711183,142.80353361489247,154.35535648890905,10.860740424055102,160.83035687037878,11.3573147641641,156.72660794684066,159.95498388629045,5.207816662600354,-1.0475668532083373,109815700,6.279422258261685,1.0420729960767006,-1423129400.0,-27.041089633120862,40.7826645074338,41.89594136137823,43.448038129392735,30.26664961027681,26.748910534711722,0.06626217815354384,8.496838406422617,169.68088165283203,163.779561920166,159.01000213623047,154.24044235229493,148.3391226196289,0.06,0.0,200.3881001646621,0.1444405970321474,0.12245715672150047,154.90142604282923,160.9028560093471,10.751266237385396
2024-04-29,0,191.46999740600586,141.4625015258789,175.23250198364258,156.410626411438,171.66875076293945,-0.8341594184920846,10.106121756672925,-0.5261590301640875,2.9937823762997526,166.03625297546387,8.373412570953366,0.06186700234131942,147.8750015258789,173.0552520751953,0.7730772612528664,-0.03253385305494567,1.1721286427197715,1.2280153063363142,1.2247456459764643,0.3535035457504523,54.70841589794002,183.56461835312857,163.35237483978273,143.1401313264369,160.2053565979004,17.46884451284523,161.99017797197615,13.557243255461648,159.736739555047,161.38071258320522,8.066217677853915,-1.3116951139600506,243869700,6.358884573709192,2.1486819801820034,-1179259700.0,-8.023959883629809,40.7826645074338,41.89594136137823,206.01918052504362,42.67652150347348,20.946473830451133,0.07756659419798186,10.075093406975661,184.6934769897461,175.92325814819336,168.83499908447266,161.74674002075196,152.9765211791992,0.08,0.0,200.21145948131363,0.36606827795035746,0.319619170517509,161.20428466796875,162.12928444998605,12.50456389331807
2024-04-30,0,186.0124969482422,141.4625015258789,191.46999740600586,156.410626411438,171.66875076293945,-0.1036799746023535,11.603438354601582,0.10196062058495503,2.9932227866401635,166.03625297546387,8.964299926757809,0.0706680007215804,147.8750015258789,173.1197521209717,0.6389263422392186,0.15604526735701651,1.132865178996567,1.1737988939824804,1.1182936861916104,0.2909018376545611,70.91710809569088,187.40337634299223,164.19649963378907,140.98962292458592,165.59357016427177,18.937991796258178,162.9599996294294,14.791356251247873,167.6488421878601,165.6499208164537,27.205688065517098,9.2662578223525,127031800,7.825581697965497,1.1141537044603362,-1306291500.0,-25.953052101138326,40.7826645074338,41.89594136137823,137.4069978842945,39.310149845460174,20.49042431954155,0.0018527594521545343,10.156200931795492,184.6934769897461,175.92325814819336,168.83499908447266,161.74674002075196,152.9765211791992,0.08,0.0,200.0443036592945,0.2667957427259193,0.29024987569001576,166.37999834333147,162.95214189801897,13.187034572187741
2024-05-01,0,181.7150001525879,141.4625015258789,191.46999740600586,156.410626411438,172.02624797821045,-0.06339290732950614,12.541750788701737,-0.28857611619238677,2.9928388813523217,166.23125076293945,9.739949645996091,0.07591129380324031,147.8750015258789,176.31050148010254,0.7359156750359553,0.11971402664783838,1.0998640458926605,1.125679108137399,1.0400384717864926,0.11747252520656026,65.39637272769076,190.29937605860465,165.21587448120118,140.13237290379772,171.34392711094446,16.31977836751662,163.59071377345495,15.421937476780169,172.24599002873663,168.96663464418603,25.43409721169158,7.873983644242915,92829700,7.971755105541894,0.8106662116278799,-1399121200.0,-31.42998521368023,40.7826645074338,41.89594136137823,98.43837686245912,37.37029453474729,22.238407476888373,-0.057556741992306225,9.919929768275091,184.6934769897461,175.92325814819336,168.83499908447266,161.74674002075196,152.9765211791992,0.08,0.0,199.8906160543751,0.11015851521907227,0.2440559483335773,171.7999986921038,163.33714185442244,13.576439039440466
2024-05-02,0,180.87250137329102,141.4625015258789,191.46999740600586,156.410626411438,172.54749584197998,-0.1346557568358693,13.04828051775871,-0.5471436379053731,2.9926240021943196,167.62249755859375,10.368336715698243,0.07860628992182947,147.8750015258789,182.14474983215334,0.7804422531108706,0.05897607074735564,1.0896237448670036,1.1030929872761779,1.0130643148007346,0.09889425579068245,60.62844020015599,192.09193533361312,165.9953742980957,139.89881326257827,176.59785624912806,11.203229842878436,164.23232105800085,15.97086006111143,174.62647237211706,171.08641620480446,28.45453614387362,5.107440152269271,89148000,7.984862414052053,0.7902512980157688,-1488269200.0,-31.396709008732337,40.7826645074338,41.89594136137823,84.04565593731301,35.03799165193802,23.025402531862888,-0.04346729594494967,9.824177583027764,184.6934769897461,175.92325814819336,168.83499908447266,161.74674002075196,152.9765211791992,0.08,0.0,199.7342127525295,0.05776238250158072,0.11028180525219305,176.8471418108259,163.97714124407088,13.896641214360573
2024-05-03,0,181.62250137329102,141.4625015258789,191.46999740600586,156.410626411438,173.4718770980835,-0.16346135454848731,13.399294715184615,-0.7043422431128219,2.992470087280598,167.62249755859375,10.797999382019043,0.08049594583101227,147.8750015258789,182.14474983215334,0.8053902579143144,0.08738260381520874,1.0910928778713673,1.0875354712340148,0.9990483962187549,0.07527791342927714,61.05325697172433,193.25783873609433,166.4592493057251,139.6606598753559,179.31357084001814,9.40837624290851,165.35196386064803,16.63595492017855,176.202662444123,172.07099653366572,25.523095617025408,5.225726927417467,75491500,7.876487122856844,0.6892833362513237,-1412777700.0,-29.432320644430543,40.7826645074338,41.89594136137823,82.15764911779361,33.50950986320317,21.932692720389216,-0.03943382144602529,9.576633032321482,184.6934769897461,175.92325814819336,168.83499908447266,161.74674002075196,152.9765211791992,0.08,0.0,199.6120777057251,0.07665345338353169,0.06469626418776937,179.56999860491072,165.38499886648995,14.276750383343858
2024-05-06,0,184.57999801635742,141.4625015258789,191.46999740600586,156.410626411438,176.6425018310547,-0.24959924578181078,13.800452529271857,-0.8500997861578972,2.992294984609555,170.02999687194824,11.47364938735962,0.08252699274597848,147.8750015258789,182.14474983215334,0.8175387758414296,0.0611735455773337,1.1037922216708913,1.083619768289308,1.0013100820848249,-0.035984746868922834,60.76772379895545,194.82440454737426,167.22349948883056,139.62259443028685,182.16857038225447,6.8938023860884226,167.36142785208565,17.168198621538814,177.60953815861066,173.09517722851956,11.690369575168521,9.445757866359775,84390300,7.818567578997644,0.777646900815356,-1328387400.0,-23.48926664578653,40.7826645074338,41.89594136137823,93.15177005568576,34.00291530011402,20.86468107648551,-0.06785364853472303,9.347498646328528,184.6934769897461,175.92325814819336,168.83499908447266,161.74674002075196,152.9765211791992,0.08,0.0,199.50250970331842,-0.04787430249328073,0.09786678874423743,181.6528560093471,167.35999843052454,14.762199531728132
2024-05-07,0,180.2174949645996,141.4625015258789,191.46999740600586,156.410626411438,181.06000137329102,-0.2771963430877549,14.293085627469628,-0.9842489719268062,2.9920709687329388,170.39874839782715,12.077886962890625,0.08513116117357117,147.8750015258789,184.7232479095459,0.8174706056305244,0.053343391933006835,1.0733948574856937,1.0318883581187464,0.9850076676957064,-0.03115383148291928,62.13682947978977,196.48104582769315,167.8948745727539,139.30870331781466,183.78428431919642,3.975424215359905,169.06982040405273,17.172819216257523,179.3797115618666,174.11123371469344,12.141922079915838,17.982067783754,75045900,7.795886660273261,0.7006384560800558,-1403433300.0,-35.05909828597063,40.7826645074338,41.89594136137823,61.936827379406715,32.060349577365635,23.39852630357365,-0.11617179919460303,9.20548338289579,184.6934769897461,175.92325814819336,168.83499908447266,161.74674002075196,152.9765211791992,0.08,0.0,199.37137338812286,-0.02984505269061044,-0.08368979766948245,183.01285661969865,168.95714133126395,14.793750325087643
2024-05-08,0,173.12999725341797,141.4625015258789,191.46999740600586,156.410626411438,181.06000137329102,-0.29494099502068194,14.46134437843362,-1.03484043000471,2.99199319928477,170.39874839782715,12.302211647033692,0.08600564810315595,147.8750015258789,184.7232479095459,0.840443743219618,0.045132957363989784,1.0296523774154562,0.9712190777505328,0.9523023629513009,-0.04724432706139292,58.042143180813575,197.06681297866896,168.14412422180175,139.22143546493453,181.16428429739815,4.10724629121335,170.6848204476493,16.336952640135653,179.60497932860886,173.68572825258383,6.695971305174047,15.302300604149936,79969500,7.838358697191362,0.748199496288404,-1483402800.0,-40.20309153725144,40.7826645074338,41.89594136137823,29.623074908652136,30.131008354354577,27.686175513311106,-0.08456074985508581,9.095055065066457,184.6934769897461,175.92325814819336,168.83499908447266,161.74674002075196,152.9765211791992,0.08,0.0,199.19296983616394,-0.029279427254982116,-0.046704482843769414,180.25142778669084,170.7278562273298,14.849705136198105
2024-05-09,0,173.49249649047852,141.4625015258789,191.46999740600586,156.410626411438,181.06000137329102,-0.30072497952366056,14.472444233388703,-1.0376906443451337,2.9919883706388446,170.39874839782715,12.333486804962158,0.08605387736869617,147.8750015258789,184.7232479095459,0.8487435348250394,0.0014170987312968188,1.0315950627701829,0.9675440346878788,0.9633949498313327,-0.040802249246176925,50.96826899697361,197.12376286405524,168.17887439727784,139.23398593050044,179.37571280343192,4.36224481399788,172.48464148385185,15.015060064419831,177.99624581194666,172.66532548494573,-9.578524260225752,15.021260373774448,65950300,8.015025972245553,0.6253922018641155,-1417452500.0,-44.781084484220095,40.7826645074338,41.89594136137823,26.07603320659573,29.085187508032394,26.7252126684493,-0.1373940316239067,8.748872261048435,184.6934769897461,175.92325814819336,168.83499908447266,161.74674002075196,152.9765211791992,0.08,0.0,199.04395878568386,-0.04466414938881347,-0.044558053379055725,178.6357138497489,172.50785609654017,14.799655255768569
2024-05-10,1,170.58250045776367,141.4625015258789,191.46999740600586,156.410626411438,181.06000137329102,-0.3056107414251181,14.482923273212847,-1.0404778298664554,2.991983762462506,170.39874839782715,12.360824050903322,0.08610063566309671,147.8750015258789,184.7232479095459,0.8496845194340856,0.009322805902148276,1.0141089229947817,0.9466182518504898,0.9550637440612838,-0.06078542488981964,51.51973965562574,197.17509566141592,168.20924911499023,139.24340256856453,177.7853557041713,5.296520037336102,174.5646414075579,12.126105820946114,176.87570264519536,171.98321734444463,-6.7307308181811845,16.991465774156907,72627200,8.011772791404733,0.6860662211204981,-1490079700.0,-52.631573385773976,40.7826645074338,41.89594136137823,9.230366985746066,27.78746273133233,28.574541530660557,-0.1435871339958474,8.503167543122002,185.23863641357423,176.80567721557617,169.98999786376953,163.1743185119629,154.74135931396484,0.02,1.0,198.86173124013757,-0.07020255560080668,-0.06410751423968616,176.98999895368303,174.39499882289343,14.78161039908943
2024-05-13,1,171.5724983215332,141.4625015258789,191.46999740600586,156.410626411438,181.06000137329102,-0.2935347845044638,14.469105453403369,-1.0385825529875057,2.991989314134047,169.74499893188477,12.301986598968506,0.08605193335150925,147.8750015258789,184.7232479095459,0.8562677749855533,0.02793050972064778,1.0203910143625181,0.9512278949712727,0.972630467684891,-0.07047079767370834,50.08437622615515,197.08208507520277,168.143874168396,139.20566326158922,176.45678383963448,5.553259600081426,176.52732004438127,8.49513870750121,175.27781122015807,171.09191055962242,-6.126351531506011,20.584959701534476,67018900,7.919798069479291,0.643181703780981,-1423060800.0,-65.23209702464685,40.7826645074338,41.89594136137823,19.977534441418932,28.140263845105917,26.888382460744804,-0.10192229449021509,8.39076783060529,189.10903497314453,183.07047488403322,178.18999481201172,173.30951473999022,167.2709546508789,0.02,0.0,198.70891698697878,-0.06965791026104029,-0.05132735209695289,175.82999965122767,176.33857073102678,14.7331505401537
2024-05-14,0,176.40250396728516,141.4625015258789,191.46999740600586,156.410626411438,181.06000137329102,-0.3504185735064207,14.478345272871664,-1.0184899245299144,2.991990929815168,171.07749938964844,12.30734924316406,0.08596309701866084,147.8750015258789,184.7232479095459,0.8500911021124987,0.09667777355839326,1.0473645487159153,0.988915532261324,1.0149799855419945,-0.02116881603566756,53.596843494965064,197.3818145234045,168.42512397766114,139.4684334319178,175.7110699244908,5.07375332930368,177.51232038225447,7.498646766176806,174.27634215890572,170.64788904535166,-5.141745141548156,19.069017946616157,86407400,7.579617157357244,0.8334900414428039,-1336653400.0,-52.62896804844544,40.7826645074338,41.89594136137823,42.85337293102534,29.813076954403922,25.13655670558834,-0.11462580262636538,8.334270810942852,189.30963641357422,183.39517721557618,178.61499786376953,173.83481851196288,167.92035931396484,0.02,0.0,198.55054883374268,-0.0014622040965399652,-0.039023553092881996,175.30999973842077,177.43999917166573,14.628251612841593
2024-05-15,0,176.75,141.4625015258789,191.46999740600586,161.03437423706055,181.06000137329102,-0.5348669369209359,14.305094719064906,-0.820466907605955,2.9921042581233674,172.3512477874756,11.859549789428712,0.0844342583470806,147.8750015258789,184.7232479095459,0.8353374235817198,0.12861487414171446,1.0432475601127673,0.9962306732521996,1.0214637457926083,0.020909159614224793,58.24569964406835,198.03306350734368,169.42287406921386,140.81268463108404,174.59249877929688,3.369493469222352,178.38053458077567,6.5289709327630705,174.75710781080392,171.18029593110688,-2.874091792887013,8.480285829763428,79663000,7.628339931774434,0.769463699362169,-1256990400.0,-76.55381422776443,40.7826645074338,41.89594136137823,31.233405815246673,28.030119017078675,24.46655298059114,-0.13283695176657312,8.231084756981994,191.1999951171875,186.4549951171875,182.6199951171875,178.7849951171875,174.0399951171875,0.02,0.0,198.39763378913295,-0.004178089070735247,-0.021483561767503455,173.77142987932478,177.71214294433594,14.289738433190644
2024-05-16,0,174.03999710083008,141.4625015258789,191.46999740600586,164.09937572479248,181.06000137329102,-0.734242612216728,14.059305641484213,-0.5164383250902076,2.992251359355378,173.31124687194824,11.263012332916261,0.08248569792588492,147.8750015258789,184.7232479095459,0.8064405338306168,0.17426258265959016,1.0210895896253838,0.9837089335363451,1.0016114022425406,0.0031557595943729755,60.442763410063925,198.56398539032926,170.44537410736083,142.3267628243924,173.70999908447266,2.285240814271559,178.74714170183455,6.085147239824904,175.20099248707623,171.92048667635228,-4.242062032996408,7.384792180291313,59812200,7.4601041518632245,0.5880301096521282,-1316802600.0,-77.21723184341106,40.7826645074338,41.89594136137823,15.78860112425684,26.93247233506876,25.017360699934255,-0.10458067016262643,7.954519488952511,191.52567626953126,186.98215698242188,183.30999755859375,179.63783813476562,175.09431884765624,0.02,0.0,198.27576239654337,0.016688928864425634,0.0006867852355147614,173.3471439906529,178.18000030517578,13.493452124701053
2024-05-17,0,175.84750366210938,141.4625015258789,191.46999740600586,167.82937335968018,181.06000137329102,-0.96291411817992,13.306995582601097,0.13702670668850692,2.992641193649698,173.7662467956543,10.084849548339843,0.07753693646865913,147.8750015258789,184.7232479095459,0.7676163332346447,0.1736066271473347,1.0246247272711673,0.9977786123665928,1.0113763695931381,0.030864849502246106,57.40587562484976,198.23536529545123,171.62137413024902,145.00738296504682,174.09821428571428,2.398315376583513,177.63124929155623,4.8870397000508845,174.82928805680893,172.65804732658233,-3.427801426816518,3.0386452784195486,77445800,7.473216007567804,0.7646079004915229,-1239356800.0,-58.14651727959432,40.7826645074338,41.89594136137823,27.41603312687323,28.734519514979972,23.456420567252998,-0.06338421948628968,7.877753172383784,185.47479766845703,182.08759811401367,179.3499984741211,176.61239883422851,173.22519927978516,0.02,0.0,198.13643931243135,0.053362648709112115,0.03192420453680343,173.7385733468192,176.995000566755,12.256508017070649
2024-05-20,0,175.94499969482422,141.4625015258789,191.46999740600586,170.16374969482422,181.06000137329102,-1.2379098076790012,12.20103713740822,1.2538174503915158,2.9931632244356408,174.94375038146973,8.716549892425538,0.07052663421655615,160.76074905395507,184.7232479095459,0.6548451459326565,0.24306796334956748,1.0170290030233338,1.0016139032910614,1.0058454405860018,0.025484861595340247,61.711878243971064,197.4010734889888,172.99899921417236,148.59692493935592,174.4485718863351,2.4730537477306864,176.9121423448835,4.259284515553038,175.05857440870247,173.6873526005685,1.5696334845507292,-8.159238499789343,61727400,7.219749458413844,0.6233847602819014,-1177629400.0,-63.654730764372225,40.7826645074338,41.89594136137823,6.25585156289431,27.594523026070274,22.525824283047953,-0.08317750119356454,7.617150923770792,182.88483813476563,179.99257849121093,177.65499877929688,175.31741906738282,172.42515942382812,0.02,0.0,198.02051604726876,0.017802068587231767,0.03846379581282238,174.16428702218192,176.4000004359654,9.862922571485978
2024-05-21,0,180.9250030517578,144.09499740600586,191.46999740600586,171.32499885559082,181.06000137329102,-1.24674752735266,9.828484733055213,2.4919081419318063,2.9941081232438242,175.8962516784668,6.948063220977784,0.056251768518960556,164.39675102233886,184.7232479095459,0.48621337595428593,0.2210347538927875,1.0354954672444259,1.0350519107130554,1.0291700207678873,0.02563738599374643,61.14248549926917,194.38009358873006,174.72312412261962,155.06615465650918,175.92607225690568,2.8405565760187446,176.8557139805385,4.195515823105756,175.3210432112678,174.9772496342557,1.413607651026164,-5.412269292970805,115266500,7.226732088863943,1.1695555457585125,-1062362900.0,-4.845994817711125,40.7826645074338,41.89594136137823,72.74124164975078,32.786130199638905,20.059981568018713,-0.037953258376604126,7.942410096807248,182.88483813476563,179.99257849121093,177.65499877929688,175.31741906738282,172.42515942382812,0.02,0.0,197.87626926071954,0.05097157361985283,0.08557802528419245,176.75428771972656,176.8721433367048,7.284866212056913
2024-05-22,0,181.22000122070312,162.61249923706055,191.46999740600586,172.74062252044678,181.0993776321411,-0.023449417353868185,6.944569580785479,-0.2542141621604488,2.9949580000824967,176.1737518310547,5.508337364196777,0.03933160226286229,168.4762477874756,184.7232479095459,0.5120707851068034,0.11261436790293003,1.026366418706388,1.036320104196451,1.0255713760259542,0.025289964473567794,61.64856422054158,190.45376356647816,176.56462440490722,162.67548524333628,177.3042869567871,2.713801685200312,176.8805353982108,4.2220518708537425,176.79025893944174,176.7710311432961,6.063050175861943,-0.4347451229489639,88313500,6.11267371055412,0.9403797722967708,-974049400.0,-37.607258285654424,40.7826645074338,41.89594136137823,40.40967143635221,30.297385131349564,18.537259005356184,-0.04265171278301072,7.980816278330643,182.88483813476563,179.99257849121093,177.65499877929688,175.31741906738282,172.42515942382812,0.02,0.0,197.75284547410672,0.035174406138104075,0.014418459671034093,177.92857360839844,176.87928662981307,6.453321561024383
2024-05-23,0,177.67499923706055,164.59500122070312,191.46999740600586,173.40187168121338,181.3206262588501,0.10019456945580973,6.221895665075259,-0.18174296555837044,2.995118251270216,176.57625198364258,5.117999897003173,0.03505392085669383,170.41500015258788,184.7232479095459,0.4161866217484243,0.10100549759532351,1.001014111572011,1.011368820672064,1.0004476368522408,0.020886015839936656,61.42027534897848,189.93879083423988,177.49499950408935,165.05120817393882,177.48607199532645,2.6858025477347187,176.5985709599086,4.00736113308244,177.9323695030876,177.78867593886096,5.622989111629153,0.19212420062402244,71975500,6.109485880449794,0.7892916755446513,-1046024900.0,-69.76271463210986,40.7826645074338,41.89594136137823,-25.620339079511307,27.967938874159685,21.43684353021451,-0.1405739230965285,8.027907751985024,182.88483813476563,179.99257849121093,177.65499877929688,175.31741906738282,172.42515942382812,0.02,0.0,197.62810986619687,-0.006291414251695326,-0.0014368641422327119,177.38428824288505,176.3471439906529,6.284617930897175
2024-05-24,0,176.9724998474121,168.90749740600586,191.46999740600586,173.9031219482422,181.3206262588501,0.44135115595405056,5.474065400270407,-0.1351652854669787,2.995262111114882,177.21249961853027,4.529399986267089,0.030727455211963545,171.47349853515624,184.7232479095459,0.3297794480355009,0.05190712055830235,0.9933959799862749,1.0049773939935243,0.9924294381500802,0.006397566993412651,53.37516557299281,189.09713020544802,178.14899940490722,167.2008686043664,177.5178576878139,2.6769414764363395,176.05517823355538,3.29415622495075,177.90457493926215,178.1844986088857,0.7213589609880946,-2.1734653505939323,65479700,6.128711919139158,0.7359486604897498,-1111504600.0,-39.937257917339345,40.7826645074338,41.89594136137823,-13.165163936704193,26.363595581623066,20.207147760154307,-0.09651485075361145,7.9080411702084445,182.36532373046876,179.57234301757813,177.31500244140625,175.05766186523437,172.26468115234374,0.02,0.0,197.5231639771375,0.01003042213430616,0.025165918825404855,178.13428824288505,175.9528590611049,5.87784248667474
2024-05-28,0,176.13999938964844,170.58250045776367,191.46999740600586,175.39562702178955,181.3206262588501,0.6232898876918757,5.059814319334485,0.1315333430919461,2.9953329523550507,177.32374954223633,4.166474876403808,0.02833800376494274,172.9742473602295,184.7232479095459,0.6303981412855094,-0.07571681075365704,0.9864899482156083,0.9966333707604702,0.9865161863791245,0.0011082991569095757,41.58758038654746,188.6718781656465,178.55224952697753,168.43262088830858,177.81785801478796,2.3154938948896615,175.7639285496303,3.07050224917612,177.7215291623313,178.42349153644454,0.12588393064334336,-4.12151817678053,59736600,3.228752050884158,0.7488930038141935,-1171241200.0,-52.953488223695544,40.7826645074338,41.89594136137823,-31.28399068901313,24.89128827806539,19.60220574804666,-0.14231006000093507,7.777450275870198,182.36532373046876,179.57234301757813,177.31500244140625,175.05766186523437,172.26468115234374,0.02,0.0,197.42059431435715,0.01028867152418611,-0.0040009392933923835,178.40714590890067,175.87714494977678,4.570383243129241
2024-05-29,0,175.61499786376953,170.58250045776367,186.0124969482422,175.39562702178955,180.99875259399414,0.16769965909648074,4.118462804388754,-0.7831774964613896,2.9954642521857453,176.86124992370605,3.487900009155271,0.023165314503827687,172.9742473602295,182.00149993896486,0.6308889909414016,-0.05307437790774221,0.9877900688499799,0.9911014319401901,0.9833609893446212,-0.029349206015871876,42.5072834902529,186.02267523493717,177.78574962615966,169.54882401738215,177.78464290073939,2.349881051133029,175.94142859322685,2.976927835200531,177.3271818646019,177.80999403049927,1.2066205032178454,-2.262541478424234,54782600,3.0341293032279384,0.7193653130183776,-1226023800.0,-55.880813972038055,40.7826645074338,41.89594136137823,-24.365617272447345,23.893877607316753,18.816732173320478,-0.0721492036456527,7.5233166744091315,182.36532373046876,179.57234301757813,177.31500244140625,175.05766186523437,172.26468115234374,0.02,0.0,197.3275484806535,-0.055787799151166384,0.007087770876217334,178.22571672712053,175.98214503696985,4.366088568453975
2024-05-30,0,178.85499954223633,170.58250045776367,184.57999801635742,175.22124767303467,180.88562679290771,0.09283808735391767,3.680095853198807,-0.8330460650808034,2.9955168831182037,176.57625198364258,3.070050201416018,0.020760317573867607,172.9742473602295,181.6317512512207,0.6596609023793166,-0.033569063003583234,1.008964640674587,1.009835525536659,1.007494740355146,-0.013050445108354958,43.59458030886192,184.62606637833366,177.26587467193605,169.90568296553843,178.2003571646554,2.2242337068905726,176.32446452549524,2.982576161168409,176.90220947130135,177.30787803483764,-0.13222013022522242,1.4353379828881752,77784800,2.900919978758429,1.0316036096206154,-1148239000.0,-42.289647317070056,40.7826645074338,41.89594136137823,42.24603338650971,26.53767454972902,17.511328121188672,-0.03225140219329832,7.506648885105865,182.36532373046876,179.57234301757813,177.31500244140625,175.05766186523437,172.26468115234374,0.02,0.0,197.21440466947098,-0.007328895229279597,-0.04185430097494322,178.7742876325335,176.4692873273577,4.332565824726166
2024-05-31,0,177.68000411987305,170.58250045776367,184.57999801635742,175.22124767303467,180.38124656677246,0.1300580337045706,3.5579750554977325,-0.6289175119558608,2.995530661171964,176.57625198364258,2.898450164794923,0.020087609026788765,172.9742473602295,181.2602512359619,0.6273504930342331,-0.011154276165456995,1.0031454405851445,1.002010472716336,1.0035498425417047,2.8168751000423597e-05,52.25568726373192,184.2388247524139,177.12287464141846,170.00692453042302,177.73678588867188,1.871989907509283,176.83142907278878,2.4948260421711765,177.4048501223607,177.2635211093597,1.6539258589101653,3.0909135324201835,67314600,3.0037117381498635,0.9058599793083476,-1215553600.0,-49.21700586456207,40.7826645074338,41.89594136137823,11.03963671630953,24.880276343766578,17.91657278039317,-0.014454790381436594,7.434738049973305,182.66032373046875,180.04984301757813,177.94000244140625,175.83016186523437,173.21968115234375,0.02,0.0,197.1094488804198,0.024979833087788172,-0.011270883195922902,177.55714416503906,177.1557159423828,4.284428914093781
2024-06-03,0,177.88750076293945,170.58250045776367,184.57999801635742,175.22124767303467,179.19562339782715,0.21689137047373164,3.456333466280544,-0.37942011771725603,2.995541774220558,176.57625198364258,2.707825336456298,0.019531362984133178,172.9742473602295,181.2602512359619,0.5925954806536718,-0.021707096992981637,1.0052228413828717,1.0011255715744847,1.0047161187197693,0.005170299997549144,48.99973338336408,183.87591671130863,176.96324977874755,170.05058284618647,177.26071439470564,1.105252213701793,177.28250067574638,1.990833942836555,177.4789755124725,177.08298647587904,-1.7935602471464147,4.160745470996728,68568900,3.0055884227997263,0.9270573818111317,-1146984700.0,-68.54371022347937,40.7826645074338,41.89594136137823,26.998888522853477,25.15916389850556,16.52314245449351,-0.033820932737308115,7.485832598243772,183.23380200195314,180.97810021972657,179.15499877929688,177.33189733886718,175.0761955566406,0.02,0.0,197.00582217556365,-0.016458447425922174,0.014677032993814895,177.0114288330078,177.47000122070312,4.168028598186852
2024-06-04,1,175.32749938964844,170.58250045776367,184.57999801635742,175.22124767303467,178.12937545776367,0.28001564581795874,3.296762984998885,0.011006820052187116,2.9955586474322464,176.57625198364258,2.502400302886963,0.018649328330938936,172.9742473602295,180.95450286865236,0.48042995787781406,-0.03625797662444921,0.9918032070968412,0.9855867139432957,0.9892346570386233,-0.004612808009625491,47.64979412508945,183.37002571822777,176.77649974822998,170.1829737782322,176.92535727364677,1.2979427484815322,177.2057146344866,2.0473162117051773,177.56371308803978,177.025884331849,-1.8389253036728028,3.6806612383598343,60056300,2.9145250269396676,0.8255464496085286,-1207041000.0,-78.3818190437438,40.7826645074338,41.89594136137823,-24.190778279362952,24.22316400378936,16.393263970565904,-0.05616047621242405,7.219677871047763,183.23380200195314,180.97810021972657,179.15499877929688,177.33189733886718,175.0761955566406,0.02,0.0,196.90522171854747,-0.01120223891111205,-0.024938635816286026,177.15857151576452,177.27142987932478,3.727903138030487
2024-06-05,1,174.65750122070312,170.58250045776367,181.22000122070312,175.00562381744385,177.73187828063965,-0.143361090303467,2.777566415603901,-0.3981882447135914,2.9956080798363365,176.2712516784668,2.1446258544921877,0.015753532831652976,172.9742473602295,180.28824577331542,0.45726480871301983,-0.027133856099329983,0.9906055402734948,0.9821613132003613,0.9863587384275923,-0.005452248695804296,44.019303144879544,181.86900764810235,176.31387481689453,170.7587419856867,176.5946431841169,1.5536665376634717,177.0562504359654,2.1566089806486475,176.97191493939755,176.5480417075559,-1.3212325073827569,-0.6094043754821555,57953800,2.809904048791044,0.8061149441755059,-1264994800.0,-76.89317473423061,40.7826645074338,41.89594136137823,-51.729634234739905,23.228177761820433,17.630638221226558,0.005306690323535595,6.991109979052356,183.23380200195314,180.97810021972657,179.15499877929688,177.33189733886718,175.0761955566406,0.02,0.0,196.80416139101845,-0.006754086071381948,-0.009900990099009901,176.5528564453125,177.34357234409876,3.7173851448976727
2024-06-06,1,176.25,170.58250045776367,181.22000122070312,174.50312519073486,177.67625045776367,-0.02171408733109434,2.6481800408280085,-0.15499402437635634,2.99561909697598,176.04249954223633,2.0148759841918946,0.015043411116494761,172.9742473602295,179.06199989318847,0.6013233622864269,0.008822872936625082,1.0012163706411692,0.9946219857564242,0.9964298075068075,-0.014564868462741298,46.752790759630855,181.33223521135574,176.03587512969972,170.7395150480437,176.6103575570243,1.5488505208395504,177.21410778590612,1.9935646508615725,176.3756272135396,176.16775935290252,-1.3081120675274436,-1.1838748397719236,69887000,2.309792129494349,0.978965829278064,-1195107800.0,-60.6101860434322,40.7826645074338,41.89594136137823,19.9415069545097,25.22459102421773,16.36972433050831,-0.0013523045350356466,6.991745028762072,183.3990048828125,181.2455048828125,179.5050048828125,177.7645048828125,175.6110048828125,0.02,0.0,196.69629181552307,-0.004754129854271261,0.009932459139286181,176.72285679408483,177.56500135149275,3.7255594999591173
2024-06-07,0,177.13500213623047,170.58250045776367,181.22000122070312,175.1599998474121,177.67625045776367,-0.13387656519349686,2.562929504922835,0.17057323003734037,2.9956263964480416,176.19499969482422,1.8698759078979492,0.014546241142155787,173.30049667358398,179.06199989318847,0.5768314441690531,0.01589407937116646,1.005352839725284,1.0024277726764679,1.004391578798954,-0.0030673231146195468,51.352013350253124,181.3177342768745,176.19187526702882,171.06601625718315,176.82750102451868,1.4915361003920171,177.30607196262903,1.954996505182213,176.34074802603874,176.26235554822662,0.06245067033764684,1.2698247161481833,56244900,2.333902343873108,0.7932617551249004,-1138862900.0,-63.72887562897246,40.7826645074338,41.89594136137823,36.79539314625,24.21993175369547,15.71774169623093,0.03232950598409157,6.761604464612325,183.3990048828125,181.2455048828125,179.5050048828125,177.7645048828125,175.6110048828125,0.02,0.0,196.6132149362103,-0.003369306476562417,-0.007327018333163924,176.90714154924666,177.5664291381836,3.5953328064912227
2024-06-10,1,175.39749908447266,170.58250045776367,181.22000122070312,175.54312324523926,177.67625045776367,-0.2988147140212845,2.4931065268779973,0.5285357328157452,2.995632217162953,176.32625198364258,1.7762508392333984,0.01413534035126052,173.7932472229004,179.06199989318847,0.47578967058841526,0.038412508087775396,0.9944634613843172,0.9928984594584871,0.9951546420085465,-0.013997620225071783,56.22399147835608,181.3602136030724,176.3740005493164,171.38778749556042,176.3335723876953,1.2632284336772344,177.26696477617537,1.9894890890950028,176.5366664494681,176.3764031291877,0.8655321532617938,0.7321676152963874,50869700,2.223682396335703,0.7286309313603987,-1189732600.0,-88.74584133342161,40.7826645074338,41.89594136137823,-62.28136277009929,22.818052603626278,17.391196530521015,0.04267566321037682,6.664341289732714,183.3990048828125,181.2455048828125,179.5050048828125,177.7645048828125,175.6110048828125,0.02,0.0,196.52976584236194,-0.014181179279656009,-0.024090344231868472,176.19285583496094,177.4835717337472,3.1370528526152417
2024-06-11,1,171.68500137329102,171.5724983215332,181.22000122070312,175.5606231689453,177.67625045776367,0.18174643082286765,2.1279623387040894,0.7478427836683763,2.995659735447486,176.32625198364258,1.5567255592346185,0.012048610509104718,174.59575080871582,179.06199989318847,0.30902770687118736,0.022293787176609507,0.9720875572739838,0.9727498649074184,0.9768511068943574,-0.020775394784262158,49.72713800714599,180.87067515806004,176.61475048065185,172.35882580324366,175.47714342389787,2.009830694786215,176.60696465628487,2.2037300206887145,176.24851040333675,176.38412173635632,-1.9331304501483553,-0.31117713563966,64761900,2.2650554073044056,0.9291173550830705,-1254494500.0,-80.17083513711033,40.7826645074338,41.89594136137823,-226.18153721358019,21.035749049364053,22.162341552624603,0.04208552385081346,6.712605298396842,179.9319631958008,177.5390232849121,175.6050033569336,173.67098342895508,171.2780435180664,0.04,0.0,196.40356960409272,-0.023516624763275762,-0.03193595688035175,175.13285609654017,176.34500013078963,3.2479067566627977
2024-06-12,1,174.68999862670898,171.68500137329102,181.22000122070312,175.5606231689453,177.67625045776367,0.221560663886192,2.1147335633291386,0.7006345120938726,2.9956606503235577,176.32625198364258,1.5516629219055176,0.011973327288808847,174.59575080871582,179.06199989318847,0.3677008647647825,-0.02674283237424469,0.9890704738928917,0.9922805473568892,0.9980859755190963,0.00018606361466710908,36.17748747658315,180.84984275989802,176.62037563323975,172.39090850658147,175.0203574044364,1.7120025645945478,176.140535899571,1.8077272061844571,175.10893343930252,175.88904675813868,-3.3740446913415543,-5.107089414183113,90389400,2.1463733795483786,1.2930929224115493,-1164105100.0,-35.25561480643029,40.7826645074338,41.89594136137823,-27.690925152802567,24.646311095465215,19.73148081003922,0.04984523997379594,7.0010069129167425,179.06863946533204,176.840680267334,175.04000091552734,173.2393215637207,171.01136236572265,0.04,0.0,196.26327145121044,0.013085675920758932,0.014418887406693035,175.27571323939733,176.14357103620256,3.244890680006282
2024-06-13,1,185.79249954223633,171.68500137329102,181.22000122070312,175.3799991607666,177.67625045776367,0.292425448089257,2.1560869007864323,0.4938980765354226,2.995657772493416,176.19499969482422,1.6287256622314459,0.012213385162489295,174.59575080871582,179.06199989318847,0.4565081359340651,-0.011654887543372083,1.05244151169569,1.0559001735181948,1.0614803580103345,0.0541418413743906,45.66526709770878,180.84692416778378,176.53475036621094,172.2225765646381,176.51535742623466,4.432554780047282,176.7203573499407,3.1449780860266805,175.00631667392994,175.80709367266098,-1.7974855582976557,-3.6033564452090587,118984100,2.2640051750285104,1.655597725600464,-1045121000.0,-36.37516382087328,40.7826645074338,41.89594136137823,246.72934107708352,31.451090778230988,17.135082122505608,0.027809641797358564,7.485961018705055,185.4938822631836,182.03806253051758,179.24500274658203,176.45194296264648,172.99612322998047,0.02,1.0,196.16216869968065,0.025458012347665093,0.042685721261160714,176.37571280343192,176.76714215959822,3.421635779557984
2024-06-14,1,181.68249893188477,171.68500137329102,185.79249954223633,175.3799991607666,177.73187828063965,1.189695124448348,2.9541958463991693,1.944016482456604,2.9955938594616187,176.19499969482422,2.12750068664551,0.016691609706474334,174.59575080871582,180.95450286865236,0.14132245759127324,0.0675275950194221,1.0265309141113053,1.0284870714219347,1.0268028641076472,0.02567249126830906,67.75557870543716,182.8952670361211,176.98687534332277,171.07848365052442,177.51892852783203,4.727277021640339,177.05678585597448,3.4144064512395693,177.70666779937255,177.21912025455856,5.968829869255386,4.568735241329655,82038200,3.294843538555342,1.1241334158044787,-1127159200.0,-55.217610203985586,40.7826645074338,41.89594136137823,90.54421090313663,28.766914306037144,19.723736888462263,-0.0384472468552553,7.59982661845497,185.4938822631836,182.03806253051758,179.24500274658203,176.45194296264648,172.99612322998047,0.02,0.0,196.06528882189738,0.002986245165965018,0.0003933464340191585,176.8057120186942,176.67928423200334,3.3835732053857646
2024-06-17,1,182.79249954223633,171.68500137329102,185.79249954223633,175.5606231689453,178.12937545776367,0.940966717683131,3.041297911872016,1.073672018496823,2.995586030230439,176.61124992370605,2.27655029296875,0.017146727468809794,174.6867488861084,181.2662509918213,0.32947764052215395,0.03318213308837936,1.0305774915236792,1.0324314217240886,1.027793162444024,0.04216137913233409,58.093860920772826,183.45159625861953,177.3690004348755,171.28640461113145,178.45357131958008,5.068996610672035,177.53196443830217,3.7257215807034862,178.7159363053163,177.92668335067273,4.022156312831142,2.661429933200738,109786100,3.4440375364220333,1.4717409729667412,-1017373100.0,-15.378114369371024,40.7826645074338,41.89594136137823,173.81350910166938,28.23584854588193,17.617669051701732,-0.00026395268387905795,7.900566705418679,185.4938822631836,182.03806253051758,179.24500274658203,176.45194296264648,172.99612322998047,0.02,0.0,195.97079287705154,0.07854312493585103,0.0561190385036826,178.16285487583704,177.44285583496094,4.076415065505261
2024-06-18,1,185.24749755859375,171.68500137329102,185.79249954223633,175.5606231689453,179.3725004196167,0.6969665578942202,3.237882035562744,0.19388792032922098,2.995566974046245,177.0537509918213,2.5141250991821322,0.01821939204429902,174.6867488861084,181.79349899291992,0.3864707475849608,0.03891841120400731,1.0423779329127887,1.0434068613701335,1.033006454458811,0.07899639500723832,59.65156596872367,184.19201430000734,177.71625022888185,171.24048615775635,179.61249923706055,5.615237772622212,178.22000013078963,4.203297274800462,179.74737149686308,178.61889841686929,3.7120564778645835,3.7768253523559685,68982300,3.4482127012380737,0.9202692891910519,-948390800.0,-26.277996205608815,40.7826645074338,41.89594136137823,150.03636664899736,26.907535204359682,16.788872112595325,0.014501896962938826,7.698375407599405,185.4938822631836,182.03806253051758,179.24500274658203,176.45194296264648,172.99612322998047,0.02,0.0,195.9141929305584,0.08320635558145684,0.06369761063280999,179.2171412876674,178.06214141845703,4.309982490577273
2024-06-20,1,182.78000259399414,171.68500137329102,185.79249954223633,175.5606231689453,180.99875259399414,0.5823723053479606,3.598146301125208,-0.35058747440661,2.9955291432243376,177.4050006866455,2.9245373535156234,0.020193728433514184,174.6867488861084,183.0379993438721,0.48429695974063575,0.023891084338406157,1.0258086877417651,1.0237883349133052,1.0040595456977814,0.04631063043610473,61.41057102568055,185.37766772432073,178.1813751220703,170.98508251981988,180.6671425955636,5.379998673991917,178.50035749162947,4.376248819211933,181.1259220594883,179.59397493166517,4.579837595352355,5.485009715569095,55893100,3.313642170528498,0.7763992712891972,-1004283900.0,-40.17741969795718,40.7826645074338,41.89594136137823,91.26332362281636,25.49369047188779,18.472388200116704,-0.07337402274093024,7.5449142593850755,185.4938822631836,182.03806253051758,179.24500274658203,176.45194296264648,172.99612322998047,0.02,0.0,195.8578530073858,0.02414131761615179,0.06392829853508118,180.32857186453683,178.2607138497489,3.928501351926424
2024-06-21,1,182.48749923706055,171.68500137329102,185.79249954223633,175.5606231689453,181.33562564849854,0.5405665260140837,3.6903994724819884,-0.5585926305065119,2.9955187762714344,177.4050006866455,3.0451123237609865,0.020700701632549584,174.6867488861084,183.0379993438721,0.5510144113624073,0.008608328897377782,1.023634243811514,1.0175206719953,0.993621328663096,-0.017788663769090718,56.04098740056721,185.6549240441461,178.27412509918213,170.89332615421816,182.21035657610213,3.643043279782676,178.84375,4.4939588534612644,181.5315195490869,180.05448473561086,4.209012983683433,2.194516821896795,63029500,3.367656170309205,0.891179263056912,-1067313400.0,-34.093823187559465,40.7826645074338,41.89594136137823,94.42673689494451,24.6735874181146,17.878152462058118,-0.037137232733746216,7.238837487765962,185.4938822631836,182.03806253051758,179.24500274658203,176.45194296264648,172.99612322998047,0.02,0.0,195.79672296347405,0.0029593537705940864,0.03226353114849207,182.09285627092635,178.61285618373327,4.060856006826439
2024-06-24,1,184.72500228881836,171.68500137329102,185.79249954223633,175.5606231689453,181.8837490081787,0.5108121027700033,3.750833062609081,-0.6878235627289309,2.995511851219647,177.4050006866455,3.1274996948242206,0.02103221735534636,174.6867488861084,183.0379993438721,0.6076604548470171,0.027085971693625758,1.0358169329996123,1.0264267870009647,1.0094372764734942,0.016746265462113996,57.27437179625365,185.83916612521818,178.3375,170.83583387478183,183.64392852783203,1.5817893674673025,179.3321429661342,4.746488487665378,181.75830917164183,180.28954547821377,6.292045185870309,2.7057040779580857,61992100,3.2598732744236445,0.882741598005775,-1005321300.0,-35.91043792792462,40.7826645074338,41.89594136137823,119.52119268510924,27.96990832437462,16.764681585916286,-0.035563557627781774,7.168203865406211,185.4938822631836,182.03806253051758,179.24500274658203,176.45194296264648,172.99612322998047,0.02,0.0,195.7465594193652,0.02567275695322402,0.0006028421637292223,182.84857177734375,179.06214250837053,4.034476363449499
2024-06-25,1,185.43249893188477,171.68500137329102,185.79249954223633,175.5606231689453,182.56062507629395,0.361835132652414,3.995316785616023,-1.0517595999810379,2.9954829465085693,177.40750312805176,3.484249801635741,0.02235892765238302,174.6867488861084,184.7772518157959,0.6131389823079461,0.043806254915823385,1.0377329384606822,1.0260308256447959,1.0099451745189638,0.014442602383903713,61.28173115591422,186.68063372381994,178.69000015258788,170.69936658135583,183.59249986921037,1.5042416669769334,180.05392864772253,4.857686353986274,182.50349725809033,180.5813011482551,5.744463759229252,3.8437222944578076,63678300,3.2805434854731756,0.9079168384145764,-941643000.0,-15.758327064143124,40.7826645074338,41.89594136137823,121.05543896498764,26.288499076780447,16.30154735836084,-0.03398819098046655,7.0819013762936995,185.4938822631836,182.03806253051758,179.24500274658203,176.45194296264648,172.99612322998047,0.02,0.0,195.70071091019457,-0.0004801341054121444,0.05246902918319558,183.54571533203122,179.96071406773157,4.483637399183728
2024-06-26,1,191.75749588012695,171.68500137329102,185.79249954223633,175.5606231689453,182.7831268310547,0.20917146098786865,4.231926438476808,-1.2751210533602435,2.9954535680272683,177.78375244140625,3.8035997772216774,0.023627131676389534,174.6867488861084,185.26599769592286,0.6423306944949084,0.05275632777583874,1.070595075543233,1.055169280091962,1.04139906292956,0.035142166060699864,62.88071899174818,187.57685298376518,179.1130001068115,170.64914722985785,185.03178514753068,3.2170048038248256,181.27535683768136,5.50334275160469,183.24136032835068,181.09032719570504,-0.19376487815091983,5.763499495181268,95737100,3.2678924518807237,1.3308513376371613,-845905900.0,-4.579900523725952,40.7826645074338,41.89594136137823,208.21954800166048,32.8543073331074,14.505353308459773,0.0001292258854062245,7.390345492162757,190.59739666748044,186.16629800415038,182.58499908447266,179.0037001647949,174.57260150146485,0.04,0.0,195.68557696432978,0.06226330449439277,0.04764187238299234,186.16857256208144,181.48714229038782,5.888151697733386
2024-06-27,1,196.3400001525879,171.68500137329102,191.75749588012695,175.5606231689453,183.27562522888184,0.48071189968918987,4.985144219976059,-0.490063285987679,2.9953498917868897,178.3712501525879,4.365262012481691,0.02771158396515091,174.6867488861084,185.46849899291993,0.5913429227682176,0.09191981443908169,1.0914212628280413,1.0685824350406499,1.0587991057789152,0.07418753346182139,71.15468279078932,189.8641633712876,179.89387493133546,169.92358649138333,186.96714237758093,5.14355248134602,182.7103568485805,6.601796230879559,185.37281449158007,182.3899046498204,5.545386598859718,9.790587028847789,72746500,3.505358877475087,0.9987858847396435,-773159400.0,-4.152038176703711,40.7826645074338,41.89594136137823,207.8731795393183,32.284246671470235,13.832940899202963,0.01958971692571939,7.196029741709114,191.330841796875,186.7595821533203,183.06500244140625,179.3704227294922,174.7991630859375,0.06,0.0,195.69099796921105,0.08729410257953107,0.06794329501852459,187.59428623744415,182.87857055664062,6.978419003427478
2024-06-28,1,198.9724998474121,171.68500137329102,196.3400001525879,176.03687477111816,184.8556261062622,0.7820912932578991,6.032094237159313,0.20564525483789575,2.9951810286515603,180.26874923706055,4.973624420166016,0.03333935813968602,174.6867488861084,186.3889991760254,0.6568405782855796,0.09776075958235939,1.0997201256400553,1.0702984765988484,1.0575290294086652,0.09033495817122628,74.67607596505282,192.99431352009498,180.93012504577638,168.86593657145778,188.92785699026925,6.745336783021092,184.2701781136649,7.6756277448243075,188.1166536115731,184.10554394005587,7.411409463888454,11.398581646858378,95438100,3.565839076123468,1.2946447859564598,-677721300.0,-14.864467905589049,40.7826645074338,41.89594136137823,191.96147281887312,34.17281077050128,12.750685982284814,0.0007446621240194208,7.249171976316769,194.75355853271483,189.52821951293944,185.30500030517578,181.08178109741212,175.85644207763673,0.08,0.0,195.71189013357517,0.08125244971482237,0.08982759762447969,189.45428684779571,184.33571406773157,7.896914165001572
2024-07-01,1,206.2400016784668,171.68500137329102,198.9724998474121,176.03687477111816,185.2937479019165,0.8391117243303837,7.1718500730991055,0.017420299361901925,2.994963302286387,182.08499908447266,5.696749496459961,0.039419631467621154,174.6867488861084,192.21574630737305,0.7221832359963712,0.1198361955978678,1.1335854454823577,1.1015814254121499,1.077277879621663,0.11647042426887966,77.50320600411469,196.2797002072333,181.93600006103514,167.59229991483699,192.2792854309082,8.72054224017915,186.47321401323592,9.206602858270116,190.82737401091077,185.9489651096194,7.409008202379168,12.328166340826824,135691400,3.5494076763925575,1.759109038420041,-542029900.0,-7.3548574874810395,40.7826645074338,41.89594136137823,233.53383984743132,38.53873101949487,10.964679057258047,0.027221995181234703,7.8278153174678735,202.41647760009764,195.72675875854492,190.31999969482422,184.91324063110352,178.22352178955077,0.1,0.0,195.82873708796345,0.1494139473420515,0.14671333210991783,193.4957144601004,186.91214316231864,9.9851267893574
2024-07-02,1,224.87749862670898,171.68500137329102,206.2400016784668,176.03687477111816,185.52249908447266,1.0069876205734642,8.833164748723473,0.36552072207024056,2.994589293827661,182.63375091552734,6.759549636840819,0.04817284064300359,174.6867488861084,196.6032501220703,0.7214647671342287,0.15938444687753026,1.226399395200598,1.1855781465807294,1.1488082893767382,0.21271891347003646,81.99272916420313,201.03032943641182,183.36399993896484,165.69767044151786,198.3349996294294,13.942440289096686,190.27267810276575,12.878111516207667,194.6877938510181,188.57467519582826,12.835101625741805,17.584345703321674,205047900,3.795385571346699,2.44219818668054,-336982000.0,-0.06505454458846086,40.7826645074338,41.89594136137823,290.1651910597693,46.49925282257311,9.05652813386142,0.16917848138412062,8.800135340327124,216.7860030517578,207.80700305175782,200.5500030517578,193.2930030517578,184.31400305175782,0.12000000000000001,0.0,196.26921342832225,0.23437409646551566,0.26662280746839895,200.3885716029576,191.24071393694197,14.43877521853679
2024-07-03,1,240.88750076293945,171.68500137329102,224.87749862670898,176.03687477111816,187.28374862670898,1.602961635028584,12.536888618537484,2.425280966272946,2.9935274467315596,182.78625106811523,8.969899673461919,0.06750660899648245,174.6867488861084,199.6992500305176,0.6344020928672999,0.28261396192584975,1.2970920314390286,1.2424182311309389,1.1829230945451508,0.2562090449571006,89.49319505860878,210.78727706922828,185.71349983215333,160.63972259507838,206.358213697161,19.75360483793437,195.0010711124965,17.892902326847107,202.22904316056855,193.28971659635997,23.22898804952205,30.9826116596887,166561500,5.26949630120572,1.8654902476204323,-170420500.0,-2.743954215520346,40.7826645074338,41.89594136137823,273.56755943812004,53.422458643129296,7.879427315352004,0.24628780523349486,9.392281201725195,231.492524230957,221.06374307250974,212.63500213623047,204.20626119995117,193.7774800415039,0.14,0.0,196.80162958656183,0.25472325465308776,0.3151320595821692,209.50428553989954,196.17642865862166,19.433081975676654
2024-07-05,1,249.04000091552734,171.68500137329102,240.88750076293945,176.91375160217285,192.9031219482422,1.7312354043912666,17.124349928081468,2.3933011822793757,2.9918154465780313,183.75875091552734,12.512599754333497,0.09060910113453924,174.6867488861084,208.10375137329103,0.675070639036885,0.3791992847678833,1.3177312262520946,1.2486337473829399,1.1666631563068217,0.2684119421512836,92.36183209136526,223.24019975698084,188.99149990081787,154.7428000446549,215.44499969482422,22.902296420171865,199.5187497820173,22.721903451300484,211.86519551518418,199.59727413452222,30.403301003245232,37.89427137021529,154501200,5.990399562880126,1.641656045128296,-15919300.0,-1.126561801333959,40.7826645074338,41.89594136137823,226.2942381297595,52.45723066817832,7.287906306359119,0.28848336711791817,9.429260974330479,234.56379583740235,223.548096282959,214.6449966430664,205.74189700317382,194.72619744873046,0.16,0.0,197.34528142617924,0.27403508563108536,0.28084743355196223,218.67142813546317,201.1085717337472,23.45508307535812
2024-07-08,0,251.1650047302246,171.68500137329102,249.04000091552734,180.5456247329712,196.99812507629395,1.532479737093221,21.19975041373976,1.2431581830697516,2.989976378007025,184.98624992370605,16.009375267028805,0.11000820752010534,175.32674903869628,226.47849884033207,0.7541018403585,0.4129929129958998,1.3033272289962143,1.2187979431607552,1.1212548211059596,0.2623101429737167,93.24733925563872,235.11012571303863,192.71062488555907,150.3111240580795,223.9317866734096,23.656335085705347,204.48178591047014,25.893366054271745,221.15204968264942,206.04596540992358,34.30224062665932,34.042010053755114,157219600,6.059970312135411,1.5964679807690207,141300300.0,-7.884521843166898,40.7826645074338,41.89594136137823,188.05806092865598,51.92584445408827,6.499455085033785,0.26839415093105684,9.817891543668093,239.98416186523437,227.94792150878905,218.22000122070312,208.49208093261717,196.45584057617188,0.18,0.0,197.9241557745453,0.2782494249037497,0.2812278633745544,226.7528577532087,206.4607151576451,26.580367637703844
2024-07-09,0,257.3099937438965,171.68500137329102,251.1650047302246,182.2862491607666,200.78937530517578,1.2542422023987845,24.34536691735417,0.17658656609563916,2.9883969344709893,185.33999824523926,19.244425582885743,0.12392250901619715,175.32674903869628,241.70275077819826,0.816656457014799,0.41792983713664544,1.3097563954542788,1.2083472432647053,1.0975422162843942,0.24762408674263425,93.44843449558158,245.14710895677868,196.4563751220703,147.76564128736194,232.64178575788225,23.019855826337395,209.80446406773157,28.608531586646656,228.64617159538255,211.8187646324501,30.980540592392266,38.2439179375168,160210900,6.034514875567026,1.5452746483352848,301511200.0,-3.816171585874069,40.7826645074338,41.89594136137823,167.51521245053843,50.6806716115307,5.803314859652269,0.2988793177858994,10.210190022547573,245.32578967285156,232.7770923461914,222.63499450683594,212.49289666748047,199.94419934082032,0.19999999999999998,0.0,198.57697972777086,0.2500237577876283,0.32570234535632525,236.02571323939733,211.80999973842077,29.792864541215703
2024-07-10,0,262.8774948120117,171.68500137329102,257.3099937438965,182.70687675476074,210.89937591552734,1.0230648855700621,27.260212570851607,-0.4822420794145921,2.9868516009349935,185.61249923706055,22.67292522430419,0.13598481337496185,175.32674903869628,249.25250129699708,0.836001971922471,0.4670106192333689,1.311337796049041,1.193800224006367,1.0744780225064394,0.16898087366394,94.67453369084063,254.98554984415682,200.4651247024536,145.9446995607504,241.77107075282507,19.90248288633415,215.34946387154716,30.913114845403104,235.79930881417965,217.62642333794142,31.05327164302998,40.76616622031695,128519400,5.902445730913003,1.1948576256156656,430030600.0,-4.924356798517331,40.7826645074338,41.89594136137823,145.41594737370906,48.609060942658154,5.406949730355849,0.31287814029573274,10.175891009949975,246.83851806640627,234.00073913574218,223.625,213.24926086425782,200.41148193359373,0.2,0.0,199.12020489501947,0.1383724639751438,0.2544553940720775,245.36571393694197,217.41000039236886,32.00835092009873
2024-07-11,0,253.7449951171875,171.68500137329102,262.8774948120117,182.78937530517578,228.8799991607666,0.8300891931964418,29.78813890972799,-0.9130322310289221,2.9855143202324634,188.77499771118164,25.852362384796145,0.1454221159364127,180.98324890136718,251.7795036315918,0.8450429643228233,0.5311616781272747,1.238752585720135,1.1131766349042471,1.0059027183900962,0.05337551476737379,96.44717540331699,264.4154023082866,204.83912448883058,145.26284666937457,248.55749838692802,12.484535401388875,220.4183919089181,30.979893323348083,242.5750979509683,223.35213894709224,32.11750116905956,41.90609766745357,221707300,5.5941923175450485,1.9210789228101763,208323300.0,-33.18569597043603,40.7826645074338,41.89594136137823,98.68106965787706,39.296274095833766,15.49950359415802,0.20721713334794029,11.688348685499115,249.68684057617187,236.50158093261717,225.84500122070312,215.18842150878908,202.00316186523438,0.2,0.0,199.85882357511167,-0.02175413216294997,0.04224684123726454,249.81857081821985,221.65714263916016,31.76002892591801
2024-07-12,1,242.23999786376953,174.68999862670898,262.8774948120117,184.24187660217285,242.92562580108643,0.6305798959718837,30.57986311921607,-1.3096695199211827,2.985292617890254,194.04874801635742,27.73076194763184,0.14635566303257144,182.40699920654296,254.10149497985842,0.8853854641490633,0.4525444908807247,1.159364100556822,1.0345703797779837,0.9506038394383589,-0.02730486278011346,83.63801359192345,270.1018504144576,208.9421241760254,147.78239793759323,251.03785542079382,7.8664368494594195,224.6864275251116,29.42945064636371,245.39342311116036,226.84469692549425,23.033840696327257,38.82535918375414,155955800,6.397919339214969,1.314019966294261,52367500.0,-25.587147844608328,40.7826645074338,41.89594136137823,73.68771767196142,34.9798093743592,17.640052479657975,0.22691149781723968,12.192758817955648,249.99835870361326,237.00581790161132,226.50499725341797,216.0041766052246,203.01163580322265,0.02,1.0,200.30407944417243,-0.013080504488851674,0.0074678207007126615,252.24285670689173,226.31571415492468,31.90599532356006
2024-07-15,0,256.48500061035156,181.68249893188477,262.8774948120117,185.1168737411499,243.93999862670898,0.4483675585631728,30.339702318441024,-1.5383541486400316,2.9856930893538336,197.65625,28.358549346923827,0.14289636410970047,182.7507522583008,254.10149497985842,0.9262713457077563,0.3038201136246674,1.2080136334632572,1.0743479787841566,1.0119048926968206,0.021181278362569333,69.8155788240449,272.99902877476046,212.3196241378784,151.64021950099635,253.26606968470983,6.622840423283486,229.81214169093542,28.15563320178257,244.62418927113157,228.041317160261,7.7208699594626236,32.74333796918739,146912900,7.063857702808066,1.2234334639713411,199280400.0,-20.631531045092377,40.7826645074338,41.89594136137823,90.23877691236044,39.34885773680598,15.897849717910784,0.20819687836543396,12.56256690337906,249.99835870361326,237.00581790161132,226.50499725341797,216.0041766052246,203.01163580322265,0.02,0.0,200.82994960112651,-0.0011860640818460721,0.004452906719794058,253.1357138497489,231.31999969482422,32.195420774237355
2024-07-16,0,254.0724983215332,181.68249893188477,262.8774948120117,185.1168737411499,249.57125186920166,0.24577462676758577,31.150418448001307,-1.6979011175624785,2.9853968762615986,202.60625076293945,29.59392444610595,0.14431227814466907,182.7507522583008,256.56749992370607,0.8938433237322041,0.41172100845283544,1.1770558109161013,1.0392076440915423,0.9981966942624038,-0.012582081928716682,76.0005983518029,278.1550860872868,215.85424919128417,153.55341229528153,253.9849978855678,6.355375116547342,234.714998790196,25.702582864875428,247.57754741688962,230.69496762028035,6.475014186295126,38.846933242602496,126332500,7.281184094036869,1.03299606062037,72947900.0,-17.06049450086867,40.7826645074338,41.89594136137823,75.16158174204645,36.48479151212327,18.10750070385887,0.26496541202831037,12.580954618230301,251.02496014404298,238.6675202331543,228.68000030517578,218.69248037719726,206.3350404663086,0.02,0.0,201.25051131333515,-0.021995156135466765,0.01431167503062737,253.855712890625,236.26357051304407,32.005293774697115
2024-07-17,0,251.46999740600586,182.48749923706055,262.8774948120117,185.386248588562,251.81000232696533,0.05328618077567376,31.1752159895653,-1.7670909036015907,2.9856274584130333,215.5587501525879,29.796249389648438,0.14204530659714187,182.7912498474121,256.56749992370607,0.9009931149817099,0.3899503478414157,1.1457862198444595,1.0088257667123381,0.9904917207692899,-0.043394728081091793,73.54220109253941,281.8241811398972,219.4737491607666,157.123317181636,254.02856826782227,6.333828944652681,238.98017747061593,22.81833674063932,249.18698413192044,232.9970395239698,2.0207586682883316,37.01616479582799,115584800,7.394764183893372,0.9428789046417686,-42636900.0,-29.239767241490423,40.7826645074338,41.89594136137823,63.0777271017953,33.934763972163864,16.84191513899874,0.20060382677195945,12.56017254251569,252.83980072021484,241.6051011657715,232.5250015258789,223.44490188598633,212.21020233154297,0.02,0.0,201.6105983956908,-0.056066281311641375,-0.052719808181196225,253.22142682756697,239.98714229038782,31.572457317232004
2024-07-18,0,251.16500091552734,182.48749923706055,262.8774948120117,190.1762466430664,252.03874683380127,-0.1394697937588302,30.724825249684987,-1.7487158008369272,2.986133017574042,232.88249969482422,29.218611831665044,0.13783658311412444,184.53050231933594,256.56749992370607,0.9062191419684422,0.3574812114612557,1.1267672067364216,0.9969664200660101,0.9982611581683141,-0.010167665377867396,70.73036300269264,284.35727455332506,222.9076240539551,161.45797355458512,253.1507121494838,6.228191014455823,242.89624895368303,19.383539744892307,249.73655318076334,234.7307869183122,0.12143119862930009,31.139591832804744,110869000,7.526497722747274,0.8892181190232435,-153505900.0,-28.743071948187033,40.7826645074338,41.89594136137823,58.222113395093,31.987465645526246,15.875465712845456,0.17007416117074897,12.373016841216929,253.12535870361327,242.06731790161132,233.12999725341797,224.1926766052246,213.13463580322264,0.02,0.0,201.9520991220169,0.034020648839444334,-0.0532933735381101,251.3499995640346,243.68785640171595,30.664225489106233
2024-07-19,0,243.31499862670898,182.48749923706055,262.8774948120117,195.19437408447266,252.03874683380127,-0.33961018414323196,30.03600846441096,-1.6376575006450649,2.9867464521722646,241.5637493133545,28.22189937591553,0.13278312920773797,184.53050231933594,256.56749992370607,0.8944255941092715,0.3741382938561148,1.075646484089659,0.9618828501436215,0.9690485134527161,0.0044377508768969065,71.04025302165556,286.2755161506237,226.20349922180176,166.13148229297985,250.35606983729772,5.4803126407456535,246.0635702950614,14.714758793516905,250.06894271741155,236.27307862508772,-2.388167182688334,27.92350041781174,87403900,7.451595502186204,0.6922698177847348,-240909800.0,-45.331440938801684,40.7826645074338,41.89594136137823,31.245012087754073,29.662045712350096,20.699753971150706,0.15324886588891237,12.389944403128093,254.4446014404297,244.20270233154295,235.9250030517578,227.64730377197264,217.4054046630859,0.02,0.0,202.1674361895786,-0.03637754878426658,-0.007592423517084108,247.91285487583704,246.63928440638952,28.823325833554243
2024-07-22,0,248.17000198364258,182.48749923706055,262.8774948120117,198.31437492370605,252.03874683380127,-0.5290121504392673,28.519480320254978,-1.4293178879262587,2.987788917663538,242.77749824523926,26.300949554443356,0.12441412266379828,185.36174926757812,256.56749992370607,0.8848624977950955,0.3333241983366237,1.0826232708854606,0.9833012872783751,0.9875388837605408,-0.03241904441554855,63.26440272423736,286.26920966394744,229.2302490234375,172.19128838292752,249.5596422467913,5.308122072220506,249.05857031685966,9.231025144495598,248.3572551670187,237.1906118921471,-7.441677804823961,22.285742408273617,101225400,7.840287913019144,0.7897943601298246,-139684400.0,-36.815271239806876,40.7826645074338,41.89594136137823,46.54296013758582,29.44177158655917,19.043326636136783,0.16585331007632428,12.505664308696355,258.50615942382814,250.7769190673828,244.52999877929688,238.28307849121094,230.5538381347656,0.02,0.0,202.461592437881,-0.004472786912375293,0.013213547257588687,249.40999712262834,249.6142839704241,26.9713483443375
2024-07-23,0,250.34250259399414,184.72500228881836,262.8774948120117,204.42312622070312,252.03874683380127,-0.7310966797057158,26.669584905840992,-1.1362376433781267,2.9889405932402338,245.74250030517578,23.925562171936036,0.1147008007659816,191.12499618530273,256.56749992370607,0.8625636743564195,0.3434564834684786,1.0766753818880062,0.9930876674125461,1.0028200904302007,-0.014680832251346976,65.51553281501637,285.8535439724486,232.5143741607666,179.17520434908462,250.71714292253768,4.217305248030966,250.87749917166573,6.066040093087292,248.26069798285445,239.23019370236776,-2.1970849635754246,20.33068268227891,111928200,7.845134732335572,0.856613569878708,-27756200.0,-64.9432675781958,40.7826645074338,41.89594136137823,41.90905921376732,29.19136343315378,17.926325223733965,0.14968986275161222,12.335971964708174,262.0532391357422,256.51837860107423,252.0449981689453,247.57161773681642,242.03675720214846,0.02,0.0,202.78102941927412,-0.039678799394501585,-0.02477831903878809,249.14571271623885,250.6942847115653,24.296721249059697
2024-07-24,0,220.52750396728516,185.43249893188477,262.8774948120117,220.21812438964844,252.03874683380127,-0.9534755456914227,24.539835434654552,-0.702893771078891,2.9901125668633135,248.60500144958496,21.115149993896488,0.10407264573992805,195.8817497253418,256.56749992370607,0.8284018154660455,0.35004653464737523,0.9352499880209946,0.8772387134163048,0.8860351505042887,-0.1230464618360142,66.54043695730074,284.8749200453345,235.79524917602538,186.71557830671628,245.5803576878139,11.548117894548149,249.42321368626185,9.884221475194412,248.7190259995055,241.08723934843061,3.344825297918505,11.323944869004624,167942900,7.826066346346471,1.235993793348777,-195699100.0,-97.72606336477885,40.7826645074338,41.89594136137823,-68.56042802331524,24.37722205509849,31.071088410078378,0.0776152048813166,13.71698362340373,257.71556158447265,249.49722256469727,242.8550033569336,236.21278414916992,227.99444512939453,0.04,0.0,202.9444208076794,-0.1308249275929011,-0.1581306222774039,243.90999930245536,248.52285657610213,21.98158212778944
2024-07-25,0,219.81999969482422,191.75749588012695,262.8774948120117,223.78999996185303,252.03874683380127,-0.9800685708141944,21.999073759913315,-0.5305704605346517,2.9912976877158464,248.60500144958496,18.658499641418462,0.0926081827527011,198.7092498779297,256.56749992370607,0.7612867517990903,0.15003329051159048,0.9253630824008471,0.8894076850113687,0.9057123007033114,-0.12479844367824633,44.10544506826674,281.548146947622,237.5499994277954,193.55185190796877,240.68714359828405,14.283025729518908,247.3360707419259,12.665182289170499,241.63352204354516,239.05282147981256,-14.019337020683144,-8.452076895301778,100636500,10.738069886817742,0.7393122269150378,-296335600.0,-90.1581205420083,40.7826645074338,41.89594136137823,-74.22316845574538,23.08684330349425,29.419613761825442,0.0443395347999814,13.452196944048865,257.71556158447265,249.49722256469727,242.8550033569336,236.21278414916992,227.99444512939453,0.04,0.0,203.0524066675633,-0.11627812151158678,-0.11368209255533199,238.72285679408483,246.2892848423549,20.18034948701278
2024-07-26,0,219.6500015258789,196.3400001525879,262.8774948120117,223.78999996185303,252.03874683380127,-0.9719493376799916,19.820707895068438,-0.39992230265029427,2.99218838306136,248.60500144958496,16.694124374389652,0.08294810091607141,205.51325149536132,256.56749992370607,0.720267301718736,0.11958846655795342,0.9192179507028114,0.9010884703428881,0.9290079736506042,-0.09726074115610372,42.98594558690169,278.59454040866717,238.95312461853027,199.3117088283934,236.14142990112305,15.306184823792327,245.08499908447266,14.587149545151746,236.1696118976921,237.34916293079857,-13.481387734992808,-11.733055377964902,94604100,10.723475221019605,0.6894605616680987,-390939700.0,-90.95754673123302,40.7826645074338,41.89594136137823,-94.5286901573984,22.204393877038015,28.790078102309675,0.042107224435841105,12.987751249180409,257.71556158447265,249.49722256469727,242.8550033569336,236.21278414916992,227.99444512939453,0.04,0.0,203.14319750221932,-0.08110365444813161,-0.11808367042606867,234.62285723005022,243.9221420288086,18.277189241201523
2024-07-29,0,228.99250030517578,198.9724998474121,262.8774948120117,223.78999996185303,252.03874683380127,-0.9072154708376459,17.870049811642353,-0.40239327573713535,2.992893433429158,248.60500144958496,15.062424278259277,0.07442175647524994,218.3090015411377,256.56749992370607,0.6618833650423304,0.10392140468820538,0.9536640508560584,0.948202237747115,0.9883060930630311,-0.0772756639609119,42.41702841853585,275.8587243104795,240.11862468719482,204.37852506391013,232.97392981392997,13.90949240558956,243.0623209817069,14.72424730404574,232.04839133312993,235.96027387801018,-12.653595342728943,-12.547529556594021,129201800,10.722523187689125,0.9301594603710435,-261737900.0,-69.10641061680055,40.7826645074338,41.89594136137823,-60.45469640606804,26.992480768497497,26.51746304678512,0.0786941795204852,13.093626847894535,257.71556158447265,249.49722256469727,242.8550033569336,236.21278414916992,227.99444512939453,0.04,0.0,203.35138195639155,-0.07717382540355766,-0.02968223635162871,232.17571585518974,241.76285770961218,15.49284057666819
2024-07-30,0,226.81999969482422,206.2400016784668,262.8774948120117,227.96374988555908,252.03874683380127,-0.7706839209596775,15.447492739066986,-0.6085183797835731,2.9936514390539566,248.60500144958496,13.034236640930178,0.06393310459612823,219.8029998779297,256.56749992370607,0.6173276181803589,0.11032049283136007,0.9387482493070805,0.9500214623405326,0.9954073902255084,-0.09396128366312118,47.90200551799315,272.514610188217,241.619624710083,210.72463923194903,230.61750139508928,13.247060940420479,240.4867856161935,14.13329265276754,231.32172597936932,236.34973911080587,-8.827862373153135,-11.005205443712933,100560300,10.795223751517739,0.7332338070087857,-362298200.0,-85.94778939995192,40.7826645074338,41.89594136137823,-101.65639617811746,25.15825977887689,27.28908229662761,0.03598335148056585,13.044796363060266,257.71556158447265,249.49722256469727,242.8550033569336,236.21278414916992,227.99444512939453,0.04,0.0,203.4795780751454,-0.09643643678360236,-0.11486620818507152,229.80714416503906,238.85999952043807,14.320209778562932
2024-07-31,0,230.3599967956543,219.6500015258789,262.8774948120117,228.4493751525879,252.03874683380127,-0.5378980762453998,13.63567929603415,-1.129477214108654,2.9941358093309582,248.60500144958496,11.737399444580081,0.05619516417164795,220.45675354003907,256.56749992370607,0.6685385725934865,0.008638041066704221,0.9493562848956923,0.9759889849175816,1.0322545761580797,0.044586242765563444,43.115033248431374,269.91998320296915,242.64862461090087,215.37726601883256,228.0732149396624,10.797916605314535,238.81642859322685,13.824337324997519,230.28640444066176,236.22923260051493,-6.779277490078283,-13.716463306595662,67497000,9.99634472048432,0.5181365446432855,-294801200.0,-65.88720609440061,40.7826645074338,41.89594136137823,-69.25403715275344,24.73759782483821,25.477236742736334,-0.03157609622064687,12.97445324716181,253.5899662475586,246.16002633666992,240.1550064086914,234.1499864807129,226.7200465698242,0.04,0.0,203.5891921779727,0.07444789769017146,-0.05808100200907179,227.0300031389509,238.22000013078963,14.287596811279535
2024-08-01,0,222.6875,219.6500015258789,262.8774948120117,230.01812267303467,252.03874683380127,-0.5584752353665579,13.327283224297618,-1.028759991600358,2.994210430701779,248.60500144958496,11.40844955444336,0.05486222780973478,220.45675354003907,256.56749992370607,0.7442542681683675,-0.043702989710725636,0.9167008871775656,0.9519967057395428,0.9891573052386833,0.013044765304143002,42.79008025052229,269.5773159679434,242.92274951934814,216.2681830707529,224.12250028337752,4.535007291508272,237.4198216029576,14.426402846065551,230.40125065828823,236.14490133440944,-7.1765342489549475,-9.215944657640742,83861900,9.316618382126899,0.664864770156319,-378663100.0,-95.06534314713167,40.7826645074338,41.89594136137823,-109.65638904309334,22.383367830225023,29.736907875750397,-0.10393394423470245,13.314851382590073,253.50028509521485,246.01486447143554,239.96500396728516,233.91514346313477,226.42972283935546,0.06,0.0,203.67447229904636,-0.015391597682853253,0.0040279415485037625,222.81285967145647,235.97928619384766,15.363626937719554
2024-08-02,0,211.1150016784668,219.6500015258789,262.8774948120117,228.4493751525879,252.03874683380127,-0.4327779718708867,14.037611347793755,-1.320062531545656,2.9940343588365943,248.60500144958496,12.523174438476559,0.058003602611374626,220.45675354003907,256.56749992370607,0.7373477397517402,-0.10581633801256662,0.8723300823243015,0.9136468242294726,0.9353705416543251,-0.03885727196959077,36.172947132503104,270.0879721767887,242.01274948120118,213.93752678561367,222.77785709926061,6.670985824200317,234.17910739353724,14.902259994987178,228.49339695166958,235.44910961570892,-11.046866715575288,-8.071539810186684,82880100,9.207762674101357,0.6762812231454848,-461543200.0,-96.42316517669182,40.7826645074338,41.89594136137823,-139.97407677587236,21.036760447684202,32.59029765643652,-0.18065703190429241,13.155218598355491,246.1497559814453,238.43511651611328,232.1999969482422,225.9648773803711,218.25023791503907,0.08,0.0,203.70423674715863,-0.05518655466058464,-0.05711692091284762,221.62428719656808,232.76714324951172,16.86182190619202
2024-08-05,1,192.49500274658203,211.1150016784668,262.8774948120117,225.78687477111816,252.03874683380127,-0.35909407854095715,15.450669767420676,-1.3247380751594202,2.993643616008686,245.74250030517578,14.09594924926758,0.06434655593576022,219.8029998779297,256.56749992370607,0.7130579824410261,-0.15945693985026047,0.8016733674358398,0.8448376971999255,0.8593718744116677,-0.15938293834930806,29.99536015494689,271.0178390541895,240.11649951934814,209.21515998450678,218.87428610665458,13.345720868880539,229.78071485246932,17.44878476885171,224.1610882659375,232.9927218276826,-4.268176131996074,-17.689143156098332,100308800,9.437916477962728,0.8379514427602188,-561852000.0,-77.92597801313688,40.7826645074338,41.89594136137823,-172.95082218108615,18.291214088238068,40.42714537909157,-0.1704608381448922,14.049134926454654,240.42308093261718,229.25846075439452,220.23500061035156,211.21154046630858,200.04692028808594,0.1,0.0,203.65337494457592,-0.14312796358086743,-0.09517742437892113,218.57143075125558,228.6471437726702,18.731873913010478
2024-08-06,1,199.23999786376953,192.49500274658203,262.8774948120117,222.1475009918213,252.03874683380127,-0.6126801535903468,18.368577729486194,-0.45416805943310523,2.9926776925508545,242.77749824523926,16.21794883728027,0.07744474846169958,218.7965015411377,256.56749992370607,0.6674698522094181,-0.25189457297886975,0.840026470492596,0.8963429040575677,0.9194468629732218,-0.1215942239139507,22.189063952677778,273.92015487913847,237.18299942016603,200.4458439611936,215.95857129778182,15.24272167039485,226.05000059945243,18.028687356961132,216.26053938177284,228.2034012491621,-12.430623685823601,-24.236190843852675,73783900,9.906593703461002,0.6394537630597172,-488068100.0,-75.19297876522832,40.7826645074338,41.89594136137823,-138.0484310791971,17.321021994916478,38.28283190634192,-0.19867615203160652,13.776338277124555,239.40697119140626,228.4365290527344,219.57000732421875,210.7034855957031,199.73304345703124,0.1,0.0,203.63252334400366,-0.09873325042509662,-0.1355450490588791,215.83428737095423,225.22857230050224,19.2833186938456
2024-08-07,1,196.875,192.49500274658203,262.8774948120117,220.35062789916992,251.24125003814697,-0.48404122978907893,19.51161474815559,-0.763383146075173,2.9922079963828643,236.2999973297119,17.108749198913575,0.08328349163836495,209.92750129699706,254.31374855041506,0.7277481098529577,-0.2420804298738105,0.8403424128622176,0.9065447331773837,0.9322637858821647,-0.14535942551413505,27.155627467408287,273.30272912247085,234.27949962615966,195.2562701298485,211.370356968471,15.49720833200088,222.17214339120048,18.049770783353782,212.00155617410428,224.39373080789622,-9.292057145606117,-20.76987317811493,71159800,9.966073771558662,0.632431237907196,-559227900.0,-86.76790234043283,40.7826645074338,41.89594136137823,-135.6978671758886,16.23246243519501,36.499609459056586,-0.24016798447571508,13.650171528738088,238.35263580322263,227.58367660522458,218.87999725341797,210.17631790161133,199.40735870361328,0.1,0.0,203.59970800289608,-0.173697640992732,-0.1386218726404465,210.07142857142858,221.12357221330916,20.024973317949012
2024-08-08,1,196.81999588012695,192.49500274658203,256.48500061035156,219.7775001525879,250.54812717437744,-0.4263769054458511,19.971851440429518,-1.0039525017060076,2.9919382767126432,229.67624855041504,17.219061946868898,0.08646595156093378,199.00349807739258,253.77774543762206,0.7678566250019606,-0.22412262788049525,0.8521106959339694,0.9162707465691735,0.9625273333391214,-0.11616055737243014,27.110274046476444,270.92307776641815,230.97937488555908,191.03567200470002,207.08464213779993,14.636887662529327,218.85107176644462,18.137557190515523,208.21194148607321,220.55087360259668,-14.025568637563739,-21.615273114340617,65033900,9.873525056378655,0.6212390745783687,-624261800.0,-77.16920066157277,40.7826645074338,41.89594136137823,-114.81904023397875,15.453896082739362,34.74895900068994,-0.1438504495204933,13.313729824457088,238.35263580322263,227.58367660522458,218.87999725341797,210.17631790161133,199.40735870361328,0.1,0.0,203.5759467661347,-0.08309510385383967,-0.1431895976971438,206.67428588867188,218.24071502685547,20.957585213272548
2024-08-09,1,198.26000213623047,192.49500274658203,256.48500061035156,217.51625156402588,248.71312713623047,-0.2691052637779294,20.571903086212995,-1.1858725188530777,2.991623204384395,227.90625,17.528124618530278,0.09017499362748309,196.8694995880127,251.7302474975586,0.8186675864557058,-0.18750000984224657,0.8690539885539815,0.9329640995816871,0.9947368282441534,-0.06089098093471723,28.17770413732964,269.27693109613205,228.13312492370605,186.98931875128005,202.4989286150251,10.601585099964147,215.28607177734375,16.786180399898587,205.35801789183787,217.2511054631552,-13.226348582603332,-19.1089752004619,58648300,9.683204811175905,0.5875476363170065,-565613500.0,-75.59652746675327,40.7826645074338,41.89594136137823,-98.51224762149504,15.055970060663958,33.62788580507015,-0.1784837949310722,12.774890715773617,238.35263580322263,227.58367660522458,218.87999725341797,210.17631790161133,199.40735870361328,0.1,0.0,203.55956976978536,-0.036933588079995805,-0.07774601384717865,202.09285627092635,214.5614297049386,21.218283580207032
2024-08-12,1,197.61000061035156,192.49500274658203,256.48500061035156,208.14625072479248,248.71312713623047,-0.0847106022842727,21.28467938622705,-1.3317416517722633,2.991271783563854,224.7537498474121,18.185124588012695,0.09420745703328183,196.8694995880127,251.7302474975586,0.8130139124401101,-0.2270113197090059,0.8746354739030179,0.9393605963054391,1.0044322951652813,0.026572107279602353,25.84791780020486,268.5034839097832,225.9341251373291,183.36476636487498,198.91642870221818,5.785682081404467,211.51946449279785,13.999872542351815,203.60636334710136,215.03843270153683,-13.934708762780026,-20.11121386488194,64044900,8.91724205502978,0.6693977762308807,-629658400.0,-70.59603711698054,40.7826645074338,41.89594136137823,-95.76840739885866,14.58778512602394,32.838889277226166,-0.11185453654586533,12.243111500220019,222.24751440429688,214.55623547363282,208.33999633789062,202.12375720214845,194.43247827148437,0.1,0.0,203.53628463428248,-0.00698913593886652,-0.04902004509818272,199.32571411132812,211.0692868913923,21.030206649838483
2024-08-13,1,202.9625015258789,192.49500274658203,254.0724983215332,198.99499893188477,244.52874946594238,0.05602433191031487,20.9240749954343,-1.3607058716465221,2.9913269973585987,221.60750198364258,17.77941204071045,0.0938339826665082,196.8694995880127,251.19550056457518,0.8119008253560973,-0.22222986779044207,0.9101850310843417,0.9794152186294033,1.0263019616923694,0.018683515870415945,25.821510355586838,264.8385251281977,222.9903751373291,181.14222514646048,197.75178582327706,3.1335675693935867,210.26482146126884,13.917318037827892,202.16454250570598,212.82761217644503,-11.261296386033539,-21.064142699397806,76247400,8.93269578306915,0.8183585164698791,-553411000.0,-50.96809904658623,40.7826645074338,41.89594136137823,-62.69911552027354,19.021002073602535,30.638592040937873,-0.1246766657604531,12.185032528259715,222.24751440429688,214.55623547363282,208.33999633789062,202.12375720214845,194.43247827148437,0.1,0.0,203.54025637461564,0.03583533923085325,0.04500199481348494,199.34857177734375,210.48642948695593,19.630441736550964
2024-08-14,1,203.9900016784668,192.49500274658203,251.46999740600586,198.99499893188477,233.59874725341797,0.21216809111745522,20.075786459597012,-1.292796136317858,2.991602201291223,220.1737518310547,16.95012493133545,0.0910735491945111,196.8694995880127,250.42475242614745,0.8155134869011541,-0.19289575846223175,0.9253980405918888,0.995838274549682,1.027628965681586,0.036139691065228075,32.815492362069186,260.58644821674045,220.4348752975464,180.28330237835237,199.39392852783203,2.92462574179403,209.1341073172433,13.72298848180639,202.40078178823717,212.00360038536905,-3.8616394324285603,-7.96499399186597,70250000,9.124557867159172,0.7727898334519653,-483161000.0,-63.21183071894744,40.7826645074338,41.89594136137823,-62.01047064465536,17.924517785917082,28.87240040499268,-0.10587779375982023,12.006815677928834,222.24751440429688,214.55623547363282,208.33999633789062,202.12375720214845,194.43247827148437,0.1,0.0,203.5375590072736,0.050166930807007626,0.0036882251565748428,199.7057146344866,209.1385726928711,18.82601171377393
2024-08-15,1,209.96500396728516,192.49500274658203,251.16500091552734,198.99499893188477,229.3343744277954,0.3758272373077716,19.046366587584266,-1.123469665052551,2.991950749109095,219.73500061035156,16.31803754806519,0.08734426358206876,196.8694995880127,248.38725204467775,0.7932147931049469,-0.187824733004606,0.9628733420201755,1.038374344612229,1.0502004645795386,0.066786954386302,34.09537126731929,256.153608686338,218.06087551116943,179.96814233600088,200.92607225690568,4.94321597122225,208.44232177734375,13.392224449870197,202.8150392749405,211.07978185167752,5.971583037414135,-7.201345663876892,89848500,9.146660737843346,0.9999456892996124,-393312500.0,-38.99012175750688,40.7826645074338,41.89594136137823,-19.314570543244873,20.762314439759663,26.418246436180098,-0.03635520476461312,12.184900657950054,222.24751440429688,214.55623547363282,208.33999633789062,202.12375720214845,194.43247827148437,0.02,1.0,203.578110678541,0.07694630523809876,0.11670841428823008,201.63428606305803,208.73428671700614,17.288027132181977
2024-08-16,0,214.46749877929688,192.49500274658203,250.34250259399414,198.99499893188477,227.3631248474121,0.4949273541499604,17.52151482265987,-0.8651022611051573,2.9924789251073545,215.38250160217285,15.067624855041505,0.08111779532752976,196.8694995880127,243.80049896240234,0.7994103870470687,-0.13706510016913917,0.9929010617214006,1.067356935281286,1.0587981026573683,0.08174869599733858,42.30879715199437,251.04390530907702,216.0008756637573,180.9578460184376,203.4392863682338,6.700219330662257,207.4048216683524,12.186041870223763,204.56973906414234,210.93629037604435,5.3829583509877645,-4.409286360716312,88765100,9.240179181112403,0.987140552909295,-304547400.0,-35.231587203933685,40.7826645074338,41.89594136137823,4.869125968281434,21.987731779647813,24.997939161576493,0.002997942514670269,11.957407296428025,222.24751440429688,214.55623547363282,208.33999633789062,202.12375720214845,194.43247827148437,0.04,0.0,203.63732339395057,0.08059997558593746,0.08690403891344267,205.1142861502511,207.59285736083984,16.388680784664103
