date,buy?,todays_price,Minimum,Maximum,25th Percentile,75th Percentile,Skewness,Standard Deviation,Kurtosis,Shannon Entropy,Median,Mean Absolute Deviation (MAD),Coefficient of Variation (CV),10th Percentile,90th Percentile,Autocorrelation,Cumulative Return,curr_to_avg_one_month,curr_to_avg_one_two_week,curr_to_avg_one_one_week,momentum,rsi,upper_band_current,middle_band_current,lower_band_current,rolling_mean_7,rolling_std_7,rolling_mean_14,rolling_std_14,ema_7,ema_14,roc_7,roc_14,Volume,Volatility,Relative Volume (RVOL),On-Balance Volume (OBV),Williams %R,Stochastic Oscillator %K,Stochastic Oscillator %D,Commodity Channel Index (CCI),ADX1,ADX2,Chaikin Money Flow (CMF),Average True Range (ATR),Fib_23.6,Fib_38.2,Fib_50,Fib_61.8,Fib_76.4,Parabolic SAR 2,Parabolic SAR 3,VWAP,Adj Close Momentum,Adj Close Return,Adj Close 7d MA,Adj Close 14d MA,Adj Close Volatility
2024-01-02,0,101.80749893188477,98.22250175476074,102.98250007629395,99.52312517166138,102.2781252861023,-0.3792415746862381,1.4479518209660325,-1.1477148285054393,2.9956291771015575,101.08249950408936,1.2594998359680176,0.014345957340797695,99.19100017547608,102.49400024414062,0.7301173072381865,-0.027601765126997573,1.0086841395563177,1.0011751516889673,1.0027924272195188,-0.004278956464938033,40.2963884025132,103.82690368389373,100.93100004196167,98.0350964000296,101.56178610665458,0.8260794394200627,101.15321445465088,1.416410405145348,101.24246438482152,101.07663229925538,-2.2952889247252677,0.8687780646002665,23483000,0.9562391974166815,1.0220013391381513,-117529300.0,-24.458236145147314,56.70552541611323,56.9646702468221,68.07903083246696,32.82672361078149,20.55421321943079,-0.03858817306450701,1.7773279821560815,102.41544265747069,101.47228279113769,100.71000289916992,99.94772300720214,99.00456314086914,0.04,0.0,100.78739133422116,0.004415624484328751,0.00619281233156342,98.88461194719586,98.56356866019112,1.4104847025730953
2024-01-03,0,102.69250106811523,98.22250175476074,102.50749969482422,99.52312517166138,102.13812446594238,-0.4546176394753369,1.386034921015339,-1.1137260227303896,2.9956376706997254,101.08249950408936,1.2007497787475585,0.01374049772087965,99.19100017547608,102.46324920654297,0.6960881731726292,-0.005567626699911509,1.0180451123440726,1.0087795867107363,1.0123821395473056,0.001804759396549338,52.56841958784094,103.6443198267719,100.87224998474122,98.10018014271053,101.73142896379743,0.9281059864052221,101.47250011989048,1.1907967374881128,101.3817587980108,101.08264638981598,-0.636834041009448,2.355096590192276,23490800,1.0309971890510394,1.0179837674170484,-94038500.0,-11.464989819372635,56.70552541611323,56.9646702468221,105.1163055064752,32.20402927463357,18.5212980205752,-0.005928507359344954,1.7938636529266954,102.45792272949218,101.54104290771484,100.80000305175781,100.05896319580077,99.14208337402343,0.02,1.0,100.88334357310183,0.01057363494175223,0.012854416158152679,99.0921380179269,98.9236068725586,1.4670787356153492
2024-01-04,0,103.25500106811523,98.22250175476074,102.69250106811523,99.52312517166138,102.13812446594238,-0.4230895801357063,1.4047141212886314,-1.1188022322166242,2.9956351453417027,101.08249950408936,1.2164999008178712,0.013923500513454931,99.19100017547608,102.49400024414062,0.7039650511043085,0.013396180943476076,1.0234616699587438,1.01371766746551,1.0175563138931996,0.01332221166447356,58.99768566379645,103.69742834938879,100.88800010681152,98.07857186423425,101.87571471078056,1.0862835403603157,101.81839302607945,0.9018222537524673,101.70501109328939,101.19879639402967,1.1698930964033236,4.550891326831671,19395200,1.0211624504498698,0.8457311945573758,-74643300.0,-45.454573478050584,56.70552541611323,56.9646702468221,100.63050507982163,32.865820441433776,16.29040355715801,0.0022214312549313385,1.8583628528612752,103.40180041503906,102.67910086059571,102.09500122070312,101.51090158081055,100.7882020263672,0.04,0.0,100.96150380173866,0.006492123931366889,0.0017621958764110837,99.1492418561663,99.16038295200893,1.5018310918103286
2024-01-05,0,102.83249855041504,98.22250175476074,103.25500106811523,99.52312517166138,102.29875040054321,-0.34689827186699307,1.4947073348130202,-1.1541617338083974,2.99562253751153,101.16750049591064,1.3125,0.014801427273271212,99.19100017547608,102.52599983215332,0.7286619868991178,0.037295642996222685,1.0183048635491831,1.008814508899774,1.010688467126233,0.019860147061630418,65.02178374125728,103.9734148756197,100.98400020599365,97.99458553636761,101.9221431187221,1.1240748381536692,101.9619643347604,0.8910112391257873,102.08211478722463,101.39859348581669,0.9878235811938878,4.920615437952343,15825000,0.9258742788450347,0.7139130487741335,-90468300.0,-39.19199267577713,56.70552541611323,56.9646702468221,80.8169624971934,30.849124814564515,15.2908001645636,0.019511848978212853,1.8069951925565477,103.40180041503906,102.67910086059571,102.09500122070312,101.51090158081055,100.7882020263672,0.04,0.0,101.0134120273146,0.024353690754904678,0.009541590159313653,99.21748897007534,99.23350524902344,1.4904724379200627
2024-01-08,0,100.39750099182129,98.22250175476074,103.25500106811523,99.97125148773193,102.46812438964844,-0.5305977616454982,1.5079923346440096,-0.9872292350398912,2.9956208375169506,101.65625,1.3163998889923092,0.014908696938780613,99.19100017547608,102.70650081634521,0.742995972498253,0.03554795460924077,0.9925752812605223,0.9845667347786472,0.9828871640145603,0.002571396959148542,62.02999856864993,104.16448482569062,101.14850015640259,98.13251548711456,101.70785740443638,1.263840922208638,101.94035734449115,0.9269124089236226,102.26527745901139,101.59040635880474,0.31704885648208825,1.9936009491633442,23370100,0.9312723174487552,1.0702783330016874,-113838400.0,-64.3739454074257,56.70552541611323,56.9646702468221,-48.064445689257596,25.83502862473336,26.88033197932154,0.11951206806793216,1.972261939234037,103.23188012695313,102.40406039428711,101.73500061035156,101.06594082641601,100.23812109375,0.02,1.0,100.98305472895733,0.009401837241190814,0.007286104531848442,99.11442129952569,99.23489815848214,1.3636531290045744
2024-01-09,0,100.36000061035156,98.22250175476074,103.25500106811523,100.33312606811523,102.46812438964844,-0.6039731793610973,1.459060336572394,-0.7457371433077746,2.995628036889179,101.65625,1.2561747169494624,0.014417129213366579,99.19100017547608,102.70650081634521,0.6779931134574237,0.011281517337885981,0.9916677606712506,0.9852690717167428,0.9820249174679831,-0.014217993141169893,46.60992927471913,104.12137098594997,101.20325031280518,98.2851296396604,101.64071464538574,1.3290529454045452,101.81589317321777,1.016158862830702,101.79212676786436,101.47674942457597,-1.4720675045017995,-0.30039510149680276,19496600,1.1001554585399524,0.8981750277158351,-133335000.0,-86.41980790604649,56.70552541611323,56.9646702468221,-64.50073042945516,24.58538693363486,24.46897797974193,0.06846840317085194,1.98308283843706,103.23188012695313,102.40406039428711,101.73500061035156,101.06594082641601,100.23812109375,0.02,0.0,100.95163448502748,-0.026279878457970418,-0.003100785751022007,99.04199327741351,99.09700993129185,1.3567133658418316
2024-01-10,0,99.11250305175781,98.22250175476074,103.25500106811523,100.38812589645386,102.46812438964844,-0.6731756545511042,1.4057223647334,-0.4584786562560299,2.995635601185835,101.65625,1.1966371917724614,0.013882666423784749,99.35975189208985,102.70650081634521,0.657820158989127,0.00899812528909136,0.9788176191924316,0.9748259377884492,0.9725731924200783,-0.03486133825860205,46.14693828427246,104.06882006516015,101.25737533569335,98.44593060622655,101.49392918178013,1.5592296116978384,101.57446479797363,1.2234257872934786,101.42935650356507,101.39826819306602,-0.46613043113172814,-1.7066167966051147,18206100,1.0999188969410751,0.8466144096180375,-151541100.0,-91.7316831930645,56.70552541611323,56.9646702468221,-124.83632419534612,22.860644662277323,27.15835844277546,0.02180516126733944,1.9544003535789936,103.05724063110351,102.12138121032714,101.3650016784668,100.60862214660645,99.67276272583008,0.04,0.0,100.88857832885175,-0.043886813191062024,-0.03585384376745431,98.86232103620257,98.7975583757673,1.4238871458057905
2024-01-11,0,98.9424991607666,98.22250175476074,103.25500106811523,100.38812589645386,102.46812438964844,-0.6726316295602145,1.4300833841325913,-0.531722796261807,2.9956321814407136,101.65625,1.21602463722229,0.01412571029353762,99.04250278472901,102.70650081634521,0.5517396130323203,0.009061073390486441,0.9773088019698265,0.9764142651919511,0.9777747965517427,-0.04176554997567394,41.49520818906494,104.09991715354961,101.23975038528442,98.37958361701924,101.08464350019183,1.8177847173528,101.3232148034232,1.378888037162884,100.84757862635001,101.11798130774386,-1.0260617454875844,-3.297799588607833,15833400,1.1002277909170168,0.7542564297509559,-167374500.0,-92.04376251977254,56.70552541611323,56.9646702468221,-130.54557900525236,21.911799843543452,26.031134426373736,-0.0034425536826629966,1.8706145590256948,103.05724063110351,102.12138121032714,101.3650016784668,100.60862214660645,99.67276272583008,0.04,0.0,100.837473681305,-0.035672380624904854,-0.044080589352454805,98.34837777273995,98.61649485996791,1.3616525212928239
2024-01-12,0,99.97749900817871,98.41250038146973,103.25500106811523,100.38812589645386,102.46812438964844,-0.5552940191302985,1.361073542986589,-0.7389397545281642,2.9956417355251213,101.65625,1.1764247798919683,0.013439283733289693,99.09550266265869,102.70650081634521,0.5050491890619013,0.005385482304000778,0.9871810256243013,0.989513728116095,0.9964965118441674,-0.027763592079177446,40.38652093290611,103.99789734155789,101.27575025558471,98.55360316961153,100.69678606305804,1.7036028928193563,101.21410751342773,1.4231212174091035,100.37793320948553,100.87624494541971,-2.814134323283021,-3.4330469989620718,18032100,1.1006990588230718,0.8628666038214367,-149342400.0,-72.07497045244338,56.70552541611323,56.9646702468221,-82.94782887082522,25.024140558618587,23.791155742023538,-0.041123673641705084,1.8795499091845507,103.05724063110351,102.12138121032714,101.3650016784668,100.60862214660645,99.67276272583008,0.04,0.0,100.81135197217863,-0.02611329460235179,-0.023162616154560136,97.89293234688895,98.49253518240792,1.2933038970729174
2024-01-16,0,98.76250076293945,98.9424991607666,103.25500106811523,100.38812589645386,102.46812438964844,-0.3697035636182902,1.2331913722746568,-0.9668015955877718,2.995658138813263,101.65625,1.0903498554229742,0.012167170215288665,99.89099941253662,102.70650081634521,0.663418713788011,-0.008381077822756315,0.9744312072616632,0.9783139014153421,0.9900208525030397,-0.016285268186257196,43.46325620065437,103.82038293146947,101.35400018692016,98.88761744237085,100.05500030517578,1.398055184625321,100.96535750797817,1.5294525086200115,100.28470577664979,100.80227326998698,-2.6438172521824947,-1.5048539912939745,20235700,0.9803210841913059,0.98224877920918,-169578100.0,-97.7272210042408,56.70552541611323,56.9646702468221,-145.6936901756149,22.421648805143036,28.194251114264823,-0.11860493042365595,1.9280996299831057,102.90855947875977,101.88071934509277,101.04999923706055,100.21927912902832,99.19143899536132,0.06,0.0,100.7367401278264,-0.032005509065556326,-0.04813404902843916,97.2480675833566,98.19865471976144,1.500761306601771
2024-01-17,1,97.03000068664551,98.76250076293945,103.25500106811523,100.30500078201294,102.46812438964844,-0.39887254153465707,1.353447752633372,-1.084016095231892,2.9956427679058155,101.65625,1.203649826049805,0.013367253160737362,99.09550266265869,102.70650081634521,0.641687311962521,-0.019240299053328122,0.9583115276088936,0.9624655343329128,0.9758526031154703,-0.033180549057933995,37.864661779046685,103.95789571888979,101.25100021362304,98.5441047083563,99.226072038923,1.1799450192839211,100.57410757882255,1.7840249303508189,99.90543996038245,100.53384500553527,-4.350879142611378,-3.406034571577452,18384000,1.0146500571533226,0.9807590586441529,-187962100.0,-94.99372174187032,56.70552541611323,56.9646702468221,-174.4793380073683,21.106265786833273,30.5787938476219,-0.2561308104971178,1.8841966128821466,102.6843601989746,101.51782051086425,100.57500076293945,99.63218101501464,98.46564132690429,0.08,0.0,100.63891511574444,-0.02698891450316243,-0.039040795449267585,96.46113586425781,97.83931241716657,1.7413843064178811
2024-01-18,1,96.67749977111816,97.03000068664551,103.25500106811523,100.09937572479248,102.46812438964844,-0.7462406295014464,1.6351789896576254,-0.29196532234675887,2.995600849803118,101.65625,1.4054997253417967,0.016179078187549534,98.92449932098388,102.70650081634521,0.6431541106924545,-0.04968045220055663,0.9565636775343023,0.9635351061385177,0.9788639624193632,-0.024568073710821925,29.11336225097274,104.33785828449103,101.06750030517578,97.79714232586053,98.69464329310826,1.384418091990609,100.20125034877232,2.0165002329427586,99.19126371724303,100.14590249943404,-5.642669336605468,-5.3435104987301525,20940300,1.0114783441943123,1.1191342492929353,-208902400.0,-88.79996163504481,56.70552541611323,56.9646702468221,-170.06359314860478,19.946524914619804,32.18678636482184,-0.17788318650634094,1.835422122541889,102.50499969482422,101.22749969482422,100.19499969482422,99.16249969482422,97.88499969482422,0.1,0.0,100.5155382152083,-0.019150798523485002,-0.02879485950262932,95.88730294363839,97.50086212158203,1.9372492435788795
2024-01-19,1,96.77499961853027,96.67749977111816,103.25500106811523,99.76125001907349,102.46812438964844,-0.710364499789402,1.873573565436619,-0.4639201551427794,2.995558735666311,101.16750049591064,1.5766247749328612,0.018587730784181238,98.58925075531006,102.70650081634521,0.7108033132823105,-0.05673586376313589,0.9601051555876764,0.9703237764489017,0.9847066458285041,-0.021906658520060907,27.31739069650158,104.54339747419598,100.79625034332275,97.04910321244952,98.18250029427665,1.3276084014165792,99.9116074698312,2.201938263980577,98.56647965682504,99.71999750492888,-3.7052727248720747,-5.122796113637864,20079300,0.9996147414697625,1.069761197321881,-188823100.0,-87.08574567522305,56.70552541611323,56.9646702468221,-140.92192894976992,19.395270168196564,31.297252030812903,-0.17208505631709903,1.7388797401410543,102.50499969482422,101.22749969482422,100.19499969482422,99.16249969482422,97.88499969482422,0.1,0.0,100.41037249901325,-0.017431788781899438,-0.01763092660250822,95.50846317836216,97.27522822788784,2.008847520054154
2024-01-22,1,96.59749794006348,96.67749977111816,103.25500106811523,99.07000207901001,102.29875040054321,-0.559503546314124,2.0231690593660945,-0.8156239691757063,2.9955288952420314,100.61375045776367,1.692874813079834,0.020128957365311177,97.00450057983399,102.70650081634521,0.7646862423326658,-0.05548506262678582,0.9610699158480109,0.9748780510448605,0.987255266981712,-0.03380761773045282,28.138763891523627,104.55671342772268,100.51037530899048,96.46403719025827,97.82321384974888,1.3734982401675555,99.6585715157645,2.370746313152937,98.12161960503626,99.377767718713,-3.5721412614773507,-4.02162085514632,19955900,1.0019060189097695,1.0661205326996555,-208779000.0,-88.06815127696946,56.70552541611323,56.9646702468221,-131.80068633671308,18.213352881496473,32.32245030743613,-0.09121956772224928,1.7069024714187364,102.49319897460937,101.20839852905273,100.16999816894531,99.1315978088379,97.84679736328125,0.12000000000000001,0.0,100.30529820987005,-0.03131561896070689,-0.01874933628930942,95.24800981794085,97.05516542707171,2.1304273029690863
2024-01-23,1,97.48750114440918,96.59749794006348,103.25500106811523,98.89749956130981,101.98437595367432,-0.40203696674022876,2.1407404246013986,-1.066748394220361,2.995503440445582,100.37875080108643,1.79402509689331,0.021360997425326874,96.76524963378907,102.70650081634521,0.8109554529821653,-0.04834740235861446,0.9727616842359669,0.9900902213341487,1.0032829712237126,-0.012909754296224873,28.331286943224647,104.49873110097282,100.21725025177003,95.93576940256723,97.61535699026925,1.2829949720151903,99.35000024523053,2.3505862667871047,97.73746893499228,99.04930423189336,-2.5375255737219837,-3.5375507400156425,15863400,0.9900940330929567,0.8552221389287161,-192915600.0,-75.68174685330933,56.70552541611323,56.9646702468221,-80.10612278331439,23.103564772797288,29.726260625855552,-0.10547483564114504,1.7118036767605895,102.49319897460937,101.20839852905273,100.16999816894531,99.1315978088379,97.84679736328125,0.12000000000000001,0.0,100.25021808063347,0.002252038642080123,-0.020410090221226473,95.14215850830078,96.74526814052037,2.1437067164319203
2024-01-24,1,98.82749938964844,96.59749794006348,103.25500106811523,98.44375085830688,101.98437595367432,-0.2022212002990748,2.198199309124882,-1.2721702100717003,2.9954903570417244,100.25000095367432,1.878487615585327,0.021978394073045943,96.76524963378907,102.70650081634521,0.8370294164999689,-0.0465303893175643,0.9881131878365098,1.0066744850301501,1.019749565961502,0.01852518489418431,34.43553337530499,104.41277387383448,100.01637525558472,95.61997663733496,97.45107133047921,0.9641146566330828,99.07392869676862,2.14587267103481,97.67229156402527,98.87086274395845,-1.4705490852755498,-4.243300182009107,17330600,0.9985844754014742,0.9233479875786557,-175585000.0,-56.47726701311042,56.70552541611323,56.9646702468221,-29.333346156355873,26.271413998628045,27.18842957476008,-0.03159570625985022,1.7271043457803996,102.49319897460937,101.20839852905273,100.16999816894531,99.1315978088379,97.84679736328125,0.12000000000000001,0.0,100.22177617335868,0.02701574565589837,0.01955149874236996,95.09340994698661,96.49317114693778,2.0924319287897966
2024-01-25,0,101.05999946594238,96.59749794006348,103.25500106811523,98.44375085830688,101.8299994468689,-0.041162686731613815,2.1506312105677106,-1.2181444407802413,2.995500196005642,100.05875015258789,1.839700012207031,0.021539590733920845,96.76524963378907,102.70650081634521,0.8379169391281212,-0.03589981529284721,1.0121637858552428,1.0310245912616913,1.0389316656196672,0.04533112363476177,43.72413174811094,104.14676260424089,99.84550018310547,95.54423776197005,97.7792854309082,1.639489050862099,98.91714286804199,1.880690739397026,97.95547237883298,98.89818914711456,-1.150258438087351,-3.7636649592390077,22089500,1.0550987127315299,1.160648958794453,-153495500.0,-16.644868410527344,56.70552541611323,56.9646702468221,59.39183718820726,34.20225776910071,24.184867354269425,0.0668904203684027,1.7925687391913196,101.59932037353515,100.48533966064453,99.58499908447266,98.68465850830079,97.57067779541016,0.02,1.0,100.25236237446381,0.05506186829869231,0.05310363397476444,95.71181161063058,96.47993959699359,2.0918628563932637
2024-01-26,0,102.31000137329102,96.59749794006348,103.25500106811523,98.44375085830688,101.24687433242798,-0.03545361146932571,2.0831262124430743,-1.1154322585977232,2.9955142313168075,100.05875015258789,1.7745625019073485,0.02087863048149509,96.76524963378907,102.70650081634521,0.811926445062346,-0.008219058541446738,1.025426448227064,1.0417075174422616,1.0423894353233611,0.05719454173679894,56.376730696862104,103.93937759654754,99.77312517166138,95.60687274677521,98.53357124328613,2.313398503020859,98.87982164110456,1.8004902756605499,98.72702452098414,99.24298639680116,2.3262864804503454,-2.125806575436335,20817200,1.1796349237112789,1.0761054115170656,-132678300.0,-1.0944155167787235,56.70552541611323,56.9646702468221,98.94600539874857,35.2778314914131,22.246071133075016,0.13278456895828344,1.800007433149364,101.35484060668944,100.28757984924316,99.42499923706055,98.56241862487792,97.49515786743164,0.04,0.0,100.30838252362986,0.062403207300531394,0.06404945098518869,96.55027553013393,96.50570569719586,2.1717218867577706
2024-01-29,0,102.79249954223633,96.59749794006348,103.25500106811523,98.44375085830688,101.24687433242798,-0.027616540534777575,2.1059743202165078,-1.1418770867962682,2.9955095255976567,100.05875015258789,1.7931250190734858,0.021103268653511652,96.76524963378907,102.70650081634521,0.8066322449836378,0.014678185566843376,1.0300494704905867,1.0430439178875,1.0356248677361963,0.06413211246958705,62.85599383261262,104.00569883116789,99.79375019073487,95.58180155030185,99.40714263916016,2.628765738981353,99.05089296613421,2.051995842638535,99.62673322315673,99.7140822245761,5.441616664207865,-0.508105107324473,18317500,1.1872970312099214,0.9420471905599337,-114360800.0,-0.9421223680904138,56.70552541611323,56.9646702468221,101.17487284668229,33.75956261030031,20.96295048353832,0.21287188324861603,1.7650581804972587,101.44651687622071,100.36173683166504,99.4849967956543,98.60825675964357,97.5234767150879,0.06,0.0,100.3621461341694,0.06517244283386336,0.0637441294801495,97.43191637311664,96.6596096583775,2.2879789770082
2024-01-30,0,103.55999946594238,96.59749794006348,103.25500106811523,98.44375085830688,101.93312454223633,-0.036415615489316114,2.195776294100092,-1.2617291960014785,2.995490581377741,100.05875015258789,1.8814375019073482,0.02198153043304785,96.76524963378907,102.7964994430542,0.8178395001814703,0.026487899050175057,1.036720947404155,1.0478387515978618,1.0304938955202305,0.06229001923577826,65.64268942937977,104.28342775986157,99.89187517166138,95.5003225834612,100.3764283316476,2.7448101188038603,99.27946431296212,2.3635986375223808,100.42458502210187,100.19538532788572,6.325152993814787,2.385516100256463,19610900,1.1762003702831678,1.0037399240345524,-94749900.0,-0.32929503059279336,56.70552541611323,56.9646702468221,124.65334948633264,36.80433601781853,18.569911937968186,0.2726587496931696,1.8418191201766723,102.73003710937499,101.39997702026366,100.32499694824219,99.2500168762207,97.91995678710937,0.08,0.0,100.44529172997409,0.07088132159476146,0.0829373919287278,98.53222765241351,97.02034541538784,2.5231793766497783
2024-01-31,0,103.79999732971191,96.59749794006348,103.55999946594238,98.44375085830688,102.40562629699707,-0.05683397871749981,2.3370646179029757,-1.3575650549704699,2.9954593615812657,100.16874980926514,2.0438750267028807,0.023355961099778128,96.76524963378907,102.87474880218505,0.8181122352589452,0.017213864916081904,1.0373477400745421,1.0451935193687552,1.0205485938986851,0.05031492217017797,66.89486803434227,104.73700431591459,100.06287508010864,95.38874584430269,101.4053568158831,2.423274249512404,99.61428533281598,2.6524828982113458,101.21996725962994,100.72402427401876,7.011108110728354,3.1885201635408906,22415300,1.1309675407607385,1.1504202454829995,-72334600.0,-22.72227833302319,56.70552541611323,56.9646702468221,103.93563024447849,33.663275420132166,16.98506555838351,0.1974429996726636,1.8620170660338173,102.73003710937499,101.39997702026366,100.32499694824219,99.2500168762207,97.91995678710937,0.08,0.0,100.52391556825822,0.0322289412444825,0.05004582032772908,99.36651393345424,97.30726187569755,2.54414239459889
2024-02-01,0,102.89750099182129,96.59749794006348,103.79999732971191,98.44375085830688,102.71750068664551,-0.011912248118217868,2.4490946122608874,-1.3878770836107537,2.995433265533808,100.16874980926514,2.1434999465942384,0.024451212901643704,96.76524963378907,103.28550090789795,0.8192293024157057,0.01078458748280057,1.0273056382560468,1.0290907877352038,1.0018791928051587,0.018182283154455803,66.97959734866465,105.06068922452177,100.1625,95.26431077547822,102.17821393694196,1.7286455585412195,99.89678546360561,2.782839884514519,101.87040501831234,101.12606236180217,7.456196633703104,4.729468163573906,19240700,1.11624662876457,0.9983789903870601,-91575300.0,-27.332576256253727,56.70552541611323,56.9646702468221,79.28679956693519,30.48916023308043,19.920491908822434,0.14579666183046786,1.9016278497082242,102.73003710937499,101.39997702026366,100.32499694824219,99.2500168762207,97.91995678710937,0.08,0.0,100.57057617820374,0.0025458222723973023,0.0280121343095946,99.99048723493304,97.5663228716169,2.5015339328767014
2024-02-02,0,102.83250045776367,96.59749794006348,103.79999732971191,98.44375085830688,102.802499294281,-0.009932711930947982,2.46006617968165,-1.3959301498969277,2.995430646825528,100.16874980926514,2.153749942779541,0.02455823744257128,96.76524963378907,103.28550090789795,0.8299660510700121,-0.003462302770769522,1.0265516366644587,1.0220826386828383,0.9976763885105591,0.005107018643917938,59.986801810791015,105.0928823555486,100.1727499961853,95.25261763682201,102.75035694667271,0.898022114722504,100.10071413857597,2.891689190727011,102.12454026115495,101.27478958518799,5.5494291923620285,3.997273026860184,21968200,1.1292765753004057,1.132347005941572,-113543500.0,-31.94287417948411,56.70552541611323,56.9646702468221,76.31442769567326,27.678586966596768,18.122745496590234,0.14454372338184082,1.9381356936508312,102.73003710937499,101.39997702026366,100.32499694824219,99.2500168762207,97.91995678710937,0.08,0.0,100.61788682379466,-0.009999876162053889,-0.001566524299017729,100.32058279854911,97.70699637276786,2.4877893884868514
2024-02-05,0,101.46999931335449,96.59749794006348,103.79999732971191,98.44375085830688,102.802499294281,-0.02045305685554739,2.435195964162177,-1.3877221808038809,2.9954365656593818,100.16874980926514,2.1326249122619627,0.02431509189188862,96.76524963378907,102.9637508392334,0.837961621732105,1.8548111343199507e-08,1.0131637838940577,1.002504528451365,0.9834603785604329,-0.012865726923377618,60.25456367878746,105.02201689399207,100.15162496566772,95.28123303734337,102.80892835344586,0.7742367531833763,100.29410689217704,2.885837821767599,102.29777156825438,101.30383220314059,4.052516852950681,2.855643997807353,17190900,1.125365190469638,0.8829935561281501,-130734400.0,-36.55317210271465,56.70552541611323,56.9646702468221,46.684574319968014,25.673733716542507,21.08671354783029,0.15784382930791035,1.933804004428989,102.73003710937499,101.39997702026366,100.32499694824219,99.2500168762207,97.91995678710937,0.08,0.0,100.63383874172621,-0.015320386045167722,-0.014077563428390479,100.23980167933873,97.97580664498466,2.445314546985585
2024-02-06,0,102.23250007629395,96.59749794006348,103.79999732971191,98.44375085830688,102.43062591552734,0.0008549323309081872,2.377622711997513,-1.3067141003630562,2.995450047454081,100.16874980926514,2.0644999504089356,0.023756390532973865,96.76524963378907,102.9637508392334,0.9026609183094068,0.010682520092014765,1.021472071544234,1.0051989256018103,0.993397276909896,-0.012818650024085887,54.97087923388312,104.83874542780971,100.08350000381469,95.32825457981967,102.79785673958915,0.7830643505506384,100.66571399143764,2.765647402914574,102.08910186550399,101.11847508141837,0.4056994355618228,2.741423647132906,13347900,1.0241593747148996,0.7037145896131729,-117386500.0,-28.869342230663857,56.70552541611323,56.9646702468221,66.25832766003755,26.75796773059714,19.858967743409025,0.10468530595725486,1.9008390434974984,102.73003710937499,101.39997702026366,100.32499694824219,99.2500168762207,97.91995678710937,0.08,0.0,100.65733799688877,-0.024797341548014606,-0.008532908778345146,100.13534218924386,98.3428088596889,2.483860420915335
2024-02-07,0,102.09500122070312,96.59749794006348,103.79999732971191,98.44375085830688,102.43062591552734,-0.07807085332594668,2.42294282661781,-1.3957452793147662,2.9954395370879885,100.16874980926514,2.1562499046325683,0.024187040487872388,96.76524963378907,102.9637508392334,0.8942362027187374,0.018657826370611294,1.0191639278511302,0.9991852618330338,0.9946272068209485,-0.016425781819560337,58.896936690044924,105.02113561127395,100.17524995803834,95.32936430480272,102.69821412222726,0.8270041601186883,101.0526783806937,2.534001114398939,102.12746290123921,101.11843594554638,-0.07575143774487599,5.361743123603286,13826800,1.0358100598631506,0.7400229658239531,-131213300.0,-29.198637261256806,56.70552541611323,56.9646702468221,53.42135672162277,25.11948495024533,20.183641823318833,0.14724872094884636,1.87485374335702,102.73003710937499,101.39997702026366,100.32499694824219,99.2500168762207,97.91995678710937,0.08,0.0,100.67745428737993,-0.005738660655439598,-0.025083412476140543,100.00859832763672,98.72025735037667,2.519088169829556
2024-02-08,0,103.20999908447266,96.59749794006348,103.79999732971191,98.44375085830688,102.43062591552734,-0.15681673337964291,2.4587988894199033,-1.4540564090717985,2.995431134397269,100.51874923706055,2.2429999351501464,0.024523736706833648,96.76524963378907,102.9637508392334,0.9019401773826338,0.030092047694404548,1.0294029552198563,1.0068777051001545,1.0088411538855966,0.0030369842769670807,60.120240705509026,105.1795977673957,100.26199998855591,95.34440220971612,102.64821406773159,0.7751736489235846,101.5123211996896,2.268052318501866,102.11858173506633,101.09073620424957,-0.6785498208909772,5.603683858613199,19636900,0.9884642303198523,1.0469760727667272,-111576400.0,-9.988978833665671,56.70552541611323,56.9646702468221,86.98983980754444,29.418296043628313,18.377549267512197,0.19580506404647668,1.9069986487260475,102.73003710937499,101.39997702026366,100.32499694824219,99.2500168762207,97.91995678710937,0.08,0.0,100.73445979837841,0.0154311863612977,0.011283000723926009,99.88603210449219,99.20912987845284,2.6097341231810742
2024-02-09,0,103.10249710083008,96.59749794006348,103.79999732971191,98.44375085830688,102.80249977111816,-0.3045769160551943,2.5243189313868704,-1.4582509290976151,2.9954157616399155,101.26499938964844,2.3124375629425047,0.025125882900791832,96.76524963378907,103.24499912261963,0.8819278300071942,0.04313111109890213,1.0262337443674094,1.0037236878475189,1.007175065157994,0.002625596400598118,65.60109683521165,105.51551265296538,100.46687479019165,95.41823692741792,102.54857117789132,0.6345119606209271,101.9769639968872,1.802209495855678,102.39231423934673,101.25977413541543,-0.33796869763873516,6.649444062317746,20410500,1.0075545847332281,1.0751037152061558,-131986900.0,-38.15954526902284,56.70552541611323,56.9646702468221,60.516215293150445,27.56024602890227,16.2490601051315,0.17402697467433764,1.997860763188895,102.95659869384764,101.76669958496093,100.80500030517578,99.84330102539062,98.6534019165039,0.08,0.0,100.7763115024762,-0.0019615154656208444,-0.0060553733710005464,99.74118041992188,99.55384717668805,2.583483537660972
2024-02-12,0,102.6825008392334,96.59749794006348,103.79999732971191,98.44375085830688,102.84875059127808,-0.4707285217690148,2.561261662822118,-1.382207247885749,2.9954073041406235,101.78250026702881,2.326399917602538,0.025440922283540657,96.76524963378907,103.24499912261963,0.9025669283708632,0.031257014064691946,1.0199416801687256,0.9988643047522742,1.002543413346083,0.011949359752477351,63.58333935636779,105.79739801283908,100.67487468719483,95.55235136155058,102.51785687037876,0.6198405880227377,102.34803540366036,1.2599834418192761,102.56691574827269,101.43967784499614,-0.6719655557083354,6.734128004850398,18173100,0.9913577575590992,0.9568954487031988,-150160000.0,-23.94956905671144,56.70552541611323,56.9646702468221,58.078484068483455,25.88428452943806,15.26094123601395,0.20352056181340902,1.9708139947660348,103.19495739746093,102.15251748657225,101.30999755859374,100.46747763061522,99.42503771972655,0.08,0.0,100.81371122867981,0.015952677757974598,0.01176809515283911,99.84981863839286,99.92015293666294,2.629374319075931
2024-02-13,0,101.9474983215332,96.59749794006348,103.79999732971191,98.44375085830688,102.84875059127808,-0.586598050735548,2.592099576522978,-1.3340133099376728,2.995399978595644,102.16375064849854,2.35133741378784,0.025712690885086924,96.76524963378907,103.24499912261963,0.904800561133151,0.039691178797741845,1.0112823344409292,0.9918205507939933,0.9930160732763721,-0.0027877803491849207,62.52492928371135,105.99432393179352,100.81012477874756,95.62592562570161,102.39142799377441,0.6350370840411496,102.57089247022357,0.7700749152431345,102.58470974646647,101.52593393531936,-0.2089459418504048,5.328887943418321,18917400,0.9480842650569472,0.9995553692139546,-169077400.0,-67.30046791734726,56.70552541611323,56.9646702468221,21.19994826365793,23.461748866804733,18.93100243711363,0.2305195078555065,2.014777206397834,103.63863854980468,102.87067935180664,102.25,101.62932064819336,100.86136145019532,0.02,1.0,100.82956373953745,0.000311176938375457,0.0072064038497445,99.89324733189174,100.10691506522042,2.538072521702494
2024-02-14,0,101.43750000000001,96.59749794006348,103.79999732971191,98.49249982833862,102.84875059127808,-0.7665581785328647,2.5590354460764537,-1.0972108687131974,2.995408950713897,102.16375064849854,2.2421249389648437,0.02534466965629782,96.76524963378907,103.24499912261963,0.878214691132268,0.05068017726567432,1.0046363102169793,0.9884094879546969,0.9885973313726183,-0.006440092196891789,59.80756360774277,106.08744554883015,100.96937465667725,95.85130376452435,102.38678523472377,0.6429657204923852,102.59785679408482,0.7179458759674581,102.4117697946374,101.58672811718561,-0.8606249311169528,3.1570149514595185,17651300,0.8630763944880628,0.9344661864623027,-186728700.0,-90.58299876321699,56.70552541611323,56.9646702468221,3.862881282389298,21.598255368393964,18.077228024916195,0.2225352871012104,2.0283412790704713,103.82743746948242,103.17627760314942,102.64999771118164,102.12371781921387,101.47255795288086,0.04,0.0,100.8373790609044,-0.004332186453507858,-0.004624260734743395,99.92488643101284,100.08234405517578,2.3547268268717896
2024-02-15,0,102.21750068664551,96.59749794006348,103.79999732971191,100.5018744468689,102.84875059127808,-0.9892359759248247,2.394811264347889,-0.5718682037638874,2.995449970531853,102.16375064849854,1.9713500404357895,0.023666540072346032,96.76524963378907,103.24499912261963,0.8431442761826551,0.04923586398232314,1.0101566716800492,0.9983079618579414,0.9974774738971438,-0.009616300810300737,56.22417416851949,105.97937215104075,101.18974962234498,96.4001270936492,102.38464246477399,0.6435902830003333,102.59124960218158,0.7212169473050938,102.15921275945928,101.61478064277703,-0.03202849470227673,0.37354100143732,23196300,0.8696393029323132,1.2207306817500072,-163532400.0,-25.784621806045543,56.70552541611323,56.9646702468221,51.79630328639709,23.658188245418486,15.999528392037854,0.24463868649259707,2.12422077931626,103.82743746948242,103.17627760314942,102.64999771118164,102.12371781921387,101.47255795288086,0.04,0.0,100.87896198878728,0.0069638545511474526,0.02420298180588865,100.26529148646763,100.20031683785575,2.213325370779457
2024-02-16,0,103.97249984741211,96.59749794006348,103.79999732971191,101.34312486648561,102.84875059127808,-1.2648653424093252,2.166376154549609,0.236004149324744,2.9955022402416644,102.22500038146973,1.661550045013427,0.021350601666412086,97.41625099182129,103.24499912261963,0.7936544246173742,0.056238709269631613,1.0246952837997334,1.0161230043368012,1.0165725645218036,0.008438231575819133,60.743861256977645,105.79950197722057,101.46674966812134,97.1339973590221,102.65285655430385,0.8582033701100843,102.67553533826556,0.8100282052694794,102.1692432865382,101.77836529259145,-0.01467184079157193,-0.09041216440610467,20146700,0.8766439486413353,1.0600541426493066,-143385700.0,-25.784621806045543,56.70552541611323,56.9646702468221,101.11943650652546,25.179452575443573,15.367390292416577,0.17094686661782732,2.0502071741288836,103.82743746948242,103.17627760314942,102.64999771118164,102.12371781921387,101.47255795288086,0.02,1.0,100.93586830272272,0.028731856942244782,0.006963854551147346,100.60987418038505,100.30923625401088,2.00507791973252
2024-02-20,0,103.34000015258789,96.59749794006348,103.97249984741211,101.46187448501587,102.94875001907349,-1.503187791809981,1.9434476815181225,1.3427049602752774,2.995548347586839,102.27125072479248,1.4079750823974613,0.019085849969336495,98.69349956512451,103.58399925231933,0.6613860840147541,0.07634775293998455,1.0148622767157887,1.0088176411945382,1.0086723982972663,0.006403226528188366,69.14731733158291,105.71352004260167,101.82662467956543,97.93972931652918,102.67142813546317,0.8735390038193654,102.65982110159737,0.7935157207674268,102.61841987384628,102.14380206936741,1.83897213797012,1.1479439749307117,17650000,0.9275442196777037,0.934354082081815,-161035700.0,-47.75779575456608,56.70552541611323,56.9646702468221,61.619200860074926,23.836307495491624,17.704657667044156,0.10104776970865491,2.0079315497369814,103.82743746948242,103.17627760314942,102.64999771118164,102.12371781921387,101.47255795288086,0.02,0.0,100.97149616766764,0.005184886508645681,0.01901280728042155,100.57295445033482,100.22949327741351,1.6130428881796632
2024-02-21,0,103.95999908447266,97.48750114440918,103.97249984741211,101.82812356948853,103.12937259674072,-1.6532410225214305,1.5526308298536406,2.4234440701563695,2.9956158000860653,102.4962511062622,1.0821249675750741,0.015197473008206898,100.836749458313,103.58399925231933,0.5637308224969882,0.060033326728821855,1.0175820611319562,1.0130208587678624,1.0134232697961614,0.01974056054413631,63.08255638386776,105.26901144989893,102.16374979019164,99.05848813048436,102.79392841884068,0.995654956037992,102.671249798366,0.8121342221779768,102.80292581104459,102.41034329609512,0.12595782314544393,-0.21243657250775,20999200,0.9463036127381836,1.096744659498732,-140036500.0,-2.8509810285951476,56.70552541611323,56.9646702468221,137.56433104540622,25.016968149799663,16.28544109876509,0.13355621622344546,2.0240892184877572,103.90384213256836,103.23808137512208,102.70000076293945,102.16192015075684,101.49615939331056,0.04,0.0,101.03288597378888,0.03463593486658256,0.025728817950850913,101.13765825544085,100.43941933768136,1.3961366816493865
2024-02-22,0,104.44500160217285,98.82749938964844,103.97249984741211,102.05812549591064,103.24249935150146,-1.3369564988668163,1.1721305073893524,2.3198177501240416,2.995666531965868,102.73750019073486,0.8788872337341296,0.011436828301699125,101.39974994659426,103.815997505188,0.4000764548301087,0.05193392250661172,1.0191011519316693,1.0160365574144699,1.0141719139936978,0.0296488143159368,64.42815249415915,104.83163570197352,102.48737468719483,100.14311367241613,103.04571424211774,1.1703152420392582,102.78178555624825,0.9404686899873033,103.10169278428964,102.7343435147303,0.831698559933011,0.1541442763746035,20470700,0.9182190037616321,1.0604464912439746,-119565800.0,-13.026068343398576,56.70552541611323,56.9646702468221,156.9768789497155,24.79987790475357,15.136928843417618,0.10778582471267469,2.019432848916473,104.23236236572266,103.5038215637207,102.91500091552734,102.326180267334,101.59763946533204,0.06,0.0,101.09531974921947,0.03887353455279219,0.033747833972567566,101.49471718924386,100.67226791381836,1.3109257779257373
2024-02-23,0,103.6724967956543,101.05999946594238,104.44500160217285,102.18687582015991,103.39499998092651,-0.050429749524493535,0.9038140825503523,-0.8211460868220022,2.995693593533329,102.8125,0.746174688339233,0.008794682057235109,101.46674938201905,103.9612491607666,0.437290795194179,0.03349497480822002,1.0087988945964557,1.0062213704135072,1.0008253595602672,0.014234315055982272,64.13372686997837,104.57587796292175,102.76824979782104,100.96062163272033,103.29214259556362,1.0785419341263924,102.84178529466901,0.9702756384428662,103.44722652689407,103.0794980545924,1.7164567950082774,1.5039243863410872,15975900,0.7965039537764615,0.840917835770498,-135541700.0,-31.46303799403724,56.70552541611323,56.9646702468221,64.41450668593045,23.115912189367688,16.16782820014285,0.07832684901890488,2.009314201313177,104.23236236572266,103.5038215637207,102.91500091552734,102.326180267334,101.59763946533204,0.06,0.0,101.12968656789535,0.0010604055178460303,0.02975012182746893,101.84615325927734,100.86970029558454,1.3316538477546964
2024-02-26,0,103.9900016784668,101.43750000000001,104.44500160217285,102.22875022888184,103.58812379837036,-0.0440675928885997,0.8335431673934469,-0.9212290840274378,2.995699459000652,102.86500072479248,0.6972618484497068,0.008100605279822216,101.89974842071533,103.9612491607666,0.5453135870943473,0.013317323859590656,1.010603877036749,1.008850137302586,1.0010782088849395,0.0001683313480043136,55.87016897571923,104.56596099909355,102.89887466430665,101.23178832951974,103.65678569248745,0.7183397811837573,103.02178546360561,0.9290878828711421,103.5125400390418,103.23402785512468,1.6920459084543735,0.8168588084033181,13360800,0.7811453003947889,0.717344908954731,-122180900.0,-23.24654078434377,56.70552541611323,56.9646702468221,94.80638539249195,24.612744401595734,15.060656501206429,0.038420048442318035,2.000665111930041,104.23236236572266,103.5038215637207,102.91500091552734,102.326180267334,101.59763946533204,0.06,0.0,101.16311353362012,0.005012989164086434,0.005012989164086364,102.3255124773298,101.12519945417132,1.3907140790117163
2024-02-27,0,104.42749977111816,101.43750000000001,104.44500160217285,102.22875022888184,103.7043719291687,-0.21630674795714766,0.8543579634747646,-0.9678180283114597,2.9956978393876623,102.99999904632568,0.7223745346069329,0.00829611686538298,101.89974842071533,103.97425003051758,0.5681136688151738,0.01164970344687871,1.0140278186644889,1.0122229587270344,1.0052559879205545,0.010523510905017464,57.12789656614784,104.69159060651495,102.98287467956543,101.2741587526159,103.97249984741211,0.3917488815143306,103.17857115609306,0.969955295077385,103.63506600733649,103.35351480998477,2.5163294427275735,2.4834950055830407,16360000,0.7774386808435667,0.8830129307960205,-105820900.0,-27.655378029202737,56.70552541611323,56.9646702468221,103.17686025522724,24.2043680705215,14.333571638789046,-0.03756998427244938,1.9499281978441656,104.23236236572266,103.5038215637207,102.91500091552734,102.326180267334,101.59763946533204,0.06,0.0,101.20662991429879,0.01245739843044813,0.0028921033835208883,102.36768450055804,101.31648799351284,1.428875084207507
2024-02-28,0,104.55500030517578,101.43750000000001,104.44500160217285,102.22875022888184,103.8399977684021,-0.24903125690509284,0.9087240579478301,-1.0519672128501163,2.995693374097242,103.15624809265137,0.7769120311737048,0.008817031650502865,101.89974842071533,104.03375148773193,0.5984262167212862,0.008376789394065947,1.0144605932310378,1.0117475204767648,1.0043804505301166,0.005723366929040186,58.71445321607565,104.88207280690519,103.06462469100953,101.24717657511387,104.0557141985212,0.44937688389734154,103.35428537641253,0.9813158020771112,103.83498169334598,103.4543879690285,2.1620554891549877,2.1470664350242212,14810500,0.7650944773456938,0.8098721227201926,-91010400.0,-22.15569135838196,56.70552541611323,56.9646702468221,115.47368134919414,23.954226354375244,13.558183507687243,-0.11289496351641402,1.9123157739864638,104.2476398010254,103.51617948913575,102.92499923706055,102.33381898498536,101.60235867309571,0.08,0.0,101.24794686569497,-0.0050548316649657865,0.015279820796855161,102.45062364850726,101.53024891444615,1.4521492163860301
2024-02-29,0,104.62249946594238,101.43750000000001,104.55500030517578,102.22875022888184,103.96312427520752,-0.186544825635468,0.9602580444865156,-1.1285297864281325,2.9956888854499897,103.15624809265137,0.8228748321533196,0.009312552657893098,101.89974842071533,104.42924995422364,0.6294915359703308,0.007273631935323313,1.0146257467678652,1.0098526277176492,1.003881281883229,0.0016994385661996958,59.16273628152751,105.03489082194422,103.11437473297119,101.19385864399815,104.23892838614327,0.36186193883972717,103.45517826080322,1.0364060070719177,104.01075882919072,103.55693482082563,0.5602447364625622,2.409519619040673,17566100,0.76400212650897,0.973461062194808,-73444300.0,-18.163738005789863,56.70552541611323,56.9646702468221,105.8165863032501,23.15249436207064,13.104400141243262,-0.06897338194083878,1.8355361272413169,104.2476398010254,103.51617948913575,102.92499923706055,102.33381898498536,101.60235867309571,0.08,0.0,101.2959451861367,-0.002290978975170499,-0.00314738289821145,102.6994400024414,101.63619722638812,1.5000992539965396
2024-03-01,0,105.83249855041504,101.43750000000001,104.62249946594238,102.22875022888184,103.97687530517578,-0.1324237289117711,1.0052971355985776,-1.1879848876389507,2.995684764828371,103.15624809265137,0.8639999389648431,0.009745453583764004,101.89974842071533,104.45600147247315,0.6900673299933838,0.016764240700638627,1.0259511001816688,1.0184011163615687,1.0151457644410242,0.020834858053223604,61.923360703045425,105.16609411097988,103.15549983978272,101.14490556858556,104.50642830984933,0.676564264689929,103.65017836434501,1.207626519662342,104.15862861544812,103.63039251104131,1.241048298297661,1.3685693188638242,18459500,0.7310314350255813,1.0251897499352296,-54984800.0,-9.212779552715677,56.70552541611323,56.9646702468221,166.47683131967267,26.637628783973508,12.141608991681228,-0.05468886773531292,1.8380251153879719,104.9810791015625,104.10945892333984,103.40499877929688,102.70053863525392,101.82891845703126,0.1,0.0,101.36368584549828,0.01926038997445767,0.010309220363313656,102.83860778808594,101.98813302176339,1.6148709337435792
2024-03-04,1,104.97500038146973,101.43750000000001,105.83249855041504,102.22875022888184,104.09937620162964,0.14801439958359605,1.1593423733864001,-0.7256044911149533,2.995669329605664,103.27499961853027,0.9795000076293938,0.011222818249887708,101.89974842071533,104.56175022125244,0.6578865837297849,0.02917363751048293,1.01619278058637,1.0066478617586856,1.0027654300487907,0.009472051996388231,69.1467266693755,105.6209344644852,103.3022497177124,100.9835649709396,104.58214242117745,0.6978650042378967,103.8139283316476,1.2216653325642979,104.57557096069607,103.87062885003785,1.8011730304276783,2.647851920516658,18138000,0.7710735132113081,1.0181636510861283,-73122800.0,-34.00332268370615,56.70552541611323,56.9646702468221,84.41250752566083,24.733019741474493,16.577093551877812,-0.044640166402890175,1.8367244416365367,104.9810791015625,104.10945892333984,103.40499877929688,102.70053863525392,101.82891845703126,0.1,0.0,101.41220832050632,0.0010551906036568859,0.005007753659347164,102.78237806047711,102.1385476248605,1.5784650993790617
2024-03-05,1,105.18999862670898,101.43750000000001,105.83249855041504,102.22875022888184,104.43187522888184,-0.0005990756588505755,1.2089129392621372,-0.9411430206867344,2.995663935661859,103.5062484741211,1.0358750343322747,0.011690554580828206,101.89974842071533,104.65774955749512,0.7115666895373336,0.0345422399904751,1.0172191729979774,1.0077407872015682,1.0029318421355278,0.007301705558995897,63.63259529221427,105.82720059242197,103.4093747138977,100.99154883537344,104.79892839704242,0.5965392236457857,104.04553549630302,1.1455963369650568,104.67581225134595,103.99297792838374,0.5074429328036403,2.232609766512815,19952700,0.725568001997942,1.1114153086628809,-53170100.0,-12.562811501597473,56.70552541611323,56.9646702468221,116.8051439980206,24.489548098859096,15.313702530758384,-0.030236266819864608,1.8448919750308708,104.9810791015625,104.10945892333984,103.40499877929688,102.70053863525392,101.82891845703126,0.1,0.0,101.47430622128005,0.015476312828502037,0.013333346224488016,103.03541237967355,102.44078281947544,1.558948789767311
2024-03-06,1,106.77750015258789,101.43750000000001,105.83249855041504,102.57000064849854,104.47250127792358,-0.08488441946725636,1.1820942163039223,-0.9484101994795942,2.9956671477664307,103.81624794006348,1.009337463378906,0.011410685273935255,102.08025093078614,104.99650020599366,0.7403260870228126,0.02892914237847965,1.0307168682276135,1.0211395615665653,1.0165897148141607,0.021256753296590825,63.80146648079697,105.95956311217326,103.59537467956542,101.23118624695759,105.19714246477399,0.8451347941530782,104.42696407863072,1.0984617083015533,104.80991422573474,104.1639816088348,1.463745812976598,3.180558972569614,20472800,0.7127991265628236,1.1181969723782494,-32697300.0,-11.477803610443402,56.70552541611323,56.9646702468221,181.8994184516237,27.710262510193346,14.163172223832344,-0.03400769608585565,1.851024576369389,105.92507940673828,104.90745922851562,104.08499908447266,103.26253894042969,102.24491876220704,0.12000000000000001,0.0,101.55832589310394,0.02348535010298458,0.026338515034465857,103.38965933663505,102.85758590698242,1.6508753298466095
2024-03-07,1,107.13750076293945,101.43750000000001,106.77750015258789,102.99749803543091,104.57187509536743,0.1656270464989106,1.3263215820743495,-0.39505598230585326,2.995650726569374,103.96624946594238,1.069862794876098,0.012774880100740377,102.08025093078614,105.25424861907959,0.6542158797975083,0.04586413512805008,1.0319282631282771,1.02182907317252,1.015718706823497,0.024038818703770115,72.02568377987669,106.47526784752883,103.82262468338013,101.16998151923143,105.58428546360561,1.033521444728366,104.77839265550885,1.1239452365275777,105.30276523552232,104.49946574165781,2.6805446957679018,5.264325473900556,15195400,0.7766728281372377,0.8268619957675792,-17501900.0,-11.444660427646474,56.70552541611323,56.9646702468221,187.18033315835015,27.819642965980716,13.388601630550134,-0.04195094208848586,1.8171058805595273,106.7221229248047,105.9439426574707,105.31500244140625,104.6860622253418,103.9078819580078,0.14,0.0,101.62460398313604,0.027267576488405387,0.029236991823301195,103.8591788155692,103.11343165806362,1.7470544432318063
2024-03-08,1,107.69499969482422,101.43750000000001,107.13750076293945,103.18312358856201,104.71062469482422,0.2848820791400704,1.447669839671566,-0.2728915990539371,2.9956356501554424,103.98125076293945,1.128975267410278,0.013909904606007611,102.19050045013428,105.92699871063232,0.7419799437310507,0.03805349978980541,1.034785094810625,1.0245153071251363,1.0161583280723812,0.017598574822666135,72.38368524555707,106.97008933983508,104.07474966049195,101.17940998114881,106.03285680498395,1.182946346391333,105.04428550175258,1.3384731529545268,105.75839036354934,104.84789437672835,2.5951028203883153,4.8132658725207245,16274600,0.750077404804065,0.8937631373367401,-1227300.0,-0.34790039062524714,56.70552541611323,56.9646702468221,183.14050977572137,27.686116656202227,12.51779585833185,-0.031659688958919394,1.8036403576845823,107.0430015258789,106.2035015258789,105.5250015258789,104.8465015258789,104.0070015258789,0.16,0.0,101.70041225358537,0.0239984862631899,0.03693069873929732,104.42990984235492,103.44026674543109,1.9834320827777359
2024-03-11,0,108.43249893188477,101.43750000000001,107.69499969482422,103.28062438964844,105.02874994277954,0.3372685660269897,1.6319867420188867,-0.40365160435846237,2.9956100586613466,104.20875072479248,1.266750240325927,0.015647194573809153,102.19050045013428,106.81350021362304,0.7675393809582951,0.044543078229258196,1.0396312452959369,1.027598958442616,1.0195336280350618,0.03293639950322258,74.90475475541652,107.5629731750473,104.29899969100953,101.03502620697175,106.57714244297573,1.2968949375324414,105.4080354145595,1.5194290594003148,106.2389027433542,105.19860749329878,3.003203462754902,3.5802734885428102,17577300,0.7501141658104948,0.9728729870875275,16350000.0,-1.6026605044690365,56.70552541611323,56.9646702468221,181.8465792690203,28.59300662930045,11.628346192394098,0.06523572277176838,1.8019403587390326,107.64736145019532,106.73632064819336,106.0,105.26367935180664,104.35263854980468,0.18,0.0,101.78859293049774,0.044653085786880986,0.030045375476906666,105.06249455043248,103.88096727643695,2.086587223971551
2024-03-12,1,108.67249870300293,101.43750000000001,108.43249893188477,103.5893726348877,105.3506236076355,0.3815094698241973,1.8371358968863216,-0.45886452127270294,2.995578259348714,104.43625068664551,1.4138498306274407,0.01756923555767951,102.19050045013428,107.19325065612793,0.7728365490209602,0.05599783844039745,1.0392768066807976,1.0255557195784926,1.0151896519248782,0.033106760355158915,78.6445665998075,108.23977157633489,104.56549978256226,100.89122798878962,106.98285675048828,1.4591900440797247,105.7446425301688,1.6867422198197257,106.78255883200093,105.57810537696699,3.641663586122454,4.927906688385414,14957200,0.7408454864029522,0.8352888484817347,31307200.0,-14.999982118610797,56.70552541611323,56.9646702468221,151.6134521486109,27.787612790189133,11.035348899663058,0.009365034564076552,1.7622589911538302,107.76959841918945,106.83519819641113,106.07999801635742,105.3247978363037,104.39039761352538,0.19999999999999998,0.0,101.86239230232032,0.025369185650314874,0.03794555761101329,105.41111973353794,104.12486376081195,2.1582848052274706
2024-03-13,0,109.53249931335449,101.43750000000001,108.67249870300293,103.88812351226807,106.06874895095825,0.3292047423752895,1.98782692234625,-0.6104357026414746,2.9955529556737988,104.50000095367432,1.5792498397827153,0.01895605710668705,102.19050045013428,107.76874961853028,0.7804951239426938,0.06596533011785814,1.0445096042725024,1.0295472254550204,1.016608964574363,0.02580130792376334,81.57851168614948,108.84065352044324,104.86499967575074,100.88934583105824,107.63392802647182,1.430463028960866,106.10803522382464,1.9174567306432744,107.25121929664863,105.98522772261721,2.6834858776720747,4.532993132003718,17122200,0.6998268188287637,0.9610110872510644,48429400.0,-10.977236423356748,56.70552541611323,56.9646702468221,165.37274649653054,29.82832248139769,10.131723300894011,0.01544589535211131,1.7814989960183276,108.58707818603516,107.49645800781249,106.61499786376953,105.73353771972656,104.64291754150389,0.2,0.0,101.95875351228452,0.02585002398166858,0.03682319022170038,106.1378893171038,104.46013368879046,2.2150236144119493
2024-03-14,0,110.63500213623045,101.43750000000001,109.53249931335449,103.96937465667725,106.86750030517578,0.39873081695543505,2.1145477551590655,-0.6081037214350542,2.9955309398307954,104.58874988555908,1.737024803161622,0.020091812718295264,103.22775020599366,108.45649890899658,0.7481409319475696,0.07980282748839904,1.051221348671847,1.0350675148876085,1.021617104052341,0.03264497816716694,85.38672834254467,109.47334523565992,105.2442497253418,101.01515421502368,108.41178567068917,1.3586490938864324,106.60535703386579,2.1284754441597658,107.82367110462788,106.47859296616421,4.341508850034031,4.870982462674213,22121000,0.6773127073672065,1.2261960622149966,70550400.0,-0.9411980124079211,56.70552541611323,56.9646702468221,177.5050934844612,32.21437236877789,9.31439194495618,0.10153292130658376,1.7986307789937315,109.5440030517578,108.3030030517578,107.3000030517578,106.2970030517578,105.0560030517578,0.2,0.0,102.0992561352009,0.03818570667365284,0.04401995942904385,106.95743887765067,104.99642562866211,2.3449348703339776
2024-03-15,0,111.3174991607666,102.21750068664551,110.63500213623045,103.98562622070312,107.27687549591064,0.6625772020490815,2.233443641372878,-0.6050987016637261,2.9955100545353806,104.79874992370605,1.90819995880127,0.021129200444347317,103.63924713134766,108.75849876403808,0.7532090362461914,0.08234892648558638,1.053104591117203,1.0356272276459708,1.0213223670229223,0.03363665421985673,87.22279679846926,110.17101211489909,105.70412483215333,101.23723754940757,109.06035695757184,1.5222424738124936,107.12874971117292,2.3275001706512417,108.53102197923452,107.04005526189628,5.176350965498464,6.7158653989975186,38263900,0.6898943145955349,2.0359933967321537,108814300.0,-12.189418351527852,56.70552541611323,56.9646702468221,164.10846881394826,33.35960231977046,8.767629356824262,0.0006836560824389708,1.7735990766282488,110.30580197143554,109.07210130310058,108.07500076293945,107.07790022277831,105.84419955444335,0.2,0.0,102.34722349535726,0.02666542381351955,0.03632288183919467,107.59002358572823,105.48984146118164,2.569721192059493
2024-03-18,0,112.01250076293945,103.34000015258789,111.3174991607666,104.31812524795532,107.87937450408936,0.7547416502882751,2.397689875624296,-0.7086676017233011,2.9954786147350267,105.08249950408936,2.0927000808715825,0.02258581050982108,103.93124885559082,109.64274959564209,0.8193214415620965,0.07064367331875122,1.055137756839475,1.036802386086409,1.0209127136953915,0.03301594878214109,87.68553628037932,110.95450450710797,106.15912475585938,101.36374500461079,109.75678552900042,1.6086236721233116,107.67053549630302,2.524787408512426,109.23056426468821,107.60615362414198,4.251831145785331,7.046348075804588,16770500,0.6206390058112733,0.9004336395629188,125584800.0,-6.320513769936903,56.70552541611323,56.9646702468221,154.5361380329229,33.24974309633015,8.142819870770802,0.0506815113118433,1.7726231664397587,110.7690404663086,109.47548037719727,108.43000030517578,107.38452023315429,106.09096014404297,0.2,0.0,102.45884576126933,0.03008626259544478,0.03616910118753747,108.28305489676339,106.0711168561663,2.8208481899478435
2024-03-19,1,112.71499824523926,103.34000015258789,112.01250076293945,104.44062614440918,108.4924988746643,0.6593744090862802,2.657319478792113,-0.8638982664955877,2.9954229821672658,105.51124858856201,2.3162376403808587,0.024937044196358955,103.93124885559082,110.70325183868407,0.8217967437749181,0.08392201081426437,1.0577497042665325,1.0365526879617202,1.0206548547518455,0.0371989196023208,90.8319189874589,111.87576375921998,106.56112480163574,101.2464858440515,110.47392817905971,1.6545909512556471,108.25339249202183,2.6869070289691876,109.92456568026898,108.1415500300538,4.550227478972833,7.2634133810020565,14878800,0.575029316229372,0.8048530929975108,140463600.0,-4.228346348737417,56.70552541611323,56.9646702468221,152.37535797885414,33.88400441132311,7.664874665958085,0.11003364569327014,1.7480401656101996,111.25743807983397,109.87627821350097,108.7599983215332,107.64371842956542,106.26255856323242,0.2,0.0,102.5637421752976,0.04403611490810411,0.0373325481904556,108.94515991210938,106.68753487723214,2.9986872231067547
2024-03-20,1,112.80999946594238,103.6724967956543,112.71499824523926,104.52750062942505,108.88749885559082,0.5960946922239658,2.8664169370547254,-0.9908697694728654,2.9953754740243825,106.30499935150146,2.4881125354766844,0.026781465875030597,103.98700141906738,111.38699932098389,0.8414899835100179,0.08421507539311086,1.054004779278094,1.0302965236149195,1.0140908334792131,0.02992262728536388,91.54515101186523,112.76270858037779,107.02987470626832,101.29704083215884,111.0992853982108,1.5799958555445908,108.83821392059326,2.72656672634471,110.62316017252883,108.71404784756318,4.661310705826854,7.804502813108913,16119700,0.5765573374587684,0.8836401829147293,156583300.0,-5.285412773672304,56.70552541611323,56.9646702468221,131.34674690247002,32.082932419497936,7.25745555120038,0.0771241938998844,1.7137523567452717,111.25743807983397,109.87627821350097,108.7599983215332,107.64371842956542,106.26255856323242,0.2,0.0,102.67459799350152,0.031589489395914994,0.043112978586630255,109.50324031284877,107.28286743164062,3.2020673266760973
2024-03-21,1,113.22249984741211,103.6724967956543,112.80999946594238,104.60562467575073,109.80812501907349,0.4577617465730512,3.0364164874666417,-1.1948126282411642,2.9953347839465976,106.95750045776367,2.6571123886108388,0.028252995202037348,104.38374996185303,112.08275051116944,0.870444441140084,0.08008997783954755,1.0535032852560058,1.0283979448637197,1.01183667173435,0.02338769522502049,91.51464178172375,113.54520770027507,107.4723747253418,101.39954175040852,111.74928556169782,1.3316384561106238,109.36607115609306,2.813852164100004,111.16676034541354,109.21836954528008,4.037074287854861,7.825754538262839,14878000,0.5822442211340436,0.8282698440577985,171461300.0,-4.251068732471078,56.70552541611323,56.9646702468221,125.36191677006244,32.423358587941706,6.844086984395155,0.07458982161463792,1.6869527009504186,111.57832250976563,110.135841796875,108.97000122070312,107.80416064453125,106.36167993164062,0.2,0.0,102.77957797309145,0.018121348410889526,0.03615439295517761,110.23000880650112,107.82056427001953,3.3782957508104383
2024-03-22,1,113.3700008392334,103.6724967956543,113.22249984741211,104.88687515258789,110.80562639236449,0.3110309968955804,3.1972115102656615,-1.3327427008529835,2.9952946020513833,107.41625022888184,2.8148749828338615,0.029628157592491926,104.38374996185303,112.72449836730956,0.8633514168749922,0.09211703534623587,1.0505855619313247,1.0240776230602633,1.008490833977956,0.01843826616606381,94.811691240244,114.30567265813508,107.91124963760376,101.51682661707244,112.29750006539481,1.0204875152187056,109.96571404593331,2.698245584469367,111.67971098344165,109.69222693757094,4.1868929110060575,6.982733468658233,14695400,0.5076890886768567,0.8210307776198521,186156700.0,-4.379620694346364,56.70552541611323,56.9646702468221,112.24193114970663,31.181562847040798,6.5819624409267306,0.07084650860457657,1.6283894371724439,111.64676272583007,110.24662214660644,109.1150016784668,107.98338121032715,106.58324063110352,0.2,0.0,102.8813536149086,0.019951455383868666,0.018121348410889488,110.78668212890625,108.46228572300502,3.433704865767715
2024-03-25,1,114.52250099182129,103.9900016784668,113.3700008392334,105.13624906539917,111.49124956130981,0.19194569722979626,3.252476661099211,-1.4390173857746569,2.9952828689214304,108.06374931335449,2.8758749008178706,0.03000546989946925,104.54225025177001,112.85124950408935,0.8729235459068172,0.09020097133731383,1.0565184056265278,1.0292122120461422,1.0150364380744845,0.022408215259776654,94.87283009690005,114.90107816198112,108.39612483978271,101.89117151758431,112.85285704476493,1.0227535340671516,110.63232135772705,2.5777541691332497,112.10382343896367,110.13756298222924,3.5035277656729487,7.9971425837170695,14011700,0.5123496327350424,0.7814116851209326,200168400.0,-11.73413889621723,56.70552541611323,56.9646702468221,126.64740702567964,37.06584936387862,5.937368945378096,0.05445374844102456,1.6758050523787447,113.50731942749023,112.1013398284912,110.96500015258789,109.82866047668458,108.42268087768555,0.2,0.0,102.98952051340981,0.020926069556430615,0.03037661864743697,111.23370797293526,109.09557342529297,3.535236943024409
2024-03-26,1,114.21000289916992,104.42749977111816,114.52250099182129,105.67187356948853,112.1881251335144,0.12063646225750593,3.3477154521717734,-1.4234711695422884,2.9952604276214063,108.55249881744385,2.983275251388549,0.030734768064074852,104.61574954986573,113.23724994659423,0.8609830219807201,0.0966699503754195,1.048541311187637,1.020816787065609,1.007782745854425,0.01326358228456792,95.69141699061622,115.61818070979399,108.92274980545044,102.22731890110688,113.26607186453683,0.8723000607493939,111.16321441105434,2.4865315640262247,112.70620194102708,110.67777270883401,3.5138055592966513,8.872043432789505,13152300,0.5326950185001271,0.7401040353657219,187016100.0,-21.67753592173139,56.70552541611323,56.9646702468221,100.03461773183291,34.56645945121229,7.3408868041517845,0.06913671967224734,1.6682241213759006,113.61351870727539,112.27323866271972,111.18999862670898,110.10675859069825,108.76647854614258,0.2,0.0,103.0833955673903,0.0061898085934439795,0.013267991247279532,111.58795601981026,109.58898980276925,3.4818613999062387
2024-03-27,1,114.23000144958496,104.55500030517578,114.52250099182129,106.54124975204468,112.73874855041504,-0.008398439411587964,3.369769124194994,-1.441624022844596,2.995257828515819,109.10249900817871,3.0228754043579094,0.030798934077035788,104.93975028991699,113.45400104522705,0.8735225196168424,0.09234376706817521,1.0440365955652602,1.0159670482437744,1.005306842885735,0.012587554209423368,90.969887607223,116.15141321024302,109.41187496185303,102.67233671346304,113.58285767691476,0.7326540062908314,111.66982160295758,2.320189155954741,113.07982523790399,111.10238622224999,2.598426806396286,6.960738672436409,12415700,0.5586770758054844,0.7033936618258084,199431800.0,-8.989981870666128,56.70552541611323,56.9646702468221,98.82688776766408,32.45923426157782,6.820369231464961,0.12411591911789716,1.6669182185841833,113.65363827514649,112.33817796325684,111.27499771118164,110.21181745910644,108.8963571472168,0.02,1.0,103.17389920856945,0.01752370245168211,0.016624008394857077,111.96328953334263,110.12317221505302,3.458126137086166
2024-03-28,1,115.81999778747559,104.62249946594238,114.52250099182129,107.04750061035156,112.91312456130981,-0.1412704969837256,3.332054231787445,-1.421848197188757,2.995271848947474,110.08375072479248,3.0088755607604973,0.03032017181038038,105.16849880218506,114.21200275421143,0.8706943869513577,0.09183017068685206,1.0539090866208174,1.0258226837076356,1.0167586673967361,0.022941534973738298,90.97521459026896,116.55973348264837,109.89562501907349,103.23151655549862,114.02642904009137,1.0078870934719366,112.25017860957554,2.2649836803905874,113.36548991979785,111.48137484312018,1.9796903662909666,6.61999826030935,18482100,0.5607458431281065,1.0443669922596788,217913900.0,-2.3051489616154957,56.70552541611323,56.9646702468221,119.0164647689474,36.39899386737079,6.383163690348722,0.17483253801374668,1.6535309738174913,114.30003680419922,112.9699767150879,111.8949966430664,110.82001657104493,109.4899564819336,0.02,1.0,103.32277717998842,0.024231257118622063,0.02876359964361895,112.40609959193638,110.67562975202289,3.4622688774024653
2024-04-01,0,116.5049991607666,104.97500038146973,115.81999778747559,107.55562496185303,113.25937509536743,-0.17202214196600507,3.339721913859862,-1.3059875208056768,2.995274257290303,110.97625064849854,2.9854504299163813,0.030235904195089026,105.76824855804443,114.25925140380859,0.8609292752327281,0.09437081590115572,1.0547686555143763,1.027172610598108,1.0181288935460833,0.02765280319596064,92.6969585018228,117.1349437628699,110.45549993515014,103.77605610743039,114.55428613935199,1.2116239428060511,112.82678576878139,2.245784466649651,113.97779539143089,112.05022762553878,2.7547350313404046,7.544452496100291,13817000,0.591446731568761,0.7911334875290692,231730900.0,-2.7144410950211815,56.70552541611323,56.9646702468221,121.87846377025117,36.88391152263996,5.873577356686193,0.21078879903073144,1.6683153513216618,115.06643807983397,113.72177821350097,112.6349983215332,111.54821842956542,110.20355856323242,0.04,0.0,103.43719219152763,0.030839756944823993,0.030839756944823982,112.96839686802456,111.23581859043666,3.5413345377643295
2024-04-02,0,118.53249931335449,104.97500038146973,116.5049991607666,108.24812412261963,113.58000135421753,-0.23116673410783095,3.410308159476862,-1.1185297741579077,2.9952589556856664,111.66499996185303,2.98546259880066,0.03072650730899782,106.61875,114.65225067138672,0.8318497153695849,0.10983566313310687,1.067964986209416,1.040290316434104,1.0302022800926955,0.03501493843397263,96.30613996271993,117.80974128462144,110.98912496566773,104.16850864671402,115.31285749162946,1.7716615237125828,113.53107152666364,2.3845485033638343,114.60679001271396,112.62016435462962,3.275418590831346,7.444723960436278,19919600,0.4938260236213502,1.1347680956277795,251650500.0,-3.0505220208808352,56.70552541611323,56.9646702468221,157.617724841348,42.64740830272135,5.241267019413402,0.28338921895221725,1.7357333344879853,117.12435897827149,115.59281929016113,114.35499954223633,113.11717979431153,111.58564010620117,0.06,0.0,103.62582100461398,0.04038376499151752,0.05101777168816008,113.7823235648019,112.00616618565151,3.592602171027234
2024-04-03,0,119.31500244140625,105.18999862670898,118.53249931335449,108.61249876022339,114.21500253677368,-0.046118100771437014,3.493898596285892,-0.8362554588365776,2.9952423786743023,112.36374950408936,2.9613001728057875,0.03128855077176863,107.1015007019043,115.88849792480468,0.7854127616506336,0.12684191330769434,1.0684893704957903,1.0411999122238886,1.0298249372360073,0.044698357522530374,97.18882600815029,118.65479710483373,111.66699991226196,104.67920271969018,116.16214343479702,2.0827135049438286,114.22982175009591,2.5502440483313547,115.58854187719278,113.43635251276002,4.689880079576561,9.073133247169094,16504300,0.5769814042322657,0.9495339146994142,268154800.0,-4.473131783792446,56.70552541611323,56.9646702468221,156.14379164507335,41.43632680582546,5.014090933944319,0.2714763933250808,1.6845000849639071,117.37584057617187,115.90708093261718,114.72000122070312,113.53292150878906,112.06416186523437,0.08,0.0,103.7839127710822,0.048422571866943986,0.04055823928120946,114.59906223842076,112.69287218366351,3.626546641996425
2024-04-04,0,119.32250022888184,106.77750015258789,119.31500244140625,109.3174991607666,114.30312633514404,0.1593937892537024,3.5405589842357688,-0.7869573075567176,2.9952365746376017,112.76249885559082,2.9146751308441177,0.031507133423573974,107.63924980163574,116.70774917602539,0.813954566320483,0.11741708010490913,1.0618407861258405,1.0353025371794984,1.0208931361324314,0.04458109703819302,97.3261612019386,119.45436807146835,112.37325010299682,105.29213213452529,116.84785761151996,2.237341184756731,114.85035732814244,2.6627115381476156,116.52081246017747,114.24518905324518,5.243893056509085,8.931142071419025,18467400,0.5387063455064474,1.0686407574008872,286622200.0,-1.771827844336519,56.70552541611323,56.9646702468221,145.88644590866656,39.77421333776461,4.74484143272531,0.32020392557421407,1.6526869622219698,117.7489175415039,116.43053771972656,115.36499786376953,114.29945800781249,112.98107818603515,0.1,0.0,103.95877632495122,0.041315160104641535,0.05211361020220398,115.31177520751953,113.2727415902274,3.6781810797311403
2024-04-05,0,120.78500175476074,107.13750076293945,119.32250022888184,110.35937643051146,114.84687519073486,0.16918830612247596,3.604316626463003,-0.8393967618463414,2.995224311244959,113.01624965667725,2.904500389099122,0.03189646614887627,108.3587490081787,118.61074962615967,0.830653479684892,0.1137323474896417,1.068889090230495,1.0421034574692252,1.0244785958626705,0.042868278899432566,97.2970958895642,120.20913335973754,113.00050010681153,105.79186685388552,117.78714316231864,2.323832988895225,115.52660751342773,2.8890635003301117,117.2193847310144,114.94499095062892,4.191315414429643,7.852395647766181,21714100,0.5545511662739765,1.2332553725363689,308336300.0,-7.058810532842162,56.70552541611323,56.9646702468221,160.61243069960372,45.083368739915834,4.247623735392993,0.3326119138766895,1.7140365095152548,119.54220080566407,117.92890036010742,116.625,115.32109963989258,113.70779919433593,0.12000000000000001,0.0,104.18073620867251,0.04413283225121534,0.055666662530502224,116.37732914515904,113.98264258248466,3.8184672713671417
2024-04-08,0,120.89500045776367,107.69499969482422,120.78500175476074,111.14687490463257,115.99124813079834,0.2514596298729782,3.719764490599805,-0.8325237571156427,2.995198219858186,113.29625034332275,3.0096629619598394,0.032720534957285594,108.64849872589112,119.31575222015381,0.8161035704965807,0.12154698079789887,1.0634407362713054,1.036290968476672,1.0168472215806033,0.03768079763632515,97.73377634274745,121.12240413760222,113.68287515640259,106.24334617520296,118.73928587777274,1.9604713766465212,116.16107177734375,3.029877006091827,118.1098005094413,115.76506065926768,5.756937823909825,8.504954445950151,17513900,0.5834212569055774,0.991216023675223,325850200.0,-15.857263082440692,56.70552541611323,56.9646702468221,137.18927337328034,42.18168250399192,3.974235306957719,0.25898851148786367,1.7008684855579832,119.76876058959961,118.29562001037598,117.10499954223633,115.91437907409669,114.44123849487306,0.12000000000000001,0.0,104.35332597475062,0.030430007490181987,0.03707850262063613,117.16173444475446,114.56251198904855,3.8472302857721545
2024-04-09,0,121.04249954223633,108.43249893188477,120.89500045776367,111.83875036239624,117.01187419891357,0.26161774933701204,3.7694897209212863,-0.9610963950399833,2.9951902400496047,113.79000186920166,3.0954500579834,0.0329665465776303,109.44649925231934,119.46875038146973,0.8366945355149541,0.11493326861080286,1.0585924075836612,1.0309056552038882,1.0106245194463261,0.02117562899139047,97.7126469078241,121.88185463639215,114.34287519454956,106.80389575270698,119.48535755702427,1.6302800213386095,116.75589329855782,3.117463811181863,118.80556808366764,116.4604940345671,5.834718483410233,7.929918209417471,14135700,0.5973329873629931,0.8078916272909251,339985900.0,-9.6806467774578,56.70552541611323,56.9646702468221,123.64150830572102,39.81855990592515,3.7515887763690485,0.22835949198611696,1.672905366915232,119.78528051757812,118.32235989379882,117.13999938964844,115.95763888549804,114.49471826171875,0.12000000000000001,0.0,104.49189082161286,0.015928881412361706,0.03581502550916603,117.85617174421039,115.13113566807338,3.8800309189790583
2024-04-10,0,121.65500068664551,108.67249870300293,121.04249954223633,112.5393738746643,118.72812509536743,0.2227123771295164,3.7827428420844136,-1.1114809240771208,2.995192173012808,114.22000217437744,3.243049888610842,0.03290103325817366,110.52475185394286,120.79600162506104,0.8402189184647149,0.1138282544973964,1.058114545637185,1.030400435077892,1.0114989340117324,0.019611936448548306,97.74124801750378,122.53886090923596,114.97337522506714,107.40788954089832,120.22107206072126,1.1534558228047906,117.38767910003662,3.152344388385464,119.36578305928892,117.07536805066736,4.509153733834285,7.388104002697617,17409200,0.6010683174483222,0.9880573508233007,357395100.0,-2.727315463084767,56.70552541611323,56.9646702468221,122.3608297307321,40.360733397317055,3.4732588595262848,0.2835915202375059,1.677704750209938,120.1336008605957,118.68820063781739,117.52000045776367,116.35180027770996,114.90640005493164,0.14,0.0,104.6669344579591,0.024308467686248614,0.024480246118725766,118.58856528145927,115.7784810747419,3.8274433722829184
2024-04-11,0,121.87750053405762,109.53249931335449,121.65500068664551,112.7862491607666,119.31687688827515,0.21974433768744117,3.7596454231853134,-1.2918153563236274,2.995204711211463,114.37625122070312,3.326999845504762,0.03251655527809764,111.24924945831299,120.90975036621094,0.8442995332996137,0.11067492706991493,1.0540984686567663,1.025816377328407,1.0094210700262432,0.02141256091914623,97.87108288818831,123.1417911706199,115.62250032424927,108.10320947787865,120.69892937796456,1.0228070904462612,118.00589343479702,3.1211894881212645,119.94091925006464,117.66205385314329,4.420412482705879,7.840618085787202,17555900,0.5990774620202876,0.9951585228081135,374951000.0,-9.11855395572775,56.70552541611323,56.9646702468221,105.4471256603857,36.42971240392274,4.751376663463146,0.3105429400915415,1.7257919796163503,120.36068179321288,118.9196613922119,117.75500106811523,116.59034074401855,115.14932034301758,0.16,0.0,104.83795203268548,0.017290305750927493,0.02087174096357146,118.94140733991351,116.3618654523577,3.738252934474851
2024-04-12,0,121.68499946594238,110.63500213623045,121.87750053405762,113.11937475204468,119.68812561035156,0.18060375362472236,3.7223355350949396,-1.4673955184264165,2.9952203948427685,115.17124938964844,3.377225065231324,0.03202291404409429,111.94300060272217,121.10374965667725,0.8618178274593435,0.10161791639849845,1.046844982569296,1.0176458228880774,1.0035793425927997,0.0074512373068387205,97.85550339728762,123.68442145547431,116.23975038528442,108.79507931509454,121.03750038146973,0.8690487373535248,118.59982190813336,2.958033601781826,120.42846270757911,118.19341651977184,2.8220118871029825,7.644240940016069,21539500,0.5953834713708706,1.2229850442036458,353411500.0,-32.68857302233319,56.70552541611323,56.9646702468221,88.10537560406298,34.81996680790494,4.019419450487882,0.2134912464463153,1.8941634486498364,121.30976086425781,119.80012139892578,118.58000183105469,117.3598822631836,115.85024279785156,0.18,0.0,105.03891492406645,-0.008239231767353195,0.005429307418933093,119.0918219430106,116.84544209071568,3.638772120782184
2024-04-15,0,120.47749900817871,111.3174991607666,121.87750053405762,113.33312559127808,120.81250143051147,0.0750712581905498,3.6691146703422297,-1.5879907785417418,2.9952390727356306,116.1624984741211,3.3979752159118646,0.03141573745203718,112.64474849700927,121.65800056457519,0.8758197119535607,0.09313450610494639,1.031553880916451,1.0026297828227357,0.992147794812922,-0.0034534219612399886,94.6636677500232,124.13047959245445,116.79225025177001,109.45402091108558,121.20250020708356,0.5343649915113872,119.02517890930176,2.747273355945587,120.74257567594071,118.6341763671929,1.9863361488845475,7.33439054878392,15029500,0.6199150066407115,0.9136188137575024,338382000.0,-39.36171311695556,56.70552541611323,56.9646702468221,61.41554209039267,31.913201197216406,4.503772841022936,0.24119459551613365,1.9188955895467088,121.30976086425781,119.80012139892578,118.58000183105469,117.3598822631836,115.85024279785156,0.02,1.0,105.1678714497168,-0.007216955068954034,-0.013924357263647867,119.08619798932757,117.19898659842355,3.4343531444777553
2024-04-16,0,119.09749984741211,112.01250076293945,121.87750053405762,114.00000238418579,120.81250143051147,-0.06304208215937096,3.5260525259158473,-1.644190171898303,2.9952797060626244,117.51874923706055,3.3085000991821287,0.03007287846783982,112.80049934387208,121.65800056457519,0.8958765035110546,0.07557190659598231,1.0157547604327077,0.9878793493483521,0.9814582088396608,-0.01606873372724371,77.26454088980759,124.30235529597232,117.25025024414063,110.19814519230894,120.96142850603376,0.9629112338903405,119.3742858341762,2.3734216274166124,120.67806284447619,118.83120600553353,0.9679639440016605,5.199849780422366,18082200,0.7313418697787775,1.0948226276179,320299800.0,-48.93616393316839,56.70552541611323,56.9646702468221,29.0223373809892,29.216266729454983,9.744801739772376,0.20368654343520431,1.9461473640121099,121.30976086425781,119.80012139892578,118.58000183105469,117.3598822631836,115.85024279785156,0.04,0.0,105.30674829034066,-0.020547871582856536,-0.015429263504753944,118.70945957728794,117.54339436122349,3.2354650881601668
2024-04-17,0,118.41250038146973,112.71499824523926,121.87750053405762,114.2250018119812,120.81250143051147,-0.19213886039386924,3.3326369377563854,-1.5875421053713725,2.9953299567782707,118.8149995803833,3.1035501098632805,0.02833766507348958,113.18124980926514,121.65800056457519,0.9066289456955886,0.056625131540047106,1.006870486943464,0.9817373838879123,0.9789514624527867,-0.026653243079811317,62.24043611165215,124.26977407387703,117.60450019836426,110.9392263228515,120.60678563799176,1.3647593937967155,119.67303575788226,1.8901066528728057,120.2847229769803,118.83225165559229,-1.3971121271951465,4.279394820221749,14538600,0.8335281435327947,0.8811758709116685,305761200.0,-58.918311946452285,56.70552541611323,56.9646702468221,11.331487060697311,26.847290075417668,11.863490580028907,0.19964007835887987,1.9664428640609652,121.69915942382814,120.43041906738281,119.40499877929688,118.37957849121095,117.11083813476563,0.06,0.0,105.41175796151859,-0.029214405630078155,-0.0210430249153172,118.43955666678292,117.8006455557687,3.058730356602286
2024-04-18,0,118.80249977111816,112.80999946594238,121.87750053405762,114.4493761062622,120.81250143051147,-0.3129357554809016,3.140477173891198,-1.4382651121043202,2.9953763982047343,118.8149995803833,2.842500000000001,0.02663918750745403,113.35525074005128,121.65800056457519,0.8938450246453422,0.049663158780696146,1.007745604415823,0.9857083558026071,0.9874698688537453,-0.025230257836475478,56.43357803360451,124.17032965295817,117.88937530517578,111.60842095739338,120.28678567068917,1.5013444112566916,119.88607161385673,1.5620275903666638,119.81391828802549,118.75253961420957,-2.0534348541247085,3.6614714863071223,13821400,0.8630676474532828,0.8435822981627088,319582600.0,-62.48508531337467,56.70552541611323,56.9646702468221,14.702984736906496,26.48146772458128,11.102670096498343,0.167943184412386,1.9509680624433274,121.77467935180664,120.55265895080566,119.56499862670898,118.57733830261229,117.35531790161131,0.06,0.0,105.51284033427508,-0.026849515784102107,-0.030114598891191446,118.06562914167132,117.96090044294085,2.833772243001733
2024-04-19,0,119.72999954223633,113.22249984741211,121.87750053405762,115.49562358856201,120.81250143051147,-0.43358972713749144,2.919676111946074,-1.2523392801396809,2.9954259989592233,118.94999980926514,2.5442999267578115,0.024703450439806027,114.12600269317628,121.65800056457519,0.880259133422336,0.049283489864877725,1.0130384318136527,0.9938326380033023,1.000292408601039,-0.016066071679223137,58.17148440783061,124.02835254432674,118.18900032043457,112.34964809654241,120.01178550720215,1.3803884164003697,120.11642878396171,1.2269066200721257,119.55888308808358,118.75012057486067,-1.8505894868244546,2.575118322066741,21566500,0.8629208506635212,1.2899704520713458,341149100.0,-58.371106331709974,56.70552541611323,56.9646702468221,42.177417620270695,28.542088488798363,10.138390334875455,0.14407226314010468,1.9837850640106296,122.18532064819337,121.21734104919435,120.43500137329102,119.6526616973877,118.68468209838868,0.06,0.0,105.6813817431963,-0.004070845333577711,-0.015682785382061155,117.73949541364398,118.16403034755162,2.6287212368616366
2024-04-22,0,119.95499992370605,113.3700008392334,121.87750053405762,116.33374881744385,120.81250143051147,-0.590044263197156,2.702603800157594,-0.9874732181976773,2.995471049719078,119.20625114440918,2.2530623626709003,0.022804016754915682,114.22800159454346,121.65800056457519,0.8474562126631999,0.05609948536581431,1.012155695162048,0.9965729952000212,1.0054566503654951,-0.004336901817966754,63.064194562769785,123.91958290549097,118.51437530517578,113.10916770486058,119.73714256286621,1.1125918609069136,120.21803597041539,1.1415774690251799,119.59605591634062,118.8890645715687,-1.5823444441610148,2.7681218872157674,16340700,0.8734790444557496,0.9726106364166369,357489800.0,-48.114687223462994,56.70552541611323,56.9646702468221,45.850870420049986,27.65571005244852,9.037101308425665,0.1370866187252265,2.0664390270619224,122.18532064819337,121.21734104919435,120.43500137329102,119.6526616973877,118.68468209838868,0.06,0.0,105.80882386677212,0.0073529240279046615,0.001578418748407008,117.56658826555524,118.25399780273438,2.381892570390403
2024-04-23,0,120.3849983215332,114.21000289916992,121.87750053405762,117.93562507629395,120.81250143051147,-0.727568692648455,2.4446272314105024,-0.6854571303813533,2.995519618156228,119.31875133514404,1.9714000320434564,0.020570116622365114,114.49325103759766,121.65800056457519,0.8525195935241254,0.04743608360659825,1.0129697580225228,1.0009270408806026,1.0099454983402365,0.01081045761473276,62.76467326511313,123.73287972222045,118.84362525939942,113.95437079657839,119.5514281136649,0.7970053812469117,120.29446424756732,1.1119012636614571,119.68219862500804,119.07499727231483,-1.577404034319145,1.2000933234277091,13929800,0.8520679393089552,0.8293142074339293,371419600.0,-41.02567643298624,56.70552541611323,56.9646702468221,52.29989466590876,26.090760974792154,8.525720355613869,0.18367120820772947,2.033811641463097,122.18532064819337,121.21734104919435,120.43500137329102,119.6526616973877,118.68468209838868,0.06,0.0,105.91813662934236,0.019715124080330382,0.011280033293521731,117.65936606270927,118.37559400285993,2.2065085309893706
2024-04-24,0,120.50000190734863,114.21000289916992,121.87750053405762,118.5024995803833,120.81250143051147,-0.9533127115928828,2.2528794713083378,-0.06251400004023511,2.995552372627971,119.52624988555908,1.7484000396728505,0.018910029599832533,115.66099815368652,121.65800056457519,0.7967386281870031,0.05406702798015743,1.0114427477669414,1.0024312256050942,1.008731194680371,0.01762906381635343,65.79287588964353,123.64250906850168,119.13675012588502,114.63099118326835,119.55464281354632,0.8013964964100547,120.37857151031494,1.0767012547101606,119.85541888418959,119.32382083832115,-1.0683331142825279,0.8967823477625217,12101200,0.8406768181236557,0.7227093058707141,383520800.0,-40.72395274146268,56.70552541611323,56.9646702468221,49.02990588632153,25.073095425461535,7.962151819518439,0.2325298211057046,2.022102794753369,122.18532064819337,121.21734104919435,120.43500137329102,119.6526616973877,118.68468209838868,0.06,0.0,106.01213110931958,0.020399513483449372,0.019883659563810694,117.8519526890346,118.46907533918109,1.8411472158515796
2024-04-25,0,120.88000106811523,114.23000144958496,121.87750053405762,118.73499965667725,120.81250143051147,-1.1178437094750218,1.9636284151084333,0.6814634783577089,2.99559630690536,119.84249973297119,1.502375030517578,0.016438743117834737,116.4364990234375,121.65800056457519,0.7159563970585212,0.05488926182436333,1.0119609547067003,1.0065595506676386,1.008387948861707,0.017487016695772573,66.37315402538879,123.37850690651081,119.45125007629395,115.52399324607708,119.80928584507534,0.9080300438930081,120.38535717555455,1.079754748468542,120.01549555157598,119.62449385069205,0.01867809288470891,0.9868228340909205,16041000,0.8391289450886015,0.9477426932648291,399561800.0,-36.50074165110322,56.70552541611323,56.9646702468221,55.809224558882114,24.752701699330743,7.305798204689939,0.22748195170381363,2.04625408039837,122.18532064819337,121.21734104919435,120.43500137329102,119.6526616973877,118.68468209838868,0.02,1.0,106.13710482796849,0.02370907986185422,0.022759811536925773,118.22306823730469,118.46626390729634,1.5319239069564812
2024-04-26,0,118.06999969482422,115.81999778747559,121.87750053405762,119.02374982833862,120.88375091552734,-0.9489542022082719,1.576158280135951,0.41318925615907975,2.995645333283772,120.16999912261963,1.2516252040863036,0.013158364798088417,118.22175025939941,121.65800056457519,0.6983312948003083,0.04368851128735578,0.9856929645166596,0.9839781633843432,0.981544596766584,-0.013864527301084006,66.32317613942506,122.93606661749236,119.78375005722046,116.63143349694856,119.76035717555455,1.0003715927828916,120.18357140677315,1.2306162670242327,120.23578369001012,119.97283215792696,1.496673920936097,0.07865158088698523,27289500,0.7852744076508592,1.5714462580294082,372272300.0,-76.89245490246938,56.70552541611323,56.9646702468221,-125.13755306035634,20.761839158157702,16.16134080514828,0.20094762269615252,2.26522552775407,121.97292028808593,120.8735404663086,119.98500061035156,119.09646075439453,117.9970809326172,0.02,1.0,106.30151333260125,-0.01601595567821168,-0.004724912082107778,118.1288833618164,118.28422001429966,1.358388736434843
2024-04-29,0,118.8025016784668,116.5049991607666,121.87750053405762,119.02374982833862,120.88375091552734,-0.5938555086101241,1.3538460270720298,-0.11932425702518401,2.995668374587241,120.16999912261963,1.1278750991821282,0.011291812924499605,118.37825031280518,121.65800056457519,0.5181584574439806,0.013432904556293371,0.9908775422690107,0.9930745520099531,0.9903674744254247,-0.009607754957878134,42.99531187485308,122.60394220673196,119.8962501525879,117.18855809844383,119.76035744803292,1.0003712884015423,120.02357155936105,1.2557134010589777,119.69838279929486,119.85858130470639,-0.28924369094658986,-2.3367391143080445,17309900,1.0352217108728297,0.9868535637107163,389582200.0,-54.58169026071662,56.70552541611323,56.9646702468221,-58.533343057817405,22.25791856069669,14.994589913447092,0.20182245106664634,2.266996192531207,121.97292028808593,120.8735404663086,119.98500061035156,119.09646075439453,117.9970809326172,0.02,0.0,106.415770037308,-0.007631031562613799,-0.002001962122079849,118.2863268171038,118.17597797938755,1.17094791901676
2024-04-30,0,118.88999938964844,118.06999969482422,121.87750053405762,119.02375030517578,120.88375091552734,-0.026887299216672853,1.1421418004027737,-1.2070657571814227,2.9956869821443814,120.16999912261963,1.0071249961853028,0.009516966012547225,118.52049942016602,121.65800056457519,0.6059026179822766,0.0022778762506181697,0.9906581503487863,0.9951993636303215,0.9930049392105121,-0.012418481976398832,44.7065248025788,122.29540887927845,120.0111252784729,117.72684167766735,119.64035742623466,1.0535857660610126,119.8260714667184,1.195373991913755,119.47900488663024,119.82420330878301,1.6054785349526725e-06,-1.8505879110567367,21083300,0.9434781080629018,1.1980046230740033,410665500.0,-72.77562078762114,56.70552541611323,56.9646702468221,-81.76588870010771,21.171455960807112,13.943649802786155,0.11626625812743684,2.263637112483322,121.97292028808593,120.8735404663086,119.98500061035156,119.09646075439453,117.9970809326172,0.02,0.0,106.54864652455193,-0.022804257869316613,-0.01899471469759624,118.06000191824776,117.89974866594586,1.2282836163233466
2024-05-01,0,117.11000061035156,118.06999969482422,121.87750053405762,119.04562473297119,120.88375091552734,-0.01157720618872256,1.1214712667560496,-1.1731223028820073,2.995688621856963,120.16999912261963,0.9892499923706055,0.009343335894813268,118.76349983215331,121.65800056457519,0.6398346765024355,-0.003562025252998045,0.9756808799117626,0.9804697266747707,0.9805867098488706,-0.02813279040114547,43.90989397652723,122.27194281579969,120.0290002822876,117.7860577487755,119.2339289528983,1.402834914591352,119.48553575788226,1.2440975246108235,119.33326804269149,119.75181990429549,-0.7015786818670867,-2.2728217347341597,27777700,0.9262983140432225,1.5294111169534779,382887800.0,-95.42651069624623,56.70552541611323,56.9646702468221,-188.42855627540823,19.325144248861427,19.92772046595958,0.05097978485555099,2.302681761999998,121.84076086425782,120.65962139892578,119.70500183105469,118.7503822631836,117.56924279785156,0.04,0.0,106.69024004294178,-0.041470440637082606,-0.04131201772179712,117.42320033482143,117.49489430018834,1.512728673433987
2024-05-02,0,116.41500091552734,117.11000061035156,121.87750053405762,118.86812496185303,120.88375091552734,-0.3295221503747912,1.2829968931649853,-0.7562360072158105,2.995674970762553,120.16999912261963,1.1031250572204585,0.01069888479595005,118.37825031280518,121.65800056457519,0.5789244777258313,-0.018542182859781722,0.9707823066064757,0.9757150401628033,0.9803327180672862,-0.03693745957258787,34.67626843904776,122.48474397706484,119.91875019073487,117.3527564044049,118.66678646632603,1.6420269574277928,119.10910728999546,1.3222326280430325,118.77963812347053,119.42253059191178,-2.3717221584460613,-3.911714551755037,25513600,1.0058447406756625,1.3780215245648584,357374200.0,-90.49189595504436,56.70552541611323,56.9646702468221,-168.2154140417688,18.484930164301712,19.061307714103688,-0.021443598026433756,2.2353171092045283,120.3204024963379,119.42980271911622,118.71000289916992,117.99020307922363,117.09960330200195,0.04,0.0,106.81366484639975,-0.04195171159233524,-0.03973563888710105,116.74984959193638,117.2046078273228,1.716536952716
2024-05-03,0,115.54999923706055,116.41500091552734,121.87750053405762,118.80250120162964,120.88375091552734,-0.5632369025301777,1.4902967474813489,-0.5181250357072642,2.995654678093646,120.16999912261963,1.2630375194549557,0.012442637979274775,117.97399978637695,121.65800056457519,0.6608872052430733,-0.03617999565961139,0.9647386075572271,0.9704069867700971,0.9804212611692875,-0.021343274873186435,28.892632923802353,122.75396872002983,119.77337522506714,116.79278173010445,117.95964322771344,1.7809565797354079,118.75714302062988,1.563731704705973,118.19572479102371,119.04555436745619,-3.2977509335527797,-4.330853082585602,28023300,0.9408675278671622,1.4882167506101927,329350900.0,-75.49146068314525,56.70552541611323,56.9646702468221,-183.09721903603338,17.233064070992125,23.451498915909067,0.02613386467639121,2.2263621924524903,119.95932098388673,118.8453402709961,117.94499969482422,117.04465911865233,115.93067840576171,0.06,0.0,106.93109963803475,-0.016615798601240517,-0.04392974844347989,116.03994968959263,116.94595118931362,1.8587942885526867
2024-05-06,0,117.03999900817871,115.54999923706055,121.87750053405762,118.70499992370605,120.88375091552734,-0.6400351454860134,1.7300714124501348,-0.3888961737902319,2.9956271604249234,119.84249973297119,1.4454624366760256,0.0144761767820859,117.04050064086914,121.65800056457519,0.6979029370229682,-0.04421192936403085,0.9793189483537503,0.9863828658725815,0.9973285725857863,-0.014835568657116438,25.71211216985519,122.9717679240824,119.51162509918213,116.05148227428185,117.41107150486538,1.2410732628243253,118.61017867497036,1.6247769196312305,117.5410684608095,118.55402483875169,-4.107885968411932,-4.089975150284002,31401300,0.9474896857790185,1.6083032130416723,360752200.0,-65.66184705223577,56.70552541611323,56.9646702468221,-92.42096178747332,23.20270400660138,21.696611516269034,-0.0012779579692979535,2.234482064677513,119.95932098388673,118.8453402709961,117.94499969482422,117.04465911865233,115.93067840576171,0.06,0.0,107.08554768979462,-0.0241557884234318,-0.010257723132903187,115.39611925397601,116.80959374564034,1.93385485625929
2024-05-07,0,116.73999977111816,115.54999923706055,121.87750053405762,118.32687520980835,120.59500169754028,-0.4196736478896615,1.7792568418545875,-0.750360692804267,2.9956208516786984,119.41374969482422,1.499874973297119,0.014911780231387532,116.97749919891358,121.65800056457519,0.7715937231783189,-0.03306690252757869,0.9783866948543759,0.9862775254396945,0.9977692493106077,-0.01808394002496283,37.31453008444797,122.87738871041205,119.31887502670288,115.76036134299372,117.2210715157645,1.2250869359279541,118.49071434565953,1.7001671583511948,117.42251464300818,118.39746600331922,-3.176705845471248,-1.7275768524691715,30122000,1.0238167974315953,1.482104359887334,330630200.0,-73.26343892488573,56.70552541611323,56.9646702468221,-106.58254456971518,21.95512402967669,22.06160897315066,-0.0635975689489435,2.1927184220543436,119.95932098388673,118.8453402709961,117.94499969482422,117.04465911865233,115.93067840576171,0.06,0.0,107.22077334993591,-0.01775592350868871,-0.02900366583182537,115.14449092320034,116.63668714250836,1.9974697095022207
2024-05-08,0,116.05500030517578,115.54999923706055,121.87750053405762,117.82999992370605,120.48312473297119,-0.2224368911555327,1.8175428342273372,-0.9613553748394872,2.9956156962366474,118.99374961853027,1.5211250114440915,0.015260164634994348,116.70749988555909,121.65800056457519,0.753516070066937,-0.04040114165292081,0.9744025714388109,0.9835190327311594,0.9955735165377604,-0.009008626929189245,34.97366068314356,122.73883570660165,119.10375003814697,115.46866436969229,116.82857131958008,1.063440476638068,118.2944643838065,1.8160329722622366,117.25499982525255,118.18670107709725,-1.1264503490672553,-1.4124358534475223,18957200,1.0053117565679848,0.929219622076245,311673000.0,-73.52551795856323,56.70552541611323,56.9646702468221,-111.19183823867873,20.829415284792923,22.661738528170904,-0.09459174070851199,2.146079609655007,119.95932098388673,118.8453402709961,117.94499969482422,117.04465911865233,115.93067840576171,0.06,0.0,107.30044380608318,0.001034261464612829,-0.017924991954662406,114.65388706752232,116.47010694231305,1.9527051756567586
2024-05-09,0,117.34000015258789,115.54999923706055,121.87750053405762,117.09250020980835,120.40812349319458,-0.11905932074285994,1.834219642439633,-1.053059388486513,2.995613048980202,118.84625053405762,1.5239998817443847,0.015436473282026578,116.37900085449219,120.96050090789795,0.71848373565457,-0.04777338067623719,0.9875130193564213,0.9981689459641194,1.0084221408255492,0.007945704847193591,31.847949051306102,122.49218930395277,118.82375001907349,115.1553107341942,116.60714285714286,0.6395693472222516,118.12375014168876,1.7827359844996515,116.9517736225082,117.88283034200576,-2.3126628938563893,-2.3126613255071606,17564000,1.0028707305508164,0.8609124475960476,329237000.0,-43.51241900647969,56.70552541611323,56.9646702468221,-38.41691266692212,24.411419923165372,20.879928254062385,-0.06492520374219501,2.1627932000558707,119.95932098388673,118.8453402709961,117.94499969482422,117.04465911865233,115.93067840576171,0.06,0.0,107.38568368031376,0.018926448703549204,0.02077056020647275,114.67778669084821,116.368894304548,1.820422827000538
2024-05-10,0,118.18500137329102,115.54999923706055,121.68499946594238,117.09250020980835,120.06249952316284,-0.058581142161169796,1.7195044330731717,-1.0844977443342134,2.995627130106355,118.80250072479248,1.4639374923706057,0.01449873306588535,116.37900085449219,120.53800182342529,0.7156965488731758,-0.035706942781970306,0.9965271123146459,1.008393692868947,1.014071832191524,0.022803999598689284,41.317630875116244,122.03588386614632,118.596875,115.15786613385367,116.76071439470563,0.8685213254349132,117.99732167380196,1.7038963588004152,117.04264275761372,117.81960904023141,-1.3037254983748472,-1.9961575200752706,13648100,1.064105002005363,0.682164877962957,342885100.0,-49.80341572674186,56.70552541611323,56.9646702468221,-16.934863508948006,23.953557824009717,20.10732719562331,-0.04095331148189761,2.085428663423087,119.95932098388673,118.8453402709961,117.94499969482422,117.04465911865233,115.93067840576171,0.06,0.0,107.4531522606385,0.01689654824391762,0.01479701018245781,114.94909558977399,116.18614796229771,1.7756292280271653
2024-05-13,0,118.12250137329102,115.54999923706055,120.88000106811523,117.09250020980835,119.78624963760376,-0.12409890800860306,1.5677139047345998,-1.1106706556715542,2.9956445933517455,118.60750007629395,1.3301249504089356,0.013238381029451607,116.37900085449219,120.4797492980957,0.7350664662274149,-0.01902842982100805,0.9974719727935796,1.0077615372666837,1.0089731212426998,0.009248994995605386,47.97321390802049,121.55730290483662,118.42187509536743,115.28644728589823,117.00464303152901,0.9869492947743108,117.83571474892753,1.5613468404069324,117.31997252425533,117.88230176494444,0.9179410446048891,-1.4755521249975374,15060600,1.0634369376248995,0.7527065243711515,327824500.0,-50.45866330693545,56.70552541611323,56.9646702468221,-14.404132286335543,22.36891215899364,20.362088549730604,-0.017769859761781238,2.0736090364974213,119.95932098388673,118.8453402709961,117.94499969482422,117.04465911865233,115.93067840576171,0.02,1.0,107.52632110048465,0.009935760956272688,0.016465505665613223,115.18385532924107,115.96685246058873,1.7556920664950626
2024-05-14,0,117.17000007629395,115.54999923706055,120.88000106811523,117.09250020980835,119.25562477111816,-0.03644208601972841,1.4956816506779795,-0.9465805245874575,2.9956523381771754,118.29875087738037,1.2413749694824219,0.012642683828456623,116.37900085449219,120.39649868011475,0.7706188255852728,-0.008186557025716436,0.9904134776764445,1.0002155441248957,0.9989896663509417,0.003683401627709859,49.554382710719565,121.295488514979,118.30412521362305,115.3127619122671,117.23607172284808,0.7506500707210888,117.59785747528076,1.3656257014697655,117.5150472294738,117.9662734659156,1.466735768015552,-1.879384458019713,15079100,1.0211744468449035,0.7593295344448003,312745400.0,-53.604211663066756,56.70552541611323,56.9646702468221,-47.10378734802151,21.241784428757875,21.591211527119572,0.030887578814786053,2.027625557653266,119.95932098388673,118.8453402709961,117.94499969482422,117.04465911865233,115.93067840576171,0.02,0.0,107.59357030079546,0.021139433336726077,0.016066534680397277,115.55297088623047,115.79646028791156,1.755134476827642
2024-05-15,0,117.77750015258789,115.54999923706055,120.88000106811523,117.09250020980835,119.09999942779541,0.12788076823921127,1.5035342655339603,-0.9687142520022984,2.995651421139611,118.15375137329102,1.2487749958038337,0.012719422057109084,116.37900085449219,120.39649868011475,0.7631168926391998,-0.01049298259198164,0.9963602211220495,1.0068798063511222,1.0034334501463875,0.014842099374285045,44.996843407224496,121.21481875613505,118.20775022506714,115.20068169399924,117.34142902919224,0.7700489457531863,117.37625026702881,0.9929135292635267,117.42696334141614,117.89484640372041,1.4019912158630399,-2.7634869529836985,18244300,1.0316048294060585,0.9102250205488251,330989700.0,-26.688553519514375,56.70552541611323,56.9646702468221,-18.32152741594949,23.00640456676999,19.544274017179998,0.05469094360910966,2.0799496989437527,118.76747702026368,117.88125706481934,117.16499710083008,116.44873713684082,115.56251718139647,0.02,0.0,107.67814046396252,0.029213565198956015,0.02903641214483434,115.94561767578125,115.67086846487862,1.7737674422539214
2024-05-16,0,118.31250190734863,115.54999923706055,120.88000106811523,117.09250020980835,119.09999942779541,0.18934204548345032,1.505578576270306,-0.9661048772165328,2.9956511787933424,118.09625053405762,1.254600105285644,0.012740138213755067,116.37900085449219,120.39649868011475,0.7676263465659897,-0.008627761372908915,1.0011550711944799,1.0108766840960952,1.0050416778819404,0.008287896314096654,48.335299841104884,121.18715736616366,118.17600021362304,115.16484306108242,117.56607219151088,0.794341005983525,117.3935718536377,1.007948523490513,117.52376530295784,117.93424269641662,0.6301274356279202,-2.566595704924838,15745200,1.0377829548143849,0.7817907871011373,346734900.0,-38.38540887649286,56.70552541611323,56.9646702468221,3.4561213788674507,23.197747231175278,18.349614421334678,0.042744012161595235,2.0570914039324686,118.76747702026368,117.88125706481934,117.16499710083008,116.44873713684082,115.56251718139647,0.04,0.0,107.75286566638661,0.003270729024185126,0.023051121753215633,116.31917898995536,115.73183495657784,1.7760892870568896
2024-05-17,0,118.9325008392334,115.54999923706055,120.88000106811523,117.09250020980835,119.09999942779541,0.2372057058078477,1.4991574818544895,-0.9186525563331309,2.9956518516559023,118.09625053405762,1.2276502227783197,0.012688433729480173,116.37900085449219,120.39649868011475,0.7501446893964671,-0.011839118352185865,1.0066101616710807,1.0145292279756346,1.0086419269568923,0.006324825123802169,50.29029796740944,121.14981528414354,118.15150032043456,115.15318535672559,117.97714369637626,0.6037102411450264,117.40285750797817,1.0224215216161083,117.72663846701275,118.03913453698014,1.3470122831193552,0.20538850948692305,15104500,1.0218247408894263,0.7622062374806446,361839400.0,-9.225660407714049,56.70552541611323,56.9646702468221,54.44389020199406,23.46022961590138,17.09631590946322,0.07710473446956129,2.050154858175477,118.76747702026368,117.88125706481934,117.16499710083008,116.44873713684082,115.56251718139647,0.06,0.0,107.82967692250344,0.022480190374843945,0.018336349481755984,116.9463882446289,115.80013765607562,1.8136813871878845
2024-05-20,0,119.21000099182129,115.54999923706055,120.88000106811523,117.09250020980835,118.90062475204468,0.2800141957030965,1.4669008984262808,-0.7664643154114348,2.995655235128119,118.09625053405762,1.1848753929138183,0.012419614865524004,116.37900085449219,120.39649868011475,0.7170996098313838,-0.008524022217689864,1.0092994707587328,1.0139707018434723,1.009715153042194,0.009206540717365597,53.746380484481804,121.04542718213699,118.11162538528443,115.17782358843186,118.2442866734096,0.6832793420792721,117.42571476527623,1.061071926013121,118.03042251941369,118.13983699215312,2.479428311137825,0.10942459874998085,11551300,1.0316795143456121,0.5900340418989398,373390700.0,-21.1805688930094,56.70552541611323,56.9646702468221,54.85302442948954,22.551338618591753,16.27774869387929,0.03894402059133161,1.9994198764624092,118.53063888549805,117.68967857360839,117.0099983215332,116.330318069458,115.48935775756834,0.08,0.0,107.88717626035844,0.01462037832562424,0.014190300571275707,117.11421748570034,115.89600208827427,1.7698179275594443
2024-05-21,0,118.36999893188477,115.54999923706055,120.88000106811523,117.09250020980835,118.90062475204468,0.29670404186676863,1.4285764422981568,-0.611245634937994,2.995659164543933,118.09625053405762,1.14762544631958,0.012098954044774443,116.37900085449219,120.39649868011475,0.6717188718117855,-0.009760330158194993,1.0025037057540744,1.0049709277040586,1.0007566601242583,0.010241519627971707,54.77907247831563,120.9315283232865,118.07437543869018,115.21722255409387,118.27071489606585,0.6841812167748534,117.51571464538574,1.0853909143382026,118.3306900977038,118.22549039352921,1.593660164310266,0.2691577120158633,14495000,1.0284725491161786,0.7393293907533075,358895700.0,-35.416669426139855,56.70552541611323,56.9646702468221,24.850043710810553,21.18966515695906,18.078936016463558,-0.029180793113041118,1.9758857171995814,118.53063888549805,117.68967857360839,117.0099983215332,116.330318069458,115.48935775756834,0.08,0.0,107.95417055829314,0.001529666804008123,0.00760941167744385,117.23331560407367,116.09120559692383,1.6666017320166984
2024-05-22,0,116.34000015258789,115.54999923706055,120.88000106811523,117.09250020980835,118.8243761062622,0.33386885031247204,1.3296995345900853,-0.2065499568437632,2.995668829977047,118.09625053405762,1.056512899398804,0.011271159373983548,116.37900085449219,119.33900108337403,0.6125490879887324,-0.017676372960571465,0.9861526225872725,0.9863710511079486,0.9816023354474505,-0.012205217449322903,48.85226150637292,120.63302453838793,117.97362546920776,115.3142264000276,118.01607186453683,1.0050219137022791,117.51035744803292,1.0914100526612494,118.34378605686761,118.16920411569107,0.15653217958633298,1.0759100973156597,17879300,1.0418510046806442,0.898705220686511,341016400.0,-76.56240272856698,56.70552541611323,56.9646702468221,-116.09034716430197,19.046381884628108,26.120059969825935,-0.07858170776739934,2.0411899537092686,118.53063888549805,117.68967857360839,117.0099983215332,116.330318069458,115.48935775756834,0.02,1.0,108.01689848170749,-0.02614268275922771,-0.01861136005705597,117.02357591901507,116.10371562412807,1.5864407650286247
2024-05-23,0,114.9950008392334,115.54999923706055,120.88000106811523,116.96499919891357,118.47812461853027,0.3823730482159576,1.2406226276291514,0.06384264204494228,2.995676855248811,117.92374992370605,1.0130628204345697,0.010534675323215002,116.31150016784667,118.96025085449219,0.40599078783875014,-0.03755791591174025,0.976473401866957,0.974732151108508,0.9726134014202464,-0.02804015648923719,37.73210284507599,120.24687063672803,117.76562538146973,115.28438012621143,117.7053576878139,1.5163357067770165,117.47071470533099,1.1749729828340751,117.84455137645281,117.86213069888178,-1.509027661943985,-0.06442534239541425,15979800,1.1181299207156126,0.8033501831188777,325036600.0,-97.70288585115063,56.70552541611323,56.9646702468221,-169.76018299068622,16.470133212097764,27.801920028689786,-0.14148556801861842,2.1918416359017154,118.34891967773437,117.39553985595703,116.625,115.85446014404297,114.90108032226563,0.04,0.0,108.0639839680329,-0.036989915678965035,-0.042755964031775825,116.43403625488281,115.99350357055664,1.5891908189224868
2024-05-24,0,114.09499931335449,114.9950008392334,119.21000099182129,116.65875005722046,118.32687616348267,-0.39796248735135614,1.1625027555985799,-0.7795818865162345,2.995683241572924,117.55875015258789,0.9958752632141114,0.009896051288552527,116.00450019836425,118.89424953460693,0.533033182536126,-0.02604386265383905,0.9712578826455737,0.9690296001847607,0.9704472586238262,-0.0406743446218959,35.07419797386229,119.7963808812228,117.47137537002564,115.14636985882848,117.17928613935199,2.0366585375715744,117.26035758427211,1.4816242743276864,117.12459323652696,117.37579016938396,-1.856276551714876,-0.48031017004900406,12211400,0.9801758353081197,0.6380860240955671,312825200.0,-94.45259360489509,56.70552541611323,56.9646702468221,-187.50028204686024,15.36959646665043,26.992349327118315,-0.18193152603512608,2.180994380258112,118.27339974975585,117.27329997253418,116.46500015258789,115.6567003326416,114.65660055541993,0.06,0.0,108.09452679750811,-0.051989259853924774,-0.037753451325320396,115.70278058733258,115.82419913155692,1.7525319217505382
2024-05-28,0,114.13999938964844,114.09499931335449,119.21000099182129,116.39625072479248,118.32687616348267,-0.5663158692804058,1.3652799333410204,-0.42187800267735565,2.995664353347245,117.25500011444092,1.1216253280639648,0.011641932030218129,115.49449939727783,118.89424953460693,0.578014137990644,-0.03962460637279282,0.9732876623855826,0.9727909909389134,0.9788854337390321,-0.042530002180946935,30.47333433100587,120.0031852176342,117.27262535095215,114.54206548427011,116.58321435110909,2.2492162681288397,117.07464327131,1.6988852023086003,116.36666658291777,116.89279289443564,-3.126659026097935,-2.5162335268119946,13978300,0.9695063896087975,0.7368259864482382,326803500.0,-73.43065547094537,56.70552541611323,56.9646702468221,-139.03090290620082,14.436558799199771,25.180366154362765,-0.18500310876064607,2.1709221338569145,118.27339974975585,117.27329997253418,116.46500015258789,115.6567003326416,114.65660055541993,0.06,0.0,108.13210012391396,-0.03210584203370437,-0.03995316855072632,115.27621459960938,115.79769679478237,1.7217628174010158
2024-05-29,0,113.8799991607666,114.09499931335449,119.21000099182129,116.26875019073486,118.21687650680542,-0.5014582274705355,1.4775937091087605,-0.6345695540692984,2.995652408254431,117.14000034332275,1.1986001968383788,0.012624743835396314,114.9095006942749,118.89424953460693,0.646735267125492,-0.039952897841578884,0.9730048311094975,0.9738806116098794,0.9852233746700892,-0.037931906831408346,30.66098890009882,119.99468765472875,117.03950023651123,114.08431281829371,115.86142839704242,2.179267596483253,116.91928604670933,1.8882005917609856,115.807600719216,116.44273852435569,-3.526679303061068,-2.227171823340173,13902000,0.9687790890851121,0.7469414729286102,312901500.0,-88.4180864017935,56.70552541611323,56.9646702468221,-152.2679028474742,13.458806486578675,24.333951371964112,-0.14887679310285787,2.1622840335376474,118.21911895751954,117.18543869018555,116.3499984741211,115.51455825805665,114.48087799072266,0.08,0.0,108.16496316760664,-0.03580821260565803,-0.04247072068087217,114.42450060163226,115.68544442313058,1.8121674456401446
2024-05-30,0,113.58749771118164,113.8799991607666,119.21000099182129,115.92875003814697,118.13812637329102,-0.4321900603541478,1.56474851335855,-0.817022253083866,2.9956423401194474,117.07499980926514,1.2891002941131589,0.013398081243465412,114.13549938201905,118.42624912261962,0.750002252976064,-0.02758091907395529,0.9725872941140364,0.9741199263985013,0.9903871125456732,-0.023659123584288788,31.338168789305257,119.91849725178423,116.78900022506714,113.65950319835005,115.05821364266532,1.7290164975375673,116.65125015803746,2.0804386926188463,115.31740225770736,116.00862149236755,-4.248209398452404,-1.8741123938562256,14692000,0.8994071005356297,0.8181487352301516,298209500.0,-83.3333333333337,56.70552541611323,56.9646702468221,-128.8257012814195,12.920939821211185,23.36147128669764,-0.06620856315195484,2.091398676343847,118.21911895751954,117.18543869018555,116.3499984741211,115.51455825805665,114.48087799072266,0.08,0.0,108.19945911408058,-0.012902698172911342,-0.03275348635178407,113.76126861572266,115.43774305071149,1.8634843389424613
2024-05-31,0,115.71500015258789,113.58749771118164,119.21000099182129,115.41124963760376,118.13812637329102,-0.3493367754220273,1.7101890826233983,-1.0638030712173878,2.995624543579469,116.88999938964844,1.4458378696441656,0.014665525410024948,114.0734992980957,118.42624912261962,0.7887558522928599,-0.024288134536865968,0.9923003791227689,0.9959440142751176,1.013803292284005,0.006261135771989501,30.826201300824508,120.03325324535544,116.61287508010864,113.19249691486183,114.67892810276577,1.0322654991837013,116.47482149941581,2.044792998343003,114.87920316030164,115.670590282208,-4.71646945211031,-3.1979737826201884,29037400,0.8914974077948837,1.6012855547966904,327246900.0,-37.146844254787105,56.70552541611323,56.9646702468221,-14.646390797875162,22.397066406655174,20.696826162031687,0.03915094566128858,2.192023332121707,118.21911895751954,117.18543869018555,116.3499984741211,115.51455825805665,114.48087799072266,0.08,0.0,108.2974915815186,0.03303677397878846,0.015413935204397058,113.67765699114118,115.45548629760742,1.8672994874625801
2024-06-03,0,115.21750068664551,113.58749771118164,119.21000099182129,115.41124963760376,118.13812637329102,-0.2887941138654368,1.7210092840182631,-1.134317179913732,2.9956231419713144,116.88999938964844,1.4843379116058344,0.014762743645814385,114.0734992980957,118.42624912261962,0.8218991553009098,0.0014279611996260639,0.9883307672675754,0.9938840639273653,1.0081726718915782,0.009838304746452087,48.13720898107048,120.0198936099982,116.57787504196168,113.13585647392514,114.51857103620257,0.7899716995626149,116.26732145036969,2.01185980077061,115.08585940220314,115.74066977549987,-2.2429659569606626,-2.0899447408741394,19589300,1.007810768480708,1.105983732594178,307657600.0,-76.8361728035862,56.70552541611323,56.9646702468221,-73.46390660517068,19.946881408779177,19.15152841044331,-0.05926419660364529,2.2854590968477746,118.21911895751954,117.18543869018555,116.3499984741211,115.51455825805665,114.48087799072266,0.08,0.0,108.35095793536571,0.009081226681997068,0.008281162903658797,113.5316881452288,115.27763203212194,1.8925173851716464
2024-06-04,0,112.41999816894531,113.58749771118164,119.21000099182129,115.16187572479248,118.13812637329102,-0.2680983251149148,1.7324263485865772,-1.1810436562610074,2.995621668030126,116.88999938964844,1.5026253318786615,0.014862798287472593,114.0734992980957,118.42624912261962,0.8387226876625549,-0.015571585244168087,0.9644714522070612,0.9728700482777001,0.9817654551490401,-0.015069224022259076,43.02187416605135,120.02610281161408,116.56125011444092,113.09639741726777,114.1507135118757,1.0781249410592382,115.92803559984479,2.2359647280553374,115.12328572809233,115.79623375506368,-0.9648439612086538,-2.459311860883404,19412200,0.9501244204160055,1.1343772004920336,288245400.0,-80.49052662377646,56.70552541611323,56.9646702468221,-157.7434548566224,17.82845822473898,25.661984812179746,0.032066646828758344,2.3743626164158207,117.7730791015625,116.46345892333984,115.40499877929688,114.34653863525392,113.03691845703126,0.1,0.0,108.38201383005959,-0.01906667917445637,-0.006612597683790375,113.4126467023577,114.92334147862026,2.0501799360247226
2024-06-05,0,112.67000198364258,112.41999816894531,119.21000099182129,114.78125047683716,118.13812637329102,-0.31245561509264025,1.947813746879184,-1.0730423578856592,2.995591838478939,116.53999996185303,1.6867254924774173,0.01674382841664661,113.8507490158081,118.42624912261962,0.7329927253522338,-0.037005324744241036,0.9685357154604571,0.980796707079027,0.986913587442927,-0.01062519481946822,31.863259355045162,120.22587756623761,116.33025007247925,112.43462257872088,113.94714246477399,1.2161027019816777,115.56321430206299,2.32585695122724,114.44675112511057,115.44765876611436,-2.239230098261419,-4.053940346723326,14863500,1.1257885225909847,0.9090978594441191,303108900.0,-75.47375386572945,56.70552541611323,56.9646702468221,-123.36425007877445,17.199550511270633,24.314837489387774,0.14061654999737366,2.326904198180926,117.7730791015625,116.46345892333984,115.40499877929688,114.34653863525392,113.03691845703126,0.1,0.0,108.40771454530447,-0.0044881941245484835,-0.015148821606175634,113.37013244628906,114.53645651681083,2.146343619711384
2024-06-06,0,113.21750068664551,112.41999816894531,119.21000099182129,114.12874937057495,118.13812637329102,-0.22225884802386553,2.1009622201199325,-1.258345020593662,2.9955683787698058,116.19750022888184,1.8492504119873048,0.018091974646730343,113.49574813842773,118.42624912261962,0.7926483244622083,-0.02916719066504746,0.974947637027018,0.9904773233991326,0.9938159525327925,-0.0032573745525843467,34.13814629845843,120.32867462334534,116.12675018310547,111.92482574286561,113.81535693577358,1.2414404296316304,115.19928564344134,2.260267348337517,114.00213323797384,115.17490896646109,-1.248956867774942,-4.336565271234522,13154100,1.1251442533309715,0.8190817064217785,316263000.0,-65.9977409510461,56.70552541611323,56.9646702468221,-85.15456698609333,18.809528329191668,22.85642828303196,0.18343992000875914,2.298551767571142,117.7730791015625,116.46345892333984,115.40499877929688,114.34653863525392,113.03691845703126,0.1,0.0,108.43436834860108,-0.00017542000102421795,0.00299219709935078,113.24400547572544,114.26011003766742,2.1863167620202058
2024-06-07,0,113.52750015258789,112.41999816894531,119.21000099182129,114.04124927520752,118.13812637329102,-0.11722672750618442,2.1947307282538917,-1.4384818369874957,2.995553092799375,116.02750015258789,1.9911253929138184,0.018922559725379266,113.16275081634521,118.42624912261962,0.829767329604292,-0.03513294239459282,0.9788129698350109,0.995909866484282,0.9971848413484607,-0.018904204270107083,35.77780388663133,120.37433665868673,115.98487520217896,111.59541374567118,113.76499993460519,1.2455238629689807,114.8132141658238,2.022674633426823,113.8076253828767,115.02858671616502,-0.8082168459224582,-4.306392932754526,13289200,1.0860397041648335,0.8386559744740414,329552200.0,-79.59864457062773,56.70552541611323,56.9646702468221,-74.51928733150564,20.181569698009238,21.269021068162612,0.09583169318190643,2.293655107321604,117.7730791015625,116.46345892333984,115.40499877929688,114.34653863525392,113.03691845703126,0.1,0.0,108.46136647222671,-0.038461563687588796,-0.010878131609665399,113.11929539271763,113.77189799717495,2.2600725555499652
2024-06-10,0,113.26499938964844,112.41999816894531,119.21000099182129,113.80687379837036,118.13812637329102,0.0677433974327062,2.233969897754545,-1.499517876824989,2.9955462354883546,115.4662504196167,2.027175397872925,0.019292580537064587,113.16275081634521,118.42624912261962,0.8319820695135643,-0.03940856425590132,0.9781573713019912,0.9948878727390426,0.9987170416706193,-0.016946221584056453,36.53165274330582,120.26218999768804,115.79425020217896,111.32631040666988,113.71892874581474,1.2590746459160527,114.38857119424003,1.610697321484721,113.73661833247434,114.90310816384726,-0.3095354854025607,-4.544595168272547,15245200,1.0648698462923936,0.9572712256961003,314307000.0,-74.67756188486354,56.70552541611323,56.9646702468221,-70.96211424547708,19.202611268875543,20.23731304120206,0.08411599902425936,2.2383907156696172,117.43691723632814,116.1915374145508,115.18499755859376,114.17845770263673,112.93307788085939,0.1,0.0,108.49132596368126,-0.011970259213828549,-0.03564732532577098,112.9903335571289,113.37580108642578,2.3068618384041666
2024-06-11,0,112.15999794006348,112.41999816894531,119.21000099182129,113.5724983215332,117.86375045776367,0.26594702915238366,2.228043173011121,-1.422579882325134,2.995546668525531,115.10625076293945,2.001575365066529,0.019282361879345632,113.16275081634521,118.42624912261962,0.8257932932960056,-0.0411225797555022,0.9706767332269147,0.9859006204799734,0.9923907084086895,-0.0023127578110355707,35.458907794209956,120.00433644901906,115.54825010299683,111.0921637569746,113.21107128688267,1.0125992617980748,113.94499969482422,1.2430325407747391,113.61859481420231,114.66282999844663,-0.28392061453208345,-4.986999037589744,12462400,1.0640006453133617,0.7889704683689152,301844600.0,-81.0318778834521,56.70552541611323,56.9646702468221,-103.57803105068916,18.101483616868858,23.58001596443609,0.10369205640976678,2.204932507350419,115.9547611999512,114.99262062072755,114.2150001525879,113.43737968444826,112.47523910522463,0.1,0.0,108.50912551091258,-0.00443776622126324,-0.019921335263082544,112.26899719238281,112.973327091762,2.389976772765616
2024-06-12,0,112.01750183105469,112.15999794006348,119.21000099182129,113.46187496185303,117.32187509536743,0.41003390747446145,2.2622935085160596,-1.2365642888810586,2.995540111682644,114.56750011444092,1.982650375366211,0.01962942348100625,112.64500160217285,118.42624912261962,0.8226822812663248,-0.0427584034562453,0.97195123994697,0.986364776626576,0.9915861288222673,-0.005791250031952799,31.90049253579673,119.7747119483676,115.25012493133545,110.7255379143033,112.75392859322685,0.5899345448262935,113.6362498147147,1.134471705248583,113.2593630989133,114.31222942669778,-3.072205165999742,-5.246262606959043,13606800,1.0697864959336054,0.8654536017951732,288237800.0,-94.40460084153193,56.70552541611323,56.9646702468221,-109.73369116723644,16.51152990468527,23.959324246744043,0.03050749517842628,2.2445825760138565,115.86508184814454,114.84746166992188,114.0250015258789,113.20254138183594,112.18492120361329,0.12000000000000001,0.0,108.52585891384044,-0.019360027739156793,-0.01544334180799946,111.77015686035156,112.65092250279018,2.499010665866257
2024-06-13,0,110.36499977111816,112.01750183105469,119.21000099182129,113.2531247138977,116.69937515258789,0.5504236800353681,2.3215938275391514,-1.075100256043909,2.995529202476514,114.11749935150146,1.993750448226929,0.02018908908975868,112.39399814605713,118.42624912261962,0.8176018456445544,-0.04890576140664198,0.9597582429533424,0.9734101539064002,0.9780879563187607,-0.025194876218141093,30.08149891268268,119.6356876741518,114.99250001907349,110.34931236399518,112.46035739353725,1.086302570412344,113.30553545270648,1.3602885243123506,112.95945915870945,114.07986761623137,-2.777354860607319,-3.715401681162068,14466900,1.050577263734857,0.9313480917436036,273770900.0,-95.88159802990684,56.70552541611323,56.9646702468221,-143.09083969470132,15.854066925254948,25.7037410875628,-0.037208133194786705,2.170679881744577,115.65627865600585,114.52185914611816,113.60499954223633,112.68813993835448,111.55372042846679,0.14,0.0,108.53550935376774,-0.03448275862068961,-0.027227750034843918,111.39744349888393,112.40504510062081,2.5639224346040903
2024-06-14,1,109.48249816894531,110.36499977111816,119.21000099182129,113.08062601089478,115.87125015258789,0.5188818920104247,2.436249501870084,-0.6708750412781024,2.9955071843375065,113.98749923706055,2.011750450134278,0.021254664538248775,112.1457483291626,118.42624912261962,0.7603201779016726,-0.06717381517681212,0.9551623385060253,0.9683789053805706,0.9751975054780953,-0.03563015109295853,23.547497124553363,119.49437400374016,114.621875,109.74937599625984,112.00499970572335,1.552018040449009,112.97607108524868,1.676252904906666,112.31978935041789,113.61403797131207,-1.8279651586000625,-4.026262910844377,13313400,1.0720591699038975,0.8638501917374463,260457500.0,-94.1572563673287,56.70552541611323,56.9646702468221,-160.64838335534392,14.9932793057952,28.095385385313502,-0.021039341064489653,2.1313438862179486,115.3895975036621,114.09019728088379,113.03999710083008,111.98979692077636,110.69039669799804,0.16,0.0,108.53954501398826,-0.03228383516344113,-0.04264283937123582,110.82916041782924,112.09964643205915,2.694891870267148
2024-06-17,1,108.79249954223633,109.48249816894531,119.21000099182129,112.60750102996826,115.3418755531311,0.4181519633796378,2.5258686787773605,-0.24705262112221016,2.9954882878214297,113.73374843597412,1.9517378902435312,0.02212174099894452,111.85225162506103,118.42624912261962,0.7248891753028389,-0.0794568566506652,0.9528125977895607,0.9676099556883492,0.9760851630946515,-0.03948704252428448,19.988024066572223,119.23211217063457,114.18037481307984,109.12863745552511,111.37285668509347,1.8486628081410856,112.59410681043353,1.9735305589443615,111.61435680463757,113.04148390564303,-2.8290616478022494,-4.0426847558333785,21147900,1.04769270198536,1.3458110573652449,239309600.0,-98.06659127413381,56.70552541611323,56.9646702468221,-172.2860312623051,14.331190738027571,28.26917698399817,-0.10729431723147434,2.0705307731325373,115.29283843994139,113.93357879638671,112.83499908447266,111.73641937255859,110.3771597290039,0.18,0.0,108.54059755885534,-0.04174036920277746,-0.03893572727508366,110.0341317313058,111.63906860351562,2.639694920949817
2024-06-18,1,109.48250007629395,108.79249954223633,119.21000099182129,112.35499811172485,115.05062580108643,0.2130462713012652,2.538757259951565,0.0272317135454192,2.995483207637184,113.55749893188477,1.8902126884460444,0.022333789821711057,110.27674961090088,116.54300003051758,0.6880204049918955,-0.08738781446952325,0.9631323106117136,0.9793432906088296,0.9902228187443377,-0.02387212832511232,17.868165256501598,118.75088926813312,113.67337474822997,108.59586022832683,110.7949995313372,1.688137656048275,112.27999973297119,2.0990838481047565,110.90780007880562,112.40581029531681,-3.908407373040631,-4.685035812166899,17762900,1.0321913016730406,1.1084873427793154,257072500.0,-87.1106631264957,56.70552541611323,56.9646702468221,-124.57295397129485,17.479830887874183,25.990313936906244,-0.09756632847319714,2.09120805779068,115.29283843994139,113.93357879638671,112.83499908447266,111.73641937255859,110.3771597290039,0.18,0.0,108.5481445391162,-0.02487294243885385,-0.03272018536312521,109.55654798235211,111.33792168753487,2.4912928875186893
2024-06-20,0,110.96500015258789,108.79249954223633,118.36999893188477,112.12437391281128,114.35374975204468,-0.035215717158448484,2.356732432317119,-0.23297649375434437,2.9955154081945423,113.39624977111816,1.810600013732909,0.02082158232405228,109.48249988555908,115.77750015258789,0.7015222358918834,-0.07508235985289713,0.9803687741904377,0.9952196469725505,1.008516016611206,-0.009395868156872322,24.644505291242442,117.90046456708787,113.18699970245362,108.47353483781937,110.46642821175712,1.3083793793228096,112.09267847878593,2.0904252864958486,110.54589848611045,111.92356666864211,-3.5630134292195446,-3.861520123709012,17433200,1.0654383640590461,1.0780293061313335,274505700.0,-61.76156291998567,56.70552541611323,56.9646702468221,-55.75714195026179,21.86330802788786,23.22252587728401,-0.033027929413079596,2.1732682151087164,115.29283843994139,113.93357879638671,112.83499908447266,111.73641937255859,110.3771597290039,0.02,1.0,108.56678407452453,0.0073018742632779965,-0.003833478746034132,109.36664799281529,111.1784907749721,2.2304059043889017
2024-06-21,0,111.53000068664551,108.79249954223633,116.34000015258789,111.75437641143799,114.10624933242798,-0.34750515526705145,2.078651675870171,-0.7341673500264254,2.995562148549398,113.24125003814697,1.6995750236511227,0.018425027136731886,109.48249988555908,115.26725063323974,0.7706182260510276,-0.046200790725032824,0.9885943436631455,1.0018189658075827,1.0155940642570407,0.010555891070025858,38.03788837220772,116.97405311522911,112.81674976348877,108.65944641174843,110.37642860412598,1.1886580725416835,111.79374994550433,1.8134707195068098,110.63776225339025,111.73370835887201,-2.030635456190846,-2.3087906780568064,52220600,1.0829204048476022,2.919239675935696,326726300.0,-68.45963649387346,56.70552541611323,56.9646702468221,-45.73982506916486,20.72340375074877,21.730325828998286,-0.1466347111127968,2.1566052262436255,114.42952053833008,113.23524049377441,112.27000045776367,111.30476042175293,110.11048037719726,0.04,0.0,108.62292517924749,0.006543065642006907,-0.00153247843444279,109.16682870047433,110.71791294642857,2.170185520086574
2024-06-24,0,112.96500015258789,108.79249954223633,115.71500015258789,111.3887505531311,113.93374919891357,-0.37732787005356727,1.9300450892571008,-0.7783404257580373,2.9955849763943485,112.94375133514404,1.5971251773834225,0.017144336330745833,109.48249988555908,115.0172508239746,0.8036457089125151,-0.03013174596547957,1.0034532182686913,1.0162492865850767,1.026483300253247,0.03180875520641324,43.42014003442288,116.43633996870585,112.57624979019165,108.71615961167745,110.51178550720215,1.4350829806090644,111.6328570502145,1.5699126686679492,110.85381346376954,111.6846180596936,-0.5616951364020435,-3.616643875404072,16266700,1.068212242067545,0.9086135832611378,342993000.0,-12.648784519598216,56.70552541611323,56.9646702468221,40.085141107398336,24.020794559600976,19.15451569109238,-0.07477441356674562,2.271851342480367,113.31408123779296,112.33296105957031,111.54000091552734,110.74704077148438,109.76592059326171,0.06,0.0,108.65220306222592,0.04527545124257015,0.03644129300784206,109.6089837210519,110.68957029070171,2.186958707066955
2024-06-25,0,114.12250137329102,108.79249954223633,115.71500015258789,111.3887505531311,113.66062307357788,-0.37342850495628327,1.8519747028367126,-0.6246379045700121,2.995596421542794,112.81750106811523,1.5057751464843747,0.01646569302760537,109.48249988555908,114.24774951934815,0.8073716210799491,-0.009904020049670472,1.014649969179823,1.0271821210899337,1.030479392195726,0.04899236485494507,53.060351264909166,116.17869916153279,112.47474975585938,108.77080035018597,111.04857145036969,1.9729642647226304,111.75446442195347,1.696417855109496,111.3853349350648,111.90002138170946,0.845848466574647,-1.9549986075324557,16213700,1.1120013413446916,0.8956417720158969,359206700.0,-7.886885164009034,56.70552541611323,56.9646702468221,69.42918356591375,23.23111779184119,18.472726050420317,-0.022793510008024445,2.1874310389723566,113.31408123779296,112.33296105957031,111.54000091552734,110.74704077148438,109.76592059326171,0.08,0.0,108.68539671218217,0.055463316055490486,0.048208267146202785,110.22261483328683,110.81002916608536,2.2178844418100367
2024-06-26,0,114.19000053405762,108.79249954223633,115.71500015258789,111.3887505531311,113.66062307357788,-0.37319149320913414,1.8531870513383562,-0.6277085381913667,2.9955962469443373,112.81750106811523,1.5070127391815191,0.016476270441072534,109.48249988555908,114.24774951934815,0.7788603491572785,-0.0001533031054055604,1.0152376842405633,1.0269970124127241,1.0212587090534744,0.04299774351593366,58.50295611431209,116.1824989615329,112.4761248588562,108.76975075617949,111.72107178824288,2.1449833788480817,111.86303574698312,1.8047040004171926,112.07358466718662,112.27274362908415,3.404613428138806,1.5144131222873471,15771800,1.144767634374684,0.8669368137304481,374978500.0,-7.29163355298114,56.70552541611323,56.9646702468221,70.20290960290664,21.935173701109363,18.50479515549159,-0.02949304004685742,2.151184936481769,113.31408123779296,112.33296105957031,111.54000091552734,110.74704077148438,109.76592059326171,0.1,0.0,108.71728217030007,0.04598649079552275,0.05583245543552223,110.97371128627232,110.90143585205077,2.195580351096768
2024-06-27,0,114.74749946594238,108.79249954223633,115.71500015258789,111.3887505531311,113.66062307357788,-0.37251328010733475,1.8554623590236068,-0.6332614038133513,2.995595918949042,112.81750106811523,1.5092627906799323,0.016496133024457023,109.48249988555908,114.29275054931641,0.7841182508405844,0.002722175760234953,1.0201716063968473,1.0301302771103142,1.01767555951966,0.03408731859733405,59.21297165446317,116.18954963412386,112.47862491607665,108.76770019802944,112.57178606305804,1.963094827895191,111.97232137407575,1.934679136103304,112.60389134338855,112.60289280250818,4.299776168651207,1.3490712023203055,16812700,1.1432014140913218,0.9168182409350589,391791200.0,-1.3215326013889943,56.70552541611323,56.9646702468221,88.52029035801645,21.855329417798117,17.940246718273244,0.009384294230461046,2.0603833735733152,113.3828384399414,112.38857879638671,111.58499908447266,110.78141937255859,109.7871597290039,0.12000000000000001,0.0,108.75423779753059,0.028279964490363962,0.050466261969441206,111.9005355834961,110.96733365740093,2.246556507725733
2024-06-28,0,115.55000114440918,108.79249954223633,115.71500015258789,111.3887505531311,113.72124862670898,-0.35160882064680754,1.8973814248253171,-0.7192155165480987,2.995589808273442,112.81750106811523,1.5483003044128423,0.016862315155997586,109.48249988555908,114.7944995880127,0.7836858840444872,0.010212406982591278,1.0269103038954295,1.034798524615569,1.0179630229136873,0.03604411757387371,62.20514062286973,116.31676278098607,112.52199993133544,108.72723708168482,113.43857192993164,1.6925966643760146,112.11678573063442,2.12580873076306,113.14030670185448,112.93154354410248,5.47372286578833,1.3513801046814178,24565900,1.146866775728395,1.304490969790976,416357100.0,-16.985622790350288,56.70552541611323,56.9646702468221,111.52479909151923,25.84738100153294,16.775305983644166,-0.05490034945207983,2.046069961510218,114.56704077148437,113.34648068237304,112.36000061035156,111.37352053833008,110.15296044921875,0.14,0.0,108.81443324480841,0.03936440351377879,0.03024885239975692,112.7139870779855,111.13526753016879,2.296828381597584
2024-07-01,0,115.48499870300293,108.79249954223633,115.71500015258789,111.3887505531311,114.13937616348267,-0.2821070271253093,1.9980247779581006,-0.8445439686978475,2.9955746166406745,112.81750106811523,1.6366129589080813,0.017741276491486806,109.48249988555908,115.25075073242188,0.7536276415213601,-0.0014259085508459108,1.0254383805504215,1.0294363310712684,1.0102348612472494,0.022307781587315834,63.437119866966356,116.61617465891302,112.62012510299682,108.62407554708062,114.08428600856236,1.4341071153635983,112.27535711015973,2.294177438380621,113.74460544833636,113.27559128565764,5.5419825669737515,1.781507554647926,11972900,1.05575852799533,0.6659541515132048,404384200.0,-20.794384193601157,56.70552541611323,56.9646702468221,114.28447290649589,24.55875704596606,15.488403155520235,-0.14798823247274695,2.0577794561877067,114.7198384399414,113.47007879638672,112.45999908447266,111.44991937255858,110.2001597290039,0.16,0.0,108.84322040453206,0.007978894320076702,0.037919771358579164,113.17031315394809,111.26848057338168,2.1054862536880443
2024-07-02,0,114.87750053405762,108.79249954223633,115.55000114440918,111.3887505531311,114.13937616348267,-0.3115676121363998,1.9807658166070572,-0.8550595930819624,2.9955772727657743,112.81750106811523,1.6262628936767585,0.01758982330234703,109.48249988555908,115.24425048828125,0.7705083566691971,0.0023216786925879455,1.020148327918267,1.0185710643230954,1.0005095000809325,0.006615690610364489,63.88789672773579,116.5701566637317,112.60862503051757,108.64709339730345,114.56250027247837,0.8985147849114421,112.46946443830218,2.3963531112078083,114.17689744095215,113.47529864831654,4.073355151804256,1.9600047016442956,13326700,1.0496185205006814,0.754394103513443,391057500.0,-29.906522064642978,56.70552541611323,56.9646702468221,80.61568145853238,22.498209036330774,17.750466971805096,-0.14106804180947968,2.085796139736128,114.7198384399414,113.47007879638672,112.45999908447266,111.44991937255858,110.2001597290039,0.16,0.0,108.87074624214281,-0.0016612891913452277,0.001139832412334628,113.65498243059429,111.4109055655343,2.09346524501066
2024-07-03,0,114.73999977111816,108.79249954223633,115.55000114440918,111.3887505531311,114.13937616348267,-0.33609870721912344,1.9596485432472268,-0.8404282478437066,2.9955804958962484,112.81750106811523,1.610962886810303,0.017404922815963085,109.48249988555908,114.93825035095215,0.8780424536729069,0.021860010719971356,1.019081123909467,1.011892421261501,0.9979994754716609,0.004816527143254534,64.55732457901445,116.51092210938263,112.59162502288818,108.67232793639373,114.81607164655414,0.5587759328716351,112.66392857687813,2.466299615575863,114.3482767407329,113.52790401751339,3.0014344362977625,2.4228803886447383,7732900,0.8322835627856418,0.4527069391568758,383324600.0,-23.13079780672641,56.70552541611323,56.9646702468221,85.4641765365023,21.333750434368532,16.831741222533804,-0.18739396150388565,2.0425243612308153,114.7198384399414,113.47007879638672,112.45999908447266,111.44991937255858,110.2001597290039,0.16,0.0,108.88760369247953,0.0030591854818664554,0.0034099969598508665,113.75560106549942,111.68229239327566,2.1525740428283995
2024-07-05,0,113.82500076293945,108.79249954223633,115.55000114440918,111.3887505531311,114.32750034332275,-0.4218901693445699,2.013968547062655,-0.9221340623491865,2.9955722045941036,113.0912504196167,1.6903625774383542,0.01786896445757071,109.48249988555908,114.93825035095215,0.8917212269376521,0.018372217547099255,1.0099139313681884,0.9991902061485273,0.9890945502120384,-0.008039379570765615,62.95313157666548,116.73556219712214,112.70762510299683,108.67968800887152,114.77357155936105,0.62741815262417,112.91107150486538,2.390399701218308,114.45342165301689,113.60038241960049,1.571282800984983,2.4304219390373127,12631000,0.8338233268060766,0.744320292848874,370693600.0,-39.36911306480682,56.70552541611323,56.9646702468221,31.71572957941855,19.7908667552955,21.13460242196404,-0.2399613763300261,2.0444869215069885,114.7198384399414,113.47007879638672,112.45999908447266,111.44991937255858,110.2001597290039,0.02,1.0,108.90887201709083,-0.013315890996281388,-0.00909010121010876,113.61388506208145,111.91824994768413,2.1563649003511367
2024-07-08,1,112.38500022888184,108.79249954223633,115.55000114440918,111.3887505531311,114.32750034332275,-0.4899180806959998,2.0285684352329185,-0.9257822261441055,2.9955699727180303,113.24125003814697,1.7328002166748036,0.017989284693799474,109.48249988555908,114.93825035095215,0.9070483328180607,0.005365778899989466,0.9966268474437451,0.9840788236854633,0.9781497103870671,-0.027390747591355402,54.2321168598584,116.82251191242752,112.76537504196168,108.70823817149584,114.51571437290737,1.100091419566781,113.11839308057513,2.187411960033433,114.3031848246373,113.53873023993319,-0.2606853221508418,3.13505277850483,13350500,0.8569692733504438,0.7862640399560298,357343100.0,-53.271014709761985,56.70552541611323,56.9646702468221,-11.11025225682487,18.32246505816439,23.990394334525092,-0.2870063862485621,2.050595452657031,114.7198384399414,113.47007879638672,112.45999908447266,111.44991937255858,110.2001597290039,0.04,0.0,108.92549650088613,-0.025538564318401957,-0.02367272485333552,113.297858101981,112.13578469412667,2.1347919063815044
2024-07-09,1,111.3025016784668,108.79249954223633,115.55000114440918,111.3887505531311,114.32750034332275,-0.43004459311034016,2.027404898851023,-0.9589248812939264,2.9955700975699755,113.11499977111816,1.7333751773834223,0.01798560550467825,109.48249988555908,114.93825035095215,0.8983593969514654,-0.010063640282490719,0.9873917578117636,0.9738710189621916,0.9740947526832232,-0.03621679933765609,44.069081966198375,116.77855981677554,112.72375001907349,108.66894022137144,114.02357183183942,1.624642951219622,113.29767894744873,1.8879399201658396,113.82770074069566,113.26823639102597,-1.5806990951343702,2.651110550526164,11727000,0.9142657664209167,0.6938414838161341,345616100.0,-73.04784901860363,56.70552541611323,56.9646702468221,-45.147926580972594,17.091448664072104,25.177982160563516,-0.27496804707377837,2.0412669258680918,114.86615908813475,113.70691984558104,112.77000045776366,111.83308106994627,110.67384182739256,0.06,0.0,108.93571358477168,-0.03496860218247688,-0.036309917493402816,112.73666272844586,112.31859915597099,2.162746694134951
2024-07-10,1,111.30499839782715,108.79249954223633,115.55000114440918,111.21812629699707,114.32750034332275,-0.277619524664341,2.0412473409139245,-1.0815335142106794,2.9955676993222444,112.67500019073486,1.7642500877380372,0.018126294498259664,109.48249988555908,114.93825035095215,0.8848294410702138,-0.01732660329101629,0.9883893733250482,0.9753115992777069,0.9813005643667437,-0.031098362339206154,38.77140180993026,116.69499477719529,112.61250009536744,108.53000541353958,113.41714286804199,1.7475292447053847,113.42785739898682,1.6528311094448092,113.19390009543281,112.86521536918642,-3.002242143409912,2.3071463076882566,10004100,0.9417410417030322,0.6012259983773551,355620200.0,-67.41256875790256,56.70552541611323,56.9646702468221,-38.8868779464095,16.15396456901151,24.50931044641498,-0.22789396625552125,2.005461678436241,115.0525975036621,114.00869728088378,113.16499710083008,112.32129692077636,111.27739669799804,0.08,0.0,108.94459941156691,-0.019793313824961856,-0.026443943363842932,112.28317042759487,112.49857875279018,2.16028680321318
2024-07-11,1,112.23250007629395,108.79249954223633,115.55000114440918,111.21812629699707,114.32750034332275,-0.14353607367354748,2.054574643343481,-1.1641786946209731,2.9955653872773,112.27249908447266,1.7872002029418952,0.01826053213148154,109.48249988555908,114.93825035095215,0.8968268555004968,-0.007623034575065045,0.9974936566454307,0.9858728087784746,0.9957502110180467,-0.021853753702511303,40.1708786579889,116.62364933246334,112.51450004577637,108.4053507590894,112.95250020708356,1.52420755037845,113.51839310782296,1.5382937126085825,112.7128590280328,112.53407622139812,-3.6737366547290797,1.6646480672830613,13082700,0.9117321800153586,0.784780794114639,368702900.0,-55.221487852723726,56.70552541611323,56.9646702468221,0.031401476261977805,19.57596021288418,22.45112442333838,-0.2004237877869663,2.032929037062138,115.248477935791,114.32575798034668,113.57999801635742,112.83423805236816,111.91151809692383,0.08,0.0,108.96106448971307,-0.013157959107985895,-0.008145072878882345,112.04083578927177,112.60557447160993,2.1680537836081952
2024-07-12,0,113.5099983215332,108.79249954223633,115.55000114440918,111.21812629699707,114.32750034332275,-0.1488215377370986,2.054009843126916,-1.1611533186225171,2.9955654844323747,112.30875015258789,1.783937606811523,0.018254924176362125,109.48249988555908,114.93825035095215,0.8992375802624603,0.0019193272633728179,1.008815230147145,0.9988120748412151,1.01158540317262,-0.002767427536084943,47.329104087373125,116.62614483884173,112.51812515258788,108.41010546633404,112.75714274815151,1.3087702925027165,113.65982151031494,1.428524151021301,112.584314252636,112.42909752078823,-2.8163819225331217,1.1422519911351476,11684900,0.936675310808589,0.7049960119268125,380387800.0,-54.90508525728084,56.70552541611323,56.9646702468221,28.805119124323166,21.481111901275508,21.230065643202266,-0.17770446106598692,1.9962910841344088,115.248477935791,114.32575798034668,113.57999801635742,112.83423805236816,111.91151809692383,0.08,0.0,108.9791432769028,-0.000882100184004253,-0.012983649105185072,111.91187395368304,112.78342819213867,2.145858827948813
2024-07-15,0,114.80500030517578,108.79249954223633,115.55000114440918,111.21812629699707,114.32750034332275,-0.24954878446259238,2.061564213137094,-1.157183908526569,2.99556437428409,112.67500019073486,1.808500099182129,0.01830991972001905,109.48249988555908,114.93825035095215,0.8742499837985792,0.0284963399351002,1.0196482484752676,1.0113084584934904,1.0237010403374431,0.021533123382705854,57.79991378833419,116.71587840338601,112.59274997711182,108.46962155083763,112.76642853873116,1.325309592146448,113.79125009264264,1.4442374989052211,112.80357663511674,112.52733625906232,-1.1904003883850103,1.7753049607259423,13032500,0.8900899984046204,0.7897192580608021,393420300.0,-24.20884261355051,56.70552541611323,56.9646702468221,82.54263686729176,26.297777120497063,19.102744690329498,-0.1488451873024219,2.0601286966392314,115.248477935791,114.32575798034668,113.57999801635742,112.83423805236816,111.91151809692383,0.02,1.0,109.00660177876627,0.02701013956591658,0.016230019274191026,111.97564588274274,112.8656234741211,2.1386403621351877
2024-07-16,0,115.11249923706055,108.79249954223633,115.55000114440918,111.30437421798706,114.74187469482422,-0.45337845049161424,2.048736688722395,-0.9865981027953756,2.995566906387383,113.23749923706055,1.7855251026153567,0.018160184627037862,109.48249988555908,114.93825035095215,0.8121615213943513,0.04861509579382429,1.0203674540179202,1.0146830945877534,1.0220321180365983,0.034231014587615904,65.47776106059919,116.91222338125948,112.8147500038147,108.71727662636991,112.95035689217704,1.5644667985982565,113.86196422576904,1.4853554467671854,113.29523993547329,112.87015129237429,0.05665028254076991,1.6288232196720256,13614100,0.8879527967897968,0.8242110676796789,407034400.0,-11.075901614606735,56.70552541611323,56.9646702468221,91.36378455326557,24.583830337764994,17.38864155935148,-0.10274897125293064,2.101548489750002,115.248477935791,114.32575798034668,113.57999801635742,112.83423805236816,111.91151809692383,0.04,0.0,109.0368413195742,0.04597076116837484,0.03440896911922248,112.3540278843471,112.98395647321429,2.068641218043055
2024-07-17,0,117.27750015258789,108.79249954223633,115.55000114440918,111.47375011444092,114.76187467575073,-0.6273058149210633,1.956238022850065,-0.6673022750522253,2.9955821198534784,113.66749954223633,1.6906249523162842,0.017297107745485076,110.81675014495849,115.14974918365479,0.7473277132465649,0.05809223725364097,1.036970722665446,1.0341064921685956,1.0342569727417066,0.053658881817811865,68.10183403658706,117.00872610292059,113.09625005722046,109.18377401152033,113.64928545270648,2.223749494802961,114.08249991280692,1.7444202131447697,113.7468735889154,113.28670733424764,1.1311209887909734,0.8674870002465861,13602800,0.8580262189385368,0.8427754317095898,420637200.0,-6.95877276896805,56.70552541611323,56.9646702468221,169.11700778666645,29.009884772708574,16.125508500261382,-0.04384534051071238,2.1042950107939107,116.3486398010254,115.21567948913575,114.29999923706055,113.38431898498536,112.25135867309571,0.06,0.0,109.07665184330205,0.05110792920407259,0.060392949876239124,113.12779780796596,113.21282795497349,1.9758253860503878
2024-07-18,0,118.52750015258789,109.48250007629395,117.27750015258789,112.05687522888184,114.82312536239624,-0.2504662203115878,1.8960243423778516,-0.5800890311339537,2.995592584165634,113.97375106811523,1.6007001018524165,0.016702043603687853,111.26875152587891,115.49149894714355,0.6472662185778653,0.07119859402974835,1.0441065715970246,1.0429214406045246,1.0343842089859203,0.05608892319082881,74.69107503885814,117.31254877249374,113.52050008773804,109.72845140298234,114.68142809186664,2.59816366163733,114.35249996185303,2.1095793746905622,114.63176596312158,113.99738446481321,4.353338891971395,2.7038266083635007,13033600,0.9487756398338978,0.8195163296815301,433670800.0,-11.78942228618451,56.70552541611323,56.9646702468221,202.27815934965216,32.43048187622179,14.78512120666554,-0.018426493850411178,2.1311310320798214,117.67799816894532,116.29099816894532,115.16999816894533,114.04899816894533,112.66199816894533,0.08,0.0,109.1201424713534,0.04900670625734471,0.061472529068878644,114.24168722970147,113.48917497907367,2.0323075751507154
2024-07-19,0,117.35249900817871,110.96500015258789,118.52750015258789,112.34687519073486,114.93625020980835,0.3436227908799555,1.9566830399398285,-0.27058540257861674,2.995585173865343,114.15625095367432,1.5734750366210932,0.01716799005348254,111.30474872589112,115.72275104522706,0.6770476038917487,0.06815211994413384,1.0296540086460235,1.0291528553568525,1.0129999557962508,0.03385164957681597,76.96860164999251,117.8861161714324,113.97275009155274,110.05938401167307,115.54535675048828,2.2734870334202006,114.48124980926514,2.2393017570107396,115.60860341067703,114.76915055992238,6.491317234713047,3.294190029620149,16157700,0.9362846499560584,1.0200413630096514,417513100.0,-40.52629972759061,56.70552541611323,56.9646702468221,114.24131862566118,29.252315779723233,18.447791222194613,-0.08578967531028174,2.1939075502131873,117.67799816894532,116.29099816894532,115.16999816894533,114.04899816894533,112.66199816894533,0.08,0.0,109.16361955687394,0.024719660634441087,0.024900661118321784,114.82980891636441,113.55648967197963,1.999291911041126
2024-07-22,0,115.24250030517578,111.3025016784668,118.52750015258789,112.82000017166138,115.20562410354614,0.2848554247776118,1.96097305359286,-0.47535965370713873,2.99558530446786,114.46500015258789,1.555374813079834,0.017157551782362977,111.50750045776367,117.28500003814698,0.7547557108195531,0.05220566919830014,1.0083153171800596,1.0075318501425519,0.988230506636057,0.0038108096235969224,67.78383934559278,118.21407114151799,114.29212503433227,110.37017892714655,115.97535678318569,1.7717628807045047,114.46392849513462,2.23186591048986,116.0477633346133,115.21949990959722,5.4332695722581485,1.5599289017027795,12065900,0.998502491741101,0.8722859670030844,405447200.0,-48.94738448293601,56.70552541611323,56.9646702468221,35.92832719935992,27.799963278414154,21.83036647604317,0.09115977629147173,2.1436278736461265,117.67799816894532,116.29099816894532,115.16999816894533,114.04899816894533,112.66199816894533,0.08,0.0,109.18883995017924,0.0005207539925027316,0.01765690045317215,115.11607578822546,113.5784557887486,1.8274270448731817
2024-07-23,0,114.13999938964845,111.3025016784668,118.52750015258789,113.37374877929688,115.30312490463257,0.20121662057394224,1.8640420584151738,-0.2852577986102376,2.9955998343519057,114.74374961853027,1.4462248611450192,0.016283007467972725,112.13974990844727,117.28500003814698,0.812977340398754,0.02016111317232372,0.9970496395538406,0.9954062500687707,0.9780424550759804,-0.008448255870193044,54.033616548038594,118.20583413208915,114.47775001525879,110.74966589842843,116.06535693577358,1.6364955676670492,114.41124984196254,2.2300563707654333,115.85309748805268,115.28297161615043,2.681932797394412,-0.20998259561901247,11251700,1.0965807326712294,0.8284422742127214,394195500.0,-68.52625796669423,56.70552541611323,56.9646702468221,-28.975126389542577,25.85181987578225,25.005754286385404,0.021370048862659474,2.140511464181494,117.67799816894532,116.29099816894532,115.16999816894533,114.04899816894533,112.66199816894533,0.08,0.0,109.20699891426725,-0.022664581936401196,-0.015623621096698284,115.13591657366074,113.52389526367188,1.841692313488159
2024-07-24,0,114.26249885559082,111.3025016784668,118.52750015258789,113.74625015258789,115.30312490463257,0.1429791355490595,1.8337078296248324,-0.1487007315955755,2.995604198752261,114.74374961853027,1.3815999031066888,0.016009811981257224,112.13974990844727,117.28500003814698,0.8265820664513716,0.00015332661085126973,0.9976077397024027,0.9940148091413123,0.9807266372277605,-0.025708267085112646,47.57661152963912,118.20391563636149,114.53649997711182,110.86908431786215,115.98785672869,1.7169964523485874,114.37714263371059,2.228292422032722,115.4297928999199,115.12156552004515,0.5550181282979857,-0.6419891980418909,14925200,1.1001430578175813,1.104152965119591,409120700.0,-51.6841687654194,56.70552541611323,56.9646702468221,-5.364016080836065,24.013673670356567,23.561579033133988,0.02666460746992109,2.1397604438046205,117.67799816894532,116.29099816894532,115.16999816894533,114.04899816894533,112.66199816894533,0.02,1.0,109.2334575417623,-0.02235632557001388,-0.008876253195974078,115.10757337297711,113.54160962785993,1.8447585726981401
2024-07-25,0,116.29749870300293,111.3025016784668,118.52750015258789,113.74625015258789,115.30312490463257,0.13223912708931213,1.8323808268810409,-0.14264567110565496,2.9956043922678526,114.74374961853027,1.373900041580199,0.015997248462470613,112.13974990844727,117.28500003814698,0.8271813582054377,0.0006348920325259147,1.015312949700806,1.0091217642782067,1.0033863868022672,-0.018814211442189754,48.103536306248614,118.20826150498888,114.54349985122681,110.87873819746474,116.15714236668178,1.674190596863576,114.5537496294294,2.278578823089972,115.14284598620605,114.96233754230258,-0.472541655975679,-0.41615906961814214,17021700,1.100386766237735,1.253455033477972,426142400.0,-26.210503829153108,56.70552541611323,56.9646702468221,92.28406137850425,30.395707278478096,20.948368483224858,0.03781418663399712,2.2347782674295,117.67799816894532,116.29099816894532,115.16999816894533,114.04899816894533,112.66199816894533,0.02,0.0,109.27622066597068,-0.011532017914425374,-0.0017850881949938598,115.30455889020648,113.82929338727679,1.952597858550375
2024-07-26,0,117.14999961853027,111.3025016784668,118.52750015258789,113.74625015258789,115.50124931335449,-0.003081715883017394,1.8692493503090009,-0.341177369350687,2.995599343476009,114.77624988555908,1.422850036621093,0.016304122951291973,112.13974990844727,117.28500003814698,0.7884676207010692,0.013507912976531521,1.0218155203363228,1.012946083709089,1.0146458948818315,-0.0017255652104547492,56.53220286713316,118.38737346029208,114.64887475967407,110.91037605905606,116.13892800467355,1.6606086505145545,114.89410672869,2.285577145808262,115.43956966407879,115.04083259517662,1.029427276617474,2.172192333398607,11252500,1.185669217624253,0.8459371897744782,437394900.0,-27.263119346217408,56.70552541611323,56.9646702468221,105.47272917462048,28.846728214915224,19.88083010028711,-0.007328083834020496,2.186579350847241,117.67799816894532,116.29099816894532,115.16999816894533,114.04899816894533,112.66199816894533,0.02,0.0,109.30650493280346,0.010855536066967097,-0.012373799871599846,115.2606266566685,114.19421223231724,2.0388545131859606
2024-07-29,0,116.54749870300293,111.3025016784668,118.52750015258789,113.74625015258789,115.73687553405762,-0.08208640255714862,1.9472950604666353,-0.6089971699229277,2.9955882492527848,114.8412504196167,1.5218500423431387,0.016967082264503625,112.13974990844727,117.28500003814698,0.7811240428257975,0.013846806216137444,1.015496335589797,1.0045747629734807,1.0097817883158493,0.011323933395851027,59.01005741081815,118.66358988823674,114.76899976730347,110.8744096463702,115.85607065473285,1.319553061192527,115.26874937329974,2.071404135259713,115.87456947799097,115.18532397545393,-0.10871696096158963,4.239889113266096,8861800,1.187320687950542,0.7080032053407432,428533100.0,-40.210523103412974,56.70552541611323,56.9646702468221,60.27898189760546,26.941641981898005,22.149240454366907,0.033877714996616334,2.1739666210945017,117.67799816894532,116.29099816894532,115.16999816894533,114.04899816894533,112.66199816894533,0.02,0.0,109.32726150994645,0.007200492287064542,0.0002584809206824029,114.87799181256973,114.5598395211356,2.0581196586917003
2024-07-30,0,117.34000015258789,111.3025016784668,118.52750015258789,113.74625015258789,116.35999870300293,-0.12059045930889345,1.9791728865188634,-0.7196245086247601,2.9955835907166555,114.8412504196167,1.568124866485595,0.017237347889309165,112.13974990844727,117.28500003814698,0.804000022646995,0.009200329150390093,1.021957413492725,1.0098888962644321,1.0143543247698394,0.028035752409769632,55.94014020794976,118.77722041827089,114.81887464523315,110.86052887219542,115.85428510393415,1.3171970434778955,115.69982092721122,1.7922168610471254,116.04454115794891,115.25200432033957,-1.6704996283866451,4.712380176043123,12483900,1.1969034698620464,0.9953548671042308,441017000.0,-19.46607804049263,56.70552541611323,56.9646702468221,105.69769571603746,28.685574102192426,20.349156880547355,0.0946739030593167,2.1972548422887916,117.79835867309572,116.48581898498536,115.42499923706055,114.36417948913575,113.05163980102539,0.02,0.0,109.36203367955751,0.04197154553555893,0.025158321625636183,115.17559596470423,115.00270244053432,2.185660807050153
2024-07-31,0,119.13749885559082,111.3025016784668,118.52750015258789,113.74625015258789,116.69812393188477,-0.15301953650693703,2.050400050468507,-0.8912219126285663,2.995572919501684,114.8412504196167,1.6642873573303212,0.017843277871193997,112.13974990844727,117.34125003814697,0.8011747358431104,0.021435873927290214,1.0367749925062808,1.0233971447797563,1.024226373637012,0.04266491673844097,59.82982842179425,119.01242481864942,114.9116247177124,110.81082461677538,116.41071346827916,1.7629507714162869,116.19303512573242,1.7129867936672944,116.36440323613087,115.48005287453519,-0.010650694017133136,5.422040197323748,15137700,1.196887370735275,1.198293952762313,456154700.0,-18.244192922141586,56.70552541611323,56.9646702468221,133.95052883282614,31.019917841311184,19.27616286296439,0.06011250090151098,2.1538795675767552,118.19955795288087,117.13521781921386,116.27499771118164,115.41477760314942,114.35043746948242,0.02,1.0,109.41036709483551,0.03112771618563004,0.04567495110760044,115.64609418596538,115.38108498709542,2.3133215288252007
2024-08-01,0,117.7874984741211,111.3025016784668,119.13749885559082,113.74625015258789,117.18187475204468,-0.06899920162310297,2.2475795405672674,-0.94238220039253,2.9955415890063106,114.95874977111816,1.8750873947143554,0.019523012975866876,112.13974990844727,117.46999912261963,0.7673981329367481,0.038325772121707596,1.0231303585032534,1.0101865493374065,1.0042030894109537,0.012811967477677877,65.97161898321858,119.61978371492361,115.12462463378907,110.62946555265452,116.93178476606097,1.4992642628102215,116.49857085091728,1.5734065586439245,117.04972482479249,115.96369172748538,3.3798282231820918,6.152405742189617,15051500,1.250930323201206,1.1579288294775454,441103200.0,-43.35769171224804,56.70552541611323,56.9646702468221,76.85771124059329,27.901018429517013,24.40510108370362,0.031124051229479845,2.2236025761740543,118.30339852905274,117.30329875183106,116.49499893188477,115.68669911193848,114.6865993347168,0.02,0.0,109.45112702461574,-0.004087601050451695,0.016868040457137218,116.14776829310824,115.64184243338448,2.3407278900415327
2024-08-02,0,116.78499984741211,111.3025016784668,119.13749885559082,113.74625015258789,117.29312515258789,-0.18432408890146068,2.3185218805397456,-1.0734087766636486,2.9955297385714768,115.17749977111816,1.9924497699737536,0.020112614738495148,112.13974990844727,117.86149864196777,0.813294796453622,0.034812191386971635,1.0130815365086865,1.0022248356490686,0.9931330712492935,-0.0031156617354390903,59.954402956962134,119.91404333001869,115.2769995689392,110.63995580785972,117.29214205060687,0.9551803417217988,116.63999938964844,1.4965791381802127,117.22222596893965,116.20081742193452,3.195636152073994,3.7683906403304346,20403800,1.2754438891383482,1.5241184168852822,420699400.0,-44.37958529497951,56.70552541611323,56.9646702468221,52.9388593547466,24.926097586567195,24.708053227803205,0.03261725641082916,2.3112030886782846,118.30339852905274,117.30329875183106,116.49499893188477,115.68669911193848,114.6865993347168,0.02,0.0,109.50209648932498,-0.0038353143760213593,-0.004683650866358057,116.41277749197822,115.76017543247768,2.3165064981982044
2024-08-05,0,114.89749908447266,111.3025016784668,119.13749885559082,113.98249912261964,117.29312515258789,-0.35089415339734,2.315583714628742,-0.9971664535191422,2.995530544806725,115.76999950408936,1.9952498435974113,0.020061370796575693,112.13974990844727,117.86149864196777,0.80530616486461,0.03915112879449474,0.9954299290373024,0.9865071373879118,0.9776888079018946,-0.014157314716251035,56.73660294538363,120.05616695242031,115.42499952316284,110.79383209390537,117.09214210510254,1.2870649174369397,116.62464223589215,1.514455660672323,117.10335501776467,116.24504528774206,2.2076368161782627,1.7246631566334862,18025900,1.249151897281285,1.323385495244493,402673500.0,-75.18252077479029,56.70552541611323,56.9646702468221,-32.60770808043543,22.23922917662534,28.488534920579177,0.052280643707537336,2.40540304087186,118.30339852905274,117.30329875183106,116.49499893188477,115.68669911193848,114.6865993347168,0.02,1.0,109.53259197724748,-0.011455675055067838,-0.021818836112430157,116.03581128801618,115.67018508911133,2.190745440902805
2024-08-06,0,114.46749877929688,111.3025016784668,119.13749885559082,114.23187398910522,117.29312515258789,-0.4434747730696419,2.2131378997669677,-0.6962629921233017,2.995548309952208,115.76999950408936,1.8696249008178705,0.019152972214522928,112.13974990844727,117.86149864196777,0.7369825995800476,0.03229934055203153,0.9906263969437504,0.9831063782371382,0.9767726586409377,-0.024480154845369362,49.584568878883815,119.97690026547632,115.55062446594238,111.12434866640844,116.70892769949776,1.6225827529680759,116.42392785208565,1.60478908426421,116.54279539356355,116.0629106409213,-1.2038088816557875,-0.18677394202442196,13647800,1.3053900634404125,0.9949486370651501,389025700.0,-84.08752977970539,56.70552541611323,56.9646702468221,-49.78591639240089,20.902340030746718,26.775974974601507,0.0570309253055496,2.3764455754803184,118.30339852905274,117.30329875183106,116.49499893188477,115.68669911193848,114.6865993347168,0.02,0.0,109.55451139474556,-0.033934098340938856,-0.016709676068851435,115.5865718296596,115.42359924316406,1.9333034496964159
2024-08-07,0,115.87750053405763,111.30499839782715,119.13749885559082,114.41624879837036,117.29312515258789,-0.3652856537679581,2.007303427124157,-0.5167143809070378,2.9955814623389587,115.76999950408936,1.7113750457763666,0.017347877929879154,113.38224849700927,117.86149864196777,0.6638528685520614,0.028412923291785103,1.0014573317220767,0.9949363569774059,0.993675783729421,-0.02736332685215004,47.86021101166382,119.7234811752322,115.70887432098388,111.69426746673557,116.61321367536273,1.6531652635165452,116.23464216504779,1.4897465829064886,116.01951886653924,115.9155276619942,-2.2898001263066945,-2.396027686158869,13660700,1.3122005642703445,0.9827898290062101,402686400.0,-60.98655219918081,56.70552541611323,56.9646702468221,1.718493321735692,23.47605266814051,24.43481551130814,-0.00478351219721252,2.418128109765277,118.1811615600586,117.2044212036133,116.41500091552734,115.62558062744141,114.6488402709961,0.02,0.0,109.58309548869148,-0.024538306127744325,-0.021071291804869694,115.5270516531808,115.20252173287528,1.707866039984139
2024-08-08,0,116.95250129699707,112.23250007629395,119.13749885559082,114.72062492370605,117.29312515258789,-0.1454859899324576,1.7345642656697977,-0.651705432151588,2.9956202637320968,116.08749961853027,1.4827499389648424,0.014961201287164771,114.07699928283692,117.86149864196777,0.6003242199605582,0.03247722767724028,1.0087547331468347,1.0027759195207144,1.008532911003714,-0.007089013587528337,52.72464655618994,119.40662795913501,115.93749942779542,112.46837089645582,116.55785669599261,1.6311130694277656,116.20607089996338,1.470368159748,115.98867453041203,115.97609871071309,-0.5748713412139795,-2.235767745981944,13851000,1.331214462569432,0.9937341870460138,416537400.0,-27.95219826839052,56.70552541611323,56.9646702468221,50.64455344947834,24.71486200065894,22.68151186218216,-0.008451036275234067,2.4189761263828142,118.1811615600586,117.2044212036133,116.41500091552734,115.62558062744141,114.6488402709961,0.02,0.0,109.61728013049209,0.00803764456452516,-0.005902713848860875,115.48737117222377,115.33148356846401,1.6290023698103409
2024-08-09,0,118.35249900817871,113.5099983215332,119.13749885559082,114.87437438964844,117.29312515258789,0.05143327442847033,1.5225562692139938,-0.9642602455131932,2.99564640577494,116.42249870300293,1.324650058746336,0.013105882803852173,114.25024890899658,117.86149864196777,0.551431274106401,0.030327751091251787,1.0187564249070213,1.0142102072740096,1.0220776115043066,0.013422093272377866,55.59969987477521,119.21861202725856,116.17349948883057,113.12838695040259,116.44571386064801,1.4399846249194623,116.42821366446358,1.546549371261192,116.24164560649558,116.12105653276073,-0.33023594263415734,-0.3408514642315059,12151900,1.3232668657496447,0.8703748866988475,428689300.0,-13.602441405359233,56.70552541611323,56.9646702468221,105.18129915717694,26.86495557976315,21.357158639043416,0.02115737496731823,2.3854775161008526,118.1811615600586,117.2044212036133,116.41500091552734,115.62558062744141,114.6488402709961,0.02,1.0,109.65194794693969,0.016854853058534403,0.016246269262802714,115.5242167881557,115.58515548706055,1.5724905236582027
2024-08-12,0,119.18499946594238,114.13999938964845,119.13749885559082,115.05874919891357,117.3431248664856,0.02339182754998113,1.4636403528629158,-1.0992914425323774,2.9956532429425864,116.66624927520752,1.263812551498411,0.012572542206924294,114.44699878692627,118.36999912261963,0.5271083681958468,0.030900210736230425,1.0237886877652622,1.020292857505304,1.0264879250381127,0.03731587210890952,59.37907926056716,119.34290522888868,116.41562452316285,113.48834381743701,116.64535685947963,1.7255739484573975,116.7885708127703,1.5600674541085833,116.7823978818445,116.45796603880878,-0.6589024068430587,2.698656046829325,13228900,1.3281170848566541,0.9468486036400516,441918200.0,-16.478850991445572,56.70552541611323,56.9646702468221,122.06901394470178,27.716566335502986,19.97246701356024,0.004666412883430762,2.3686577570284304,118.49439852905275,117.45779875183106,116.61999893188477,115.78219911193848,114.7455993347168,0.04,0.0,109.6917355575707,0.03685635385401986,0.018138235207415192,115.81473541259766,115.98125185285296,1.6334451546560795
2024-08-13,0,118.03750038146973,114.13999938964845,119.18499946594238,115.21000003814697,117.4612488746643,-0.05807186154145392,1.5323343176390483,-1.0352478403406518,2.995645944487071,116.86875057220459,1.2866626739501938,0.013137902440677257,114.44699878692627,118.58850002288818,0.5358258155335166,0.03537843636332667,1.0120279540188744,1.00819324541742,1.009152158867467,0.03118790608901234,61.8255181271705,119.69929311647927,116.63462448120117,113.56995584592308,116.82428550720215,1.8055510656712124,117.0582137789045,1.408775216112267,117.39191482883732,116.86531788765915,1.186459522381598,4.420010603882543,11585100,1.335781912465271,0.8352598457612461,430333100.0,-33.38147644258452,56.70552541611323,56.9646702468221,60.01994777727479,26.42911905656501,20.655008963582727,-0.04484248902349294,2.306610618576584,118.53687860107424,117.52655886840822,116.70999908447266,115.89343930053711,114.88311956787109,0.04,0.0,109.722221863656,0.032410637365029915,0.026923491873947387,115.95361764090401,116.18319756644112,1.645090033304633
2024-08-14,0,118.64499855041504,114.13999938964845,119.18499946594238,115.71875047683717,117.84999895095825,-0.25957122056859133,1.5196115156225116,-0.9383664596045294,2.995647510668703,117.05125045776367,1.2514501953124992,0.013012503302692343,114.44699878692627,118.58850002288818,0.6402449294260806,0.006480358362797738,1.0159625796549425,1.0127786985959708,1.0081916232183699,0.023882962642467476,54.410186400717826,119.82009756966664,116.78087453842163,113.74165150717661,117.35964257376534,1.6909724840238824,117.22589233943394,1.4503578341768029,117.55549391905797,117.11355316318146,1.0724840824541662,3.3037974520843387,12194500,1.2850145713661074,0.883682472876104,442527600.0,-17.63008010866374,56.70552541611323,56.9646702468221,97.77147577110733,28.878463411490483,19.20141422462627,-0.05449999908175279,2.3039958734714143,118.53687860107424,117.52655886840822,116.70999908447266,115.89343930053711,114.88311956787109,0.04,0.0,109.75743463251396,0.028267610130338294,0.04195860917470848,116.54599217006138,116.29090172903878,1.7046113425709681
2024-08-15,0,118.6825008392334,114.13999938964845,119.18499946594238,115.71875047683717,118.11625003814697,-0.283868972736317,1.5703375736810912,-1.055270146329248,2.995641849991039,117.05125045776367,1.312575092315673,0.013439004366402227,114.44699878692627,118.69424858093262,0.6324739719944857,0.0009913176071028695,1.0156890300059176,1.0135249206604535,1.0037890894757089,0.014792326141388479,55.5841354306241,119.98992460567516,116.84924945831298,113.70857431095081,117.96178572518485,1.1549712326417563,117.33535671234131,1.5011325556328843,117.82154046052398,117.35457200816018,3.261602294047515,2.0185299542916946,11579400,1.2609564862166094,0.8435535112366713,454107000.0,-20.809179090161546,56.70552541611323,56.9646702468221,97.19172025207997,27.492458075474595,18.279853330088017,-0.06748329524801112,2.247281367342706,118.53687860107424,117.52655886840822,116.70999908447266,115.89343930053711,114.88311956787109,0.04,0.0,109.7906200550251,0.01523354702224955,0.03462895595424708,117.32909829275948,116.45783506120954,1.7670538459924716
2024-08-16,0,118.07500076293945,114.13999938964845,119.18499946594238,115.71875047683717,118.11625003814697,-0.27575019039232346,1.578959877236621,-1.0650862174375095,2.9956408690848733,117.05125045776367,1.3195501232147209,0.013511898166921507,114.44699878692627,118.72800064086914,0.6750079377125393,0.011333391638826499,1.0104230065428887,1.00756689331794,0.9957370825084692,-0.002344675841784105,57.243722572264836,120.01491924711851,116.85699949264526,113.699079738172,118.27571432931083,0.7050373508760911,117.44446400233677,1.4949627680734565,118.02763400797178,117.4822921956501,3.6822697314837005,1.308152988214539,10056000,1.229861332435481,0.749226354498953,444051000.0,-28.901741751541802,56.70552541611323,56.9646702468221,56.13306495097829,26.52110869757472,19.15292003769851,-0.007687804326513422,2.1631896502365624,118.53687860107424,117.52655886840822,116.70999908447266,115.89343930053711,114.88311956787109,0.04,0.0,109.81695188272928,0.002283302551727484,0.010445068648817576,117.8167953491211,116.67192350115094,1.821367522791875
